dx,dy,button,rx,ry,time,distance,targetID,directionX,directionY,targetX,targetY,initMouseX,initMouseY,targetSize
0,1,0.02,-0.0,1.0,0.22440767288208008,540.6375865586854,1,455,-292,1415,309,960,600,20
0,1,0.01,-0.0,1.0,0.23238682746887207,541.1783439865272,1,455,-293,1415,309,960,600,20
0,1,0.02,-0.0,1.0,0.2413632869720459,541.7204075904839,1,455,-294,1415,309,960,600,20
0,1,0.02,-0.0,1.0,0.2493419647216797,542.2637734534735,1,455,-295,1415,309,960,600,20
0,1,0.02,-0.0,1.0,0.2573211193084717,542.808437664707,1,455,-296,1415,309,960,600,20
0,1,0.02,-0.0,1.0,0.26729726791381836,543.3543963197501,1,455,-297,1415,309,960,600,20
0,1,0.01,-0.0,1.0,0.27428364753723145,543.9016455205849,1,455,-298,1415,309,960,600,20
0,1,0.01,-0.0,1.0,0.2842597961425781,544.45018137567,1,455,-299,1415,309,960,600,20
0,1,0.01,-0.0,1.0,0.291231632232666,545.0,1,455,-300,1415,309,960,600,20
0,1,0.01,-0.0,1.0,0.3012058734893799,545.551097515164,1,455,-301,1415,309,960,600,20
0,0,0.02,-0.0,-0.0,0.30818700790405273,545.551097515164,1,455,-301,1415,309,960,600,20
1,0,0.01,1.0,-0.0,0.3181605339050293,544.7173579022427,1,454,-301,1415,309,960,600,20
1,-1,0.0,1.0,-1.0,0.32813477516174316,543.3313905895737,1,453,-300,1415,309,960,600,20
1,-1,0.0,1.0,-1.0,0.3371102809906006,541.9455692225927,1,452,-299,1415,309,960,600,20
1,-2,0.0,1.0,-2.0,0.3460867404937744,540.0092591798774,1,451,-297,1415,309,960,600,20
1,-2,0.0,1.0,-2.0,0.3540656566619873,538.0752735445107,1,450,-295,1415,309,960,600,20
1,-3,0.0,1.0,-3.0,0.36304211616516113,535.5977968587996,1,449,-292,1415,309,960,600,20
1,-4,0.0,1.0,-4.0,0.37102723121643066,532.5861432669836,1,448,-288,1415,309,960,600,20
2,-5,0.0,2.0,-5.0,0.37999844551086426,528.2092388438506,1,446,-283,1415,309,960,600,20
3,-6,0.0,3.0,-6.0,0.38797712326049805,522.4729658078014,1,443,-277,1415,309,960,600,20
4,-7,0.0,4.0,-7.0,0.39695239067077637,515.3843226175977,1,439,-270,1415,309,960,600,20
5,-8,0.0,5.0,-8.0,0.40493130683898926,506.951674225463,1,434,-262,1415,309,960,600,20
6,-9,0.0,6.0,-9.0,0.41291022300720215,497.18507620402283,1,428,-253,1415,309,960,600,20
7,-10,0.0,7.0,-10.0,0.42088913917541504,486.09669819903115,1,421,-243,1415,309,960,600,20
8,-10,0.0,8.0,-10.0,0.42986607551574707,474.19194425886235,1,413,-233,1415,309,960,600,20
9,-10,0.0,9.0,-10.0,0.4388420581817627,461.45964070544676,1,404,-223,1415,309,960,600,20
9,-10,0.0,9.0,-10.0,0.44881510734558105,448.7694285487816,1,395,-213,1415,309,960,600,20
10,-10,0.0,10.0,-10.0,0.45679497718811035,435.2401635878748,1,385,-203,1415,309,960,600,20
10,-10,0.0,10.0,-10.0,0.4667689800262451,421.7511114389623,1,375,-193,1415,309,960,600,20
10,-9,0.0,10.0,-9.0,0.4767420291900635,408.7554280985147,1,365,-184,1415,309,960,600,20
10,-9,0.0,10.0,-9.0,0.48472094535827637,395.790348543266,1,355,-175,1415,309,960,600,20
10,-8,0.0,10.0,-8.0,0.49270009994506836,383.29362113137233,1,345,-167,1415,309,960,600,20
10,-8,0.0,10.0,-8.0,0.5016763210296631,370.81801466487576,1,335,-159,1415,309,960,600,20
10,-7,0.0,10.0,-7.0,0.5106523036956787,358.7882383802457,1,325,-152,1415,309,960,600,20
10,-7,0.0,10.0,-7.0,0.5186319351196289,346.77081768799405,1,315,-145,1415,309,960,600,20
10,-6,0.0,10.0,-6.0,0.5266103744506836,335.18054836162554,1,305,-139,1415,309,960,600,20
10,-6,0.0,10.0,-6.0,0.5346038341522217,323.5954264200902,1,295,-133,1415,309,960,600,20
10,-6,0.0,10.0,-6.0,0.544562816619873,312.0160252294744,1,285,-127,1415,309,960,600,20
10,-6,0.0,10.0,-6.0,0.5515449047088623,300.4430062424486,1,275,-121,1415,309,960,600,20
10,-6,0.0,10.0,-6.0,0.5595242977142334,288.87713651308576,1,265,-115,1415,309,960,600,20
10,-6,0.0,10.0,-6.0,0.5684995651245117,277.3193105429191,1,255,-109,1415,309,960,600,20
10,-6,0.0,10.0,-6.0,0.5764789581298828,265.7705777545739,1,245,-103,1415,309,960,600,20
10,-6,0.0,10.0,-6.0,0.5834598541259766,254.23217734976035,1,235,-97,1415,309,960,600,20
10,-6,0.0,10.0,-6.0,0.5924365520477295,242.7055829600959,1,225,-91,1415,309,960,600,20
10,-6,0.0,10.0,-6.0,0.6004149913787842,231.19256043393784,1,215,-85,1415,309,960,600,20
10,-6,0.0,10.0,-6.0,0.6073968410491943,219.69524346239268,1,205,-79,1415,309,960,600,20
10,-6,0.0,10.0,-6.0,0.6163730621337891,208.21623375712088,1,195,-73,1415,309,960,600,20
10,-6,0.0,10.0,-6.0,0.6243526935577393,196.7587355112855,1,185,-67,1415,309,960,600,20
10,-5,0.0,10.0,-5.0,0.6323308944702148,185.6582882609877,1,175,-62,1415,309,960,600,20
9,-5,0.0,9.0,-5.0,0.6423051357269287,175.5135322418189,1,166,-57,1415,309,960,600,20
9,-5,0.0,9.0,-5.0,0.6502840518951416,165.38742394752995,1,157,-52,1415,309,960,600,20
9,-4,0.0,9.0,-4.0,0.6582629680633545,155.58920271021378,1,148,-48,1415,309,960,600,20
9,-4,0.0,9.0,-4.0,0.6682367324829102,145.79780519610026,1,139,-44,1415,309,960,600,20
9,-4,0.0,9.0,-4.0,0.676215410232544,136.01470508735443,1,130,-40,1415,309,960,600,20
9,-4,0.0,9.0,-4.0,0.6861894130706787,126.24183141890805,1,121,-36,1415,309,960,600,20
8,-3,0.0,8.0,-3.0,0.6961631774902344,117.72000679578642,1,113,-33,1415,309,960,600,20
7,-3,0.0,7.0,-3.0,0.7051472663879395,110.16351483136329,1,106,-30,1415,309,960,600,20
6,-3,0.0,6.0,-3.0,0.7141156196594238,103.58088626768937,1,100,-27,1415,309,960,600,20
6,-3,0.0,6.0,-3.0,0.7210969924926758,97.01546268507923,1,94,-24,1415,309,960,600,20
6,-3,0.0,6.0,-3.0,0.7310705184936523,90.47098982546837,1,88,-21,1415,309,960,600,20
6,-3,0.0,6.0,-3.0,0.7390491962432861,83.95236744726142,1,82,-18,1415,309,960,600,20
6,-3,0.0,6.0,-3.0,0.7490236759185791,77.46612162745726,1,76,-15,1415,309,960,600,20
6,-3,0.0,6.0,-3.0,0.756005048751831,71.02112361825881,1,70,-12,1415,309,960,600,20
6,-2,0.0,6.0,-2.0,0.7649836540222168,64.77653896280658,1,64,-10,1415,309,960,600,20
5,-2,0.0,5.0,-2.0,0.7719662189483643,59.53990258641679,1,59,-8,1415,309,960,600,20
5,-2,0.0,5.0,-2.0,0.7809393405914307,54.3323108288245,1,54,-6,1415,309,960,600,20
5,-1,0.0,5.0,-1.0,0.7889177799224854,49.25444142409901,1,49,-5,1415,309,960,600,20
5,-1,0.0,5.0,-1.0,0.7968969345092773,44.181444068749045,1,44,-4,1415,309,960,600,20
5,-1,0.0,5.0,-1.0,0.8048758506774902,39.11521443121589,1,39,-3,1415,309,960,600,20
4,-1,0.0,4.0,-1.0,0.8138527870178223,35.05709628591621,1,35,-2,1415,309,960,600,20
4,-1,0.0,4.0,-1.0,0.8213696479797363,31.016124838541646,1,31,-1,1415,309,960,600,20
3,-1,0.0,3.0,-1.0,0.8303465843200684,28.0,1,28,0,1415,309,960,600,20
3,-1,0.0,3.0,-1.0,0.838325023651123,25.019992006393608,1,25,1,1415,309,960,600,20
2,-1,0.0,2.0,-1.0,0.8463039398193359,23.08679276123039,1,23,2,1415,309,960,600,20
2,-1,0.0,2.0,-1.0,0.8542828559875488,21.213203435596427,1,21,3,1415,309,960,600,20
2,-1,0.01,2.0,-1.0,0.8632616996765137,19.4164878389476,1,19,4,1415,309,960,600,20
2,-1,0.02,2.0,-1.0,0.871239185333252,17.72004514666935,1,17,5,1415,309,960,600,20
2,-1,0.03,2.0,-1.0,0.882209300994873,16.15549442140351,1,15,6,1415,309,960,600,20
2,-1,0.05,2.0,-1.0,0.8901879787445068,14.7648230602334,1,13,7,1415,309,960,600,20
1,-1,0.06,1.0,-1.0,0.8991646766662598,14.422205101855956,1,12,8,1415,309,960,600,20
1,-1,0.31,1.0,-1.0,0.9081506729125977,14.212670403551895,1,11,9,1415,309,960,600,20
1,0,0.66,1.0,-0.0,0.9171171188354492,13.45362404707371,1,10,9,1415,309,960,600,20
0,0,0.84,-0.0,-0.0,0.007554292678833008,319.7811751807789,2,116,298,1521,598,1405,300,35
0,0,0.31,-0.0,-0.0,0.016530752182006836,319.7811751807789,2,116,298,1521,598,1405,300,35
0,1,0.15,-0.0,1.0,0.02550673484802246,318.8494942759044,2,116,297,1521,598,1405,300,35
0,1,0.11,-0.0,1.0,0.034483909606933594,317.91822848021786,2,116,296,1521,598,1405,300,35
0,1,0.11,-0.0,1.0,0.04246234893798828,316.98738145232215,2,116,295,1521,598,1405,300,35
0,1,0.08,-0.0,1.0,0.051438331604003906,316.0569568922665,2,116,294,1521,598,1405,300,35
0,1,0.04,-0.0,1.0,0.0594172477722168,315.12695854210887,2,116,293,1521,598,1405,300,35
0,1,0.02,-0.0,1.0,0.06739616394042969,314.1973901864877,2,116,292,1521,598,1405,300,35
0,1,0.01,-0.0,1.0,0.07637262344360352,313.2682556532021,2,116,291,1521,598,1405,300,35
0,1,0.0,-0.0,1.0,0.08435225486755371,312.33955881380126,2,116,290,1521,598,1405,300,35
0,1,0.0,-0.0,1.0,0.09532308578491211,311.4113035841827,2,116,289,1521,598,1405,300,35
0,1,0.0,-0.0,1.0,0.10493063926696777,310.4834939252005,2,116,288,1521,598,1405,300,35
0,1,0.0,-0.0,1.0,0.1168985366821289,309.5561338432821,2,116,287,1521,598,1405,300,35
0,1,0.0,-0.0,1.0,0.12687373161315918,308.62922739105574,2,116,286,1521,598,1405,300,35
0,2,0.0,-0.0,2.0,0.13784480094909668,306.7767918210242,2,116,284,1521,598,1405,300,35
0,3,0.0,-0.0,3.0,0.15080928802490234,304.00164473239283,2,116,281,1521,598,1405,300,35
0,4,0.0,-0.0,4.0,0.16078519821166992,300.30817504690077,2,116,277,1521,598,1405,300,35
0,5,0.0,-0.0,5.0,0.17275357246398926,295.70255325241953,2,116,272,1521,598,1405,300,35
0,6,0.0,-0.0,6.0,0.18372273445129395,290.1930391997713,2,116,266,1521,598,1405,300,35
1,7,0.0,1.0,7.0,0.19269919395446777,283.38313287844073,2,115,259,1521,598,1405,300,35
2,8,0.0,2.0,8.0,0.2046680450439453,275.26351011349107,2,113,251,1521,598,1405,300,35
3,8,0.0,3.0,8.0,0.2156379222869873,266.7376988728815,2,110,243,1521,598,1405,300,35
4,8,0.0,4.0,8.0,0.22261929512023926,257.8003103178893,2,106,235,1521,598,1405,300,35
5,8,0.0,5.0,8.0,0.23259305953979492,248.4552273549502,2,101,227,1521,598,1405,300,35
5,8,0.0,5.0,8.0,0.24156928062438965,239.11712611187014,2,96,219,1521,598,1405,300,35
5,8,0.0,5.0,8.0,0.24956488609313965,229.78685776170926,2,91,211,1521,598,1405,300,35
5,8,0.0,5.0,8.0,0.25852513313293457,220.4654167891191,2,86,203,1521,598,1405,300,35
5,8,0.0,5.0,8.0,0.26650381088256836,211.1539722572133,2,81,195,1521,598,1405,300,35
5,8,0.0,5.0,8.0,0.2754805088043213,201.8539075668341,2,76,187,1521,598,1405,300,35
5,8,0.0,5.0,8.0,0.2834584712982178,192.566871501824,2,71,179,1521,598,1405,300,35
5,8,0.0,5.0,8.0,0.2954273223876953,183.29484444468153,2,66,171,1521,598,1405,300,35
5,8,0.0,5.0,8.0,0.3034093379974365,174.04022523543227,2,61,163,1521,598,1405,300,35
5,8,0.0,5.0,8.0,0.31238269805908203,164.80594649465777,2,56,155,1521,598,1405,300,35
5,8,0.0,5.0,8.0,0.32135891914367676,155.59562975867928,2,51,147,1521,598,1405,300,35
5,7,0.0,5.0,7.0,0.3303351402282715,147.36349615830918,2,46,140,1521,598,1405,300,35
5,7,0.0,5.0,7.0,0.3383138179779053,139.17614738165446,2,41,133,1521,598,1405,300,35
5,6,0.0,5.0,6.0,0.3472902774810791,132.00378782444085,2,36,127,1521,598,1405,300,35
5,6,0.0,5.0,6.0,0.355269193649292,124.90796611905904,2,31,121,1521,598,1405,300,35
5,5,0.0,5.0,5.0,0.36524343490600586,118.87808881370864,2,26,116,1521,598,1405,300,35
5,5,0.0,5.0,5.0,0.3722245693206787,112.96902230257638,2,21,111,1521,598,1405,300,35
5,5,0.0,5.0,5.0,0.38120079040527344,107.20074626605917,2,16,106,1521,598,1405,300,35
5,4,0.0,5.0,4.0,0.38918018341064453,102.59142264341595,2,11,102,1521,598,1405,300,35
4,4,0.0,4.0,4.0,0.3971590995788574,98.2496819333274,2,7,98,1521,598,1405,300,35
4,4,0.0,4.0,4.0,0.4061412811279297,94.04786015641186,2,3,94,1521,598,1405,300,35
4,4,0.0,4.0,4.0,0.4151113033294678,90.00555538409837,2,-1,90,1521,598,1405,300,35
4,4,0.0,4.0,4.0,0.42309117317199707,86.14522621712709,2,-5,86,1521,598,1405,300,35
4,4,0.0,4.0,4.0,0.4320664405822754,82.49242389456137,2,-9,82,1521,598,1405,300,35
4,4,0.0,4.0,4.0,0.43904829025268555,79.07591289387686,2,-13,78,1521,598,1405,300,35
4,4,0.0,4.0,4.0,0.4490225315093994,75.92759709091287,2,-17,74,1521,598,1405,300,35
3,4,0.0,3.0,4.0,0.4570004940032959,72.80109889280519,2,-20,70,1521,598,1405,300,35
3,4,0.0,3.0,4.0,0.4659767150878906,69.8927750200262,2,-23,66,1521,598,1405,300,35
3,4,0.0,3.0,4.0,0.4729583263397217,67.23094525588644,2,-26,62,1521,598,1405,300,35
3,4,0.0,3.0,4.0,0.4819364547729492,64.8459713474939,2,-29,58,1521,598,1405,300,35
3,4,0.0,3.0,4.0,0.48891711235046387,62.76941930590086,2,-32,54,1521,598,1405,300,35
3,4,0.0,3.0,4.0,0.4978940486907959,61.032778078668514,2,-35,50,1521,598,1405,300,35
3,4,0.0,3.0,4.0,0.5058765411376953,59.665735560705194,2,-38,46,1521,598,1405,300,35
3,4,0.0,3.0,4.0,0.5148487091064453,58.69412236331676,2,-41,42,1521,598,1405,300,35
3,4,0.0,3.0,4.0,0.5228269100189209,58.137767414994535,2,-44,38,1521,598,1405,300,35
3,4,0.0,3.0,4.0,0.5308065414428711,58.008620049092706,2,-47,34,1521,598,1405,300,35
3,4,0.0,3.0,4.0,0.5387852191925049,58.309518948453004,2,-50,30,1521,598,1405,300,35
3,4,0.0,3.0,4.0,0.5477621555328369,59.033888572581766,2,-53,26,1521,598,1405,300,35
3,4,0.0,3.0,4.0,0.5557401180267334,60.166435825965294,2,-56,22,1521,598,1405,300,35
3,4,0.0,3.0,4.0,0.56571364402771,61.68468205316454,2,-59,18,1521,598,1405,300,35
3,4,0.0,3.0,4.0,0.5736937522888184,63.56099432828282,2,-62,14,1521,598,1405,300,35
2,4,0.0,2.0,4.0,0.5826699733734131,64.77653896280658,2,-64,10,1521,598,1405,300,35
2,3,0.0,2.0,3.0,0.5906493663787842,66.37017402418047,2,-66,7,1521,598,1405,300,35
1,3,0.0,1.0,3.0,0.5986275672912598,67.11929677819934,2,-67,4,1521,598,1405,300,35
0,2,0.0,-0.0,2.0,0.6066064834594727,67.02984409947557,2,-67,2,1521,598,1405,300,35
0,2,0.0,-0.0,2.0,0.6155827045440674,67.0,2,-67,0,1521,598,1405,300,35
-1,2,0.0,-1.0,2.0,0.6245584487915039,66.03029607687671,2,-66,-2,1521,598,1405,300,35
-1,2,0.0,-1.0,2.0,0.6325376033782959,65.12296062065974,2,-65,-4,1521,598,1405,300,35
-1,2,0.0,-1.0,2.0,0.6405162811279297,64.28063471995279,2,-64,-6,1521,598,1405,300,35
-1,1,0.0,-1.0,1.0,0.6494927406311035,63.387695966961914,2,-63,-7,1521,598,1405,300,35
-1,1,0.01,-1.0,1.0,0.6574716567993164,62.51399843235114,2,-62,-8,1521,598,1405,300,35
-1,1,0.03,-1.0,1.0,0.6654613018035889,61.66036003787198,2,-61,-9,1521,598,1405,300,35
-1,0,0.03,-1.0,-0.0,0.6734414100646973,60.67124524847005,2,-60,-9,1521,598,1405,300,35
-1,0,0.04,-1.0,-0.0,0.6814084053039551,59.682493245507096,2,-59,-9,1521,598,1405,300,35
-1,0,0.03,-1.0,-0.0,0.690385103225708,58.69412236331676,2,-58,-9,1521,598,1405,300,35
-2,0,0.03,-2.0,-0.0,0.6983635425567627,56.71860364994893,2,-56,-9,1521,598,1405,300,35
-2,0,0.01,-2.0,-0.0,0.7073402404785156,54.74486277268398,2,-54,-9,1521,598,1405,300,35
-2,0,0.0,-2.0,-0.0,0.716315746307373,52.773099207835045,2,-52,-9,1521,598,1405,300,35
-2,0,0.0,-2.0,-0.0,0.7232978343963623,50.80354318352215,2,-50,-9,1521,598,1405,300,35
-2,0,0.01,-2.0,-0.0,0.7322742938995361,48.83646178829912,2,-48,-9,1521,598,1405,300,35
-2,0,0.01,-2.0,-0.0,0.739255428314209,46.87216658103186,2,-46,-9,1521,598,1405,300,35
-2,0,0.01,-2.0,-0.0,0.7482318878173828,44.91102314577124,2,-44,-9,1521,598,1405,300,35
-2,0,0.01,-2.0,-0.0,0.7572088241577148,42.95346318982906,2,-42,-9,1521,598,1405,300,35
-2,0,0.03,-2.0,-0.0,0.7671823501586914,41.0,2,-40,-9,1521,598,1405,300,35
-2,0,0.04,-2.0,-0.0,0.776158332824707,39.05124837953327,2,-38,-9,1521,598,1405,300,35
-2,0,0.04,-2.0,-0.0,0.7841370105743408,37.107950630558946,2,-36,-9,1521,598,1405,300,35
-2,0,0.06,-2.0,-0.0,0.792116641998291,35.17101079013795,2,-34,-9,1521,598,1405,300,35
-2,0,0.09,-2.0,-0.0,0.8010928630828857,33.24154027718932,2,-32,-9,1521,598,1405,300,35
-1,0,0.16,-1.0,-0.0,0.8090717792510986,32.28002478313795,2,-31,-9,1521,598,1405,300,35
-1,0,0.56,-1.0,-0.0,0.8170502185821533,31.32091952673165,2,-30,-9,1521,598,1405,300,35
0,0,0.84,-0.0,-0.0,0.009974241256713867,1182.7577943095534,3,-1070,504,481,1111,1551,607,15
0,0,0.52,-0.0,-0.0,0.019954204559326172,1182.7577943095534,3,-1070,504,481,1111,1551,607,15
0,1,0.43,-0.0,1.0,0.02992105484008789,1182.3320176667805,3,-1070,503,481,1111,1551,607,15
0,1,0.43,-0.0,1.0,0.03889751434326172,1181.9069337304015,3,-1070,502,481,1111,1551,607,15
0,1,0.63,-0.0,1.0,0.04687619209289551,1181.4825432481007,3,-1070,501,481,1111,1551,607,15
0,1,0.69,-0.0,1.0,0.0548555850982666,1181.058846967415,3,-1070,500,481,1111,1551,607,15
0,1,0.57,-0.0,1.0,0.06383180618286133,1180.635845635732,3,-1070,499,481,1111,1551,607,15
0,1,0.42,-0.0,1.0,0.07181072235107422,1180.2135400002833,3,-1070,498,481,1111,1551,607,15
0,1,0.26,-0.0,1.0,0.07979011535644531,1179.7919308081405,3,-1070,497,481,1111,1551,607,15
0,1,0.34,-0.0,1.0,0.0877685546875,1179.371018806211,3,-1070,496,481,1111,1551,607,15
0,0,0.18,-0.0,-0.0,0.09674477577209473,1179.371018806211,3,-1070,496,481,1111,1551,607,15
0,0,0.16,-0.0,-0.0,0.10472345352172852,1179.371018806211,3,-1070,496,481,1111,1551,607,15
-1,0,0.12,-1.0,-0.0,0.11369967460632324,1178.4638305862425,3,-1069,496,481,1111,1551,607,15
-1,0,0.03,-1.0,-0.0,0.12167906761169434,1177.5567926856013,3,-1068,496,481,1111,1551,607,15
-1,0,0.01,-1.0,-0.0,0.1316523551940918,1176.6499054519147,3,-1067,496,481,1111,1551,607,15
-2,0,0.01,-2.0,-0.0,0.13863801956176758,1174.8365843809938,3,-1065,496,481,1111,1551,607,15
-2,0,0.0,-2.0,-0.0,0.14761018753051758,1173.0238701748572,3,-1063,496,481,1111,1551,607,15
-2,0,0.0,-2.0,-0.0,0.15558934211730957,1171.2117656512848,3,-1061,496,481,1111,1551,607,15
-3,0,0.0,-3.0,-0.0,0.1645658016204834,1168.494758225299,3,-1058,496,481,1111,1551,607,15
-3,0,0.0,-3.0,-0.0,0.17354226112365723,1165.7791386021624,3,-1055,496,481,1111,1551,607,15
-4,0,0.0,-4.0,-0.0,0.18152093887329102,1162.1604880566194,3,-1051,496,481,1111,1551,607,15
-5,0,0.0,-5.0,-0.0,0.1894996166229248,1157.6407041910716,3,-1046,496,481,1111,1551,607,15
-6,0,0.0,-6.0,-0.0,0.1998438835144043,1152.2222007928854,3,-1040,496,481,1111,1551,607,15
-7,0,0.0,-7.0,-0.0,0.2078235149383545,1145.9079369652695,3,-1033,496,481,1111,1551,607,15
-8,0,0.0,-8.0,-0.0,0.21580195426940918,1138.7014534108578,3,-1025,496,481,1111,1551,607,15
-9,0,0.0,-9.0,-0.0,0.22378087043762207,1130.606916660251,3,-1016,496,481,1111,1551,607,15
-10,0,0.0,-10.0,-0.0,0.23375439643859863,1121.6291722311792,3,-1006,496,481,1111,1551,607,15
-11,0,0.0,-11.0,-0.0,0.24173474311828613,1111.7738079303722,3,-995,496,481,1111,1551,607,15
-11,0,0.0,-11.0,-0.0,0.25070977210998535,1101.9401072653632,3,-984,496,481,1111,1551,607,15
-11,0,0.0,-11.0,-0.0,0.25868892669677734,1092.1286554248084,3,-973,496,481,1111,1551,607,15
-11,0,0.0,-11.0,-0.0,0.26666760444641113,1082.3400574680768,3,-962,496,481,1111,1551,607,15
-11,0,0.0,-11.0,-0.0,0.27564406394958496,1072.5749391068207,3,-951,496,481,1111,1551,607,15
-11,0,0.0,-11.0,-0.0,0.28362274169921875,1062.8339475195548,3,-940,496,481,1111,1551,607,15
-11,0,0.0,-11.0,-0.0,0.29161691665649414,1053.117752200579,3,-929,496,481,1111,1551,607,15
-11,0,0.0,-11.0,-0.0,0.30057859420776367,1043.4270458446053,3,-918,496,481,1111,1551,607,15
-10,0,0.0,-10.0,-0.0,0.3095543384552002,1034.6400340214948,3,-908,496,481,1111,1551,607,15
-9,0,0.0,-9.0,-0.0,0.3175337314605713,1026.75070002411,3,-899,496,481,1111,1551,607,15
-8,0,0.0,-8.0,-0.0,0.325512170791626,1019.7534015633388,3,-891,496,481,1111,1551,607,15
-7,0,0.0,-7.0,-0.0,0.3344886302947998,1013.6429351601086,3,-884,496,481,1111,1551,607,15
-6,0,0.0,-6.0,-0.0,0.34147047996520996,1008.4145972763386,3,-878,496,481,1111,1551,607,15
-5,0,0.0,-5.0,-0.0,0.34944915771484375,1004.0642409726581,3,-873,496,481,1111,1551,607,15
-4,0,0.0,-4.0,-0.0,0.3584260940551758,1000.5883269357083,3,-869,496,481,1111,1551,607,15
-3,0,0.0,-3.0,-0.0,0.3674018383026123,997.9839678070986,3,-866,496,481,1111,1551,607,15
-2,0,0.0,-2.0,-0.0,0.37439942359924316,996.2489648677182,3,-864,496,481,1111,1551,607,15
-1,0,0.01,-1.0,-0.0,0.38236260414123535,995.3818362819366,3,-863,496,481,1111,1551,607,15
0,0,0.02,-0.0,-0.0,0.3923361301422119,995.3818362819366,3,-863,496,481,1111,1551,607,15
0,1,0.01,-0.0,1.0,0.4003150463104248,994.8839128260141,3,-863,495,481,1111,1551,607,15
1,1,0.0,1.0,1.0,0.40929102897644043,995.254741259744,3,-864,494,481,1111,1551,607,15
1,1,0.0,1.0,1.0,0.4162724018096924,995.6274403611021,3,-865,493,481,1111,1551,607,15
1,1,0.0,1.0,1.0,0.4252488613128662,996.0020080301043,3,-866,492,481,1111,1551,607,15
1,1,0.0,1.0,1.0,0.43422532081604004,996.3784421594036,3,-867,491,481,1111,1551,607,15
1,1,0.0,1.0,1.0,0.44220423698425293,996.7567406343435,3,-868,490,481,1111,1551,607,15
1,1,0.0,1.0,1.0,0.45118045806884766,997.1369013330116,3,-869,489,481,1111,1551,607,15
1,1,0.0,1.0,1.0,0.45915937423706055,997.5189221262923,3,-870,488,481,1111,1551,607,15
1,1,0.0,1.0,1.0,0.46713805198669434,997.9028008779212,3,-871,487,481,1111,1551,607,15
1,1,0.01,1.0,1.0,0.4741196632385254,998.2885354445377,3,-872,486,481,1111,1551,607,15
1,1,0.01,1.0,1.0,0.4830961227416992,998.6761236757391,3,-873,485,481,1111,1551,607,15
1,1,0.01,1.0,1.0,0.4910757541656494,999.0655634141335,3,-874,484,481,1111,1551,607,15
0,1,0.0,-0.0,1.0,0.5010488033294678,998.5814939202509,3,-874,483,481,1111,1551,607,15
-1,1,0.0,-1.0,1.0,0.5100252628326416,997.2226431444485,3,-873,482,481,1111,1551,607,15
-2,1,0.0,-2.0,1.0,0.5170063972473145,994.9884421439276,3,-871,481,481,1111,1551,607,15
-3,1,0.0,-3.0,1.0,0.5249912738800049,991.8790248815628,3,-868,480,481,1111,1551,607,15
-4,1,0.0,-4.0,1.0,0.5329647064208984,987.8952373607234,3,-864,479,481,1111,1551,607,15
-5,1,0.0,-5.0,1.0,0.5409438610076904,983.0386564118422,3,-859,478,481,1111,1551,607,15
-6,1,0.0,-6.0,1.0,0.5489225387573242,977.3116186764588,3,-853,477,481,1111,1551,607,15
-7,1,0.0,-7.0,1.0,0.5578992366790771,970.7172605862121,3,-846,476,481,1111,1551,607,15
-8,1,0.0,-8.0,1.0,0.5658779144287109,963.2595704170294,3,-838,475,481,1111,1551,607,15
-9,1,0.0,-9.0,1.0,0.5748541355133057,954.943453823314,3,-829,474,481,1111,1551,607,15
-10,1,0.0,-10.0,1.0,0.5838301181793213,945.7748146361268,3,-819,473,481,1111,1551,607,15
-11,1,0.0,-11.0,1.0,0.5918095111846924,935.7606531587016,3,-808,472,481,1111,1551,607,15
-11,1,0.0,-11.0,1.0,0.6000015735626221,925.7699498255492,3,-797,471,481,1111,1551,607,15
-11,1,0.0,-11.0,1.0,0.6099750995635986,915.8034723672978,3,-786,470,481,1111,1551,607,15
-11,1,0.0,-11.0,1.0,0.6179540157318115,905.8620203982503,3,-775,469,481,1111,1551,607,15
-11,1,0.0,-11.0,1.0,0.6269307136535645,895.9464269698273,3,-764,468,481,1111,1551,607,15
-11,1,0.0,-11.0,1.0,0.6359140872955322,886.0575602070105,3,-753,467,481,1111,1551,607,15
-11,1,0.0,-11.0,1.0,0.6459429264068604,876.1963250322384,3,-742,466,481,1111,1551,607,15
-11,1,0.0,-11.0,1.0,0.6538612842559814,866.363664981398,3,-731,465,481,1111,1551,607,15
-10,1,0.0,-10.0,1.0,0.6628365516662598,857.4013062737891,3,-721,464,481,1111,1551,607,15
-9,1,0.0,-9.0,1.0,0.6718120574951172,849.3014776862218,3,-712,463,481,1111,1551,607,15
-8,1,0.0,-8.0,1.0,0.6807882785797119,842.057005196204,3,-704,462,481,1111,1551,607,15
-7,1,0.0,-7.0,1.0,0.6887671947479248,835.6614146889875,3,-697,461,481,1111,1551,607,15
-6,1,0.0,-6.0,1.0,0.6977431774139404,830.1090289835427,3,-691,460,481,1111,1551,607,15
-5,1,0.0,-5.0,1.0,0.7057223320007324,825.3950569272874,3,-686,459,481,1111,1551,607,15
-4,1,0.0,-4.0,1.0,0.7137014865875244,821.5156724007156,3,-682,458,481,1111,1551,607,15
-3,1,0.0,-3.0,1.0,0.7216804027557373,818.4680812346929,3,-679,457,481,1111,1551,607,15
-2,1,0.0,-2.0,1.0,0.730656623840332,816.2505742723861,3,-677,456,481,1111,1551,607,15
-1,1,0.0,-1.0,1.0,0.7386353015899658,814.8625650991705,3,-676,455,481,1111,1551,607,15
0,1,0.0,-0.0,1.0,0.7476119995117188,814.3046113095517,3,-676,454,481,1111,1551,607,15
0,1,0.0,-0.0,1.0,0.7555909156799316,813.7475038364173,3,-676,453,481,1111,1551,607,15
1,1,0.0,1.0,1.0,0.7635698318481445,814.0227269554579,3,-677,452,481,1111,1551,607,15
1,1,0.0,1.0,1.0,0.7725458145141602,814.3003131523407,3,-678,451,481,1111,1551,607,15
1,1,0.0,1.0,1.0,0.7805254459381104,814.5802600112527,3,-679,450,481,1111,1551,607,15
1,1,0.0,1.0,1.0,0.7895011901855469,814.8625650991705,3,-680,449,481,1111,1551,607,15
1,1,0.0,1.0,1.0,0.7984774112701416,815.14722596596,3,-681,448,481,1111,1551,607,15
1,1,0.0,1.0,1.0,0.8074541091918945,815.4342401444767,3,-682,447,481,1111,1551,607,15
1,1,0.0,1.0,1.0,0.8154332637786865,815.7236051506662,3,-683,446,481,1111,1551,607,15
1,1,0.0,1.0,1.0,0.825406551361084,816.0153184836666,3,-684,445,481,1111,1551,607,15
1,1,0.0,1.0,1.0,0.8343825340270996,816.3093776259096,3,-685,444,481,1111,1551,607,15
1,1,0.01,1.0,1.0,0.8423616886138916,816.6057800432226,3,-686,443,481,1111,1551,607,15
1,1,0.01,1.0,1.0,0.8503410816192627,816.9045231849313,3,-687,442,481,1111,1551,607,15
1,1,0.01,1.0,1.0,0.8583190441131592,817.2056044839634,3,-688,441,481,1111,1551,607,15
0,1,0.01,-0.0,1.0,0.867295503616333,816.6663945577778,3,-688,440,481,1111,1551,607,15
0,1,0.01,-0.0,1.0,0.8762722015380859,816.1280536778527,3,-688,439,481,1111,1551,607,15
-1,1,0.01,-1.0,1.0,0.8842620849609375,814.7472000565574,3,-687,438,481,1111,1551,607,15
-2,1,0.0,-2.0,1.0,0.8962194919586182,812.5232304371365,3,-685,437,481,1111,1551,607,15
-2,1,0.0,-2.0,1.0,0.903200626373291,810.2993274093222,3,-683,436,481,1111,1551,607,15
-3,1,0.0,-3.0,1.0,0.9131748676300049,807.2329279706075,3,-680,435,481,1111,1551,607,15
-4,1,0.0,-4.0,1.0,0.9211533069610596,803.3255877911521,3,-676,434,481,1111,1551,607,15
-5,1,0.0,-5.0,1.0,0.9301300048828125,798.5799897317738,3,-671,433,481,1111,1551,607,15
-6,1,0.0,-6.0,1.0,0.9381086826324463,793.0,3,-665,432,481,1111,1551,607,15
-7,1,0.0,-7.0,1.0,0.9470853805541992,786.5907449239407,3,-658,431,481,1111,1551,607,15
-7,1,0.0,-7.0,1.0,0.9560620784759521,780.1929248589736,3,-651,430,481,1111,1551,607,15
-7,1,0.0,-7.0,1.0,0.9650375843048096,773.8068234385117,3,-644,429,481,1111,1551,607,15
-7,1,0.0,-7.0,1.0,0.9730172157287598,767.4327332085855,3,-637,428,481,1111,1551,607,15
-7,1,0.0,-7.0,1.0,0.9819931983947754,761.0709559561448,3,-630,427,481,1111,1551,607,15
-7,1,0.0,-7.0,1.0,0.9909772872924805,754.721803050634,3,-623,426,481,1111,1551,607,15
-7,1,0.0,-7.0,1.0,0.9999465942382812,748.3855957993846,3,-616,425,481,1111,1551,607,15
-7,1,0.0,-7.0,1.0,1.007925033569336,742.0626658173823,3,-609,424,481,1111,1551,607,15
-7,1,0.0,-7.0,1.0,1.0178983211517334,735.7533554119885,3,-602,423,481,1111,1551,607,15
-7,1,0.0,-7.0,1.0,1.0258777141571045,729.4580179832147,3,-595,422,481,1111,1551,607,15
-7,1,0.0,-7.0,1.0,1.0338568687438965,723.1770184401603,3,-588,421,481,1111,1551,607,15
-7,1,0.0,-7.0,1.0,1.0418353080749512,716.910733634251,3,-581,420,481,1111,1551,607,15
-6,1,0.0,-6.0,1.0,1.050813913345337,711.4674975007642,3,-575,419,481,1111,1551,607,15
-6,1,0.0,-6.0,1.0,1.0587904453277588,706.0347016967368,3,-569,418,481,1111,1551,607,15
-5,1,0.0,-5.0,1.0,1.066770076751709,701.4164241019738,3,-564,417,481,1111,1551,607,15
-5,1,0.0,-5.0,1.0,1.0767431259155273,696.8048507293846,3,-559,416,481,1111,1551,607,15
-4,1,0.0,-4.0,1.0,1.0857188701629639,693.0007215003459,3,-555,415,481,1111,1551,607,15
-3,1,0.0,-3.0,1.0,1.093698263168335,690.0,3,-552,414,481,1111,1551,607,15
-2,1,0.0,-2.0,1.0,1.1026816368103027,687.8001163128719,3,-550,413,481,1111,1551,607,15
-1,1,0.0,-1.0,1.0,1.1096653938293457,686.4000291375285,3,-549,412,481,1111,1551,607,15
0,1,0.01,-0.0,1.0,1.1176347732543945,685.8002624671414,3,-549,411,481,1111,1551,607,15
0,1,0.0,-0.0,1.0,1.1266112327575684,685.2014302378535,3,-549,410,481,1111,1551,607,15
1,1,0.0,1.0,1.0,1.1345925331115723,685.4057192641451,3,-550,409,481,1111,1551,607,15
1,1,0.0,1.0,1.0,1.1435680389404297,685.6128645234131,3,-551,408,481,1111,1551,607,15
1,1,0.0,1.0,1.0,1.1525437831878662,685.8228634275763,3,-552,407,481,1111,1551,607,15
1,1,0.0,1.0,1.0,1.1625299453735352,686.0357133560905,3,-553,406,481,1111,1551,607,15
1,1,0.0,1.0,1.0,1.1704955101013184,686.2514116561073,3,-554,405,481,1111,1551,607,15
1,1,0.0,1.0,1.0,1.1794722080230713,686.4699556426341,3,-555,404,481,1111,1551,607,15
1,1,0.0,1.0,1.0,1.1864535808563232,686.6913425986962,3,-556,403,481,1111,1551,607,15
1,1,0.0,1.0,1.0,1.196427583694458,686.9155697755001,3,-557,402,481,1111,1551,607,15
1,1,0.0,1.0,1.0,1.2044076919555664,687.1426343925983,3,-558,401,481,1111,1551,607,15
1,1,0.01,1.0,1.0,1.2143795490264893,687.3725336380556,3,-559,400,481,1111,1551,607,15
1,1,0.01,1.0,1.0,1.2223594188690186,687.6052646686178,3,-560,399,481,1111,1551,607,15
1,1,0.01,1.0,1.0,1.2313380241394043,687.8408246098802,3,-561,398,481,1111,1551,607,15
1,1,0.01,1.0,1.0,1.239314079284668,688.0792105564591,3,-562,397,481,1111,1551,607,15
0,1,0.01,-0.0,1.0,1.2492883205413818,687.5027272673178,3,-562,396,481,1111,1551,607,15
0,1,0.01,-0.0,1.0,1.2572662830352783,686.9272159406701,3,-562,395,481,1111,1551,607,15
-1,1,0.01,-1.0,1.0,1.2652466297149658,685.5340983496006,3,-561,394,481,1111,1551,607,15
-2,1,0.0,-2.0,1.0,1.2732245922088623,683.3227641459049,3,-559,393,481,1111,1551,607,15
-2,1,0.0,-2.0,1.0,1.2832112312316895,681.1115914444563,3,-557,392,481,1111,1551,607,15
-3,1,0.0,-3.0,1.0,1.2911770343780518,678.083328212691,3,-554,391,481,1111,1551,607,15
-3,1,0.0,-3.0,1.0,1.2991559505462646,675.0562939488825,3,-551,390,481,1111,1551,607,15
-3,1,0.0,-3.0,1.0,1.3091318607330322,672.0305052599919,3,-548,389,481,1111,1551,607,15
-3,1,0.0,-3.0,1.0,1.3171091079711914,669.0059790465255,3,-545,388,481,1111,1551,607,15
-3,1,0.0,-3.0,1.0,1.3270823955535889,665.9827325088842,3,-542,387,481,1111,1551,607,15
-3,1,0.0,-3.0,1.0,1.3340635299682617,662.9607831538756,3,-539,386,481,1111,1551,607,15
-3,1,0.0,-3.0,1.0,1.3430402278900146,659.9401488013895,3,-536,385,481,1111,1551,607,15
-3,1,0.0,-3.0,1.0,1.3530151844024658,656.9208475912452,3,-533,384,481,1111,1551,607,15
-3,1,0.0,-3.0,1.0,1.3629882335662842,653.9028979902139,3,-530,383,481,1111,1551,607,15
-3,1,0.0,-3.0,1.0,1.3699703216552734,650.8863187992201,3,-527,382,481,1111,1551,607,15
-3,1,0.0,-3.0,1.0,1.3779492378234863,647.8711291607306,3,-524,381,481,1111,1551,607,15
-3,1,0.0,-3.0,1.0,1.3869256973266602,644.8573485663321,3,-521,380,481,1111,1551,607,15
-3,1,0.0,-3.0,1.0,1.3968992233276367,641.8449968645078,3,-518,379,481,1111,1551,607,15
-3,1,0.0,-3.0,1.0,1.4058740139007568,638.8340942686137,3,-515,378,481,1111,1551,607,15
-3,1,0.0,-3.0,1.0,1.4158475399017334,635.8246613650654,3,-512,377,481,1111,1551,607,15
-3,1,0.0,-3.0,1.0,1.4248239994049072,632.8167191217375,3,-509,376,481,1111,1551,607,15
-3,1,0.0,-3.0,1.0,1.4328038692474365,629.8102888965851,3,-506,375,481,1111,1551,607,15
-3,1,0.0,-3.0,1.0,1.440781593322754,626.8053924464913,3,-503,374,481,1111,1551,607,15
-3,1,0.0,-3.0,1.0,1.449758529663086,623.8020519363495,3,-500,373,481,1111,1551,607,15
-3,1,0.0,-3.0,1.0,1.4577369689941406,620.8002899483859,3,-497,372,481,1111,1551,607,15
-3,1,0.0,-3.0,1.0,1.467721700668335,617.8001294917314,3,-494,371,481,1111,1551,607,15
-3,1,0.0,-3.0,1.0,1.4766871929168701,614.8015940122472,3,-491,370,481,1111,1551,607,15
-3,1,0.0,-3.0,1.0,1.4846675395965576,611.8047074026156,3,-488,369,481,1111,1551,607,15
-3,1,0.0,-3.0,1.0,1.4926509857177734,608.8094940127002,3,-485,368,481,1111,1551,607,15
-3,1,0.0,-3.0,1.0,1.5006256103515625,605.8159786601868,3,-482,367,481,1111,1551,607,15
-3,1,0.0,-3.0,1.0,1.5096006393432617,602.8241866415116,3,-479,366,481,1111,1551,607,15
-3,1,0.0,-3.0,1.0,1.5195748805999756,599.8341437430851,3,-476,365,481,1111,1551,607,15
-3,1,0.0,-3.0,1.0,1.5265576839447021,596.8458762528229,3,-473,364,481,1111,1551,607,15
-3,1,0.0,-3.0,1.0,1.5355327129364014,593.8594109719909,3,-470,363,481,1111,1551,607,15
-3,1,0.0,-3.0,1.0,1.543510913848877,590.8747752273742,3,-467,362,481,1111,1551,607,15
-3,1,0.0,-3.0,1.0,1.5514910221099854,587.8919968837814,3,-464,361,481,1111,1551,607,15
-3,1,0.0,-3.0,1.0,1.5594687461853027,584.9111043568929,3,-461,360,481,1111,1551,607,15
-3,1,0.0,-3.0,1.0,1.5684449672698975,581.9321266264649,3,-458,359,481,1111,1551,607,15
-3,1,0.0,-3.0,1.0,1.5754444599151611,578.9550932498996,3,-455,358,481,1111,1551,607,15
-3,1,0.0,-3.0,1.0,1.5834057331085205,575.9800343761926,3,-452,357,481,1111,1551,607,15
-3,1,0.0,-3.0,1.0,1.593379020690918,573.0069807602696,3,-449,356,481,1111,1551,607,15
-3,1,0.0,-3.0,1.0,1.60235595703125,570.0359637777252,3,-446,355,481,1111,1551,607,15
-3,1,0.0,-3.0,1.0,1.6123290061950684,567.0670154399743,3,-443,354,481,1111,1551,607,15
-3,1,0.0,-3.0,1.0,1.619311809539795,564.1001684098312,3,-440,353,481,1111,1551,607,15
-3,1,0.0,-3.0,1.0,1.6282875537872314,561.1354560175288,3,-437,352,481,1111,1551,607,15
-3,1,0.0,-3.0,1.0,1.6362662315368652,558.1729122771903,3,-434,351,481,1111,1551,607,15
-3,1,0.0,-3.0,1.0,1.6472368240356445,555.2125719037709,3,-431,350,481,1111,1551,607,15
-3,1,0.0,-3.0,1.0,1.6542184352874756,552.2544703304809,3,-428,349,481,1111,1551,607,15
-3,1,0.0,-3.0,1.0,1.6641929149627686,549.2986437267072,3,-425,348,481,1111,1551,607,15
-3,1,0.0,-3.0,1.0,1.6731700897216797,546.3451290164487,3,-422,347,481,1111,1551,607,15
-3,1,0.0,-3.0,1.0,1.682145357131958,543.3939638972814,3,-419,346,481,1111,1551,607,15
-3,1,0.0,-3.0,1.0,1.6911225318908691,540.4451868598702,3,-416,345,481,1111,1551,607,15
-3,1,0.0,-3.0,1.0,1.7000982761383057,537.4988372080446,3,-413,344,481,1111,1551,607,15
-3,1,0.0,-3.0,1.0,1.7070796489715576,534.5549550794567,3,-410,343,481,1111,1551,607,15
-3,1,0.0,-3.0,1.0,1.7160553932189941,531.6135814668395,3,-407,342,481,1111,1551,607,15
-3,1,0.0,-3.0,1.0,1.7230370044708252,528.6747582398842,3,-404,341,481,1111,1551,607,15
-3,1,0.0,-3.0,1.0,1.7330107688903809,525.7385281677575,3,-401,340,481,1111,1551,607,15
-3,1,0.0,-3.0,1.0,1.7399921417236328,522.8049349422785,3,-398,339,481,1111,1551,607,15
-3,1,0.0,-3.0,1.0,1.7489683628082275,519.8740232017753,3,-395,338,481,1111,1551,607,15
-3,1,0.0,-3.0,1.0,1.7569572925567627,516.945838555646,3,-392,337,481,1111,1551,607,15
-3,1,0.0,-3.0,1.0,1.7659239768981934,514.0204276096428,3,-389,336,481,1111,1551,607,15
-3,1,0.0,-3.0,1.0,1.7739033699035645,511.0978379919054,3,-386,335,481,1111,1551,607,15
-3,1,0.0,-3.0,1.0,1.781881332397461,508.17811837976654,3,-383,334,481,1111,1551,607,15
-3,1,0.0,-3.0,1.0,1.789860486984253,505.26131852735375,3,-380,333,481,1111,1551,607,15
-3,1,0.0,-3.0,1.0,1.7988371849060059,502.3474892940145,3,-377,332,481,1111,1551,607,15
-3,1,0.0,-3.0,1.0,1.8068156242370605,499.43668267358976,3,-374,331,481,1111,1551,607,15
-3,1,0.0,-3.0,1.0,1.8167903423309326,496.5289518245638,3,-371,330,481,1111,1551,607,15
-3,1,0.0,-3.0,1.0,1.824767827987671,493.6243511011182,3,-368,329,481,1111,1551,607,15
-3,1,0.0,-3.0,1.0,1.8337445259094238,490.7229360851192,3,-365,328,481,1111,1551,607,15
-3,1,0.0,-3.0,1.0,1.8407270908355713,487.82476361906845,3,-362,327,481,1111,1551,607,15
-3,1,0.0,-3.0,1.0,1.849703311920166,484.92989184004733,3,-359,326,481,1111,1551,607,15
-3,1,0.0,-3.0,1.0,1.8576812744140625,482.0383802146879,3,-356,325,481,1111,1551,607,15
-3,1,0.0,-3.0,1.0,1.8686530590057373,479.15028957520207,3,-353,324,481,1111,1551,607,15
-3,1,0.0,-3.0,1.0,1.876633882522583,476.2656821565039,3,-350,323,481,1111,1551,607,15
-3,1,0.0,-3.0,1.0,1.8866047859191895,473.3846216344591,3,-347,322,481,1111,1551,607,15
-3,1,0.0,-3.0,1.0,1.898573875427246,470.5071731652983,3,-344,321,481,1111,1551,607,15
-3,1,0.0,-3.0,1.0,1.9085488319396973,467.63340342623087,3,-341,320,481,1111,1551,607,15
-3,1,0.0,-3.0,1.0,1.9175240993499756,464.7633806572975,3,-338,319,481,1111,1551,607,15
-3,1,0.0,-3.0,1.0,1.9265096187591553,461.8971747045006,3,-335,318,481,1111,1551,607,15
-3,1,0.0,-3.0,1.0,1.934478759765625,459.0348570642539,3,-332,317,481,1111,1551,607,15
-3,1,0.0,-3.0,1.0,1.9424688816070557,456.1765009291908,3,-329,316,481,1111,1551,607,15
-3,1,0.0,-3.0,1.0,1.9504363536834717,453.322181235377,3,-326,315,481,1111,1551,607,15
-3,1,0.0,-3.0,1.0,1.9594130516052246,450.4719747109691,3,-323,314,481,1111,1551,607,15
-3,1,0.0,-3.0,1.0,1.9683899879455566,447.6259599263653,3,-320,313,481,1111,1551,607,15
-3,1,0.0,-3.0,1.0,1.978363275527954,444.7842173458946,3,-317,312,481,1111,1551,607,15
-3,1,0.0,-3.0,1.0,1.9853451251983643,441.94682938109196,3,-314,311,481,1111,1551,607,15
-3,1,0.0,-3.0,1.0,1.9933271408081055,439.11388044560834,3,-311,310,481,1111,1551,607,15
-3,1,0.0,-3.0,1.0,2.0013039112091064,436.28545701180553,3,-308,309,481,1111,1551,607,15
-3,1,0.0,-3.0,1.0,2.0112764835357666,433.4616476690873,3,-305,308,481,1111,1551,607,15
-3,1,0.0,-3.0,1.0,2.0192558765411377,430.64254318401936,3,-302,307,481,1111,1551,607,15
-3,1,0.0,-3.0,1.0,2.028231382369995,427.8282365622914,3,-299,306,481,1111,1551,607,15
-3,1,0.0,-3.0,1.0,2.0362110137939453,425.01882311257697,3,-296,305,481,1111,1551,607,15
-3,1,0.0,-3.0,1.0,2.04618501663208,422.21440051234634,3,-293,304,481,1111,1551,607,15
-3,1,0.0,-3.0,1.0,2.055161237716675,419.4150688756903,3,-290,303,481,1111,1551,607,15
-3,1,0.0,-3.0,1.0,2.0651347637176514,416.62093082321246,3,-287,302,481,1111,1551,607,15
-3,1,0.0,-3.0,1.0,2.073113203048706,413.83209155405046,3,-284,301,481,1111,1551,607,15
-3,1,0.0,-3.0,1.0,2.0820889472961426,411.04865892008456,3,-281,300,481,1111,1551,607,15
-3,1,0.0,-3.0,1.0,2.0910661220550537,408.27074350239695,3,-278,299,481,1111,1551,607,15
-3,1,0.0,-3.0,1.0,2.1000418663024902,405.49845869004236,3,-275,298,481,1111,1551,607,15
-3,1,0.0,-3.0,1.0,2.108020544052124,402.7319207611932,3,-272,297,481,1111,1551,607,15
-3,1,0.0,-3.0,1.0,2.115999460220337,399.9712489667226,3,-269,296,481,1111,1551,607,15
-3,1,0.0,-3.0,1.0,2.1249759197235107,397.2165656162895,3,-266,295,481,1111,1551,607,15
-3,1,0.0,-3.0,1.0,2.1339523792266846,394.46799616698945,3,-263,294,481,1111,1551,607,15
-3,1,0.0,-3.0,1.0,2.1409335136413574,391.72566931463655,3,-260,293,481,1111,1551,607,15
-3,1,0.0,-3.0,1.0,2.1499102115631104,388.98971708774,3,-257,292,481,1111,1551,607,15
-3,1,0.0,-3.0,1.0,2.1568915843963623,386.26027494424017,3,-254,291,481,1111,1551,607,15
-3,1,0.0,-3.0,1.0,2.1668648719787598,383.5374818710682,3,-251,290,481,1111,1551,607,15
-3,1,0.0,-3.0,1.0,2.1738479137420654,380.8214804865923,3,-248,289,481,1111,1551,607,15
-3,1,0.0,-3.0,1.0,2.182823657989502,378.11241714601226,3,-245,288,481,1111,1551,607,15
-3,1,0.0,-3.0,1.0,2.1917998790740967,375.41044204976504,3,-242,287,481,1111,1551,607,15
-3,1,0.0,-3.0,1.0,2.1997783184051514,372.71570935499886,3,-239,286,481,1111,1551,607,15
-3,1,0.0,-3.0,1.0,2.2087550163269043,370.0283772901749,3,-236,285,481,1111,1551,607,15
-3,1,0.0,-3.0,1.0,2.2167489528656006,367.3486082728503,3,-233,284,481,1111,1551,607,15
-3,1,0.0,-3.0,1.0,2.224712610244751,364.67656903069604,3,-230,283,481,1111,1551,607,15
-3,1,0.0,-3.0,1.0,2.2336955070495605,362.01243072579706,3,-227,282,481,1111,1551,607,15
-3,1,0.0,-3.0,1.0,2.2426655292510986,359.3563690822802,3,-224,281,481,1111,1551,607,15
-3,1,0.0,-3.0,1.0,2.2516512870788574,356.70856451731015,3,-221,280,481,1111,1551,607,15
-3,1,0.0,-3.0,1.0,2.2606189250946045,354.0692022754874,3,-218,279,481,1111,1551,607,15
-3,1,0.0,-3.0,1.0,2.269594192504883,351.43847256667846,3,-215,278,481,1111,1551,607,15
-3,1,0.0,-3.0,1.0,2.277573585510254,348.8165707072988,3,-212,277,481,1111,1551,607,15
-3,1,0.0,-3.0,1.0,2.2865495681762695,346.2036972650639,3,-209,276,481,1111,1551,607,15
-3,1,0.0,-3.0,1.0,2.296523094177246,343.6000582072128,3,-206,275,481,1111,1551,607,15
-3,1,0.0,-3.0,1.0,2.3035049438476562,341.0058650522011,3,-203,274,481,1111,1551,607,15
-3,1,0.0,-3.0,1.0,2.311483383178711,338.4213350248474,3,-200,273,481,1111,1551,607,15
-3,1,0.0,-3.0,1.0,2.320460319519043,335.8466912149054,3,-197,272,481,1111,1551,607,15
-3,1,0.0,-3.0,1.0,2.327441692352295,333.28216273902206,3,-194,271,481,1111,1551,607,15
-3,1,0.0,-3.0,1.0,2.3354203701019287,330.72798490602514,3,-191,270,481,1111,1551,607,15
-3,1,0.0,-3.0,1.0,2.3443965911865234,328.18439938546743,3,-188,269,481,1111,1551,607,15
-3,1,0.0,-3.0,1.0,2.3523755073547363,325.6516543793383,3,-185,268,481,1111,1551,607,15
-3,1,0.0,-3.0,1.0,2.3643438816070557,323.130004796831,3,-182,267,481,1111,1551,607,15
-3,1,0.0,-3.0,1.0,2.370328187942505,320.61971243203374,3,-179,266,481,1111,1551,607,15
-3,1,0.0,-3.0,1.0,2.3812992572784424,318.12104614438823,3,-176,265,481,1111,1551,607,15
-3,1,0.0,-3.0,1.0,2.390275716781616,315.6342820417326,3,-173,264,481,1111,1551,607,15
-3,1,0.0,-3.0,1.0,2.398257255554199,313.15970366571753,3,-170,263,481,1111,1551,607,15
-3,1,0.0,-3.0,1.0,2.4062340259552,310.6976021793538,3,-167,262,481,1111,1551,607,15
-3,1,0.0,-3.0,1.0,2.4152095317840576,308.24827655641485,3,-164,261,481,1111,1551,607,15
-3,1,0.0,-3.0,1.0,2.4231884479522705,305.81203377238114,3,-161,260,481,1111,1551,607,15
-3,1,0.0,-3.0,1.0,2.4341604709625244,303.3891889965758,3,-158,259,481,1111,1551,607,15
-3,1,0.0,-3.0,1.0,2.442138671875,300.98006578509484,3,-155,258,481,1111,1551,607,15
-3,1,0.0,-3.0,1.0,2.4511146545410156,298.58499627409276,3,-152,257,481,1111,1551,607,15
-3,1,0.0,-3.0,1.0,2.458096981048584,296.2043213729334,3,-149,256,481,1111,1551,607,15
-3,1,0.0,-3.0,1.0,2.4670791625976562,293.8383909566617,3,-146,255,481,1111,1551,607,15
-3,1,0.0,-3.0,1.0,2.4750518798828125,291.4875640571995,3,-143,254,481,1111,1551,607,15
-3,1,0.0,-3.0,1.0,2.4840288162231445,289.1522090526026,3,-140,253,481,1111,1551,607,15
-3,1,0.0,-3.0,1.0,2.492007255554199,286.8327038536575,3,-137,252,481,1111,1551,607,15
-3,1,0.0,-3.0,1.0,2.5009968280792236,284.52943608702424,3,-134,251,481,1111,1551,607,15
-3,1,0.0,-3.0,1.0,2.507964611053467,282.24280327406046,3,-131,250,481,1111,1551,607,15
-3,1,0.0,-3.0,1.0,2.516941785812378,279.9732130043873,3,-128,249,481,1111,1551,607,15
-3,1,0.0,-3.0,1.0,2.5259175300598145,277.72108310317384,3,-125,248,481,1111,1551,607,15
-3,1,0.0,-3.0,1.0,2.533897638320923,275.48684179103725,3,-122,247,481,1111,1551,607,15
-3,1,0.0,-3.0,1.0,2.5418756008148193,273.27092783536267,3,-119,246,481,1111,1551,607,15
-3,1,0.0,-3.0,1.0,2.5498547554016113,271.07379069175977,3,-116,245,481,1111,1551,607,15
-3,1,0.0,-3.0,1.0,2.5588314533233643,268.895890634275,3,-113,244,481,1111,1551,607,15
-3,1,0.0,-3.0,1.0,2.56680965423584,266.7376988728815,3,-110,243,481,1111,1551,607,15
-3,1,0.0,-3.0,1.0,2.5767834186553955,264.5996976566678,3,-107,242,481,1111,1551,607,15
-3,1,0.0,-3.0,1.0,2.5847787857055664,262.4823803610444,3,-104,241,481,1111,1551,607,15
-3,1,0.0,-3.0,1.0,2.591745138168335,260.3862515571819,3,-101,240,481,1111,1551,607,15
-3,1,0.0,-3.0,1.0,2.6007347106933594,258.3118270617898,3,-98,239,481,1111,1551,607,15
-3,1,0.0,-3.0,1.0,2.608698844909668,256.25963396524236,3,-95,238,481,1111,1551,607,15
-3,1,0.0,-3.0,1.0,2.617675542831421,254.23021063595098,3,-92,237,481,1111,1551,607,15
-3,1,0.0,-3.0,1.0,2.624656915664673,252.22410669878485,3,-89,236,481,1111,1551,607,15
-3,1,0.0,-3.0,1.0,2.633634328842163,250.2418829852429,3,-86,235,481,1111,1551,607,15
-3,1,0.0,-3.0,1.0,2.6416122913360596,248.28411145298847,3,-83,234,481,1111,1551,607,15
-3,1,0.0,-3.0,1.0,2.6505887508392334,246.35137507227356,3,-80,233,481,1111,1551,607,15
-3,1,0.0,-3.0,1.0,2.6585681438446045,244.44426767670376,3,-77,232,481,1111,1551,607,15
-3,1,0.0,-3.0,1.0,2.668541193008423,242.5633937757303,3,-74,231,481,1111,1551,607,15
-3,1,0.0,-3.0,1.0,2.677518129348755,240.7093683262037,3,-71,230,481,1111,1551,607,15
-3,1,0.0,-3.0,1.0,2.686493396759033,238.88281646028875,3,-68,229,481,1111,1551,607,15
-3,1,0.0,-3.0,1.0,2.6944730281829834,237.08437316702253,3,-65,228,481,1111,1551,607,15
-3,1,0.0,-3.0,1.0,2.70344877243042,235.3146829248018,3,-62,227,481,1111,1551,607,15
-3,1,0.0,-3.0,1.0,2.7144203186035156,233.57439928211312,3,-59,226,481,1111,1551,607,15
-3,1,0.0,-3.0,1.0,2.7233963012695312,231.8641843838759,3,-56,225,481,1111,1551,607,15
-3,1,0.0,-3.0,1.0,2.732372760772705,230.18470844085192,3,-53,224,481,1111,1551,607,15
-3,1,0.0,-3.0,1.0,2.740351915359497,228.53664913969487,3,-50,223,481,1111,1551,607,15
-3,1,0.0,-3.0,1.0,2.7493276596069336,226.92069099136816,3,-47,222,481,1111,1551,607,15
-3,1,0.0,-3.0,1.0,2.7573070526123047,225.33752461585266,3,-44,221,481,1111,1551,607,15
-3,1,0.0,-3.0,1.0,2.765286922454834,223.78784596130328,3,-41,220,481,1111,1551,607,15
-3,1,0.0,-3.0,1.0,2.7732648849487305,222.27235545609355,3,-38,219,481,1111,1551,607,15
-3,1,0.0,-3.0,1.0,2.7832391262054443,220.79175709251467,3,-35,218,481,1111,1551,607,15
-3,1,0.0,-3.0,1.0,2.7902472019195557,219.3467574412715,3,-32,217,481,1111,1551,607,15
-3,1,0.0,-3.0,1.0,2.799196243286133,217.9380645963435,3,-29,216,481,1111,1551,607,15
-3,1,0.0,-3.0,1.0,2.807176351547241,216.566387050253,3,-26,215,481,1111,1551,607,15
-3,1,0.0,-3.0,1.0,2.8161516189575195,215.23243250030885,3,-23,214,481,1111,1551,607,15
-3,1,0.0,-3.0,1.0,2.8241305351257324,213.9369065869655,3,-20,213,481,1111,1551,607,15
-3,1,0.0,-3.0,1.0,2.833106517791748,212.6805115660577,3,-17,212,481,1111,1551,607,15
-3,1,0.0,-3.0,1.0,2.8410871028900146,211.463944917331,3,-14,211,481,1111,1551,607,15
-3,1,0.0,-3.0,1.0,2.8500630855560303,210.28789789238942,3,-11,210,481,1111,1551,607,15
-3,1,0.0,-3.0,1.0,2.858042001724243,209.15305400591214,3,-8,209,481,1111,1551,607,15
-3,1,0.0,-3.0,1.0,2.8670170307159424,208.0600874747485,3,-5,208,481,1111,1551,607,15
-3,1,0.0,-3.0,1.0,2.8740007877349854,207.00966161027364,3,-2,207,481,1111,1551,607,15
-3,1,0.0,-3.0,1.0,2.8839731216430664,206.0024271701671,3,1,206,481,1111,1551,607,15
-3,1,0.0,-3.0,1.0,2.8919525146484375,205.03902067655318,3,4,205,481,1111,1551,607,15
-3,1,0.0,-3.0,1.0,2.900927782058716,204.12006270820123,3,7,204,481,1111,1551,607,15
-3,1,0.0,-3.0,1.0,2.907909870147705,203.24615617521528,3,10,203,481,1111,1551,607,15
-3,1,0.0,-3.0,1.0,2.91788387298584,202.41788458533006,3,13,202,481,1111,1551,607,15
-3,1,0.0,-3.0,1.0,2.9248645305633545,201.63581031156147,3,16,201,481,1111,1551,607,15
-3,1,0.0,-3.0,1.0,2.9348390102386475,200.90047287151916,3,19,200,481,1111,1551,607,15
-3,1,0.0,-3.0,1.0,2.943814754486084,200.21238722916223,3,22,199,481,1111,1551,607,15
-3,1,0.0,-3.0,1.0,2.951794147491455,199.5720421301541,3,25,198,481,1111,1551,607,15
-3,1,0.0,-3.0,1.0,2.9607698917388916,198.97989848223364,3,28,197,481,1111,1551,607,15
-3,1,0.0,-3.0,1.0,2.9687492847442627,198.4363877921587,3,31,196,481,1111,1551,607,15
-3,1,0.0,-3.0,1.0,2.9767301082611084,197.9419106707824,3,34,195,481,1111,1551,607,15
-3,1,0.0,-3.0,1.0,2.985705852508545,197.4968354176846,3,37,194,481,1111,1551,607,15
-2,1,0.0,-2.0,1.0,2.9926867485046387,196.9009903479411,3,39,193,481,1111,1551,607,15
-2,1,0.01,-2.0,1.0,3.0016632080078125,196.32880583347927,3,41,192,481,1111,1551,607,15
-1,1,0.01,-1.0,1.0,3.008643388748169,195.5632889885011,3,42,191,481,1111,1551,607,15
-1,1,0.01,-1.0,1.0,3.01762056350708,194.80503073586164,3,43,190,481,1111,1551,607,15
-1,1,0.01,-1.0,1.0,3.024601697921753,194.05411616350733,3,44,189,481,1111,1551,607,15
-1,1,0.01,-1.0,1.0,3.0335774421691895,193.31063085097003,3,45,188,481,1111,1551,607,15
-1,1,0.01,-1.0,1.0,3.0415568351745605,192.57466084612483,3,46,187,481,1111,1551,607,15
-1,1,0.01,-1.0,1.0,3.051539421081543,191.84629264074925,3,47,186,481,1111,1551,607,15
-1,1,0.01,-1.0,1.0,3.058511734008789,191.12561314486345,3,48,185,481,1111,1551,607,15
-1,1,0.01,-1.0,1.0,3.0684869289398193,190.41270965983338,3,49,184,481,1111,1551,607,15
-1,1,0.01,-1.0,1.0,3.0764641761779785,189.70766985021982,3,50,183,481,1111,1551,607,15
-1,1,0.01,-1.0,1.0,3.08444881439209,189.01058171435798,3,51,182,481,1111,1551,607,15
-1,1,0.01,-1.0,1.0,3.0934197902679443,188.32153355365392,3,52,181,481,1111,1551,607,15
-1,1,0.01,-1.0,1.0,3.1023964881896973,187.6406139405859,3,53,180,481,1111,1551,607,15
-1,1,0.01,-1.0,1.0,3.111372232437134,186.96791168540125,3,54,179,481,1111,1551,607,15
-1,1,0.01,-1.0,1.0,3.118924379348755,186.30351580150065,3,55,178,481,1111,1551,607,15
-1,1,0.01,-1.0,1.0,3.1269052028656006,185.64751546950473,3,56,177,481,1111,1551,607,15
-1,1,0.01,-1.0,1.0,3.136876344680786,185.0,3,57,176,481,1111,1551,607,15
-1,1,0.01,-1.0,1.0,3.145852565765381,184.36105879496353,3,58,175,481,1111,1551,607,15
-1,1,0.01,-1.0,1.0,3.152834892272949,183.73078130786905,3,59,174,481,1111,1551,607,15
-1,1,0.01,-1.0,1.0,3.161811590194702,183.10925700247927,3,60,173,481,1111,1551,607,15
-1,1,0.01,-1.0,1.0,3.1707890033721924,182.49657531033287,3,61,172,481,1111,1551,607,15
-1,1,0.01,-1.0,1.0,3.1797640323638916,181.89282558693733,3,62,171,481,1111,1551,607,15
-1,1,0.01,-1.0,1.0,3.188746452331543,181.29809706668186,3,63,170,481,1111,1551,607,15
-1,1,0.01,-1.0,1.0,3.195721387863159,180.71247881648904,3,64,169,481,1111,1551,607,15
-1,1,0.01,-1.0,1.0,3.2047007083892822,180.13605968822566,3,65,168,481,1111,1551,607,15
-1,1,0.01,-1.0,1.0,3.212677478790283,179.56892826989863,3,66,167,481,1111,1551,607,15
-1,1,0.01,-1.0,1.0,3.2216525077819824,179.0111728356641,3,67,166,481,1111,1551,607,15
-1,1,0.01,-1.0,1.0,3.2316267490386963,178.4628812946827,3,68,165,481,1111,1551,607,15
-1,1,0.01,-1.0,1.0,3.239609479904175,177.92414113885727,3,69,164,481,1111,1551,607,15
-1,1,0.01,-1.0,1.0,3.249589204788208,177.39503938949363,3,70,163,481,1111,1551,607,15
-1,1,0.01,-1.0,1.0,3.257558822631836,176.87566254292872,3,71,162,481,1111,1551,607,15
-1,1,0.01,-1.0,1.0,3.266533851623535,176.36609651517495,3,72,161,481,1111,1551,607,15
-1,1,0.01,-1.0,1.0,3.2745139598846436,175.86642658563346,3,73,160,481,1111,1551,607,15
-1,1,0.01,-1.0,1.0,3.284487247467041,175.37673733993344,3,74,159,481,1111,1551,607,15
-1,1,0.01,-1.0,1.0,3.2924656867980957,174.89711261195822,3,75,158,481,1111,1551,607,15
-1,1,0.01,-1.0,1.0,3.3014421463012695,174.42763542512407,3,76,157,481,1111,1551,607,15
-1,1,0.01,-1.0,1.0,3.308424234390259,173.9683879329805,3,77,156,481,1111,1551,607,15
-1,1,0.01,-1.0,1.0,3.3183979988098145,173.5194513592064,3,78,155,481,1111,1551,607,15
-1,1,0.01,-1.0,1.0,3.3263766765594482,173.08090593707902,3,79,154,481,1111,1551,607,15
-1,1,0.01,-1.0,1.0,3.3353524208068848,172.6528308484978,3,80,153,481,1111,1551,607,15
-1,1,0.01,-1.0,1.0,3.3443284034729004,172.23530416264836,3,81,152,481,1111,1551,607,15
-1,1,0.01,-1.0,1.0,3.352308511734009,171.82840277439584,3,82,151,481,1111,1551,607,15
-1,1,0.01,-1.0,1.0,3.3602871894836426,171.4322023425004,3,83,150,481,1111,1551,607,15
-1,1,0.01,-1.0,1.0,3.368265151977539,171.04677722775136,3,84,149,481,1111,1551,607,15
-1,1,0.01,-1.0,1.0,3.375247001647949,170.67220043111882,3,85,148,481,1111,1551,607,15
-1,1,0.01,-1.0,1.0,3.3842408657073975,170.30854353202602,3,86,147,481,1111,1551,607,15
-1,1,0.01,-1.0,1.0,3.392202615737915,169.95587662684687,3,87,146,481,1111,1551,607,15
-1,1,0.01,-1.0,1.0,3.400181293487549,169.61426826773743,3,88,145,481,1111,1551,607,15
-1,1,0.01,-1.0,1.0,3.410155773162842,169.28378540191025,3,89,144,481,1111,1551,607,15
-1,1,0.01,-1.0,1.0,3.4181337356567383,168.9644933114647,3,90,143,481,1111,1551,607,15
-1,1,0.01,-1.0,1.0,3.427110433578491,168.65645555388622,3,91,142,481,1111,1551,607,15
-1,1,0.01,-1.0,1.0,3.4380812644958496,168.35973390332975,3,92,141,481,1111,1551,607,15
-1,1,0.01,-1.0,1.0,3.4490528106689453,168.07438829280326,3,93,140,481,1111,1551,607,15
-1,1,0.01,-1.0,1.0,3.458028554916382,167.80047675736802,3,94,139,481,1111,1551,607,15
-1,1,0.01,-1.0,1.0,3.4670047760009766,167.53805537847214,3,95,138,481,1111,1551,607,15
-1,1,0.01,-1.0,1.0,3.474985122680664,167.28717822953436,3,96,137,481,1111,1551,607,15
-1,1,0.01,-1.0,1.0,3.483961582183838,167.0478973228936,3,97,136,481,1111,1551,607,15
-1,1,0.01,-1.0,1.0,3.4919397830963135,166.82026255823962,3,98,135,481,1111,1551,607,15
-1,1,0.01,-1.0,1.0,3.500915765762329,166.6043216726385,3,99,134,481,1111,1551,607,15
-1,1,0.01,-1.0,1.0,3.508894443511963,166.4001201922643,3,100,133,481,1111,1551,607,15
-1,1,0.01,-1.0,1.0,3.5178706645965576,166.20770138594662,3,101,132,481,1111,1551,607,15
-1,1,0.01,-1.0,1.0,3.5248525142669678,166.02710622064097,3,102,131,481,1111,1551,607,15
-1,1,0.01,-1.0,1.0,3.5348258018493652,165.85837331892532,3,103,130,481,1111,1551,607,15
-1,1,0.01,-1.0,1.0,3.5428049564361572,165.7015389186232,3,104,129,481,1111,1551,607,15
-1,1,0.01,-1.0,1.0,3.55078387260437,165.55663683464942,3,105,128,481,1111,1551,607,15
-1,1,0.01,-1.0,1.0,3.558762550354004,165.42369842317032,3,106,127,481,1111,1551,607,15
-1,1,0.01,-1.0,1.0,3.5677413940429688,165.3027525481654,3,107,126,481,1111,1551,607,15
-1,1,0.01,-1.0,1.0,3.5757176876068115,165.19382555047267,3,108,125,481,1111,1551,607,15
-1,1,0.01,-1.0,1.0,3.5836968421936035,165.0969412193939,3,109,124,481,1111,1551,607,15
-1,1,0.01,-1.0,1.0,3.5916759967803955,165.01212076693034,3,110,123,481,1111,1551,607,15
-1,1,0.01,-1.0,1.0,3.601649761199951,164.93938280471406,3,111,122,481,1111,1551,607,15
-1,1,0.01,-1.0,1.0,3.608631134033203,164.87874332369228,3,112,121,481,1111,1551,607,15
-1,1,0.01,-1.0,1.0,3.616609811782837,164.83021567661677,3,113,120,481,1111,1551,607,15
-1,1,0.01,-1.0,1.0,3.6245884895324707,164.7938105633825,3,114,119,481,1111,1551,607,15
-1,1,0.01,-1.0,1.0,3.6335651874542236,164.76953601925328,3,115,118,481,1111,1551,607,15
-1,1,0.01,-1.0,1.0,3.6415443420410156,164.7573974060042,3,116,117,481,1111,1551,607,15
-1,1,0.01,-1.0,1.0,3.6505205631256104,164.7573974060042,3,117,116,481,1111,1551,607,15
-1,1,0.01,-1.0,1.0,3.6584994792938232,164.76953601925328,3,118,115,481,1111,1551,607,15
-1,1,0.01,-1.0,1.0,3.667475700378418,164.7938105633825,3,119,114,481,1111,1551,607,15
-1,1,0.01,-1.0,1.0,3.674457311630249,164.83021567661677,3,120,113,481,1111,1551,607,15
-1,1,0.01,-1.0,1.0,3.683433771133423,164.87874332369228,3,121,112,481,1111,1551,607,15
-1,1,0.01,-1.0,1.0,3.692411184310913,164.93938280471406,3,122,111,481,1111,1551,607,15
-1,1,0.01,-1.0,1.0,3.702383041381836,165.01212076693034,3,123,110,481,1111,1551,607,15
-1,1,0.01,-1.0,1.0,3.7093777656555176,165.0969412193939,3,124,109,481,1111,1551,607,15
-1,1,0.01,-1.0,1.0,3.719339609146118,165.19382555047267,3,125,108,481,1111,1551,607,15
-1,1,0.01,-1.0,1.0,3.7273178100585938,165.3027525481654,3,126,107,481,1111,1551,607,15
-1,1,0.01,-1.0,1.0,3.7352981567382812,165.42369842317032,3,127,106,481,1111,1551,607,15
-1,1,0.01,-1.0,1.0,3.7432754039764404,165.55663683464942,3,128,105,481,1111,1551,607,15
-1,1,0.01,-1.0,1.0,3.7522518634796143,165.7015389186232,3,129,104,481,1111,1551,607,15
-1,1,0.01,-1.0,1.0,3.761228561401367,165.85837331892532,3,130,103,481,1111,1551,607,15
-1,1,0.01,-1.0,1.0,3.7692067623138428,166.02710622064097,3,131,102,481,1111,1551,607,15
-1,1,0.01,-1.0,1.0,3.777186870574951,166.20770138594662,3,132,101,481,1111,1551,607,15
-1,1,0.01,-1.0,1.0,3.7851650714874268,166.4001201922643,3,133,100,481,1111,1551,607,15
-1,1,0.01,-1.0,1.0,3.794142484664917,166.6043216726385,3,134,99,481,1111,1551,607,15
-1,1,0.01,-1.0,1.0,3.805112361907959,166.82026255823962,3,135,98,481,1111,1551,607,15
-1,1,0.01,-1.0,1.0,3.8150861263275146,167.0478973228936,3,136,97,481,1111,1551,607,15
-1,1,0.02,-1.0,1.0,3.8230648040771484,167.28717822953436,3,137,96,481,1111,1551,607,15
-1,1,0.02,-1.0,1.0,3.8300468921661377,167.53805537847214,3,138,95,481,1111,1551,607,15
-1,1,0.02,-1.0,1.0,3.8380258083343506,167.80047675736802,3,139,94,481,1111,1551,607,15
-1,1,0.02,-1.0,1.0,3.8479998111724854,168.07438829280326,3,140,93,481,1111,1551,607,15
-1,1,0.02,-1.0,1.0,3.8549933433532715,168.35973390332975,3,141,92,481,1111,1551,607,15
-1,1,0.02,-1.0,1.0,3.86296010017395,168.65645555388622,3,142,91,481,1111,1551,607,15
-1,1,0.02,-1.0,1.0,3.8719358444213867,168.9644933114647,3,143,90,481,1111,1551,607,15
-1,1,0.02,-1.0,1.0,3.881911277770996,169.28378540191025,3,144,89,481,1111,1551,607,15
-1,1,0.02,-1.0,1.0,3.890885829925537,169.61426826773743,3,145,88,481,1111,1551,607,15
-1,1,0.02,-1.0,1.0,3.9008595943450928,169.95587662684687,3,146,87,481,1111,1551,607,15
-1,1,0.02,-1.0,1.0,3.9088385105133057,170.30854353202602,3,147,86,481,1111,1551,607,15
-1,1,0.02,-1.0,1.0,3.9188122749328613,170.67220043111882,3,148,85,481,1111,1551,607,15
-1,1,0.02,-1.0,1.0,3.9257938861846924,171.04677722775136,3,149,84,481,1111,1551,607,15
-1,1,0.02,-1.0,1.0,3.933781385421753,171.4322023425004,3,150,83,481,1111,1551,607,15
-1,1,0.02,-1.0,1.0,3.942748785018921,171.82840277439584,3,151,82,481,1111,1551,607,15
-1,1,0.02,-1.0,1.0,3.9527227878570557,172.23530416264836,3,152,81,481,1111,1551,607,15
-1,1,0.02,-1.0,1.0,3.959704637527466,172.6528308484978,3,153,80,481,1111,1551,607,15
-1,1,0.02,-1.0,1.0,3.9686808586120605,173.08090593707902,3,154,79,481,1111,1551,607,15
-1,1,0.02,-1.0,1.0,3.9756627082824707,173.5194513592064,3,155,78,481,1111,1551,607,15
-1,1,0.02,-1.0,1.0,3.9856362342834473,173.9683879329805,3,156,77,481,1111,1551,607,15
-1,1,0.02,-1.0,1.0,3.992617130279541,174.42763542512407,3,157,76,481,1111,1551,607,15
-1,1,0.02,-1.0,1.0,4.001593828201294,174.89711261195822,3,158,75,481,1111,1551,607,15
-1,1,0.02,-1.0,1.0,4.009572982788086,175.37673733993344,3,159,74,481,1111,1551,607,15
-1,1,0.02,-1.0,1.0,4.018548965454102,175.86642658563346,3,160,73,481,1111,1551,607,15
-1,1,0.02,-1.0,1.0,4.025530815124512,176.36609651517495,3,161,72,481,1111,1551,607,15
-1,1,0.02,-1.0,1.0,4.034506797790527,176.87566254292872,3,162,71,481,1111,1551,607,15
-1,1,0.02,-1.0,1.0,4.0414886474609375,177.39503938949363,3,163,70,481,1111,1551,607,15
-1,1,0.02,-1.0,1.0,4.050464630126953,177.92414113885727,3,164,69,481,1111,1551,607,15
-1,1,0.02,-1.0,1.0,4.058444023132324,178.4628812946827,3,165,68,481,1111,1551,607,15
-1,1,0.02,-1.0,1.0,4.06742000579834,179.0111728356641,3,166,67,481,1111,1551,607,15
-1,1,0.02,-1.0,1.0,4.075398683547974,179.56892826989863,3,167,66,481,1111,1551,607,15
-1,1,0.02,-1.0,1.0,4.084375381469727,180.13605968822566,3,168,65,481,1111,1551,607,15
-1,1,0.02,-1.0,1.0,4.09235405921936,180.71247881648904,3,169,64,481,1111,1551,607,15
-1,1,0.02,-1.0,1.0,4.102327346801758,181.29809706668186,3,170,63,481,1111,1551,607,15
-1,1,0.02,-1.0,1.0,4.110307216644287,181.89282558693733,3,171,62,481,1111,1551,607,15
-1,1,0.02,-1.0,1.0,4.118285894393921,182.49657531033287,3,172,61,481,1111,1551,607,15
-1,1,0.02,-1.0,1.0,4.126265048980713,183.10925700247927,3,173,60,481,1111,1551,607,15
-1,1,0.02,-1.0,1.0,4.1352410316467285,183.73078130786905,3,174,59,481,1111,1551,607,15
-1,1,0.02,-1.0,1.0,4.143219947814941,184.36105879496353,3,175,58,481,1111,1551,607,15
-1,1,0.02,-1.0,1.0,4.151209354400635,185.0,3,176,57,481,1111,1551,607,15
-1,1,0.02,-1.0,1.0,4.160175561904907,185.64751546950473,3,177,56,481,1111,1551,607,15
-1,1,0.02,-1.0,1.0,4.169151782989502,186.30351580150065,3,178,55,481,1111,1551,607,15
-1,1,0.02,-1.0,1.0,4.177130699157715,186.96791168540125,3,179,54,481,1111,1551,607,15
-1,1,0.02,-1.0,1.0,4.186106443405151,187.6406139405859,3,180,53,481,1111,1551,607,15
-1,1,0.02,-1.0,1.0,4.194085597991943,188.32153355365392,3,181,52,481,1111,1551,607,15
-1,1,0.02,-1.0,1.0,4.203061580657959,189.01058171435798,3,182,51,481,1111,1551,607,15
-1,1,0.02,-1.0,1.0,4.210043668746948,189.70766985021982,3,183,50,481,1111,1551,607,15
-1,1,0.03,-1.0,1.0,4.218022346496582,190.41270965983338,3,184,49,481,1111,1551,607,15
-1,1,0.03,-1.0,1.0,4.226998805999756,191.12561314486345,3,185,48,481,1111,1551,607,15
-1,1,0.03,-1.0,1.0,4.23597526550293,191.84629264074925,3,186,47,481,1111,1551,607,15
