dx,dy,button,rx,ry,time,distance,targetID,directionX,directionY,targetX,targetY,initMouseX,initMouseY,targetSize
-1,1,0.09,-1.0,1.0,0.9031722545623779,877.7302518220273,1,887,36,1846,637,960,600,20
-3,3,0.03,-3.0,3.0,0.9111514091491699,880.6115876183062,1,890,33,1846,637,960,600,20
0,2,0.1,-0.0,2.0,0.9191310405731201,880.5397239876501,1,890,31,1846,637,960,600,20
-1,3,0.38,-1.0,3.0,0.9271090030670166,881.4398465404157,1,891,28,1846,637,960,600,20
-1,5,0.27,-1.0,5.0,0.9350864887237549,882.2964753936889,1,892,23,1846,637,960,600,20
-2,6,0.08,-2.0,6.0,0.9430656433105469,884.1616185008166,1,894,17,1846,637,960,600,20
-3,7,0.01,-3.0,7.0,0.9500749111175537,887.0557396282575,1,897,10,1846,637,960,600,20
-4,8,0.0,-4.0,8.0,0.9600203037261963,891.0022197530925,1,901,2,1846,637,960,600,20
-3,8,0.0,-3.0,8.0,0.9670019149780273,894.0199112851442,1,904,-6,1846,637,960,600,20
-4,9,0.0,-4.0,9.0,0.9769763946533203,898.1238902264382,1,908,-15,1846,637,960,600,20
-4,9,0.0,-4.0,9.0,0.9847116470336914,902.3157348199142,1,912,-24,1846,637,960,600,20
-3,9,0.0,-3.0,9.0,0.9936873912811279,905.5948885833734,1,915,-33,1846,637,960,600,20
-2,9,0.0,-2.0,9.0,1.0016679763793945,907.9613281614863,1,917,-42,1846,637,960,600,20
-1,8,0.0,-1.0,8.0,1.0096464157104492,909.3606474066638,1,918,-50,1846,637,960,600,20
0,7,0.0,-0.0,7.0,1.0176239013671875,909.7679055066012,1,918,-57,1846,637,960,600,20
0,6,0.0,-0.0,6.0,1.027597188949585,910.1592253517866,1,918,-63,1846,637,960,600,20
1,5,0.0,1.0,5.0,1.0355761051177979,909.5178084191735,1,917,-68,1846,637,960,600,20
1,4,0.0,1.0,4.0,1.0445537567138672,908.825337047254,1,916,-72,1846,637,960,600,20
1,4,0.0,1.0,4.0,1.0535297393798828,908.1508590640211,1,915,-76,1846,637,960,600,20
1,3,0.0,1.0,3.0,1.063502311706543,907.4077610310477,1,914,-79,1846,637,960,600,20
1,3,0.0,1.0,3.0,1.0704843997955322,906.6749696593662,1,913,-82,1846,637,960,600,20
1,3,0.0,1.0,3.0,1.0789813995361328,905.9525096859553,1,912,-85,1846,637,960,600,20
1,3,0.0,1.0,3.0,1.087949514389038,905.2404055765895,1,911,-88,1846,637,960,600,20
1,3,0.0,1.0,3.0,1.09493088722229,904.5386815220011,1,910,-91,1846,637,960,600,20
1,3,0.0,1.0,3.0,1.1039071083068848,903.8473614340636,1,909,-94,1846,637,960,600,20
1,3,0.0,1.0,3.0,1.1128973960876465,903.1664689419996,1,908,-97,1846,637,960,600,20
1,3,0.0,1.0,3.0,1.122856616973877,902.4960273886128,1,907,-100,1846,637,960,600,20
1,3,0.0,1.0,3.0,1.1298367977142334,901.8360598265458,1,906,-103,1846,637,960,600,20
1,3,0.0,1.0,3.0,1.138812780380249,901.1865890145663,1,905,-106,1846,637,960,600,20
1,3,0.0,1.0,3.0,1.1477899551391602,900.5476374138807,1,904,-109,1846,637,960,600,20
1,3,0.0,1.0,3.0,1.157763957977295,899.9192271844793,1,903,-112,1846,637,960,600,20
1,3,0.0,1.0,3.0,1.1657428741455078,899.3013801815106,1,902,-115,1846,637,960,600,20
1,3,0.0,1.0,3.0,1.1747174263000488,898.69411795169,1,901,-118,1846,637,960,600,20
1,3,0.0,1.0,3.0,1.1836953163146973,898.0974617297419,1,900,-121,1846,637,960,600,20
1,3,0.0,1.0,3.0,1.1906764507293701,897.5114324348757,1,899,-124,1846,637,960,600,20
1,3,0.0,1.0,3.0,1.1996510028839111,896.9360506673004,1,898,-127,1846,637,960,600,20
1,3,0.0,1.0,3.0,1.2086286544799805,896.3713367047746,1,897,-130,1846,637,960,600,20
1,3,0.0,1.0,3.0,1.2176053524017334,895.8173104991978,1,896,-133,1846,637,960,600,20
1,3,0.0,1.0,3.0,1.2265803813934326,895.2739916732393,1,895,-136,1846,637,960,600,20
1,3,0.0,1.0,3.0,1.2355561256408691,894.7413995170111,1,894,-139,1846,637,960,600,20
1,3,0.0,1.0,3.0,1.244532823562622,894.2195529847826,1,893,-142,1846,637,960,600,20
1,3,0.0,1.0,3.0,1.2535080909729004,893.7084706917381,1,892,-145,1846,637,960,600,20
1,3,0.0,1.0,3.0,1.2634832859039307,893.2081709107817,1,891,-148,1846,637,960,600,20
1,3,0.0,1.0,3.0,1.2724580764770508,892.7186715693877,1,890,-151,1846,637,960,600,20
1,3,0.0,1.0,3.0,1.2824373245239258,892.2399902464975,1,889,-154,1846,637,960,600,20
1,3,0.0,1.0,3.0,1.2904117107391357,891.7721441694681,1,888,-157,1846,637,960,600,20
1,3,0.0,1.0,3.0,1.298391342163086,891.3151502110679,1,887,-160,1846,637,960,600,20
1,3,0.0,1.0,3.0,1.3063695430755615,890.8690248865258,1,886,-163,1846,637,960,600,20
1,3,0.0,1.0,3.0,1.3143479824066162,890.4337843506318,1,885,-166,1846,637,960,600,20
1,3,0.0,1.0,3.0,1.322326898574829,890.0094443948908,1,884,-169,1846,637,960,600,20
1,3,0.0,1.0,3.0,1.332298755645752,889.5960204447327,1,883,-172,1846,637,960,600,20
1,3,0.0,1.0,3.0,1.339310884475708,889.1935275567769,1,882,-175,1846,637,960,600,20
1,3,0.0,1.0,3.0,1.3492558002471924,888.8019804161537,1,881,-178,1846,637,960,600,20
1,3,0.0,1.0,3.0,1.3572328090667725,888.4213933338854,1,880,-181,1846,637,960,600,20
1,3,0.0,1.0,3.0,1.3652238845825195,888.0517802443242,1,879,-184,1846,637,960,600,20
1,3,0.0,1.0,3.0,1.37319016456604,887.6931547026522,1,878,-187,1846,637,960,600,20
1,3,0.0,1.0,3.0,1.3801720142364502,887.3455298824416,1,877,-190,1846,637,960,600,20
1,3,0.0,1.0,3.0,1.3891489505767822,887.008918573277,1,876,-193,1846,637,960,600,20
1,3,0.0,1.0,3.0,1.3981280326843262,886.6833331784416,1,875,-196,1846,637,960,600,20
1,3,0.0,1.0,3.0,1.4061031341552734,886.3687857126664,1,874,-199,1846,637,960,600,20
1,3,0.0,1.0,3.0,1.4140818119049072,886.065287799946,1,873,-202,1846,637,960,600,20
1,3,0.0,1.0,3.0,1.4210643768310547,885.7728506714188,1,872,-205,1846,637,960,600,20
1,3,0.0,1.0,3.0,1.4300520420074463,885.4914851633152,1,871,-208,1846,637,960,600,20
1,3,0.0,1.0,3.0,1.4390156269073486,885.2212017149728,1,870,-211,1846,637,960,600,20
1,3,0.0,1.0,3.0,1.4489898681640625,884.9620103669206,1,869,-214,1846,637,960,600,20
1,3,0.0,1.0,3.0,1.4569687843322754,884.7139207590324,1,868,-217,1846,637,960,600,20
1,3,0.0,1.0,3.0,1.4659442901611328,884.4769421287505,1,867,-220,1846,637,960,600,20
1,3,0.0,1.0,3.0,1.4749209880828857,884.2510833093802,1,866,-223,1846,637,960,600,20
1,3,0.0,1.0,3.0,1.483896017074585,884.0363527284559,1,865,-226,1846,637,960,600,20
1,3,0.0,1.0,3.0,1.4938697814941406,883.8327584061797,1,864,-229,1846,637,960,600,20
1,3,0.0,1.0,3.0,1.5008518695831299,883.6403079539328,1,863,-232,1846,637,960,600,20
1,3,0.0,1.0,3.0,1.510826587677002,883.4590085728612,1,862,-235,1846,637,960,600,20
1,3,0.0,1.0,3.0,1.518813133239746,883.2888670525341,1,861,-238,1846,637,960,600,20
1,3,0.0,1.0,3.0,1.5277800559997559,883.1298897696796,1,860,-241,1846,637,960,600,20
1,3,0.0,1.0,3.0,1.5367553234100342,882.9820826869932,1,859,-244,1846,637,960,600,20
1,3,0.0,1.0,3.0,1.5447359085083008,882.8454513520243,1,858,-247,1846,637,960,600,20
1,3,0.0,1.0,3.0,1.5547080039978027,882.7200008961377,1,857,-250,1846,637,960,600,20
1,3,0.0,1.0,3.0,1.561690092086792,882.6057360335525,1,856,-253,1846,637,960,600,20
1,3,0.0,1.0,3.0,1.5716640949249268,882.5026610604586,1,855,-256,1846,637,960,600,20
1,3,0.0,1.0,3.0,1.5796418190002441,882.4107798542104,1,854,-259,1846,637,960,600,20
1,3,0.0,1.0,3.0,1.5886175632476807,882.330095872598,1,853,-262,1846,637,960,600,20
1,3,0.0,1.0,3.0,1.599590539932251,882.2606121531982,1,852,-265,1846,637,960,600,20
1,3,0.0,1.0,3.0,1.6075835227966309,882.2023313128026,1,851,-268,1846,637,960,600,20
1,3,0.0,1.0,3.0,1.615546703338623,882.1552555469256,1,850,-271,1846,637,960,600,20
1,3,0.0,1.0,3.0,1.6225292682647705,882.1193866293905,1,849,-274,1846,637,960,600,20
1,3,0.0,1.0,3.0,1.6315040588378906,882.0947259119964,1,848,-277,1846,637,960,600,20
1,3,0.0,1.0,3.0,1.6404800415039062,882.0812743242625,1,847,-280,1846,637,960,600,20
1,3,0.0,1.0,3.0,1.649456262588501,882.0790323732533,1,846,-283,1846,637,960,600,20
1,3,0.0,1.0,3.0,1.6584322452545166,882.0880001434836,1,845,-286,1846,637,960,600,20
1,3,0.0,1.0,3.0,1.6674082279205322,882.1081772969015,1,844,-289,1846,637,960,600,20
1,3,0.0,1.0,3.0,1.6773817539215088,882.1395630729533,1,843,-292,1846,637,960,600,20
1,3,0.0,1.0,3.0,1.6843631267547607,882.1821562887257,1,842,-295,1846,637,960,600,20
1,3,0.0,1.0,3.0,1.6943368911743164,882.2359553391692,1,841,-298,1846,637,960,600,20
1,3,0.0,1.0,3.0,1.7013182640075684,882.300958197401,1,840,-301,1846,637,960,600,20
1,3,0.0,1.0,3.0,1.7112932205200195,882.3771624150855,1,839,-304,1846,637,960,600,20
1,3,0.0,1.0,3.0,1.7182738780975342,882.464565122896,1,838,-307,1846,637,960,600,20
1,3,0.0,1.0,3.0,1.727250337600708,882.563163031054,1,837,-310,1846,637,960,600,20
1,3,0.0,1.0,3.0,1.735229730606079,882.6729524299479,1,836,-313,1846,637,960,600,20
1,3,0.0,1.0,3.0,1.7422096729278564,882.7939291908295,1,835,-316,1846,637,960,600,20
1,3,0.0,1.0,3.0,1.7511870861053467,882.9260887665899,1,834,-319,1846,637,960,600,20
1,3,0.0,1.0,3.0,1.760162353515625,883.0694261926113,1,833,-322,1846,637,960,600,20
1,3,0.0,1.0,3.0,1.7671558856964111,883.223936087698,1,832,-325,1846,637,960,600,20
1,3,0.0,1.0,3.0,1.7761199474334717,883.3896126550834,1,831,-328,1846,637,960,600,20
1,2,0.0,1.0,2.0,1.7840995788574219,883.1965069345043,1,830,-330,1846,637,960,600,20
1,2,0.0,1.0,2.0,1.7910816669464111,883.0089585216937,1,829,-332,1846,637,960,600,20
1,1,0.0,1.0,1.0,1.7990589141845703,882.4533601258947,1,828,-333,1846,637,960,600,20
1,1,0.0,1.0,1.0,1.8080344200134277,881.8996580333462,1,827,-334,1846,637,960,600,20
1,0,0.0,1.0,-0.0,1.8160250186920166,880.972502381527,1,826,-334,1846,637,960,600,20
1,0,0.0,1.0,-0.0,1.8249897956848145,880.045504454688,1,825,-334,1846,637,960,600,20
1,0,0.0,1.0,-0.0,1.8329684734344482,879.1186647461631,1,824,-334,1846,637,960,600,20
1,0,0.0,1.0,-0.0,1.841944694519043,878.1919837512609,1,823,-334,1846,637,960,600,20
1,0,0.0,1.0,-0.0,1.8509206771850586,877.265461967274,1,822,-334,1846,637,960,600,20
1,0,0.0,1.0,-0.0,1.8598980903625488,876.3390998934889,1,821,-334,1846,637,960,600,20
1,0,0.01,1.0,-0.0,1.8688733577728271,875.4128980311954,1,820,-334,1846,637,960,600,20
1,0,0.01,1.0,-0.0,1.8778634071350098,874.4868568836962,1,819,-334,1846,637,960,600,20
1,0,0.01,1.0,-0.0,1.8868262767791748,873.5609769563163,1,818,-334,1846,637,960,600,20
1,0,0.01,1.0,-0.0,1.8958027362823486,872.6352587564129,1,817,-334,1846,637,960,600,20
1,0,0.02,1.0,-0.0,1.904778242111206,871.7097027933854,1,816,-334,1846,637,960,600,20
1,0,0.02,1.0,-0.0,1.913754940032959,870.7843095786845,1,815,-334,1846,637,960,600,20
1,0,0.02,1.0,-0.0,1.9227311611175537,869.8590796258228,1,814,-334,1846,637,960,600,20
1,0,0.02,1.0,-0.0,1.9337005615234375,868.9340134503841,1,813,-334,1846,637,960,600,20
1,0,0.02,1.0,-0.0,1.9426908493041992,868.0091115700337,1,812,-334,1846,637,960,600,20
1,0,0.02,1.0,-0.0,1.9506571292877197,867.0843745045285,1,811,-334,1846,637,960,600,20
1,0,0.02,1.0,-0.0,1.958634376525879,866.1598027757266,1,810,-334,1846,637,960,600,20
1,0,0.02,1.0,-0.0,1.9676384925842285,865.2353969075976,1,809,-334,1846,637,960,600,20
1,0,0.02,1.0,-0.0,1.9765887260437012,864.3111574262334,1,808,-334,1846,637,960,600,20
1,0,0.02,1.0,-0.0,1.9865729808807373,863.3870848598575,1,807,-334,1846,637,960,600,20
1,0,0.02,1.0,-0.0,1.9945392608642578,862.4631797388357,1,806,-334,1846,637,960,600,20
1,0,0.02,1.0,-0.0,2.0025179386138916,861.5394425956865,1,805,-334,1846,637,960,600,20
1,0,0.02,1.0,-0.0,2.010498285293579,860.6158739650914,1,804,-334,1846,637,960,600,20
1,0,0.02,1.0,-0.0,2.018503189086914,859.6924743839054,1,803,-334,1846,637,960,600,20
1,0,0.02,1.0,-0.0,2.0274531841278076,858.7692443911674,1,802,-334,1846,637,960,600,20
1,0,0.02,1.0,-0.0,2.035431385040283,857.8461845281109,1,801,-334,1846,637,960,600,20
1,0,0.02,1.0,-0.0,2.0424129962921143,856.9232953381746,1,800,-334,1846,637,960,600,20
1,0,0.02,1.0,-0.0,2.0513899326324463,856.0005773670131,1,799,-334,1846,637,960,600,20
1,0,0.02,1.0,-0.0,2.0593671798706055,855.0780311625073,1,798,-334,1846,637,960,600,20
1,0,0.02,1.0,-0.0,2.0673470497131348,854.1556572747759,1,797,-334,1846,637,960,600,20
1,0,0.02,1.0,-0.0,2.074327230453491,853.2334562561856,1,796,-334,1846,637,960,600,20
1,0,0.02,1.0,-0.0,2.0833046436309814,852.3114286613625,1,795,-334,1846,637,960,600,20
1,0,0.02,1.0,-0.0,2.0922791957855225,851.3895750472025,1,794,-334,1846,637,960,600,20
1,0,0.02,1.0,-0.0,2.10025954246521,850.4678959728828,1,793,-334,1846,637,960,600,20
1,0,0.02,1.0,-0.0,2.1092352867126465,849.5463919998734,1,792,-334,1846,637,960,600,20
1,0,0.02,1.0,-0.0,2.118210554122925,848.6250636919469,1,791,-334,1846,637,960,600,20
1,0,0.02,1.0,-0.0,2.1271867752075195,847.7039116151914,1,790,-334,1846,637,960,600,20
1,0,0.02,1.0,-0.0,2.1361639499664307,846.7829363380202,1,789,-334,1846,637,960,600,20
1,0,0.02,1.0,-0.0,2.1451401710510254,845.8621384311845,1,788,-334,1846,637,960,600,20
1,0,0.02,1.0,-0.0,2.154116630554199,844.9415184677839,1,787,-334,1846,637,960,600,20
1,0,0.02,1.0,-0.0,2.1630914211273193,844.0210770232782,1,786,-334,1846,637,960,600,20
1,0,0.02,1.0,-0.0,2.1720688343048096,843.1008146754989,1,785,-334,1846,637,960,600,20
1,0,0.02,1.0,-0.0,2.1810436248779297,842.1807320046611,1,784,-334,1846,637,960,600,20
1,0,0.02,1.0,-0.0,2.1900196075439453,841.2608295933744,1,783,-334,1846,637,960,600,20
1,0,0.02,1.0,-0.0,2.2000207901000977,840.3411080266554,1,782,-334,1846,637,960,600,20
1,0,0.02,1.0,-0.0,2.2079806327819824,839.421567891939,1,781,-334,1846,637,960,600,20
1,0,0.02,1.0,-0.0,2.2159512042999268,838.5022097790907,1,780,-334,1846,637,960,600,20
1,0,0.02,1.0,-0.0,2.2249269485473633,837.5830342804179,1,779,-334,1846,637,960,600,20
1,0,0.02,1.0,-0.0,2.2329065799713135,836.6640419906824,1,778,-334,1846,637,960,600,20
1,0,0.02,1.0,-0.0,2.239887237548828,835.7452335071124,1,777,-334,1846,637,960,600,20
1,0,0.02,1.0,-0.0,2.249868392944336,834.8266094294142,1,776,-334,1846,637,960,600,20
1,0,0.02,1.0,-0.0,2.2568440437316895,833.908170359785,1,775,-334,1846,637,960,600,20
1,0,0.02,1.0,-0.0,2.266817331314087,832.9899169029247,1,774,-334,1846,637,960,600,20
1,0,0.02,1.0,-0.0,2.2747950553894043,832.0718496660484,1,773,-334,1846,637,960,600,20
1,0,0.02,1.0,-0.0,2.2827742099761963,831.1539692588985,1,772,-334,1846,637,960,600,20
1,0,0.02,1.0,-0.0,2.289754867553711,830.2362762937578,1,771,-334,1846,637,960,600,20
1,0,0.02,1.0,-0.0,2.298743963241577,829.3187713854611,1,770,-334,1846,637,960,600,20
1,0,0.02,1.0,-0.0,2.308704376220703,828.401455151409,1,769,-334,1846,637,960,600,20
1,0,0.02,1.0,-0.0,2.315685749053955,827.4843282115792,1,768,-334,1846,637,960,600,20
1,0,0.02,1.0,-0.0,2.3246634006500244,826.5673911885402,1,767,-334,1846,637,960,600,20
1,0,0.02,1.0,-0.0,2.3336398601531982,825.6506447074638,1,766,-334,1846,637,960,600,20
1,0,0.02,1.0,-0.0,2.3426156044006348,824.7340893961382,1,765,-334,1846,637,960,600,20
1,0,0.02,1.0,-0.0,2.352595329284668,823.8177258849802,1,764,-334,1846,637,960,600,20
1,0,0.02,1.0,-0.0,2.3615641593933105,822.9015548070493,1,763,-334,1846,637,960,600,20
1,0,0.02,1.0,-0.0,2.370540142059326,821.9855767980597,1,762,-334,1846,637,960,600,20
1,0,0.02,1.0,-0.0,2.379516363143921,821.0697924963944,1,761,-334,1846,637,960,600,20
1,0,0.02,1.0,-0.0,2.3892757892608643,820.1542025431179,1,760,-334,1846,637,960,600,20
1,0,0.02,1.0,-0.0,2.3972532749176025,819.2388075819896,1,759,-334,1846,637,960,600,20
1,0,0.02,1.0,-0.0,2.4052317142486572,818.3236082594773,1,758,-334,1846,637,960,600,20
1,0,0.02,1.0,-0.0,2.412215232849121,817.4086052247704,1,757,-334,1846,637,960,600,20
1,0,0.02,1.0,-0.0,2.421198606491089,816.4937991297938,1,756,-334,1846,637,960,600,20
1,0,0.02,1.0,-0.0,2.4301669597625732,815.5791906292212,1,755,-334,1846,637,960,600,20
1,0,0.02,1.0,-0.0,2.4391415119171143,814.6647803804889,1,754,-334,1846,637,960,600,20
1,0,0.02,1.0,-0.0,2.448117971420288,813.7505690438095,1,753,-334,1846,637,960,600,20
1,0,0.02,1.0,-0.0,2.45809268951416,812.8365572821859,1,752,-334,1846,637,960,600,20
1,0,0.02,1.0,-0.0,2.4660704135894775,811.922745761425,1,751,-334,1846,637,960,600,20
1,0,0.02,1.0,-0.0,2.4730722904205322,811.0091351501517,1,750,-334,1846,637,960,600,20
1,0,0.02,1.0,-0.0,2.482028007507324,810.0957261198232,1,749,-334,1846,637,960,600,20
1,0,0.02,1.0,-0.0,2.491004705429077,809.1825193447429,1,748,-334,1846,637,960,600,20
1,0,0.02,1.0,-0.0,2.4999804496765137,808.2695155020747,1,747,-334,1846,637,960,600,20
1,0,0.02,1.0,-0.0,2.506962776184082,807.3567152718573,1,746,-334,1846,637,960,600,20
1,0,0.02,1.0,-0.0,2.5169360637664795,806.4441193370187,1,745,-334,1846,637,960,600,20
1,0,0.02,1.0,-0.0,2.5249152183532715,805.5317283833904,1,744,-334,1846,637,960,600,20
1,0,0.02,1.0,-0.0,2.532892942428589,804.6195430997221,1,743,-334,1846,637,960,600,20
1,0,0.02,1.0,-0.0,2.539874315261841,803.7075641776964,1,742,-334,1846,637,960,600,20
1,0,0.02,1.0,-0.0,2.5508463382720947,802.7957923119435,1,741,-334,1846,637,960,600,20
1,0,0.02,1.0,-0.0,2.558824062347412,801.8842282000556,1,740,-334,1846,637,960,600,20
1,0,0.02,1.0,-0.0,2.5658063888549805,800.9728725426024,1,739,-334,1846,637,960,600,20
1,0,0.03,1.0,-0.0,2.575780153274536,800.0617260431454,1,738,-334,1846,637,960,600,20
1,0,0.03,1.0,-0.0,2.584782600402832,799.1507894082537,1,737,-334,1846,637,960,600,20
1,0,0.03,1.0,-0.0,2.59224534034729,798.240063347518,1,736,-334,1846,637,960,600,20
1,0,0.03,1.0,-0.0,2.6002230644226074,797.3295485735673,1,735,-334,1846,637,960,600,20
1,0,0.03,1.0,-0.0,2.6091997623443604,796.4192458020827,1,734,-334,1846,637,960,600,20
1,0,0.03,1.0,-0.0,2.6171791553497314,795.5091557518139,1,733,-334,1846,637,960,600,20
1,0,0.03,1.0,-0.0,2.6251580715179443,794.5992791445938,1,732,-334,1846,637,960,600,20
1,0,0.03,1.0,-0.0,2.6331357955932617,793.6896167053548,1,731,-334,1846,637,960,600,20
1,0,0.03,1.0,-0.0,2.64111590385437,792.7801691621437,1,730,-334,1846,637,960,600,20
1,0,0.03,1.0,-0.0,2.6490936279296875,791.8709372461382,1,729,-334,1846,637,960,600,20
1,0,0.03,1.0,-0.0,2.6580703258514404,790.9619216916619,1,728,-334,1846,637,960,600,20
1,0,0.03,1.0,-0.0,2.665050745010376,790.0531232362011,1,727,-334,1846,637,960,600,20
1,0,0.03,1.0,-0.0,2.673029899597168,789.1445426204198,1,726,-334,1846,637,960,600,20
1,0,0.03,1.0,-0.0,2.68001127243042,788.2361805881766,1,725,-334,1846,637,960,600,20
1,0,0.03,1.0,-0.0,2.689504861831665,787.3280378865402,1,724,-334,1846,637,960,600,20
1,0,0.03,1.0,-0.0,2.6984729766845703,786.4201152658062,1,723,-334,1846,637,960,600,20
1,0,0.03,1.0,-0.0,2.7064576148986816,785.5124134795133,1,722,-334,1846,637,960,600,20
1,0,0.03,1.0,-0.0,2.7154271602630615,784.6049332844593,1,721,-334,1846,637,960,600,20
1,0,0.03,1.0,-0.0,2.724405288696289,783.6976754407184,1,720,-334,1846,637,960,600,20
1,0,0.03,1.0,-0.0,2.7343780994415283,782.7906407116573,1,719,-334,1846,637,960,600,20
1,0,0.03,1.0,-0.0,2.7413859367370605,781.8838298639517,1,718,-334,1846,637,960,600,20
1,0,0.03,1.0,-0.0,2.7503345012664795,780.9772436676038,1,717,-334,1846,637,960,600,20
1,0,0.03,1.0,-0.0,2.759312152862549,780.0708828959589,1,716,-334,1846,637,960,600,20
1,0,0.03,1.0,-0.0,2.769284725189209,779.1647483257219,1,715,-334,1846,637,960,600,20
1,0,0.03,1.0,-0.0,2.7782604694366455,778.2588407369752,1,714,-334,1846,637,960,600,20
1,0,0.03,1.0,-0.0,2.786240816116333,777.3531609131953,1,713,-334,1846,637,960,600,20
1,0,0.03,1.0,-0.0,2.794217824935913,776.4477096412704,1,712,-334,1846,637,960,600,20
1,0,0.03,1.0,-0.0,2.8011999130249023,775.5424877115178,1,711,-334,1846,637,960,600,20
1,0,0.03,1.0,-0.0,2.8111727237701416,774.6374959177008,1,710,-334,1846,637,960,600,20
1,0,0.03,1.0,-0.0,2.8191518783569336,773.7327350570474,1,709,-334,1846,637,960,600,20
1,0,0.03,1.0,-0.0,2.8271307945251465,772.8282059302667,1,708,-334,1846,637,960,600,20
1,0,0.03,1.0,-0.0,2.835109233856201,771.9239093415675,1,707,-334,1846,637,960,600,20
1,0,0.03,1.0,-0.0,2.843088388442993,771.0198460986763,1,706,-334,1846,637,960,600,20
1,0,0.03,1.0,-0.0,2.851066827774048,770.1160170128543,1,705,-334,1846,637,960,600,20
1,0,0.03,1.0,-0.0,2.8610410690307617,769.2124228989165,1,704,-334,1846,637,960,600,20
1,0,0.03,1.0,-0.0,2.869046926498413,768.3090645752495,1,703,-334,1846,637,960,600,20
1,0,0.03,1.0,-0.0,2.878016710281372,767.4059428638296,1,702,-334,1846,637,960,600,20
1,0,0.03,1.0,-0.0,2.885974645614624,766.5030585902415,1,701,-334,1846,637,960,600,20
1,0,0.03,1.0,-0.0,2.89298415184021,765.6004125836963,1,700,-334,1846,637,960,600,20
1,0,0.03,1.0,-0.0,2.901933193206787,764.6980056770509,1,699,-334,1846,637,960,600,20
1,0,0.03,1.0,-0.0,2.911924362182617,763.7958387068259,1,698,-334,1846,637,960,600,20
1,0,0.03,1.0,-0.0,2.918886661529541,762.8939125132246,1,697,-334,1846,637,960,600,20
1,0,0.03,1.0,-0.0,2.927863597869873,761.9922279401522,1,696,-334,1846,637,960,600,20
1,0,0.03,1.0,-0.0,2.9368398189544678,761.0907858352348,1,695,-334,1846,637,960,600,20
1,0,0.03,1.0,-0.0,2.945814609527588,760.189587049838,1,694,-334,1846,637,960,600,20
1,0,0.03,1.0,-0.0,2.9547910690307617,759.2886324390865,1,693,-334,1846,637,960,600,20
1,0,0.03,1.0,-0.0,2.963768482208252,758.3879228618836,1,692,-334,1846,637,960,600,20
1,0,0.03,1.0,-0.0,2.972743511199951,757.4874591809302,1,691,-334,1846,637,960,600,20
1,0,0.03,1.0,-0.0,2.981719970703125,756.5872422627447,1,690,-334,1846,637,960,600,20
1,0,0.03,1.0,-0.0,2.989699602127075,755.6872729776825,1,689,-334,1846,637,960,600,20
1,0,0.03,1.0,-0.0,2.997678279876709,754.7875521999557,1,688,-334,1846,637,960,600,20
1,0,0.03,1.0,-0.0,3.0056569576263428,753.8880808076534,1,687,-334,1846,637,960,600,20
1,0,0.03,1.0,-0.0,3.015643358230591,752.988859682761,1,686,-334,1846,637,960,600,20
1,0,0.03,1.0,-0.0,3.0246074199676514,752.089889711181,1,685,-334,1846,637,960,600,20
1,0,0.03,1.0,-0.0,3.0345804691314697,751.1911717827526,1,684,-334,1846,637,960,600,20
1,0,0.03,1.0,-0.0,3.0415618419647217,750.2927067912726,1,683,-334,1846,637,960,600,20
1,0,0.03,1.0,-0.0,3.050537347793579,749.3944956345154,1,682,-334,1846,637,960,600,20
1,0,0.03,1.0,-0.0,3.0595128536224365,748.4965392142537,1,681,-334,1846,637,960,600,20
1,0,0.03,1.0,-0.0,3.067492723464966,747.5988384362795,1,680,-334,1846,637,960,600,20
1,0,0.03,1.0,-0.0,3.0754706859588623,746.7013942104244,1,679,-334,1846,637,960,600,20
1,0,0.03,1.0,-0.0,3.0824530124664307,745.8042074505804,1,678,-334,1846,637,960,600,20
1,0,0.03,1.0,-0.0,3.090430736541748,744.9072790747218,1,677,-334,1846,637,960,600,20
1,0,0.03,1.0,-0.0,3.099411725997925,744.0106100049256,1,676,-334,1846,637,960,600,20
1,0,0.03,1.0,-0.0,3.108384370803833,743.1142011673927,1,675,-334,1846,637,960,600,20
1,0,0.03,1.0,-0.0,3.1173601150512695,742.2180534924697,1,674,-334,1846,637,960,600,20
1,0,0.04,1.0,-0.0,3.126335382461548,741.3221679146703,1,673,-334,1846,637,960,600,20
1,0,0.04,1.0,-0.0,3.135312795639038,740.4265453726966,1,672,-334,1846,637,960,600,20
1,0,0.04,1.0,-0.0,3.14528489112854,739.5311868094616,1,671,-334,1846,637,960,600,20
1,0,0.04,1.0,-0.0,3.153263568878174,738.6360931721099,1,670,-334,1846,637,960,600,20
1,0,0.04,1.0,-0.0,3.162240743637085,737.7412654120408,1,669,-334,1846,637,960,600,20
1,0,0.04,1.0,-0.0,3.1712162494659424,736.8467044849298,1,668,-334,1846,637,960,600,20
1,0,0.04,1.0,-0.0,3.1801929473876953,735.9524113507509,1,667,-334,1846,637,960,600,20
1,0,0.04,1.0,-0.0,3.1891679763793945,735.0583869737995,1,666,-334,1846,637,960,600,20
1,0,0.04,1.0,-0.0,3.1981444358825684,734.1646323227139,1,665,-334,1846,637,960,600,20
1,0,0.04,1.0,-0.0,3.2071402072906494,733.2711483704987,1,664,-334,1846,637,960,600,20
1,0,0.04,1.0,-0.0,3.216097831726074,732.3779360945475,1,663,-334,1846,637,960,600,20
1,0,0.04,1.0,-0.0,3.2250730991363525,731.4849964766651,1,662,-334,1846,637,960,600,20
1,0,0.04,1.0,-0.0,3.2340505123138428,730.5923305030913,1,661,-334,1846,637,960,600,20
1,0,0.04,1.0,-0.0,3.244023084640503,729.6999391645237,1,660,-334,1846,637,960,600,20
1,0,0.04,1.0,-0.0,3.2520132064819336,728.8078234561407,1,659,-334,1846,637,960,600,20
1,0,0.04,1.0,-0.0,3.2599802017211914,727.9159843776255,1,658,-334,1846,637,960,600,20
1,0,0.04,1.0,-0.0,3.267986536026001,727.0244229331888,1,657,-334,1846,637,960,600,20
1,0,0.04,1.0,-0.0,3.2759387493133545,726.1331401315933,1,656,-334,1846,637,960,600,20
1,0,0.04,1.0,-0.0,3.2829203605651855,725.2421369861768,1,655,-334,1846,637,960,600,20
1,0,0.04,1.0,-0.0,3.2908995151519775,724.3514145148765,1,654,-334,1846,637,960,600,20
1,0,0.04,1.0,-0.0,3.300872802734375,723.4609737402529,1,653,-334,1846,637,960,600,20
1,0,0.04,1.0,-0.0,3.307854175567627,722.5708156895141,1,652,-334,1846,637,960,600,20
1,0,0.04,1.0,-0.0,3.317826747894287,721.6809413945398,1,651,-334,1846,637,960,600,20
1,0,0.04,1.0,-0.0,3.325805187225342,720.7913518919063,1,650,-334,1846,637,960,600,20
1,0,0.04,1.0,-0.0,3.3337841033935547,719.9020482229105,1,649,-334,1846,637,960,600,20
1,0,0.04,1.0,-0.0,3.3417630195617676,719.0130314335952,1,648,-334,1846,637,960,600,20
1,0,0.04,1.0,-0.0,3.3507401943206787,718.1243025747733,1,647,-334,1846,637,960,600,20
1,0,0.04,1.0,-0.0,3.3587188720703125,717.2358627020535,1,646,-334,1846,637,960,600,20
1,0,0.04,1.0,-0.0,3.365699291229248,716.347712875865,1,645,-334,1846,637,960,600,20
1,0,0.04,1.0,-0.0,3.372680902481079,715.4598541614829,1,644,-334,1846,637,960,600,20
1,0,0.04,1.0,-0.0,3.380673885345459,714.5722876290536,1,643,-334,1846,637,960,600,20
1,0,0.04,1.0,-0.0,3.391631841659546,713.6850143536205,1,642,-334,1846,637,960,600,20
1,0,0.04,1.0,-0.0,3.3996102809906006,712.7980354151497,1,641,-334,1846,637,960,600,20
1,0,0.04,1.0,-0.0,3.407588005065918,711.9113518985555,1,640,-334,1846,637,960,600,20
1,0,0.04,1.0,-0.0,3.41556715965271,711.0249648937269,1,639,-334,1846,637,960,600,20
1,0,0.04,1.0,-0.0,3.4245429039001465,710.1388754955533,1,638,-334,1846,637,960,600,20
1,0,0.05,1.0,-0.0,3.433520555496216,709.2530848039513,1,637,-334,1846,637,960,600,20
1,0,0.05,1.0,-0.0,3.4424962997436523,708.3675939238907,1,636,-334,1846,637,960,600,20
1,0,0.05,1.0,-0.0,3.4524688720703125,707.4824039654213,1,635,-334,1846,637,960,600,20
1,0,0.05,1.0,-0.0,3.4594552516937256,706.5975160436994,1,634,-334,1846,637,960,600,20
1,0,0.05,1.0,-0.0,3.468427896499634,705.7129312790149,1,633,-334,1846,637,960,600,20
1,0,0.05,1.0,-0.0,3.476405143737793,704.8286507968186,1,632,-334,1846,637,960,600,20
1,0,0.05,1.0,-0.0,3.485381603240967,703.9446757277485,1,631,-334,1846,637,960,600,20
1,0,0.05,1.0,-0.0,3.4953556060791016,703.0610072076582,1,630,-334,1846,637,960,600,20
1,0,0.05,1.0,-0.0,3.503333806991577,702.1776463776437,1,629,-334,1846,637,960,600,20
1,0,0.05,1.0,-0.0,3.51031494140625,701.2945943840709,1,628,-334,1846,637,960,600,20
1,0,0.05,1.0,-0.0,3.5192928314208984,700.4118523786044,1,627,-334,1846,637,960,600,20
1,0,0.05,1.0,-0.0,3.5292649269104004,699.5294215182341,1,626,-334,1846,637,960,600,20
1,0,0.05,1.0,-0.0,3.5362462997436523,698.6473029653044,1,625,-334,1846,637,960,600,20
1,0,0.05,1.0,-0.0,3.5452234745025635,697.7654978875419,1,624,-334,1846,637,960,600,20
1,0,0.05,1.0,-0.0,3.5541982650756836,696.8840074580836,1,623,-334,1846,637,960,600,20
1,0,0.05,1.0,-0.0,3.563175916671753,696.0028328555063,1,622,-334,1846,637,960,600,20
1,0,0.05,1.0,-0.0,3.5701704025268555,695.1219752638547,1,621,-334,1846,637,960,600,20
1,0,0.05,1.0,-0.0,3.580130100250244,694.24143587267,1,620,-334,1846,637,960,600,20
1,0,0.05,1.0,-0.0,3.5891151428222656,693.3612158770201,1,619,-334,1846,637,960,600,20
1,0,0.05,1.0,-0.0,3.5960893630981445,692.4813164775273,1,618,-334,1846,637,960,600,20
1,0,0.05,1.0,-0.0,3.6050631999969482,691.6017388803994,1,617,-334,1846,637,960,600,20
1,0,0.05,1.0,-0.0,3.615039348602295,690.7224842974571,1,616,-334,1846,637,960,600,20
1,0,0.05,1.0,-0.0,3.6220362186431885,689.8435539461659,1,615,-334,1846,637,960,600,20
1,0,0.05,1.0,-0.0,3.6299986839294434,688.9649490496645,1,614,-334,1846,637,960,600,20
1,0,0.05,1.0,-0.0,3.639975070953369,688.0866708367952,1,613,-334,1846,637,960,600,20
1,0,0.05,1.0,-0.0,3.64794921875,687.2087205421343,1,612,-334,1846,637,960,600,20
1,0,0.05,1.0,-0.0,3.6559295654296875,686.3310994060225,1,611,-334,1846,637,960,600,20
1,0,0.05,1.0,-0.0,3.6629207134246826,685.4538086745948,1,610,-334,1846,637,960,600,20
1,0,0.05,1.0,-0.0,3.6718854904174805,684.5768495998121,1,609,-334,1846,637,960,600,20
1,0,0.06,1.0,-0.0,3.6808621883392334,683.7002234394912,1,608,-334,1846,637,960,600,20
1,0,0.06,1.0,-0.0,3.6878433227539062,682.8239314573365,1,607,-334,1846,637,960,600,20
1,0,0.06,1.0,-0.0,3.6968209743499756,681.9479749229706,1,606,-334,1846,637,960,600,20
1,0,0.06,1.0,-0.0,3.705796957015991,681.0723551119665,1,605,-334,1846,637,960,600,20
1,0,0.06,1.0,-0.0,3.7147717475891113,680.1970733058783,1,604,-334,1846,637,960,600,20
1,0,0.06,1.0,-0.0,3.7237484455108643,679.3221307922734,1,603,-334,1846,637,960,600,20
1,0,0.06,1.0,-0.0,3.73272442817688,678.447528864764,1,602,-334,1846,637,960,600,20
1,0,0.06,1.0,-0.0,3.7417008876800537,677.5732688230397,1,601,-334,1846,637,960,600,20
1,0,0.06,1.0,-0.0,3.751673936843872,676.6993519728994,1,600,-334,1846,637,960,600,20
1,0,0.06,1.0,-0.0,3.7606699466705322,675.8257796262839,1,599,-334,1846,637,960,600,20
1,0,0.06,1.0,-0.0,3.769627332687378,674.9525531013079,1,598,-334,1846,637,960,600,20
1,0,0.06,1.0,-0.0,3.7796013355255127,674.0796737222938,1,597,-334,1846,637,960,600,20
1,0,0.06,1.0,-0.0,3.7875783443450928,673.207142819804,1,596,-334,1846,637,960,600,20
1,0,0.06,1.0,-0.0,3.7965543270111084,672.3349617306737,1,595,-334,1846,637,960,600,20
1,0,0.06,1.0,-0.0,3.8035354614257812,671.4631317980453,1,594,-334,1846,637,960,600,20
1,0,0.06,1.0,-0.0,3.811516523361206,670.5916543714006,1,593,-334,1846,637,960,600,20
1,0,0.06,1.0,-0.0,3.8204917907714844,669.7205308065955,1,592,-334,1846,637,960,600,20
1,0,0.06,1.0,-0.0,3.82846999168396,668.8497624658935,1,591,-334,1846,637,960,600,20
1,0,0.06,1.0,-0.0,3.8364484310150146,667.9793507179994,1,590,-334,1846,637,960,600,20
1,0,0.06,1.0,-0.0,3.846421957015991,667.1092969380941,1,589,-334,1846,637,960,600,20
1,0,0.06,1.0,-0.0,3.853431224822998,666.2396025078685,1,588,-334,1846,637,960,600,20
1,0,0.06,1.0,-0.0,3.862380027770996,665.3702688155587,1,587,-334,1846,637,960,600,20
1,0,0.06,1.0,-0.0,3.8703582286834717,664.50129725598,1,586,-334,1846,637,960,600,20
1,0,0.06,1.0,-0.0,3.87833833694458,663.6326892305628,1,585,-334,1846,637,960,600,20
1,0,0.07,1.0,-0.0,3.8863441944122314,662.7644461473867,1,584,-334,1846,637,960,600,20
1,0,0.07,1.0,-0.0,3.895292282104492,661.8965694212168,1,583,-334,1846,637,960,600,20
1,0,0.07,1.0,-0.0,3.9022748470306396,661.0290604735386,1,582,-334,1846,637,960,600,20
1,0,0.07,1.0,-0.0,3.912247896194458,660.1619207325942,1,581,-334,1846,637,960,600,20
1,0,0.07,1.0,-0.0,3.920227289199829,659.295151633418,1,580,-334,1846,637,960,600,20
1,0,0.07,1.0,-0.0,3.9292025566101074,658.4287546178725,1,579,-334,1846,637,960,600,20
1,0,0.07,1.0,-0.0,3.938178062438965,657.5627311346852,1,578,-334,1846,637,960,600,20
1,0,0.07,1.0,-0.0,3.9471542835235596,656.6970826394847,1,577,-334,1846,637,960,600,20
1,0,0.07,1.0,-0.0,3.9561307430267334,655.8318105948379,1,576,-334,1846,637,960,600,20
1,0,0.07,1.0,-0.0,3.9651076793670654,654.9669164702858,1,575,-334,1846,637,960,600,20
1,0,0.07,1.0,-0.0,3.9740843772888184,654.1024017423819,1,574,-334,1846,637,960,600,20
1,0,0.07,1.0,-0.0,3.9830658435821533,653.2382678947288,1,573,-334,1846,637,960,600,20
1,0,0.07,1.0,-0.0,3.993032693862915,652.3745164180156,1,572,-334,1846,637,960,600,20
1,0,0.07,1.0,-0.0,4.001011610031128,651.5111488100559,1,571,-334,1846,637,960,600,20
1,0,0.07,1.0,-0.0,4.008991956710815,650.6481665758257,1,570,-334,1846,637,960,600,20
1,0,0.07,1.0,-0.0,4.017980337142944,649.7855712275011,1,569,-334,1846,637,960,600,20
1,0,0.07,1.0,-0.0,4.026942729949951,648.9233642844971,1,568,-334,1846,637,960,600,20
1,0,0.07,1.0,-0.0,4.034922361373901,648.0615472735054,1,567,-334,1846,637,960,600,20
1,0,0.07,1.0,-0.0,4.04289984703064,647.2001217285341,1,566,-334,1846,637,960,600,20
1,0,0.07,1.0,-0.0,4.050880193710327,646.3390891909455,1,565,-334,1846,637,960,600,20
1,0,0.07,1.0,-0.0,4.058865547180176,645.4784512094963,1,564,-334,1846,637,960,600,20
1,0,0.07,1.0,-0.0,4.06585168838501,644.6182093403758,1,563,-334,1846,637,960,600,20
1,0,0.07,1.0,-0.0,4.07581353187561,643.7583651472461,1,562,-334,1846,637,960,600,20
1,0,0.07,1.0,-0.0,4.082795143127441,642.898920201282,1,561,-334,1846,637,960,600,20
1,0,0.07,1.0,-0.0,4.091771841049194,642.0398760812102,1,560,-334,1846,637,960,600,20
1,0,0.08,1.0,-0.0,4.098751544952393,641.1812343733502,1,559,-334,1846,637,960,600,20
1,0,0.08,1.0,-0.0,4.107727766036987,640.3229966716539,1,558,-334,1846,637,960,600,20
1,0,0.08,1.0,-0.0,4.116704225540161,639.465164577747,1,557,-334,1846,637,960,600,20
1,0,0.08,1.0,-0.0,4.1256818771362305,638.607739700969,1,556,-334,1846,637,960,600,20
1,0,0.08,1.0,-0.0,4.135654926300049,637.7507236584148,1,555,-334,1846,637,960,600,20
1,0,0.08,1.0,-0.0,4.145626783370972,636.8941180749753,1,554,-334,1846,637,960,600,20
1,0,0.08,1.0,-0.0,4.155600547790527,636.0379245833792,1,553,-334,1846,637,960,600,20
1,0,0.08,1.0,-0.0,4.163581132888794,635.1821448242349,1,552,-334,1846,637,960,600,20
1,0,0.08,1.0,-0.0,4.170560598373413,634.3267804460714,1,551,-334,1846,637,960,600,20
1,0,0.08,1.0,-0.0,4.18053412437439,633.4718331053815,1,550,-334,1846,637,960,600,20
1,0,0.08,1.0,-0.0,4.187515497207642,632.6173044666631,1,549,-334,1846,637,960,600,20
1,0,0.08,1.0,-0.0,4.196492910385132,631.7631962024622,1,548,-334,1846,637,960,600,20
1,0,0.08,1.0,-0.0,4.203993082046509,630.9095099934156,1,547,-334,1846,637,960,600,20
1,0,0.08,1.0,-0.0,4.2129693031311035,630.0562475282934,1,546,-334,1846,637,960,600,20
1,0,0.08,1.0,-0.0,4.220948219299316,629.203410504043,1,545,-334,1846,637,960,600,20
1,0,0.08,1.0,-0.0,4.228928565979004,628.3510006258313,1,544,-334,1846,637,960,600,20
1,0,0.08,1.0,-0.0,4.236910581588745,627.4990196070893,1,543,-334,1846,637,960,600,20
1,0,0.08,1.0,-0.0,4.244884967803955,626.6474691695554,1,542,-334,1846,637,960,600,20
1,0,0.08,1.0,-0.0,4.254868984222412,625.7963510433195,1,541,-334,1846,637,960,600,20
1,0,0.08,1.0,-0.0,4.262838363647461,624.9456669668673,1,540,-334,1846,637,960,600,20
1,0,0.09,1.0,-0.0,4.270815372467041,624.0954186871247,1,539,-334,1846,637,960,600,20
1,0,0.09,1.0,-0.0,4.279792070388794,623.2456079595025,1,538,-334,1846,637,960,600,20
1,0,0.09,1.0,-0.0,4.288768768310547,622.3962365479415,1,537,-334,1846,637,960,600,20
1,0,0.09,1.0,-0.0,4.297745943069458,621.5473062249573,1,536,-334,1846,637,960,600,20
1,0,0.09,1.0,-0.0,4.304727077484131,620.698818771686,1,535,-334,1846,637,960,600,20
1,0,0.09,1.0,-0.0,4.31469988822937,619.8507759779295,1,534,-334,1846,637,960,600,20
1,0,0.09,1.0,-0.0,4.32267951965332,619.0031796422018,1,533,-334,1846,637,960,600,20
1,0,0.09,1.0,-0.0,4.331655740737915,618.1560315717744,1,532,-334,1846,637,960,600,20
1,0,0.09,1.0,-0.0,4.34162712097168,617.309333582723,1,531,-334,1846,637,960,600,20
1,0,0.09,1.0,-0.0,4.351602077484131,616.4630874999739,1,530,-334,1846,637,960,600,20
1,0,0.09,1.0,-0.0,4.359579801559448,615.617295157351,1,529,-334,1846,637,960,600,20
1,0,0.09,1.0,-0.0,4.36755895614624,614.771958397622,1,528,-334,1846,637,960,600,20
1,0,0.09,1.0,-0.0,4.37454080581665,613.9270790725467,1,527,-334,1846,637,960,600,20
1,0,0.09,1.0,-0.0,4.3845133781433105,613.0826590429234,1,526,-334,1846,637,960,600,20
1,0,0.09,1.0,-0.0,4.391495943069458,612.2387001786373,1,525,-334,1846,637,960,600,20
1,0,0.09,1.0,-0.0,4.401468515396118,611.3952043587076,1,524,-334,1846,637,960,600,20
1,0,0.09,1.0,-0.0,4.409447193145752,610.5521734713367,1,523,-334,1846,637,960,600,20
1,0,0.1,1.0,-0.0,4.417426109313965,609.7096094139577,1,522,-334,1846,637,960,600,20
1,0,0.1,1.0,-0.0,4.425405979156494,608.8675140932831,1,521,-334,1846,637,960,600,20
1,0,0.1,1.0,-0.0,4.43338418006897,608.0258894253541,1,520,-334,1846,637,960,600,20
1,0,0.1,1.0,-0.0,4.442359685897827,607.184737335589,1,519,-334,1846,637,960,600,20
1,0,0.1,1.0,-0.0,4.450338840484619,606.344059758833,1,518,-334,1846,637,960,600,20
1,0,0.1,1.0,-0.0,4.458317995071411,605.5038586394077,1,517,-334,1846,637,960,600,20
1,0,0.1,1.0,-0.0,4.466297626495361,604.6641359311603,1,516,-334,1846,637,960,600,20
1,0,0.1,1.0,-0.0,4.4742748737335205,603.8248935975145,1,515,-334,1846,637,960,600,20
1,0,0.1,1.0,-0.0,4.482254505157471,602.9861336115198,1,514,-334,1846,637,960,600,20
1,0,0.1,1.0,-0.0,4.490232944488525,602.1478579559026,1,513,-334,1846,637,960,600,20
1,0,0.1,1.0,-0.0,4.498212814331055,601.310068623117,1,512,-334,1846,637,960,600,20
1,0,0.1,1.0,-0.0,4.50619101524353,600.4727676153949,1,511,-334,1846,637,960,600,20
1,0,0.1,1.0,-0.0,4.514168977737427,599.6359569447983,1,510,-334,1846,637,960,600,20
1,0,0.1,1.0,-0.0,4.521150350570679,598.7996386332699,1,509,-334,1846,637,960,600,20
1,0,0.1,1.0,-0.0,4.530126571655273,597.963814712685,1,508,-334,1846,637,960,600,20
1,0,0.1,1.0,-0.0,4.538105487823486,597.1284872249037,1,507,-334,1846,637,960,600,20
1,0,0.11,1.0,-0.0,4.546111583709717,596.2936582218224,1,506,-334,1846,637,960,600,20
1,0,0.11,1.0,-0.0,4.5540642738342285,595.4593297654269,1,505,-334,1846,637,960,600,20
1,0,0.11,1.0,-0.0,4.563039064407349,594.6255039278445,1,504,-334,1846,637,960,600,20
1,0,0.11,1.0,-0.0,4.570021867752075,593.7921827913972,1,503,-334,1846,637,960,600,20
1,0,0.11,1.0,-0.0,4.5780205726623535,592.9593684486542,1,502,-334,1846,637,960,600,20
1,0,0.11,1.0,-0.0,4.586976051330566,592.1270630024862,1,501,-334,1846,637,960,600,20
1,0,0.11,1.0,-0.0,4.59695029258728,591.295268566118,1,500,-334,1846,637,960,600,20
1,0,0.11,1.0,-0.0,4.606936693191528,590.463987263183,1,499,-334,1846,637,960,600,20
1,0,0.11,1.0,-0.0,4.615898609161377,589.6332212277769,1,498,-334,1846,637,960,600,20
1,0,0.11,1.0,-0.0,4.622882127761841,588.8029726045121,1,497,-334,1846,637,960,600,20
1,0,0.11,1.0,-0.0,4.632866859436035,587.9732435485722,1,496,-334,1846,637,960,600,20
1,0,0.11,1.0,-0.0,4.640834331512451,587.1440362257669,1,495,-334,1846,637,960,600,20
1,0,0.12,1.0,-0.0,4.650805950164795,586.3153528125869,1,494,-334,1846,637,960,600,20
1,0,0.12,1.0,-0.0,4.658786296844482,585.4871954962592,1,493,-334,1846,637,960,600,20
1,0,0.12,1.0,-0.0,4.6677610874176025,584.6595664748024,1,492,-334,1846,637,960,600,20
1,0,0.12,1.0,-0.0,4.675745725631714,583.8324679570829,1,491,-334,1846,637,960,600,20
1,0,0.12,1.0,-0.0,4.683718681335449,583.0059021628706,1,490,-334,1846,637,960,600,20
1,0,0.12,1.0,-0.0,4.690700054168701,582.1798713228945,1,489,-334,1846,637,960,600,20
1,0,0.12,1.0,-0.0,4.699676036834717,581.3543776789007,1,488,-334,1846,637,960,600,20
1,0,0.12,1.0,-0.0,4.70965051651001,580.5294234837075,1,487,-334,1846,637,960,600,20
1,0,0.12,1.0,-0.0,4.718626022338867,579.7050110012632,1,486,-334,1846,637,960,600,20
1,0,0.12,1.0,-0.0,4.727603435516357,578.8811425067031,1,485,-334,1846,637,960,600,20
1,0,0.12,1.0,-0.0,4.736578941345215,578.0578202864069,1,484,-334,1846,637,960,600,20
1,0,0.12,1.0,-0.0,4.745555400848389,577.2350466380561,1,483,-334,1846,637,960,600,20
1,0,0.13,1.0,-0.0,4.754532098770142,576.4128238706927,1,482,-334,1846,637,960,600,20
1,0,0.13,1.0,-0.0,4.764503717422485,575.5911543047761,1,481,-334,1846,637,960,600,20
1,0,0.13,1.0,-0.0,4.771485090255737,574.7700402722425,1,480,-334,1846,637,960,600,20
1,0,0.13,1.0,-0.0,4.780461549758911,573.949484116563,1,479,-334,1846,637,960,600,20
1,0,0.13,1.0,-0.0,4.789438486099243,573.1294881928027,1,478,-334,1846,637,960,600,20
1,0,0.13,1.0,-0.0,4.797416687011719,572.3100548676796,1,477,-334,1846,637,960,600,20
1,0,0.13,1.0,-0.0,4.806394100189209,571.4911865196239,1,476,-334,1846,637,960,600,20
1,0,0.13,1.0,-0.0,4.816366195678711,570.6728855388376,1,475,-334,1846,637,960,600,20
1,0,0.13,1.0,-0.0,4.824345111846924,569.8551543273544,1,474,-334,1846,637,960,600,20
1,0,0.13,1.0,-0.0,4.832324743270874,569.0379952990995,1,473,-334,1846,637,960,600,20
1,0,0.14,1.0,-0.0,4.840303897857666,568.22141087995,1,472,-334,1846,637,960,600,20
1,0,0.14,1.0,-0.0,4.848281621932983,567.4054035077954,1,471,-334,1846,637,960,600,20
1,0,0.14,1.0,-0.0,4.856261730194092,566.589975632598,1,470,-334,1846,637,960,600,20
1,0,0.14,1.0,-0.0,4.86423921585083,565.7751297164544,1,469,-334,1846,637,960,600,20
1,0,0.14,1.0,-0.0,4.871220350265503,564.9608682336564,1,468,-334,1846,637,960,600,20
1,0,0.14,1.0,-0.0,4.8801963329315186,564.147193670752,1,467,-334,1846,637,960,600,20
1,0,0.14,1.0,-0.0,4.88817572593689,563.3341085266077,1,466,-334,1846,637,960,600,20
1,0,0.14,1.0,-0.0,4.897151947021484,562.5216153124701,1,465,-334,1846,637,960,600,20
1,0,0.14,1.0,-0.0,4.907148122787476,561.7097165520278,1,464,-334,1846,637,960,600,20
1,0,0.15,1.0,-0.0,4.9151036739349365,560.8984147814741,1,463,-334,1846,637,960,600,20
1,0,0.15,1.0,-0.0,4.923083066940308,560.087712549569,1,462,-334,1846,637,960,600,20
1,0,0.15,1.0,-0.0,4.931071519851685,559.2776124177026,1,461,-334,1846,637,960,600,20
1,0,0.15,1.0,-0.0,4.939040899276733,558.4681169599576,1,460,-334,1846,637,960,600,20
1,0,0.15,1.0,-0.0,4.947018623352051,557.6592287631727,1,459,-334,1846,637,960,600,20
1,0,0.15,1.0,-0.0,4.954999208450317,556.850950427006,1,458,-334,1846,637,960,600,20
1,0,0.15,1.0,-0.0,4.962976455688477,556.0432845639987,1,457,-334,1846,637,960,600,20
1,0,0.15,1.0,-0.0,4.970968961715698,555.2362337996389,1,456,-334,1846,637,960,600,20
1,0,0.15,1.0,-0.0,4.979931592941284,554.4298007724256,1,455,-334,1846,637,960,600,20
1,0,0.15,1.0,-0.0,4.988907814025879,553.6239881339332,1,454,-334,1846,637,960,600,20
1,0,0.15,1.0,-0.0,4.996886491775513,552.8187985488757,1,453,-334,1846,637,960,600,20
1,0,0.15,1.0,-0.0,5.00386905670166,552.0142346951721,1,452,-334,1846,637,960,600,20
1,0,0.16,1.0,-0.0,5.012844800949097,551.2102992640102,1,451,-334,1846,637,960,600,20
1,0,0.16,1.0,-0.0,5.01982569694519,550.406994959913,1,450,-334,1846,637,960,600,20
1,0,0.16,1.0,-0.0,5.029798746109009,549.6043245008029,1,449,-334,1846,637,960,600,20
1,0,0.16,1.0,-0.0,5.036780595779419,548.8022906180682,1,448,-334,1846,637,960,600,20
1,0,0.16,1.0,-0.0,5.0467634201049805,548.0008960566282,1,447,-334,1846,637,960,600,20
1,0,0.16,1.0,-0.0,5.05573034286499,547.2001435749994,1,446,-334,1846,637,960,600,20
1,0,0.16,1.0,-0.0,5.063709020614624,546.4000359453619,1,445,-334,1846,637,960,600,20
1,0,0.16,1.0,-0.0,5.0726847648620605,545.6005759536251,1,444,-334,1846,637,960,600,20
1,0,0.16,1.0,-0.0,5.080663442611694,544.8017663994951,1,443,-334,1846,637,960,600,20
1,0,0.16,1.0,-0.0,5.090638875961304,544.0036100965408,1,442,-334,1846,637,960,600,20
1,0,0.16,1.0,-0.0,5.098617315292358,543.2061098722609,1,441,-334,1846,637,960,600,20
1,0,0.16,1.0,-0.0,5.106596231460571,542.4092685681513,1,440,-334,1846,637,960,600,20
1,0,0.16,1.0,-0.0,5.115574359893799,541.6130890397725,1,439,-334,1846,637,960,600,20
1,0,0.16,1.0,-0.0,5.122552156448364,540.8175741568165,1,438,-334,1846,637,960,600,20
1,0,0.16,1.0,-0.0,5.13153862953186,540.0227268031749,1,437,-334,1846,637,960,600,20
1,0,0.16,1.0,-0.0,5.13850998878479,539.228549877007,1,436,-334,1846,637,960,600,20
1,0,0.16,1.0,-0.0,5.147498846054077,538.4350462908073,1,435,-334,1846,637,960,600,20
1,0,0.17,1.0,-0.0,5.157470941543579,537.6422189714741,1,434,-334,1846,637,960,600,20
1,0,0.17,1.0,-0.0,5.164469242095947,536.8500708603776,1,433,-334,1846,637,960,600,20
1,0,0.17,1.0,-0.0,5.17341685295105,536.0586049134287,1,432,-334,1846,637,960,600,20
1,0,0.17,1.0,-0.0,5.183391332626343,535.2678241011475,1,431,-334,1846,637,960,600,20
1,0,0.17,1.0,-0.0,5.190372943878174,534.4777314087327,1,430,-334,1846,637,960,600,20
1,0,0.17,1.0,-0.0,5.199350833892822,533.6883298361296,1,429,-334,1846,637,960,600,20
1,0,0.17,1.0,-0.0,5.208012819290161,532.8996223981004,1,428,-334,1846,637,960,600,20
1,0,0.17,1.0,-0.0,5.215982437133789,532.1116121242931,1,427,-334,1846,637,960,600,20
1,0,0.17,1.0,-0.0,5.223963260650635,531.3243020593109,1,426,-334,1846,637,960,600,20
1,0,0.17,1.0,-0.0,5.232936859130859,530.5376952627819,1,425,-334,1846,637,960,600,20
1,0,0.17,1.0,-0.0,5.239919900894165,529.751794809429,1,424,-334,1846,637,960,600,20
1,0,0.17,1.0,-0.0,5.2489049434661865,528.9666037891402,1,423,-334,1846,637,960,600,20
1,0,0.17,1.0,-0.0,5.256873369216919,528.1821253070377,1,422,-334,1846,637,960,600,20
1,0,0.17,1.0,-0.0,5.264852523803711,527.398362483549,1,421,-334,1846,637,960,600,20
1,0,0.17,1.0,-0.0,5.274826765060425,526.6153184544772,1,420,-334,1846,637,960,600,20
1,0,0.17,1.0,-0.0,5.282806396484375,525.8329963710709,1,419,-334,1846,637,960,600,20
1,0,0.17,1.0,-0.0,5.290783405303955,525.051399400095,1,418,-334,1846,637,960,600,20
1,0,0.18,1.0,-0.0,5.298762798309326,524.2705307239021,1,417,-334,1846,637,960,600,20
1,0,0.18,1.0,-0.0,5.307738780975342,523.4903935405023,1,416,-334,1846,637,960,600,20
1,0,0.18,1.0,-0.0,5.314719915390015,522.7109910636348,1,415,-334,1846,637,960,600,20
1,0,0.18,1.0,-0.0,5.323719024658203,521.9323265228388,1,414,-334,1846,637,960,600,20
1,0,0.18,1.0,-0.0,5.332684755325317,521.1544031635245,1,413,-334,1846,637,960,600,20
1,0,0.18,1.0,-0.0,5.3426737785339355,520.3772242470448,1,412,-334,1846,637,960,600,20
1,0,0.18,1.0,-0.0,5.352619171142578,519.6007930507658,1,411,-334,1846,637,960,600,20
1,0,0.18,1.0,-0.0,5.359600782394409,518.8251128681391,1,410,-334,1846,637,960,600,20
1,0,0.18,1.0,-0.0,5.369575262069702,518.0501870087729,1,409,-334,1846,637,960,600,20
1,0,0.18,1.0,-0.0,5.376555681228638,517.2760187985036,1,408,-334,1846,637,960,600,20
1,0,0.18,1.0,-0.0,5.38654088973999,516.5026115794678,1,407,-334,1846,637,960,600,20
1,0,0.18,1.0,-0.0,5.394507884979248,515.7299687101735,1,406,-334,1846,637,960,600,20
1,0,0.19,1.0,-0.0,5.402488470077515,514.9580935655722,1,405,-334,1846,637,960,600,20
1,0,0.19,1.0,-0.0,5.410473823547363,514.1869895371308,1,404,-334,1846,637,960,600,20
1,0,0.19,1.0,-0.0,5.417447566986084,513.4166600329035,1,403,-334,1846,637,960,600,20
1,0,0.19,1.0,-0.0,5.4264349937438965,512.6471084776036,1,402,-334,1846,637,960,600,20
1,0,0.19,1.0,-0.0,5.435400485992432,511.8783383126761,1,401,-334,1846,637,960,600,20
1,0,0.19,1.0,-0.0,5.442396402359009,511.11035299636876,1,400,-334,1846,637,960,600,20
1,0,0.19,1.0,-0.0,5.451357841491699,510.3431560038049,1,399,-334,1846,637,960,600,20
1,0,0.19,1.0,-0.0,5.459336996078491,509.57675082705543,1,398,-334,1846,637,960,600,20
1,0,0.19,1.0,-0.0,5.466318130493164,508.8111409752107,1,397,-334,1846,637,960,600,20
1,0,0.19,1.0,-0.0,5.475319147109985,508.0463299744531,1,396,-334,1846,637,960,600,20
1,0,0.19,1.0,-0.0,5.484269618988037,507.2823213681287,1,395,-334,1846,637,960,600,20
1,0,0.2,1.0,-0.0,5.491252422332764,506.51911871681966,1,394,-334,1846,637,960,600,20
1,0,0.2,1.0,-0.0,5.500227451324463,505.7567255984162,1,393,-334,1846,637,960,600,20
1,0,0.2,1.0,-0.0,5.509132146835327,504.9951456081892,1,392,-334,1846,637,960,600,20
1,0,0.2,1.0,-0.0,5.518059492111206,504.2343823588617,1,391,-334,1846,637,960,600,20
1,0,0.2,1.0,-0.0,5.527028322219849,503.47443948068144,1,390,-334,1846,637,960,600,20
1,0,0.2,1.0,-0.0,5.536004543304443,502.71532062149265,1,389,-334,1846,637,960,600,20
1,0,0.2,1.0,-0.0,5.544982194900513,501.9570294468082,1,388,-334,1846,637,960,600,20
1,0,0.2,1.0,-0.0,5.553958415985107,501.1995696398814,1,387,-334,1846,637,960,600,20
1,0,0.2,1.0,-0.0,5.563974857330322,500.44294490177845,1,386,-334,1846,637,960,600,20
1,0,0.2,1.0,-0.0,5.570911884307861,499.68715895144936,1,385,-334,1846,637,960,600,20
1,0,0.21,1.0,-0.0,5.580885410308838,498.93221552580064,1,384,-334,1846,637,960,600,20
1,0,0.21,1.0,-0.0,5.589862585067749,498.17811837976654,1,383,-334,1846,637,960,600,20
1,0,0.21,1.0,-0.0,5.597840309143066,497.42487128638066,1,382,-334,1846,637,960,600,20
1,0,0.21,1.0,-0.0,5.604821681976318,496.6724780368478,1,381,-334,1846,637,960,600,20
1,0,0.21,1.0,-0.0,5.61379861831665,495.9209424406149,1,380,-334,1846,637,960,600,20
1,0,0.21,1.0,-0.0,5.621777534484863,495.1702683254429,1,379,-334,1846,637,960,600,20
1,0,0.21,1.0,-0.0,5.631750583648682,494.42045953747754,1,378,-334,1846,637,960,600,20
1,0,0.21,1.0,-0.0,5.639757394790649,493.67151994132047,1,377,-334,1846,637,960,600,20
1,0,0.21,1.0,-0.0,5.647709131240845,492.9234534201005,1,376,-334,1846,637,960,600,20
1,0,0.21,1.0,-0.0,5.657682657241821,492.176263875544,1,375,-334,1846,637,960,600,20
1,0,0.22,1.0,-0.0,5.666660785675049,491.4299552280458,1,374,-334,1846,637,960,600,20
1,0,0.22,1.0,-0.0,5.674638032913208,490.6845314167395,1,373,-334,1846,637,960,600,20
1,0,0.22,1.0,-0.0,5.685620069503784,489.9399963995679,1,372,-334,1846,637,960,600,20
1,0,0.22,1.0,-0.0,5.692611217498779,489.1963541533532,1,371,-334,1846,637,960,600,20
1,0,0.22,1.0,-0.0,5.701565265655518,488.4536086738665,1,370,-334,1846,637,960,600,20
1,0,0.22,1.0,-0.0,5.709543704986572,487.711763975898,1,369,-334,1846,637,960,600,20
1,0,0.22,1.0,-0.0,5.7175233364105225,486.9708240933264,1,368,-334,1846,637,960,600,20
1,0,0.22,1.0,-0.0,5.725503921508789,486.2307930791881,1,367,-334,1846,637,960,600,20
1,0,0.22,1.0,-0.0,5.732482671737671,485.4916750057462,1,366,-334,1846,637,960,600,20
1,0,0.22,1.0,-0.0,5.741458892822266,484.7534739645594,1,365,-334,1846,637,960,600,20
1,0,0.23,1.0,-0.0,5.751432418823242,484.01619406655084,1,364,-334,1846,637,960,600,20
1,0,0.23,1.0,-0.0,5.759410858154297,483.27983944207574,1,363,-334,1846,637,960,600,20
1,0,0.23,1.0,-0.0,5.766392469406128,482.54441424099,1,362,-334,1846,637,960,600,20
1,0,0.23,1.0,-0.0,5.775368690490723,481.8099226327179,1,361,-334,1846,637,960,600,20
1,0,0.23,1.0,-0.0,5.784344434738159,481.0763688063192,1,360,-334,1846,637,960,600,20
1,0,0.23,1.0,-0.0,5.7933220863342285,480.34375697055634,1,359,-334,1846,637,960,600,20
1,0,0.23,1.0,-0.0,5.803295373916626,479.61209135396155,1,358,-334,1846,637,960,600,20
1,0,0.23,1.0,-0.0,5.811286687850952,478.8813762049031,1,357,-334,1846,637,960,600,20
1,0,0.23,1.0,-0.0,5.819252252578735,478.15161579165135,1,356,-334,1846,637,960,600,20
1,0,0.23,1.0,-0.0,5.82723069190979,477.42281440244466,1,355,-334,1846,637,960,600,20
1,0,0.23,1.0,-0.0,5.836208343505859,476.69497634555466,1,354,-334,1846,637,960,600,20
1,0,0.23,1.0,-0.0,5.84419584274292,475.96810594935135,1,353,-334,1846,637,960,600,20
1,0,0.23,1.0,-0.0,5.852165222167969,475.24220756236775,1,352,-334,1846,637,960,600,20
1,0,0.23,1.0,-0.0,5.860143661499023,474.51728555336393,1,351,-334,1846,637,960,600,20
1,0,0.23,1.0,-0.0,5.867124795913696,473.79334431139085,1,350,-334,1846,637,960,600,20
1,0,0.23,1.0,-0.0,5.877099275588989,473.0703882458539,1,349,-334,1846,637,960,600,20
1,0,0.23,1.0,-0.0,5.884079694747925,472.34842178657533,1,348,-334,1846,637,960,600,20
1,0,0.23,1.0,-0.0,5.894053220748901,471.62744938385725,1,347,-334,1846,637,960,600,20
1,0,0.23,1.0,-0.0,5.90205979347229,470.90747550854314,1,346,-334,1846,637,960,600,20
1,0,0.24,1.0,-0.0,5.9090142250061035,470.1885046520793,1,345,-334,1846,637,960,600,20
1,0,0.24,1.0,-0.0,5.917989492416382,469.4705413265762,1,344,-334,1846,637,960,600,20
1,0,0.24,1.0,-0.0,5.924996852874756,468.7535900648683,1,343,-334,1846,637,960,600,20
1,0,0.24,1.0,-0.0,5.933946847915649,468.0376554205746,1,342,-334,1846,637,960,600,20
1,0,0.24,1.0,-0.0,5.94295334815979,467.32274196815723,1,341,-334,1846,637,960,600,20
1,0,0.24,1.0,-0.0,5.951901197433472,466.60885430298083,1,340,-334,1846,637,960,600,20
1,0,0.24,1.0,-0.0,5.960885763168335,465.8959970413704,1,339,-334,1846,637,960,600,20
1,0,0.24,1.0,-0.0,5.969851732254028,465.1841748206689,1,338,-334,1846,637,960,600,20
1,0,0.24,1.0,-0.0,5.977830410003662,464.4733922992943,1,337,-334,1846,637,960,600,20
1,0,0.24,1.0,-0.0,5.985810279846191,463.7636541567958,1,336,-334,1846,637,960,600,20
1,0,0.24,1.0,-0.0,5.994786977767944,463.0549650939096,1,335,-334,1846,637,960,600,20
1,0,0.24,1.0,-0.0,6.003761529922485,462.34732983261375,1,334,-334,1846,637,960,600,20
1,0,0.24,1.0,-0.0,6.013735055923462,461.6407531161827,1,333,-334,1846,637,960,600,20
1,0,0.24,1.0,-0.0,6.021714687347412,460.9352397092407,1,332,-334,1846,637,960,600,20
1,0,0.24,1.0,-0.0,6.031687259674072,460.2307943978148,1,331,-334,1846,637,960,600,20
1,0,0.24,1.0,-0.0,6.03966760635376,459.5274219893871,1,330,-334,1846,637,960,600,20
1,0,0.24,1.0,-0.0,6.047646999359131,458.825127312946,1,329,-334,1846,637,960,600,20
1,0,0.24,1.0,-0.0,6.055624961853027,458.12391521903686,1,328,-334,1846,637,960,600,20
1,0,0.24,1.0,-0.0,6.064600944519043,457.4237905798121,1,327,-334,1846,637,960,600,20
1,0,0.24,1.0,-0.0,6.072579383850098,456.72475828907983,1,326,-334,1846,637,960,600,20
1,0,0.24,1.0,-0.0,6.081555128097534,456.0268232623526,1,325,-334,1846,637,960,600,20
1,0,0.25,1.0,-0.0,6.088536262512207,455.32999043689415,1,324,-334,1846,637,960,600,20
1,0,0.25,1.0,-0.0,6.098510026931763,454.6342647717665,1,323,-334,1846,637,960,600,20
1,0,0.25,1.0,-0.0,6.1064887046813965,453.93965124787513,1,322,-334,1846,637,960,600,20
1,0,0.25,1.0,-0.0,6.115466356277466,453.246154868014,1,321,-334,1846,637,960,600,20
1,0,0.25,1.0,-0.0,6.123443603515625,452.5537806569091,1,320,-334,1846,637,960,600,20
1,0,0.25,1.0,-0.0,6.131422519683838,451.8625336612616,1,319,-334,1846,637,960,600,20
1,0,0.25,1.0,-0.0,6.139401435852051,451.17241894978935,1,318,-334,1846,637,960,600,20
1,0,0.25,1.0,-0.0,6.1483776569366455,450.483441613268,1,317,-334,1846,637,960,600,20
1,0,0.25,1.0,-0.0,6.155358552932739,449.795606764571,1,316,-334,1846,637,960,600,20
1,0,0.25,1.0,-0.0,6.164335250854492,449.10891953870816,1,315,-334,1846,637,960,600,20
1,0,0.25,1.0,-0.0,6.173312187194824,448.42338509286367,1,314,-334,1846,637,960,600,20
1,0,0.25,1.0,-0.0,6.182288885116577,447.73900860643283,1,313,-334,1846,637,960,600,20
1,0,0.25,1.0,-0.0,6.1922607421875,447.05579528105756,1,312,-334,1846,637,960,600,20
1,0,0.25,1.0,-0.0,6.199242115020752,446.37375034066105,1,311,-334,1846,637,960,600,20
1,0,0.25,1.0,-0.0,6.208218336105347,445.692879031481,1,310,-334,1846,637,960,600,20
1,0,0.26,1.0,-0.0,6.2171947956085205,445.0131866221022,1,309,-334,1846,637,960,600,20
1,0,0.26,1.0,-0.0,6.226171255111694,444.33467840348703,1,308,-334,1846,637,960,600,20
1,0,0.26,1.0,-0.0,6.235146999359131,443.65735968900583,1,307,-334,1846,637,960,600,20
1,0,0.26,1.0,-0.0,6.2441229820251465,442.98123581446504,1,306,-334,1846,637,960,600,20
1,0,0.26,1.0,-0.0,6.2511045932769775,442.306312138135,1,305,-334,1846,637,960,600,20
1,0,0.26,1.0,-0.0,6.260082721710205,441.6325940407756,1,304,-334,1846,637,960,600,20
1,0,0.26,1.0,-0.0,6.270055770874023,440.9600869256613,1,303,-334,1846,637,960,600,20
1,0,0.26,1.0,-0.0,6.27703595161438,440.2887962186046,1,302,-334,1846,637,960,600,20
1,0,0.26,1.0,-0.0,6.287009239196777,439.61872736797784,1,301,-334,1846,637,960,600,20
1,0,0.26,1.0,-0.0,6.294987678527832,438.94988584473435,1,300,-334,1846,637,960,600,20
1,0,0.26,1.0,-0.0,6.303964138031006,438.2822771424273,1,299,-334,1846,637,960,600,20
1,0,0.26,1.0,-0.0,6.31194281578064,437.6159067772279,1,298,-334,1846,637,960,600,20
1,0,0.26,1.0,-0.0,6.320919036865234,436.95078028794177,1,297,-334,1846,637,960,600,20
1,0,0.26,1.0,-0.0,6.3289079666137695,436.2869032360237,1,296,-334,1846,637,960,600,20
1,0,0.26,1.0,-0.0,6.33587908744812,435.6242812055914,1,295,-334,1846,637,960,600,20
1,0,0.27,1.0,-0.0,6.345852613449097,434.9629198034371,1,294,-334,1846,637,960,600,20
1,0,0.27,1.0,-0.0,6.352833986282349,434.30282465903815,1,293,-334,1846,637,960,600,20
1,0,0.27,1.0,-0.0,6.361810207366943,433.64400142456566,1,292,-334,1846,637,960,600,20
1,0,0.27,1.0,-0.0,6.370786428451538,432.9864557748916,1,291,-334,1846,637,960,600,20
1,0,0.27,1.0,-0.0,6.379762411117554,432.33019340759455,1,290,-334,1846,637,960,600,20
1,0,0.27,1.0,-0.0,6.3887388706207275,431.67522004296325,1,289,-334,1846,637,960,600,20
1,0,0.27,1.0,-0.0,6.397714614868164,431.02154142399894,1,288,-334,1846,637,960,600,20
1,0,0.27,1.0,-0.0,6.407688617706299,430.3691633164157,1,287,-334,1846,637,960,600,20
1,0,0.28,1.0,-0.0,6.416665077209473,429.7180915086392,1,286,-334,1846,637,960,600,20
1,0,0.28,1.0,-0.0,6.425640344619751,429.06833181180355,1,285,-334,1846,637,960,600,20
1,0,0.28,1.0,-0.0,6.43462872505188,428.41989005974625,1,284,-334,1846,637,960,600,20
1,0,0.28,1.0,-0.0,6.443596839904785,427.7727721090018,1,283,-334,1846,637,960,600,20
1,0,0.28,1.0,-0.0,6.453567028045654,427.12698383879257,1,282,-334,1846,637,960,600,20
1,0,0.28,1.0,-0.0,6.462543249130249,426.4825311510187,1,281,-334,1846,637,960,600,20
1,0,0.28,1.0,-0.0,6.470521450042725,425.83941997024544,1,280,-334,1846,637,960,600,20
1,0,0.29,1.0,-0.0,6.477502822875977,425.19765624368887,1,279,-334,1846,637,960,600,20
1,0,0.29,1.0,-0.0,6.486479759216309,424.5572459411993,1,278,-334,1846,637,960,600,20
1,0,0.29,1.0,-0.0,6.496452569961548,423.9181950552431,1,277,-334,1846,637,960,600,20
1,0,0.29,1.0,-0.0,6.504431247711182,423.280509600882,1,276,-334,1846,637,960,600,20
1,0,0.29,1.0,-0.0,6.511412620544434,422.64419561575073,1,275,-334,1846,637,960,600,20
1,0,0.29,1.0,-0.0,6.520388841629028,422.00925916003234,1,274,-334,1846,637,960,600,20
1,0,0.3,1.0,-0.0,6.528367280960083,421.3757063164313,1,273,-334,1846,637,960,600,20
1,0,0.3,1.0,-0.0,6.537344455718994,420.74354319014463,1,272,-334,1846,637,960,600,20
1,0,0.3,1.0,-0.0,6.54532265663147,420.11277590883066,1,271,-334,1846,637,960,600,20
1,0,0.3,1.0,-0.0,6.5552966594696045,419.4834106225757,1,270,-334,1846,637,960,600,20
1,0,0.3,1.0,-0.0,6.565276861190796,418.8554535038583,1,269,-334,1846,637,960,600,20
1,0,0.31,1.0,-0.0,6.573249816894531,418.2289107475113,1,268,-334,1846,637,960,600,20
1,0,0.31,1.0,-0.0,6.582226037979126,417.6037885706814,1,267,-334,1846,637,960,600,20
1,0,0.31,1.0,-0.0,6.591222763061523,416.9800932127867,1,266,-334,1846,637,960,600,20
1,0,0.31,1.0,-0.0,6.600178003311157,416.3578309354714,1,265,-334,1846,637,960,600,20
1,0,0.31,1.0,-0.0,6.609153985977173,415.7370080225584,1,264,-334,1846,637,960,600,20
1,0,0.32,1.0,-0.0,6.619128704071045,415.1176307799995,1,263,-334,1846,637,960,600,20
1,0,0.32,1.0,-0.0,6.626135349273682,414.4997055358225,1,262,-334,1846,637,960,600,20
1,0,0.32,1.0,-0.0,6.63508415222168,413.88323864007646,1,261,-334,1846,637,960,600,20
1,0,0.32,1.0,-0.0,6.644061803817749,413.2682364647742,1,260,-334,1846,637,960,600,20
1,0,0.32,1.0,-0.0,6.654035329818726,412.654705403832,1,259,-334,1846,637,960,600,20
1,0,0.32,1.0,-0.0,6.662012577056885,412.0426518730068,1,258,-334,1846,637,960,600,20
1,0,0.32,1.0,-0.0,6.668993949890137,411.4320823098308,1,257,-334,1846,637,960,600,20
1,0,0.32,1.0,-0.0,6.676974534988403,410.82300317354327,1,256,-334,1846,637,960,600,20
1,0,0.32,1.0,-0.0,6.687944173812866,410.21542094501956,1,255,-334,1846,637,960,600,20
1,0,0.32,1.0,-0.0,6.694926500320435,409.60934212669764,1,254,-334,1846,637,960,600,20
1,0,0.32,1.0,-0.0,6.703902959823608,409.00477324250136,1,253,-334,1846,637,960,600,20
1,0,0.32,1.0,-0.0,6.712878465652466,408.4017208377614,1,252,-334,1846,637,960,600,20
1,0,0.32,1.0,-0.0,6.7228522300720215,407.80019147913276,1,251,-334,1846,637,960,600,20
1,0,0.32,1.0,-0.0,6.729832172393799,407.2001917545101,1,250,-334,1846,637,960,600,20
1,0,0.33,1.0,-0.0,6.738809585571289,406.60172827293934,1,249,-334,1846,637,960,600,20
1,0,0.33,1.0,-0.0,6.747785806655884,406.0048076645269,1,248,-334,1846,637,960,600,20
1,0,0.33,1.0,-0.0,6.755764961242676,405.4094365803454,1,247,-334,1846,637,960,600,20
1,0,0.33,1.0,-0.0,6.76476788520813,404.81562169233695,1,246,-334,1846,637,960,600,20
1,0,0.33,1.0,-0.0,6.771728038787842,404.22336969321276,1,245,-334,1846,637,960,600,20
1,0,0.33,1.0,-0.0,6.782692909240723,403.6326872963499,1,244,-334,1846,637,960,600,20
1,0,0.33,1.0,-0.0,6.791668176651001,403.0435812356851,1,243,-334,1846,637,960,600,20
1,0,0.33,1.0,-0.0,6.798649787902832,402.45605826560484,1,242,-334,1846,637,960,600,20
1,0,0.33,1.0,-0.0,6.807626724243164,401.8701251608327,1,241,-334,1846,637,960,600,20
1,0,0.33,1.0,-0.0,6.8156044483184814,401.2857887163134,1,240,-334,1846,637,960,600,20
1,0,0.33,1.0,-0.0,6.825986385345459,400.7030557470933,1,239,-334,1846,637,960,600,20
1,0,0.33,1.0,-0.0,6.833965301513672,400.1219330881976,1,238,-334,1846,637,960,600,20
1,0,0.33,1.0,-0.0,6.840946674346924,399.54242759450455,1,237,-334,1846,637,960,600,20
1,0,0.33,1.0,-0.0,6.849924564361572,398.96454614061594,1,236,-334,1846,637,960,600,20
1,0,0.33,1.0,-0.0,6.858900308609009,398.3882956207242,1,235,-334,1846,637,960,600,20
1,0,0.33,1.0,-0.0,6.868872404098511,397.81368294847584,1,234,-334,1846,637,960,600,20
1,0,0.33,1.0,-0.0,6.876879453659058,397.2407150568322,1,233,-334,1846,637,960,600,20
1,0,0.33,1.0,-0.0,6.884839773178101,396.6693988979254,1,232,-334,1846,637,960,600,20
1,0,0.33,1.0,-0.0,6.891813516616821,396.09974144291203,1,231,-334,1846,637,960,600,20
1,0,0.33,1.0,-0.0,6.900787353515625,395.5317496818221,1,230,-334,1846,637,960,600,20
1,0,0.33,1.0,-0.0,6.908767461776733,394.9654306234052,1,229,-334,1846,637,960,600,20
1,0,0.33,1.0,-0.0,6.917742490768433,394.40079129497263,1,228,-334,1846,637,960,600,20
1,0,0.33,1.0,-0.0,6.926718711853027,393.83783874223576,1,227,-334,1846,637,960,600,20
1,0,0.33,1.0,-0.0,6.937692403793335,393.2765800291408,1,226,-334,1846,637,960,600,20
1,0,0.34,1.0,-0.0,6.945670127868652,392.7170222376998,1,225,-334,1846,637,960,600,20
1,0,0.34,1.0,-0.0,6.9536473751068115,392.15917246781777,1,224,-334,1846,637,960,600,20
1,0,0.34,1.0,-0.0,6.96162748336792,391.60303783711595,1,223,-334,1846,637,960,600,20
1,0,0.34,1.0,-0.0,6.968607425689697,391.0486254807514,1,222,-334,1846,637,960,600,20
1,0,0.34,1.0,-0.0,6.977583646774292,390.49594255123236,1,221,-334,1846,637,960,600,20
1,0,0.34,1.0,-0.0,6.9875571727752686,389.94499621823,1,220,-334,1846,637,960,600,20
1,0,0.34,1.0,-0.0,6.995535850524902,389.39579366838603,1,219,-334,1846,637,960,600,20
1,0,0.33,1.0,-0.0,7.002517461776733,388.84834210511644,1,218,-334,1846,637,960,600,20
1,0,0.33,1.0,-0.0,7.010497331619263,388.3026487484109,1,217,-334,1846,637,960,600,20
1,0,0.33,1.0,-0.0,7.019477367401123,387.7587208346286,1,216,-334,1846,637,960,600,20
1,0,0.33,1.0,-0.0,7.028449535369873,387.2165656162895,1,215,-334,1846,637,960,600,20
1,0,0.33,1.0,-0.0,7.037425756454468,386.67619036186176,1,214,-334,1846,637,960,600,20
1,0,0.33,1.0,-0.0,7.046402454376221,386.13760235554514,1,213,-334,1846,637,960,600,20
1,0,0.33,1.0,-0.0,7.055376768112183,385.60080889704966,1,212,-334,1846,637,960,600,20
1,0,0.32,1.0,-0.0,7.06535005569458,385.06581730137066,1,211,-334,1846,637,960,600,20
1,0,0.32,1.0,-0.0,7.073330640792847,384.5326348985594,1,210,-334,1846,637,960,600,20
1,0,0.32,1.0,-0.0,7.0823118686676025,384.0012690334893,1,209,-334,1846,637,960,600,20
1,0,0.32,1.0,-0.0,7.091282844543457,383.47172706561776,1,208,-334,1846,637,960,600,20
1,0,0.32,1.0,-0.0,7.098263740539551,382.9440163687443,1,207,-334,1846,637,960,600,20
1,0,0.32,1.0,-0.0,7.108248472213745,382.4181443307636,1,206,-334,1846,637,960,600,20
1,0,0.32,1.0,-0.0,7.116215705871582,381.89411835341446,1,205,-334,1846,637,960,600,20
1,0,0.32,1.0,-0.0,7.124195575714111,381.3719458520245,1,204,-334,1846,637,960,600,20
1,0,0.31,1.0,-0.0,7.132174015045166,380.85163425525036,1,203,-334,1846,637,960,600,20
1,0,0.31,1.0,-0.0,7.139155387878418,380.3331910048132,1,202,-334,1846,637,960,600,20
1,0,0.31,1.0,-0.0,7.149132013320923,379.81662355523014,1,201,-334,1846,637,960,600,20
1,0,0.31,1.0,-0.0,7.156109094619751,379.30193937354073,1,200,-334,1846,637,960,600,20
1,0,0.31,1.0,-0.0,7.165086030960083,378.78914593902954,1,199,-334,1846,637,960,600,20
1,0,0.31,1.0,-0.0,7.174062013626099,378.2782507429434,1,198,-334,1846,637,960,600,20
1,0,0.31,1.0,-0.0,7.183063507080078,377.76926128820475,1,197,-334,1846,637,960,600,20
1,0,0.31,1.0,-0.0,7.192014932632446,377.26218508912024,1,196,-334,1846,637,960,600,20
1,0,0.31,1.0,-0.0,7.200999975204468,376.7570296710843,1,195,-334,1846,637,960,600,20
1,0,0.31,1.0,-0.0,7.209967851638794,376.25380257027894,1,194,-334,1846,637,960,600,20
1,0,0.3,1.0,-0.0,7.2189435958862305,375.75251133336775,1,193,-334,1846,637,960,600,20
1,0,0.3,1.0,-0.0,7.227919340133667,375.25316351718647,1,192,-334,1846,637,960,600,20
1,0,0.3,1.0,-0.0,7.237893104553223,374.75576668842797,1,191,-334,1846,637,960,600,20
1,0,0.3,1.0,-0.0,7.244874477386475,374.2603284233229,1,190,-334,1846,637,960,600,20
1,0,0.3,1.0,-0.0,7.25484824180603,373.76685630731583,1,189,-334,1846,637,960,600,20
1,0,0.3,1.0,-0.0,7.2628254890441895,373.275357934736,1,188,-334,1846,637,960,600,20
1,0,0.3,1.0,-0.0,7.269808769226074,372.78584090846414,1,187,-334,1846,637,960,600,20
1,0,0.3,1.0,-0.0,7.277786493301392,372.2983128395939,1,186,-334,1846,637,960,600,20
1,0,0.3,1.0,-0.0,7.285767078399658,371.812781347089,1,185,-334,1846,637,960,600,20
1,0,0.3,1.0,-0.0,7.295742511749268,371.32925405743526,1,184,-334,1846,637,960,600,20
1,0,0.29,1.0,-0.0,7.303720712661743,370.8477386042879,1,183,-334,1846,637,960,600,20
1,0,0.29,1.0,-0.0,7.312693119049072,370.3682426281143,1,182,-334,1846,637,960,600,20
1,0,0.29,1.0,-0.0,7.322668075561523,369.8907737758315,1,181,-334,1846,637,960,600,20
1,0,0.29,1.0,-0.0,7.3326404094696045,369.41533970043963,1,180,-334,1846,637,960,600,20
1,0,0.29,1.0,-0.0,7.34061861038208,368.9419480606495,1,179,-334,1846,637,960,600,20
1,0,0.29,1.0,-0.0,7.348597764968872,368.4706065205064,1,178,-334,1846,637,960,600,20
1,0,0.29,1.0,-0.0,7.356576204299927,368.00132274900835,1,177,-334,1846,637,960,600,20
1,0,0.29,1.0,-0.0,7.36455512046814,367.53410441971994,1,176,-334,1846,637,960,600,20
1,0,0.29,1.0,-0.0,7.372535705566406,367.068959210381,1,175,-334,1846,637,960,600,20
1,0,0.29,1.0,-0.0,7.381510257720947,366.60589480251105,1,174,-334,1846,637,960,600,20
1,0,0.28,1.0,-0.0,7.388512372970581,366.14491888100787,1,173,-334,1846,637,960,600,20
1,0,0.28,1.0,-0.0,7.3964715003967285,365.6860391337426,1,172,-334,1846,637,960,600,20
1,0,0.28,1.0,-0.0,7.404450416564941,365.2292632511489,1,171,-334,1846,637,960,600,20
1,0,0.28,1.0,-0.0,7.411430358886719,364.77459892580765,1,170,-334,1846,637,960,600,20
1,0,0.28,1.0,-0.0,7.419409513473511,364.32205385202724,1,169,-334,1846,637,960,600,20
1,0,0.28,1.0,-0.0,7.428404331207275,363.87163572541846,1,168,-334,1846,637,960,600,20
1,0,0.28,1.0,-0.0,7.438363790512085,363.4233522424649,1,167,-334,1846,637,960,600,20
1,0,0.28,1.0,-0.0,7.446337699890137,362.97721110008854,1,166,-334,1846,637,960,600,20
1,0,0.28,1.0,-0.0,7.454317092895508,362.53321999521063,1,165,-334,1846,637,960,600,20
1,0,0.28,1.0,-0.0,7.4623122215271,362.09138662430763,1,164,-334,1846,637,960,600,20
1,0,0.28,1.0,-0.0,7.4702863693237305,361.6517186829626,1,163,-334,1846,637,960,600,20
1,0,0.27,1.0,-0.0,7.478254079818726,361.2142238654117,1,162,-334,1846,637,960,600,20
1,0,0.27,1.0,-0.0,7.485234975814819,360.77890986408596,1,161,-334,1846,637,960,600,20
1,0,0.27,1.0,-0.0,7.495208978652954,360.3457843691487,1,160,-334,1846,637,960,600,20
1,0,0.27,1.0,-0.0,7.504185438156128,359.9148550680278,1,159,-334,1846,637,960,600,20
1,0,0.27,1.0,-0.0,7.512164115905762,359.4861296449435,1,158,-334,1846,637,960,600,20
1,0,0.27,1.0,-0.0,7.5201826095581055,359.0596157804319,1,157,-334,1846,637,960,600,20
1,0,0.26,1.0,-0.0,7.528121471405029,358.63532115086315,1,156,-334,1846,637,960,600,20
1,0,0.26,1.0,-0.0,7.537098407745361,358.2132534279558,1,155,-334,1846,637,960,600,20
1,0,0.26,1.0,-0.0,7.545075416564941,357.79342027828613,1,154,-334,1846,637,960,600,20
1,0,0.26,1.0,-0.0,7.554051876068115,357.375829362793,1,153,-334,1846,637,960,600,20
1,0,0.26,1.0,-0.0,7.5620317459106445,356.9604883362785,1,152,-334,1846,637,960,600,20
1,0,0.25,1.0,-0.0,7.571008205413818,356.5474048469038,1,151,-334,1846,637,960,600,20
1,0,0.25,1.0,-0.0,7.578985691070557,356.1365865356807,1,150,-334,1846,637,960,600,20
1,0,0.25,1.0,-0.0,7.585967063903809,355.7280410359588,1,149,-334,1846,637,960,600,20
1,0,0.25,1.0,-0.0,7.594944477081299,355.3217759729086,1,148,-334,1846,637,960,600,20
1,0,0.25,1.0,-0.0,7.604916334152222,354.9177989629993,1,147,-334,1846,637,960,600,20
1,0,0.25,1.0,-0.0,7.611897706985474,354.51611761347397,1,146,-334,1846,637,960,600,20
1,0,0.24,1.0,-0.0,7.621871471405029,354.1167395218188,1,145,-334,1846,637,960,600,20
1,0,0.24,1.0,-0.0,7.628852605819702,353.719672275229,1,144,-334,1846,637,960,600,20
1,0,0.24,1.0,-0.0,7.6378302574157715,353.3249234500711,1,143,-334,1846,637,960,600,20
1,0,0.24,1.0,-0.0,7.646806716918945,352.93250061133955,1,142,-334,1846,637,960,600,20
1,0,0.24,1.0,-0.0,7.655782699584961,352.5424113121112,1,141,-334,1846,637,960,600,20
1,0,0.23,1.0,-0.0,7.665754795074463,352.154663092994,1,140,-334,1846,637,960,600,20
1,0,0.23,1.0,-0.0,7.673734664916992,351.7692634815733,1,139,-334,1846,637,960,600,20
1,0,0.23,1.0,-0.0,7.683707237243652,351.386219991853,1,138,-334,1846,637,960,600,20
1,0,0.23,1.0,-0.0,7.693681955337524,351.00554012369395,1,137,-334,1846,637,960,600,20
1,0,0.23,1.0,-0.0,7.701659679412842,350.6272313622475,1,136,-334,1846,637,960,600,20
1,0,0.23,1.0,-0.0,7.709638595581055,350.25130117738644,1,135,-334,1846,637,960,600,20
1,0,0.22,1.0,-0.0,7.717618227005005,349.8777570231314,1,134,-334,1846,637,960,600,20
1,0,0.22,1.0,-0.0,7.725597143173218,349.5066063370741,1,133,-334,1846,637,960,600,20
1,0,0.22,1.0,-0.0,7.734572887420654,349.13785653979727,1,132,-334,1846,637,960,600,20
1,0,0.22,1.0,-0.0,7.741553544998169,348.7715150342903,1,131,-334,1846,637,960,600,20
1,0,0.21,1.0,-0.0,7.7515270709991455,348.4075892053627,1,130,-334,1846,637,960,600,20
1,0,0.21,1.0,-0.0,7.759519577026367,348.04608641905304,1,129,-334,1846,637,960,600,20
1,0,0.21,1.0,-0.0,7.768481731414795,347.6870140220357,1,128,-334,1846,637,960,600,20
1,0,0.21,1.0,-0.0,7.778456687927246,347.33037934102384,1,127,-334,1846,637,960,600,20
1,0,0.21,1.0,-0.0,7.787431716918945,346.97618968216915,1,126,-334,1846,637,960,600,20
1,0,0.2,1.0,-0.0,7.795411109924316,346.62445233045923,1,125,-334,1846,637,960,600,20
1,0,0.2,1.0,-0.0,7.805384874343872,346.2751745491117,1,124,-334,1846,637,960,600,20
1,0,0.2,1.0,-0.0,7.8133625984191895,345.92836357896516,1,123,-334,1846,637,960,600,20
1,0,0.2,1.0,-0.0,7.8203442096710205,345.58402663786796,1,122,-334,1846,637,960,600,20
1,0,0.2,1.0,-0.0,7.830317497253418,345.24217092006404,1,121,-334,1846,637,960,600,20
1,0,0.2,1.0,-0.0,7.838295936584473,344.902803595576,1,120,-334,1846,637,960,600,20
1,0,0.19,1.0,-0.0,7.846275091171265,344.565931809586,1,119,-334,1846,637,960,600,20
1,0,0.19,1.0,-0.0,7.854254245758057,344.2315626818141,1,118,-334,1846,637,960,600,20
1,0,0.19,1.0,-0.0,7.861236333847046,343.89970330589426,1,117,-334,1846,637,960,600,20
1,0,0.19,1.0,-0.0,7.871210336685181,343.57036074874827,1,116,-334,1846,637,960,600,20
1,0,0.19,1.0,-0.0,7.87918758392334,343.24354204995734,1,115,-334,1846,637,960,600,20
1,0,0.19,1.0,-0.0,7.886168956756592,342.919254221132,1,114,-334,1846,637,960,600,20
1,0,0.18,1.0,-0.0,7.89514684677124,342.59750424527965,1,113,-334,1846,637,960,600,20
1,0,0.18,1.0,-0.0,7.903125286102295,342.27829907617075,1,112,-334,1846,637,960,600,20
1,0,0.18,1.0,-0.0,7.911111831665039,341.961645637703,1,111,-334,1846,637,960,600,20
1,0,0.18,1.0,-0.0,7.9200804233551025,341.64755082326394,1,110,-334,1846,637,960,600,20
1,0,0.18,1.0,-0.0,7.928059101104736,341.3360214950924,1,109,-334,1846,637,960,600,20
1,0,0.18,1.0,-0.0,7.9370338916778564,341.0270644836378,1,108,-334,1846,637,960,600,20
1,0,0.17,1.0,-0.0,7.946010112762451,340.7206865869192,1,107,-334,1846,637,960,600,20
1,0,0.17,1.0,-0.0,7.955983400344849,340.4168945698823,1,106,-334,1846,637,960,600,20
1,0,0.17,1.0,-0.0,7.962966680526733,340.11569516375584,1,105,-334,1846,637,960,600,20
1,0,0.17,1.0,-0.0,7.971942901611328,339.817095065407,1,104,-334,1846,637,960,600,20
1,0,0.17,1.0,-0.0,7.9799346923828125,339.521100936696,1,103,-334,1846,637,960,600,20
1,0,0.16,1.0,-0.0,7.986902236938477,339.22771940382967,1,102,-334,1846,637,960,600,20
1,0,0.16,1.0,-0.0,7.9948811531066895,338.93695705671536,1,101,-334,1846,637,960,600,20
1,0,0.16,1.0,-0.0,8.004854917526245,338.648820448313,1,100,-334,1846,637,960,600,20
1,0,0.16,1.0,-0.0,8.01183533668518,338.3633160939883,1,99,-334,1846,637,960,600,20
1,0,0.16,1.0,-0.0,8.021809577941895,338.08045047086455,1,98,-334,1846,637,960,600,20
1,0,0.15,1.0,-0.0,8.028792142868042,337.80023001717524,1,97,-334,1846,637,960,600,20
1,0,0.15,1.0,-0.0,8.038763761520386,337.522661131616,1,96,-334,1846,637,960,600,20
1,0,0.15,1.0,-0.0,8.045745372772217,337.2477501726973,1,95,-334,1846,637,960,600,20
1,0,0.15,1.0,-0.0,8.054722547531128,336.9755034580972,1,94,-334,1846,637,960,600,20
1,0,0.15,1.0,-0.0,8.063698291778564,336.70592726401435,1,93,-334,1846,637,960,600,20
1,0,0.15,1.0,-0.0,8.072673797607422,336.4390278245221,1,92,-334,1846,637,960,600,20
1,0,0.14,1.0,-0.0,8.08264708518982,336.1748113309228,1,91,-334,1846,637,960,600,20
1,0,0.14,1.0,-0.0,8.090626955032349,335.9132839311032,1,90,-334,1846,637,960,600,20
1,0,0.14,1.0,-0.0,8.100628137588501,335.65445172889065,1,89,-334,1846,637,960,600,20
1,0,0.14,1.0,-0.0,8.10957670211792,335.3983207834109,1,88,-334,1846,637,960,600,20
1,0,0.14,1.0,-0.0,8.116558313369751,335.14489710844634,1,87,-334,1846,637,960,600,20
1,0,0.13,1.0,-0.0,8.123539209365845,334.8941866717965,1,86,-334,1846,637,960,600,20
1,0,0.13,1.0,-0.0,8.132514476776123,334.64619539463945,1,85,-334,1846,637,960,600,20
1,0,0.13,1.0,-0.0,8.141491174697876,334.4009291508953,1,84,-334,1846,637,960,600,20
1,0,0.13,1.0,-0.0,8.149469375610352,334.15839376659113,1,83,-334,1846,637,960,600,20
1,0,0.13,1.0,-0.0,8.157448053359985,333.91859501922835,1,82,-334,1846,637,960,600,20
1,0,0.13,1.0,-0.0,8.166455745697021,333.68153863715173,1,81,-334,1846,637,960,600,20
1,0,0.12,1.0,-0.0,8.174402952194214,333.4472302989209,1,80,-334,1846,637,960,600,20
1,0,0.12,1.0,-0.0,8.18238377571106,333.21567563268434,1,79,-334,1846,637,960,600,20
1,0,0.12,1.0,-0.0,8.190361499786377,332.98688021555574,1,78,-334,1846,637,960,600,20
1,0,0.12,1.0,-0.0,8.198340892791748,332.7608495729931,1,77,-334,1846,637,960,600,20
1,0,0.12,1.0,-0.0,8.205322504043579,332.53758917818055,1,76,-334,1846,637,960,600,20
1,0,0.12,1.0,-0.0,8.215306997299194,332.31710445141357,1,75,-334,1846,637,960,600,20
1,0,0.12,1.0,-0.0,8.223286628723145,332.09940075948685,1,74,-334,1846,637,960,600,20
1,0,0.12,1.0,-0.0,8.230616092681885,331.8844834150857,1,73,-334,1846,637,960,600,20
1,0,0.11,1.0,-0.0,8.239587783813477,331.67235767618075,1,72,-334,1846,637,960,600,20
1,0,0.11,1.0,-0.0,8.249560594558716,331.4630287454265,1,71,-334,1846,637,960,600,20
1,0,0.11,1.0,-0.0,8.25753903388977,331.2565017695634,1,70,-334,1846,637,960,600,20
1,0,0.11,1.0,-0.0,8.265517950057983,331.0527818388233,1,69,-334,1846,637,960,600,20
1,0,0.11,1.0,-0.0,8.273497104644775,330.8518739863403,1,68,-334,1846,637,960,600,20
1,0,0.11,1.0,-0.0,8.2804856300354,330.6537831875642,1,67,-334,1846,637,960,600,20
1,0,0.11,1.0,-0.0,8.289455890655518,330.4585143596794,1,66,-334,1846,637,960,600,20
1,0,0.11,1.0,-0.0,8.296435594558716,330.2660723610275,1,65,-334,1846,637,960,600,20
1,0,0.11,1.0,-0.0,8.304414510726929,330.0764619905353,1,64,-334,1846,637,960,600,20
1,0,0.1,1.0,-0.0,8.31438946723938,329.8896879871468,1,63,-334,1846,637,960,600,20
1,0,0.1,1.0,-0.0,8.321369647979736,329.70575502926056,1,62,-334,1846,637,960,600,20
1,0,0.1,1.0,-0.0,8.330373287200928,329.52466773417217,1,61,-334,1846,637,960,600,20
1,0,0.1,1.0,-0.0,8.339323282241821,329.3464306575214,1,60,-334,1846,637,960,600,20
1,0,0.1,1.0,-0.0,8.347310304641724,329.17104829274564,1,59,-334,1846,637,960,600,20
1,0,0.1,1.0,-0.0,8.355290412902832,328.9985250705377,1,58,-334,1846,637,960,600,20
1,0,0.1,1.0,-0.0,8.364256858825684,328.82886535831034,1,57,-334,1846,637,960,600,20
1,0,0.1,1.0,-0.0,8.37123703956604,328.6620734596657,1,56,-334,1846,637,960,600,20
1,0,0.1,1.0,-0.0,8.379221677780151,328.4981536138713,1,55,-334,1846,637,960,600,20
1,0,0.1,1.0,-0.0,8.388193368911743,328.3371099953418,1,54,-334,1846,637,960,600,20
1,0,0.1,1.0,-0.0,8.39517331123352,328.178946713127,1,53,-334,1846,637,960,600,20
1,0,0.1,1.0,-0.0,8.404150247573853,328.02366781040644,1,52,-334,1846,637,960,600,20
1,0,0.09,1.0,-0.0,8.412155628204346,327.87127726399,1,51,-334,1846,637,960,600,20
1,0,0.09,1.0,-0.0,8.422101974487305,327.7217789838257,1,50,-334,1846,637,960,600,20
1,0,0.09,1.0,-0.0,8.42911171913147,327.57517681251386,1,49,-334,1846,637,960,600,20
1,0,0.09,1.0,-0.0,8.439056873321533,327.4314745248285,1,48,-334,1846,637,960,600,20
1,0,0.09,1.0,-0.0,8.446038007736206,327.2906758272455,1,47,-334,1846,637,960,600,20
1,0,0.09,1.0,-0.0,8.456013202667236,327.1527843574779,1,46,-334,1846,637,960,600,20
1,0,0.09,1.0,-0.0,8.462994575500488,327.01780368401904,1,45,-334,1846,637,960,600,20
1,0,0.09,1.0,-0.0,8.470975637435913,326.88573730569243,1,44,-334,1846,637,960,600,20
1,0,0.09,1.0,-0.0,8.480955600738525,326.7565886512096,1,43,-334,1846,637,960,600,20
1,0,0.09,1.0,-0.0,8.489922523498535,326.63036107873575,1,42,-334,1846,637,960,600,20
1,0,0.09,1.0,-0.0,8.497901439666748,326.5070578754627,1,41,-334,1846,637,960,600,20
1,0,0.09,1.0,-0.0,8.506876707077026,326.38668225719044,1,40,-334,1846,637,960,600,20
1,0,0.09,1.0,-0.0,8.513858318328857,326.2692373679162,1,39,-334,1846,637,960,600,20
1,0,0.08,1.0,-0.0,8.522835493087769,326.1547262794322,1,38,-334,1846,637,960,600,20
1,0,0.08,1.0,-0.0,8.531810522079468,326.04315199093105,1,37,-334,1846,637,960,600,20
1,0,0.08,1.0,-0.0,8.538793325424194,325.9345174286203,1,36,-334,1846,637,960,600,20
1,0,0.08,1.0,-0.0,8.546770572662354,325.828825445345,1,35,-334,1846,637,960,600,20
1,0,0.08,1.0,-0.0,8.555747032165527,325.72607882021913,1,34,-334,1846,637,960,600,20
1,0,0.08,1.0,-0.0,8.56572151184082,325.6262802582658,1,33,-334,1846,637,960,600,20
1,0,0.08,1.0,-0.0,8.574696063995361,325.5294323900662,1,32,-334,1846,637,960,600,20
1,0,0.08,1.0,-0.0,8.582675218582153,325.43553777141744,1,31,-334,1846,637,960,600,20
1,0,0.08,1.0,-0.0,8.591651439666748,325.3445988829998,1,30,-334,1846,637,960,600,20
1,0,0.08,1.0,-0.0,8.59966230392456,325.25661813005274,1,29,-334,1846,637,960,600,20
1,0,0.08,1.0,-0.0,8.60761022567749,325.1715978420606,1,28,-334,1846,637,960,600,20
1,0,0.08,1.0,-0.0,8.616586208343506,325.08954027244715,1,27,-334,1846,637,960,600,20
1,0,0.08,1.0,-0.0,8.624563932418823,325.0104475982801,1,26,-334,1846,637,960,600,20
1,0,0.08,1.0,-0.0,8.633541107177734,324.93432191998477,1,25,-334,1846,637,960,600,20
1,0,0.08,1.0,-0.0,8.640522480010986,324.8611652610676,1,24,-334,1846,637,960,600,20
1,0,0.08,1.0,-0.0,8.649499416351318,324.79097956784915,1,23,-334,1846,637,960,600,20
1,0,0.08,1.0,-0.0,8.657477378845215,324.72376670920755,1,22,-334,1846,637,960,600,20
1,0,0.08,1.0,-0.0,8.666452646255493,324.6595284763307,1,21,-334,1846,637,960,600,20
1,0,0.08,1.0,-0.0,8.674431800842285,324.5982665824795,1,20,-334,1846,637,960,600,20
1,0,0.08,1.0,-0.0,8.682410478591919,324.53998266276034,1,19,-334,1846,637,960,600,20
1,0,0.08,1.0,-0.0,8.690388917922974,324.4846782739084,1,18,-334,1846,637,960,600,20
1,0,0.07,1.0,-0.0,8.699365377426147,324.43235489408016,1,17,-334,1846,637,960,600,20
1,0,0.07,1.0,-0.0,8.707345008850098,324.38301392265726,1,16,-334,1846,637,960,600,20
1,0,0.07,1.0,-0.0,8.716320514678955,324.33665668005955,1,15,-334,1846,637,960,600,20
1,0,0.07,1.0,-0.0,8.723302125930786,324.2932844075693,1,14,-334,1846,637,960,600,20
1,0,0.07,1.0,-0.0,8.733275413513184,324.2528982671654,1,13,-334,1846,637,960,600,20
1,0,0.07,1.0,-0.0,8.740257024765015,324.21549934136806,1,12,-334,1846,637,960,600,20
1,0,0.07,1.0,-0.0,8.751238584518433,324.18108863309425,1,11,-334,1846,637,960,600,20
1,0,0.07,1.0,-0.0,8.758209705352783,324.1496670655232,1,10,-334,1846,637,960,600,20
1,0,0.07,1.0,-0.0,8.767185688018799,324.1212354819729,1,9,-334,1846,637,960,600,20
1,0,0.07,1.0,-0.0,8.777159690856934,324.0957946457872,1,8,-334,1846,637,960,600,20
1,0,0.07,1.0,-0.0,8.78513765335083,324.07334524023315,1,7,-334,1846,637,960,600,20
1,0,0.07,1.0,-0.0,8.793116331100464,324.0538878684096,1,6,-334,1846,637,960,600,20
1,0,0.07,1.0,-0.0,8.801095724105835,324.0374230531663,1,5,-334,1846,637,960,600,20
1,0,0.07,1.0,-0.0,8.810071229934692,324.0239512370333,1,4,-334,1846,637,960,600,20
1,0,0.07,1.0,-0.0,8.81705355644226,324.0134727821619,1,3,-334,1846,637,960,600,20
1,0,0.07,1.0,-0.0,8.827027082443237,324.0059879702758,1,2,-334,1846,637,960,600,20
1,-1,0.07,1.0,-1.0,8.83400845527649,323.0015014981164,1,1,-333,1846,637,960,600,20
1,-1,0.03,1.0,-1.0,8.842983722686768,322.0,1,0,-332,1846,637,960,600,20
1,-2,0.02,1.0,-2.0,8.851961135864258,320.00151514803684,1,-1,-330,1846,637,960,600,20
1,-3,0.01,1.0,-3.0,8.860937356948853,317.00611615075337,1,-2,-327,1846,637,960,600,20
1,-4,0.01,1.0,-4.0,8.869911909103394,313.0139315880973,1,-3,-323,1846,637,960,600,20
1,-5,0.01,1.0,-5.0,8.878893613815308,308.0251562376788,1,-4,-318,1846,637,960,600,20
1,-6,0.0,1.0,-6.0,8.888861656188965,302.04006153056696,1,-5,-312,1846,637,960,600,20
1,-7,0.0,1.0,-7.0,8.895844221115112,295.05901068481813,1,-6,-305,1846,637,960,600,20
1,-8,0.0,1.0,-8.0,8.906814098358154,287.0824801296771,1,-7,-297,1846,637,960,600,20
1,-9,0.0,1.0,-9.0,8.914793014526367,278.1110896859057,1,-8,-288,1846,637,960,600,20
1,-10,0.01,1.0,-10.0,8.922771453857422,268.14564530116235,1,-9,-278,1846,637,960,600,20
1,-10,0.01,1.0,-10.0,8.930750370025635,258.1865022703417,1,-10,-268,1846,637,960,600,20
1,-10,0.01,1.0,-10.0,8.94072437286377,248.23438965405052,1,-11,-258,1846,637,960,600,20
1,-10,0.01,1.0,-10.0,8.947705507278442,238.29015284541592,1,-12,-248,1846,637,960,600,20
1,-10,0.01,1.0,-10.0,8.956681728363037,228.3547775900454,1,-13,-238,1846,637,960,600,20
1,-10,0.01,1.0,-10.0,8.965657472610474,218.42942017174582,1,-14,-228,1846,637,960,600,20
1,-10,0.01,1.0,-10.0,8.97563123703003,208.51544567833184,1,-15,-218,1846,637,960,600,20
1,-10,0.01,1.0,-10.0,8.983610153198242,198.61447696648477,1,-16,-208,1846,637,960,600,20
1,-10,0.01,1.0,-10.0,8.990591526031494,188.72845795205075,1,-17,-198,1846,637,960,600,20
1,-9,0.01,1.0,-9.0,8.999567747116089,179.85520798756087,1,-18,-189,1846,637,960,600,20
1,-9,0.01,1.0,-9.0,9.008543968200684,171.0,1,-19,-180,1846,637,960,600,20
1,-8,0.01,1.0,-8.0,9.017520427703857,163.1588865753069,1,-20,-172,1846,637,960,600,20
1,-8,0.01,1.0,-8.0,9.026495933532715,155.33904560024533,1,-21,-164,1846,637,960,600,20
1,-8,0.01,1.0,-8.0,9.03547191619873,147.54364474646383,1,-22,-156,1846,637,960,600,20
1,-8,0.01,1.0,-8.0,9.044448375701904,139.77650015940418,1,-23,-148,1846,637,960,600,20
1,-8,0.01,1.0,-8.0,9.05342435836792,132.04224723651762,1,-24,-140,1846,637,960,600,20
1,-7,0.0,1.0,-7.0,9.062400817871094,125.32922818075923,1,-25,-133,1846,637,960,600,20
1,-7,0.0,1.0,-7.0,9.071377754211426,118.65457628860312,1,-26,-126,1846,637,960,600,20
1,-6,0.0,1.0,-6.0,9.079361200332642,113.0,1,-27,-120,1846,637,960,600,20
1,-6,0.0,1.0,-6.0,9.08932876586914,107.38824472663352,1,-28,-114,1846,637,960,600,20
1,-6,0.0,1.0,-6.0,9.097307920455933,101.8257573191436,1,-29,-108,1846,637,960,600,20
1,-6,0.0,1.0,-6.0,9.104289531707764,96.3202708800161,1,-30,-102,1846,637,960,600,20
1,-6,0.0,1.0,-6.0,9.113267421722412,90.88111815399351,1,-31,-96,1846,637,960,600,20
1,-6,0.0,1.0,-6.0,9.122252225875854,85.51963149007642,1,-32,-90,1846,637,960,600,20
1,-5,0.0,1.0,-5.0,9.13121771812439,81.18113840043894,1,-33,-85,1846,637,960,600,20
1,-5,0.0,1.0,-5.0,9.138200044631958,76.92525524840292,1,-34,-80,1846,637,960,600,20
1,-5,0.0,1.0,-5.0,9.146206617355347,72.76472678623425,1,-35,-75,1846,637,960,600,20
1,-5,0.0,1.0,-5.0,9.155155420303345,68.71467461661771,1,-36,-70,1846,637,960,600,20
1,-5,0.0,1.0,-5.0,9.162136554718018,64.79304780526061,1,-37,-65,1846,637,960,600,20
1,-4,0.0,1.0,-4.0,9.170114517211914,61.867934435323804,1,-38,-61,1846,637,960,600,20
0,-4,0.0,-0.0,-4.0,9.179091453552246,58.505474233815804,1,-38,-57,1846,637,960,600,20
0,-4,0.0,-0.0,-4.0,9.189065933227539,55.215028942721474,1,-38,-53,1846,637,960,600,20
0,-4,0.0,-0.0,-4.0,9.197043895721436,52.00806399170998,1,-38,-49,1846,637,960,600,20
0,-4,0.0,-0.0,-4.0,9.20502233505249,48.89821729050889,1,-38,-45,1846,637,960,600,20
0,-4,0.0,-0.0,-4.0,9.214996337890625,45.90169943749474,1,-38,-41,1846,637,960,600,20
0,-4,0.0,-0.0,-4.0,9.221977472305298,43.03772242470448,1,-38,-37,1846,637,960,600,20
0,-4,0.0,-0.0,-4.0,9.230952739715576,40.32891812864648,1,-38,-33,1846,637,960,600,20
0,-3,0.0,-0.0,-3.0,9.239930391311646,38.41487374764082,1,-38,-30,1846,637,960,600,20
0,-3,0.0,-0.0,-3.0,9.249902486801147,36.61544808322666,1,-38,-27,1846,637,960,600,20
0,-3,0.01,-0.0,-3.0,9.256885528564453,34.94441010848846,1,-38,-24,1846,637,960,600,20
0,-3,0.01,-0.0,-3.0,9.266856908798218,33.41658669218482,1,-38,-21,1846,637,960,600,20
0,-3,0.0,-0.0,-3.0,9.27483606338501,32.04759208325728,1,-38,-18,1846,637,960,600,20
0,-3,0.0,-0.0,-3.0,9.284810781478882,30.85339643163099,1,-38,-15,1846,637,960,600,20
0,-3,0.01,-0.0,-3.0,9.291792392730713,29.84971769034255,1,-38,-12,1846,637,960,600,20
0,-3,0.01,-0.0,-3.0,9.301764249801636,29.05124837953327,1,-38,-9,1846,637,960,600,20
0,-3,0.01,-0.0,-3.0,9.31074047088623,28.470768123342687,1,-38,-6,1846,637,960,600,20
0,-3,0.01,-0.0,-3.0,9.320714473724365,28.118237105091836,1,-38,-3,1846,637,960,600,20
0,-2,0.01,-0.0,-2.0,9.329690217971802,28.013155617496423,1,-38,-1,1846,637,960,600,20
0,-2,0.02,-0.0,-2.0,9.33967113494873,28.013155617496423,1,-38,1,1846,637,960,600,20
0,-2,0.02,-0.0,-2.0,9.348640203475952,28.118237105091836,1,-38,3,1846,637,960,600,20
0,-2,0.02,-0.0,-2.0,9.355623960494995,28.3275357934736,1,-38,5,1846,637,960,600,20
0,-2,0.02,-0.0,-2.0,9.363601684570312,28.639358172723313,1,-38,7,1846,637,960,600,20
0,-2,0.02,-0.0,-2.0,9.373573780059814,29.05124837953327,1,-38,9,1846,637,960,600,20
0,-2,0.03,-0.0,-2.0,9.380554676055908,29.560080889704963,1,-38,11,1846,637,960,600,20
0,-2,0.03,-0.0,-2.0,9.389532089233398,30.162171256046406,1,-38,13,1846,637,960,600,20
0,-2,0.03,-0.0,-2.0,9.398523807525635,30.85339643163099,1,-38,15,1846,637,960,600,20
0,-1,0.04,-0.0,-1.0,9.407484531402588,31.231056256176608,1,-38,16,1846,637,960,600,20
0,-1,0.21,-0.0,-1.0,9.417457103729248,31.6293165929973,1,-38,17,1846,637,960,600,20
0,0,0.34,-0.0,-0.0,9.4244384765625,31.6293165929973,1,-38,17,1846,637,960,600,20
0,0,0.63,-0.0,-0.0,9.4334237575531,31.6293165929973,1,-38,17,1846,637,960,600,20
-1,0,0.75,-1.0,-0.0,9.440395832061768,30.718546143004666,1,-37,17,1846,637,960,600,20
-1,0,0.59,-1.0,-0.0,9.450371026992798,29.812058474788763,1,-36,17,1846,637,960,600,20
-1,0,0.45,-1.0,-0.0,9.457350969314575,28.910152916687437,1,-35,17,1846,637,960,600,20
-1,0,0.45,-1.0,-0.0,9.465331077575684,28.013155617496423,1,-34,17,1846,637,960,600,20
-1,0,0.49,-1.0,-0.0,9.474307537078857,27.12142238654117,1,-33,17,1846,637,960,600,20
-1,0,0.51,-1.0,-0.0,9.48328185081482,26.235341863986875,1,-32,17,1846,637,960,600,20
-1,0,0.56,-1.0,-0.0,9.492259740829468,25.355339059327378,1,-31,17,1846,637,960,600,20
-1,0,0.61,-1.0,-0.0,9.501235485076904,24.481879299133332,1,-30,17,1846,637,960,600,20
-1,0,0.63,-1.0,-0.0,9.51021146774292,23.61547262794322,1,-29,17,1846,637,960,600,20
-1,0,0.67,-1.0,-0.0,9.519187927246094,22.756678708318397,1,-28,17,1846,637,960,600,20
-1,0,0.73,-1.0,-0.0,9.528162717819214,21.906112267087632,1,-27,17,1846,637,960,600,20
-1,0,0.74,-1.0,-0.0,9.537140369415283,21.064449134018133,1,-26,17,1846,637,960,600,20
-1,0,0.77,-1.0,-0.0,9.54633092880249,20.23243291566195,1,-25,17,1846,637,960,600,20
-1,0,0.78,-1.0,-0.0,9.556303977966309,19.410882339705484,1,-24,17,1846,637,960,600,20
-1,0,0.78,-1.0,-0.0,9.565279006958008,18.600699292150182,1,-23,17,1846,637,960,600,20
-1,0,0.81,-1.0,-0.0,9.573257684707642,17.80287754891569,1,-22,17,1846,637,960,600,20
-1,0,0.83,-1.0,-0.0,9.580239057540894,17.018512172212592,1,-21,17,1846,637,960,600,20
-1,0,0.85,-1.0,-0.0,9.589217185974121,16.248809496813376,1,-20,17,1846,637,960,600,20
-1,0,0.86,-1.0,-0.0,9.597195148468018,15.495097567963924,1,-19,17,1846,637,960,600,20
-1,0,0.87,-1.0,-0.0,9.605172872543335,14.758836806279895,1,-18,17,1846,637,960,600,20
-1,0,0.88,-1.0,-0.0,9.613179683685303,14.041630560342615,1,-17,17,1846,637,960,600,20
-1,0,0.89,-1.0,-0.0,9.62312626838684,13.345235059857504,1,-16,17,1846,637,960,600,20
0,0,0.89,-0.0,-0.0,9.631103992462158,13.345235059857504,1,-16,17,1846,637,960,600,20
-1,0,0.94,-1.0,-0.0,9.639456510543823,12.671568097509269,1,-15,17,1846,637,960,600,20
0,0,0.96,-0.0,-0.0,9.647425174713135,12.671568097509269,1,-15,17,1846,637,960,600,20
0,0,0.96,-0.0,-0.0,9.656403303146362,12.671568097509269,1,-15,17,1846,637,960,600,20
0,0,0.96,-0.0,-0.0,9.665379524230957,12.671568097509269,1,-15,17,1846,637,960,600,20
0,0,0.97,-0.0,-0.0,9.674354076385498,12.671568097509269,1,-15,17,1846,637,960,600,20
0,0,0.96,-0.0,-0.0,9.68435549736023,12.671568097509269,1,-15,17,1846,637,960,600,20
0,0,0.96,-0.0,-0.0,9.691310167312622,12.671568097509269,1,-15,17,1846,637,960,600,20
0,0,0.96,-0.0,-0.0,9.700285196304321,12.671568097509269,1,-15,17,1846,637,960,600,20
0,1,0.96,-0.0,1.0,9.709261417388916,11.931712199461309,1,-15,16,1846,637,960,600,20
0,1,0.96,-0.0,1.0,9.718238592147827,11.213203435596427,1,-15,15,1846,637,960,600,20
0,1,0.95,-0.0,1.0,9.727215051651001,10.518284528683193,1,-15,14,1846,637,960,600,20
0,1,0.96,-0.0,1.0,9.736191511154175,9.849433241279208,1,-15,13,1846,637,960,600,20
0,1,0.96,-0.0,1.0,0.009123086929321289,401.0981625161192,2,-371,233,1490,858,1861,624,74
0,1,0.97,-0.0,1.0,0.01909661293029785,400.5671377057468,2,-371,232,1490,858,1861,624,74
-1,1,0.85,-1.0,1.0,0.02607870101928711,399.1891791413446,2,-370,231,1490,858,1861,624,74
-1,1,0.84,-1.0,1.0,0.03507590293884277,397.81145339100715,2,-369,230,1490,858,1861,624,74
-1,1,0.72,-1.0,1.0,0.04405808448791504,396.4339626748232,2,-368,229,1490,858,1861,624,74
-1,1,0.67,-1.0,1.0,0.05400490760803223,395.0567092408125,2,-367,228,1490,858,1861,624,74
-1,1,0.56,-1.0,1.0,0.061983346939086914,393.6796953653608,2,-366,227,1490,858,1861,624,74
-1,1,0.45,-1.0,1.0,0.07095956802368164,392.30292335366175,2,-365,226,1490,858,1861,624,74
-1,1,0.37,-1.0,1.0,0.0809333324432373,390.9263955401676,2,-364,225,1490,858,1861,624,74
-1,1,0.36,-1.0,1.0,0.0889129638671875,389.5501142890481,2,-363,224,1490,858,1861,624,74
-1,1,0.28,-1.0,1.0,0.09888505935668945,388.1740819946578,2,-362,223,1490,858,1861,624,74
-2,1,0.27,-2.0,1.0,0.10686540603637695,385.9468051658506,2,-360,222,1490,858,1861,624,74
-2,2,0.16,-2.0,2.0,0.11484193801879883,383.1951927378513,2,-358,220,1490,858,1861,624,74
-3,2,0.11,-3.0,2.0,0.12282133102416992,379.5921266658793,2,-355,218,1490,858,1861,624,74
-3,3,0.04,-3.0,3.0,0.1307997703552246,375.46696837443847,2,-352,215,1490,858,1861,624,74
-4,3,0.03,-4.0,3.0,0.13977622985839844,370.4898771748815,2,-348,212,1490,858,1861,624,74
-5,4,0.01,-5.0,4.0,0.147782564163208,364.1396265641179,2,-343,208,1490,858,1861,624,74
-6,4,0.0,-6.0,4.0,0.15573477745056152,356.93527387122873,2,-337,204,1490,858,1861,624,74
-7,5,0.0,-7.0,5.0,0.16271567344665527,348.3582748560098,2,-330,199,1490,858,1861,624,74
-7,5,0.0,-7.0,5.0,0.1716914176940918,339.78243058826405,2,-323,194,1490,858,1861,624,74
-8,5,0.0,-8.0,5.0,0.17867255210876465,330.3499693752539,2,-315,189,1490,858,1861,624,74
-8,5,0.0,-8.0,5.0,0.18765020370483398,320.9175882797603,2,-307,184,1490,858,1861,624,74
-8,5,0.0,-8.0,5.0,0.19762301445007324,311.4852938073571,2,-299,179,1490,858,1861,624,74
-8,5,0.0,-8.0,5.0,0.20560145378112793,302.05309318748294,2,-291,174,1490,858,1861,624,74
-8,5,0.01,-8.0,5.0,0.21460533142089844,292.6209944769902,2,-283,169,1490,858,1861,624,74
-8,5,0.01,-8.0,5.0,0.22255682945251465,283.18900668199086,2,-275,164,1490,858,1861,624,74
-8,5,0.01,-8.0,5.0,0.23153257369995117,273.75713990188547,2,-267,159,1490,858,1861,624,74
-8,5,0.01,-8.0,5.0,0.23951268196105957,264.3254055004324,2,-259,154,1490,858,1861,624,74
-8,5,0.01,-8.0,5.0,0.24848699569702148,254.89381630997258,2,-251,149,1490,858,1861,624,74
-8,5,0.01,-8.0,5.0,0.2564666271209717,245.46238687655386,2,-243,144,1490,858,1861,624,74
-8,5,0.01,-8.0,5.0,0.2654421329498291,236.0311337558411,2,-235,139,1490,858,1861,624,74
-8,5,0.01,-8.0,5.0,0.2734217643737793,226.60007587252323,2,-227,134,1490,858,1861,624,74
-8,5,0.0,-8.0,5.0,0.2823972702026367,217.1692349597016,2,-219,129,1490,858,1861,624,74
-8,5,0.0,-8.0,5.0,0.29137444496154785,207.73863609981976,2,-211,124,1490,858,1861,624,74
-8,5,0.0,-8.0,5.0,0.29935359954833984,198.30830839560255,2,-203,119,1490,858,1861,624,74
-8,5,0.0,-8.0,5.0,0.3063347339630127,188.8782858089728,2,-195,114,1490,858,1861,624,74
-8,5,0.0,-8.0,5.0,0.3153109550476074,179.44860821913363,2,-187,109,1490,858,1861,624,74
-8,5,0.0,-8.0,5.0,0.3222920894622803,170.01932276963907,2,-179,104,1490,858,1861,624,74
-8,5,0.0,-8.0,5.0,0.3312971591949463,160.59048560090133,2,-171,99,1490,858,1861,624,74
-8,5,0.0,-8.0,5.0,0.339247465133667,151.16216410320115,2,-163,94,1490,858,1861,624,74
-8,5,0.0,-8.0,5.0,0.348222017288208,141.73443988218946,2,-155,89,1490,858,1861,624,74
-8,5,0.0,-8.0,5.0,0.3562018871307373,132.30741271426953,2,-147,84,1490,858,1861,624,74
-8,5,0.0,-8.0,5.0,0.36318230628967285,122.88120589988054,2,-139,79,1490,858,1861,624,74
-8,5,0.0,-8.0,5.0,0.3721592426300049,113.45597362683876,2,-131,74,1490,858,1861,624,74
-7,5,0.0,-7.0,5.0,0.38213396072387695,104.90489773083945,2,-124,69,1490,858,1861,624,74
-7,5,0.0,-7.0,5.0,0.39011096954345703,96.3604139165742,2,-117,64,1490,858,1861,624,74
-6,5,0.0,-6.0,5.0,0.3980896472930908,88.70600622086441,2,-111,59,1490,858,1861,624,74
-6,5,0.0,-6.0,5.0,0.4060699939727783,81.07201192492656,2,-105,54,1490,858,1861,624,74
-5,5,0.0,-5.0,5.0,0.4140474796295166,74.35977729862789,2,-100,49,1490,858,1861,624,74
-5,4,0.0,-5.0,4.0,0.4220309257507324,68.11898020814318,2,-95,45,1490,858,1861,624,74
-4,4,0.0,-4.0,4.0,0.4300048351287842,62.80981915623332,2,-91,41,1490,858,1861,624,74
-4,4,0.0,-4.0,4.0,0.43798398971557617,57.54099639838793,2,-87,37,1490,858,1861,624,74
-4,3,0.0,-4.0,3.0,0.44596314430236816,52.69392398596462,2,-83,34,1490,858,1861,624,74
-4,3,0.0,-4.0,3.0,0.4549398422241211,47.86459803710851,2,-79,31,1490,858,1861,624,74
-4,3,0.0,-4.0,3.0,0.4629175662994385,43.05623023850174,2,-75,28,1490,858,1861,624,74
-4,3,0.0,-4.0,3.0,0.4708974361419678,38.272837066235255,2,-71,25,1490,858,1861,624,74
-4,3,0.01,-4.0,3.0,0.47888898849487305,33.51950084905593,2,-67,22,1490,858,1861,624,74
-4,3,0.01,-4.0,3.0,0.4878561496734619,28.80273550544841,2,-63,19,1490,858,1861,624,74
-4,3,0.01,-4.0,3.0,0.49783945083618164,24.1310068623117,2,-59,16,1490,858,1861,624,74
-4,3,0.01,-4.0,3.0,0.505803108215332,19.515484603779164,2,-55,13,1490,858,1861,624,74
-4,3,0.01,-4.0,3.0,0.5147817134857178,14.97114584074513,2,-51,10,1490,858,1861,624,74
-4,3,0.02,-4.0,3.0,0.52178955078125,10.518417482066887,2,-47,7,1490,858,1861,624,74
-3,3,0.02,-3.0,3.0,0.5297396183013916,7.181444068749045,2,-44,4,1490,858,1861,624,74
-3,2,0.04,-3.0,2.0,0.5387158393859863,4.048751503547585,2,-41,2,1490,858,1861,624,74
-2,2,0.07,-2.0,2.0,0.5466947555541992,2.0,2,-39,0,1490,858,1861,624,74
-2,1,0.18,-2.0,1.0,0.5556716918945312,0.013511046643493785,2,-37,-1,1490,858,1861,624,74
-1,1,0.38,-1.0,1.0,0.5626535415649414,-0.9444872453601079,2,-36,-2,1490,858,1861,624,74
-1,1,0.86,-1.0,1.0,0.5716562271118164,-1.8716638594994066,2,-35,-3,1490,858,1861,624,74
0,0,0.93,-0.0,-0.0,0.007948160171508789,497.80015157254365,3,-317,-422,1208,439,1525,861,61
0,0,0.87,-0.0,-0.0,0.015927791595458984,497.80015157254365,3,-317,-422,1208,439,1525,861,61
0,0,0.75,-0.0,-0.0,0.023905515670776367,497.80015157254365,3,-317,-422,1208,439,1525,861,61
0,-1,0.71,-0.0,-1.0,0.03387904167175293,497.0009487657494,3,-317,-421,1208,439,1525,861,61
0,-1,0.44,-0.0,-1.0,0.04185891151428223,496.20243252953514,3,-317,-420,1208,439,1525,861,61
0,-2,0.33,-0.0,-2.0,0.05086016654968262,494.6074723066762,3,-317,-418,1208,439,1525,861,61
0,-3,0.23,-0.0,-3.0,0.058827877044677734,492.220260043595,3,-317,-415,1208,439,1525,861,61
0,-4,0.08,-0.0,-4.0,0.06679177284240723,489.0472040190565,3,-317,-411,1208,439,1525,861,61
0,-6,0.03,-0.0,-6.0,0.07579517364501953,484.3092454934093,3,-317,-405,1208,439,1525,861,61
-1,-8,0.03,-1.0,-8.0,0.08374595642089844,477.41009055792335,3,-316,-397,1208,439,1525,861,61
-2,-10,0.01,-2.0,-10.0,0.09172630310058594,468.3623179976592,3,-314,-387,1208,439,1525,861,61
-4,-12,0.0,-4.0,-12.0,0.10070109367370605,456.5439342957633,3,-310,-375,1208,439,1525,861,61
-6,-14,0.0,-6.0,-14.0,0.10868120193481445,441.9502092382204,3,-304,-361,1208,439,1525,861,61
-8,-15,0.0,-8.0,-15.0,0.11766576766967773,425.3372376601764,3,-296,-346,1208,439,1525,861,61
-9,-16,0.0,-9.0,-16.0,0.12566447257995605,407.34311472801306,3,-287,-330,1208,439,1525,861,61
-10,-16,0.0,-10.0,-16.0,0.13364315032958984,388.7182823808867,3,-277,-314,1208,439,1525,861,61
-11,-16,0.0,-11.0,-16.0,0.14259052276611328,369.4496213541828,3,-266,-298,1208,439,1525,861,61
-11,-16,0.0,-11.0,-16.0,0.14957141876220703,350.1960020831361,3,-255,-282,1208,439,1525,861,61
-11,-15,0.0,-11.0,-15.0,0.1595451831817627,331.69738732813653,3,-244,-267,1208,439,1525,861,61
-11,-15,0.0,-11.0,-15.0,0.16652727127075195,313.20984834354624,3,-233,-252,1208,439,1525,861,61
-11,-14,0.0,-11.0,-14.0,0.17650079727172852,295.46582001801664,3,-222,-238,1208,439,1525,861,61
-11,-14,0.0,-11.0,-14.0,0.1844801902770996,277.7287766849243,3,-211,-224,1208,439,1525,861,61
-11,-13,0.0,-11.0,-13.0,0.19248509407043457,260.7249559291393,3,-200,-211,1208,439,1525,861,61
-11,-12,0.0,-11.0,-12.0,0.2004380226135254,244.4485379811669,3,-189,-199,1208,439,1525,861,61
-10,-11,0.0,-10.0,-11.0,0.2074282169342041,229.58620918685182,3,-179,-188,1208,439,1525,861,61
-9,-10,0.0,-9.0,-10.0,0.21639394760131836,216.1381725779242,3,-170,-178,1208,439,1525,861,61
-8,-9,0.0,-8.0,-9.0,0.2253718376159668,204.10467744152402,3,-162,-169,1208,439,1525,861,61
-7,-9,0.0,-7.0,-9.0,0.23338007926940918,192.76669409945464,3,-155,-160,1208,439,1525,861,61
-7,-8,0.0,-7.0,-8.0,0.2423262596130371,182.1508896988179,3,-148,-152,1208,439,1525,861,61
-6,-8,0.01,-6.0,-8.0,0.24930620193481445,172.23748416156684,3,-142,-144,1208,439,1525,861,61
-6,-7,0.0,-6.0,-7.0,0.25728654861450195,163.04144632694815,3,-136,-137,1208,439,1525,861,61
-6,-7,0.01,-6.0,-7.0,0.26626110076904297,153.84776310850236,3,-130,-130,1208,439,1525,861,61
-6,-7,0.0,-6.0,-7.0,0.2752397060394287,144.6568063374571,3,-124,-123,1208,439,1525,861,61
-6,-7,0.0,-6.0,-7.0,0.2832205295562744,135.46903033498444,3,-118,-116,1208,439,1525,861,61
-6,-7,0.0,-6.0,-7.0,0.2921938896179199,126.28499608087785,3,-112,-109,1208,439,1525,861,61
-6,-7,0.0,-6.0,-7.0,0.300173282623291,117.10540438746634,3,-106,-102,1208,439,1525,861,61
-6,-6,0.0,-6.0,-6.0,0.30914783477783203,108.62178760930766,3,-100,-96,1208,439,1525,861,61
-6,-6,0.0,-6.0,-6.0,0.3171262741088867,100.13838787997952,3,-94,-90,1208,439,1525,861,61
-6,-6,0.0,-6.0,-6.0,0.3251056671142578,91.6552506059644,3,-88,-84,1208,439,1525,861,61
-6,-6,0.0,-6.0,-6.0,0.3331112861633301,83.17243480636087,3,-82,-78,1208,439,1525,861,61
-6,-5,0.0,-6.0,-5.0,0.3410632610321045,75.38026380684383,3,-76,-73,1208,439,1525,861,61
-5,-5,0.0,-5.0,-5.0,0.3490431308746338,68.3107318658548,3,-71,-68,1208,439,1525,861,61
-5,-4,0.0,-5.0,-4.0,0.35702013969421387,61.93475947648963,3,-66,-64,1208,439,1525,861,61
-5,-4,0.0,-5.0,-4.0,0.36499905586242676,55.562842402528915,3,-61,-60,1208,439,1525,861,61
-5,-4,0.0,-5.0,-4.0,0.371981143951416,49.19595949289332,3,-56,-56,1208,439,1525,861,61
-5,-4,0.0,-5.0,-4.0,0.38095760345458984,42.835430938520574,3,-51,-52,1208,439,1525,861,61
-5,-4,0.0,-5.0,-4.0,0.3879392147064209,36.483080554378645,3,-46,-48,1208,439,1525,861,61
-4,-4,0.0,-4.0,-4.0,0.39791178703308105,30.8276253029822,3,-42,-44,1208,439,1525,861,61
-4,-3,0.0,-4.0,-3.0,0.4068887233734131,25.90169943749474,3,-38,-41,1208,439,1525,861,61
-4,-3,0.0,-4.0,-3.0,0.41686224937438965,20.99019513592785,3,-34,-38,1208,439,1525,861,61
-4,-3,0.0,-4.0,-3.0,0.4238550662994385,16.09772228646444,3,-30,-35,1208,439,1525,861,61
-4,-3,0.0,-4.0,-3.0,0.43184947967529297,11.231056256176608,3,-26,-32,1208,439,1525,861,61
-4,-3,0.0,-4.0,-3.0,0.4407999515533447,6.400549446402593,3,-22,-29,1208,439,1525,861,61
-3,-3,0.0,-3.0,-3.0,0.44977736473083496,2.2024843762092345,3,-19,-26,1208,439,1525,861,61
-3,-2,0.0,-3.0,-2.0,0.4577646255493164,-1.155589796288087,3,-16,-24,1208,439,1525,861,61
-3,-2,0.02,-3.0,-2.0,0.46673130989074707,-4.4461353216387245,3,-13,-22,1208,439,1525,861,61
-2,-2,0.04,-2.0,-2.0,0.4757072925567627,-7.1745755789733465,3,-11,-20,1208,439,1525,861,61
-2,-1,0.11,-2.0,-1.0,0.4836852550506592,-8.97620395837136,3,-9,-19,1208,439,1525,861,61
-1,-1,0.47,-1.0,-1.0,0.4926629066467285,-10.302284396407792,3,-8,-18,1208,439,1525,861,61
-1,0,0.82,-1.0,-0.0,0.4996769428253174,-10.686792084172033,3,-7,-18,1208,439,1525,861,61
0,0,0.95,-0.0,-0.0,0.0069544315338134766,706.2017872080465,4,17,716,1232,1173,1215,457,20
0,0,0.61,-0.0,-0.0,0.016954660415649414,706.2017872080465,4,17,716,1232,1173,1215,457,20
0,0,0.64,-0.0,-0.0,0.024905681610107422,706.2017872080465,4,17,716,1232,1173,1215,457,20
0,1,0.45,-0.0,1.0,0.03288388252258301,705.2020693482367,4,17,715,1232,1173,1215,457,20
0,2,0.17,-0.0,2.0,0.04186439514160156,703.2026360018589,4,17,713,1232,1173,1215,457,20
0,3,0.06,-0.0,3.0,0.04884171485900879,700.203491965507,4,17,710,1232,1173,1215,457,20
0,4,0.02,-0.0,4.0,0.05684804916381836,696.2046445613339,4,17,706,1232,1173,1215,457,20
0,5,0.0,-0.0,5.0,0.06579828262329102,691.2061037954533,4,17,701,1232,1173,1215,457,20
0,6,0.0,-0.0,6.0,0.07277965545654297,685.2078825790168,4,17,695,1232,1173,1215,457,20
0,7,0.0,-0.0,7.0,0.0817558765411377,678.209997021258,4,17,688,1232,1173,1215,457,20
0,8,0.0,-0.0,8.0,0.09174084663391113,670.2124668072469,4,17,680,1232,1173,1215,457,20
0,10,0.0,-0.0,10.0,0.0987093448638916,660.2156369408282,4,17,670,1232,1173,1215,457,20
0,11,0.0,-0.0,11.0,0.10768556594848633,649.2192351562567,4,17,659,1232,1173,1215,457,20
0,13,0.0,-0.0,13.0,0.11666107177734375,636.2236454974392,4,17,646,1232,1173,1215,457,20
0,14,0.0,-0.0,14.0,0.12566518783569336,622.2285978979439,4,17,632,1232,1173,1215,457,20
0,15,0.0,-0.0,15.0,0.13561153411865234,607.234153300026,4,17,617,1232,1173,1215,457,20
1,16,0.0,1.0,16.0,0.1425924301147461,591.2129406458248,4,16,601,1232,1173,1215,457,20
1,17,0.0,1.0,17.0,0.1515967845916748,574.1926052253657,4,15,584,1232,1173,1215,457,20
2,18,0.0,2.0,18.0,0.1615431308746338,556.1492736019362,4,13,566,1232,1173,1215,457,20
2,18,0.0,2.0,18.0,0.16852521896362305,538.1103903412159,4,11,548,1232,1173,1215,457,20
2,18,0.0,2.0,18.0,0.17750096321105957,520.0764095863916,4,9,530,1232,1173,1215,457,20
2,18,0.0,2.0,18.0,0.18747329711914062,502.04784932660345,4,7,512,1232,1173,1215,457,20
2,18,0.0,2.0,18.0,0.1944561004638672,484.0253029957069,4,5,494,1232,1173,1215,457,20
2,18,0.0,2.0,18.0,0.20345401763916016,466.0094536876342,4,3,476,1232,1173,1215,457,20
2,18,0.0,2.0,18.0,0.2134082317352295,448.0010917017557,4,1,458,1232,1173,1215,457,20
2,18,0.0,2.0,18.0,0.22138285636901855,430.00113636216895,4,-1,440,1232,1173,1215,457,20
2,18,0.0,2.0,18.0,0.22836589813232422,412.01066337238444,4,-3,422,1232,1173,1215,457,20
2,18,0.0,2.0,18.0,0.23734211921691895,394.0309394093477,4,-5,404,1232,1173,1215,457,20
2,18,0.0,2.0,18.0,0.24631667137145996,376.0634662850138,4,-7,386,1232,1173,1215,457,20
2,18,0.0,2.0,18.0,0.2532980442047119,358.11003789627904,4,-9,368,1232,1173,1215,457,20
2,17,0.0,2.0,17.0,0.26227593421936035,341.17232237179513,4,-11,351,1232,1173,1215,457,20
2,17,0.0,2.0,17.0,0.2722756862640381,324.2528982671654,4,-13,334,1232,1173,1215,457,20
2,16,0.0,2.0,16.0,0.2832198143005371,308.3535770177555,4,-15,318,1232,1173,1215,457,20
2,16,0.0,2.0,16.0,0.29219484329223633,292.4780983806927,4,-17,302,1232,1173,1215,457,20
2,15,0.0,2.0,15.0,0.302199125289917,277.62823227214676,4,-19,287,1232,1173,1215,457,20
2,15,0.0,2.0,15.0,0.3111724853515625,262.8094573140748,4,-21,272,1232,1173,1215,457,20
1,14,0.0,1.0,14.0,0.32012104988098145,248.93628559937287,4,-22,258,1232,1173,1215,457,20
1,14,0.0,1.0,14.0,0.3290987014770508,235.08161905781512,4,-23,244,1232,1173,1215,457,20
1,13,0.0,1.0,13.0,0.3380744457244873,222.24340679554285,4,-24,231,1232,1173,1215,457,20
1,13,0.0,1.0,13.0,0.34804725646972656,209.4288039433292,4,-25,218,1232,1173,1215,457,20
1,12,0.0,1.0,12.0,0.3550279140472412,197.63429389192913,4,-26,206,1232,1173,1215,457,20
1,12,0.0,1.0,12.0,0.36500120162963867,185.86985475054604,4,-27,194,1232,1173,1215,457,20
1,11,0.0,1.0,11.0,0.37198424339294434,175.129684275645,4,-28,183,1232,1173,1215,457,20
1,11,0.0,1.0,11.0,0.38096094131469727,164.42763542512407,4,-29,172,1232,1173,1215,457,20
1,10,0.0,1.0,10.0,0.38893938064575195,154.75436261295178,4,-30,162,1232,1173,1215,457,20
1,10,0.0,1.0,10.0,0.3959200382232666,145.12897859523216,4,-31,152,1232,1173,1215,457,20
1,9,0.0,1.0,9.0,0.4048953056335449,136.53668482670133,4,-32,143,1232,1173,1215,457,20
1,9,0.0,1.0,9.0,0.414898157119751,128.00362314084367,4,-33,134,1232,1173,1215,457,20
1,8,0.0,1.0,8.0,0.4238462448120117,120.50670480860362,4,-34,126,1232,1173,1215,457,20
1,8,0.0,1.0,8.0,0.43082642555236816,113.08127396155761,4,-35,118,1232,1173,1215,457,20
1,7,0.0,1.0,7.0,0.44081902503967285,106.69190203266035,4,-36,111,1232,1173,1215,457,20
1,7,0.0,1.0,7.0,0.44880032539367676,100.38568747804219,4,-37,104,1232,1173,1215,457,20
1,7,0.0,1.0,7.0,0.455808162689209,94.17773274553444,4,-38,97,1232,1173,1215,457,20
1,7,0.0,1.0,7.0,0.4647560119628906,88.08669634563088,4,-39,90,1232,1173,1215,457,20
1,7,0.0,1.0,7.0,0.47375011444091797,82.13576938409967,4,-40,83,1232,1173,1215,457,20
1,6,0.0,1.0,6.0,0.48273754119873047,77.23531395025755,4,-41,77,1232,1173,1215,457,20
1,6,0.01,1.0,6.0,0.49268150329589844,72.49242389456137,4,-42,71,1232,1173,1215,457,20
1,5,0.01,1.0,5.0,0.5006601810455322,68.77182237323191,4,-43,66,1232,1173,1215,457,20
1,5,0.01,1.0,5.0,0.509636640548706,65.21303078589507,4,-44,61,1232,1173,1215,457,20
1,5,0.01,1.0,5.0,0.5176150798797607,61.84010022264724,4,-45,56,1232,1173,1215,457,20
1,5,0.01,1.0,5.0,0.52659010887146,58.6804193347711,4,-46,51,1232,1173,1215,457,20
1,5,0.01,1.0,5.0,0.5335714817047119,55.76473218982953,4,-47,46,1232,1173,1215,457,20
1,5,0.01,1.0,5.0,0.5438270568847656,53.12685640834652,4,-48,41,1232,1173,1215,457,20
1,5,0.01,1.0,5.0,0.5528020858764648,50.802960454241045,4,-49,36,1232,1173,1215,457,20
1,5,0.01,1.0,5.0,0.5597853660583496,48.83026432033091,4,-50,31,1232,1173,1215,457,20
1,4,0.01,1.0,4.0,0.5697572231292725,47.706152185014034,4,-51,27,1232,1173,1215,457,20
1,4,0.01,1.0,4.0,0.5777401924133301,46.859475903318,4,-52,23,1232,1173,1215,457,20
1,4,0.01,1.0,4.0,0.5867135524749756,46.302753041036986,4,-53,19,1232,1173,1215,457,20
1,4,0.01,1.0,4.0,0.5956881046295166,46.04462507680822,4,-54,15,1232,1173,1215,457,20
1,4,0.01,1.0,4.0,0.6036670207977295,46.089214649520635,4,-55,11,1232,1173,1215,457,20
1,3,0.01,1.0,3.0,0.6106879711151123,46.568542494923804,4,-56,8,1232,1173,1215,457,20
0,3,0.01,-0.0,3.0,0.6196255683898926,46.22277118748239,4,-56,5,1232,1173,1215,457,20
0,3,0.01,-0.0,3.0,0.6295986175537109,46.0357029044876,4,-56,2,1232,1173,1215,457,20
0,3,0.01,-0.0,3.0,0.636580228805542,46.00892785976178,4,-56,-1,1232,1173,1215,457,20
0,2,0.01,-0.0,2.0,0.6465542316436768,46.08029957123981,4,-56,-3,1232,1173,1215,457,20
0,2,0.02,-0.0,2.0,0.6545491218566895,46.22277118748239,4,-56,-5,1232,1173,1215,457,20
0,2,0.03,-0.0,2.0,0.6645057201385498,46.43580423808985,4,-56,-7,1232,1173,1215,457,20
0,2,0.03,-0.0,2.0,0.6724858283996582,46.71860364994893,4,-56,-9,1232,1173,1215,457,20
0,2,0.04,-0.0,2.0,0.6814680099487305,47.0701322935211,4,-56,-11,1232,1173,1215,457,20
-1,1,0.05,-1.0,1.0,0.6904644966125488,46.293871780150276,4,-55,-12,1232,1173,1215,457,20
-1,1,0.09,-1.0,1.0,0.6994125843048096,45.54277630799526,4,-54,-13,1232,1173,1215,457,20
-1,1,0.08,-1.0,1.0,0.7083897590637207,44.817880294662984,4,-53,-14,1232,1173,1215,457,20
-1,1,0.1,-1.0,1.0,0.717365026473999,44.120236510939236,4,-52,-15,1232,1173,1215,457,20
-1,0,0.1,-1.0,-0.0,0.726341724395752,43.16013544000805,4,-51,-15,1232,1173,1215,457,20
-1,0,0.08,-1.0,-0.0,0.7353179454803467,42.20153254455275,4,-50,-15,1232,1173,1215,457,20
-1,0,0.07,-1.0,-0.0,0.7442929744720459,41.24451190127583,4,-49,-15,1232,1173,1215,457,20
-1,0,0.08,-1.0,-0.0,0.7542669773101807,40.28916384272063,4,-48,-15,1232,1173,1215,457,20
-1,0,0.09,-1.0,-0.0,0.7612497806549072,39.33558553417604,4,-47,-15,1232,1173,1215,457,20
-1,0,0.1,-1.0,-0.0,0.7712216377258301,38.38388161361178,4,-46,-15,1232,1173,1215,457,20
-1,0,0.15,-1.0,-0.0,0.7811954021453857,37.43416490252569,4,-45,-15,1232,1173,1215,457,20
-1,0,0.2,-1.0,-0.0,0.7901861667633057,36.486557196677836,4,-44,-15,1232,1173,1215,457,20
-1,0,0.2,-1.0,-0.0,0.7991495132446289,35.5411901469428,4,-43,-15,1232,1173,1215,457,20
-1,0,0.21,-1.0,-0.0,0.8091216087341309,34.598206241955516,4,-42,-15,1232,1173,1215,457,20
-1,0,0.26,-1.0,-0.0,0.8180971145629883,33.657759905886145,4,-41,-15,1232,1173,1215,457,20
-1,0,0.3,-1.0,-0.0,0.8280720710754395,32.720018726587654,4,-40,-15,1232,1173,1215,457,20
-1,0,0.3,-1.0,-0.0,0.8370485305786133,31.785164831552358,4,-39,-15,1232,1173,1215,457,20
-1,0,0.3,-1.0,-0.0,0.8470206260681152,30.85339643163099,4,-38,-15,1232,1173,1215,457,20
-1,0,0.34,-1.0,-0.0,0.8540318012237549,29.92492955535426,4,-37,-15,1232,1173,1215,457,20
-1,0,0.37,-1.0,-0.0,0.8629791736602783,29.0,4,-36,-15,1232,1173,1215,457,20
-1,0,0.42,-1.0,-0.0,0.8729515075683594,28.078865529319543,4,-35,-15,1232,1173,1215,457,20
-1,0,0.42,-1.0,-0.0,0.8819286823272705,27.16180835212409,4,-34,-15,1232,1173,1215,457,20
-1,0,0.4,-1.0,-0.0,0.8889105319976807,26.249137920783717,4,-33,-15,1232,1173,1215,457,20
-1,0,0.42,-1.0,-0.0,0.8989253044128418,25.341194094144583,4,-32,-15,1232,1173,1215,457,20
-1,0,0.44,-1.0,-0.0,0.9068624973297119,24.438350715445125,4,-31,-15,1232,1173,1215,457,20
-1,0,0.45,-1.0,-0.0,0.9138455390930176,23.541019662496844,4,-30,-15,1232,1173,1215,457,20
-1,0,0.46,-1.0,-0.0,0.9228200912475586,22.649655434629018,4,-29,-15,1232,1173,1215,457,20
-1,0,0.47,-1.0,-0.0,0.9317965507507324,21.76476034853718,4,-28,-15,1232,1173,1215,457,20
-1,0,0.48,-1.0,-0.0,0.9407727718353271,20.886890422961002,4,-27,-15,1232,1173,1215,457,20
-1,0,0.49,-1.0,-0.0,0.9497878551483154,20.01666203960727,4,-26,-15,1232,1173,1215,457,20
-1,0,0.5,-1.0,-0.0,0.9597222805023193,19.154759474226502,4,-25,-15,1232,1173,1215,457,20
-1,0,0.51,-1.0,-0.0,0.9677009582519531,18.30194339616981,4,-24,-15,1232,1173,1215,457,20
-1,0,0.53,-1.0,-0.0,0.9756791591644287,17.459060435491963,4,-23,-15,1232,1173,1215,457,20
-1,0,0.54,-1.0,-0.0,0.9836585521697998,16.627053911388696,4,-22,-15,1232,1173,1215,457,20
-1,0,0.55,-1.0,-0.0,0.9906406402587891,15.80697580112788,4,-21,-15,1232,1173,1215,457,20
-1,0,0.56,-1.0,-0.0,1.0006134510040283,15.0,4,-20,-15,1232,1173,1215,457,20
-1,0,0.58,-1.0,-0.0,1.008601427078247,14.20743687382041,4,-19,-15,1232,1173,1215,457,20
-1,0,0.58,-1.0,-0.0,1.0165700912475586,13.430749027719962,4,-18,-15,1232,1173,1215,457,20
-1,0,0.6,-1.0,-0.0,1.0255475044250488,12.671568097509269,4,-17,-15,1232,1173,1215,457,20
-1,0,0.61,-1.0,-0.0,1.0325288772583008,11.931712199461309,4,-16,-15,1232,1173,1215,457,20
-1,0,0.62,-1.0,-0.0,1.0425364971160889,11.213203435596427,4,-15,-15,1232,1173,1215,457,20
-1,0,0.64,-1.0,-0.0,1.0514779090881348,10.518284528683193,4,-14,-15,1232,1173,1215,457,20
-1,0,0.65,-1.0,-0.0,1.0584595203399658,9.849433241279208,4,-13,-15,1232,1173,1215,457,20
-1,0,0.67,-1.0,-0.0,0.010979652404785156,1621.3286875659544,5,-1183,-1116,61,72,1245,1188,10
0,0,0.78,-0.0,-0.0,0.01894998550415039,1621.3286875659544,5,-1183,-1116,61,72,1245,1188,10
0,-1,0.68,-0.0,-1.0,0.025931596755981445,1620.6426421572485,5,-1183,-1115,61,72,1245,1188,10
-1,-1,0.66,-1.0,-1.0,0.035904884338378906,1619.2290478870275,5,-1182,-1114,61,72,1245,1188,10
-2,-2,0.44,-2.0,-2.0,0.043883562088012695,1616.4018625868173,5,-1180,-1112,61,72,1245,1188,10
-2,-2,0.16,-2.0,-2.0,0.052858591079711914,1613.5746816257815,5,-1178,-1110,61,72,1245,1188,10
-3,-3,0.1,-3.0,-3.0,0.06183624267578125,1609.3339183700502,5,-1175,-1107,61,72,1245,1188,10
-4,-4,0.03,-4.0,-4.0,0.07081103324890137,1603.679582763454,5,-1171,-1103,61,72,1245,1188,10
-5,-6,0.01,-5.0,-6.0,0.07984161376953125,1595.9262943683573,5,-1166,-1097,61,72,1245,1188,10
-7,-8,0.0,-7.0,-8.0,0.09075808525085449,1585.3465031243977,5,-1159,-1089,61,72,1245,1188,10
-9,-11,0.0,-9.0,-11.0,0.10073161125183105,1571.2563243330699,5,-1150,-1078,61,72,1245,1188,10
-12,-14,0.0,-12.0,-14.0,0.10973620414733887,1552.9281113068087,5,-1138,-1064,61,72,1245,1188,10
-16,-17,0.0,-16.0,-17.0,0.11871147155761719,1529.6312260605152,5,-1122,-1047,61,72,1245,1188,10
-20,-20,0.0,-20.0,-20.0,0.129655122756958,1501.364165797899,5,-1102,-1027,61,72,1245,1188,10
-24,-22,0.0,-24.0,-22.0,0.1376333236694336,1468.80765366448,5,-1078,-1005,61,72,1245,1188,10
-28,-24,0.0,-28.0,-24.0,0.14662742614746094,1431.9624212205413,5,-1050,-981,61,72,1245,1188,10
-31,-25,0.0,-31.0,-25.0,0.15658283233642578,1392.246220248958,5,-1019,-956,61,72,1245,1188,10
-33,-26,0.0,-33.0,-26.0,0.16356563568115234,1350.3951453358536,5,-986,-930,61,72,1245,1188,10
-34,-26,0.0,-34.0,-26.0,0.17055511474609375,1307.829006382781,5,-952,-904,61,72,1245,1188,10
-35,-26,0.0,-35.0,-26.0,0.17953157424926758,1264.5562216774806,5,-917,-878,61,72,1245,1188,10
-35,-26,0.0,-35.0,-26.0,0.1894969940185547,1221.3066500675923,5,-882,-852,61,72,1245,1188,10
-35,-26,0.0,-35.0,-26.0,0.19750285148620605,1178.0828373364225,5,-847,-826,61,72,1245,1188,10
-35,-26,0.0,-35.0,-26.0,0.20545434951782227,1134.8877137683344,5,-812,-800,61,72,1245,1188,10
-35,-26,0.0,-35.0,-26.0,0.21343183517456055,1091.7246691854798,5,-777,-774,61,72,1245,1188,10
-35,-26,0.0,-35.0,-26.0,0.22240900993347168,1048.5976461628984,5,-742,-748,61,72,1245,1188,10
-35,-25,0.0,-35.0,-25.0,0.229417085647583,1006.2259885900876,5,-707,-723,61,72,1245,1188,10
-34,-24,0.0,-34.0,-24.0,0.2393631935119629,965.3246879266754,5,-673,-699,61,72,1245,1188,10
-33,-23,0.0,-33.0,-23.0,0.2473456859588623,925.9006391661787,5,-640,-676,61,72,1245,1188,10
-32,-22,0.0,-32.0,-22.0,0.2553215026855469,887.9613653456682,5,-608,-654,61,72,1245,1188,10
-31,-21,0.0,-31.0,-21.0,0.26233386993408203,851.5150319755048,5,-577,-633,61,72,1245,1188,10
-30,-20,0.0,-30.0,-20.0,0.27129673957824707,816.5704473750258,5,-547,-613,61,72,1245,1188,10
-29,-19,0.0,-29.0,-19.0,0.2802557945251465,783.1370439206623,5,-518,-594,61,72,1245,1188,10
-28,-18,0.0,-28.0,-18.0,0.2912333011627197,751.2248342920245,5,-490,-576,61,72,1245,1188,10
-27,-17,0.0,-27.0,-17.0,0.2982344627380371,720.8443359288547,5,-463,-559,61,72,1245,1188,10
-26,-16,0.0,-26.0,-16.0,0.30718469619750977,692.0064562111315,5,-437,-543,61,72,1245,1188,10
-25,-15,0.0,-25.0,-15.0,0.3181726932525635,664.7223305221352,5,-412,-528,61,72,1245,1188,10
-24,-14,0.0,-24.0,-14.0,0.3251364231109619,639.003105582574,5,-388,-514,61,72,1245,1188,10
-23,-13,0.0,-23.0,-13.0,0.33510851860046387,614.8596615363836,5,-365,-501,61,72,1245,1188,10
-22,-13,0.0,-22.0,-13.0,0.34308838844299316,591.4838639896304,5,-343,-488,61,72,1245,1188,10
-21,-12,0.0,-21.0,-12.0,0.3520650863647461,569.6825210496662,5,-322,-476,61,72,1245,1188,10
-20,-12,0.0,-20.0,-12.0,0.36203742027282715,548.6244214266563,5,-302,-464,61,72,1245,1188,10
-19,-11,0.0,-19.0,-11.0,0.37001657485961914,529.1329422531436,5,-283,-453,61,72,1245,1188,10
-18,-11,0.0,-18.0,-11.0,0.3769986629486084,510.3532768887766,5,-265,-442,61,72,1245,1188,10
-17,-10,0.0,-17.0,-10.0,0.38697171211242676,493.1244824338591,5,-248,-432,61,72,1245,1188,10
-16,-10,0.0,-16.0,-10.0,0.39495086669921875,476.5682713800817,5,-232,-422,61,72,1245,1188,10
-15,-10,0.0,-15.0,-10.0,0.4049370288848877,460.6533045088373,5,-217,-412,61,72,1245,1188,10
-14,-10,0.0,-14.0,-10.0,0.4129030704498291,445.34764349333506,5,-203,-402,61,72,1245,1188,10
-13,-10,0.0,-13.0,-10.0,0.41988325119018555,430.6190996730974,5,-190,-392,61,72,1245,1188,10
-12,-10,0.0,-12.0,-10.0,0.4298579692840576,416.4356415871823,5,-178,-382,61,72,1245,1188,10
-11,-10,0.0,-11.0,-10.0,0.4378371238708496,402.7658641916952,5,-167,-372,61,72,1245,1188,10
-10,-10,0.0,-10.0,-10.0,0.44481706619262695,389.57952303686517,5,-157,-362,61,72,1245,1188,10
-9,-10,0.0,-9.0,-10.0,0.4547922611236572,376.8481373530582,5,-148,-352,61,72,1245,1188,10
-8,-10,0.0,-8.0,-10.0,0.46378087997436523,364.5456670020635,5,-140,-342,61,72,1245,1188,10
-7,-10,0.0,-7.0,-10.0,0.4737417697906494,352.64926953651116,5,-133,-332,61,72,1245,1188,10
-6,-10,0.0,-6.0,-10.0,0.4847118854522705,341.14014502799296,5,-127,-322,61,72,1245,1188,10
-6,-10,0.0,-6.0,-10.0,0.49471592903137207,329.6415993268022,5,-121,-312,61,72,1245,1188,10
-6,-10,0.0,-6.0,-10.0,0.5026946067810059,318.154761685481,5,-115,-302,61,72,1245,1188,10
-6,-10,0.0,-6.0,-10.0,0.5126683712005615,306.6809265899984,5,-109,-292,61,72,1245,1188,10
-6,-10,0.0,-6.0,-10.0,0.523667573928833,295.22158483360255,5,-103,-282,61,72,1245,1188,10
-6,-10,0.0,-6.0,-10.0,0.532630205154419,283.7784618007375,5,-97,-272,61,72,1245,1188,10
-6,-10,0.0,-6.0,-10.0,0.5406045913696289,272.35356496717327,5,-91,-262,61,72,1245,1188,10
-6,-10,0.0,-6.0,-10.0,0.5485730171203613,260.9492432777352,5,-85,-252,61,72,1245,1188,10
-6,-9,0.0,-6.0,-9.0,0.558546781539917,250.51907952244974,5,-79,-243,61,72,1245,1188,10
-6,-9,0.0,-6.0,-9.0,0.5655279159545898,240.12241839538055,5,-73,-234,61,72,1245,1188,10
-6,-9,0.0,-6.0,-9.0,0.5745046138763428,229.76371099469355,5,-67,-225,61,72,1245,1188,10
-6,-9,0.0,-6.0,-9.0,0.5834808349609375,219.44821228960592,5,-61,-216,61,72,1245,1188,10
-6,-9,0.0,-6.0,-9.0,0.5914590358734131,209.1821654573508,5,-55,-207,61,72,1245,1188,10
-6,-9,0.0,-6.0,-9.0,0.5984408855438232,198.9730374338726,5,-49,-198,61,72,1245,1188,10
-6,-8,0.0,-6.0,-8.0,0.6084167957305908,189.80503073586164,5,-43,-190,61,72,1245,1188,10
-5,-8,0.01,-5.0,-8.0,0.6153960227966309,180.9247159470736,5,-38,-182,61,72,1245,1188,10
-5,-7,0.01,-5.0,-7.0,0.6243722438812256,173.08424972467387,5,-33,-175,61,72,1245,1188,10
-4,-7,0.01,-4.0,-7.0,0.6333470344543457,165.48460341039598,5,-29,-168,61,72,1245,1188,10
-4,-7,0.01,-4.0,-7.0,0.6403558254241943,157.92943257741985,5,-25,-161,61,72,1245,1188,10
-4,-7,0.01,-4.0,-7.0,0.6493046283721924,150.42522317822161,5,-21,-154,61,72,1245,1188,10
-4,-7,0.01,-4.0,-7.0,0.6592793464660645,142.97972834141845,5,-17,-147,61,72,1245,1188,10
-4,-7,0.02,-4.0,-7.0,0.6662592887878418,135.60227594174995,5,-13,-140,61,72,1245,1188,10
-4,-7,0.01,-4.0,-7.0,0.6752371788024902,128.30416347586447,5,-9,-133,61,72,1245,1188,10
-4,-7,0.01,-4.0,-7.0,0.6852102279663086,121.09916732476864,5,-5,-126,61,72,1245,1188,10
-4,-7,0.01,-4.0,-7.0,0.6921913623809814,114.00420160649792,5,-1,-119,61,72,1245,1188,10
-4,-7,0.01,-4.0,-7.0,0.7021675109863281,107.04017136723775,5,3,-112,61,72,1245,1188,10
-4,-6,0.01,-4.0,-6.0,0.7091732025146484,101.23088063270491,5,7,-106,61,72,1245,1188,10
-3,-6,0.02,-3.0,-6.0,0.719123125076294,95.4987562112089,5,10,-100,61,72,1245,1188,10
-3,-5,0.01,-3.0,-5.0,0.7271077632904053,90.88534820294495,5,13,-95,61,72,1245,1188,10
-2,-5,0.01,-2.0,-5.0,0.7350845336914062,86.2414379544733,5,15,-90,61,72,1245,1188,10
-2,-5,0.01,-2.0,-5.0,0.7430570125579834,81.68333173107735,5,17,-85,61,72,1245,1188,10
-2,-5,0.01,-2.0,-5.0,0.7530298233032227,77.22530024268686,5,19,-80,61,72,1245,1188,10
-2,-5,0.01,-2.0,-5.0,0.7600102424621582,72.88452991448301,5,21,-75,61,72,1245,1188,10
-2,-5,0.01,-2.0,-5.0,0.7689864635467529,68.68174807915459,5,23,-70,61,72,1245,1188,10
-2,-4,0.01,-2.0,-4.0,0.7789599895477295,65.57619995437555,5,25,-66,61,72,1245,1188,10
-2,-4,0.01,-2.0,-4.0,0.7859501838684082,62.62396025078685,5,27,-62,61,72,1245,1188,10
-1,-4,0.01,-1.0,-4.0,0.7949187755584717,59.40496875241847,5,28,-58,61,72,1245,1188,10
-1,-4,0.01,-1.0,-4.0,0.8048915863037109,56.29437168288782,5,29,-54,61,72,1245,1188,10
-1,-3,0.01,-1.0,-3.0,0.811882734298706,54.16924876994806,5,30,-51,61,72,1245,1188,10
-1,-3,0.01,-1.0,-3.0,0.8208777904510498,52.14017850864661,5,31,-48,61,72,1245,1188,10
-1,-3,0.01,-1.0,-3.0,0.8298263549804688,50.21775076911409,5,32,-45,61,72,1245,1188,10
0,-3,0.01,-0.0,-3.0,0.8388020992279053,47.80151512977634,5,32,-42,61,72,1245,1188,10
0,-3,0.01,-0.0,-3.0,0.8487753868103027,45.44799302251776,5,32,-39,61,72,1245,1188,10
0,-3,0.01,-0.0,-3.0,0.8557813167572021,43.16637831516918,5,32,-36,61,72,1245,1188,10
0,-3,0.01,-0.0,-3.0,0.864732027053833,40.967379738244816,5,32,-33,61,72,1245,1188,10
0,-3,0.01,-0.0,-3.0,0.8747329711914062,38.86342439892262,5,32,-30,61,72,1245,1188,10
0,-3,0.01,-0.0,-3.0,0.8856770992279053,36.86884283091664,5,32,-27,61,72,1245,1188,10
0,-2,0.01,-0.0,-2.0,0.8955512046813965,35.607881008493905,5,32,-25,61,72,1245,1188,10
0,-2,0.02,-0.0,-2.0,0.9025323390960693,34.408120990476064,5,32,-23,61,72,1245,1188,10
0,-2,0.02,-0.0,-2.0,0.911522626876831,33.27531841800928,5,32,-21,61,72,1245,1188,10
0,-2,0.02,-0.0,-2.0,0.9204862117767334,32.21558813185679,5,32,-19,61,72,1245,1188,10
0,-2,0.01,-0.0,-2.0,0.9294955730438232,31.235341863986875,5,32,-17,61,72,1245,1188,10
0,-2,0.01,-0.0,-2.0,0.937441349029541,30.341194094144583,5,32,-15,61,72,1245,1188,10
0,-2,0.02,-0.0,-2.0,0.9464161396026611,29.539832078341085,5,32,-13,61,72,1245,1188,10
0,-2,0.02,-0.0,-2.0,0.9553916454315186,28.837848631377263,5,32,-11,61,72,1245,1188,10
0,-2,0.02,-0.0,-2.0,0.9623734951019287,28.241540277189323,5,32,-9,61,72,1245,1188,10
0,-2,0.02,-0.0,-2.0,0.9713494777679443,27.756678708318397,5,32,-7,61,72,1245,1188,10
0,-2,0.02,-0.0,-2.0,0.9803273677825928,27.38826948140329,5,32,-5,61,72,1245,1188,10
0,-2,0.02,-0.0,-2.0,0.9893028736114502,27.140317359976393,5,32,-3,61,72,1245,1188,10
0,-2,0.02,-0.0,-2.0,0.9988255500793457,27.015621187164243,5,32,-1,61,72,1245,1188,10
0,-2,0.03,-0.0,-2.0,1.0087995529174805,27.015621187164243,5,32,1,61,72,1245,1188,10
0,-2,0.03,-0.0,-2.0,1.0187935829162598,27.140317359976393,5,32,3,61,72,1245,1188,10
0,-2,0.03,-0.0,-2.0,1.0287466049194336,27.38826948140329,5,32,5,61,72,1245,1188,10
0,-2,0.03,-0.0,-2.0,1.0377228260040283,27.756678708318397,5,32,7,61,72,1245,1188,10
0,-2,0.03,-0.0,-2.0,1.0477015972137451,28.241540277189323,5,32,9,61,72,1245,1188,10
0,-2,0.03,-0.0,-2.0,1.0556747913360596,28.837848631377263,5,32,11,61,72,1245,1188,10
0,-2,0.04,-0.0,-2.0,1.0636529922485352,29.539832078341085,5,32,13,61,72,1245,1188,10
0,-1,0.04,-0.0,-1.0,1.0706348419189453,29.928498393145958,5,32,14,61,72,1245,1188,10
0,-1,0.1,-0.0,-1.0,1.0796101093292236,30.341194094144583,5,32,15,61,72,1245,1188,10
0,0,0.18,-0.0,-0.0,1.0885860919952393,30.341194094144583,5,32,15,61,72,1245,1188,10
0,0,0.5,-0.0,-0.0,1.0975637435913086,30.341194094144583,5,32,15,61,72,1245,1188,10
1,0,0.69,1.0,-0.0,1.1075477600097656,29.438350715445125,5,31,15,61,72,1245,1188,10
1,0,0.47,1.0,-0.0,1.1145172119140625,28.541019662496844,5,30,15,61,72,1245,1188,10
1,0,0.4,1.0,-0.0,1.1244924068450928,27.649655434629018,5,29,15,61,72,1245,1188,10
1,0,0.35,1.0,-0.0,1.1314730644226074,26.76476034853718,5,28,15,61,72,1245,1188,10
1,0,0.32,1.0,-0.0,1.141446590423584,25.886890422961002,5,27,15,61,72,1245,1188,10
1,0,0.32,1.0,-0.0,1.1484324932098389,25.01666203960727,5,26,15,61,72,1245,1188,10
1,0,0.32,1.0,-0.0,1.1574037075042725,24.154759474226502,5,25,15,61,72,1245,1188,10
1,0,0.31,1.0,-0.0,1.1673777103424072,23.30194339616981,5,24,15,61,72,1245,1188,10
1,0,0.31,1.0,-0.0,1.175356388092041,22.459060435491963,5,23,15,61,72,1245,1188,10
1,0,0.32,1.0,-0.0,1.1843326091766357,21.627053911388696,5,22,15,61,72,1245,1188,10
1,0,0.34,1.0,-0.0,1.1913244724273682,20.80697580112788,5,21,15,61,72,1245,1188,10
1,0,0.35,1.0,-0.0,1.2002902030944824,20.0,5,20,15,61,72,1245,1188,10
1,0,0.4,1.0,-0.0,1.2092669010162354,19.20743687382041,5,19,15,61,72,1245,1188,10
1,0,0.48,1.0,-0.0,1.2162747383117676,18.430749027719962,5,18,15,61,72,1245,1188,10
1,0,0.5,1.0,-0.0,1.2252285480499268,17.67156809750927,5,17,15,61,72,1245,1188,10
1,0,0.51,1.0,-0.0,1.2332017421722412,16.93171219946131,5,16,15,61,72,1245,1188,10
1,0,0.53,1.0,-0.0,1.242178201675415,16.213203435596427,5,15,15,61,72,1245,1188,10
1,0,0.6,1.0,-0.0,1.2511539459228516,15.518284528683193,5,14,15,61,72,1245,1188,10
1,0,0.61,1.0,-0.0,1.25913405418396,14.849433241279208,5,13,15,61,72,1245,1188,10
1,0,0.66,1.0,-0.0,1.2661142349243164,14.209372712298546,5,12,15,61,72,1245,1188,10
1,0,0.68,1.0,-0.0,1.275104284286499,13.601075237738275,5,11,15,61,72,1245,1188,10
1,0,0.71,1.0,-0.0,1.2850654125213623,13.027756377319946,5,10,15,61,72,1245,1188,10
1,0,0.74,1.0,-0.0,1.2920458316802979,12.4928556845359,5,9,15,61,72,1245,1188,10
1,0,0.76,1.0,-0.0,1.3000361919403076,12.0,5,8,15,61,72,1245,1188,10
1,0,0.78,1.0,-0.0,1.3090019226074219,11.552945357246848,5,7,15,61,72,1245,1188,10
1,0,0.8,1.0,-0.0,1.3189740180969238,11.15549442140351,5,6,15,61,72,1245,1188,10
1,0,0.82,1.0,-0.0,1.326953649520874,10.811388300841896,5,5,15,61,72,1245,1188,10
1,0,0.83,1.0,-0.0,1.3369269371032715,10.524174696260024,5,4,15,61,72,1245,1188,10
1,0,0.84,1.0,-0.0,1.345902919769287,10.297058540778355,5,3,15,61,72,1245,1188,10
1,0,0.85,1.0,-0.0,1.3538963794708252,10.132745950421556,5,2,15,61,72,1245,1188,10
1,0,0.86,1.0,-0.0,1.3608629703521729,10.033296378372908,5,1,15,61,72,1245,1188,10
0,0,0.86,-0.0,-0.0,1.3698394298553467,10.033296378372908,5,1,15,61,72,1245,1188,10
1,0,0.93,1.0,-0.0,1.3808107376098633,10.0,5,0,15,61,72,1245,1188,10
0,0,0.91,-0.0,-0.0,1.389786958694458,10.0,5,0,15,61,72,1245,1188,10
0,0,0.93,-0.0,-0.0,1.3997607231140137,10.0,5,0,15,61,72,1245,1188,10
0,0,0.89,-0.0,-0.0,1.408736228942871,10.0,5,0,15,61,72,1245,1188,10
0,1,0.89,-0.0,1.0,1.4167156219482422,9.0,5,0,14,61,72,1245,1188,10
0,1,0.89,-0.0,1.0,1.4246933460235596,8.0,5,0,13,61,72,1245,1188,10
0,1,0.86,-0.0,1.0,1.4336700439453125,7.0,5,0,12,61,72,1245,1188,10
0,1,0.86,-0.0,1.0,1.4416494369506836,6.0,5,0,11,61,72,1245,1188,10
0,1,0.87,-0.0,1.0,1.4506518840789795,5.0,5,0,10,61,72,1245,1188,10
0,1,0.83,-0.0,1.0,0.008976459503173828,807.7505690438095,6,334,753,395,816,61,62,32
0,1,0.73,-0.0,1.0,0.018922805786132812,806.8365572821859,6,334,752,395,816,61,62,32
0,1,0.53,-0.0,1.0,0.02590465545654297,805.922745761425,6,334,751,395,816,61,62,32
0,2,0.3,-0.0,2.0,0.034879207611083984,804.0957261198232,6,334,749,395,816,61,62,32
0,3,0.1,-0.0,3.0,0.04385638236999512,801.3567152718573,6,334,746,395,816,61,62,32
0,3,0.03,-0.0,3.0,0.052832603454589844,798.6195430997221,6,334,743,395,816,61,62,32
0,4,0.01,-0.0,4.0,0.061812400817871094,794.9728725426024,6,334,739,395,816,61,62,32
1,5,0.0,1.0,5.0,0.0707855224609375,790.005583107214,6,333,734,395,816,61,62,32
2,6,0.0,2.0,6.0,0.07876467704772949,783.7155744388126,6,331,728,395,816,61,62,32
3,7,0.0,3.0,7.0,0.08774042129516602,776.1016348928968,6,328,721,395,816,61,62,32
4,8,0.0,4.0,8.0,0.09674739837646484,767.1634567572723,6,324,713,395,816,61,62,32
5,9,0.0,5.0,9.0,0.1066901683807373,756.9016755060115,6,319,704,395,816,61,62,32
6,10,0.0,6.0,10.0,0.11369490623474121,745.3179362132486,6,313,694,395,816,61,62,32
7,11,0.0,7.0,11.0,0.12264871597290039,732.4149918327398,6,306,683,395,816,61,62,32
8,12,0.0,8.0,12.0,0.13164997100830078,718.196840091266,6,298,671,395,816,61,62,32
9,13,0.0,9.0,13.0,0.14059877395629883,702.6689084689833,6,289,658,395,816,61,62,32
10,14,0.0,10.0,14.0,0.14957571029663086,685.8383004652852,6,279,644,395,816,61,62,32
11,15,0.0,11.0,15.0,0.15855169296264648,667.7141215449627,6,268,629,395,816,61,62,32
11,16,0.0,11.0,16.0,0.16852569580078125,648.6939145200594,6,257,613,395,816,61,62,32
11,17,0.0,11.0,17.0,0.1755073070526123,628.7728282116113,6,246,596,395,816,61,62,32
11,17,0.0,11.0,17.0,0.1855001449584961,608.872787053493,6,235,579,395,816,61,62,32
11,17,0.0,11.0,17.0,0.19348597526550293,588.9958677544831,6,224,562,395,816,61,62,32
11,17,0.0,11.0,17.0,0.20146489143371582,569.1444266161988,6,213,545,395,816,61,62,32
11,17,0.0,11.0,17.0,0.20941638946533203,549.3211476674121,6,202,528,395,816,61,62,32
11,17,0.0,11.0,17.0,0.21839213371276855,529.5291009652922,6,191,511,395,816,61,62,32
11,17,0.0,11.0,17.0,0.22637057304382324,509.7718136226018,6,180,494,395,816,61,62,32
10,17,0.0,10.0,17.0,0.2333528995513916,490.38819101554884,6,170,477,395,816,61,62,32
9,17,0.0,9.0,17.0,0.24232816696166992,471.3612623095931,6,161,460,395,816,61,62,32
8,17,0.0,8.0,17.0,0.2523055076599121,452.67686096072634,6,153,443,395,816,61,62,32
7,17,0.0,7.0,17.0,0.25928306579589844,434.3243275684759,6,146,426,395,816,61,62,32
6,17,0.0,6.0,17.0,0.2692575454711914,416.29735136824513,6,140,409,395,816,61,62,32
6,17,0.0,6.0,17.0,0.2772355079650879,398.2704430682933,6,134,392,395,816,61,62,32
6,17,0.0,6.0,17.0,0.2852160930633545,380.24361193588976,6,128,375,395,816,61,62,32
6,17,0.0,6.0,17.0,0.29322099685668945,362.2168690050723,6,122,358,395,816,61,62,32
6,16,0.0,6.0,16.0,0.3041720390319824,345.13709308239163,6,116,342,395,816,61,62,32
6,16,0.0,6.0,16.0,0.31214380264282227,328.0581346226245,6,110,326,395,816,61,62,32
6,15,0.0,6.0,15.0,0.32012200355529785,311.9283458318296,6,104,311,395,816,61,62,32
6,15,0.0,6.0,15.0,0.32912540435791016,295.8012187275733,6,98,296,395,816,61,62,32
6,14,0.0,6.0,14.0,0.33808135986328125,280.627712798383,6,92,282,395,816,61,62,32
6,14,0.0,6.0,14.0,0.3490726947784424,265.46047679914136,6,86,268,395,816,61,62,32
6,13,0.0,6.0,13.0,0.35802507400512695,251.25456029785533,6,80,255,395,816,61,62,32
6,13,0.0,6.0,13.0,0.3690192699432373,237.06125740618614,6,74,242,395,816,61,62,32
6,12,0.0,6.0,12.0,0.3769984245300293,223.841614404173,6,68,230,395,816,61,62,32
5,12,0.0,5.0,12.0,0.38594675064086914,210.92069099136816,6,63,218,395,816,61,62,32
5,11,0.0,5.0,11.0,0.3929431438446045,198.9720912118594,6,58,207,395,816,61,62,32
4,11,0.0,4.0,11.0,0.40290236473083496,187.30272993740147,6,54,196,395,816,61,62,32
4,10,0.0,4.0,10.0,0.41088151931762695,176.60321908005588,6,50,186,395,816,61,62,32
3,10,0.0,3.0,10.0,0.4188954830169678,166.16750533506243,6,47,176,395,816,61,62,32
3,9,0.0,3.0,9.0,0.42683887481689453,156.69916039170545,6,44,167,395,816,61,62,32
2,9,0.0,2.0,9.0,0.4338207244873047,147.48700254148645,6,42,158,395,816,61,62,32
2,8,0.0,2.0,8.0,0.4428231716156006,139.24174696260025,6,40,150,395,816,61,62,32
2,8,0.0,2.0,8.0,0.4528031349182129,130.99659860010368,6,38,142,395,816,61,62,32
2,8,0.0,2.0,8.0,0.4607818126678467,122.7515765676196,6,36,134,395,816,61,62,32
2,8,0.0,2.0,8.0,0.46876025199890137,114.50670480860362,6,34,126,395,816,61,62,32
2,8,0.0,2.0,8.0,0.47673797607421875,106.2620137246234,6,32,118,395,816,61,62,32
2,7,0.0,2.0,7.0,0.4837193489074707,98.9826073804208,6,30,111,395,816,61,62,32
2,7,0.0,2.0,7.0,0.49370312690734863,91.70329614269008,6,28,104,395,816,61,62,32
2,6,0.0,2.0,6.0,0.5016720294952393,85.39033484509261,6,26,98,395,816,61,62,32
2,6,0.0,2.0,6.0,0.5096523761749268,79.0789145920377,6,24,92,395,816,61,62,32
2,6,0.0,2.0,6.0,0.5176315307617188,72.76936408468859,6,22,86,395,816,61,62,32
2,6,0.0,2.0,6.0,0.5266070365905762,66.46211251235322,6,20,80,395,816,61,62,32
2,6,0.0,2.0,6.0,0.5355815887451172,60.15773105863909,6,18,74,395,816,61,62,32
2,6,0.0,2.0,6.0,0.5425631999969482,53.856996786291916,6,16,68,395,816,61,62,32
2,6,0.0,2.0,6.0,0.5535683631896973,47.56099432828282,6,14,62,395,816,61,62,32
2,5,0.0,2.0,5.0,0.5605778694152832,42.249463516842795,6,12,57,395,816,61,62,32
2,5,0.0,2.0,5.0,0.5695273876190186,36.952809179494906,6,10,52,395,816,61,62,32
2,4,0.0,2.0,4.0,0.5785109996795654,32.662100242385755,6,8,48,395,816,61,62,32
2,4,0.0,2.0,4.0,0.5884757041931152,28.407206622349037,6,6,44,395,816,61,62,32
2,4,0.0,2.0,4.0,0.5954804420471191,24.19950248448356,6,4,40,395,816,61,62,32
2,4,0.0,2.0,4.0,0.6044340133666992,20.055512754639892,6,2,36,395,816,61,62,32
2,4,0.0,2.0,4.0,0.6124134063720703,16.0,6,0,32,395,816,61,62,32
2,4,0.0,2.0,4.0,0.6213879585266113,12.071337695236398,6,-2,28,395,816,61,62,32
2,4,0.0,2.0,4.0,0.6293680667877197,8.331050121192877,6,-4,24,395,816,61,62,32
2,4,0.0,2.0,4.0,0.6373460292816162,4.880613017821101,6,-6,20,395,816,61,62,32
2,3,0.0,2.0,3.0,0.6463222503662109,2.7882942280559355,6,-8,17,395,816,61,62,32
1,3,0.01,1.0,3.0,0.6552979946136475,0.6433169770932388,6,-9,14,395,816,61,62,32
1,2,0.01,1.0,2.0,0.6642744541168213,-0.37950064818669205,6,-10,12,395,816,61,62,32
1,2,0.01,1.0,2.0,0.6742479801177979,-1.133931252681494,6,-11,10,395,816,61,62,32
0,2,0.03,-0.0,2.0,0.6812307834625244,-2.398529491264556,6,-11,8,395,816,61,62,32
0,1,0.05,-0.0,1.0,0.6912035942077637,-2.9615951895947017,6,-11,7,395,816,61,62,32
0,1,0.15,-0.0,1.0,0.6981856822967529,-3.4700359138583323,6,-11,6,395,816,61,62,32
0,1,0.37,-0.0,1.0,0.708165168762207,-3.9169540264054277,6,-11,5,395,816,61,62,32
0,1,0.51,-0.0,1.0,0.7171339988708496,-4.295300089280374,6,-11,4,395,816,61,62,32
0,1,0.59,-0.0,1.0,0.009973287582397461,889.3040625248815,7,897,-223,1303,590,406,812,70
0,1,0.51,-0.0,1.0,0.019947528839111328,889.5458344506236,7,897,-224,1303,590,406,812,70
0,1,0.5,-0.0,1.0,0.029922008514404297,889.7886244975118,7,897,-225,1303,590,406,812,70
1,1,0.32,1.0,1.0,0.039895057678222656,889.0627684308031,7,896,-226,1303,590,406,812,70
1,1,0.21,1.0,1.0,0.046892404556274414,888.3385078074022,7,895,-227,1303,590,406,812,70
1,1,0.15,1.0,1.0,0.05585169792175293,887.6158463846152,7,894,-228,1303,590,406,812,70
1,1,0.05,1.0,1.0,0.06383013725280762,886.8947879232206,7,893,-229,1303,590,406,812,70
1,1,0.02,1.0,1.0,0.07380461692810059,886.1753361874166,7,892,-230,1303,590,406,812,70
2,1,0.0,2.0,1.0,0.08178281784057617,884.4895322949577,7,890,-231,1303,590,406,812,70
3,1,0.0,3.0,1.0,0.08976268768310547,881.8385899382727,7,887,-232,1303,590,406,812,70
4,1,0.0,4.0,1.0,0.09674286842346191,878.2239593878382,7,883,-233,1303,590,406,812,70
5,1,0.0,5.0,1.0,0.1047518253326416,873.647346334099,7,878,-234,1303,590,406,812,70
6,0,0.0,6.0,-0.0,0.11470961570739746,867.8510397623741,7,872,-234,1303,590,406,812,70
7,0,0.0,7.0,-0.0,0.1217048168182373,861.0920711623332,7,865,-234,1303,590,406,812,70
9,0,0.0,9.0,-0.0,0.13068103790283203,852.4074599641363,7,856,-234,1303,590,406,812,70
11,-1,0.0,11.0,-1.0,0.14062738418579102,841.5352246202089,7,845,-233,1303,590,406,812,70
13,-1,0.0,13.0,-1.0,0.1486060619354248,828.7407018312846,7,832,-232,1303,590,406,812,70
15,-1,0.0,15.0,-1.0,0.1565842628479004,814.0288569889718,7,817,-231,1303,590,406,812,70
17,-1,0.0,17.0,-1.0,0.16356730461120605,797.4061508662703,7,800,-230,1303,590,406,812,70
19,-1,0.0,19.0,-1.0,0.1735389232635498,778.8808266570727,7,781,-229,1303,590,406,812,70
20,-1,0.0,20.0,-1.0,0.18052101135253906,759.4211729303292,7,761,-228,1303,590,406,812,70
21,-1,0.0,21.0,-1.0,0.19050168991088867,739.0342369688824,7,740,-227,1303,590,406,812,70
22,-1,0.0,22.0,-1.0,0.19847321510314941,717.7283706623525,7,718,-226,1303,590,406,812,70
22,-1,0.0,22.0,-1.0,0.20847439765930176,696.464968402452,7,696,-225,1303,590,406,812,70
22,-1,0.0,22.0,-1.0,0.21842002868652344,675.2478440657177,7,674,-224,1303,590,406,812,70
22,-1,0.0,22.0,-1.0,0.22640013694763184,654.0812724200244,7,652,-223,1303,590,406,812,70
22,-1,0.0,22.0,-1.0,0.23443102836608887,632.9700592092433,7,630,-222,1303,590,406,812,70
21,-2,0.0,21.0,-2.0,0.2434067726135254,612.5191116870606,7,609,-220,1303,590,406,812,70
20,-2,0.0,20.0,-2.0,0.25038814544677734,593.048565001147,7,589,-218,1303,590,406,812,70
19,-3,0.0,19.0,-3.0,0.2603607177734375,574.2002954693965,7,570,-215,1303,590,406,812,70
18,-3,0.0,18.0,-3.0,0.26933789253234863,556.3104091760943,7,552,-212,1303,590,406,812,70
17,-4,0.0,17.0,-4.0,0.2773158550262451,539.011323930112,7,535,-208,1303,590,406,812,70
17,-4,0.0,17.0,-4.0,0.28629255294799805,521.7225520849681,7,518,-204,1303,590,406,812,70
17,-4,0.0,17.0,-4.0,0.2933042049407959,504.44508524964795,7,501,-200,1303,590,406,812,70
17,-4,0.0,17.0,-4.0,0.30324864387512207,487.1800455781512,7,484,-196,1303,590,406,812,70
17,-4,0.0,17.0,-4.0,0.31122708320617676,469.92870783903743,7,467,-192,1303,590,406,812,70
17,-4,0.0,17.0,-4.0,0.31920480728149414,452.6925260858526,7,450,-188,1303,590,406,812,70
17,-4,0.0,17.0,-4.0,0.32818150520324707,435.4731660785767,7,433,-184,1303,590,406,812,70
16,-4,0.0,16.0,-4.0,0.3361678123474121,419.1904886718787,7,417,-180,1303,590,406,812,70
15,-4,0.0,15.0,-4.0,0.3431425094604492,403.8393783606936,7,402,-176,1303,590,406,812,70
14,-4,0.0,14.0,-4.0,0.35312819480895996,389.41489135043315,7,388,-172,1303,590,406,812,70
13,-4,0.0,13.0,-4.0,0.36011791229248047,375.9123994235268,7,375,-168,1303,590,406,812,70
12,-4,0.0,12.0,-4.0,0.37007761001586914,363.32775449370837,7,363,-164,1303,590,406,812,70
12,-4,0.0,12.0,-4.0,0.3770616054534912,350.7473266271589,7,351,-160,1303,590,406,812,70
12,-4,0.0,12.0,-4.0,0.3860359191894531,338.17154232336634,7,339,-156,1303,590,406,812,70
12,-4,0.0,12.0,-4.0,0.39600181579589844,325.6008874087805,7,327,-152,1303,590,406,812,70
12,-4,0.0,12.0,-4.0,0.40497660636901855,313.0359176866664,7,315,-148,1303,590,406,812,70
12,-4,0.0,12.0,-4.0,0.4139528274536133,300.47727195743084,7,303,-144,1303,590,406,812,70
12,-4,0.0,12.0,-4.0,0.4249236583709717,287.92568804602706,7,291,-140,1303,590,406,812,70
11,-4,0.0,11.0,-4.0,0.4329032897949219,276.2812233334995,7,280,-136,1303,590,406,812,70
11,-4,0.0,11.0,-4.0,0.44127988815307617,264.6414524060381,7,269,-132,1303,590,406,812,70
10,-4,0.0,10.0,-4.0,0.4482603073120117,253.90309794116087,7,259,-128,1303,590,406,812,70
10,-4,0.0,10.0,-4.0,0.45723748207092285,243.16721589720095,7,249,-124,1303,590,406,812,70
9,-4,0.0,9.0,-4.0,0.46521735191345215,233.32815729997475,7,240,-120,1303,590,406,812,70
9,-4,0.0,9.0,-4.0,0.47319507598876953,223.48984506165806,7,231,-116,1303,590,406,812,70
8,-4,0.0,8.0,-4.0,0.48020339012145996,214.545587017683,7,223,-112,1303,590,406,812,70
8,-4,0.0,8.0,-4.0,0.49015045166015625,205.6013300046365,7,215,-108,1303,590,406,812,70
7,-4,0.0,7.0,-4.0,0.4971601963043213,197.55106965997814,7,208,-104,1303,590,406,812,70
7,-4,0.0,7.0,-4.0,0.5061116218566895,189.50167037240502,7,201,-100,1303,590,406,812,70
7,-4,0.0,7.0,-4.0,0.5131196975708008,181.453228204155,7,194,-96,1303,590,406,812,70
7,-4,0.0,7.0,-4.0,0.5240600109100342,173.40585404445815,7,187,-92,1303,590,406,812,70
7,-4,0.0,7.0,-4.0,0.5320391654968262,165.3596765818911,7,180,-88,1303,590,406,812,70
7,-4,0.0,7.0,-4.0,0.5430088043212891,157.31484602078956,7,173,-84,1303,590,406,812,70
7,-4,0.0,7.0,-4.0,0.5529863834381104,149.27153876819935,7,166,-80,1303,590,406,812,70
6,-4,0.0,6.0,-4.0,0.5619590282440186,142.13271860387624,7,160,-76,1303,590,406,812,70
6,-4,0.0,6.0,-4.0,0.5709629058837891,135.0,7,154,-72,1303,590,406,812,70
6,-4,0.0,6.0,-4.0,0.5809075832366943,127.87418457201866,7,148,-68,1303,590,406,812,70
6,-4,0.0,6.0,-4.0,0.5908820629119873,120.7562197795003,7,142,-64,1303,590,406,812,70
6,-4,0.0,6.0,-4.0,0.5978643894195557,113.64723340849636,7,136,-60,1303,590,406,812,70
6,-4,0.0,6.0,-4.0,0.6078360080718994,106.54857823376398,7,130,-56,1303,590,406,812,70
6,-4,0.0,6.0,-4.0,0.6158154010772705,99.46189051177288,7,124,-52,1303,590,406,812,70
6,-4,0.0,6.0,-4.0,0.6247920989990234,92.38916751435343,7,118,-48,1303,590,406,812,70
5,-3,0.0,5.0,-3.0,0.631800651550293,86.63058825805291,7,113,-45,1303,590,406,812,70
5,-3,0.0,5.0,-3.0,0.6407768726348877,80.8792474949678,7,108,-42,1303,590,406,812,70
4,-3,0.0,4.0,-3.0,0.6487283706665039,76.07204868912791,7,104,-39,1303,590,406,812,70
4,-3,0.0,4.0,-3.0,0.6557087898254395,71.28264204469139,7,100,-36,1303,590,406,812,70
4,-3,0.0,4.0,-3.0,0.6646862030029297,66.51354589413178,7,96,-33,1303,590,406,812,70
4,-3,0.0,4.0,-3.0,0.6746587753295898,61.767763227223554,7,92,-30,1303,590,406,812,70
4,-3,0.0,4.0,-3.0,0.6826374530792236,57.04890004774636,7,88,-27,1303,590,406,812,70
4,-3,0.0,4.0,-3.0,0.690617561340332,52.36131867136622,7,84,-24,1303,590,406,812,70
4,-3,0.0,4.0,-3.0,0.6995925903320312,47.710337927008865,7,80,-21,1303,590,406,812,70
4,-3,0.0,4.0,-3.0,0.7075719833374023,43.10249675906654,7,76,-18,1303,590,406,812,70
3,-3,0.0,3.0,-3.0,0.7155508995056152,39.52516353554684,7,73,-15,1303,590,406,812,70
3,-2,0.0,3.0,-2.0,0.7245302200317383,36.19691004531025,7,70,-13,1303,590,406,812,70
3,-2,0.01,3.0,-2.0,0.7315092086791992,32.896980787071826,7,67,-11,1303,590,406,812,70
2,-2,0.01,2.0,-2.0,0.7414813041687012,30.620118866091673,7,65,-9,1303,590,406,812,70
2,-1,0.01,2.0,-1.0,0.7494614124298096,28.50590523722971,7,63,-8,1303,590,406,812,70
1,-1,0.09,1.0,-1.0,0.758436918258667,27.393909959225986,7,62,-7,1303,590,406,812,70
1,-1,0.43,1.0,-1.0,0.7674133777618408,26.29437168288782,7,61,-6,1303,590,406,812,70
1,0,0.65,1.0,-0.0,0.7763900756835938,25.29925372672534,7,60,-6,1303,590,406,812,70
0,0,0.79,-0.0,-0.0,0.008985519409179688,1024.6625660865795,8,-941,418,302,1014,1243,596,11
0,0,0.57,-0.0,-0.0,0.01795029640197754,1024.6625660865795,8,-941,418,302,1014,1243,596,11
-1,0,0.37,-1.0,-0.0,0.026928424835205078,1023.7487545557467,8,-940,418,302,1014,1243,596,11
-1,0,0.2,-1.0,-0.0,0.035918474197387695,1022.8351035063943,8,-939,418,302,1014,1243,596,11
-2,0,0.23,-2.0,-0.0,0.04489445686340332,1021.0082845669424,8,-937,418,302,1014,1243,596,11
-2,0,0.14,-2.0,-0.0,0.05388522148132324,1019.1821127123828,8,-935,418,302,1014,1243,596,11
-2,0,0.1,-2.0,-0.0,0.06383013725280762,1017.3565914102574,8,-933,418,302,1014,1243,596,11
-3,1,0.09,-3.0,1.0,0.07081103324890137,1014.2099881771175,8,-930,417,302,1014,1243,596,11
-3,1,0.04,-3.0,1.0,0.07979726791381836,1011.0634822687016,8,-927,416,302,1014,1243,596,11
-4,2,0.02,-4.0,2.0,0.08876323699951172,1006.595274801143,8,-923,414,302,1014,1243,596,11
-4,3,0.01,-4.0,3.0,0.09873676300048828,1001.7184313401638,8,-919,411,302,1014,1243,596,11
-5,3,0.01,-5.0,3.0,0.10671591758728027,995.9295679517115,8,-914,408,302,1014,1243,596,11
-6,4,0.0,-6.0,4.0,0.11469459533691406,988.8209094198008,8,-908,404,302,1014,1243,596,11
-7,5,0.0,-7.0,5.0,0.12267279624938965,980.3943373086736,8,-901,399,302,1014,1243,596,11
-8,6,0.0,-8.0,6.0,0.13265585899353027,970.6526021079429,8,-893,393,302,1014,1243,596,11
-9,7,0.0,-9.0,7.0,0.13962817192077637,959.5993987143056,8,-884,386,302,1014,1243,596,11
-10,8,0.0,-10.0,8.0,0.1486034393310547,947.2394656807709,8,-874,378,302,1014,1243,596,11
-11,8,0.0,-11.0,8.0,0.1575794219970703,933.9723105608599,8,-863,370,302,1014,1243,596,11
-12,9,0.0,-12.0,9.0,0.16655731201171875,919.4035915118461,8,-851,361,302,1014,1243,596,11
-13,9,0.0,-13.0,9.0,0.1765298843383789,903.9268397401411,8,-838,352,302,1014,1243,596,11
-14,9,0.0,-14.0,9.0,0.18351125717163086,887.5385145751414,8,-824,343,302,1014,1243,596,11
-14,9,0.0,-14.0,9.0,0.19251441955566406,871.1598027757266,8,-810,334,302,1014,1243,596,11
-14,9,0.0,-14.0,9.0,0.20047450065612793,854.7912537354634,8,-796,325,302,1014,1243,596,11
-14,9,0.0,-14.0,9.0,0.20748138427734375,838.4334591418578,8,-782,316,302,1014,1243,596,11
-14,9,0.0,-14.0,9.0,0.21642446517944336,822.0870570864956,8,-768,307,302,1014,1243,596,11
-14,9,0.0,-14.0,9.0,0.2264103889465332,805.7527366589644,8,-754,298,302,1014,1243,596,11
-14,9,0.0,-14.0,9.0,0.23337817192077637,789.4312430915592,8,-740,289,302,1014,1243,596,11
-14,9,0.0,-14.0,9.0,0.24335336685180664,773.1233835324575,8,-726,280,302,1014,1243,596,11
-14,9,0.0,-14.0,9.0,0.25133180618286133,756.8300335376651,8,-712,271,302,1014,1243,596,11
-14,9,0.0,-14.0,9.0,0.26030659675598145,740.5521443869637,8,-698,262,302,1014,1243,596,11
-14,9,0.0,-14.0,9.0,0.2672896385192871,724.2907513468136,8,-684,253,302,1014,1243,596,11
-14,9,0.0,-14.0,9.0,0.2772634029388428,708.0469830242605,8,-670,244,302,1014,1243,596,11
-14,8,0.0,-14.0,8.0,0.28524017333984375,692.159952951975,8,-656,236,302,1014,1243,596,11
-14,8,0.0,-14.0,8.0,0.29324960708618164,676.2840817162837,8,-642,228,302,1014,1243,596,11
-14,7,0.0,-14.0,7.0,0.30121326446533203,660.7514551242077,8,-628,221,302,1014,1243,596,11
-14,7,0.0,-14.0,7.0,0.31017518043518066,645.2245765887352,8,-614,214,302,1014,1243,596,11
-14,7,0.0,-14.0,7.0,0.3171839714050293,629.7038679573333,8,-600,207,302,1014,1243,596,11
-14,7,0.0,-14.0,7.0,0.32616257667541504,614.18979319753,8,-586,200,302,1014,1243,596,11
-14,7,0.0,-14.0,7.0,0.33411598205566406,598.6828637620915,8,-572,193,302,1014,1243,596,11
-14,7,0.0,-14.0,7.0,0.3410933017730713,583.1836447913186,8,-558,186,302,1014,1243,596,11
-14,7,0.0,-14.0,7.0,0.3500692844390869,567.6927623080285,8,-544,179,302,1014,1243,596,11
-14,6,0.0,-14.0,6.0,0.3590731620788574,552.5204032140887,8,-530,173,302,1014,1243,596,11
-14,6,0.0,-14.0,6.0,0.36804890632629395,537.3513621260668,8,-516,167,302,1014,1243,596,11
-14,6,0.0,-14.0,6.0,0.3769984245300293,522.185925457044,8,-502,161,302,1014,1243,596,11
-14,5,0.0,-14.0,5.0,0.3859736919403076,507.3280199247354,8,-488,156,302,1014,1243,596,11
-14,5,0.0,-14.0,5.0,0.3949766159057617,492.4706021464987,8,-474,151,302,1014,1243,596,11
-13,5,0.0,-13.0,5.0,0.4029557704925537,478.56695503311636,8,-461,146,302,1014,1243,596,11
-13,5,0.0,-13.0,5.0,0.41190361976623535,464.6647740676322,8,-448,141,302,1014,1243,596,11
-12,5,0.0,-12.0,5.0,0.4209249019622803,451.71873182517925,8,-436,136,302,1014,1243,596,11
-12,5,0.0,-12.0,5.0,0.43085432052612305,438.77584431782674,8,-424,131,302,1014,1243,596,11
-11,5,0.0,-11.0,5.0,0.43883252143859863,426.7927743721518,8,-413,126,302,1014,1243,596,11
-11,5,0.0,-11.0,5.0,0.4458150863647461,414.81543563809083,8,-402,121,302,1014,1243,596,11
-11,5,0.0,-11.0,5.0,0.4547898769378662,402.8443330487749,8,-391,116,302,1014,1243,596,11
-11,5,0.0,-11.0,5.0,0.46378111839294434,390.8800323330289,8,-380,111,302,1014,1243,596,11
-11,5,0.0,-11.0,5.0,0.473102331161499,378.92316939721155,8,-369,106,302,1014,1243,596,11
-11,5,0.0,-11.0,5.0,0.48208022117614746,366.9744614889576,8,-358,101,302,1014,1243,596,11
-11,5,0.0,-11.0,5.0,0.4910550117492676,355.0347205478938,8,-347,96,302,1014,1243,596,11
-11,5,0.0,-11.0,5.0,0.5020256042480469,343.104869256378,8,-336,91,302,1014,1243,596,11
-11,4,0.0,-11.0,4.0,0.5100319385528564,331.44316013258464,8,-325,87,302,1014,1243,596,11
-11,4,0.0,-11.0,4.0,0.5169878005981445,319.7845439672276,8,-314,83,302,1014,1243,596,11
-11,4,0.0,-11.0,4.0,0.5269646644592285,308.12936623702353,8,-303,79,302,1014,1243,596,11
-11,4,0.0,-11.0,4.0,0.5359365940093994,296.4780257332199,8,-292,75,302,1014,1243,596,11
-11,4,0.0,-11.0,4.0,0.542940616607666,284.8309852310481,8,-281,71,302,1014,1243,596,11
-11,4,0.0,-11.0,4.0,0.5529179573059082,273.18878482066816,8,-270,67,302,1014,1243,596,11
-11,4,0.0,-11.0,4.0,0.5608706474304199,261.5520587052368,8,-259,63,302,1014,1243,596,11
-11,4,0.0,-11.0,4.0,0.5688493251800537,249.9215565620138,8,-248,59,302,1014,1243,596,11
-11,4,0.0,-11.0,4.0,0.576826810836792,238.29817097545143,8,-237,55,302,1014,1243,596,11
-11,4,0.0,-11.0,4.0,0.5848336219787598,226.68297304722245,8,-226,51,302,1014,1243,596,11
-10,4,0.01,-10.0,4.0,0.5947792530059814,216.05429197371402,8,-216,47,302,1014,1243,596,11
-9,4,0.01,-9.0,4.0,0.6037557125091553,206.4190152280537,8,-207,43,302,1014,1243,596,11
-8,4,0.01,-8.0,4.0,0.6117367744445801,197.7856010667424,8,-199,39,302,1014,1243,596,11
-7,3,0.01,-7.0,3.0,0.6207108497619629,190.34584715319647,8,-192,36,302,1014,1243,596,11
-6,3,0.02,-6.0,3.0,0.6306838989257812,183.904737897174,8,-186,33,302,1014,1243,596,11
-6,3,0.02,-6.0,3.0,0.6406850814819336,177.4828759089466,8,-180,30,302,1014,1243,596,11
-6,3,0.02,-6.0,3.0,0.650658130645752,171.08236708995025,8,-174,27,302,1014,1243,596,11
-6,3,0.02,-6.0,3.0,0.6606111526489258,164.7056274847714,8,-168,24,302,1014,1243,596,11
-6,3,0.02,-6.0,3.0,0.6696076393127441,158.35544068074378,8,-162,21,302,1014,1243,596,11
-6,3,0.02,-6.0,3.0,0.6775901317596436,152.0350279396288,8,-156,18,302,1014,1243,596,11
-6,3,0.02,-6.0,3.0,0.6875362396240234,145.74813431681335,8,-150,15,302,1014,1243,596,11
-6,3,0.02,-6.0,3.0,0.6955258846282959,139.49913494550754,8,-144,12,302,1014,1243,596,11
-6,3,0.02,-6.0,3.0,0.70448899269104,133.2931668593933,8,-138,9,302,1014,1243,596,11
-6,3,0.02,-6.0,3.0,0.7134914398193359,127.13629327327143,8,-132,6,302,1014,1243,596,11
-6,3,0.02,-6.0,3.0,0.7204451560974121,121.03570922560003,8,-126,3,302,1014,1243,596,11
-6,3,0.02,-6.0,3.0,0.7284255027770996,115.0,8,-120,0,302,1014,1243,596,11
-6,3,0.02,-6.0,3.0,0.7374105453491211,109.03946685248927,8,-114,-3,302,1014,1243,596,11
-6,3,0.02,-6.0,3.0,0.7463903427124023,103.16653826391968,8,-108,-6,302,1014,1243,596,11
-6,3,0.02,-6.0,3.0,0.7553534507751465,97.39628899525607,8,-102,-9,302,1014,1243,596,11
-6,3,0.02,-6.0,3.0,0.7653272151947021,91.74709297958259,8,-96,-12,302,1014,1243,596,11
-6,3,0.02,-6.0,3.0,0.7723269462585449,86.2414379544733,8,-90,-15,302,1014,1243,596,11
-6,3,0.02,-6.0,3.0,0.7822883129119873,80.90692637965812,8,-84,-18,302,1014,1243,596,11
-6,3,0.02,-6.0,3.0,0.790259599685669,75.77747210701756,8,-78,-21,302,1014,1243,596,11
-5,3,0.02,-5.0,3.0,0.7972424030303955,71.84399781375251,8,-73,-24,302,1014,1243,596,11
-5,2,0.02,-5.0,2.0,0.8052210807800293,67.80109889280519,8,-68,-26,302,1014,1243,596,11
-4,2,0.02,-4.0,2.0,0.8151934146881104,64.85699678629192,8,-64,-28,302,1014,1243,596,11
-3,1,0.02,-3.0,1.0,0.8221757411956787,62.54257916307313,8,-61,-29,302,1014,1243,596,11
-3,1,0.03,-3.0,1.0,0.8331470489501953,60.299310869258036,8,-58,-30,302,1014,1243,596,11
-3,1,0.03,-3.0,1.0,0.8411450386047363,58.13477647065839,8,-55,-31,302,1014,1243,596,11
-3,1,0.02,-3.0,1.0,0.8481066226959229,56.05735008989499,8,-52,-32,302,1014,1243,596,11
-3,1,0.02,-3.0,1.0,0.8570840358734131,54.07622195096772,8,-49,-33,302,1014,1243,596,11
-3,1,0.01,-3.0,1.0,0.8660597801208496,52.201398584300364,8,-46,-34,302,1014,1243,596,11
-3,1,0.01,-3.0,1.0,0.8757214546203613,50.44366510251645,8,-43,-35,302,1014,1243,596,11
-3,1,0.01,-3.0,1.0,0.884697437286377,48.81449618829484,8,-40,-36,302,1014,1243,596,11
-3,1,0.01,-3.0,1.0,0.8936741352081299,47.32590180780452,8,-37,-37,302,1014,1243,596,11
-3,1,0.01,-3.0,1.0,0.9006552696228027,45.99019513592785,8,-34,-38,302,1014,1243,596,11
-3,1,0.01,-3.0,1.0,0.9106292724609375,44.8196748283246,8,-31,-39,302,1014,1243,596,11
-3,1,0.01,-3.0,1.0,0.9176092147827148,43.82622246293481,8,-28,-40,302,1014,1243,596,11
-3,1,0.01,-3.0,1.0,0.9265854358673096,43.02082881417188,8,-25,-41,302,1014,1243,596,11
-3,1,0.01,-3.0,1.0,0.9355621337890625,42.41307836451879,8,-22,-42,302,1014,1243,596,11
-3,1,0.02,-3.0,1.0,0.9435513019561768,42.01063709417264,8,-19,-43,302,1014,1243,596,11
-3,1,0.01,-3.0,1.0,0.9505214691162109,41.8187996428785,8,-16,-44,302,1014,1243,596,11
-3,1,0.01,-3.0,1.0,0.9604952335357666,41.84015371452148,8,-13,-45,302,1014,1243,596,11
-3,1,0.01,-3.0,1.0,0.9692316055297852,42.07440918375928,8,-10,-46,302,1014,1243,596,11
-3,1,0.02,-3.0,1.0,0.9772107601165771,42.51841748206689,8,-7,-47,302,1014,1243,596,11
-3,1,0.02,-3.0,1.0,0.9842188358306885,43.16637831516918,8,-4,-48,302,1014,1243,596,11
-3,1,0.03,-3.0,1.0,0.9941647052764893,44.01020301937138,8,-1,-49,302,1014,1243,596,11
-3,1,0.03,-3.0,1.0,1.0021438598632812,45.039984012787215,8,2,-50,302,1014,1243,596,11
-3,1,0.03,-3.0,1.0,1.0101494789123535,46.24451190127583,8,5,-51,302,1014,1243,596,11
-3,1,0.03,-3.0,1.0,1.0181019306182861,47.61178575186362,8,8,-52,302,1014,1243,596,11
-3,1,0.03,-3.0,1.0,1.0250933170318604,49.12947441089743,8,11,-53,302,1014,1243,596,11
-3,1,0.03,-3.0,1.0,1.0340583324432373,50.78530272392541,8,14,-54,302,1014,1243,596,11
-3,1,0.03,-3.0,1.0,1.0440611839294434,52.56735185849702,8,17,-55,302,1014,1243,596,11
-3,1,0.03,-3.0,1.0,1.0510413646697998,54.464274989274024,8,20,-56,302,1014,1243,596,11
-3,1,0.03,-3.0,1.0,1.060988187789917,56.465437442517235,8,23,-57,302,1014,1243,596,11
-3,1,0.03,-3.0,1.0,1.0682413578033447,58.56099432828282,8,26,-58,302,1014,1243,596,11
-3,1,0.03,-3.0,1.0,1.0782148838043213,60.74191965557441,8,29,-59,302,1014,1243,596,11
-3,1,0.02,-3.0,1.0,1.086193323135376,63.0,8,32,-60,302,1014,1243,596,11
-3,1,0.02,-3.0,1.0,1.0941987037658691,65.32780389006896,8,35,-61,302,1014,1243,596,11
-3,1,0.02,-3.0,1.0,1.1031482219696045,67.71863585079137,8,38,-62,302,1014,1243,596,11
-3,1,0.02,-3.0,1.0,1.1111266613006592,70.16648189186454,8,41,-63,302,1014,1243,596,11
-3,1,0.02,-3.0,1.0,1.119105577468872,72.6659513557904,8,44,-64,302,1014,1243,596,11
-3,1,0.02,-3.0,1.0,1.1280815601348877,75.2122185206219,8,47,-65,302,1014,1243,596,11
-3,1,0.02,-3.0,1.0,1.135068655014038,77.80096617793781,8,50,-66,302,1014,1243,596,11
-3,1,0.02,-3.0,1.0,1.1420447826385498,80.42833253669417,8,53,-67,302,1014,1243,596,11
-3,1,0.02,-3.0,1.0,1.1520180702209473,83.09086218218096,8,56,-68,302,1014,1243,596,11
-3,1,0.02,-3.0,1.0,1.159996509552002,85.78546139112804,8,59,-69,302,1014,1243,596,11
-3,1,0.02,-3.0,1.0,1.1671147346496582,88.50935782048768,8,62,-70,302,1014,1243,596,11
-3,1,0.02,-3.0,1.0,1.1770803928375244,91.26006440887103,8,65,-71,302,1014,1243,596,11
-3,1,0.02,-3.0,1.0,1.185058832168579,94.03534722511958,8,68,-72,302,1014,1243,596,11
-3,1,0.02,-3.0,1.0,1.194042444229126,96.83319694480774,8,71,-73,302,1014,1243,596,11
-3,1,0.02,-3.0,1.0,1.201016902923584,99.65180361560904,8,74,-74,302,1014,1243,596,11
-3,1,0.02,-3.0,1.0,1.2109901905059814,102.48953437428223,8,77,-75,302,1014,1243,596,11
-3,1,0.02,-3.0,1.0,1.217972755432129,105.34491379306978,8,80,-76,302,1014,1243,596,11
-3,1,0.02,-3.0,1.0,1.2279441356658936,108.21660655575224,8,83,-77,302,1014,1243,596,11
-3,1,0.02,-3.0,1.0,1.2349269390106201,111.10340218959993,8,86,-78,302,1014,1243,596,11
-3,1,0.02,-3.0,1.0,1.2449004650115967,114.00420160649792,8,89,-79,302,1014,1243,596,11
-3,1,0.01,-3.0,1.0,1.2518935203552246,116.91800523302537,8,92,-80,302,1014,1243,596,11
-3,1,0.01,-3.0,1.0,1.2618553638458252,119.84390253432484,8,95,-81,302,1014,1243,596,11
-3,1,0.01,-3.0,1.0,1.2694199085235596,122.7810627597063,8,98,-82,302,1014,1243,596,11
-3,1,0.01,-3.0,1.0,1.278407335281372,125.728726758888,8,101,-83,302,1014,1243,596,11
-3,1,0.01,-3.0,1.0,1.2873563766479492,128.68619973654722,8,104,-84,302,1014,1243,596,11
-3,1,0.01,-3.0,1.0,1.2963335514068604,131.65284482951682,8,107,-85,302,1014,1243,596,11
-3,1,0.01,-3.0,1.0,1.3053088188171387,134.62807740565648,8,110,-86,302,1014,1243,596,11
-3,1,0.01,-3.0,1.0,1.3142845630645752,137.61135999632006,8,113,-87,302,1014,1243,596,11
-3,1,0.01,-3.0,1.0,1.3242597579956055,140.60219778561037,8,116,-88,302,1014,1243,596,11
-3,1,0.01,-3.0,1.0,1.3312397003173828,143.60013458944107,8,119,-89,302,1014,1243,596,11
-3,1,0.01,-3.0,1.0,1.3402457237243652,146.6047492659778,8,122,-90,302,1014,1243,596,11
-3,1,0.01,-3.0,1.0,1.3501901626586914,149.6156525064652,8,125,-91,302,1014,1243,596,11
-3,1,0.01,-3.0,1.0,1.3571715354919434,152.63248396190426,8,128,-92,302,1014,1243,596,11
-3,1,0.02,-3.0,1.0,1.3661472797393799,155.65490966665163,8,131,-93,302,1014,1243,596,11
-3,1,0.02,-3.0,1.0,1.3751225471496582,158.682619724881,8,134,-94,302,1014,1243,596,11
-3,1,0.02,-3.0,1.0,1.383105754852295,161.715326230074,8,137,-95,302,1014,1243,596,11
-3,1,0.02,-3.0,1.0,1.3911104202270508,164.75276139138356,8,140,-96,302,1014,1243,596,11
-3,1,0.02,-3.0,1.0,1.4000577926635742,167.7946758439044,8,143,-97,302,1014,1243,596,11
-3,1,0.02,-3.0,1.0,1.4090337753295898,170.84083712266613,8,146,-98,302,1014,1243,596,11
-3,1,0.02,-3.0,1.0,1.419006109237671,173.89102828258325,8,149,-99,302,1014,1243,596,11
-3,1,0.02,-3.0,1.0,1.426985263824463,176.94504664870655,8,152,-100,302,1014,1243,596,11
-3,1,0.02,-3.0,1.0,1.4359633922576904,180.00270268296083,8,155,-101,302,1014,1243,596,11
-3,1,0.02,-3.0,1.0,1.4449379444122314,183.06381895516213,8,158,-102,302,1014,1243,596,11
-3,1,0.02,-3.0,1.0,1.451918601989746,186.12822920751398,8,161,-103,302,1014,1243,596,11
-3,1,0.02,-3.0,1.0,1.4618933200836182,189.1957775030137,8,164,-104,302,1014,1243,596,11
-3,1,0.02,-3.0,1.0,1.4698724746704102,192.2663174492797,8,167,-105,302,1014,1243,596,11
-3,1,0.02,-3.0,1.0,1.4788486957550049,195.33971149025845,8,170,-106,302,1014,1243,596,11
-3,1,0.02,-3.0,1.0,1.4868388175964355,198.4158302591025,8,173,-107,302,1014,1243,596,11
-3,1,0.02,-3.0,1.0,1.4938347339630127,201.49455198624491,8,176,-108,302,1014,1243,596,11
-3,1,0.02,-3.0,1.0,1.5028109550476074,204.57576195734086,8,179,-109,302,1014,1243,596,11
-3,1,0.02,-3.0,1.0,1.5117602348327637,207.6593520163174,8,182,-110,302,1014,1243,596,11
-3,1,0.02,-3.0,1.0,1.5217351913452148,210.74522010927612,8,185,-111,302,1014,1243,596,11
-3,1,0.02,-3.0,1.0,1.5307111740112305,213.8332698654389,8,188,-112,302,1014,1243,596,11
-3,1,0.02,-3.0,1.0,1.5386884212493896,216.92341021172146,8,191,-113,302,1014,1243,596,11
-3,1,0.03,-3.0,1.0,1.5466663837432861,220.01555501786981,8,194,-114,302,1014,1243,596,11
-3,1,0.03,-3.0,1.0,1.555673360824585,223.10962276940444,8,197,-115,302,1014,1243,596,11
-3,1,0.03,-3.0,1.0,1.5656168460845947,226.2055362658948,8,200,-116,302,1014,1243,596,11
-3,1,0.03,-3.0,1.0,1.574594259262085,229.30322234233142,8,203,-117,302,1014,1243,596,11
-3,1,0.03,-3.0,1.0,1.5845668315887451,232.40261161158273,8,206,-118,302,1014,1243,596,11
-3,1,0.03,-3.0,1.0,1.592545747756958,235.50363822611914,8,209,-119,302,1014,1243,596,11
-3,1,0.03,-3.0,1.0,1.601527214050293,238.6062396573618,8,212,-120,302,1014,1243,596,11
-3,1,0.03,-3.0,1.0,1.6095013618469238,241.71035649116962,8,215,-121,302,1014,1243,596,11
-3,1,0.03,-3.0,1.0,1.6174790859222412,244.81593223811808,8,218,-122,302,1014,1243,596,11
-3,1,0.03,-3.0,1.0,1.6254782676696777,247.9229131573492,8,221,-123,302,1014,1243,596,11
-3,1,0.03,-3.0,1.0,1.6324670314788818,251.03124809288414,8,224,-124,302,1014,1243,596,11
-3,1,0.03,-3.0,1.0,1.641416311264038,254.14088832139169,8,227,-125,302,1014,1243,596,11
-3,1,0.03,-3.0,1.0,1.650392770767212,257.25178741049604,8,230,-126,302,1014,1243,596,11
-3,1,0.03,-3.0,1.0,1.6603741645812988,260.36390108679063,8,233,-127,302,1014,1243,596,11
-3,1,0.03,-3.0,1.0,1.6683433055877686,263.47718711279737,8,236,-128,302,1014,1243,596,11
-3,1,0.03,-3.0,1.0,1.6783182621002197,266.5916051721776,8,239,-129,302,1014,1243,596,11
-3,1,0.03,-3.0,1.0,1.6863019466400146,269.70711676256224,8,242,-130,302,1014,1243,596,11
-3,1,0.03,-3.0,1.0,1.694274663925171,272.82368509542164,8,245,-131,302,1014,1243,596,11
-3,1,0.03,-3.0,1.0,1.702284812927246,275.941275002446,8,248,-132,302,1014,1243,596,11
-3,1,0.03,-3.0,1.0,1.7122271060943604,279.05985284795173,8,251,-133,302,1014,1243,596,11
-3,1,0.03,-3.0,1.0,1.7192084789276123,282.17938644686876,8,254,-134,302,1014,1243,596,11
-3,1,0.03,-3.0,1.0,1.7282123565673828,285.29984498790213,8,257,-135,302,1014,1243,596,11
-3,1,0.03,-3.0,1.0,1.7371890544891357,288.4211989614929,8,260,-136,302,1014,1243,596,11
-3,1,0.03,-3.0,1.0,1.7461378574371338,291.5434200922354,8,263,-137,302,1014,1243,596,11
-3,1,0.03,-3.0,1.0,1.7551138401031494,294.66648127543397,8,266,-138,302,1014,1243,596,11
-3,1,0.03,-3.0,1.0,1.764089822769165,297.79035651750866,8,269,-139,302,1014,1243,596,11
-3,1,0.03,-3.0,1.0,1.7730929851531982,300.9150208799823,8,272,-140,302,1014,1243,596,11
-3,1,0.03,-3.0,1.0,1.7820415496826172,304.04045042680093,8,275,-141,302,1014,1243,596,11
-3,1,0.03,-3.0,1.0,1.792015552520752,307.166622174761,8,278,-142,302,1014,1243,596,11
-3,1,0.03,-3.0,1.0,1.8009943962097168,310.29351404683223,8,281,-143,302,1014,1243,596,11
-3,1,0.03,-3.0,1.0,1.8089697360992432,313.4211048281819,8,284,-144,302,1014,1243,596,11
-3,1,0.03,-3.0,1.0,1.817945957183838,316.54937412472134,8,287,-145,302,1014,1243,596,11
-3,1,0.02,-3.0,1.0,1.8279192447662354,319.6783023240081,8,290,-146,302,1014,1243,596,11
-3,1,0.02,-3.0,1.0,1.8358983993530273,322.8078705583501,8,293,-147,302,1014,1243,596,11
-3,1,0.02,-3.0,1.0,1.8458728790283203,325.9380606699689,8,296,-148,302,1014,1243,596,11
-3,1,0.02,-3.0,1.0,1.8538506031036377,329.0688551780905,8,299,-149,302,1014,1243,596,11
-3,1,0.02,-3.0,1.0,1.8628294467926025,332.2002372478406,8,302,-150,302,1014,1243,596,11
0,1,0.02,0,1.0,1.8728017807006836,331.7521343659161,8,301,-151,302,1014,1243,596,11
0,0,0.07,0,-0.0,1.8807799816131592,331.7521343659161,8,301,-151,302,1014,1243,596,11
1,0,0.07,1.0,-0.0,1.8887591361999512,330.85860119996926,8,300,-151,302,1014,1243,596,11
1,-1,0.05,1.0,-1.0,1.897733449935913,329.51606837340415,8,299,-150,302,1014,1243,596,11
1,-1,0.03,1.0,-1.0,1.9077122211456299,328.17412864746865,8,298,-149,302,1014,1243,596,11
1,-1,0.02,1.0,-1.0,1.9167113304138184,326.8327892177022,8,297,-148,302,1014,1243,596,11
1,-1,0.02,1.0,-1.0,1.9276561737060547,325.49205739321485,8,296,-147,302,1014,1243,596,11
1,-1,0.03,1.0,-1.0,1.9366319179534912,324.1519405988669,8,295,-146,302,1014,1243,596,11
1,-1,0.03,1.0,-1.0,1.945608139038086,322.812446377498,8,294,-145,302,1014,1243,596,11
1,-1,0.04,1.0,-1.0,1.9545915126800537,321.47358239220523,8,293,-144,302,1014,1243,596,11
1,-1,0.04,1.0,-1.0,1.9645564556121826,320.13535642867265,8,292,-143,302,1014,1243,596,11
1,-1,0.05,1.0,-1.0,1.9735333919525146,318.79777639755343,8,291,-142,302,1014,1243,596,11
1,-1,0.06,1.0,-1.0,1.9835102558135986,317.46085033690525,8,290,-141,302,1014,1243,596,11
1,-1,0.07,1.0,-1.0,1.991485595703125,316.1245864146811,8,289,-140,302,1014,1243,596,11
1,-1,0.07,1.0,-1.0,1.9994730949401855,314.7889929312765,8,288,-139,302,1014,1243,596,11
1,-1,0.1,1.0,-1.0,2.008441686630249,313.45407832213425,8,287,-138,302,1014,1243,596,11
1,-1,0.08,1.0,-1.0,2.016449213027954,312.11985116040904,8,286,-137,302,1014,1243,596,11
1,-1,0.09,1.0,-1.0,2.0254065990448,310.7863201596928,8,285,-136,302,1014,1243,596,11
1,-1,0.09,1.0,-1.0,2.0353691577911377,309.45349417680194,8,284,-135,302,1014,1243,596,11
1,-1,0.1,1.0,-1.0,2.044344425201416,308.12138221462936,8,283,-134,302,1014,1243,596,11
1,-1,0.11,1.0,-1.0,2.0513272285461426,306.78999342506165,8,282,-133,302,1014,1243,596,11
1,-1,0.11,1.0,-1.0,2.0583088397979736,305.4593371119638,8,281,-132,302,1014,1243,596,11
1,-1,0.11,1.0,-1.0,2.0672833919525146,304.1294227342328,8,280,-131,302,1014,1243,596,11
1,-1,0.11,1.0,-1.0,2.0768332481384277,302.8002599089221,8,279,-130,302,1014,1243,596,11
1,-1,0.11,1.0,-1.0,2.084813356399536,301.4718584144391,8,278,-129,302,1014,1243,596,11
1,-1,0.11,1.0,-1.0,2.094785213470459,300.14422819381656,8,277,-128,302,1014,1243,596,11
1,-1,0.11,1.0,-1.0,2.1027920246124268,298.8173793580611,8,276,-127,302,1014,1243,596,11
1,-1,0.11,1.0,-1.0,2.111743927001953,297.49132218957953,8,275,-126,302,1014,1243,596,11
1,-1,0.11,1.0,-1.0,2.1207170486450195,296.16606714568627,8,274,-125,302,1014,1243,596,11
1,-1,0.11,1.0,-1.0,2.129704236984253,294.8416248621929,8,273,-124,302,1014,1243,596,11
1,-1,0.11,1.0,-1.0,2.138669967651367,293.5180061570826,8,272,-123,302,1014,1243,596,11
1,-1,0.11,1.0,-1.0,2.1486423015594482,292.1952220342716,8,271,-122,302,1014,1243,596,11
1,-1,0.11,1.0,-1.0,2.158616542816162,290.87328368745966,8,270,-121,302,1014,1243,596,11
1,-1,0.11,1.0,-1.0,2.167619466781616,289.5522025040723,8,269,-120,302,1014,1243,596,11
1,-1,0.11,1.0,-1.0,2.177565097808838,288.2319900692965,8,268,-119,302,1014,1243,596,11
1,-1,0.11,1.0,-1.0,2.1865413188934326,286.91265817021366,8,267,-118,302,1014,1243,596,11
1,-1,0.11,1.0,-1.0,2.195518732070923,285.5942188000305,8,266,-117,302,1014,1243,596,11
1,-1,0.11,1.0,-1.0,2.202511787414551,284.2766841624122,8,265,-116,302,1014,1243,596,11
1,-1,0.1,1.0,-1.0,2.21248459815979,282.9600666759195,8,264,-115,302,1014,1243,596,11
1,-1,0.1,1.0,-1.0,2.2194783687591553,281.6443789785524,8,263,-114,302,1014,1243,596,11
1,-1,0.1,1.0,-1.0,2.2284297943115234,280.3296339324046,8,262,-113,302,1014,1243,596,11
1,-1,0.1,1.0,-1.0,2.237407922744751,279.01584462842914,8,261,-112,302,1014,1243,596,11
1,-1,0.1,1.0,-1.0,2.246391773223877,277.70302439132126,8,260,-111,302,1014,1243,596,11
1,-1,0.1,1.0,-1.0,2.2553598880767822,276.3911867845189,8,259,-110,302,1014,1243,596,11
1,-1,0.1,1.0,-1.0,2.264335870742798,275.0803456153252,8,258,-109,302,1014,1243,596,11
1,-1,0.09,1.0,-1.0,2.2733452320098877,273.7705149401565,8,257,-108,302,1014,1243,596,11
1,-1,0.09,1.0,-1.0,2.2832841873168945,272.46170906991836,8,256,-107,302,1014,1243,596,11
1,-1,0.09,1.0,-1.0,2.291264533996582,271.1539425755135,8,255,-106,302,1014,1243,596,11
1,-1,0.09,1.0,-1.0,2.298260450363159,269.84723029348504,8,254,-105,302,1014,1243,596,11
1,-1,0.09,1.0,-1.0,2.307248592376709,268.5415873317986,8,253,-104,302,1014,1243,596,11
1,-1,0.09,1.0,-1.0,2.316211700439453,267.237029075767,8,252,-103,302,1014,1243,596,11
1,-1,0.09,1.0,-1.0,2.3252005577087402,265.9335711941213,8,251,-102,302,1014,1243,596,11
1,-1,0.09,1.0,-1.0,2.3331668376922607,264.6312296452323,8,250,-101,302,1014,1243,596,11
1,-1,0.08,1.0,-1.0,2.3411307334899902,263.33002068348594,8,249,-100,302,1014,1243,596,11
1,-1,0.08,1.0,-1.0,2.348111867904663,262.02996086581743,8,248,-99,302,1014,1243,596,11
1,-1,0.08,1.0,-1.0,2.3570892810821533,260.73106705840775,8,247,-98,302,1014,1243,596,11
1,-1,0.08,1.0,-1.0,2.36706280708313,259.43335644354704,8,246,-97,302,1014,1243,596,11
1,-1,0.08,1.0,-1.0,2.3750600814819336,258.13684652666944,8,245,-96,302,1014,1243,596,11
1,-1,0.08,1.0,-1.0,2.382021903991699,256.8415551435639,8,244,-95,302,1014,1243,596,11
1,-1,0.08,1.0,-1.0,2.3900020122528076,255.54750046776502,8,243,-94,302,1014,1243,596,11
1,-1,0.08,1.0,-1.0,2.3999741077423096,254.25470101813005,8,242,-93,302,1014,1243,596,11
1,-1,0.08,1.0,-1.0,2.406956672668457,252.96317566660554,8,241,-92,302,1014,1243,596,11
1,-1,0.07,1.0,-1.0,2.4159328937530518,251.67294364618954,8,240,-91,302,1014,1243,596,11
1,-1,0.07,1.0,-1.0,2.4249086380004883,250.38402455909414,8,239,-90,302,1014,1243,596,11
1,-1,0.07,1.0,-1.0,2.433885097503662,249.09643838511394,8,238,-89,302,1014,1243,596,11
1,-1,0.07,1.0,-1.0,2.4428610801696777,247.81020549020565,8,237,-88,302,1014,1243,596,11
1,-1,0.07,1.0,-1.0,2.4518370628356934,246.52534663528445,8,236,-87,302,1014,1243,596,11
1,-1,0.07,1.0,-1.0,2.4618098735809326,245.2418829852429,8,235,-86,302,1014,1243,596,11
1,-1,0.07,1.0,-1.0,2.469789981842041,243.95983611819798,8,234,-85,302,1014,1243,596,11
1,-1,0.07,1.0,-1.0,2.4777684211730957,242.67922803497268,8,233,-84,302,1014,1243,596,11
1,-1,0.07,1.0,-1.0,2.4847495555877686,241.4000811688178,8,232,-83,302,1014,1243,596,11
1,-1,0.07,1.0,-1.0,2.495720148086548,240.12241839538055,8,231,-82,302,1014,1243,596,11
1,-1,0.06,1.0,-1.0,2.5046958923339844,238.8462630429263,8,230,-81,302,1014,1243,596,11
1,-1,0.06,1.0,-1.0,2.512674570083618,237.5716389028198,8,229,-80,302,1014,1243,596,11
1,-1,0.06,1.0,-1.0,2.523646831512451,236.29857024027308,8,228,-79,302,1014,1243,596,11
1,-1,0.06,1.0,-1.0,2.531625986099243,235.0270818053663,8,227,-78,302,1014,1243,596,11
1,-1,0.06,1.0,-1.0,2.5396101474761963,233.75719884434898,8,226,-77,302,1014,1243,596,11
1,-1,0.06,1.0,-1.0,2.548578977584839,232.48894711122873,8,225,-76,302,1014,1243,596,11
1,-1,0.06,1.0,-1.0,2.5555624961853027,231.22235287965447,8,224,-75,302,1014,1243,596,11
1,-1,0.06,1.0,-1.0,2.565534830093384,229.95744295510198,8,223,-74,302,1014,1243,596,11
1,-1,0.06,1.0,-1.0,2.5735130310058594,228.69424468736923,8,222,-73,302,1014,1243,596,11
1,-1,0.06,1.0,-1.0,2.581493616104126,227.43278598338918,8,221,-72,302,1014,1243,596,11
1,-1,0.06,1.0,-1.0,2.5894975662231445,226.1730953203681,8,220,-71,302,1014,1243,596,11
1,-1,0.06,1.0,-1.0,2.5994462966918945,224.91520175925731,8,219,-70,302,1014,1243,596,11
1,-1,0.06,1.0,-1.0,2.6074252128601074,223.65913495856665,8,218,-69,302,1014,1243,596,11
1,-1,0.05,1.0,-1.0,2.6163995265960693,222.40492518852795,8,217,-68,302,1014,1243,596,11
1,-1,0.05,1.0,-1.0,2.624378204345703,221.15260334561705,8,216,-67,302,1014,1243,596,11
1,-1,0.05,1.0,-1.0,2.632357120513916,219.90220096744272,8,215,-66,302,1014,1243,596,11
1,-1,0.05,1.0,-1.0,2.640336751937866,218.6537502480117,8,214,-65,302,1014,1243,596,11
1,-1,0.05,1.0,-1.0,2.648315668106079,217.40728405337808,8,213,-64,302,1014,1243,596,11
1,-1,0.05,1.0,-1.0,2.656294584274292,216.16283593768642,8,212,-63,302,1014,1243,596,11
1,-1,0.05,1.0,-1.0,2.664271831512451,214.92044015961773,8,211,-62,302,1014,1243,596,11
1,-1,0.05,1.0,-1.0,2.6722514629364014,213.68013169924697,8,210,-61,302,1014,1243,596,11
1,-1,0.05,1.0,-1.0,2.67981219291687,212.44194627532195,8,209,-60,302,1014,1243,596,11
1,-1,0.05,1.0,-1.0,2.6877894401550293,211.20592036297248,8,208,-59,302,1014,1243,596,11
1,-1,0.05,1.0,-1.0,2.6957695484161377,209.9720912118594,8,207,-58,302,1014,1243,596,11
1,-1,0.05,1.0,-1.0,2.703746795654297,208.74049686477292,8,206,-57,302,1014,1243,596,11
1,-1,0.05,1.0,-1.0,2.7127227783203125,207.5111761766896,8,205,-56,302,1014,1243,596,11
1,-1,0.05,1.0,-1.0,2.7226967811584473,206.28416883429767,8,204,-55,302,1014,1243,596,11
1,-1,0.05,1.0,-1.0,2.7306764125823975,205.05951537600004,8,203,-54,302,1014,1243,596,11
1,-1,0.05,1.0,-1.0,2.7396514415740967,203.83725721240452,8,202,-53,302,1014,1243,596,11
1,-1,0.05,1.0,-1.0,2.7476308345794678,202.6174366473105,8,201,-52,302,1014,1243,596,11
1,-1,0.05,1.0,-1.0,2.755624294281006,201.40009689920205,8,200,-51,302,1014,1243,596,11
1,-1,0.05,1.0,-1.0,2.76358962059021,200.1852821232556,8,199,-50,302,1014,1243,596,11
1,-1,0.05,1.0,-1.0,2.7725751399993896,198.9730374338726,8,198,-49,302,1014,1243,596,11
1,-1,0.05,1.0,-1.0,2.7795464992523193,197.76340892774513,8,197,-48,302,1014,1243,596,11
1,-1,0.05,1.0,-1.0,2.788522958755493,196.55644370746373,8,196,-47,302,1014,1243,596,11
1,-1,0.05,1.0,-1.0,2.7974977493286133,195.35218990567586,8,195,-46,302,1014,1243,596,11
1,-1,0.05,1.0,-1.0,2.8054776191711426,194.15069670980316,8,194,-45,302,1014,1243,596,11
1,-1,0.05,1.0,-1.0,2.8144538402557373,192.9520143873257,8,193,-44,302,1014,1243,596,11
1,-1,0.05,1.0,-1.0,2.823430299758911,191.75619431164043,8,192,-43,302,1014,1243,596,11
1,-1,0.05,1.0,-1.0,2.832409620285034,190.5632889885011,8,191,-42,302,1014,1243,596,11
1,-1,0.05,1.0,-1.0,2.8423912525177,189.3733520830466,8,190,-41,302,1014,1243,596,11
1,-1,0.05,1.0,-1.0,2.8503572940826416,188.18643844742311,8,189,-40,302,1014,1243,596,11
1,-1,0.05,1.0,-1.0,2.858337163925171,187.00260414900626,8,188,-39,302,1014,1243,596,11
1,-1,0.05,1.0,-1.0,2.8663156032562256,185.8219064992277,8,187,-38,302,1014,1243,596,11
1,-1,0.04,1.0,-1.0,2.8752920627593994,184.64440408301004,8,186,-37,302,1014,1243,596,11
1,-1,0.04,1.0,-1.0,2.8832709789276123,183.47015678881365,8,185,-36,302,1014,1243,596,11
1,-1,0.04,1.0,-1.0,2.8902509212493896,182.29922583929704,8,184,-35,302,1014,1243,596,11
1,-1,0.04,1.0,-1.0,2.9002254009246826,181.1316738225926,8,183,-34,302,1014,1243,596,11
1,-1,0.04,1.0,-1.0,2.9072060585021973,179.967564724197,8,182,-33,302,1014,1243,596,11
1,-1,0.04,1.0,-1.0,2.916182279586792,178.8069639594757,8,181,-32,302,1014,1243,596,11
1,-1,0.04,1.0,-1.0,2.9251599311828613,177.64993840677855,8,180,-31,302,1014,1243,596,11
1,-1,0.04,1.0,-1.0,2.9341354370117188,176.49655644116226,8,179,-30,302,1014,1243,596,11
1,-1,0.03,1.0,-1.0,2.9431118965148926,175.34688796871433,8,178,-29,302,1014,1243,596,11
1,-1,0.03,1.0,-1.0,2.9520883560180664,174.20100446147057,8,177,-28,302,1014,1243,596,11
1,-1,0.03,1.0,-1.0,2.9610867500305176,173.05897899291685,8,176,-27,302,1014,1243,596,11
1,-1,0.03,1.0,-1.0,2.9710373878479004,171.92088627406318,8,175,-26,302,1014,1243,596,11
1,-1,0.03,1.0,-1.0,2.979015350341797,170.78680269007683,8,174,-25,302,1014,1243,596,11
1,-1,0.03,1.0,-1.0,2.9859981536865234,169.6568063374571,8,173,-24,302,1014,1243,596,11
1,-1,0.03,1.0,-1.0,2.994974374771118,168.53097706173386,8,172,-23,302,1014,1243,596,11
1,-1,0.02,1.0,-1.0,3.0019543170928955,167.40939649566667,8,171,-22,302,1014,1243,596,11
1,-1,0.02,1.0,-1.0,3.0119292736053467,166.29214809792072,8,170,-21,302,1014,1243,596,11
1,-1,0.02,1.0,-1.0,3.0199220180511475,165.17931719218996,8,169,-20,302,1014,1243,596,11
1,-1,0.02,1.0,-1.0,3.026888370513916,164.07099100673656,8,168,-19,302,1014,1243,596,11
1,-1,0.02,1.0,-1.0,3.035865068435669,162.96725871431016,8,167,-18,302,1014,1243,596,11
1,-1,0.02,1.0,-1.0,3.0458462238311768,161.86821147240718,8,166,-17,302,1014,1243,596,11
1,-1,0.02,1.0,-1.0,3.053839683532715,160.77394246382633,8,165,-16,302,1014,1243,596,11
1,-1,0.02,1.0,-1.0,3.0627942085266113,159.68454693747074,8,164,-15,302,1014,1243,596,11
1,-1,0.02,1.0,-1.0,3.0717689990997314,158.6001222493431,8,163,-14,302,1014,1243,596,11
1,-1,0.02,1.0,-1.0,3.080759048461914,157.5207679036744,8,162,-13,302,1014,1243,596,11
1,-1,0.02,1.0,-1.0,3.0897209644317627,156.4465855941215,8,161,-12,302,1014,1243,596,11
1,-1,0.02,1.0,-1.0,3.099696159362793,155.37767924496225,8,160,-11,302,1014,1243,596,11
1,-1,0.02,1.0,-1.0,3.109689235687256,154.31415505221122,8,159,-10,302,1014,1243,596,11
1,-1,0.02,1.0,-1.0,3.1186652183532715,153.25612152457168,8,158,-9,302,1014,1243,596,11
1,-1,0.02,1.0,-1.0,3.1286191940307617,152.20368952413298,8,157,-8,302,1014,1243,596,11
1,-1,0.01,1.0,-1.0,3.137594223022461,151.1569723067145,8,156,-7,302,1014,1243,596,11
1,-1,0.01,1.0,-1.0,3.1475768089294434,150.11608556174951,8,155,-6,302,1014,1243,596,11
1,-1,0.01,1.0,-1.0,3.155545949935913,149.0811474515945,8,154,-5,302,1014,1243,596,11
1,-1,0.01,1.0,-1.0,3.1635262966156006,148.05227865013967,8,153,-4,302,1014,1243,596,11
1,-1,0.01,1.0,-1.0,3.171504020690918,147.029602380589,8,152,-3,302,1014,1243,596,11
1,-1,0.01,1.0,-1.0,3.179511547088623,146.0132444522665,8,151,-2,302,1014,1243,596,11
1,-1,0.01,1.0,-1.0,3.1884865760803223,145.00333329629711,8,150,-1,302,1014,1243,596,11
1,-1,0.01,1.0,-1.0,3.197437047958374,144.0,8,149,0,302,1014,1243,596,11
1,-1,0.01,1.0,-1.0,3.2064387798309326,143.00337833982033,8,148,1,302,1014,1243,596,11
1,-1,0.01,1.0,-1.0,3.216386079788208,142.0136048126159,8,147,2,302,1014,1243,596,11
1,-1,0.01,1.0,-1.0,3.22336745262146,141.03081866510234,8,146,3,302,1014,1243,596,11
1,-1,0.01,1.0,-1.0,3.2323434352874756,140.0551619212498,8,145,4,302,1014,1243,596,11
1,-1,0.01,1.0,-1.0,3.241335153579712,139.08677940741129,8,144,5,302,1014,1243,596,11
1,-1,0.01,1.0,-1.0,3.2482995986938477,138.1258187749506,8,143,6,302,1014,1243,596,11
1,-1,0.01,1.0,-1.0,3.257276773452759,137.1724305201258,8,142,7,302,1014,1243,596,11
1,-1,0.01,1.0,-1.0,3.2672510147094727,136.2267680009707,8,141,8,302,1014,1243,596,11
1,-1,0.01,1.0,-1.0,3.274266242980957,135.28898745090436,8,140,9,302,1014,1243,596,11
1,-1,0.01,1.0,-1.0,3.284205436706543,134.35924798878617,8,139,10,302,1014,1243,596,11
1,-1,0.01,1.0,-1.0,3.291186571121216,133.43771162512041,8,138,11,302,1014,1243,596,11
1,-1,0.01,1.0,-1.0,3.3011605739593506,132.5245432641025,8,137,12,302,1014,1243,596,11
1,-1,0.01,1.0,-1.0,3.310150623321533,131.61991070118586,8,136,13,302,1014,1243,596,11
1,-1,0.01,1.0,-1.0,3.317117214202881,130.72398461583714,8,135,14,302,1014,1243,596,11
1,-1,0.01,1.0,-1.0,3.3261044025421143,129.8369385591352,8,134,15,302,1014,1243,596,11
1,-1,0.01,1.0,-1.0,3.3350701332092285,128.9589489358587,8,133,16,302,1014,1243,596,11
1,-1,0.01,1.0,-1.0,3.3440511226654053,128.09019498069722,8,132,17,302,1014,1243,596,11
1,-1,0.01,1.0,-1.0,3.353029727935791,127.23085872821065,8,131,18,302,1014,1243,596,11
1,-1,0.01,1.0,-1.0,3.3619985580444336,126.38112497615478,8,130,19,302,1014,1243,596,11
1,-1,0.01,1.0,-1.0,3.369007110595703,125.54118124178285,8,129,20,302,1014,1243,596,11
1,-1,0.01,1.0,-1.0,3.378952741622925,124.71121771072848,8,128,21,302,1014,1243,596,11
1,-1,0.01,1.0,-1.0,3.3859736919403076,123.89142717807107,8,127,22,302,1014,1243,596,11
1,-1,0.01,1.0,-1.0,3.3959078788757324,123.08200498118384,8,126,23,302,1014,1243,596,11
1,-1,0.01,1.0,-1.0,3.402888774871826,122.283148923964,8,125,24,302,1014,1243,596,11
1,-1,0.01,1.0,-1.0,3.411879301071167,121.49505919204908,8,124,25,302,1014,1243,596,11
1,-1,0.01,1.0,-1.0,3.418877363204956,120.7179382586272,8,123,26,302,1014,1243,596,11
1,-1,0.01,1.0,-1.0,3.4288418292999268,119.95199078045935,8,122,27,302,1014,1243,596,11
1,-1,0.01,1.0,-1.0,3.436800003051758,119.19742348374221,8,121,28,302,1014,1243,596,11
1,-1,0.01,1.0,-1.0,3.443793535232544,118.45444503945575,8,120,29,302,1014,1243,596,11
1,-1,0.01,1.0,-1.0,3.4527575969696045,117.723265927859,8,119,30,302,1014,1243,596,11
1,-1,0.01,1.0,-1.0,3.463728904724121,117.00409829181969,8,118,31,302,1014,1243,596,11
1,-1,0.01,1.0,-1.0,3.472703456878662,116.29715577869086,8,117,32,302,1014,1243,596,11
1,-1,0.01,1.0,-1.0,3.4817073345184326,115.60265337047937,8,116,33,302,1014,1243,596,11
1,-1,0.01,1.0,-1.0,3.4916539192199707,114.9208072020865,8,115,34,302,1014,1243,596,11
1,-1,0.01,1.0,-1.0,3.501657724380493,114.25183436744275,8,114,35,302,1014,1243,596,11
1,-1,0.01,1.0,-1.0,3.5106041431427,113.59595271340417,8,113,36,302,1014,1243,596,11
1,-1,0.01,1.0,-1.0,3.519580602645874,112.95338062132852,8,112,37,302,1014,1243,596,11
1,-1,0.01,1.0,-1.0,3.5295605659484863,112.32433677630571,8,111,38,302,1014,1243,596,11
1,-1,0.01,1.0,-1.0,3.5365355014801025,111.70903992407786,8,110,39,302,1014,1243,596,11
1,-1,0.01,1.0,-1.0,3.5465075969696045,111.1077086157504,8,109,40,302,1014,1243,596,11
1,-1,0.01,1.0,-1.0,3.5544867515563965,110.52056094046635,8,108,41,302,1014,1243,596,11
1,-1,0.01,1.0,-1.0,3.562476873397827,109.94781424629178,8,107,42,302,1014,1243,596,11
1,-1,0.01,1.0,-1.0,3.571442127227783,109.38968484964018,8,106,43,302,1014,1243,596,11
1,-1,0.01,1.0,-1.0,3.579420804977417,108.84638773364749,8,105,44,302,1014,1243,596,11
1,-1,0.01,1.0,-1.0,3.586907386779785,108.3181362359971,8,104,45,302,1014,1243,596,11
1,-1,0.01,1.0,-1.0,3.5958845615386963,107.80514172678478,8,103,46,302,1014,1243,596,11
1,-1,0.01,1.0,-1.0,3.6038620471954346,107.30761327710601,8,102,47,302,1014,1243,596,11
1,-1,0.01,1.0,-1.0,3.612842321395874,106.8257573191436,8,101,48,302,1014,1243,596,11
1,-1,0.01,1.0,-1.0,3.620828151702881,106.35977729862789,8,100,49,302,1014,1243,596,11
1,-1,0.01,1.0,-1.0,3.6297950744628906,105.90987332063814,8,99,50,302,1014,1243,596,11
1,-1,0.01,1.0,-1.0,3.6387908458709717,105.47624178980746,8,98,51,302,1014,1243,596,11
1,-1,0.01,1.0,-1.0,3.650737762451172,105.05907504608605,8,97,52,302,1014,1243,596,11
1,-1,0.01,1.0,-1.0,3.6597142219543457,104.65856099730654,8,96,53,302,1014,1243,596,11
1,-1,0.01,1.0,-1.0,3.6676924228668213,104.27488274987991,8,95,54,302,1014,1243,596,11
1,-1,0.01,1.0,-1.0,3.6756985187530518,103.90821823902914,8,94,55,302,1014,1243,596,11
1,-1,0.01,1.0,-1.0,3.684648036956787,103.55873986004075,8,93,56,302,1014,1243,596,11
1,-1,0.01,1.0,-1.0,3.691628932952881,103.2266141020775,8,92,57,302,1014,1243,596,11
1,-1,0.01,1.0,-1.0,3.7016029357910156,102.91200118615167,8,91,58,302,1014,1243,596,11
1,-1,0.01,1.0,-1.0,3.7085835933685303,102.61505470890214,8,90,59,302,1014,1243,596,11
1,-1,0.01,1.0,-1.0,3.717559814453125,102.33592129385204,8,89,60,302,1014,1243,596,11
1,-1,0.01,1.0,-1.0,3.725538730621338,102.07474025184464,8,88,61,302,1014,1243,596,11
1,-1,0.01,1.0,-1.0,3.733517646789551,101.83164325236227,8,87,62,302,1014,1243,596,11
1,-1,0.01,1.0,-1.0,3.7405002117156982,101.60675400742676,8,86,63,302,1014,1243,596,11
1,-1,0.01,1.0,-1.0,3.7504725456237793,101.40018796975878,8,85,64,302,1014,1243,596,11
1,-1,0.01,1.0,-1.0,3.7574548721313477,101.21205204683694,8,84,65,302,1014,1243,596,11
1,-1,0.01,1.0,-1.0,3.767427682876587,101.04244433244644,8,83,66,302,1014,1243,596,11
1,-1,0.01,1.0,-1.0,3.776405096054077,100.89145385724005,8,82,67,302,1014,1243,596,11
1,-1,0.01,1.0,-1.0,3.7843823432922363,100.75916035975324,8,81,68,302,1014,1243,596,11
1,-1,0.01,1.0,-1.0,3.7923672199249268,100.64563407921787,8,80,69,302,1014,1243,596,11
1,-1,0.01,1.0,-1.0,3.8013439178466797,100.55093557141026,8,79,70,302,1014,1243,596,11
1,-1,0.01,1.0,-1.0,3.809321165084839,100.47511554864494,8,78,71,302,1014,1243,596,11
1,-1,0.01,1.0,-1.0,3.818309783935547,100.41821474489122,8,77,72,302,1014,1243,596,11
1,-1,0.01,1.0,-1.0,3.826277256011963,100.38026380684383,8,76,73,302,1014,1243,596,11
1,-1,0.01,1.0,-1.0,3.834261894226074,100.3612832116238,8,75,74,302,1014,1243,596,11
1,-1,0.01,1.0,-1.0,3.8422350883483887,100.3612832116238,8,74,75,302,1014,1243,596,11
1,-1,0.01,1.0,-1.0,3.851209878921509,100.38026380684383,8,73,76,302,1014,1243,596,11
1,-1,0.01,1.0,-1.0,3.8581910133361816,100.41821474489122,8,72,77,302,1014,1243,596,11
1,-1,0.01,1.0,-1.0,3.8661704063415527,100.47511554864494,8,71,78,302,1014,1243,596,11
1,-1,0.01,1.0,-1.0,3.8751633167266846,100.55093557141026,8,70,79,302,1014,1243,596,11
1,-1,0.01,1.0,-1.0,3.884122610092163,100.64563407921787,8,69,80,302,1014,1243,596,11
1,-1,0.02,1.0,-1.0,3.8911046981811523,100.75916035975324,8,68,81,302,1014,1243,596,11
1,-1,0.02,1.0,-1.0,3.9000797271728516,100.89145385724005,8,67,82,302,1014,1243,596,11
1,-1,0.02,1.0,-1.0,3.9090569019317627,101.04244433244644,8,66,83,302,1014,1243,596,11
1,-1,0.02,1.0,-1.0,3.919029474258423,101.21205204683694,8,65,84,302,1014,1243,596,11
1,-1,0.02,1.0,-1.0,3.927009105682373,101.40018796975878,8,64,85,302,1014,1243,596,11
1,-1,0.02,1.0,-1.0,3.9340174198150635,101.60675400742676,8,63,86,302,1014,1243,596,11
1,-1,0.02,1.0,-1.0,3.942967414855957,101.83164325236227,8,62,87,302,1014,1243,596,11
1,-1,0.02,1.0,-1.0,3.9519433975219727,102.07474025184464,8,61,88,302,1014,1243,596,11
1,-1,0.02,1.0,-1.0,3.960919141769409,102.33592129385204,8,60,89,302,1014,1243,596,11
1,-1,0.02,1.0,-1.0,3.9699246883392334,102.61505470890214,8,59,90,302,1014,1243,596,11
1,-1,0.02,1.0,-1.0,3.979869842529297,102.91200118615167,8,58,91,302,1014,1243,596,11
1,-1,0.02,1.0,-1.0,3.988844156265259,103.2266141020775,8,57,92,302,1014,1243,596,11
1,-1,0.02,1.0,-1.0,3.995863199234009,103.55873986004075,8,56,93,302,1014,1243,596,11
1,-1,0.02,1.0,-1.0,4.004802703857422,103.90821823902914,8,55,94,302,1014,1243,596,11
1,-1,0.02,1.0,-1.0,4.013802528381348,104.27488274987991,8,54,95,302,1014,1243,596,11
1,-1,0.02,1.0,-1.0,4.0217578411102295,104.65856099730654,8,53,96,302,1014,1243,596,11
1,-1,0.02,1.0,-1.0,4.030734539031982,105.05907504608605,8,52,97,302,1014,1243,596,11
1,-1,0.03,1.0,-1.0,4.040707349777222,105.47624178980746,8,51,98,302,1014,1243,596,11
1,-1,0.03,1.0,-1.0,4.050709009170532,105.90987332063814,8,50,99,302,1014,1243,596,11
1,-1,0.03,1.0,-1.0,4.059657096862793,106.35977729862789,8,49,100,302,1014,1243,596,11
1,-1,0.03,1.0,-1.0,4.068633317947388,106.8257573191436,8,48,101,302,1014,1243,596,11
1,-1,0.03,1.0,-1.0,4.075614929199219,107.30761327710601,8,47,102,302,1014,1243,596,11
1,-1,0.03,1.0,-1.0,4.0856029987335205,107.80514172678478,8,46,103,302,1014,1243,596,11
1,-1,0.03,1.0,-1.0,4.094553709030151,108.3181362359971,8,45,104,302,1014,1243,596,11
1,-1,0.03,1.0,-1.0,4.10452675819397,108.84638773364749,8,44,105,302,1014,1243,596,11
1,-1,0.04,1.0,-1.0,4.113503456115723,109.38968484964018,8,43,106,302,1014,1243,596,11
1,-1,0.04,1.0,-1.0,4.121481657028198,109.94781424629178,8,42,107,302,1014,1243,596,11
1,-1,0.04,1.0,-1.0,4.130457878112793,110.52056094046635,8,41,108,302,1014,1243,596,11
1,-1,0.04,1.0,-1.0,4.138436317443848,111.1077086157504,8,40,109,302,1014,1243,596,11
1,-1,0.04,1.0,-1.0,4.146414518356323,111.70903992407786,8,39,110,302,1014,1243,596,11
1,-1,0.05,1.0,-1.0,4.153397083282471,112.32433677630571,8,38,111,302,1014,1243,596,11
1,-1,0.05,1.0,-1.0,4.163370132446289,112.95338062132852,8,37,112,302,1014,1243,596,11
1,-1,0.05,1.0,-1.0,4.171348333358765,113.59595271340417,8,36,113,302,1014,1243,596,11
1,-1,0.05,1.0,-1.0,4.180324554443359,114.25183436744275,8,35,114,302,1014,1243,596,11
1,-1,0.05,1.0,-1.0,4.189105987548828,114.9208072020865,8,34,115,302,1014,1243,596,11
1,-1,0.05,1.0,-1.0,4.197083234786987,115.60265337047937,8,33,116,302,1014,1243,596,11
1,-1,0.06,1.0,-1.0,4.204064846038818,116.29715577869086,8,32,117,302,1014,1243,596,11
1,-1,0.06,1.0,-1.0,4.214051961898804,117.00409829181969,8,31,118,302,1014,1243,596,11
1,-1,0.06,1.0,-1.0,4.222018718719482,117.723265927859,8,30,119,302,1014,1243,596,11
1,-1,0.06,1.0,-1.0,4.231990814208984,118.45444503945575,8,29,120,302,1014,1243,596,11
1,-1,0.06,1.0,-1.0,4.239970684051514,119.19742348374221,8,28,121,302,1014,1243,596,11
1,-1,0.06,1.0,-1.0,4.248945951461792,119.95199078045935,8,27,122,302,1014,1243,596,11
1,-1,0.07,1.0,-1.0,4.258939266204834,120.7179382586272,8,26,123,302,1014,1243,596,11
1,-1,0.07,1.0,-1.0,4.2668986320495605,121.49505919204908,8,25,124,302,1014,1243,596,11
1,-1,0.07,1.0,-1.0,4.274907350540161,122.283148923964,8,24,125,302,1014,1243,596,11
1,-1,0.07,1.0,-1.0,4.281858444213867,123.08200498118384,8,23,126,302,1014,1243,596,11
1,-1,0.07,1.0,-1.0,4.290867567062378,123.89142717807107,8,22,127,302,1014,1243,596,11
1,-1,0.07,1.0,-1.0,4.299813270568848,124.71121771072848,8,21,128,302,1014,1243,596,11
1,-1,0.08,1.0,-1.0,4.308787107467651,125.54118124178285,8,20,129,302,1014,1243,596,11
1,-1,0.08,1.0,-1.0,4.3187689781188965,126.38112497615478,8,19,130,302,1014,1243,596,11
1,-1,0.08,1.0,-1.0,4.325741529464722,127.23085872821065,8,18,131,302,1014,1243,596,11
1,-1,0.08,1.0,-1.0,4.335716247558594,128.09019498069722,8,17,132,302,1014,1243,596,11
1,-1,0.08,1.0,-1.0,4.3476948738098145,128.9589489358587,8,16,133,302,1014,1243,596,11
1,-1,0.09,1.0,-1.0,4.355662822723389,129.8369385591352,8,15,134,302,1014,1243,596,11
1,0,0.09,1.0,-0.0,4.36563515663147,129.72935834479432,8,14,134,302,1014,1243,596,11
1,0,0.15,1.0,-0.0,4.3746421337127686,129.6291201783626,8,13,134,302,1014,1243,596,11
1,1,0.14,1.0,1.0,4.384587049484253,128.5402561027947,8,12,133,302,1014,1243,596,11
1,1,0.11,1.0,1.0,4.393561124801636,127.45754036671525,8,11,132,302,1014,1243,596,11
1,2,0.09,1.0,2.0,4.402538061141968,125.38404810405297,8,10,130,302,1014,1243,596,11
1,2,0.06,1.0,2.0,4.41252326965332,123.31601614763451,8,9,128,302,1014,1243,596,11
1,3,0.05,1.0,3.0,4.420494318008423,120.25573839150046,8,8,125,302,1014,1243,596,11
1,3,0.04,1.0,3.0,4.429466724395752,117.20065466273084,8,7,122,302,1014,1243,596,11
1,4,0.04,1.0,4.0,4.436471939086914,113.15244390193544,8,6,118,302,1014,1243,596,11
1,4,0.03,1.0,4.0,4.444436550140381,109.10959644131601,8,5,114,302,1014,1243,596,11
1,4,0.02,1.0,4.0,4.453403472900391,105.07270324653611,8,4,110,302,1014,1243,596,11
1,4,0.02,1.0,4.0,4.460384368896484,101.04244433244644,8,3,106,302,1014,1243,596,11
1,4,0.02,1.0,4.0,4.46937108039856,97.0196059588548,8,2,102,302,1014,1243,596,11
1,4,0.02,1.0,4.0,4.478374242782593,93.00510190801293,8,1,98,302,1014,1243,596,11
1,4,0.02,1.0,4.0,4.488309621810913,89.0,8,0,94,302,1014,1243,596,11
1,4,0.02,1.0,4.0,4.4963202476501465,85.00555538409837,8,-1,90,302,1014,1243,596,11
1,4,0.02,1.0,4.0,4.504268169403076,81.02325267042627,8,-2,86,302,1014,1243,596,11
1,4,0.02,1.0,4.0,4.511249780654907,77.05485969764375,8,-3,82,302,1014,1243,596,11
1,4,0.02,1.0,4.0,4.520252227783203,73.10249675906654,8,-4,78,302,1014,1243,596,11
1,4,0.02,1.0,4.0,4.530208587646484,69.16872656315464,8,-5,74,302,1014,1243,596,11
1,4,0.02,1.0,4.0,4.537179231643677,65.25667228100119,8,-6,70,302,1014,1243,596,11
1,4,0.02,1.0,4.0,4.547154664993286,61.37017402418047,8,-7,66,302,1014,1243,596,11
1,4,0.02,1.0,4.0,4.55413818359375,57.51399843235114,8,-8,62,302,1014,1243,596,11
1,4,0.02,1.0,4.0,4.56410813331604,53.69412236331676,8,-9,58,302,1014,1243,596,11
1,4,0.02,1.0,4.0,4.571090459823608,49.91812087098393,8,-10,54,302,1014,1243,596,11
1,4,0.02,1.0,4.0,4.581063508987427,46.19570294468082,8,-11,50,302,1014,1243,596,11
1,4,0.02,1.0,4.0,4.590039968490601,42.53945729601885,8,-12,46,302,1014,1243,596,11
1,4,0.02,1.0,4.0,4.599016189575195,38.965895873961216,8,-13,42,302,1014,1243,596,11
1,4,0.02,1.0,4.0,4.6089887619018555,35.496913462633174,8,-14,38,302,1014,1243,596,11
1,4,0.02,1.0,4.0,4.615969896316528,32.16180835212409,8,-15,34,302,1014,1243,596,11
1,4,0.02,1.0,4.0,4.623950958251953,29.0,8,-16,30,302,1014,1243,596,11
1,4,0.02,1.0,4.0,4.63292670249939,26.064449134018133,8,-17,26,302,1014,1243,596,11
1,4,0.02,1.0,4.0,4.641902685165405,23.42534080710379,8,-18,22,302,1014,1243,596,11
1,4,0.02,1.0,4.0,4.651875734329224,21.1725046566048,8,-19,18,302,1014,1243,596,11
1,3,0.02,1.0,3.0,4.658857583999634,20.0,8,-20,15,302,1014,1243,596,11
1,3,0.02,1.0,3.0,4.669828653335571,19.186773244895647,8,-21,12,302,1014,1243,596,11
1,3,0.02,1.0,3.0,4.676808834075928,18.769728648009426,8,-22,9,302,1014,1243,596,11
1,2,0.03,1.0,2.0,4.685786247253418,19.041630560342615,8,-23,7,302,1014,1243,596,11
1,2,0.04,1.0,2.0,4.696767568588257,19.515301344262525,8,-24,5,302,1014,1243,596,11
0,2,0.05,-0.0,2.0,4.706729888916016,19.186773244895647,8,-24,3,302,1014,1243,596,11
0,1,0.04,-0.0,1.0,4.71570611000061,19.08318915758459,8,-24,2,302,1014,1243,596,11
0,1,0.06,-0.0,1.0,4.7246832847595215,19.020824298928627,8,-24,1,302,1014,1243,596,11
0,1,0.1,-0.0,1.0,4.734665870666504,19.0,8,-24,0,302,1014,1243,596,11
-1,1,0.15,-1.0,1.0,4.743630886077881,18.021728866442675,8,-23,-1,302,1014,1243,596,11
-1,1,0.15,-1.0,1.0,4.7536139488220215,17.090722034374522,8,-22,-2,302,1014,1243,596,11
-1,1,0.11,-1.0,1.0,4.763590335845947,16.213203435596427,8,-21,-3,302,1014,1243,596,11
-1,1,0.14,-1.0,1.0,4.77056360244751,15.396078054371138,8,-20,-4,302,1014,1243,596,11
-1,1,0.17,-1.0,1.0,4.780533790588379,14.6468827043885,8,-19,-5,302,1014,1243,596,11
-1,1,0.18,-1.0,1.0,4.788512945175171,13.973665961010276,8,-18,-6,302,1014,1243,596,11
-1,0,0.22,-1.0,-0.0,4.796492576599121,13.027756377319946,8,-17,-6,302,1014,1243,596,11
-1,0,0.31,-1.0,-0.0,4.803473234176636,12.08800749063506,8,-16,-6,302,1014,1243,596,11
-1,0,0.28,-1.0,-0.0,4.813446760177612,11.15549442140351,8,-15,-6,302,1014,1243,596,11
-1,0,0.34,-1.0,-0.0,4.820455074310303,10.231546211727817,8,-14,-6,302,1014,1243,596,11
-1,0,0.41,-1.0,-0.0,4.830431699752808,9.317821063276353,8,-13,-6,302,1014,1243,596,11
-1,0,0.48,-1.0,-0.0,4.838381052017212,8.416407864998739,8,-12,-6,302,1014,1243,596,11
-1,0,0.59,-1.0,-0.0,4.845386505126953,7.529964086141668,8,-11,-6,302,1014,1243,596,11
-1,0,0.69,-1.0,-0.0,4.854337692260742,6.6619037896906015,8,-10,-6,302,1014,1243,596,11
-1,0,0.82,-1.0,-0.0,4.863326549530029,5.816653826391969,8,-9,-6,302,1014,1243,596,11
-1,0,0.82,-1.0,-0.0,0.007965326309204102,125.86038956948718,9,-117,54,193,1074,311,1020,7
0,0,0.72,-0.0,-0.0,0.016968727111816406,125.86038956948718,9,-117,54,193,1074,311,1020,7
0,0,0.7,-0.0,-0.0,0.024920225143432617,125.86038956948718,9,-117,54,193,1074,311,1020,7
0,0,0.67,-0.0,-0.0,0.03389859199523926,125.86038956948718,9,-117,54,193,1074,311,1020,7
0,0,0.61,-0.0,-0.0,0.0408785343170166,125.86038956948718,9,-117,54,193,1074,311,1020,7
0,0,0.53,-0.0,-0.0,0.05085110664367676,125.86038956948718,9,-117,54,193,1074,311,1020,7
0,0,0.49,-0.0,-0.0,0.05783414840698242,125.86038956948718,9,-117,54,193,1074,311,1020,7
0,0,0.4,-0.0,-0.0,0.06780767440795898,125.86038956948718,9,-117,54,193,1074,311,1020,7
0,0,0.33,-0.0,-0.0,0.07578516006469727,125.86038956948718,9,-117,54,193,1074,311,1020,7
0,0,0.29,-0.0,-0.0,0.08276677131652832,125.86038956948718,9,-117,54,193,1074,311,1020,7
0,0,0.3,-0.0,-0.0,0.09274125099182129,125.86038956948718,9,-117,54,193,1074,311,1020,7
0,0,0.3,-0.0,-0.0,0.10072040557861328,125.86038956948718,9,-117,54,193,1074,311,1020,7
0,0,0.27,-0.0,-0.0,0.10770010948181152,125.86038956948718,9,-117,54,193,1074,311,1020,7
0,0,0.27,-0.0,-0.0,0.11768651008605957,125.86038956948718,9,-117,54,193,1074,311,1020,7
0,0,0.27,-0.0,-0.0,0.12565279006958008,125.86038956948718,9,-117,54,193,1074,311,1020,7
0,0,0.27,-0.0,-0.0,0.13363170623779297,125.86038956948718,9,-117,54,193,1074,311,1020,7
0,0,0.25,-0.0,-0.0,0.14063739776611328,125.86038956948718,9,-117,54,193,1074,311,1020,7
0,0,0.21,-0.0,-0.0,0.15158462524414062,125.86038956948718,9,-117,54,193,1074,311,1020,7
0,0,0.26,-0.0,-0.0,0.15856623649597168,125.86038956948718,9,-117,54,193,1074,311,1020,7
0,0,0.25,-0.0,-0.0,0.16554665565490723,125.86038956948718,9,-117,54,193,1074,311,1020,7
0,0,0.24,-0.0,-0.0,0.1755201816558838,125.86038956948718,9,-117,54,193,1074,311,1020,7
0,0,0.24,-0.0,-0.0,0.18251609802246094,125.86038956948718,9,-117,54,193,1074,311,1020,7
0,0,0.24,-0.0,-0.0,0.19147896766662598,125.86038956948718,9,-117,54,193,1074,311,1020,7
0,0,0.24,-0.0,-0.0,0.20145177841186523,125.86038956948718,9,-117,54,193,1074,311,1020,7
0,0,0.24,-0.0,-0.0,0.20942974090576172,125.86038956948718,9,-117,54,193,1074,311,1020,7
0,0,0.24,-0.0,-0.0,0.2194044589996338,125.86038956948718,9,-117,54,193,1074,311,1020,7
0,0,0.24,-0.0,-0.0,0.22641396522521973,125.86038956948718,9,-117,54,193,1074,311,1020,7
0,0,0.24,-0.0,-0.0,0.23638629913330078,125.86038956948718,9,-117,54,193,1074,311,1020,7
0,0,0.24,-0.0,-0.0,0.2453620433807373,125.86038956948718,9,-117,54,193,1074,311,1020,7
0,0,0.24,-0.0,-0.0,0.25630688667297363,125.86038956948718,9,-117,54,193,1074,311,1020,7
0,0,0.24,-0.0,-0.0,0.26528239250183105,125.86038956948718,9,-117,54,193,1074,311,1020,7
0,0,0.24,-0.0,-0.0,0.27428555488586426,125.86038956948718,9,-117,54,193,1074,311,1020,7
0,0,0.24,-0.0,-0.0,0.28426194190979004,125.86038956948718,9,-117,54,193,1074,311,1020,7
0,0,0.24,-0.0,-0.0,0.29221105575561523,125.86038956948718,9,-117,54,193,1074,311,1020,7
0,0,0.24,-0.0,-0.0,0.3002164363861084,125.86038956948718,9,-117,54,193,1074,311,1020,7
0,0,0.24,-0.0,-0.0,0.3081691265106201,125.86038956948718,9,-117,54,193,1074,311,1020,7
0,0,0.24,-0.0,-0.0,0.3181416988372803,125.86038956948718,9,-117,54,193,1074,311,1020,7
0,0,0.24,-0.0,-0.0,0.3251347541809082,125.86038956948718,9,-117,54,193,1074,311,1020,7
0,0,0.24,-0.0,-0.0,0.335099458694458,125.86038956948718,9,-117,54,193,1074,311,1020,7
0,0,0.24,-0.0,-0.0,0.343076229095459,125.86038956948718,9,-117,54,193,1074,311,1020,7
0,0,0.24,-0.0,-0.0,0.3520526885986328,125.86038956948718,9,-117,54,193,1074,311,1020,7
0,0,0.24,-0.0,-0.0,0.3600294589996338,125.86038956948718,9,-117,54,193,1074,311,1020,7
0,0,0.24,-0.0,-0.0,0.3680098056793213,125.86038956948718,9,-117,54,193,1074,311,1020,7
0,0,0.24,-0.0,-0.0,0.37600135803222656,125.86038956948718,9,-117,54,193,1074,311,1020,7
0,0,0.24,-0.0,-0.0,0.3849649429321289,125.86038956948718,9,-117,54,193,1074,311,1020,7
0,0,0.24,-0.0,-0.0,0.39394116401672363,125.86038956948718,9,-117,54,193,1074,311,1020,7
0,0,0.24,-0.0,-0.0,0.40291643142700195,125.86038956948718,9,-117,54,193,1074,311,1020,7
0,0,0.24,-0.0,-0.0,0.41089463233947754,125.86038956948718,9,-117,54,193,1074,311,1020,7
0,0,0.24,-0.0,-0.0,0.41987061500549316,125.86038956948718,9,-117,54,193,1074,311,1020,7
0,0,0.24,-0.0,-0.0,0.42984533309936523,125.86038956948718,9,-117,54,193,1074,311,1020,7
0,0,0.24,-0.0,-0.0,0.4368314743041992,125.86038956948718,9,-117,54,193,1074,311,1020,7
0,0,0.24,-0.0,-0.0,0.4468061923980713,125.86038956948718,9,-117,54,193,1074,311,1020,7
0,0,0.24,-0.0,-0.0,0.45380640029907227,125.86038956948718,9,-117,54,193,1074,311,1020,7
0,0,0.24,-0.0,-0.0,0.46275782585144043,125.86038956948718,9,-117,54,193,1074,311,1020,7
0,0,0.24,-0.0,-0.0,0.4727318286895752,125.86038956948718,9,-117,54,193,1074,311,1020,7
0,0,0.24,-0.0,-0.0,0.480710506439209,125.86038956948718,9,-117,54,193,1074,311,1020,7
0,0,0.24,-0.0,-0.0,0.48868799209594727,125.86038956948718,9,-117,54,193,1074,311,1020,7
0,0,0.24,-0.0,-0.0,0.49668216705322266,125.86038956948718,9,-117,54,193,1074,311,1020,7
0,0,0.24,-0.0,-0.0,0.5036497116088867,125.86038956948718,9,-117,54,193,1074,311,1020,7
0,0,0.24,-0.0,-0.0,0.512624979019165,125.86038956948718,9,-117,54,193,1074,311,1020,7
0,0,0.24,-0.0,-0.0,0.5216145515441895,125.86038956948718,9,-117,54,193,1074,311,1020,7
0,0,0.24,-0.0,-0.0,0.5305776596069336,125.86038956948718,9,-117,54,193,1074,311,1020,7
0,0,0.24,-0.0,-0.0,0.5405523777008057,125.86038956948718,9,-117,54,193,1074,311,1020,7
0,0,0.24,-0.0,-0.0,0.5485286712646484,125.86038956948718,9,-117,54,193,1074,311,1020,7
0,0,0.24,-0.0,-0.0,0.5575146675109863,125.86038956948718,9,-117,54,193,1074,311,1020,7
0,0,0.24,-0.0,-0.0,0.5644865036010742,125.86038956948718,9,-117,54,193,1074,311,1020,7
0,0,0.24,-0.0,-0.0,0.5734639167785645,125.86038956948718,9,-117,54,193,1074,311,1020,7
0,0,0.24,-0.0,-0.0,0.5824403762817383,125.86038956948718,9,-117,54,193,1074,311,1020,7
0,0,0.24,-0.0,-0.0,0.5924420356750488,125.86038956948718,9,-117,54,193,1074,311,1020,7
0,0,0.24,-0.0,-0.0,0.6023869514465332,125.86038956948718,9,-117,54,193,1074,311,1020,7
0,0,0.24,-0.0,-0.0,0.6123602390289307,125.86038956948718,9,-117,54,193,1074,311,1020,7
0,0,0.24,-0.0,-0.0,0.6203405857086182,125.86038956948718,9,-117,54,193,1074,311,1020,7
0,0,0.24,-0.0,-0.0,0.6283183097839355,125.86038956948718,9,-117,54,193,1074,311,1020,7
0,0,0.24,-0.0,-0.0,0.6352989673614502,125.86038956948718,9,-117,54,193,1074,311,1020,7
0,0,0.24,-0.0,-0.0,0.6442761421203613,125.86038956948718,9,-117,54,193,1074,311,1020,7
0,0,0.24,-0.0,-0.0,0.6532516479492188,125.86038956948718,9,-117,54,193,1074,311,1020,7
0,0,0.24,-0.0,-0.0,0.6612300872802734,125.86038956948718,9,-117,54,193,1074,311,1020,7
0,0,0.24,-0.0,-0.0,0.6712028980255127,125.86038956948718,9,-117,54,193,1074,311,1020,7
0,0,0.24,-0.0,-0.0,0.6781854629516602,125.86038956948718,9,-117,54,193,1074,311,1020,7
0,0,0.24,-0.0,-0.0,0.6871614456176758,125.86038956948718,9,-117,54,193,1074,311,1020,7
0,0,0.24,-0.0,-0.0,0.6971354484558105,125.86038956948718,9,-117,54,193,1074,311,1020,7
0,0,0.24,-0.0,-0.0,0.7041170597076416,125.86038956948718,9,-117,54,193,1074,311,1020,7
0,0,0.24,-0.0,-0.0,0.7130930423736572,125.86038956948718,9,-117,54,193,1074,311,1020,7
0,0,0.24,-0.0,-0.0,0.7240633964538574,125.86038956948718,9,-117,54,193,1074,311,1020,7
0,0,0.24,-0.0,-0.0,0.7310471534729004,125.86038956948718,9,-117,54,193,1074,311,1020,7
0,0,0.24,-0.0,-0.0,0.7400212287902832,125.86038956948718,9,-117,54,193,1074,311,1020,7
0,0,0.24,-0.0,-0.0,0.7499935626983643,125.86038956948718,9,-117,54,193,1074,311,1020,7
0,0,0.24,-0.0,-0.0,0.7570028305053711,125.86038956948718,9,-117,54,193,1074,311,1020,7
0,0,0.24,-0.0,-0.0,0.7659790515899658,125.86038956948718,9,-117,54,193,1074,311,1020,7
0,0,0.24,-0.0,-0.0,0.7749285697937012,125.86038956948718,9,-117,54,193,1074,311,1020,7
0,0,0.24,-0.0,-0.0,0.7819101810455322,125.86038956948718,9,-117,54,193,1074,311,1020,7
0,0,0.24,-0.0,-0.0,0.7918820381164551,125.86038956948718,9,-117,54,193,1074,311,1020,7
0,0,0.24,-0.0,-0.0,0.7998623847961426,125.86038956948718,9,-117,54,193,1074,311,1020,7
0,0,0.24,-0.0,-0.0,0.8068423271179199,125.86038956948718,9,-117,54,193,1074,311,1020,7
0,0,0.24,-0.0,-0.0,0.8168163299560547,125.86038956948718,9,-117,54,193,1074,311,1020,7
0,0,0.24,-0.0,-0.0,0.8247947692871094,125.86038956948718,9,-117,54,193,1074,311,1020,7
0,0,0.24,-0.0,-0.0,0.8317790031433105,125.86038956948718,9,-117,54,193,1074,311,1020,7
0,0,0.24,-0.0,-0.0,0.8407552242279053,125.86038956948718,9,-117,54,193,1074,311,1020,7
0,0,0.24,-0.0,-0.0,0.8497560024261475,125.86038956948718,9,-117,54,193,1074,311,1020,7
0,0,0.24,-0.0,-0.0,0.8587055206298828,125.86038956948718,9,-117,54,193,1074,311,1020,7
0,0,0.24,-0.0,-0.0,0.8686795234680176,125.86038956948718,9,-117,54,193,1074,311,1020,7
0,0,0.24,-0.0,-0.0,0.8756611347198486,125.86038956948718,9,-117,54,193,1074,311,1020,7
0,0,0.24,-0.0,-0.0,0.885634183883667,125.86038956948718,9,-117,54,193,1074,311,1020,7
0,0,0.24,-0.0,-0.0,0.8926146030426025,125.86038956948718,9,-117,54,193,1074,311,1020,7
0,0,0.24,-0.0,-0.0,0.9015920162200928,125.86038956948718,9,-117,54,193,1074,311,1020,7
0,0,0.24,-0.0,-0.0,0.9105668067932129,125.86038956948718,9,-117,54,193,1074,311,1020,7
0,0,0.24,-0.0,-0.0,0.9195523262023926,125.86038956948718,9,-117,54,193,1074,311,1020,7
0,0,0.24,-0.0,-0.0,0.9285204410552979,125.86038956948718,9,-117,54,193,1074,311,1020,7
0,0,0.24,-0.0,-0.0,0.9378478527069092,125.86038956948718,9,-117,54,193,1074,311,1020,7
0,0,0.24,-0.0,-0.0,0.946840763092041,125.86038956948718,9,-117,54,193,1074,311,1020,7
0,0,0.24,-0.0,-0.0,0.9557952880859375,125.86038956948718,9,-117,54,193,1074,311,1020,7
0,0,0.24,-0.0,-0.0,0.9657669067382812,125.86038956948718,9,-117,54,193,1074,311,1020,7
