dx,dy,button,rx,ry,time,distance,targetID,directionX,directionY,targetX,targetY,initMouseX,initMouseY,targetSize
0,0,0.18,-0.0,-0.0,0.9021165370941162,253.87307554959068,1,-98,-245,862,355,960,600,20
7,-2,0.04,7.0,-2.0,0.9090878963470459,254.71494102146937,1,-105,-243,862,355,960,600,20
5,-2,0.05,5.0,-2.0,0.9170670509338379,254.91696812397652,1,-110,-241,862,355,960,600,20
3,-3,0.01,3.0,-3.0,0.9260416030883789,253.46346995361614,1,-113,-238,862,355,960,600,20
3,-3,0.01,3.0,-3.0,0.9350214004516602,252.070601174569,1,-116,-235,862,355,960,600,20
3,-3,0.01,3.0,-3.0,0.9449911117553711,250.73933343475431,1,-119,-232,862,355,960,600,20
3,-4,0.01,3.0,-4.0,0.9519731998443604,248.58847615468096,1,-122,-228,862,355,960,600,20
3,-5,0.02,3.0,-5.0,0.9619505405426025,245.64428411368795,1,-125,-223,862,355,960,600,20
3,-6,0.01,3.0,-6.0,0.9699325561523438,241.93848455525804,1,-128,-217,862,355,960,600,20
2,-6,0.01,2.0,-6.0,0.9798984527587891,237.83260479605988,1,-130,-211,862,355,960,600,20
1,-7,0.01,1.0,-7.0,0.987877368927002,232.4396832203837,1,-131,-204,862,355,960,600,20
0,-7,0.01,-0.0,-7.0,0.9968547821044922,226.57979626333267,1,-131,-197,862,355,960,600,20
-1,-7,0.01,-1.0,-7.0,1.0058302879333496,220.21728866442677,1,-130,-190,862,355,960,600,20
-2,-7,0.01,-2.0,-7.0,1.0148065090179443,213.32263655975405,1,-128,-183,862,355,960,600,20
-3,-7,0.01,-3.0,-7.0,1.0237820148468018,205.87264764207623,1,-125,-176,862,355,960,600,20
-4,-7,0.02,-4.0,-7.0,1.0327644348144531,197.85090810482401,1,-121,-169,862,355,960,600,20
-4,-7,0.02,-4.0,-7.0,1.041734218597412,189.83242980057065,1,-117,-162,862,355,960,600,20
-4,-7,0.02,-4.0,-7.0,1.0517077445983887,181.81762171396036,1,-113,-155,862,355,960,600,20
-4,-7,0.01,-4.0,-7.0,1.0586903095245361,173.8069639594757,1,-109,-148,862,355,960,600,20
-4,-7,0.01,-4.0,-7.0,1.0676653385162354,165.80102388780332,1,-105,-141,862,355,960,600,20
-4,-7,0.01,-4.0,-7.0,1.076641321182251,157.80047675736802,1,-101,-134,862,355,960,600,20
-4,-7,0.01,-4.0,-7.0,1.0866425037384033,149.80613254815975,1,-97,-127,862,355,960,600,20
-4,-7,0.02,-4.0,-7.0,1.096588373184204,141.81897114655993,1,-93,-120,862,355,960,600,20
-4,-7,0.01,-4.0,-7.0,1.1035709381103516,133.8401890988746,1,-89,-113,862,355,960,600,20
-4,-7,0.01,-4.0,-7.0,1.1125459671020508,125.87126259809321,1,-85,-106,862,355,960,600,20
-4,-7,0.01,-4.0,-7.0,1.1215236186981201,117.91403363196706,1,-81,-99,862,355,960,600,20
-4,-6,0.01,-4.0,-6.0,1.1315226554870605,110.7393887677091,1,-77,-93,862,355,960,600,20
-4,-6,0.01,-4.0,-6.0,1.1394741535186768,103.56936206565572,1,-73,-87,862,355,960,600,20
-4,-5,0.01,-4.0,-5.0,1.1464629173278809,97.16809226630845,1,-69,-82,862,355,960,600,20
-4,-5,0.01,-4.0,-5.0,1.1544365882873535,90.7670581092849,1,-65,-77,862,355,960,600,20
-4,-5,0.01,-4.0,-5.0,1.163412094116211,84.36630754670864,1,-61,-72,862,355,960,600,20
-4,-5,0.02,-4.0,-5.0,1.1723871231079102,77.96590248499699,1,-57,-67,862,355,960,600,20
-4,-5,0.02,-4.0,-5.0,1.1813633441925049,71.5659242576212,1,-53,-62,862,355,960,600,20
-4,-5,0.02,-4.0,-5.0,1.1903531551361084,65.16648189186454,1,-49,-57,862,355,960,600,20
-4,-4,0.02,-4.0,-4.0,1.1993160247802734,59.52697318307479,1,-45,-53,862,355,960,600,20
-4,-4,0.02,-4.0,-4.0,1.209289789199829,53.89053137985315,1,-41,-49,862,355,960,600,20
-4,-3,0.01,-4.0,-3.0,1.2162973880767822,49.033888572581766,1,-37,-46,862,355,960,600,20
-3,-3,0.01,-3.0,-3.0,1.2252464294433594,44.817880294662984,1,-34,-43,862,355,960,600,20
-3,-3,0.01,-3.0,-3.0,1.2342498302459717,40.60632371551998,1,-31,-40,862,355,960,600,20
-3,-3,0.01,-3.0,-3.0,1.2431986331939697,36.400431032480725,1,-28,-37,862,355,960,600,20
-3,-3,0.01,-3.0,-3.0,1.2521748542785645,32.20189569201838,1,-25,-34,862,355,960,600,20
-3,-3,0.01,-3.0,-3.0,1.2621486186981201,28.013155617496423,1,-22,-31,862,355,960,600,20
-3,-3,0.01,-3.0,-3.0,1.269129991531372,23.837848631377263,1,-19,-28,862,355,960,600,20
-3,-3,0.01,-3.0,-3.0,1.2791032791137695,19.68164415931166,1,-16,-25,862,355,960,600,20
-3,-3,0.01,-3.0,-3.0,1.2870819568634033,15.553864678361276,1,-13,-22,862,355,960,600,20
-3,-3,0.01,-3.0,-3.0,1.296057939529419,11.470910553583888,1,-10,-19,862,355,960,600,20
-3,-3,0.01,-3.0,-3.0,1.3050343990325928,7.464249196572979,1,-7,-16,862,355,960,600,20
-3,-2,0.01,-3.0,-2.0,1.314033031463623,4.560219778561036,1,-4,-14,862,355,960,600,20
-2,-2,0.01,-2.0,-2.0,1.3229877948760986,2.1655250605964387,1,-2,-12,862,355,960,600,20
-2,-2,0.01,-2.0,-2.0,1.3299691677093506,0.0,1,0,-10,862,355,960,600,20
-2,-2,0.01,-2.0,-2.0,1.3399419784545898,-1.7537887487646788,1,2,-8,862,355,960,600,20
-2,-2,0.01,-2.0,-2.0,1.3469231128692627,-2.7888974490720218,1,4,-6,862,355,960,600,20
-2,-2,0.01,-2.0,-2.0,1.3558993339538574,-2.7888974490720218,1,6,-4,862,355,960,600,20
-2,-2,0.02,-2.0,-2.0,1.3638789653778076,-1.7537887487646788,1,8,-2,862,355,960,600,20
-2,-2,0.02,-2.0,-2.0,1.372854471206665,0.0,1,10,0,862,355,960,600,20
-2,-2,0.03,-2.0,-2.0,1.3818321228027344,2.1655250605964387,1,12,2,862,355,960,600,20
-2,-1,0.03,-2.0,-1.0,1.3908195495605469,4.317821063276353,1,14,3,862,355,960,600,20
-1,-1,0.17,-1.0,-1.0,1.399810791015625,5.524174696260024,1,15,4,862,355,960,600,20
-1,0,0.57,-1.0,-0.0,1.4077658653259277,6.492422502470642,1,16,4,862,355,960,600,20
0,0,0.81,-0.0,-0.0,0.008971929550170898,740.9366639923668,2,-303,686,543,1037,846,351,19
0,0,0.41,-0.0,-0.0,0.01595330238342285,740.9366639923668,2,-303,686,543,1037,846,351,19
0,1,0.34,-0.0,1.0,0.024931669235229492,740.0220290485454,2,-303,685,543,1037,846,351,19
0,2,0.11,-0.0,2.0,0.03390622138977051,738.1934153885459,2,-303,683,543,1037,846,351,19
0,2,0.04,-0.0,2.0,0.043878793716430664,736.3656820648506,2,-303,681,543,1037,846,351,19
0,3,0.03,-0.0,3.0,0.05185890197753906,733.6257469277509,2,-303,678,543,1037,846,351,19
0,3,0.02,-0.0,3.0,0.06083393096923828,730.8878293363123,2,-303,675,543,1037,846,351,19
0,4,0.01,-0.0,4.0,0.07080769538879395,727.2404498531713,2,-303,671,543,1037,846,351,19
0,5,0.0,-0.0,5.0,0.07878661155700684,722.6864082378461,2,-303,666,543,1037,846,351,19
0,6,0.0,-0.0,6.0,0.08576846122741699,717.229302631063,2,-303,660,543,1037,846,351,19
0,7,0.0,-0.0,7.0,0.09474587440490723,710.8736000160028,2,-303,653,543,1037,846,351,19
0,8,0.0,-0.0,8.0,0.10471725463867188,703.6247259252235,2,-303,645,543,1037,846,351,19
0,9,0.0,-0.0,9.0,0.11169838905334473,695.4891766379382,2,-303,636,543,1037,846,351,19
-1,10,0.0,-1.0,10.0,0.1216740608215332,686.0395672190181,2,-302,626,543,1037,846,351,19
-1,11,0.0,-1.0,11.0,0.12865328788757324,675.7086971844304,2,-301,615,543,1037,846,351,19
-2,12,0.0,-2.0,12.0,0.13763070106506348,664.0601756158211,2,-299,603,543,1037,846,351,19
-2,13,0.0,-2.0,13.0,0.1466062068939209,651.5369028298117,2,-297,590,543,1037,846,351,19
-3,14,0.0,-3.0,14.0,0.154585599899292,637.6931266064299,2,-294,576,543,1037,846,351,19
-3,15,0.0,-3.0,15.0,0.16356110572814941,622.9825946970375,2,-291,561,543,1037,846,351,19
-3,16,0.0,-3.0,16.0,0.1715712547302246,607.4162554637896,2,-288,545,543,1037,846,351,19
-3,16,0.0,-3.0,16.0,0.179518461227417,591.8876766917424,2,-285,529,543,1037,846,351,19
-3,16,0.0,-3.0,16.0,0.1880183219909668,576.3998633412891,2,-282,513,543,1037,846,351,19
-3,16,0.0,-3.0,16.0,0.19498753547668457,560.9561386633186,2,-279,497,543,1037,846,351,19
-3,16,0.0,-3.0,16.0,0.20496106147766113,545.5601860934482,2,-276,481,543,1037,846,351,19
-3,16,0.0,-3.0,16.0,0.21296024322509766,530.2160976825525,2,-273,465,543,1037,846,351,19
-3,16,0.0,-3.0,16.0,0.2209186553955078,514.9284302268775,2,-270,449,543,1037,846,351,19
-3,16,0.0,-3.0,16.0,0.2288980484008789,499.7022704883476,2,-267,433,543,1037,846,351,19
-3,16,0.0,-3.0,16.0,0.23589181900024414,484.54331116934407,2,-264,417,543,1037,846,351,19
-3,15,0.0,-3.0,15.0,0.24585485458374023,470.2963592601137,2,-261,402,543,1037,846,351,19
-3,15,0.0,-3.0,15.0,0.2558259963989258,456.1161145348546,2,-258,387,543,1037,846,351,19
-3,14,0.0,-3.0,14.0,0.26480770111083984,442.83404032896857,2,-255,373,543,1037,846,351,19
-3,14,0.0,-3.0,14.0,0.27377867698669434,429.6171451277298,2,-252,359,543,1037,846,351,19
-3,13,0.0,-3.0,13.0,0.28275370597839355,417.28277000132204,2,-249,346,543,1037,846,351,19
-3,13,0.0,-3.0,13.0,0.2917301654815674,405.01086942253096,2,-246,333,543,1037,846,351,19
-3,12,0.0,-3.0,12.0,0.300706148147583,393.6040238248992,2,-243,321,543,1037,846,351,19
-3,12,0.0,-3.0,12.0,0.31067943572998047,382.2556708854199,2,-240,309,543,1037,846,351,19
-3,11,0.0,-3.0,11.0,0.31766271591186523,371.7532009057836,2,-237,298,543,1037,846,351,19
-3,11,0.0,-3.0,11.0,0.32663846015930176,361.3039292257105,2,-234,287,543,1037,846,351,19
-3,10,0.0,-3.0,10.0,0.3356139659881592,351.67991349671803,2,-231,277,543,1037,846,351,19
-3,10,0.0,-3.0,10.0,0.34360384941101074,342.10254912204783,2,-228,267,543,1037,846,351,19
-3,10,0.0,-3.0,10.0,0.35157179832458496,332.57576026410305,2,-225,257,543,1037,846,351,19
-3,9,0.0,-3.0,9.0,0.35955047607421875,323.84831380074615,2,-222,248,543,1037,846,351,19
-3,9,0.0,-3.0,9.0,0.3665308952331543,315.1635389737717,2,-219,239,543,1037,846,351,19
-3,9,0.0,-3.0,9.0,0.37452268600463867,306.52495939307244,2,-216,230,543,1037,846,351,19
-3,8,0.0,-3.0,8.0,0.38448429107666016,298.6572768520192,2,-213,222,543,1037,846,351,19
-3,8,0.0,-3.0,8.0,0.39246201515197754,290.82661656364,2,-210,214,543,1037,846,351,19
-3,8,0.0,-3.0,8.0,0.3994452953338623,283.0359566902678,2,-207,206,543,1037,846,351,19
-3,8,0.01,-3.0,8.0,0.4084205627441406,275.2885857715712,2,-204,198,543,1037,846,351,19
-3,8,0.01,-3.0,8.0,0.41739583015441895,267.58814146669414,2,-201,190,543,1037,846,351,19
-3,8,0.01,-3.0,8.0,0.426379919052124,259.9386547151599,2,-198,182,543,1037,846,351,19
-3,7,0.01,-3.0,7.0,0.4353482723236084,253.01145013147806,2,-195,175,543,1037,846,351,19
-3,7,0.01,-3.0,7.0,0.4443244934082031,246.1234995056316,2,-192,168,543,1037,846,351,19
-3,7,0.01,-3.0,7.0,0.45330166816711426,239.2780699135548,2,-189,161,543,1037,846,351,19
-3,7,0.01,-3.0,7.0,0.4622774124145508,232.4787775354182,2,-186,154,543,1037,846,351,19
-3,7,0.01,-3.0,7.0,0.4712543487548828,225.72963170422264,2,-183,147,543,1037,846,351,19
-3,7,0.01,-3.0,7.0,0.48022937774658203,219.0350850198276,2,-180,140,543,1037,846,351,19
-3,6,0.01,-3.0,6.0,0.48920631408691406,213.00225224082752,2,-177,134,543,1037,846,351,19
-3,6,0.02,-3.0,6.0,0.4981813430786133,207.0092590608097,2,-174,128,543,1037,846,351,19
-3,6,0.02,-3.0,6.0,0.508155345916748,201.05951537600004,2,-171,122,543,1037,846,351,19
-3,6,0.02,-3.0,6.0,0.5161335468292236,195.15680248279753,2,-168,116,543,1037,846,351,19
-3,6,0.02,-3.0,6.0,0.5251116752624512,189.3053201505194,2,-165,110,543,1037,846,351,19
-3,6,0.02,-3.0,6.0,0.534085750579834,183.50974001333023,2,-162,104,543,1037,846,351,19
-3,5,0.02,-3.0,5.0,0.5430667400360107,178.3018953454556,2,-159,99,543,1037,846,351,19
-3,5,0.02,-3.0,5.0,0.5520479679107666,173.1318203939114,2,-156,94,543,1037,846,351,19
-3,5,0.03,-3.0,5.0,0.56201171875,168.00282483621552,2,-153,89,543,1037,846,351,19
-3,5,0.03,-3.0,5.0,0.5699906349182129,162.91858538273283,2,-150,84,543,1037,846,351,19
-3,5,0.02,-3.0,5.0,0.5779962539672852,157.88319268278636,2,-147,79,543,1037,846,351,19
-3,5,0.02,-3.0,5.0,0.5861256122589111,152.90120444270946,2,-144,74,543,1037,846,351,19
-3,5,0.02,-3.0,5.0,0.5931069850921631,147.97770542341354,2,-141,69,543,1037,846,351,19
-3,4,0.03,-3.0,4.0,0.6020832061767578,143.5417975507041,2,-138,65,543,1037,846,351,19
-3,4,0.03,-3.0,4.0,0.6110591888427734,139.14182393908885,2,-135,61,543,1037,846,351,19
-3,4,0.03,-3.0,4.0,0.6190519332885742,134.7810835958611,2,-132,57,543,1037,846,351,19
-3,4,0.03,-3.0,4.0,0.6270279884338379,130.46325680981354,2,-129,53,543,1037,846,351,19
-3,4,0.03,-3.0,4.0,0.6340041160583496,126.19245541079576,2,-126,49,543,1037,846,351,19
-3,4,0.03,-3.0,4.0,0.6420044898986816,121.97327971765844,2,-123,45,543,1037,846,351,19
-3,4,0.03,-3.0,4.0,0.6509571075439453,117.81088281373961,2,-120,41,543,1037,846,351,19
-3,4,0.03,-3.0,4.0,0.6609268188476562,113.71104269787622,2,-117,37,543,1037,846,351,19
-3,4,0.03,-3.0,4.0,0.6679081916809082,109.68024266911489,2,-114,33,543,1037,846,351,19
-3,3,0.03,-3.0,3.0,0.6778817176818848,105.9826073804208,2,-111,30,543,1037,846,351,19
-3,3,0.04,-3.0,3.0,0.6863687038421631,102.32385189167684,2,-108,27,543,1037,846,351,19
-3,3,0.03,-3.0,3.0,0.6953439712524414,98.70793842609746,2,-105,24,543,1037,846,351,19
-3,3,0.03,-3.0,3.0,0.7053177356719971,95.1393297462587,2,-102,21,543,1037,846,351,19
-3,3,0.03,-3.0,3.0,0.7133026123046875,91.62305898749054,2,-99,18,543,1037,846,351,19
-3,3,0.03,-3.0,3.0,0.7222733497619629,88.16480844420988,2,-96,15,543,1037,846,351,19
-3,3,0.02,-3.0,3.0,0.7312495708465576,84.7709976485267,2,-93,12,543,1037,846,351,19
-3,3,0.02,-3.0,3.0,0.7412235736846924,81.44888059008801,2,-90,9,543,1037,846,351,19
-3,3,0.02,-3.0,3.0,0.7492012977600098,78.20665112249179,2,-87,6,543,1037,846,351,19
-3,3,0.01,-3.0,3.0,0.7581770420074463,75.0535543567314,2,-84,3,543,1037,846,351,19
-3,3,0.01,-3.0,3.0,0.7651586532592773,72.0,2,-81,0,543,1037,846,351,19
-3,3,0.01,-3.0,3.0,0.7741351127624512,69.05767098754612,2,-78,-3,543,1037,846,351,19
-3,3,0.01,-3.0,3.0,0.7831122875213623,66.23961722390672,2,-75,-6,543,1037,846,351,19
-3,3,0.01,-3.0,3.0,0.7920887470245361,63.56031973468694,2,-72,-9,543,1037,846,351,19
-3,3,0.0,-3.0,3.0,0.8010637760162354,61.03570517957252,2,-69,-12,543,1037,846,351,19
-3,3,0.0,-3.0,3.0,0.8090419769287109,58.683085036070864,2,-66,-15,543,1037,846,351,19
-3,3,0.0,-3.0,3.0,0.8180181980133057,56.52098900352466,2,-63,-18,543,1037,846,351,19
-3,3,0.0,-3.0,3.0,0.8259978294372559,54.56886030125127,2,-60,-21,543,1037,846,351,19
-3,2,0.0,-3.0,2.0,0.8339767456054688,52.465437442517235,2,-57,-23,543,1037,846,351,19
-3,2,0.0,-3.0,2.0,0.8419549465179443,50.50630218724736,2,-54,-25,543,1037,846,351,19
-3,2,0.0,-3.0,2.0,0.849933385848999,48.706152185014034,2,-51,-27,543,1037,846,351,19
-3,2,0.0,-3.0,2.0,0.8569157123565674,47.08029957123981,2,-48,-29,543,1037,846,351,19
-3,2,0.0,-3.0,2.0,0.8658909797668457,45.644304369257,2,-45,-31,543,1037,846,351,19
-3,2,0.0,-3.0,2.0,0.8748669624328613,44.41348144429457,2,-42,-33,543,1037,846,351,19
-3,2,0.0,-3.0,2.0,0.8848414421081543,43.40229002629561,2,-39,-35,543,1037,846,351,19
-3,2,0.0,-3.0,2.0,0.8938171863555908,42.62363799656123,2,-36,-37,543,1037,846,351,19
-3,2,0.0,-3.0,2.0,0.9018189907073975,42.088159097779204,2,-33,-39,543,1037,846,351,19
-3,2,0.0,-3.0,2.0,0.9107720851898193,41.80354318352215,2,-30,-41,543,1037,846,351,19
-3,1,0.0,-3.0,1.0,0.9197478294372559,40.92995093127971,2,-27,-42,543,1037,846,351,19
-2,1,0.0,-2.0,1.0,0.9287238121032715,40.73932046178355,2,-25,-43,543,1037,846,351,19
-2,0,0.01,-2.0,-0.0,0.9386975765228271,39.76474136094644,2,-23,-43,543,1037,846,351,19
-2,0,0.01,-2.0,-0.0,0.9466779232025146,38.853944456021594,2,-21,-43,543,1037,846,351,19
-2,0,0.01,-2.0,-0.0,0.9566495418548584,38.01063709417264,2,-19,-43,543,1037,846,351,19
-2,0,0.01,-2.0,-0.0,0.9646289348602295,37.238512086787566,2,-17,-43,543,1037,846,351,19
-2,0,0.01,-2.0,-0.0,0.9736049175262451,36.5411901469428,2,-15,-43,543,1037,846,351,19
-2,0,0.02,-2.0,-0.0,0.9805862903594971,35.9221548904324,2,-13,-43,543,1037,846,351,19
-2,0,0.03,-2.0,-0.0,0.9895637035369873,35.384682042344295,2,-11,-43,543,1037,846,351,19
-2,0,0.04,-2.0,-0.0,0.9975419044494629,34.93176527297759,2,-9,-43,543,1037,846,351,19
-2,0,0.06,-2.0,-0.0,1.0055198669433594,34.56604182158393,2,-7,-43,543,1037,846,351,19
-2,0,0.07,-2.0,-0.0,1.015493392944336,34.289721643826724,2,-5,-43,543,1037,846,351,19
-2,0,0.08,-2.0,-0.0,1.0234718322753906,34.104524124504614,2,-3,-43,543,1037,846,351,19
-2,0,0.09,-2.0,-0.0,1.0314545631408691,34.01162633521314,2,-1,-43,543,1037,846,351,19
-2,0,0.1,-2.0,-0.0,1.039433240890503,34.01162633521314,2,1,-43,543,1037,846,351,19
-2,0,0.11,-2.0,-0.0,1.0464119911193848,34.104524124504614,2,3,-43,543,1037,846,351,19
-2,0,0.12,-2.0,-0.0,1.056384563446045,34.289721643826724,2,5,-43,543,1037,846,351,19
-2,0,0.13,-2.0,-0.0,1.0633668899536133,34.56604182158393,2,7,-43,543,1037,846,351,19
-2,0,0.14,-2.0,-0.0,1.072343111038208,34.93176527297759,2,9,-43,543,1037,846,351,19
-1,0,0.15,-1.0,-0.0,1.0803217887878418,35.14748010928823,2,10,-43,543,1037,846,351,19
-1,0,0.27,-1.0,-0.0,1.0883376598358154,35.384682042344295,2,11,-43,543,1037,846,351,19
-1,0,0.34,-1.0,-0.0,1.0962803363800049,35.64302857109943,2,12,-43,543,1037,846,351,19
-1,0,0.34,-1.0,-0.0,1.1042578220367432,35.9221548904324,2,13,-43,543,1037,846,351,19
-1,0,0.34,-1.0,-0.0,1.1112396717071533,36.221676218380054,2,14,-43,543,1037,846,351,19
-1,0,0.35,-1.0,-0.0,1.119217872619629,36.5411901469428,2,15,-43,543,1037,846,351,19
-1,0,0.36,-1.0,-0.0,1.12819504737854,36.880278987817846,2,16,-43,543,1037,846,351,19
-1,0,0.39,-1.0,-0.0,1.1371703147888184,37.238512086787566,2,17,-43,543,1037,846,351,19
-1,0,0.41,-1.0,-0.0,1.1471476554870605,37.61544808322666,2,18,-43,543,1037,846,351,19
-1,0,0.42,-1.0,-0.0,1.1541261672973633,38.01063709417264,2,19,-43,543,1037,846,351,19
-1,0,0.44,-1.0,-0.0,1.1640982627868652,38.4236228055175,2,20,-43,543,1037,846,351,19
-1,0,0.46,-1.0,-0.0,1.171081304550171,38.853944456021594,2,21,-43,543,1037,846,351,19
-1,0,0.5,-1.0,-0.0,1.1800572872161865,39.30113870293329,2,22,-43,543,1037,846,351,19
-1,0,0.51,-1.0,-0.0,1.1900303363800049,39.76474136094644,2,23,-43,543,1037,846,351,19
-1,0,0.53,-1.0,-0.0,1.1980082988739014,40.24428900898052,2,24,-43,543,1037,846,351,19
-1,0,0.54,-1.0,-0.0,1.20601487159729,40.73932046178355,2,25,-43,543,1037,846,351,19
-1,0,0.54,-1.0,-0.0,1.2139670848846436,41.24937810560445,2,26,-43,543,1037,846,351,19
-1,0,0.56,-1.0,-0.0,1.2219598293304443,41.774009099144415,2,27,-43,543,1037,846,351,19
-1,0,0.58,-1.0,-0.0,1.2299249172210693,42.31276644267,2,28,-43,543,1037,846,351,19
-1,0,0.57,-1.0,-0.0,1.237903118133545,42.86520991955976,2,29,-43,543,1037,846,351,19
-1,0,0.56,-1.0,-0.0,1.2458934783935547,43.43090691567332,2,30,-43,543,1037,846,351,19
-1,0,0.56,-1.0,-0.0,1.2538599967956543,44.009433122794285,2,31,-43,543,1037,846,351,19
-1,0,0.56,-1.0,-0.0,1.2628357410430908,44.600373133029585,2,32,-43,543,1037,846,351,19
-1,0,0.56,-1.0,-0.0,1.2698452472686768,45.20332093147061,2,33,-43,543,1037,846,351,19
-1,0,0.57,-1.0,-0.0,1.278794765472412,45.817880294662984,2,34,-43,543,1037,846,351,19
-1,0,0.57,-1.0,-0.0,1.2887673377990723,46.44366510251645,2,35,-43,543,1037,846,351,19
-1,0,0.57,-1.0,-0.0,1.2967541217803955,47.08029957123981,2,36,-43,543,1037,846,351,19
-1,0,0.57,-1.0,-0.0,1.3057222366333008,47.72741841473134,2,37,-43,543,1037,846,351,19
-1,0,0.57,-1.0,-0.0,1.313706874847412,48.38466694161429,2,38,-43,543,1037,846,351,19
-1,0,0.57,-1.0,-0.0,1.3226771354675293,49.05170109479997,2,39,-43,543,1037,846,351,19
-1,0,0.56,-1.0,-0.0,1.330655574798584,49.728187440104094,2,40,-43,543,1037,846,351,19
-1,0,0.56,-1.0,-0.0,1.3396320343017578,50.413803110051795,2,41,-43,543,1037,846,351,19
-1,0,0.56,-1.0,-0.0,1.3486087322235107,51.108235708594876,2,42,-43,543,1037,846,351,19
-1,0,0.55,-1.0,-0.0,1.3575851917266846,51.81118318204309,2,43,-43,543,1037,846,351,19
-1,0,0.54,-1.0,-0.0,1.3665616512298584,52.5223536610881,2,44,-43,543,1037,846,351,19
-1,0,0.54,-1.0,-0.0,1.3755817413330078,53.24146527838174,2,45,-43,543,1037,846,351,19
-1,0,0.53,-1.0,-0.0,1.3845138549804688,53.96824596572466,2,46,-43,543,1037,846,351,19
-1,0,0.52,-1.0,-0.0,1.394486665725708,54.702433234531945,2,47,-43,543,1037,846,351,19
-1,0,0.51,-1.0,-0.0,1.403463363647461,55.4437739428721,2,48,-43,543,1037,846,351,19
-1,0,0.5,-1.0,-0.0,1.413435935974121,56.19202405202648,2,49,-43,543,1037,846,351,19
-1,0,0.49,-1.0,-0.0,1.4224398136138916,56.94694837519019,2,50,-43,543,1037,846,351,19
-1,0,0.48,-1.0,-0.0,1.4303920269012451,57.70832032063167,2,51,-43,543,1037,846,351,19
-1,0,0.47,-1.0,-0.0,1.4373779296875,58.47592163134935,2,52,-43,543,1037,846,351,19
-1,0,0.46,-1.0,-0.0,1.4473457336425781,59.24954212300622,2,53,-43,543,1037,846,351,19
-1,0,0.46,-1.0,-0.0,1.455324649810791,60.02897942168927,2,54,-43,543,1037,846,351,19
-1,0,0.45,-1.0,-0.0,1.4633045196533203,60.81403870282824,2,55,-43,543,1037,846,351,19
-1,0,0.44,-1.0,-0.0,1.4732770919799805,61.60453243241541,2,56,-43,543,1037,846,351,19
-1,0,0.43,-1.0,-0.0,1.4812564849853516,62.40028011149536,2,57,-43,543,1037,846,351,19
-1,0,0.43,-1.0,-0.0,1.4902315139770508,63.20110802473879,2,58,-43,543,1037,846,351,19
-1,0,0.42,-1.0,-0.0,1.4992077350616455,64.00684899377592,2,59,-43,543,1037,846,351,19
-1,0,0.41,-1.0,-0.0,1.5081841945648193,64.81734213584231,2,60,-43,543,1037,846,351,19
-1,0,0.4,-1.0,-0.0,1.517160415649414,65.63243262818116,2,61,-43,543,1037,846,351,19
-1,0,0.39,-1.0,-0.0,1.5261363983154297,66.45197147855052,2,62,-43,543,1037,846,351,19
-1,0,0.39,-1.0,-0.0,1.535114049911499,67.27581530209953,2,63,-43,543,1037,846,351,19
-1,0,0.38,-1.0,-0.0,1.5450859069824219,68.10382610480494,2,64,-43,543,1037,846,351,19
-1,0,0.37,-1.0,-0.0,1.5520691871643066,68.93587107359485,2,65,-43,543,1037,846,351,19
-1,0,0.36,-1.0,-0.0,1.5630395412445068,69.77182237323191,2,66,-43,543,1037,846,351,19
-1,0,0.35,-1.0,-0.0,1.5730130672454834,70.61155694998057,2,67,-43,543,1037,846,351,19
-1,0,0.34,-1.0,-0.0,1.5800070762634277,71.45495634204272,2,68,-43,543,1037,846,351,19
-1,0,0.34,-1.0,-0.0,1.5889978408813477,72.30190649671138,2,69,-43,543,1037,846,351,19
-1,0,0.33,-1.0,-0.0,1.5979459285736084,73.15229759416349,2,70,-43,543,1037,846,351,19
-1,0,0.32,-1.0,-0.0,1.608917474746704,74.00602387778854,2,71,-43,543,1037,846,351,19
-1,0,0.32,-1.0,-0.0,1.6158995628356934,74.86298349093002,2,72,-43,543,1037,846,351,19
-1,0,0.31,-1.0,-0.0,1.6248743534088135,75.72307831990054,2,73,-43,543,1037,846,351,19
-1,0,0.3,-1.0,-0.0,1.6338515281677246,76.58621384311844,2,74,-43,543,1037,846,351,19
-1,0,0.3,-1.0,-0.0,1.6428265571594238,77.45229898620394,2,75,-43,543,1037,846,351,19
-1,0,0.29,-1.0,-0.0,1.6518034934997559,78.32124598286491,2,76,-43,543,1037,846,351,19
-1,0,0.28,-1.0,-0.0,1.661775827407837,79.19297024139736,2,77,-43,543,1037,846,351,19
-1,0,0.28,-1.0,-0.0,1.6687588691711426,80.06739021662193,2,78,-43,543,1037,846,351,19
-1,0,0.27,-1.0,-0.0,1.6787309646606445,80.94442728707543,2,79,-43,543,1037,846,351,19
-1,0,0.27,-1.0,-0.0,1.6857149600982666,81.82400563727631,2,80,-43,543,1037,846,351,19
-1,0,0.26,-1.0,-0.0,1.6956892013549805,82.706052144883,2,81,-43,543,1037,846,351,19
-1,0,0.26,-1.0,-0.0,1.7026715278625488,83.59049627256569,2,82,-43,543,1037,846,351,19
-1,0,0.25,-1.0,-0.0,1.711646556854248,84.47726996441435,2,83,-43,543,1037,846,351,19
-1,0,0.25,-1.0,-0.0,1.720634937286377,85.36630754670864,2,84,-43,543,1037,846,351,19
-1,0,0.24,-1.0,-0.0,1.7296128273010254,86.25754563287887,2,85,-43,543,1037,846,351,19
-1,0,0.24,-1.0,-0.0,1.7395737171173096,87.15092303249095,2,86,-43,543,1037,846,351,19
-1,0,0.23,-1.0,-0.0,1.7475526332855225,88.04638066409278,2,87,-43,543,1037,846,351,19
-1,0,0.23,-1.0,-0.0,1.7565274238586426,88.94386147176351,2,88,-43,543,1037,846,351,19
-1,0,0.22,-1.0,-0.0,1.7655057907104492,89.84331034521254,2,89,-43,543,1037,846,351,19
-1,0,0.22,-1.0,-0.0,1.7764766216278076,90.74467404327912,2,90,-43,543,1037,846,351,19
-1,0,0.21,-1.0,-0.0,1.7834663391113281,91.64790112068906,2,91,-43,543,1037,846,351,19
-1,0,0.21,-1.0,-0.0,1.7914350032806396,92.55294185792945,2,92,-43,543,1037,846,351,19
-1,0,0.2,-1.0,-0.0,1.7994134426116943,93.45974819410792,2,93,-43,543,1037,846,351,19
-1,0,0.19,-1.0,-0.0,1.8073923587799072,94.36827366266692,2,94,-43,543,1037,846,351,19
-1,0,0.19,-1.0,-0.0,1.8143856525421143,95.27847332982968,2,95,-43,543,1037,846,351,19
-1,0,0.18,-1.0,-0.0,1.8233513832092285,96.19030373565806,2,96,-43,543,1037,846,351,19
-1,0,0.17,-1.0,-0.0,1.8323259353637695,97.10372283760829,2,97,-43,543,1037,846,351,19
-1,0,0.17,-1.0,-0.0,1.8413023948669434,98.01868995647442,2,98,-43,543,1037,846,351,19
-1,0,0.16,-1.0,-0.0,1.8502798080444336,98.93516572461452,2,99,-43,543,1037,846,351,19
-1,0,0.16,-1.0,-0.0,1.8592557907104492,99.85311203635843,2,100,-43,543,1037,846,351,19
-1,0,0.15,-1.0,-0.0,1.8682317733764648,100.77249200050075,2,101,-43,543,1037,846,351,19
-1,0,0.14,-1.0,-0.0,1.877206563949585,101.69326989478628,2,102,-43,543,1037,846,351,19
-1,0,0.14,-1.0,-0.0,1.8861842155456543,102.61541112229978,2,103,-43,543,1037,846,351,19
-1,0,0.13,-1.0,-0.0,1.89516019821167,103.53888216967503,2,104,-43,543,1037,846,351,19
-1,0,0.13,-1.0,-0.0,1.9021403789520264,104.46365056704283,2,105,-43,543,1037,846,351,19
-1,0,0.12,-1.0,-0.0,1.9121150970458984,105.38968484964018,2,106,-43,543,1037,846,351,19
-1,0,0.11,-1.0,-0.0,1.9190962314605713,106.31695452100702,2,107,-43,543,1037,846,351,19
-1,0,0.11,-1.0,-0.0,1.9290690422058105,107.24543001770004,2,108,-43,543,1037,846,351,19
-1,0,0.1,-1.0,-0.0,1.9360520839691162,108.17508267545622,2,109,-43,543,1037,846,351,19
-1,0,0.1,-1.0,-0.0,1.9450268745422363,109.10588469674151,2,110,-43,543,1037,846,351,19
-1,0,0.09,-1.0,-0.0,1.9540300369262695,110.03780911962384,2,111,-43,543,1037,846,351,19
-1,0,0.09,-1.0,-0.0,1.9629790782928467,110.97082978791136,2,112,-43,543,1037,846,351,19
-1,0,0.08,-1.0,-0.0,1.9729523658752441,111.90492132250036,2,113,-43,543,1037,846,351,19
-1,0,0.08,-1.0,-0.0,1.9819293022155762,112.8400590938793,2,114,-43,543,1037,846,351,19
-1,0,0.08,-1.0,-0.0,1.9909048080444336,113.77621919573839,2,115,-43,543,1037,846,351,19
-1,0,0.07,-1.0,-0.0,1.997887134552002,114.71337841963576,2,116,-43,543,1037,846,351,19
-1,0,0.07,-1.0,-0.0,2.0068633556365967,115.65151423067431,2,117,-43,543,1037,846,351,19
-1,0,0.07,-1.0,-0.0,2.014841079711914,116.59060474414477,2,118,-43,543,1037,846,351,19
-1,0,0.06,-1.0,-0.0,2.0238170623779297,117.53062870309307,2,119,-43,543,1037,846,351,19
-1,0,0.06,-1.0,-0.0,2.0327930450439453,118.47156545677157,2,120,-43,543,1037,846,351,19
-1,0,0.06,-1.0,-0.0,2.0407721996307373,119.41339493993607,2,121,-43,543,1037,846,351,19
-1,0,0.05,-1.0,-0.0,2.0477538108825684,120.3560976529518,2,122,-43,543,1037,846,351,19
-1,0,0.05,-1.0,-0.0,2.056729555130005,121.29965464267354,2,123,-43,543,1037,846,351,19
-1,0,0.05,-1.0,-0.0,2.065706729888916,122.24404748406687,2,124,-43,543,1037,846,351,19
-1,0,0.05,-1.0,-0.0,2.074683427810669,123.18925826253812,2,125,-43,543,1037,846,351,19
-1,0,0.05,-1.0,-0.0,2.08367919921875,124.13526955694348,2,126,-43,543,1037,846,351,19
-1,0,0.04,-1.0,-0.0,2.0926356315612793,125.08206442324789,2,127,-43,543,1037,846,351,19
-1,0,0.04,-1.0,-0.0,2.101642370223999,126.02962637880623,2,128,-43,543,1037,846,351,19
-1,0,0.04,-1.0,-0.0,2.1106185913085938,126.9779393872403,2,129,-43,543,1037,846,351,19
-1,0,0.04,-1.0,-0.0,2.1195948123931885,127.92698784388708,2,130,-43,543,1037,846,351,19
-1,0,0.04,-1.0,-0.0,2.128571033477783,128.87675656179326,2,131,-43,543,1037,846,351,19
-1,0,0.04,-1.0,-0.0,2.137547731399536,129.82723075823418,2,132,-43,543,1037,846,351,19
-1,0,0.04,-1.0,-0.0,2.1465232372283936,130.77839604173457,2,133,-43,543,1037,846,351,19
-1,0,0.04,-1.0,-0.0,2.1565046310424805,131.73023839957068,2,134,-43,543,1037,846,351,19
-1,0,0.04,-1.0,-0.0,2.164475679397583,132.6827441857335,2,135,-43,543,1037,846,351,19
-1,0,0.04,-1.0,-0.0,2.173452377319336,133.63590010933433,2,136,-43,543,1037,846,351,19
-1,0,0.04,-1.0,-0.0,2.1834263801574707,134.58969322343438,2,137,-43,543,1037,846,351,19
-1,0,0.04,-1.0,-0.0,2.192401170730591,135.5441109142811,2,138,-43,543,1037,846,351,19
-1,0,0.04,-1.0,-0.0,2.19988751411438,136.49914089093448,2,139,-43,543,1037,846,351,19
-1,0,0.04,-1.0,-0.0,2.208862781524658,137.4547711752676,2,140,-43,543,1037,846,351,19
-1,0,0.04,-1.0,-0.0,2.218837022781372,138.41099009232656,2,141,-43,543,1037,846,351,19
-1,0,0.04,-1.0,-0.0,2.2268424034118652,139.36778626103444,2,142,-43,543,1037,846,351,19
-1,0,0.04,-1.0,-0.0,2.2357919216156006,140.3251485852266,2,143,-43,543,1037,846,351,19
-1,0,0.04,-1.0,-0.0,2.2447683811187744,141.28306624500314,2,144,-43,543,1037,846,351,19
-1,0,0.04,-1.0,-0.0,2.2537474632263184,142.24152868838638,2,145,-43,543,1037,846,351,19
-1,0,0.04,-1.0,-0.0,2.263716697692871,143.2005256232711,2,146,-43,543,1037,846,351,19
-1,0,0.04,-1.0,-0.0,2.270698308944702,144.16004700965587,2,147,-43,543,1037,846,351,19
-1,0,0.04,-1.0,-0.0,2.279674768447876,145.12008305214476,2,148,-43,543,1037,846,351,19
-1,0,0.04,-1.0,-0.0,2.2896478176116943,146.08062419270823,2,149,-43,543,1037,846,351,19
-1,0,0.04,-1.0,-0.0,2.2960333824157715,147.0416611036937,2,150,-43,543,1037,846,351,19
-1,0,0.04,-1.0,-0.0,2.3050007820129395,148.00318468107582,2,151,-43,543,1037,846,351,19
-1,0,0.04,-1.0,-0.0,2.311983346939087,148.96518603793686,2,152,-43,543,1037,846,351,19
-1,0,0.04,-1.0,-0.0,2.320958375930786,149.927656498169,2,153,-43,543,1037,846,351,19
-1,0,0.04,-1.0,-0.0,2.3299343585968018,150.89058759038946,2,154,-43,543,1037,846,351,19
-1,0,0.04,-1.0,-0.0,2.339907646179199,151.85397104206038,2,155,-43,543,1037,846,351,19
-1,0,0.04,-1.0,-0.0,2.348884105682373,152.8177987738061,2,156,-43,543,1037,846,351,19
-1,0,0.04,-1.0,-0.0,2.3598642349243164,153.7820628939196,2,157,-43,543,1037,846,351,19
-1,0,0.04,-1.0,-0.0,2.3678338527679443,154.74675569305182,2,158,-43,543,1037,846,351,19
-1,0,0.04,-1.0,-0.0,2.3768107891082764,155.7118696390761,2,159,-43,543,1037,846,351,19
-1,0,0.04,-1.0,-0.0,2.385786533355713,156.67739737212196,2,160,-43,543,1037,846,351,19
-1,0,0.04,-1.0,-0.0,2.3957605361938477,157.6433316997713,2,161,-43,543,1037,846,351,19
-1,0,0.04,-1.0,-0.0,2.403738260269165,158.60966559241146,2,162,-43,543,1037,846,351,19
-1,0,0.04,-1.0,-0.0,2.4107208251953125,159.57639217873896,2,163,-43,543,1037,846,351,19
-1,0,0.04,-1.0,-0.0,2.4206933975219727,160.54350474140847,2,164,-43,543,1037,846,351,19
-1,0,0.04,-1.0,-0.0,2.427675485610962,161.51099671282202,2,165,-43,543,1037,846,351,19
-1,0,0.04,-1.0,-0.0,2.436678409576416,162.4788616710526,2,166,-43,543,1037,846,351,19
-1,0,0.04,-1.0,-0.0,2.445627212524414,163.44709333589824,2,167,-43,543,1037,846,351,19
-1,0,0.04,-1.0,-0.0,2.454603433609009,164.4156855650607,2,168,-43,543,1037,846,351,19
-1,0,0.04,-1.0,-0.0,2.4635791778564453,165.38463235044537,2,169,-43,543,1037,846,351,19
-1,0,0.04,-1.0,-0.0,2.47255539894104,166.35392781457733,2,170,-43,543,1037,846,351,19
-1,0,0.04,-1.0,-0.0,2.4825291633605957,167.32356620712955,2,171,-43,543,1037,846,351,19
-1,0,0.04,-1.0,-0.0,2.4895122051239014,168.2935419015594,2,172,-43,543,1037,846,351,19
-1,0,0.04,-1.0,-0.0,2.4984867572784424,169.2638493918495,2,173,-43,543,1037,846,351,19
-1,0,0.04,-1.0,-0.0,2.507463216781616,170.2344832893492,2,174,-43,543,1037,846,351,19
-1,0,0.04,-1.0,-0.0,2.5164384841918945,171.20543831971332,2,175,-43,543,1037,846,351,19
-1,0,0.05,-1.0,-0.0,2.5254151821136475,172.1767093199344,2,176,-43,543,1037,846,351,19
-1,0,0.05,-1.0,-0.0,2.53440523147583,173.14829123546562,2,177,-43,543,1037,846,351,19
-1,0,0.05,-1.0,-0.0,2.5433671474456787,174.12017911743098,2,178,-43,543,1037,846,351,19
-1,0,0.05,-1.0,-0.0,2.5523431301116943,175.09236811991963,2,179,-43,543,1037,846,351,19
-1,0,0.05,-1.0,-0.0,2.5613210201263428,176.06485349736184,2,180,-43,543,1037,846,351,19
-1,0,0.05,-1.0,-0.0,2.570295572280884,177.03763060198332,2,181,-43,543,1037,846,351,19
-1,0,0.05,-1.0,-0.0,2.5782761573791504,178.0106948813356,2,182,-43,543,1037,846,351,19
-1,0,0.05,-1.0,-0.0,2.585257053375244,178.98404187589966,2,183,-43,543,1037,846,351,19
-1,0,0.05,-1.0,-0.0,2.5942325592041016,179.95766721676048,2,184,-43,543,1037,846,351,19
-1,0,0.05,-1.0,-0.0,2.603208303451538,180.9315666233499,2,185,-43,543,1037,846,351,19
-1,0,0.05,-1.0,-0.0,2.61318302154541,181.90573590125572,2,186,-43,543,1037,846,351,19
-1,0,0.05,-1.0,-0.0,2.622185707092285,182.88017094009479,2,187,-43,543,1037,846,351,19
-1,0,0.05,-1.0,-0.0,2.632131576538086,183.85486771144772,2,188,-43,543,1037,846,351,19
-1,0,0.05,-1.0,-0.0,2.6401376724243164,184.82982226685345,2,189,-43,543,1037,846,351,19
-1,0,0.05,-1.0,-0.0,2.6480891704559326,185.80503073586164,2,190,-43,543,1037,846,351,19
-1,0,0.05,-1.0,-0.0,2.657066583633423,186.78048932414077,2,191,-43,543,1037,846,351,19
-1,0,0.05,-1.0,-0.0,2.665044069290161,187.75619431164043,2,192,-43,543,1037,846,351,19
-1,0,0.05,-1.0,-0.0,2.673022747039795,188.7321420508057,2,193,-43,543,1037,846,351,19
-1,0,0.05,-1.0,-0.0,2.6810030937194824,189.70832896484234,2,194,-43,543,1037,846,351,19
-1,0,0.05,-1.0,-0.0,2.688981294631958,190.68475154603067,2,195,-43,543,1037,846,351,19
-1,0,0.05,-1.0,-0.0,2.6979565620422363,191.66140635408692,2,196,-43,543,1037,846,351,19
-1,0,0.05,-1.0,-0.0,2.706932783126831,192.6382900145704,2,197,-43,543,1037,846,351,19
-1,0,0.05,-1.0,-0.0,2.715909004211426,193.6153992173349,2,198,-43,543,1037,846,351,19
-1,0,0.05,-1.0,-0.0,2.725882053375244,194.59273071502332,2,199,-43,543,1037,846,351,19
-1,0,0.05,-1.0,-0.0,2.734858512878418,195.57028132160352,2,200,-43,543,1037,846,351,19
-1,0,0.05,-1.0,-0.0,2.7438626289367676,196.54804791094466,2,201,-43,543,1037,846,351,19
-1,0,0.05,-1.0,-0.0,2.752812385559082,197.52602741543257,2,202,-43,543,1037,846,351,19
-1,0,0.05,-1.0,-0.0,2.7627854347229004,198.50421682462263,2,203,-43,543,1037,846,351,19
-1,0,0.05,-1.0,-0.0,2.769765853881836,199.48261318392957,2,204,-43,543,1037,846,351,19
-1,0,0.05,-1.0,-0.0,2.77974009513855,200.4612135933524,2,205,-43,543,1037,846,351,19
-1,0,0.05,-1.0,-0.0,2.7877187728881836,201.440015206234,2,206,-43,543,1037,846,351,19
0,0,0.05,-0.0,-0.0,2.7946994304656982,201.440015206234,2,206,-43,543,1037,846,351,19
0,0,0.07,-0.0,-0.0,2.803675651550293,201.440015206234,2,206,-43,543,1037,846,351,19
1,0,0.06,1.0,-0.0,2.8106632232666016,200.4612135933524,2,205,-43,543,1037,846,351,19
1,0,0.04,1.0,-0.0,2.8206334114074707,199.48261318392957,2,204,-43,543,1037,846,351,19
2,0,0.04,2.0,-0.0,2.82861065864563,197.52602741543257,2,202,-43,543,1037,846,351,19
3,0,0.03,3.0,-0.0,2.837585926055908,194.59273071502332,2,199,-43,543,1037,846,351,19
4,0,0.03,4.0,-0.0,2.8465614318847656,190.68475154603067,2,195,-43,543,1037,846,351,19
5,0,0.02,5.0,-0.0,2.854541063308716,185.80503073586164,2,190,-43,543,1037,846,351,19
6,0,0.02,6.0,-0.0,2.8635170459747314,179.95766721676048,2,184,-43,543,1037,846,351,19
6,0,0.02,6.0,-0.0,2.870525598526001,174.12017911743098,2,178,-43,543,1037,846,351,19
6,0,0.02,6.0,-0.0,2.8794760704040527,168.2935419015594,2,172,-43,543,1037,846,351,19
6,0,0.02,6.0,-0.0,2.888472557067871,162.4788616710526,2,166,-43,543,1037,846,351,19
6,0,0.03,6.0,-0.0,2.896432876586914,156.67739737212196,2,160,-43,543,1037,846,351,19
6,0,0.02,6.0,-0.0,2.904409170150757,150.89058759038946,2,154,-43,543,1037,846,351,19
6,0,0.02,6.0,-0.0,2.9133856296539307,145.12008305214476,2,148,-43,543,1037,846,351,19
6,0,0.02,6.0,-0.0,2.9203927516937256,139.36778626103444,2,142,-43,543,1037,846,351,19
6,0,0.02,6.0,-0.0,2.9293417930603027,133.63590010933433,2,136,-43,543,1037,846,351,19
6,0,0.01,6.0,-0.0,2.9383456707000732,127.92698784388708,2,130,-43,543,1037,846,351,19
6,0,0.01,6.0,-0.0,2.947296142578125,122.24404748406687,2,124,-43,543,1037,846,351,19
6,0,0.01,6.0,-0.0,2.9572675228118896,116.59060474414477,2,118,-43,543,1037,846,351,19
6,0,0.01,6.0,-0.0,2.9652464389801025,110.97082978791136,2,112,-43,543,1037,846,351,19
6,0,0.01,6.0,-0.0,2.9742541313171387,105.38968484964018,2,106,-43,543,1037,846,351,19
6,0,0.01,6.0,-0.0,2.9831995964050293,99.85311203635843,2,100,-43,543,1037,846,351,19
6,0,0.01,6.0,-0.0,2.9921748638153076,94.36827366266692,2,94,-43,543,1037,846,351,19
6,0,0.01,6.0,-0.0,3.002159595489502,88.94386147176351,2,88,-43,543,1037,846,351,19
6,0,0.0,6.0,-0.0,3.011125087738037,83.59049627256569,2,82,-43,543,1037,846,351,19
5,0,0.0,5.0,-0.0,3.01910400390625,79.19297024139736,2,77,-43,543,1037,846,351,19
5,0,0.0,5.0,-0.0,3.0270814895629883,74.86298349093002,2,72,-43,543,1037,846,351,19
4,0,0.01,4.0,-0.0,3.035066843032837,71.45495634204272,2,68,-43,543,1037,846,351,19
4,0,0.01,4.0,-0.0,3.0440375804901123,68.10382610480494,2,64,-43,543,1037,846,351,19
3,0,0.01,3.0,-0.0,3.051018714904785,65.63243262818116,2,61,-43,543,1037,846,351,19
3,0,0.01,3.0,-0.0,3.0609936714172363,63.20110802473879,2,58,-43,543,1037,846,351,19
3,0,0.01,3.0,-0.0,3.0689709186553955,60.81403870282824,2,55,-43,543,1037,846,351,19
3,0,0.01,3.0,-0.0,3.0789458751678467,58.47592163134935,2,52,-43,543,1037,846,351,19
3,0,0.01,3.0,-0.0,3.086923599243164,56.19202405202648,2,49,-43,543,1037,846,351,19
3,0,0.01,3.0,-0.0,3.0968968868255615,53.96824596572466,2,46,-43,543,1037,846,351,19
3,0,0.01,3.0,-0.0,3.107868194580078,51.81118318204309,2,43,-43,543,1037,846,351,19
3,0,0.0,3.0,-0.0,3.115847587585449,49.728187440104094,2,40,-43,543,1037,846,351,19
3,0,0.0,3.0,-0.0,3.1248223781585693,47.72741841473134,2,37,-43,543,1037,846,351,19
3,0,0.0,3.0,-0.0,3.1328020095825195,45.817880294662984,2,34,-43,543,1037,846,351,19
3,0,0.0,3.0,-0.0,3.140782117843628,44.009433122794285,2,31,-43,543,1037,846,351,19
3,0,0.0,3.0,-0.0,3.14875864982605,42.31276644267,2,28,-43,543,1037,846,351,19
3,0,0.0,3.0,-0.0,3.156738042831421,40.73932046178355,2,25,-43,543,1037,846,351,19
3,0,0.0,3.0,-0.0,3.1637191772460938,39.30113870293329,2,22,-43,543,1037,846,351,19
2,0,0.0,2.0,-0.0,3.1726951599121094,38.4236228055175,2,20,-43,543,1037,846,351,19
2,0,0.01,2.0,-0.0,3.180673837661743,37.61544808322666,2,18,-43,543,1037,846,351,19
1,0,0.01,1.0,-0.0,3.1886537075042725,37.238512086787566,2,17,-43,543,1037,846,351,19
1,0,0.01,1.0,-0.0,3.19663143157959,36.880278987817846,2,16,-43,543,1037,846,351,19
1,0,0.03,1.0,-0.0,3.204292058944702,36.5411901469428,2,15,-43,543,1037,846,351,19
1,0,0.04,1.0,-0.0,3.2122669219970703,36.221676218380054,2,14,-43,543,1037,846,351,19
1,0,0.05,1.0,-0.0,3.2202463150024414,35.9221548904324,2,13,-43,543,1037,846,351,19
1,0,0.06,1.0,-0.0,3.2292213439941406,35.64302857109943,2,12,-43,543,1037,846,351,19
1,0,0.07,1.0,-0.0,3.23720121383667,35.384682042344295,2,11,-43,543,1037,846,351,19
1,0,0.07,1.0,-0.0,3.2451789379119873,35.14748010928823,2,10,-43,543,1037,846,351,19
1,0,0.08,1.0,-0.0,3.2521612644195557,34.93176527297759,2,9,-43,543,1037,846,351,19
1,0,0.09,1.0,-0.0,3.262134075164795,34.73785545725808,2,8,-43,543,1037,846,351,19
1,0,0.11,1.0,-0.0,3.270113229751587,34.56604182158393,2,7,-43,543,1037,846,351,19
1,0,0.11,1.0,-0.0,3.278092622756958,34.41658669218482,2,6,-43,543,1037,846,351,19
1,0,0.12,1.0,-0.0,3.287076473236084,34.289721643826724,2,5,-43,543,1037,846,351,19
1,0,0.14,1.0,-0.0,3.2970659732818604,34.18564576337837,2,4,-43,543,1037,846,351,19
1,0,0.16,1.0,-0.0,3.306018590927124,34.104524124504614,2,3,-43,543,1037,846,351,19
1,0,0.17,1.0,-0.0,3.3139963150024414,34.04648650006177,2,2,-43,543,1037,846,351,19
1,0,0.18,1.0,-0.0,3.322000026702881,34.01162633521314,2,1,-43,543,1037,846,351,19
1,0,0.19,1.0,-0.0,3.3309576511383057,34.0,2,0,-43,543,1037,846,351,19
1,0,0.21,1.0,-0.0,3.3379390239715576,34.01162633521314,2,-1,-43,543,1037,846,351,19
1,0,0.2,1.0,-0.0,3.3459126949310303,34.04648650006177,2,-2,-43,543,1037,846,351,19
1,0,0.21,1.0,-0.0,3.3568832874298096,34.104524124504614,2,-3,-43,543,1037,846,351,19
1,0,0.22,1.0,-0.0,3.364861488342285,34.18564576337837,2,-4,-43,543,1037,846,351,19
1,0,0.23,1.0,-0.0,3.37283992767334,34.289721643826724,2,-5,-43,543,1037,846,351,19
1,0,0.23,1.0,-0.0,3.380819082260132,34.41658669218482,2,-6,-43,543,1037,846,351,19
1,0,0.24,1.0,-0.0,3.388798713684082,34.56604182158393,2,-7,-43,543,1037,846,351,19
1,0,0.25,1.0,-0.0,3.3967761993408203,34.73785545725808,2,-8,-43,543,1037,846,351,19
1,0,0.26,1.0,-0.0,3.40377140045166,34.93176527297759,2,-9,-43,543,1037,846,351,19
1,0,0.27,1.0,-0.0,3.4127352237701416,35.14748010928823,2,-10,-43,543,1037,846,351,19
1,0,0.28,1.0,-0.0,3.4207279682159424,35.384682042344295,2,-11,-43,543,1037,846,351,19
1,0,0.29,1.0,-0.0,3.4286911487579346,35.64302857109943,2,-12,-43,543,1037,846,351,19
1,0,0.3,1.0,-0.0,3.436671018600464,35.9221548904324,2,-13,-43,543,1037,846,351,19
1,0,0.31,1.0,-0.0,3.444650650024414,36.221676218380054,2,-14,-43,543,1037,846,351,19
1,0,0.31,1.0,-0.0,3.4526286125183105,36.5411901469428,2,-15,-43,543,1037,846,351,19
1,0,0.32,1.0,-0.0,3.460625648498535,36.880278987817846,2,-16,-43,543,1037,846,351,19
1,0,0.33,1.0,-0.0,3.4685864448547363,37.238512086787566,2,-17,-43,543,1037,846,351,19
1,0,0.34,1.0,-0.0,3.4775617122650146,37.61544808322666,2,-18,-43,543,1037,846,351,19
1,0,0.34,1.0,-0.0,3.4845452308654785,38.01063709417264,2,-19,-43,543,1037,846,351,19
1,0,0.35,1.0,-0.0,3.493528127670288,38.4236228055175,2,-20,-43,543,1037,846,351,19
1,0,0.35,1.0,-0.0,3.5014984607696533,38.853944456021594,2,-21,-43,543,1037,846,351,19
1,0,0.36,1.0,-0.0,3.5104756355285645,39.30113870293329,2,-22,-43,543,1037,846,351,19
1,0,0.37,1.0,-0.0,3.5174570083618164,39.76474136094644,2,-23,-43,543,1037,846,351,19
1,0,0.37,1.0,-0.0,3.527430295944214,40.24428900898052,2,-24,-43,543,1037,846,351,19
1,0,0.38,1.0,-0.0,3.5354156494140625,40.73932046178355,2,-25,-43,543,1037,846,351,19
1,0,0.38,1.0,-0.0,3.543386697769165,41.24937810560445,2,-26,-43,543,1037,846,351,19
1,0,0.38,1.0,-0.0,3.550367832183838,41.774009099144415,2,-27,-43,543,1037,846,351,19
1,0,0.38,1.0,-0.0,3.5583484172821045,42.31276644267,2,-28,-43,543,1037,846,351,19
1,0,0.38,1.0,-0.0,3.567323684692383,42.86520991955976,2,-29,-43,543,1037,846,351,19
1,0,0.38,1.0,-0.0,3.576298952102661,43.43090691567332,2,-30,-43,543,1037,846,351,19
1,0,0.38,1.0,-0.0,3.5852866172790527,44.009433122794285,2,-31,-43,543,1037,846,351,19
0,0,0.38,-0.0,-0.0,3.594252347946167,44.009433122794285,2,-31,-43,543,1037,846,351,19
0,0,0.52,-0.0,-0.0,3.6032285690307617,44.009433122794285,2,-31,-43,543,1037,846,351,19
0,0,0.42,-0.0,-0.0,3.613738536834717,44.009433122794285,2,-31,-43,543,1037,846,351,19
0,0,0.37,-0.0,-0.0,3.6207473278045654,44.009433122794285,2,-31,-43,543,1037,846,351,19
0,0,0.35,-0.0,-0.0,3.6296963691711426,44.009433122794285,2,-31,-43,543,1037,846,351,19
0,0,0.33,-0.0,-0.0,3.6406943798065186,44.009433122794285,2,-31,-43,543,1037,846,351,19
0,0,0.31,-0.0,-0.0,3.6476778984069824,44.009433122794285,2,-31,-43,543,1037,846,351,19
0,0,0.28,-0.0,-0.0,3.6576220989227295,44.009433122794285,2,-31,-43,543,1037,846,351,19
0,0,0.26,-0.0,-0.0,3.666599750518799,44.009433122794285,2,-31,-43,543,1037,846,351,19
0,0,0.25,-0.0,-0.0,3.674576997756958,44.009433122794285,2,-31,-43,543,1037,846,351,19
0,0,0.24,-0.0,-0.0,3.6815590858459473,44.009433122794285,2,-31,-43,543,1037,846,351,19
0,0,0.23,-0.0,-0.0,3.6915318965911865,44.009433122794285,2,-31,-43,543,1037,846,351,19
0,0,0.23,-0.0,-0.0,3.698514938354492,44.009433122794285,2,-31,-43,543,1037,846,351,19
0,0,0.23,-0.0,-0.0,3.707489490509033,44.009433122794285,2,-31,-43,543,1037,846,351,19
0,0,0.23,-0.0,-0.0,3.715496778488159,44.009433122794285,2,-31,-43,543,1037,846,351,19
0,0,0.23,-0.0,-0.0,3.723461866378784,44.009433122794285,2,-31,-43,543,1037,846,351,19
0,0,0.23,-0.0,-0.0,3.7314274311065674,44.009433122794285,2,-31,-43,543,1037,846,351,19
0,0,0.24,-0.0,-0.0,3.7384095191955566,44.009433122794285,2,-31,-43,543,1037,846,351,19
0,0,0.23,-0.0,-0.0,3.7473855018615723,44.009433122794285,2,-31,-43,543,1037,846,351,19
0,0,0.24,-0.0,-0.0,3.7543649673461914,44.009433122794285,2,-31,-43,543,1037,846,351,19
0,0,0.24,-0.0,-0.0,3.7633445262908936,44.009433122794285,2,-31,-43,543,1037,846,351,19
0,0,0.24,-0.0,-0.0,3.7723171710968018,44.009433122794285,2,-31,-43,543,1037,846,351,19
0,0,0.24,-0.0,-0.0,3.7812931537628174,44.009433122794285,2,-31,-43,543,1037,846,351,19
0,0,0.24,-0.0,-0.0,3.7912678718566895,44.009433122794285,2,-31,-43,543,1037,846,351,19
0,0,0.24,-0.0,-0.0,3.7992453575134277,44.009433122794285,2,-31,-43,543,1037,846,351,19
0,0,0.24,-0.0,-0.0,3.8072240352630615,44.009433122794285,2,-31,-43,543,1037,846,351,19
0,0,0.24,-0.0,-0.0,3.8142073154449463,44.009433122794285,2,-31,-43,543,1037,846,351,19
0,0,0.24,-0.0,-0.0,3.822211980819702,44.009433122794285,2,-31,-43,543,1037,846,351,19
0,0,0.24,-0.0,-0.0,3.8311607837677,44.009433122794285,2,-31,-43,543,1037,846,351,19
0,0,0.24,-0.0,-0.0,3.8411357402801514,44.009433122794285,2,-31,-43,543,1037,846,351,19
0,0,0.24,-0.0,-0.0,3.8491134643554688,44.009433122794285,2,-31,-43,543,1037,846,351,19
0,0,0.24,-0.0,-0.0,3.858088970184326,44.009433122794285,2,-31,-43,543,1037,846,351,19
0,0,0.24,-0.0,-0.0,3.8660688400268555,44.009433122794285,2,-31,-43,543,1037,846,351,19
0,0,0.24,-0.0,-0.0,3.874047040939331,44.009433122794285,2,-31,-43,543,1037,846,351,19
0,0,0.24,-0.0,-0.0,3.8820254802703857,44.009433122794285,2,-31,-43,543,1037,846,351,19
0,0,0.24,-0.0,-0.0,3.8890066146850586,44.009433122794285,2,-31,-43,543,1037,846,351,19
0,0,0.24,-0.0,-0.0,3.8989806175231934,44.009433122794285,2,-31,-43,543,1037,846,351,19
0,0,0.24,-0.0,-0.0,3.9059624671936035,44.009433122794285,2,-31,-43,543,1037,846,351,19
0,0,0.24,-0.0,-0.0,3.9149389266967773,44.009433122794285,2,-31,-43,543,1037,846,351,19
0,0,0.24,-0.0,-0.0,3.9249155521392822,44.009433122794285,2,-31,-43,543,1037,846,351,19
0,0,0.24,-0.0,-0.0,3.9358839988708496,44.009433122794285,2,-31,-43,543,1037,846,351,19
0,0,0.24,-0.0,-0.0,3.942863941192627,44.009433122794285,2,-31,-43,543,1037,846,351,19
0,0,0.24,-0.0,-0.0,3.952838659286499,44.009433122794285,2,-31,-43,543,1037,846,351,19
0,0,0.24,-0.0,-0.0,3.9598207473754883,44.009433122794285,2,-31,-43,543,1037,846,351,19
0,0,0.24,-0.0,-0.0,3.968794822692871,44.009433122794285,2,-31,-43,543,1037,846,351,19
0,0,0.24,-0.0,-0.0,3.9777722358703613,44.009433122794285,2,-31,-43,543,1037,846,351,19
0,0,0.24,-0.0,-0.0,3.986748218536377,44.009433122794285,2,-31,-43,543,1037,846,351,19
0,0,0.24,-0.0,-0.0,3.996721029281616,44.009433122794285,2,-31,-43,543,1037,846,351,19
0,0,0.24,-0.0,-0.0,4.003729343414307,44.009433122794285,2,-31,-43,543,1037,846,351,19
0,0,0.24,-0.0,-0.0,4.013676166534424,44.009433122794285,2,-31,-43,543,1037,846,351,19
0,0,0.24,-0.0,-0.0,4.020659446716309,44.009433122794285,2,-31,-43,543,1037,846,351,19
0,0,0.24,-0.0,-0.0,4.0306315422058105,44.009433122794285,2,-31,-43,543,1037,846,351,19
0,0,0.24,-0.0,-0.0,4.037613153457642,44.009433122794285,2,-31,-43,543,1037,846,351,19
0,0,0.24,-0.0,-0.0,4.047586441040039,44.009433122794285,2,-31,-43,543,1037,846,351,19
0,0,0.24,-0.0,-0.0,4.055582761764526,44.009433122794285,2,-31,-43,543,1037,846,351,19
0,0,0.24,-0.0,-0.0,4.06454062461853,44.009433122794285,2,-31,-43,543,1037,846,351,19
0,0,0.24,-0.0,-0.0,4.072525501251221,44.009433122794285,2,-31,-43,543,1037,846,351,19
0,0,0.24,-0.0,-0.0,4.080499649047852,44.009433122794285,2,-31,-43,543,1037,846,351,19
0,0,0.24,-0.0,-0.0,4.0894763469696045,44.009433122794285,2,-31,-43,543,1037,846,351,19
0,0,0.24,-0.0,-0.0,4.0974531173706055,44.009433122794285,2,-31,-43,543,1037,846,351,19
0,0,0.24,-0.0,-0.0,4.105433225631714,44.009433122794285,2,-31,-43,543,1037,846,351,19
0,0,0.24,-0.0,-0.0,4.112414360046387,44.009433122794285,2,-31,-43,543,1037,846,351,19
0,0,0.24,-0.0,-0.0,4.122387409210205,44.009433122794285,2,-31,-43,543,1037,846,351,19
0,0,0.24,-0.0,-0.0,4.130365610122681,44.009433122794285,2,-31,-43,543,1037,846,351,19
0,0,0.24,-0.0,-0.0,4.1383442878723145,44.009433122794285,2,-31,-43,543,1037,846,351,19
0,0,0.24,-0.0,-0.0,4.1453258991241455,44.009433122794285,2,-31,-43,543,1037,846,351,19
0,0,0.24,-0.0,-0.0,4.153334856033325,44.009433122794285,2,-31,-43,543,1037,846,351,19
0,0,0.24,-0.0,-0.0,4.162281036376953,44.009433122794285,2,-31,-43,543,1037,846,351,19
0,0,0.24,-0.0,-0.0,4.171258449554443,44.009433122794285,2,-31,-43,543,1037,846,351,19
0,0,0.24,-0.0,-0.0,4.180233478546143,44.009433122794285,2,-31,-43,543,1037,846,351,19
0,0,0.24,-0.0,-0.0,4.189209222793579,44.009433122794285,2,-31,-43,543,1037,846,351,19
0,0,0.24,-0.0,-0.0,4.19818639755249,44.009433122794285,2,-31,-43,543,1037,846,351,19
0,0,0.24,-0.0,-0.0,4.20815896987915,44.009433122794285,2,-31,-43,543,1037,846,351,19
0,0,0.24,-0.0,-0.0,4.21613883972168,44.009433122794285,2,-31,-43,543,1037,846,351,19
0,0,0.24,-0.0,-0.0,4.225114583969116,44.009433122794285,2,-31,-43,543,1037,846,351,19
0,0,0.24,-0.0,-0.0,4.234090328216553,44.009433122794285,2,-31,-43,543,1037,846,351,19
0,0,0.24,-0.0,-0.0,4.24306583404541,44.009433122794285,2,-31,-43,543,1037,846,351,19
0,0,0.24,-0.0,-0.0,4.252042770385742,44.009433122794285,2,-31,-43,543,1037,846,351,19
0,0,0.24,-0.0,-0.0,4.2620158195495605,44.009433122794285,2,-31,-43,543,1037,846,351,19
0,0,0.24,-0.0,-0.0,4.269997835159302,44.009433122794285,2,-31,-43,543,1037,846,351,19
0,0,0.24,-0.0,-0.0,4.278001308441162,44.009433122794285,2,-31,-43,543,1037,846,351,19
0,0,0.24,-0.0,-0.0,4.286949396133423,44.009433122794285,2,-31,-43,543,1037,846,351,19
0,0,0.24,-0.0,-0.0,4.296924352645874,44.009433122794285,2,-31,-43,543,1037,846,351,19
0,0,0.24,-0.0,-0.0,4.307895660400391,44.009433122794285,2,-31,-43,543,1037,846,351,19
0,0,0.24,-0.0,-0.0,4.315873146057129,44.009433122794285,2,-31,-43,543,1037,846,351,19
0,0,0.24,-0.0,-0.0,4.322855234146118,44.009433122794285,2,-31,-43,543,1037,846,351,19
0,0,0.24,-0.0,-0.0,4.332827806472778,44.009433122794285,2,-31,-43,543,1037,846,351,19
0,0,0.24,-0.0,-0.0,4.340806722640991,44.009433122794285,2,-31,-43,543,1037,846,351,19
0,0,0.24,-0.0,-0.0,4.348785638809204,44.009433122794285,2,-31,-43,543,1037,846,351,19
0,0,0.24,-0.0,-0.0,4.357791185379028,44.009433122794285,2,-31,-43,543,1037,846,351,19
0,0,0.24,-0.0,-0.0,4.365740060806274,44.009433122794285,2,-31,-43,543,1037,846,351,19
0,0,0.24,-0.0,-0.0,4.372723579406738,44.009433122794285,2,-31,-43,543,1037,846,351,19
0,0,0.24,-0.0,-0.0,4.381711006164551,44.009433122794285,2,-31,-43,543,1037,846,351,19
0,0,0.24,-0.0,-0.0,4.388679265975952,44.009433122794285,2,-31,-43,543,1037,846,351,19
0,0,0.24,-0.0,-0.0,4.397655248641968,44.009433122794285,2,-31,-43,543,1037,846,351,19
0,0,0.24,-0.0,-0.0,4.406632423400879,44.009433122794285,2,-31,-43,543,1037,846,351,19
0,0,0.24,-0.0,-0.0,4.415607690811157,44.009433122794285,2,-31,-43,543,1037,846,351,19
0,0,0.24,-0.0,-0.0,4.425582408905029,44.009433122794285,2,-31,-43,543,1037,846,351,19
0,0,0.24,-0.0,-0.0,4.4345574378967285,44.009433122794285,2,-31,-43,543,1037,846,351,19
0,0,0.24,-0.0,-0.0,4.443533658981323,44.009433122794285,2,-31,-43,543,1037,846,351,19
0,0,0.24,-0.0,-0.0,4.452510356903076,44.009433122794285,2,-31,-43,543,1037,846,351,19
0,0,0.24,-0.0,-0.0,4.461486577987671,44.009433122794285,2,-31,-43,543,1037,846,351,19
0,0,0.24,-0.0,-0.0,4.471461057662964,44.009433122794285,2,-31,-43,543,1037,846,351,19
0,0,0.24,-0.0,-0.0,4.479438066482544,44.009433122794285,2,-31,-43,543,1037,846,351,19
0,0,0.24,-0.0,-0.0,4.488414525985718,44.009433122794285,2,-31,-43,543,1037,846,351,19
0,0,0.24,-0.0,-0.0,4.497390985488892,44.009433122794285,2,-31,-43,543,1037,846,351,19
0,0,0.24,-0.0,-0.0,4.505370140075684,44.009433122794285,2,-31,-43,543,1037,846,351,19
0,0,0.24,-0.0,-0.0,4.51334810256958,44.009433122794285,2,-31,-43,543,1037,846,351,19
0,0,0.24,-0.0,-0.0,4.521326541900635,44.009433122794285,2,-31,-43,543,1037,846,351,19
0,0,0.24,-0.0,-0.0,4.5283098220825195,44.009433122794285,2,-31,-43,543,1037,846,351,19
0,0,0.24,-0.0,-0.0,4.537285327911377,44.009433122794285,2,-31,-43,543,1037,846,351,19
0,0,0.24,-0.0,-0.0,4.546261548995972,44.009433122794285,2,-31,-43,543,1037,846,351,19
0,0,0.24,-0.0,-0.0,4.553243637084961,44.009433122794285,2,-31,-43,543,1037,846,351,19
0,0,0.24,-0.0,-0.0,4.562218904495239,44.009433122794285,2,-31,-43,543,1037,846,351,19
0,0,0.24,-0.0,-0.0,4.569200754165649,44.009433122794285,2,-31,-43,543,1037,846,351,19
0,0,0.24,-0.0,-0.0,4.5781755447387695,44.009433122794285,2,-31,-43,543,1037,846,351,19
0,0,0.24,-0.0,-0.0,4.587153196334839,44.009433122794285,2,-31,-43,543,1037,846,351,19
0,0,0.24,-0.0,-0.0,4.596128225326538,44.009433122794285,2,-31,-43,543,1037,846,351,19
0,0,0.24,-0.0,-0.0,4.605105400085449,44.009433122794285,2,-31,-43,543,1037,846,351,19
0,0,0.24,-0.0,-0.0,4.614088535308838,44.009433122794285,2,-31,-43,543,1037,846,351,19
0,0,0.24,-0.0,-0.0,4.623056888580322,44.009433122794285,2,-31,-43,543,1037,846,351,19
0,0,0.24,-0.0,-0.0,4.632033824920654,44.009433122794285,2,-31,-43,543,1037,846,351,19
0,0,0.24,-0.0,-0.0,4.6420063972473145,44.009433122794285,2,-31,-43,543,1037,846,351,19
0,0,0.24,-0.0,-0.0,4.649991989135742,44.009433122794285,2,-31,-43,543,1037,846,351,19
0,0,0.24,-0.0,-0.0,4.65896201133728,44.009433122794285,2,-31,-43,543,1037,846,351,19
0,0,0.24,-0.0,-0.0,4.668935060501099,44.009433122794285,2,-31,-43,543,1037,846,351,19
0,0,0.24,-0.0,-0.0,4.678908824920654,44.009433122794285,2,-31,-43,543,1037,846,351,19
0,0,0.24,-0.0,-0.0,4.685890197753906,44.009433122794285,2,-31,-43,543,1037,846,351,19
0,0,0.24,-0.0,-0.0,4.695863962173462,44.009433122794285,2,-31,-43,543,1037,846,351,19
0,0,0.24,-0.0,-0.0,4.703841924667358,44.009433122794285,2,-31,-43,543,1037,846,351,19
0,0,0.24,-0.0,-0.0,4.7128190994262695,44.009433122794285,2,-31,-43,543,1037,846,351,19
0,0,0.24,-0.0,-0.0,4.721794128417969,44.009433122794285,2,-31,-43,543,1037,846,351,19
0,0,0.24,-0.0,-0.0,4.731767892837524,44.009433122794285,2,-31,-43,543,1037,846,351,19
0,0,0.24,-0.0,-0.0,4.738749265670776,44.009433122794285,2,-31,-43,543,1037,846,351,19
0,0,0.24,-0.0,-0.0,4.747725009918213,44.009433122794285,2,-31,-43,543,1037,846,351,19
0,0,0.24,-0.0,-0.0,4.756702661514282,44.009433122794285,2,-31,-43,543,1037,846,351,19
0,0,0.24,-0.0,-0.0,4.763684511184692,44.009433122794285,2,-31,-43,543,1037,846,351,19
0,0,0.24,-0.0,-0.0,4.772660493850708,44.009433122794285,2,-31,-43,543,1037,846,351,19
0,0,0.24,-0.0,-0.0,4.781635046005249,44.009433122794285,2,-31,-43,543,1037,846,351,19
0,0,0.24,-0.0,-0.0,4.791611671447754,44.009433122794285,2,-31,-43,543,1037,846,351,19
