dx,dy,button,rx,ry,time,distance,targetID,directionX,directionY,targetX,targetY,initMouseX,initMouseY,targetSize
0,0,0.0,-0.0,-0.0,0.223374605178833,815.0300607953059,1,755,307,1712,907,957,600,20
1,0,0.0,1.0,-0.0,0.23035621643066406,814.1038017353807,1,754,307,1712,907,957,600,20
2,1,0.0,2.0,1.0,0.23933696746826172,811.8743745186197,1,752,306,1712,907,957,600,20
4,2,0.0,4.0,2.0,0.2483079433441162,807.4156302673364,1,748,304,1712,907,957,600,20
6,3,0.0,6.0,3.0,0.25728392601013184,800.7277939474812,1,742,301,1712,907,957,600,20
8,4,0.0,8.0,4.0,0.26526355743408203,791.8112148738486,1,734,297,1712,907,957,600,20
10,5,0.0,10.0,5.0,0.275256872177124,780.6663820096264,1,724,292,1712,907,957,600,20
12,6,0.0,12.0,6.0,0.2842121124267578,767.2939462813453,1,712,286,1712,907,957,600,20
14,7,0.0,14.0,7.0,0.29318809509277344,751.6947518773827,1,698,279,1712,907,957,600,20
16,8,0.0,16.0,8.0,0.30217885971069336,733.8698794745565,1,682,271,1712,907,957,600,20
18,9,0.0,18.0,9.0,0.31014323234558105,713.8207057798197,1,664,262,1712,907,957,600,20
20,10,0.0,20.0,10.0,0.32012391090393066,691.5489859727943,1,644,252,1712,907,957,600,20
21,10,0.0,21.0,10.0,0.32909250259399414,668.3509557111444,1,623,242,1712,907,957,600,20
22,10,0.0,22.0,10.0,0.3380701541900635,644.2243398071823,1,601,232,1712,907,957,600,20
22,10,0.0,22.0,10.0,0.3470444679260254,620.1007982578317,1,579,222,1712,907,957,600,20
22,10,0.0,22.0,10.0,0.3560466766357422,595.980704385637,1,557,212,1712,907,957,600,20
22,10,0.0,22.0,10.0,0.36499810218811035,571.8644944390236,1,535,202,1712,907,957,600,20
22,10,0.0,22.0,10.0,0.37397289276123047,547.7526814174441,1,513,192,1712,907,957,600,20
21,10,0.0,21.0,10.0,0.3829505443572998,524.5836444267015,1,492,182,1712,907,957,600,20
20,10,0.0,20.0,10.0,0.3919253349304199,502.3624189765791,1,472,172,1712,907,957,600,20
19,10,0.0,19.0,10.0,0.40090131759643555,481.09562459037187,1,453,162,1712,907,957,600,20
18,10,0.0,18.0,10.0,0.4098775386810303,460.79170999487394,1,435,152,1712,907,957,600,20
17,10,0.0,17.0,10.0,0.4188535213470459,441.4612100739996,1,418,142,1712,907,957,600,20
16,10,0.0,16.0,10.0,0.4268341064453125,423.1170050943356,1,402,132,1712,907,957,600,20
15,10,0.0,15.0,10.0,0.4368102550506592,405.7745679561498,1,387,122,1712,907,957,600,20
14,10,0.0,14.0,10.0,0.4447968006134033,389.45217934940354,1,373,112,1712,907,957,600,20
13,10,0.0,13.0,10.0,0.45376110076904297,374.1710838640528,1,360,102,1712,907,957,600,20
12,10,0.0,12.0,10.0,0.4627373218536377,359.95555281173256,1,348,92,1712,907,957,600,20
12,9,0.0,12.0,9.0,0.4717135429382324,346.09969661934116,1,336,83,1712,907,957,600,20
12,9,0.0,12.0,9.0,0.48068928718566895,332.3431961090824,1,324,74,1712,907,957,600,20
12,8,0.0,12.0,8.0,0.48966526985168457,318.90437438203946,1,312,66,1712,907,957,600,20
12,8,0.0,12.0,8.0,0.4986424446105957,305.5552323230614,1,300,58,1712,907,957,600,20
12,7,0.0,12.0,7.0,0.507617712020874,292.48076859855246,1,288,51,1712,907,957,600,20
12,7,0.0,12.0,7.0,0.516594648361206,279.48524111301475,1,276,44,1712,907,957,600,20
12,6,0.0,12.0,6.0,0.5265953540802002,266.7208278331484,1,264,38,1712,907,957,600,20
12,6,0.0,12.0,6.0,0.5355443954467773,254.02362094891885,1,252,32,1712,907,957,600,20
12,5,0.0,12.0,5.0,0.5425586700439453,241.51397475094478,1,240,27,1712,907,957,600,20
12,5,0.0,12.0,5.0,0.5515217781066895,229.0589443789524,1,228,22,1712,907,957,600,20
12,4,0.0,12.0,4.0,0.5614743232727051,216.74870241826133,1,216,18,1712,907,957,600,20
12,4,0.0,12.0,4.0,0.5694539546966553,204.47982785595258,1,204,14,1712,907,957,600,20
12,3,0.0,12.0,3.0,0.5774405002593994,192.31484602078956,1,192,11,1712,907,957,600,20
11,3,0.0,11.0,3.0,0.5864081382751465,181.1767093199344,1,181,8,1712,907,957,600,20
11,2,0.0,11.0,2.0,0.596381425857544,170.10584939971935,1,170,6,1712,907,957,600,20
10,2,0.0,10.0,2.0,0.6063632965087891,160.04999218994044,1,160,4,1712,907,957,600,20
9,2,0.0,9.0,2.0,0.6163287162780762,151.0132444522665,1,151,2,1712,907,957,600,20
8,2,0.0,8.0,2.0,0.6263027191162109,143.0,1,143,0,1712,907,957,600,20
7,2,0.0,7.0,2.0,0.6362757682800293,136.01470508735443,1,136,-2,1712,907,957,600,20
6,2,0.0,6.0,2.0,0.6452517509460449,130.06152390311286,1,130,-4,1712,907,957,600,20
6,2,0.0,6.0,2.0,0.6542401313781738,124.14507642270796,1,124,-6,1712,907,957,600,20
6,2,0.0,6.0,2.0,0.663210391998291,118.27087553578015,1,118,-8,1712,907,957,600,20
6,2,0.0,6.0,2.0,0.6730399131774902,112.44554237496477,1,112,-10,1712,907,957,600,20
6,2,0.0,6.0,2.0,0.6800053119659424,106.6770828247567,1,106,-12,1712,907,957,600,20
6,2,0.0,6.0,2.0,0.6899487972259521,100.9752444909147,1,100,-14,1712,907,957,600,20
6,2,0.0,6.0,2.0,0.6979260444641113,95.35197952848173,1,94,-16,1712,907,957,600,20
6,2,0.0,6.0,2.0,0.706902265548706,89.82204629154248,1,88,-18,1712,907,957,600,20
6,2,0.0,6.0,2.0,0.7168939113616943,84.40379138403677,1,82,-20,1712,907,957,600,20
6,2,0.0,6.0,2.0,0.7248551845550537,79.12016177940993,1,76,-22,1712,907,957,600,20
6,2,0.0,6.0,2.0,0.7338306903839111,74.0,1,70,-24,1712,907,957,600,20
6,1,0.0,6.0,1.0,0.7428088188171387,68.70953354520753,1,64,-25,1712,907,957,600,20
6,1,0.0,6.0,1.0,0.7517926692962646,63.56099432828282,1,58,-26,1712,907,957,600,20
6,1,0.0,6.0,1.0,0.7617599964141846,58.59180830116101,1,52,-27,1712,907,957,600,20
6,1,0.0,6.0,1.0,0.7697350978851318,53.85164807134504,1,46,-28,1712,907,957,600,20
6,1,0.0,6.0,1.0,0.7777142524719238,49.4064773081425,1,40,-29,1712,907,957,600,20
6,1,0.0,6.0,1.0,0.7846953868865967,45.34313619501854,1,34,-30,1712,907,957,600,20
6,1,0.0,6.0,1.0,0.7936723232269287,41.773197148410844,1,28,-31,1712,907,957,600,20
5,1,0.0,5.0,1.0,0.8026480674743652,39.408120990476064,1,23,-32,1712,907,957,600,20
4,1,0.0,4.0,1.0,0.810626745223999,38.07886552931954,1,19,-33,1712,907,957,600,20
3,1,0.0,3.0,1.0,0.8205997943878174,37.57658845611187,1,16,-34,1712,907,957,600,20
2,1,0.0,2.0,1.0,0.8295767307281494,37.69615364994153,1,14,-35,1712,907,957,600,20
2,1,0.0,2.0,1.0,0.8405478000640869,37.94733192202055,1,12,-36,1712,907,957,600,20
2,1,0.0,2.0,1.0,0.8475487232208252,38.3275357934736,1,10,-37,1712,907,957,600,20
2,0,0.0,2.0,-0.0,0.8555078506469727,37.8549864614954,1,8,-37,1712,907,957,600,20
2,0,0.0,2.0,-0.0,0.864483118057251,37.48332962798263,1,6,-37,1712,907,957,600,20
2,0,0.0,2.0,-0.0,0.8734593391418457,37.21558813185679,1,4,-37,1712,907,957,600,20
2,-1,0.0,2.0,-1.0,0.8824739456176758,36.05551275463989,1,2,-36,1712,907,957,600,20
2,-1,0.0,2.0,-1.0,0.8914117813110352,35.0,1,0,-35,1712,907,957,600,20
2,-1,0.0,2.0,-1.0,0.9023830890655518,34.058772731852805,1,-2,-34,1712,907,957,600,20
2,-1,0.0,2.0,-1.0,0.912355899810791,33.24154027718932,1,-4,-33,1712,907,957,600,20
2,-1,0.0,2.0,-1.0,0.9193382263183594,32.55764119219941,1,-6,-32,1712,907,957,600,20
2,-1,0.0,2.0,-1.0,0.9283132553100586,32.01562118716424,1,-8,-31,1712,907,957,600,20
2,-1,0.0,2.0,-1.0,0.9372961521148682,31.622776601683793,1,-10,-30,1712,907,957,600,20
2,-1,0.0,2.0,-1.0,0.9472634792327881,31.38470965295043,1,-12,-29,1712,907,957,600,20
2,-1,0.0,2.0,-1.0,0.9572515487670898,31.304951684997057,1,-14,-28,1712,907,957,600,20
2,-1,0.0,2.0,-1.0,0.9642181396484375,31.38470965295043,1,-16,-27,1712,907,957,600,20
2,-1,0.0,2.0,-1.0,0.9741921424865723,31.622776601683793,1,-18,-26,1712,907,957,600,20
2,-1,0.0,2.0,-1.0,0.9821839332580566,32.01562118716424,1,-20,-25,1712,907,957,600,20
2,-1,0.0,2.0,-1.0,0.9911463260650635,32.55764119219941,1,-22,-24,1712,907,957,600,20
1,-1,0.0,1.0,-1.0,1.0001220703125,32.526911934581186,1,-23,-23,1712,907,957,600,20
1,-1,0.01,1.0,-1.0,1.00911283493042,32.55764119219941,1,-24,-22,1712,907,957,600,20
0,-1,0.01,-0.0,-1.0,1.0180752277374268,31.89043743820395,1,-24,-21,1712,907,957,600,20
0,-1,0.02,-0.0,-1.0,1.0270507335662842,31.240998703626616,1,-24,-20,1712,907,957,600,20
0,-1,0.03,-0.0,-1.0,1.036029577255249,30.610455730027933,1,-24,-19,1712,907,957,600,20
0,-1,0.03,-0.0,-1.0,1.045003890991211,30.0,1,-24,-18,1712,907,957,600,20
0,-1,0.03,-0.0,-1.0,1.0539836883544922,29.410882339705484,1,-24,-17,1712,907,957,600,20
0,-1,0.03,-0.0,-1.0,1.0629560947418213,28.844410203711913,1,-24,-16,1712,907,957,600,20
0,-1,0.06,-0.0,-1.0,1.073610544204712,28.30194339616981,1,-24,-15,1712,907,957,600,20
0,-1,0.09,-0.0,-1.0,1.0805976390838623,27.784887978899608,1,-24,-14,1712,907,957,600,20
0,-1,0.12,-0.0,-1.0,1.0875720977783203,27.294688127912362,1,-24,-13,1712,907,957,600,20
0,-1,0.16,-0.0,-1.0,1.0965757369995117,26.832815729997478,1,-24,-12,1712,907,957,600,20
0,-1,0.14,-0.0,-1.0,1.1055245399475098,26.40075756488817,1,-24,-11,1712,907,957,600,20
0,-1,0.11,-0.0,-1.0,1.1154975891113281,26.0,1,-24,-10,1712,907,957,600,20
0,-1,0.13,-0.0,-1.0,1.123476266860962,25.632011235952593,1,-24,-9,1712,907,957,600,20
0,-1,0.11,-0.0,-1.0,1.1304590702056885,25.298221281347036,1,-24,-8,1712,907,957,600,20
0,-1,0.15,-0.0,-1.0,1.1404318809509277,25.0,1,-24,-7,1712,907,957,600,20
0,-1,0.14,-0.0,-1.0,1.1494083404541016,24.73863375370596,1,-24,-6,1712,907,957,600,20
-1,-1,0.15,-1.0,-1.0,1.159393072128296,23.53720459187964,1,-23,-5,1712,907,957,600,20
-1,-1,0.09,-1.0,-1.0,1.168391466140747,22.360679774997898,1,-22,-4,1712,907,957,600,20
-1,0,0.18,-1.0,-0.0,1.1793675422668457,21.37755832643195,1,-21,-4,1712,907,957,600,20
-1,0,0.42,-1.0,-0.0,1.1873397827148438,20.396078054371138,1,-20,-4,1712,907,957,600,20
-1,0,0.65,-1.0,-0.0,1.1943223476409912,19.4164878389476,1,-19,-4,1712,907,957,600,20
-1,0,0.7,-1.0,-0.0,0.007990360260009766,1149.4572632333923,2,-1056,-454,674,457,1731,911,28
-1,0,0.72,-1.0,-0.0,0.01695394515991211,1148.5386367031804,2,-1055,-454,674,457,1731,911,28
-1,0,0.91,-1.0,-0.0,0.025930166244506836,1147.620146215637,2,-1054,-454,674,457,1731,911,28
0,0,0.89,-0.0,-0.0,0.03490781784057617,1147.620146215637,2,-1054,-454,674,457,1731,911,28
1,0,0.91,1.0,-0.0,0.04489493370056152,1148.5386367031804,2,-1055,-454,674,457,1731,911,28
2,1,0.83,2.0,1.0,0.051862239837646484,1150.7710458644674,2,-1057,-455,674,457,1731,911,28
3,1,0.06,3.0,1.0,0.061835527420043945,1153.9220077630896,2,-1060,-456,674,457,1731,911,28
4,2,0.0,4.0,2.0,0.06983280181884766,1158.386809317164,2,-1064,-458,674,457,1731,911,28
5,2,0.0,5.0,2.0,0.07878971099853516,1163.7701663129194,2,-1069,-460,674,457,1731,911,28
6,3,0.0,6.0,3.0,0.08577203750610352,1170.467427996183,2,-1075,-463,674,457,1731,911,28
7,4,0.0,7.0,4.0,0.09574437141418457,1178.4791046089872,2,-1082,-467,674,457,1731,911,28
8,5,0.0,8.0,5.0,0.1047205924987793,1187.8063815285723,2,-1090,-472,674,457,1731,911,28
9,6,0.0,9.0,6.0,0.11269927024841309,1198.4510836909449,2,-1099,-478,674,457,1731,911,28
10,6,0.0,10.0,6.0,0.12167549133300781,1210.015289159604,2,-1109,-484,674,457,1731,911,28
11,6,0.0,11.0,6.0,0.13067865371704102,1222.4974437601086,2,-1120,-490,674,457,1731,911,28
11,6,0.0,11.0,6.0,0.14065909385681152,1234.9805666487225,2,-1131,-496,674,457,1731,911,28
12,6,0.0,12.0,6.0,0.14760613441467285,1248.3801504349547,2,-1143,-502,674,457,1731,911,28
12,6,0.0,12.0,6.0,0.15558481216430664,1261.780091775108,2,-1155,-508,674,457,1731,911,28
12,6,0.0,12.0,6.0,0.16457796096801758,1275.180379397362,2,-1167,-514,674,457,1731,911,28
12,6,0.0,12.0,6.0,0.1735522747039795,1288.5810024984848,2,-1179,-520,674,457,1731,911,28
12,6,0.0,12.0,6.0,0.18351173400878906,1301.9819507197478,2,-1191,-526,674,457,1731,911,28
12,6,0.0,12.0,6.0,0.19148945808410645,1315.38321412431,2,-1203,-532,674,457,1731,911,28
12,6,0.0,12.0,6.0,0.1984715461730957,1328.7847831759664,2,-1215,-538,674,457,1731,911,28
12,5,0.0,12.0,5.0,0.20744681358337402,1341.781651387438,2,-1227,-543,674,457,1731,911,28
12,5,0.0,12.0,5.0,0.21642374992370605,1354.778579694852,2,-1239,-548,674,457,1731,911,28
0,4,0.0,0,4.0,0.22539997100830078,1361.8843563239868,2,-1245,-552,674,457,1731,911,28
0,4,0.0,0,4.0,0.2343752384185791,1363.5105426801804,2,-1245,-556,674,457,1731,911,28
-2,4,0.0,-2.0,4.0,0.24434947967529297,1363.3227790952515,2,-1243,-560,674,457,1731,911,28
-3,3,0.0,-3.0,3.0,0.2513313293457031,1361.8256129181887,2,-1240,-563,674,457,1731,911,28
-4,3,0.0,-4.0,3.0,0.2613036632537842,1359.4307632240782,2,-1236,-566,674,457,1731,911,28
-5,2,0.0,-5.0,2.0,0.26828670501708984,1355.7230543145602,2,-1231,-568,674,457,1731,911,28
-6,1,0.0,-6.0,1.0,0.27925705909729004,1350.6983378978446,2,-1225,-569,674,457,1731,911,28
-7,0,0.0,-7.0,-0.0,0.2862374782562256,1344.3530042366106,2,-1218,-569,674,457,1731,911,28
-8,-1,0.0,-8.0,-1.0,0.2952144145965576,1336.6839566629053,2,-1210,-568,674,457,1731,911,28
-9,-2,0.0,-9.0,-2.0,0.30419039726257324,1327.6885930066583,2,-1201,-566,674,457,1731,911,28
-10,-3,0.0,-10.0,-3.0,0.3121683597564697,1317.3647938213621,2,-1191,-563,674,457,1731,911,28
-11,-4,0.0,-11.0,-4.0,0.32114481925964355,1305.7109174698662,2,-1180,-559,674,457,1731,911,28
-12,-5,0.0,-12.0,-5.0,0.3301205635070801,1292.7258023262318,2,-1168,-554,674,457,1731,911,28
-12,-6,0.0,-12.0,-6.0,0.34009504318237305,1279.3123152694184,2,-1156,-548,674,457,1731,911,28
-12,-7,0.0,-12.0,-7.0,0.35007357597351074,1265.4710585390721,2,-1144,-541,674,457,1731,911,28
-12,-7,0.0,-12.0,-7.0,0.36008262634277344,1251.6309360190808,2,-1132,-534,674,457,1731,911,28
-12,-8,0.0,-12.0,-8.0,0.3690183162689209,1237.366558461962,2,-1120,-526,674,457,1731,911,28
-12,-8,0.0,-12.0,-8.0,0.37899041175842285,1223.1058825792638,2,-1108,-518,674,457,1731,911,28
-12,-8,0.0,-12.0,-8.0,0.38696956634521484,1208.849039375885,2,-1096,-510,674,457,1731,911,28
-12,-8,0.0,-12.0,-8.0,0.3969440460205078,1194.5961660745443,2,-1084,-502,674,457,1731,911,28
-12,-8,0.0,-12.0,-8.0,0.40592479705810547,1180.3474064867512,2,-1072,-494,674,457,1731,911,28
-12,-8,0.0,-12.0,-8.0,0.4149165153503418,1166.102911410481,2,-1060,-486,674,457,1731,911,28
-12,-8,0.0,-12.0,-8.0,0.4238729476928711,1151.8628390568038,2,-1048,-478,674,457,1731,911,28
-12,-8,0.0,-12.0,-8.0,0.43384528160095215,1137.627355507945,2,-1036,-470,674,457,1731,911,28
-12,-8,0.0,-12.0,-8.0,0.4408383369445801,1123.3966352094883,2,-1024,-462,674,457,1731,911,28
-12,-8,0.0,-12.0,-8.0,0.4508042335510254,1109.170861499706,2,-1012,-454,674,457,1731,911,28
-12,-8,0.0,-12.0,-8.0,0.45877957344055176,1094.9502271792996,2,-1000,-446,674,457,1731,911,28
-12,-8,0.0,-12.0,-8.0,0.46675753593444824,1080.7349351251676,2,-988,-438,674,457,1731,911,28
-12,-8,0.0,-12.0,-8.0,0.47473740577697754,1066.525198952186,2,-976,-430,674,457,1731,911,28
-12,-8,0.0,-12.0,-8.0,0.48271942138671875,1052.3212437274085,2,-964,-422,674,457,1731,911,28
-12,-8,0.0,-12.0,-8.0,0.49169087409973145,1038.123306741545,2,-952,-414,674,457,1731,911,28
-12,-7,0.0,-12.0,-7.0,0.49966979026794434,1024.3285605702888,2,-940,-407,674,457,1731,911,28
-12,-7,0.0,-12.0,-7.0,0.5076494216918945,1010.5364911768402,2,-928,-400,674,457,1731,911,28
-12,-7,0.0,-12.0,-7.0,0.5176270008087158,996.7472096775591,2,-916,-393,674,457,1731,911,28
-12,-7,0.0,-12.0,-7.0,0.5246031284332275,982.9608334008024,2,-904,-386,674,457,1731,911,28
-12,-7,0.0,-12.0,-7.0,0.5345768928527832,969.1774863253892,2,-892,-379,674,457,1731,911,28
-12,-7,0.0,-12.0,-7.0,0.5415606498718262,955.3972995565772,2,-880,-372,674,457,1731,911,28
-12,-7,0.0,-12.0,-7.0,0.5515320301055908,941.6204118433287,2,-868,-365,674,457,1731,911,28
-12,-7,0.0,-12.0,-7.0,0.5595104694366455,927.8469701410896,2,-856,-358,674,457,1731,911,28
-12,-7,0.0,-12.0,-7.0,0.5674898624420166,914.0771302247967,2,-844,-351,674,457,1731,911,28
-12,-7,0.0,-12.0,-7.0,0.5754680633544922,900.3110573574003,2,-832,-344,674,457,1731,911,28
-12,-7,0.0,-12.0,-7.0,0.5844438076019287,886.5489270198233,2,-820,-337,674,457,1731,911,28
-12,-7,0.0,-12.0,-7.0,0.5934202671051025,872.7909257090154,2,-808,-330,674,457,1731,911,28
-12,-7,0.0,-12.0,-7.0,0.6023962497711182,859.0372518115847,2,-796,-323,674,457,1731,911,28
-11,-7,0.0,-11.0,-7.0,0.6123702526092529,846.2156935439097,2,-785,-316,674,457,1731,911,28
-10,-6,0.0,-10.0,-6.0,0.6203482151031494,834.7005451058482,2,-775,-310,674,457,1731,911,28
-9,-6,0.0,-9.0,-6.0,0.6293344497680664,824.1189234570458,2,-766,-304,674,457,1731,911,28
-8,-5,0.0,-8.0,-5.0,0.6383004188537598,814.8404751851739,2,-758,-299,674,457,1731,911,28
-7,-5,0.0,-7.0,-5.0,0.6482758522033691,806.4967451887205,2,-751,-294,674,457,1731,911,28
-6,-4,0.0,-6.0,-4.0,0.6562540531158447,799.4529379519472,2,-745,-290,674,457,1731,911,28
-5,-4,0.0,-5.0,-4.0,0.6652295589447021,793.3448178440444,2,-740,-286,674,457,1731,911,28
-5,-4,0.0,-5.0,-4.0,0.673208475112915,787.2413861072092,2,-735,-282,674,457,1731,911,28
-5,-4,0.0,-5.0,-4.0,0.6801891326904297,781.1427526387222,2,-730,-278,674,457,1731,911,28
-5,-4,0.0,-5.0,-4.0,0.6891660690307617,775.0490307070902,2,-725,-274,674,457,1731,911,28
-5,-4,0.0,-5.0,-4.0,0.6981422901153564,768.9603370785778,2,-720,-270,674,457,1731,911,28
-5,-4,0.0,-5.0,-4.0,0.707118034362793,762.8767921492959,2,-715,-266,674,457,1731,911,28
-5,-4,0.0,-5.0,-4.0,0.7180891036987305,756.7985200831196,2,-710,-262,674,457,1731,911,28
-5,-4,0.0,-5.0,-4.0,0.7260687351226807,750.7256489557287,2,-705,-258,674,457,1731,911,28
-5,-4,0.0,-5.0,-4.0,0.7350449562072754,744.6583109050755,2,-700,-254,674,457,1731,911,28
-5,-4,0.0,-5.0,-4.0,0.7454805374145508,738.596642288604,2,-695,-250,674,457,1731,911,28
-5,-4,0.0,-5.0,-4.0,0.7529959678649902,732.5407838475617,2,-690,-246,674,457,1731,911,28
-5,-4,0.0,-5.0,-4.0,0.7629745006561279,726.4908808787623,2,-685,-242,674,457,1731,911,28
-5,-3,0.0,-5.0,-3.0,0.771221399307251,720.7780518301039,2,-680,-239,674,457,1731,911,28
-5,-3,0.0,-5.0,-3.0,0.7791996002197266,715.0671297158051,2,-675,-236,674,457,1731,911,28
-5,-3,0.0,-5.0,-3.0,0.7871799468994141,709.3581605930815,2,-670,-233,674,457,1731,911,28
-5,-3,0.0,-5.0,-3.0,0.7961552143096924,703.6511919978534,2,-665,-230,674,457,1731,911,28
-5,-3,0.0,-5.0,-3.0,0.804133415222168,697.9462730038753,2,-660,-227,674,457,1731,911,28
-5,-3,0.0,-5.0,-3.0,0.8121120929718018,692.2434542846902,2,-655,-224,674,457,1731,911,28
-5,-3,0.0,-5.0,-3.0,0.8210878372192383,686.5427881785665,2,-650,-221,674,457,1731,911,28
-5,-3,0.0,-5.0,-3.0,0.8300647735595703,680.8443287565815,2,-645,-218,674,457,1731,911,28
-5,-3,0.0,-5.0,-3.0,0.8390414714813232,675.148131894031,2,-640,-215,674,457,1731,911,28
-5,-3,0.0,-5.0,-3.0,0.8480162620544434,669.4542553453522,2,-635,-212,674,457,1731,911,28
-5,-3,0.0,-5.0,-3.0,0.8569931983947754,663.7627588227589,2,-630,-209,674,457,1731,911,28
-5,-3,0.0,-5.0,-3.0,0.8659687042236328,658.073704078806,2,-625,-206,674,457,1731,911,28
-5,-3,0.0,-5.0,-3.0,0.8749451637268066,652.3871549931068,2,-620,-203,674,457,1731,911,28
-5,-3,0.0,-5.0,-3.0,0.8839218616485596,646.703177663447,2,-615,-200,674,457,1731,911,28
-5,-3,0.0,-5.0,-3.0,0.8939111232757568,641.0218405015542,2,-610,-197,674,457,1731,911,28
-5,-3,0.0,-5.0,-3.0,0.9008767604827881,635.3432143337961,2,-605,-194,674,457,1731,911,28
-5,-3,0.0,-5.0,-3.0,0.9118685722351074,629.6673725071039,2,-600,-191,674,457,1731,911,28
-5,-3,0.0,-5.0,-3.0,0.9188487529754639,623.994391000432,2,-595,-188,674,457,1731,911,28
-5,-3,0.0,-5.0,-3.0,0.927804708480835,618.32434854209,2,-590,-185,674,457,1731,911,28
-5,-3,0.0,-5.0,-3.0,0.9348089694976807,612.6573267333052,2,-585,-182,674,457,1731,911,28
-5,-3,0.0,-5.0,-3.0,0.9447591304779053,606.9934101783972,2,-580,-179,674,457,1731,911,28
-5,-3,0.0,-5.0,-3.0,0.9527382850646973,601.332686621973,2,-575,-176,674,457,1731,911,28
-5,-3,0.0,-5.0,-3.0,0.9597470760345459,595.675247093582,2,-570,-173,674,457,1731,911,28
-5,-3,0.0,-5.0,-3.0,0.9686975479125977,590.0211860602973,2,-565,-170,674,457,1731,911,28
-5,-3,0.0,-5.0,-3.0,0.9786691665649414,584.3706015877253,2,-560,-167,674,457,1731,911,28
-5,-3,0.0,-5.0,-3.0,0.9866487979888916,578.7235955099809,2,-555,-164,674,457,1731,911,28
-5,-3,0.0,-5.0,-3.0,0.9956240653991699,573.0802736092039,2,-550,-161,674,457,1731,911,28
-5,-3,0.0,-5.0,-3.0,1.0046005249023438,567.4407458052339,2,-545,-158,674,457,1731,911,28
-5,-3,0.0,-5.0,-3.0,1.0135760307312012,561.8051263561058,2,-540,-155,674,457,1731,911,28
-5,-3,0.0,-5.0,-3.0,1.0225529670715332,556.1735340700778,2,-535,-152,674,457,1731,911,28
-5,-3,0.0,-5.0,-3.0,1.031529188156128,550.5460925299534,2,-530,-149,674,457,1731,911,28
-5,-3,0.0,-5.0,-3.0,1.0405058860778809,544.9229303305193,2,-525,-146,674,457,1731,911,28
-5,-3,0.0,-5.0,-3.0,1.0494804382324219,539.30418132998,2,-520,-143,674,457,1731,911,28
-5,-3,0.0,-5.0,-3.0,1.0584568977355957,533.689984916337,2,-515,-140,674,457,1731,911,28
-5,-3,0.0,-5.0,-3.0,1.0674331188201904,528.0804862897321,2,-510,-137,674,457,1731,911,28
-5,-3,0.0,-5.0,-3.0,1.0754122734069824,522.4758367618545,2,-505,-134,674,457,1731,911,28
-5,-3,0.0,-5.0,-3.0,1.084392786026001,516.8761940735905,2,-500,-131,674,457,1731,911,28
-5,-3,0.0,-5.0,-3.0,1.0933763980865479,511.2817227321939,2,-495,-128,674,457,1731,911,28
-5,-3,0.0,-5.0,-3.0,1.1033375263214111,505.69259436934607,2,-490,-125,674,457,1731,911,28
-5,-3,0.0,-5.0,-3.0,1.1123144626617432,500.10898812158933,2,-485,-122,674,457,1731,911,28
-5,-3,0.0,-5.0,-3.0,1.1192946434020996,494.53109103472957,2,-480,-119,674,457,1731,911,28
-5,-3,0.0,-5.0,-3.0,1.1282706260681152,488.9590984939333,2,-475,-116,674,457,1731,911,28
-5,-3,0.0,-5.0,-3.0,1.1372504234313965,483.3932146813813,2,-470,-113,674,457,1731,911,28
-5,-3,0.0,-5.0,-3.0,1.146223545074463,477.83365306349026,2,-465,-110,674,457,1731,911,28
-5,-3,0.0,-5.0,-3.0,1.1551992893218994,472.28063690987796,2,-460,-107,674,457,1731,911,28
-5,-3,0.0,-5.0,-3.0,1.1641757488250732,466.73439984642226,2,-455,-104,674,457,1731,911,28
-5,-3,0.0,-5.0,-3.0,1.1731524467468262,461.19518644495844,2,-450,-101,674,457,1731,911,28
-5,-3,0.0,-5.0,-3.0,1.1831252574920654,455.66325285236684,2,-445,-98,674,457,1731,911,28
-5,-3,0.0,-5.0,-3.0,1.1921138763427734,450.1388674620311,2,-440,-95,674,457,1731,911,28
-5,-3,0.0,-5.0,-3.0,1.2010776996612549,444.6223116308942,2,-435,-92,674,457,1731,911,28
-5,-3,0.0,-5.0,-3.0,1.2100534439086914,439.11388044560834,2,-430,-89,674,457,1731,911,28
-5,-3,0.0,-5.0,-3.0,1.2180323600769043,433.6138835415674,2,-425,-86,674,457,1731,911,28
-5,-3,0.0,-5.0,-3.0,1.2270088195800781,428.1226459789297,2,-420,-83,674,457,1731,911,28
-5,-3,0.0,-5.0,-3.0,1.2359848022460938,422.6405091800832,2,-415,-80,674,457,1731,911,28
-5,-3,0.0,-5.0,-3.0,1.2459683418273926,417.16783193338387,2,-410,-77,674,457,1731,911,28
-5,-3,0.0,-5.0,-3.0,1.25494384765625,411.7049914684057,2,-405,-74,674,457,1731,911,28
-5,-3,0.0,-5.0,-3.0,1.2639141082763672,406.252384608386,2,-400,-71,674,457,1731,911,28
-5,-3,0.0,-5.0,-3.0,1.2728865146636963,400.81042900603273,2,-395,-68,674,457,1731,911,28
-5,-3,0.0,-5.0,-3.0,1.2820041179656982,395.37956446938426,2,-390,-65,674,457,1731,911,28
-5,-3,0.0,-5.0,-3.0,1.2909674644470215,389.96025438498214,2,-385,-62,674,457,1731,911,28
-5,-3,0.0,-5.0,-3.0,1.2989599704742432,384.5529872462311,2,-380,-59,674,457,1731,911,28
-5,-3,0.0,-5.0,-3.0,1.3089218139648438,379.15827829548965,2,-375,-56,674,457,1731,911,28
-5,-3,0.0,-5.0,-3.0,1.3178966045379639,373.7766712891536,2,-370,-53,674,457,1731,911,28
-5,-3,0.0,-5.0,-3.0,1.3248777389526367,368.4087403957729,2,-365,-50,674,457,1731,911,28
-5,-3,0.0,-5.0,-3.0,1.334850788116455,363.05509223807894,2,-360,-47,674,457,1731,911,28
-5,-3,0.0,-5.0,-3.0,1.3428308963775635,357.7163680906984,2,-355,-44,674,457,1731,911,28
-5,-3,0.0,-5.0,-3.0,1.3508079051971436,352.3932462462923,2,-350,-41,674,457,1731,911,28
-5,-2,0.0,-5.0,-2.0,1.358808994293213,347.1973502203034,2,-345,-39,674,457,1731,911,28
-5,-2,0.0,-5.0,-2.0,1.3667657375335693,342.00730986340045,2,-340,-37,674,457,1731,911,28
-5,-1,0.0,-5.0,-1.0,1.3747456073760986,336.92877585626314,2,-335,-36,674,457,1731,911,28
-5,-1,0.0,-5.0,-1.0,1.3819200992584229,331.85087012090236,2,-330,-35,674,457,1731,911,28
-5,-1,0.0,-5.0,-1.0,1.390873670578003,326.7736219464478,2,-325,-34,674,457,1731,911,28
-5,0,0.0,-5.0,-0.0,1.3998489379882812,321.80118085550896,2,-320,-34,674,457,1731,911,28
-5,0,0.0,-5.0,-0.0,1.4088239669799805,316.8296072023573,2,-315,-34,674,457,1731,911,28
-5,0,0.0,-5.0,-0.0,1.4178016185760498,311.85894247239406,2,-310,-34,674,457,1731,911,28
-5,0,0.0,-5.0,-0.0,1.4267871379852295,306.8892308309303,2,-305,-34,674,457,1731,911,28
-5,0,0.0,-5.0,-0.0,1.4357538223266602,301.9205193424256,2,-300,-34,674,457,1731,911,28
-5,0,0.0,-5.0,-0.0,1.4447286128997803,296.952858211535,2,-295,-34,674,457,1731,911,28
-5,0,0.0,-5.0,-0.0,1.4537100791931152,291.9863010485252,2,-290,-34,674,457,1731,911,28
-5,0,0.0,-5.0,-0.0,1.4636781215667725,287.020905161976,2,-285,-34,674,457,1731,911,28
-5,0,0.0,-5.0,-0.0,1.4716567993164062,282.0567318820808,2,-280,-34,674,457,1731,911,28
-5,0,0.0,-5.0,-0.0,1.48063325881958,277.09384691833196,2,-275,-34,674,457,1731,911,28
-5,0,0.0,-5.0,-0.0,1.488759994506836,272.13232075591463,2,-270,-34,674,457,1731,911,28
-5,0,0.0,-5.0,-0.0,1.4987390041351318,267.1722290957651,2,-265,-34,674,457,1731,911,28
-5,0,0.0,-5.0,-0.0,1.5077102184295654,262.21365334398587,2,-260,-34,674,457,1731,911,28
-5,0,0.0,-5.0,-0.0,1.5176844596862793,257.25668115716644,2,-255,-34,674,457,1731,911,28
-5,0,0.0,-5.0,-0.0,1.5246641635894775,252.30140705116966,2,-250,-34,674,457,1731,911,28
-5,0,0.0,-5.0,-0.0,1.5336403846740723,247.34793308212625,2,-245,-34,674,457,1731,911,28
-5,0,0.0,-5.0,-0.0,1.5436146259307861,242.39636960977776,2,-240,-34,674,457,1731,911,28
-5,0,0.0,-5.0,-0.0,1.5505952835083008,237.44683615495913,2,-235,-34,674,457,1731,911,28
-5,0,0.0,-5.0,-0.0,1.5585737228393555,232.4994623649698,2,-230,-34,674,457,1731,911,28
-5,0,0.0,-5.0,-0.0,1.5675508975982666,227.55438910291315,2,-225,-34,674,457,1731,911,28
-5,0,0.0,-5.0,-0.0,1.5745317935943604,222.61176967986216,2,-220,-34,674,457,1731,911,28
-5,0,0.0,-5.0,-0.0,1.5840716361999512,217.671771252039,2,-215,-34,674,457,1731,911,28
-5,0,0.0,-5.0,-0.0,1.5930452346801758,212.73457640919588,2,-210,-34,674,457,1731,911,28
-5,0,0.0,-5.0,-0.0,1.6000282764434814,207.80038498520642,2,-205,-34,674,457,1731,911,28
-5,0,0.0,-5.0,-0.0,1.6100013256072998,202.86941612771503,2,-200,-34,674,457,1731,911,28
-5,0,0.0,-5.0,-0.0,1.6179802417755127,197.9419106707824,2,-195,-34,674,457,1731,911,28
-5,0,0.0,-5.0,-0.0,1.6249606609344482,193.0181338631166,2,-190,-34,674,457,1731,911,28
-5,0,0.0,-5.0,-0.0,1.6349339485168457,188.09837851507388,2,-185,-34,674,457,1731,911,28
-5,0,0.0,-5.0,-0.0,1.6429121494293213,183.1829686406463,2,-180,-34,674,457,1731,911,28
-5,0,0.0,-5.0,-0.0,1.650890827178955,178.27226368675525,2,-175,-34,674,457,1731,911,28
-5,0,0.0,-5.0,-0.0,1.6598665714263916,173.3666634621547,2,-170,-34,674,457,1731,911,28
-5,0,0.0,-5.0,-0.0,1.6678454875946045,168.46661390317072,2,-165,-34,674,457,1731,911,28
-5,0,0.0,-5.0,-0.0,1.6758239269256592,163.5726138447387,2,-160,-34,674,457,1731,911,28
-5,0,0.0,-5.0,-0.0,1.6828060150146484,158.68522300453813,2,-155,-34,674,457,1731,911,28
-5,0,0.0,-5.0,-0.0,1.691781759262085,153.80507143784303,2,-150,-34,674,457,1731,911,28
-5,0,0.0,-5.0,-0.0,1.7017557621002197,148.93287078412206,2,-145,-34,674,457,1731,911,28
-5,0,0.0,-5.0,-0.0,1.7087364196777344,144.06942770761603,2,-140,-34,674,457,1731,911,28
-5,0,0.0,-5.0,-0.0,1.7187108993530273,139.21566003866087,2,-135,-34,674,457,1731,911,28
-5,0,0.0,-5.0,-0.0,1.7267169952392578,134.3726162579266,2,-130,-34,674,457,1731,911,28
-5,0,0.0,-5.0,-0.0,1.7356653213500977,129.5414991421668,2,-125,-34,674,457,1731,911,28
-5,0,0.0,-5.0,-0.0,1.7436444759368896,124.72369462135092,2,-120,-34,674,457,1731,911,28
-5,0,0.0,-5.0,-0.0,1.7506260871887207,119.9208072020865,2,-115,-34,674,457,1731,911,28
-5,0,0.0,-5.0,-0.0,1.7596290111541748,115.13470371699404,2,-110,-34,674,457,1731,911,28
-5,0,0.0,-5.0,-0.0,1.767599105834961,110.3675676999362,2,-105,-34,674,457,1731,911,28
-5,0,0.0,-5.0,-0.0,1.7775533199310303,105.62196741208714,2,-100,-34,674,457,1731,911,28
-5,0,0.0,-5.0,-0.0,1.7845346927642822,100.90094152187085,2,-95,-34,674,457,1731,911,28
-5,0,0.0,-5.0,-0.0,1.7935361862182617,96.20810776644555,2,-90,-34,674,457,1731,911,28
-5,0,0.0,-5.0,-0.0,1.8024873733520508,91.54780172128658,2,-85,-34,674,457,1731,911,28
-5,0,0.0,-5.0,-0.0,1.8124840259552002,86.92525524840292,2,-80,-34,674,457,1731,911,28
-5,0,0.0,-5.0,-0.0,1.8204429149627686,82.34682750416071,2,-75,-34,674,457,1731,911,28
-5,0,0.0,-5.0,-0.0,1.8284187316894531,77.82030583337487,2,-70,-34,674,457,1731,911,28
-5,0,0.0,-5.0,-0.0,1.8373942375183105,73.35529974037323,2,-65,-34,674,457,1731,911,28
-5,0,0.0,-5.0,-0.0,1.8463706970214844,68.96375859826666,2,-60,-34,674,457,1731,911,28
-5,0,0.0,-5.0,-0.0,1.8553528785705566,64.66065264130884,2,-55,-34,674,457,1731,911,28
-4,0,0.0,-4.0,-0.0,1.8643243312835693,61.29437168288782,2,-51,-34,674,457,1731,911,28
-4,0,0.0,-4.0,-0.0,1.8732988834381104,58.008620049092706,2,-47,-34,674,457,1731,911,28
-3,0,0.0,-3.0,-0.0,1.8822760581970215,55.60575509783138,2,-44,-34,674,457,1731,911,28
-3,0,0.0,-3.0,-0.0,1.8912580013275146,53.2634959423431,2,-41,-34,674,457,1731,911,28
-3,0,0.0,-3.0,-0.0,1.9002273082733154,50.99019513592785,2,-38,-34,674,457,1731,911,28
-3,0,0.0,-3.0,-0.0,1.9092044830322266,48.79549159502341,2,-35,-34,674,457,1731,911,28
-3,0,0.0,-3.0,-0.0,1.9181795120239258,46.69047011971501,2,-32,-34,674,457,1731,911,28
-3,0,0.0,-3.0,-0.0,1.9261589050292969,44.68780594300866,2,-29,-34,674,457,1731,911,28
-3,0,0.0,-3.0,-0.0,1.9351346492767334,42.80186911806539,2,-26,-34,674,457,1731,911,28
-3,0,0.0,-3.0,-0.0,1.9461264610290527,41.048751503547585,2,-23,-34,674,457,1731,911,28
-2,0,0.0,-2.0,-0.0,1.9560894966125488,39.96248240537617,2,-21,-34,674,457,1731,911,28
-2,0,0.01,-2.0,-0.0,1.9660589694976807,38.948684188300895,2,-19,-34,674,457,1731,911,28
-2,0,0.02,-2.0,-0.0,1.974031686782837,38.01315561749642,2,-17,-34,674,457,1731,911,28
-2,0,0.02,-2.0,-0.0,1.9830071926116943,37.16180835212409,2,-15,-34,674,457,1731,911,28
-2,0,0.03,-2.0,-0.0,1.9899885654449463,36.40054944640259,2,-13,-34,674,457,1731,911,28
-2,0,0.02,-2.0,-0.0,1.998964548110962,35.73513677041127,2,-11,-34,674,457,1731,911,28
-2,0,0.03,-2.0,-0.0,2.0079429149627686,35.17101079013795,2,-9,-34,674,457,1731,911,28
-1,0,0.04,-1.0,-0.0,2.0179145336151123,34.92849839314596,2,-8,-34,674,457,1731,911,28
-1,0,0.28,-1.0,-0.0,2.0258944034576416,34.713109915419565,2,-7,-34,674,457,1731,911,28
-1,0,0.58,-1.0,-0.0,2.033872604370117,34.52535300326414,2,-6,-34,674,457,1731,911,28
-1,0,0.62,-1.0,-0.0,2.0408530235290527,34.36568055487916,2,-5,-34,674,457,1731,911,28
-1,0,0.59,-1.0,-0.0,2.0498290061950684,34.23448553724738,2,-4,-34,674,457,1731,911,28
-1,0,0.51,-1.0,-0.0,2.0588364601135254,34.132096331752024,2,-3,-34,674,457,1731,911,28
-1,0,0.61,-1.0,-0.0,2.0687789916992188,34.058772731852805,2,-2,-34,674,457,1731,911,28
-1,0,0.59,-1.0,-0.0,2.0757603645324707,34.0147027033899,2,-1,-34,674,457,1731,911,28
-1,0,0.59,-1.0,-0.0,2.0857343673706055,34.0,2,0,-34,674,457,1731,911,28
-1,0,0.57,-1.0,-0.0,2.093712329864502,34.0147027033899,2,1,-34,674,457,1731,911,28
-1,0,0.54,-1.0,-0.0,2.100721836090088,34.058772731852805,2,2,-34,674,457,1731,911,28
-1,0,0.52,-1.0,-0.0,2.109671115875244,34.132096331752024,2,3,-34,674,457,1731,911,28
-1,0,0.58,-1.0,-0.0,2.1186554431915283,34.23448553724738,2,4,-34,674,457,1731,911,28
-1,0,0.66,-1.0,-0.0,2.1276233196258545,34.36568055487916,2,5,-34,674,457,1731,911,28
-1,0,0.59,-1.0,-0.0,2.1365983486175537,34.52535300326414,2,6,-34,674,457,1731,911,28
-1,0,0.45,-1.0,-0.0,2.1466028690338135,34.713109915419565,2,7,-34,674,457,1731,911,28
-1,0,0.36,-1.0,-0.0,2.1535544395446777,34.92849839314596,2,8,-34,674,457,1731,911,28
-1,0,0.34,-1.0,-0.0,2.163526773452759,35.17101079013795,2,9,-34,674,457,1731,911,28
-1,0,0.3,-1.0,-0.0,2.1715052127838135,35.4400902933387,2,10,-34,674,457,1731,911,28
-1,0,0.32,-1.0,-0.0,2.1804819107055664,35.73513677041127,2,11,-34,674,457,1731,911,28
-1,0,0.37,-1.0,-0.0,2.189457416534424,36.05551275463989,2,12,-34,674,457,1731,911,28
-1,0,0.34,-1.0,-0.0,2.198434591293335,36.40054944640259,2,13,-34,674,457,1731,911,28
-1,0,0.3,-1.0,-0.0,2.2074105739593506,36.76955262170047,2,14,-34,674,457,1731,911,28
-1,0,0.23,-1.0,-0.0,2.216386556625366,37.16180835212409,2,15,-34,674,457,1731,911,28
-1,0,0.2,-1.0,-0.0,2.2253623008728027,37.57658845611187,2,16,-34,674,457,1731,911,28
-1,0,0.17,-1.0,-0.0,2.2353367805480957,38.01315561749642,2,17,-34,674,457,1731,911,28
-1,0,0.17,-1.0,-0.0,2.242344617843628,38.47076812334269,2,18,-34,674,457,1731,911,28
-1,0,0.18,-1.0,-0.0,2.252291440963745,38.948684188300895,2,19,-34,674,457,1731,911,28
-1,0,0.19,-1.0,-0.0,2.260308027267456,39.44616584663204,2,20,-34,674,457,1731,911,28
-1,0,0.2,-1.0,-0.0,2.26824951171875,39.96248240537617,2,21,-34,674,457,1731,911,28
-1,0,0.17,-1.0,-0.0,2.276228427886963,40.496913462633174,2,22,-34,674,457,1731,911,28
-1,0,0.17,-1.0,-0.0,2.2832090854644775,41.048751503547585,2,23,-34,674,457,1731,911,28
-1,0,0.17,-1.0,-0.0,2.292185068130493,41.617304093369626,2,24,-34,674,457,1731,911,28
-1,0,0.14,-1.0,-0.0,2.3021578788757324,42.20189569201838,2,25,-34,674,457,1731,911,28
-1,0,0.13,-1.0,-0.0,2.3101377487182617,42.80186911806539,2,26,-34,674,457,1731,911,28
-1,0,0.13,-1.0,-0.0,2.320111036300659,43.41658669218482,2,27,-34,674,457,1731,911,28
-1,0,0.12,-1.0,-0.0,2.3310818672180176,44.04543109109048,2,28,-34,674,457,1731,911,28
-1,0,0.11,-1.0,-0.0,2.339060068130493,44.68780594300866,2,29,-34,674,457,1731,911,28
-1,0,0.12,-1.0,-0.0,2.3490331172943115,45.34313619501854,2,30,-34,674,457,1731,911,28
-1,0,0.12,-1.0,-0.0,2.3590071201324463,46.010868281309364,2,31,-34,674,457,1731,911,28
-1,0,0.1,-1.0,-0.0,2.368981122970581,46.69047011971501,2,32,-34,674,457,1731,911,28
-1,0,0.09,-1.0,-0.0,2.376959800720215,47.38143096192854,2,33,-34,674,457,1731,911,28
-1,0,0.09,-1.0,-0.0,2.3869361877441406,48.08326112068523,2,34,-34,674,457,1731,911,28
-1,0,0.09,-1.0,-0.0,2.394912004470825,48.79549159502341,2,35,-34,674,457,1731,911,28
-1,0,0.09,-1.0,-0.0,2.4048843383789062,49.51767361255979,2,36,-34,674,457,1731,911,28
-1,0,0.09,-1.0,-0.0,2.4128634929656982,50.24937810560445,2,37,-34,674,457,1731,911,28
-1,0,0.09,-1.0,-0.0,2.41984486579895,50.99019513592785,2,38,-34,674,457,1731,911,28
-1,0,0.09,-1.0,-0.0,2.428821086883545,51.73973328110612,2,39,-34,674,457,1731,911,28
-1,0,0.1,-1.0,-0.0,2.4378063678741455,52.49761899362675,2,40,-34,674,457,1731,911,28
-1,0,0.1,-1.0,-0.0,2.4467732906341553,53.2634959423431,2,41,-34,674,457,1731,911,28
-1,0,0.1,-1.0,-0.0,2.455749034881592,54.037024344425184,2,42,-34,674,457,1731,911,28
-1,0,0.1,-1.0,-0.0,2.4647257328033447,54.817880294662984,2,43,-34,674,457,1731,911,28
-1,0,0.1,-1.0,-0.0,2.473701238632202,55.60575509783138,2,44,-34,674,457,1731,911,28
-1,0,0.1,-1.0,-0.0,2.483675003051758,56.4003546088143,2,45,-34,674,457,1731,911,28
-1,0,0.1,-1.0,-0.0,2.491222381591797,57.201398584300364,2,46,-34,674,457,1731,911,28
-1,0,0.1,-1.0,-0.0,2.5001988410949707,58.008620049092706,2,47,-34,674,457,1731,911,28
-1,0,0.1,-1.0,-0.0,2.5091755390167236,58.82176467941097,2,48,-34,674,457,1731,911,28
-1,0,0.09,-1.0,-0.0,2.518151044845581,59.64059020499378,2,49,-34,674,457,1731,911,28
-1,0,0.09,-1.0,-0.0,2.5271270275115967,60.4648658313239,2,50,-34,674,457,1731,911,28
-1,0,0.09,-1.0,-0.0,2.534109115600586,61.29437168288782,2,51,-34,674,457,1731,911,28
-1,0,0.09,-1.0,-0.0,2.5430850982666016,62.12889826803627,2,52,-34,674,457,1731,911,28
-1,0,0.09,-1.0,-0.0,2.553072214126587,62.96824596572466,2,53,-34,674,457,1731,911,28
-1,0,0.09,-1.0,-0.0,2.5640296936035156,63.812224534175265,2,54,-34,674,457,1731,911,28
-1,0,0.09,-1.0,-0.0,2.5720083713531494,64.66065264130884,2,55,-34,674,457,1731,911,28
-1,0,0.09,-1.0,-0.0,2.5799906253814697,65.5133574166368,2,56,-34,674,457,1731,911,28
-1,0,0.09,-1.0,-0.0,2.5879735946655273,66.37017402418047,2,57,-34,674,457,1731,911,28
-1,0,0.09,-1.0,-0.0,2.5949466228485107,67.23094525588644,2,58,-34,674,457,1731,911,28
-1,0,0.1,-1.0,-0.0,2.6049201488494873,68.09552114493287,2,59,-34,674,457,1731,911,28
-1,0,0.09,-1.0,-0.0,2.6138992309570312,68.96375859826666,2,60,-34,674,457,1731,911,28
-1,0,0.09,-1.0,-0.0,2.620878219604492,69.83552104767315,2,61,-34,674,457,1731,911,28
-1,0,0.1,-1.0,-0.0,2.6308512687683105,70.71067811865476,2,62,-34,674,457,1731,911,28
-1,0,0.1,-1.0,-0.0,2.6388351917266846,71.58910531638176,2,63,-34,674,457,1731,911,28
-1,0,0.1,-1.0,-0.0,2.646808624267578,72.47068372797375,2,64,-34,674,457,1731,911,28
-1,0,0.09,-1.0,-0.0,2.65378999710083,73.35529974037323,2,65,-34,674,457,1731,911,28
-1,0,0.09,-1.0,-0.0,2.6627657413482666,74.24284477308234,2,66,-34,674,457,1731,911,28
-1,0,0.09,-1.0,-0.0,2.6697475910186768,75.13321502504735,2,67,-34,674,457,1731,911,28
-1,0,0.09,-1.0,-0.0,2.6787238121032715,76.02631123499285,2,68,-34,674,457,1731,911,28
-1,0,0.09,-1.0,-0.0,2.687700033187866,76.92203845452875,2,69,-34,674,457,1731,911,28
-1,0,0.09,-1.0,-0.0,2.697673797607422,77.82030583337487,2,70,-34,674,457,1731,911,28
-1,0,0.09,-1.0,-0.0,2.7056519985198975,78.7210264160726,2,71,-34,674,457,1731,911,28
-1,0,0.09,-1.0,-0.0,2.7146289348602295,79.62411694957753,2,72,-34,674,457,1731,911,28
-1,0,0.09,-1.0,-0.0,2.723605155944824,80.52949770115296,2,73,-34,674,457,1731,911,28
-1,0,0.09,-1.0,-0.0,2.730586290359497,81.43709228600933,2,74,-34,674,457,1731,911,28
-1,0,0.08,-1.0,-0.0,2.7395617961883545,82.34682750416071,2,75,-34,674,457,1731,911,28
-1,0,0.08,-1.0,-0.0,2.7475404739379883,83.2586331859946,2,76,-34,674,457,1731,911,28
-1,0,0.08,-1.0,-0.0,2.756518840789795,84.17244204607586,2,77,-34,674,457,1731,911,28
-1,0,0.08,-1.0,-0.0,2.7655234336853027,85.0881895447306,2,78,-34,674,457,1731,911,28
-1,0,0.08,-1.0,-0.0,2.7744858264923096,86.00581375697809,2,79,-34,674,457,1731,911,28
-1,0,0.08,-1.0,-0.0,2.783445358276367,86.92525524840292,2,80,-34,674,457,1731,911,28
-1,0,0.08,-1.0,-0.0,2.7924368381500244,87.84645695758026,2,81,-34,674,457,1731,911,28
-1,0,0.08,-1.0,-0.0,2.8023953437805176,88.76936408468859,2,82,-34,674,457,1731,911,28
-1,0,0.08,-1.0,-0.0,2.8093786239624023,89.69392398596462,2,83,-34,674,457,1731,911,28
-1,0,0.08,-1.0,-0.0,2.818352222442627,90.62008607367353,2,84,-34,674,457,1731,911,28
-1,0,0.08,-1.0,-0.0,2.8283257484436035,91.54780172128658,2,85,-34,674,457,1731,911,28
-1,0,0.08,-1.0,-0.0,2.836305618286133,92.47702417357513,2,86,-34,674,457,1731,911,28
-1,0,0.08,-1.0,-0.0,2.8452868461608887,93.40770846134703,2,87,-34,674,457,1731,911,28
-1,0,0.08,-1.0,-0.0,2.853271722793579,94.33981132056604,2,88,-34,674,457,1731,911,28
-1,0,0.07,-1.0,-0.0,2.8622353076934814,95.2732911156112,2,89,-34,674,457,1731,911,28
-1,0,0.07,-1.0,-0.0,2.8692240715026855,96.20810776644555,2,90,-34,674,457,1731,911,28
-1,0,0.07,-1.0,-0.0,2.880187511444092,97.14422267947796,2,91,-34,674,457,1731,911,28
-1,0,0.07,-1.0,-0.0,2.88716983795166,98.08159868191383,2,92,-34,674,457,1731,911,28
-1,0,0.07,-1.0,-0.0,2.8966312408447266,99.02019995940222,2,93,-34,674,457,1731,911,28
-1,0,0.07,-1.0,-0.0,2.905555486679077,99.9599919967984,2,94,-34,674,457,1731,911,28
-1,0,0.07,-1.0,-0.0,2.914531946182251,100.90094152187085,2,95,-34,674,457,1731,911,28
-1,0,0.07,-1.0,-0.0,2.923529624938965,101.84301645179212,2,96,-34,674,457,1731,911,28
-1,0,0.07,-1.0,-0.0,2.9324824810028076,102.7861858422619,2,97,-34,674,457,1731,911,28
-1,0,0.07,-1.0,-0.0,2.9414596557617188,103.73041983911952,2,98,-34,674,457,1731,911,28
-1,0,0.06,-1.0,-0.0,2.950434923171997,104.67568963231147,2,99,-34,674,457,1731,911,28
-1,0,0.06,-1.0,-0.0,2.95941162109375,105.62196741208714,2,100,-34,674,457,1731,911,28
-1,0,0.06,-1.0,-0.0,2.9693844318389893,106.56922632730333,2,101,-34,674,457,1731,911,28
-1,0,0.06,-1.0,-0.0,2.977368116378784,107.5174404457249,2,102,-34,674,457,1731,911,28
-1,0,0.06,-1.0,-0.0,2.985342264175415,108.4665847162157,2,103,-34,674,457,1731,911,28
-1,0,0.06,-1.0,-0.0,2.993889570236206,109.41663493271945,2,104,-34,674,457,1731,911,28
-1,0,0.06,-1.0,-0.0,3.001868486404419,110.3675676999362,2,105,-34,674,457,1731,911,28
-1,0,0.06,-1.0,-0.0,3.008850336074829,111.31936040060597,2,106,-34,674,457,1731,911,28
-1,0,0.06,-1.0,-0.0,3.017826795578003,112.27199116431488,2,107,-34,674,457,1731,911,28
-1,0,0.05,-1.0,-0.0,3.0268020629882812,113.22543883774529,2,108,-34,674,457,1731,911,28
-1,0,0.05,-1.0,-0.0,3.035778760910034,114.17968295629481,2,109,-34,674,457,1731,911,28
-1,0,0.05,-1.0,-0.0,3.0437841415405273,115.13470371699404,2,110,-34,674,457,1731,911,28
-1,0,0.05,-1.0,-0.0,3.051736354827881,116.09048195265622,2,111,-34,674,457,1731,911,28
-1,0,0.05,-1.0,-0.0,3.0607118606567383,117.04699910719626,2,112,-34,674,457,1731,911,28
-1,0,0.05,-1.0,-0.0,3.069687604904175,118.00423721205946,2,113,-34,674,457,1731,911,28
-1,0,0.05,-1.0,-0.0,3.078669786453247,118.96217886370441,2,114,-34,674,457,1731,911,28
-1,0,0.05,-1.0,-0.0,3.0876402854919434,119.9208072020865,2,115,-34,674,457,1731,911,28
-1,0,0.05,-1.0,-0.0,3.0966367721557617,120.88010589009261,2,116,-34,674,457,1731,911,28
-1,0,0.05,-1.0,-0.0,3.105592966079712,121.8400590938793,2,117,-34,674,457,1731,911,28
-1,0,0.05,-1.0,-0.0,3.1145687103271484,122.80065146407001,2,118,-34,674,457,1731,911,28
-1,0,0.04,-1.0,-0.0,3.1235451698303223,123.76186811776881,2,119,-34,674,457,1731,911,28
-1,0,0.04,-1.0,-0.0,3.1325206756591797,124.72369462135092,2,120,-34,674,457,1731,911,28
-1,0,0.04,-1.0,-0.0,3.1414968967437744,125.686116973992,2,121,-34,674,457,1731,911,28
-1,0,0.04,-1.0,-0.0,3.1504790782928467,126.64912159190051,2,122,-34,674,457,1731,911,28
-1,0,0.04,-1.0,-0.0,3.159491777420044,127.61269529321916,2,123,-34,674,457,1731,911,28
-1,0,0.04,-1.0,-0.0,3.1694223880767822,128.57682528356344,2,124,-34,674,457,1731,911,28
-1,0,0.04,-1.0,-0.0,3.1774020195007324,129.5414991421668,2,125,-34,674,457,1731,911,28
-1,0,0.04,-1.0,-0.0,3.1873748302459717,130.50670480860362,2,126,-34,674,457,1731,911,28
-1,0,0.04,-1.0,-0.0,3.195361852645874,131.47243057006287,2,127,-34,674,457,1731,911,28
-1,0,0.04,-1.0,-0.0,3.202335834503174,132.43866504914644,2,128,-34,674,457,1731,911,28
-1,0,0.04,-1.0,-0.0,3.212308406829834,133.4053971921676,2,129,-34,674,457,1731,911,28
-1,0,0.04,-1.0,-0.0,3.2202870845794678,134.3726162579266,2,130,-34,674,457,1731,911,28
-1,0,0.04,-1.0,-0.0,3.2282657623291016,135.34031180694095,2,131,-34,674,457,1731,911,28
-1,0,0.04,-1.0,-0.0,3.2362658977508545,136.3084736911099,2,132,-34,674,457,1731,911,28
-1,0,0.04,-1.0,-0.0,3.2442243099212646,137.27709204379295,2,133,-34,674,457,1731,911,28
-1,0,0.04,-1.0,-0.0,3.253199338912964,138.24615727028365,2,134,-34,674,457,1731,911,28
-1,0,0.04,-1.0,-0.0,3.26020884513855,139.21566003866087,2,135,-34,674,457,1731,911,28
-1,0,0.04,-1.0,-0.0,3.2701544761657715,140.18559127100045,2,136,-34,674,457,1731,911,28
-1,0,0.04,-1.0,-0.0,3.2821240425109863,141.15594213493105,2,137,-34,674,457,1731,911,28
-1,0,0.04,-1.0,-0.0,3.2910988330841064,142.12670403551894,2,138,-34,674,457,1731,911,28
-1,0,0.04,-1.0,-0.0,3.3020710945129395,143.09786860746738,2,139,-34,674,457,1731,911,28
-1,0,0.04,-1.0,-0.0,3.3100483417510986,144.06942770761603,2,140,-34,674,457,1731,911,28
-1,0,0.04,-1.0,-0.0,3.3200223445892334,145.04137340772803,2,141,-34,674,457,1731,911,28
-1,0,0.04,-1.0,-0.0,3.328997850418091,146.01369798755184,2,142,-34,674,457,1731,911,28
-1,0,0.04,-1.0,-0.0,3.33803129196167,146.98639392814562,2,143,-34,674,457,1731,911,28
-1,0,0.03,-1.0,-0.0,3.348012924194336,147.95945390545344,2,144,-34,674,457,1731,911,28
-1,0,0.03,-1.0,-0.0,3.356980323791504,148.93287078412206,2,145,-34,674,457,1731,911,28
-1,0,0.03,-1.0,-0.0,3.3659567832946777,149.90663761154806,2,146,-34,674,457,1731,911,28
-1,0,0.03,-1.0,-0.0,3.3749465942382812,150.88074761214565,2,147,-34,674,457,1731,911,28
-1,0,0.03,-1.0,-0.0,3.383908748626709,151.85519418182574,2,148,-34,674,457,1731,911,28
-1,0,0.03,-1.0,-0.0,3.392883777618408,152.82997088267732,2,149,-34,674,457,1731,911,28
-1,0,0.03,-1.0,-0.0,3.4018607139587402,153.80507143784303,2,150,-34,674,457,1731,911,28
-1,0,0.03,-1.0,-0.0,3.4098386764526367,154.7804897265802,2,151,-34,674,457,1731,911,28
-1,0,0.03,-1.0,-0.0,3.417818546295166,155.7562197795003,2,152,-34,674,457,1731,911,28
-1,0,0.03,-1.0,-0.0,3.4257972240448,156.7322557739791,2,153,-34,674,457,1731,911,28
-1,0,0.03,-1.0,-0.0,3.434772253036499,157.70859202973057,2,154,-34,674,457,1731,911,28
-1,0,0.03,-1.0,-0.0,3.444746494293213,158.68522300453813,2,155,-34,674,457,1731,911,28
-1,0,0.03,-1.0,-0.0,3.452725887298584,159.66214329013624,2,156,-34,674,457,1731,911,28
-1,0,0.03,-1.0,-0.0,3.459707736968994,160.63934760823702,2,157,-34,674,457,1731,911,28
-1,0,0.03,-1.0,-0.0,3.4686834812164307,161.6168308066954,2,158,-34,674,457,1731,911,28
-1,0,0.03,-1.0,-0.0,3.477663278579712,162.5945878558078,2,159,-34,674,457,1731,911,28
-1,0,0.03,-1.0,-0.0,3.4876325130462646,163.5726138447387,2,160,-34,674,457,1731,911,28
-1,0,0.03,-1.0,-0.0,3.4946131706237793,164.55090397806995,2,161,-34,674,457,1731,911,28
-1,0,0.03,-1.0,-0.0,3.5035903453826904,165.5294535724685,2,162,-34,674,457,1731,911,28
-1,0,0.03,-1.0,-0.0,3.513564109802246,166.50825805346713,2,163,-34,674,457,1731,911,28
-1,0,0.03,-1.0,-0.0,3.520545244216919,167.4873129523547,2,164,-34,674,457,1731,911,28
-1,0,0.03,-1.0,-0.0,3.5305185317993164,168.46661390317072,2,165,-34,674,457,1731,911,28
-1,0,0.03,-1.0,-0.0,3.537499189376831,169.44615663980107,2,166,-34,674,457,1731,911,28
-1,0,0.03,-1.0,-0.0,3.547473192214966,170.42593699317015,2,167,-34,674,457,1731,911,28
-1,0,0.03,-1.0,-0.0,3.5544557571411133,171.40595088852663,2,168,-34,674,457,1731,911,28
-1,0,0.03,-1.0,-0.0,3.564427137374878,172.38619434281853,2,169,-34,674,457,1731,911,28
-1,0,0.03,-1.0,-0.0,3.5714094638824463,173.3666634621547,2,170,-34,674,457,1731,911,28
-1,0,0.03,-1.0,-0.0,3.5813841819763184,174.34735443934903,2,171,-34,674,457,1731,911,28
-1,0,0.03,-1.0,-0.0,3.5883734226226807,175.32826355154492,2,172,-34,674,457,1731,911,28
-1,0,0.03,-1.0,-0.0,3.598337173461914,176.30938715791623,2,173,-34,674,457,1731,911,28
-1,0,0.03,-1.0,-0.0,3.6053194999694824,177.29072169744248,2,174,-34,674,457,1731,911,28
-1,0,0.03,-1.0,-0.0,3.6142959594726562,178.27226368675525,2,175,-34,674,457,1731,911,28
-1,0,0.03,-1.0,-0.0,3.6242690086364746,179.25400971805345,2,176,-34,674,457,1731,911,28
-1,0,0.03,-1.0,-0.0,3.6322479248046875,180.23595645708434,2,177,-34,674,457,1731,911,28
-1,0,0.03,-1.0,-0.0,3.6412782669067383,181.2181006411887,2,178,-34,674,457,1731,911,28
-1,0,0.03,-1.0,-0.0,3.648210048675537,182.20043907740728,2,179,-34,674,457,1731,911,28
-1,0,0.03,-1.0,-0.0,3.6571807861328125,183.1829686406463,2,180,-34,674,457,1731,911,28
-1,0,0.03,-1.0,-0.0,3.6661579608917236,184.16568627190028,2,181,-34,674,457,1731,911,28
-1,0,0.03,-1.0,-0.0,3.6751339435577393,185.14858897652988,2,182,-34,674,457,1731,911,28
-1,0,0.03,-1.0,-0.0,3.6861047744750977,186.1316738225926,2,183,-34,674,457,1731,911,28
-1,0,0.03,-1.0,-0.0,3.695080518722534,187.11493793922494,2,184,-34,674,457,1731,911,28
-1,0,0.03,-1.0,-0.0,3.704057216644287,188.09837851507388,2,185,-34,674,457,1731,911,28
-1,0,0.03,-1.0,-0.0,3.714029312133789,189.08199279677586,2,186,-34,674,457,1731,911,28
-1,0,0.03,-1.0,-0.0,3.7230072021484375,190.06577808748213,2,187,-34,674,457,1731,911,28
-1,0,0.03,-1.0,-0.0,3.7319817543029785,191.049731745428,2,188,-34,674,457,1731,911,28
-1,0,0.03,-1.0,-0.0,3.740957736968994,192.03385118254542,2,189,-34,674,457,1731,911,28
-1,0,0.03,-1.0,-0.0,3.7499337196350098,193.0181338631166,2,190,-34,674,457,1731,911,28
-1,0,0.03,-1.0,-0.0,3.7589101791381836,194.0025773024678,2,191,-34,674,457,1731,911,28
-1,0,0.03,-1.0,-0.0,3.767886161804199,194.98717906570164,2,192,-34,674,457,1731,911,28
-1,0,0.03,-1.0,-0.0,3.7758703231811523,195.97193676646665,2,193,-34,674,457,1731,911,28
-1,0,0.03,-1.0,-0.0,3.7868378162384033,196.95684806576287,2,194,-34,674,457,1731,911,28
-1,0,0.03,-1.0,-0.0,3.7958130836486816,197.9419106707824,2,195,-34,674,457,1731,911,28
-1,0,0.03,-1.0,-0.0,3.803792715072632,198.92712233378333,2,196,-34,674,457,1731,911,28
-1,0,0.03,-1.0,-0.0,3.814762830734253,199.9124808509964,2,197,-34,674,457,1731,911,28
-1,0,0.03,-1.0,-0.0,3.823774814605713,200.89798406156294,2,198,-34,674,457,1731,911,28
-1,0,0.03,-1.0,-0.0,3.8337130546569824,201.8836298465034,2,199,-34,674,457,1731,911,28
-1,0,0.03,-1.0,-0.0,3.841691255569458,202.86941612771503,2,200,-34,674,457,1731,911,28
-1,0,0.03,-1.0,-0.0,3.852663040161133,203.85534086699815,2,201,-34,674,457,1731,911,28
-1,0,0.03,-1.0,-0.0,3.861638307571411,204.84140206510986,2,202,-34,674,457,1731,911,28
-1,0,0.03,-1.0,-0.0,3.872607946395874,205.8275977608445,2,203,-34,674,457,1731,911,28
-1,0,0.03,-1.0,-0.0,3.8815853595733643,206.81392603013947,2,204,-34,674,457,1731,911,28
-1,0,0.03,-1.0,-0.0,3.8895623683929443,207.80038498520642,2,205,-34,674,457,1731,911,28
-1,0,0.03,-1.0,-0.0,3.899553060531616,208.78697277368624,2,206,-34,674,457,1731,911,28
-1,0,0.03,-1.0,-0.0,3.906517505645752,209.77368757782756,2,207,-34,674,457,1731,911,28
-1,0,0.03,-1.0,-0.0,3.9154932498931885,210.76052761368766,2,208,-34,674,457,1731,911,28
-1,0,0.03,-1.0,-0.0,3.924471139907837,211.74749113035554,2,209,-34,674,457,1731,911,28
-1,0,0.02,-1.0,-0.0,3.932448625564575,212.73457640919588,2,210,-34,674,457,1731,911,28
-1,0,0.02,-1.0,-0.0,3.9424219131469727,213.7217817631137,2,211,-34,674,457,1731,911,28
-1,0,0.02,-1.0,-0.0,3.9513988494873047,214.7091055358389,2,212,-34,674,457,1731,911,28
-1,0,0.02,-1.0,-0.0,3.960379123687744,215.6965461012299,2,213,-34,674,457,1731,911,28
-1,0,0.02,-1.0,-0.0,3.969350814819336,216.68410186259626,2,214,-34,674,457,1731,911,28
-1,0,0.02,-1.0,-0.0,3.977329730987549,217.671771252039,2,215,-34,674,457,1731,911,28
-1,0,0.02,-1.0,-0.0,3.986306667327881,218.65955272980872,2,216,-34,674,457,1731,911,28
-1,0,0.02,-1.0,-0.0,3.99428391456604,219.64744478368056,2,217,-34,674,457,1731,911,28
-1,0,0.02,-1.0,-0.0,4.0031352043151855,220.6354459283458,2,218,-34,674,457,1731,911,28
-1,0,0.02,-1.0,-0.0,4.01211142539978,221.6235547048192,2,219,-34,674,457,1731,911,28
-1,0,0.02,-1.0,-0.0,4.020090579986572,222.61176967986216,2,220,-34,674,457,1731,911,28
-1,0,0.02,-1.0,-0.0,4.029066324234009,223.6000894454204,2,221,-34,674,457,1731,911,28
-1,0,0.02,-1.0,-0.0,4.039039611816406,224.58851261807672,2,222,-34,674,457,1731,911,28
-1,0,0.02,-1.0,-0.0,4.049013137817383,225.5770378385176,2,223,-34,674,457,1731,911,28
-1,0,0.02,-1.0,-0.0,4.056992769241333,226.56566377101365,2,224,-34,674,457,1731,911,28
-1,0,0.02,-1.0,-0.0,4.065968990325928,227.55438910291315,2,225,-34,674,457,1731,911,28
-1,0,0.02,-1.0,-0.0,4.074952840805054,228.54321254414887,2,226,-34,674,457,1731,911,28
-1,0,0.02,-1.0,-0.0,4.083920478820801,229.53213282675696,2,227,-34,674,457,1731,911,28
-1,0,0.02,-1.0,-0.0,4.093893766403198,230.52114870440846,2,228,-34,674,457,1731,911,28
-1,0,0.02,-1.0,-0.0,4.101874351501465,231.51025895195227,2,229,-34,674,457,1731,911,28
-1,0,0.02,-1.0,-0.0,4.109851121902466,232.4994623649698,2,230,-34,674,457,1731,911,28
-1,0,0.02,-1.0,-0.0,4.119826316833496,233.48875775934053,2,231,-34,674,457,1731,911,28
-1,0,0.02,-1.0,-0.0,4.127804756164551,234.47814397081873,2,232,-34,674,457,1731,911,28
-1,0,0.02,-1.0,-0.0,4.1347856521606445,235.46761985462035,2,233,-34,674,457,1731,911,28
-1,0,0.02,-1.0,-0.0,4.144758701324463,236.4571842850202,2,234,-34,674,457,1731,911,28
-1,0,0.02,-1.0,-0.0,4.1527509689331055,237.44683615495913,2,235,-34,674,457,1731,911,28
-1,0,0.02,-1.0,-0.0,4.160722732543945,238.43657437566074,2,236,-34,674,457,1731,911,28
-1,0,0.02,-1.0,-0.0,4.168695449829102,239.42639787625757,2,237,-34,674,457,1731,911,28
-1,0,0.02,-1.0,-0.0,4.1766746044158936,240.41630560342617,2,238,-34,674,457,1731,911,28
-1,0,0.02,-1.0,-0.0,4.184662818908691,241.40629652103112,2,239,-34,674,457,1731,911,28
-1,0,0.02,-1.0,-0.0,4.192631959915161,242.39636960977776,2,240,-34,674,457,1731,911,28
-1,0,0.02,-1.0,-0.0,4.202780246734619,243.38652386687312,2,241,-34,674,457,1731,911,28
-1,0,0.02,-1.0,-0.0,4.211758136749268,244.37675830569486,2,242,-34,674,457,1731,911,28
-1,0,0.02,-1.0,-0.0,4.219735622406006,245.3670719554684,2,243,-34,674,457,1731,911,28
-1,0,0.02,-1.0,-0.0,4.2267186641693115,246.35746386095144,2,244,-34,674,457,1731,911,28
-1,0,0.02,-1.0,-0.0,4.23570704460144,247.34793308212625,2,245,-34,674,457,1731,911,28
-1,0,0.02,-1.0,-0.0,4.243673086166382,248.33847869389874,2,246,-34,674,457,1731,911,28
-1,0,0.02,-1.0,-0.0,4.250653982162476,249.3290997858052,2,247,-34,674,457,1731,911,28
-1,0,0.02,-1.0,-0.0,4.258633613586426,250.3197954617253,2,248,-34,674,457,1731,911,28
-1,0,0.02,-1.0,-0.0,4.267609119415283,251.3105648396024,2,249,-34,674,457,1731,911,28
-1,0,0.02,-1.0,-0.0,4.274589538574219,252.30140705116966,2,250,-34,674,457,1731,911,28
-1,0,0.02,-1.0,-0.0,4.283566474914551,253.2923212416831,2,251,-34,674,457,1731,911,28
-1,0,0.02,-1.0,-0.0,4.2925426959991455,254.2833065696606,2,252,-34,674,457,1731,911,28
-1,0,0.02,-1.0,-0.0,4.301517963409424,255.27436220662662,2,253,-34,674,457,1731,911,28
-1,0,0.02,-1.0,-0.0,4.311491966247559,256.2654873368632,2,254,-34,674,457,1731,911,28
-1,0,0.02,-1.0,-0.0,4.318473815917969,257.25668115716644,2,255,-34,674,457,1731,911,28
-1,0,0.02,-1.0,-0.0,4.327449798583984,258.2479428766084,2,256,-34,674,457,1731,911,28
-1,0,0.02,-1.0,-0.0,4.337422132492065,259.2392717163046,2,257,-34,674,457,1731,911,28
-1,0,0.02,-1.0,-0.0,4.34440541267395,260.23066690918654,2,258,-34,674,457,1731,911,28
-1,0,0.02,-1.0,-0.0,4.3533806800842285,261.22212769977966,2,259,-34,674,457,1731,911,28
-1,0,0.02,-1.0,-0.0,4.3623576164245605,262.21365334398587,2,260,-34,674,457,1731,911,28
-1,0,0.02,-1.0,-0.0,4.371333122253418,263.20524310887123,2,261,-34,674,457,1731,911,28
-1,0,0.02,-1.0,-0.0,4.381306886672974,264.1968962724581,2,262,-34,674,457,1731,911,28
-1,0,0.02,-1.0,-0.0,4.388299465179443,265.1886121235224,2,263,-34,674,457,1731,911,28
-1,0,0.02,-1.0,-0.0,4.3982603549957275,266.18038996139444,2,264,-34,674,457,1731,911,28
-1,0,0.02,-1.0,-0.0,4.405243396759033,267.1722290957651,2,265,-34,674,457,1731,911,28
-1,0,0.02,-1.0,-0.0,4.414219856262207,268.16412884649577,2,266,-34,674,457,1731,911,28
-1,0,0.02,-1.0,-0.0,4.423203706741333,269.15608854343236,2,267,-34,674,457,1731,911,28
-1,0,0.02,-1.0,-0.0,4.433181047439575,270.1481075262235,2,268,-34,674,457,1731,911,28
-1,0,0.02,-1.0,-0.0,4.443141460418701,271.1401851441427,2,269,-34,674,457,1731,911,28
-1,0,0.02,-1.0,-0.0,4.450124025344849,272.13232075591463,2,270,-34,674,457,1731,911,28
-1,0,0.02,-1.0,-0.0,4.459100246429443,273.1245137295442,2,271,-34,674,457,1731,911,28
-1,0,0.02,-1.0,-0.0,4.469073295593262,274.11676344215067,2,272,-34,674,457,1731,911,28
-1,0,0.02,-1.0,-0.0,4.481041193008423,275.10906927980403,2,273,-34,674,457,1731,911,28
-1,0,0.02,-1.0,-0.0,4.488021612167358,276.1014306373656,2,274,-34,674,457,1731,911,28
-1,0,0.02,-1.0,-0.0,4.497994899749756,277.09384691833196,2,275,-34,674,457,1731,911,28
-1,0,0.02,-1.0,-0.0,4.504977226257324,278.08631753468205,2,276,-34,674,457,1731,911,28
-1,0,0.02,-1.0,-0.0,4.5139546394348145,279.0788419067271,2,277,-34,674,457,1731,911,28
-1,0,0.02,-1.0,-0.0,4.5219361782073975,280.07141946296485,2,278,-34,674,457,1731,911,28
-1,0,0.02,-1.0,-0.0,4.5319061279296875,281.06404963993526,2,279,-34,674,457,1731,911,28
-1,0,0.02,-1.0,-0.0,4.538887977600098,282.0567318820808,2,280,-34,674,457,1731,911,28
-1,0,0.02,-1.0,-0.0,4.548861503601074,283.0494656416083,2,281,-34,674,457,1731,911,28
-1,0,0.02,-1.0,-0.0,4.555842399597168,284.0422503783548,2,282,-34,674,457,1731,911,28
-1,0,0.02,-1.0,-0.0,4.565826416015625,285.0350855596553,2,283,-34,674,457,1731,911,28
-1,0,0.02,-1.0,-0.0,4.572796106338501,286.02797066021355,2,284,-34,674,457,1731,911,28
-1,0,0.02,-1.0,-0.0,4.582771301269531,287.020905161976,2,285,-34,674,457,1731,911,28
-1,0,0.02,-1.0,-0.0,4.589752197265625,288.01388855400705,2,286,-34,674,457,1731,911,28
-1,0,0.02,-1.0,-0.0,4.5987327098846436,289.0069203323685,2,287,-34,674,457,1731,911,28
-1,0,0.01,-1.0,-0.0,4.607704162597656,290.0,2,288,-34,674,457,1731,911,28
-1,0,0.01,-1.0,-0.0,4.616680145263672,290.9931270666027,2,289,-34,674,457,1731,911,28
-1,0,0.01,-1.0,-0.0,4.625656843185425,291.9863010485252,2,290,-34,674,457,1731,911,28
-1,0,0.01,-1.0,-0.0,4.63463282585144,292.97952146865146,2,291,-34,674,457,1731,911,28
-1,0,0.01,-1.0,-0.0,4.643609523773193,293.97278785629123,2,292,-34,674,457,1731,911,28
-1,0,0.01,-1.0,-0.0,4.652585029602051,294.96609974707263,2,293,-34,674,457,1731,911,28
-1,0,0.01,-1.0,-0.0,4.661561012268066,295.9594566828369,2,294,-34,674,457,1731,911,28
-1,0,0.01,-1.0,-0.0,4.670537710189819,296.952858211535,2,295,-34,674,457,1731,911,28
-1,0,0.01,-1.0,-0.0,4.679513931274414,297.9463038871266,2,296,-34,674,457,1731,911,28
-1,0,0.01,-1.0,-0.0,4.689486265182495,298.93979326948096,2,297,-34,674,457,1731,911,28
-1,0,0.01,-1.0,-0.0,4.697465419769287,299.93332592427936,2,298,-34,674,457,1731,911,28
-1,0,0.01,-1.0,-0.0,4.704447269439697,300.9269014229203,2,299,-34,674,457,1731,911,28
-1,0,0.01,-1.0,-0.0,4.713423252105713,301.9205193424256,2,300,-34,674,457,1731,911,28
-1,0,0.01,-1.0,-0.0,4.723396301269531,302.914179265349,2,301,-34,674,457,1731,911,28
-1,0,0.01,-1.0,-0.0,4.731374502182007,303.90788077968625,2,302,-34,674,457,1731,911,28
-1,0,0.01,-1.0,-0.0,4.738356590270996,304.90162347878703,2,303,-34,674,457,1731,911,28
-1,0,0.01,-1.0,-0.0,4.7473320960998535,305.8954069612684,2,304,-34,674,457,1731,911,28
-1,0,0.01,-1.0,-0.0,4.755310773849487,306.8892308309303,2,305,-34,674,457,1731,911,28
-1,0,0.01,-1.0,-0.0,4.76528525352478,307.8830946966722,2,306,-34,674,457,1731,911,28
-1,0,0.01,-1.0,-0.0,4.772265434265137,308.8769981724117,2,307,-34,674,457,1731,911,28
-1,0,0.01,-1.0,-0.0,4.782240629196167,309.87094087700444,2,308,-34,674,457,1731,911,28
-1,0,0.01,-1.0,-0.0,4.789220094680786,310.8649224341659,2,309,-34,674,457,1731,911,28
-1,0,0.01,-1.0,-0.0,4.7991955280303955,311.85894247239406,2,310,-34,674,457,1731,911,28
-1,0,0.01,-1.0,-0.0,4.806176424026489,312.8530006248941,2,311,-34,674,457,1731,911,28
-1,0,0.01,-1.0,-0.0,4.816149711608887,313.8470965295043,2,312,-34,674,457,1731,911,28
-1,0,0.01,-1.0,-0.0,4.8261237144470215,314.8412298286233,2,313,-34,674,457,1731,911,28
-1,0,0.01,-1.0,-0.0,4.836097478866577,315.8354001691387,2,314,-34,674,457,1731,911,28
-1,0,0.01,-1.0,-0.0,4.84806489944458,316.8296072023573,2,315,-34,674,457,1731,911,28
-1,0,0.01,-1.0,-0.0,4.8560426235198975,317.8238505839359,2,316,-34,674,457,1731,911,28
-1,0,0.01,-1.0,-0.0,4.865019798278809,318.8181299738144,2,317,-34,674,457,1731,911,28
-1,0,0.01,-1.0,-0.0,4.872997999191284,319.81244503614926,2,318,-34,674,457,1731,911,28
-1,0,0.01,-1.0,-0.0,4.881975173950195,320.8067954392488,2,319,-34,674,457,1731,911,28
-1,0,0.01,-1.0,-0.0,4.890951156616211,321.80118085550896,2,320,-34,674,457,1731,911,28
-1,0,0.01,-1.0,-0.0,4.899925947189331,322.7956009613514,2,321,-34,674,457,1731,911,28
-1,0,0.01,-1.0,-0.0,4.908902645111084,323.7900554371613,2,322,-34,674,457,1731,911,28
-1,0,0.01,-1.0,-0.0,4.917877912521362,324.7845439672276,2,323,-34,674,457,1731,911,28
-1,0,0.01,-1.0,-0.0,4.926855087280273,325.77906623968335,2,324,-34,674,457,1731,911,28
-1,0,0.01,-1.0,-0.0,4.935842275619507,326.7736219464478,2,325,-34,674,457,1731,911,28
-1,0,0.01,-1.0,-0.0,4.944809198379517,327.76821078316914,2,326,-34,674,457,1731,911,28
-1,0,0.01,-1.0,-0.0,4.954781532287598,328.76283244916846,2,327,-34,674,457,1731,911,28
-1,0,0.01,-1.0,-0.0,4.961762428283691,329.75748664738455,2,328,-34,674,457,1731,911,28
-1,0,0.01,-1.0,-0.0,4.970738410949707,330.75217308432,2,329,-34,674,457,1731,911,28
-1,0,0.01,-1.0,-0.0,4.97871994972229,331.746891469988,2,330,-34,674,457,1731,911,28
-1,0,0.01,-1.0,-0.0,4.987692832946777,332.74164151785993,2,331,-34,674,457,1731,911,28
-1,0,0.01,-1.0,-0.0,4.996682405471802,333.73642294481436,2,332,-34,674,457,1731,911,28
-1,0,0.01,-1.0,-0.0,5.005645513534546,334.73123547108656,2,333,-34,674,457,1731,911,28
-1,0,0.01,-1.0,-0.0,5.015619516372681,335.72607882021913,2,334,-34,674,457,1731,911,28
-1,0,0.01,-1.0,-0.0,5.022602558135986,336.7209527190133,2,335,-34,674,457,1731,911,28
-1,0,0.01,-1.0,-0.0,5.030595541000366,337.7158568974812,2,336,-34,674,457,1731,911,28
-1,0,0.01,-1.0,-0.0,5.038556814193726,338.71079108879894,2,337,-34,674,457,1731,911,28
-1,0,0.01,-1.0,-0.0,5.049542665481567,339.70575502926056,2,338,-34,674,457,1731,911,28
-1,0,0.01,-1.0,-0.0,5.056512355804443,340.7007484582328,2,339,-34,674,457,1731,911,28
-1,0,0.01,-1.0,-0.0,5.065486192703247,341.69577111811026,2,340,-34,674,457,1731,911,28
-1,0,0.01,-1.0,-0.0,5.072468280792236,342.6908227542722,2,341,-34,674,457,1731,911,28
-1,0,0.01,-1.0,-0.0,5.082441806793213,343.685903115039,2,342,-34,674,457,1731,911,28
-1,0,0.01,-1.0,-0.0,5.089422702789307,344.6810119516304,2,343,-34,674,457,1731,911,28
-1,0,0.01,-1.0,-0.0,5.099395275115967,345.6761490181236,2,344,-34,674,457,1731,911,28
-1,0,0.01,-1.0,-0.0,5.10737419128418,346.6713140714126,2,345,-34,674,457,1731,911,28
-1,0,0.01,-1.0,-0.0,5.116350173950195,347.6665068711681,2,346,-34,674,457,1731,911,28
-1,0,0.01,-1.0,-0.0,5.123332977294922,348.66172717979816,2,347,-34,674,457,1731,911,28
-1,0,0.01,-1.0,-0.0,5.133305311203003,349.6569747624091,2,348,-34,674,457,1731,911,28
-1,0,0.01,-1.0,-0.0,5.140291690826416,350.6522493867678,2,349,-34,674,457,1731,911,28
-1,0,0.01,-1.0,-0.0,5.148286819458008,351.64755082326394,2,350,-34,674,457,1731,911,28
-1,0,0.01,-1.0,-0.0,5.155246734619141,352.64287884487334,2,351,-34,674,457,1731,911,28
-1,0,0.01,-1.0,-0.0,5.1642231941223145,353.63823322712153,2,352,-34,674,457,1731,911,28
-1,0,0.01,-1.0,-0.0,5.172202825546265,354.63361374804845,2,353,-34,674,457,1731,911,28
-1,0,0.01,-1.0,-0.0,5.1831724643707275,355.62902018817306,2,354,-34,674,457,1731,911,28
