dx,dy,button,rx,ry,time,distance,targetID,directionX,directionY,targetX,targetY,initMouseX,initMouseY,targetSize
0,4,0.01,-0.0,4.0,0.04188895225524902,516.0769905631685,1,279,446,1047,832,768,382,20
2,3,0.11,2.0,3.0,0.049868106842041016,512.4729658078014,1,277,443,1047,832,768,382,20
0,5,0.01,-0.0,5.0,0.0578460693359375,508.2402917566329,1,277,438,1047,832,768,382,20
0,5,0.0,-0.0,5.0,0.06682395935058594,504.02140033270985,1,277,433,1047,832,768,382,20
2,8,0.0,2.0,8.0,0.07480096817016602,496.2114182829147,1,275,425,1047,832,768,382,20
-1,10,0.0,-1.0,10.0,0.08280777931213379,488.39843498951717,1,276,415,1047,832,768,382,20
-2,14,0.0,-2.0,14.0,0.09275293350219727,477.93954543570254,1,278,401,1047,832,768,382,20
-2,8,0.0,-2.0,8.0,0.10073161125183105,472.54429848460546,1,280,393,1047,832,768,382,20
2,10,0.0,2.0,10.0,0.11070561408996582,463.25785783228156,1,278,383,1047,832,768,382,20
1,15,0.0,1.0,15.0,0.11868596076965332,450.6006947454595,1,277,368,1047,832,768,382,20
3,14,0.0,3.0,14.0,0.12865734100341797,437.6516502817788,1,274,354,1047,832,768,382,20
3,9,0.0,3.0,9.0,0.13663697242736816,428.70947106257006,1,271,345,1047,832,768,382,20
-1,7,0.0,-1.0,7.0,0.14661026000976562,423.85250950063664,1,272,338,1047,832,768,382,20
2,12,0.0,2.0,12.0,0.1545884609222412,413.2918614856657,1,270,326,1047,832,768,382,20
6,10,0.0,6.0,10.0,0.16359639167785645,401.7669243637716,1,264,316,1047,832,768,382,20
3,14,0.0,3.0,14.0,0.17254209518432617,389.15535822534065,1,261,302,1047,832,768,382,20
4,8,0.0,4.0,8.0,0.1815176010131836,380.4932777910524,1,257,294,1047,832,768,382,20
7,13,0.0,7.0,13.0,0.1904923915863037,366.1130149303531,1,250,281,1047,832,768,382,20
3,12,0.0,3.0,12.0,0.19946813583374023,355.1985761198967,1,247,269,1047,832,768,382,20
3,8,0.0,3.0,8.0,0.2094426155090332,347.2911977645125,1,244,261,1047,832,768,382,20
6,8,0.0,6.0,8.0,0.21942949295043945,337.3514070793438,1,238,253,1047,832,768,382,20
6,7,0.0,6.0,7.0,0.22739577293395996,328.1419820134731,1,232,246,1047,832,768,382,20
7,8,0.0,7.0,8.0,0.23736834526062012,317.51946507039855,1,225,238,1047,832,768,382,20
6,6,0.0,6.0,6.0,0.24734091758728027,309.03761533712606,1,219,232,1047,832,768,382,20
7,5,0.0,7.0,5.0,0.25531983375549316,300.60103026229643,1,212,227,1047,832,768,382,20
6,4,0.0,6.0,4.0,0.26329851150512695,293.58689036254515,1,206,223,1047,832,768,382,20
6,3,0.0,6.0,3.0,0.2722761631011963,287.3213749463701,1,200,220,1047,832,768,382,20
5,2,0.0,5.0,2.0,0.28025317192077637,282.4876065750479,1,195,218,1047,832,768,382,20
6,2,0.0,6.0,2.0,0.2892298698425293,277.0139369438355,1,189,216,1047,832,768,382,20
6,2,0.0,6.0,2.0,0.29920291900634766,271.5759222660915,1,183,214,1047,832,768,382,20
5,1,0.0,5.0,1.0,0.3081789016723633,267.58422145359776,1,178,213,1047,832,768,382,20
5,2,0.0,5.0,2.0,0.31615734100341797,262.8552729928451,1,173,211,1047,832,768,382,20
4,2,0.0,4.0,2.0,0.3251335620880127,258.77871939571406,1,169,209,1047,832,768,382,20
3,3,0.0,3.0,3.0,0.33211469650268555,254.5600120955546,1,166,206,1047,832,768,382,20
3,3,0.0,3.0,3.0,0.3410913944244385,250.34208265280512,1,163,203,1047,832,768,382,20
3,3,0.0,3.0,3.0,0.3500683307647705,246.12496949731394,1,160,200,1047,832,768,382,20
3,5,0.0,3.0,5.0,0.36004090309143066,240.34775812856802,1,157,195,1047,832,768,382,20
4,5,0.0,4.0,5.0,0.3670229911804199,233.9446658568291,1,153,190,1047,832,768,382,20
4,6,0.0,4.0,6.0,0.3769958019256592,226.76359517459605,1,149,184,1047,832,768,382,20
4,7,0.03,4.0,7.0,0.38397645950317383,218.80996481796853,1,145,177,1047,832,768,382,20
5,8,0.04,5.0,8.0,0.3949470520019531,209.45614596087302,1,140,169,1047,832,768,382,20
5,9,0.03,5.0,9.0,0.4029271602630615,199.34421415458323,1,135,160,1047,832,768,382,20
5,9,0.01,5.0,9.0,0.4138965606689453,189.25109786397664,1,130,151,1047,832,768,382,20
4,10,0.01,4.0,10.0,0.4218759536743164,179.0952141118331,1,126,141,1047,832,768,382,20
4,10,0.0,4.0,10.0,0.429854154586792,169.0111728356641,1,122,131,1047,832,768,382,20
4,10,0.0,4.0,10.0,0.4388306140899658,159.01183390520322,1,118,121,1047,832,768,382,20
3,10,0.0,3.0,10.0,0.4468400478363037,149.8311609167624,1,115,111,1047,832,768,382,20
3,10,0.0,3.0,10.0,0.45479297637939453,140.81445554057476,1,112,101,1047,832,768,382,20
3,10,0.0,3.0,10.0,0.46376943588256836,131.9929575718458,1,109,91,1047,832,768,382,20
3,9,0.0,3.0,9.0,0.47174835205078125,124.01492454200763,1,106,82,1047,832,768,382,20
3,9,0.0,3.0,9.0,0.480724573135376,116.24579200908045,1,103,73,1047,832,768,382,20
3,8,0.0,3.0,8.0,0.4896998405456543,109.26860441876563,1,100,65,1047,832,768,382,20
3,7,0.0,3.0,7.0,0.4976785182952881,103.01769772916099,1,97,58,1047,832,768,382,20
3,6,0.0,3.0,6.0,0.5066554546356201,97.42439201596628,1,94,52,1047,832,768,382,20
3,5,0.0,3.0,5.0,0.5146331787109375,92.42070103255493,1,91,47,1047,832,768,382,20
3,4,0.0,3.0,4.0,0.5236093997955322,87.94386147176351,1,88,43,1047,832,768,382,20
4,3,0.0,4.0,3.0,0.531588077545166,83.03762679690406,1,84,40,1047,832,768,382,20
4,2,0.0,4.0,2.0,0.5395667552947998,78.56635930193812,1,80,38,1047,832,768,382,20
5,1,0.0,5.0,1.0,0.5485432147979736,73.6301381082203,1,75,37,1047,832,768,382,20
5,0,0.0,5.0,-0.0,0.5575194358825684,69.17701686727027,1,70,37,1047,832,768,382,20
5,0,0.0,5.0,-0.0,0.566495418548584,64.79304780526061,1,65,37,1047,832,768,382,20
5,0,0.0,5.0,-0.0,0.5764689445495605,60.49113419430843,1,60,37,1047,832,768,382,20
4,-1,0.0,4.0,-1.0,0.5854454040527344,57.675697262754525,1,56,38,1047,832,768,382,20
4,-1,0.0,4.0,-1.0,0.5954325199127197,55.0,1,52,39,1047,832,768,382,20
3,-1,0.0,3.0,-1.0,0.6033973693847656,53.25345840347388,1,49,40,1047,832,768,382,20
2,-1,0.0,2.0,-1.0,0.6133699417114258,52.369864518050704,1,47,41,1047,832,768,382,20
2,-1,0.0,2.0,-1.0,0.6203515529632568,51.554853586049575,1,45,42,1047,832,768,382,20
1,-1,0.0,1.0,-1.0,0.6293275356292725,51.5223536610881,1,44,43,1047,832,768,382,20
1,-1,0.0,1.0,-1.0,0.6363101005554199,51.5223536610881,1,43,44,1047,832,768,382,20
1,-1,0.0,1.0,-1.0,0.6462826728820801,51.554853586049575,1,42,45,1047,832,768,382,20
1,0,0.02,1.0,-0.0,0.6552586555480957,50.876925020897694,1,41,45,1047,832,768,382,20
1,0,0.05,1.0,-0.0,0.6632370948791504,50.207972893961475,1,40,45,1047,832,768,382,20
1,0,0.1,1.0,-0.0,0.6712172031402588,49.54829972383762,1,39,45,1047,832,768,382,20
1,1,0.18,1.0,1.0,0.6811892986297607,48.137767414994535,1,38,44,1047,832,768,382,20
1,1,0.23,1.0,1.0,0.6891682147979736,46.72741841473134,1,37,43,1047,832,768,382,20
1,2,0.31,1.0,2.0,0.6981439590454102,44.56189146281496,1,36,41,1047,832,768,382,20
1,2,0.32,1.0,2.0,0.7081172466278076,42.40229002629561,1,35,39,1047,832,768,382,20
1,2,0.45,1.0,2.0,0.7160959243774414,40.24937810560445,1,34,37,1047,832,768,382,20
1,2,0.48,1.0,2.0,0.7260696887969971,38.104053883222775,1,33,35,1047,832,768,382,20
1,3,0.38,1.0,3.0,0.7340490818023682,35.254833995939045,1,32,32,1047,832,768,382,20
1,3,0.41,1.0,3.0,0.7440214157104492,32.44997055358225,1,31,29,1047,832,768,382,20
0,3,0.37,-0.0,3.0,0.7520005702972412,30.45985664828782,1,31,26,1047,832,768,382,20
0,3,0.44,-0.0,3.0,0.7619738578796387,28.600518131237564,1,31,23,1047,832,768,382,20
0,3,0.47,-0.0,3.0,0.7699539661407471,26.89173349139343,1,31,20,1047,832,768,382,20
0,3,0.42,-0.0,3.0,0.7789297103881836,25.355339059327378,1,31,17,1047,832,768,382,20
1,2,0.46,1.0,2.0,0.7879166603088379,23.541019662496844,1,30,15,1047,832,768,382,20
1,2,0.45,1.0,2.0,0.7968811988830566,21.78049716414141,1,29,13,1047,832,768,382,20
1,2,0.42,1.0,2.0,0.8068544864654541,20.083217912982647,1,28,11,1047,832,768,382,20
1,2,0.34,1.0,2.0,0.813835859298706,18.460498941515414,1,27,9,1047,832,768,382,20
1,1,0.31,1.0,1.0,0.8238101005554199,17.202941017470888,1,26,8,1047,832,768,382,20
2,1,0.3,2.0,1.0,0.8337831497192383,15.0,1,24,7,1047,832,768,382,20
2,1,0.21,2.0,1.0,0.8417620658874512,12.803508501982758,1,22,6,1047,832,768,382,20
2,1,0.13,2.0,1.0,0.8498387336730957,10.615528128088304,1,20,5,1047,832,768,382,20
2,0,0.07,2.0,-0.0,0.8578181266784668,8.681541692269406,1,18,5,1047,832,768,382,20
2,0,0.06,2.0,-0.0,0.8667938709259033,6.763054614240211,1,16,5,1047,832,768,382,20
2,0,0.06,2.0,-0.0,0.876767635345459,4.866068747318506,1,14,5,1047,832,768,382,20
1,0,0.06,1.0,-0.0,0.883751392364502,3.928388277184119,1,13,5,1047,832,768,382,20
1,0,0.09,1.0,-0.0,0.8947198390960693,3.0,1,12,5,1047,832,768,382,20
0,0,0.11,-0.0,-0.0,0.9017002582550049,3.0,1,12,5,1047,832,768,382,20
0,0,0.13,-0.0,-0.0,0.9106771945953369,3.0,1,12,5,1047,832,768,382,20
0,0,0.16,-0.0,-0.0,0.9186553955078125,3.0,1,12,5,1047,832,768,382,20
0,-1,0.17,-0.0,-1.0,0.9286289215087891,3.416407864998739,1,12,6,1047,832,768,382,20
0,-1,0.24,-0.0,-1.0,0.9356100559234619,3.892443989449804,1,12,7,1047,832,768,382,20
0,-1,0.28,-0.0,-1.0,0.9455840587615967,4.4222051018559565,1,12,8,1047,832,768,382,20
0,-1,0.35,-0.0,-1.0,0.9537646770477295,5.0,1,12,9,1047,832,768,382,20
-1,-1,0.34,-1.0,-1.0,0.9627394676208496,6.401219466856727,1,13,10,1047,832,768,382,20
-1,0,0.31,-1.0,-0.0,0.9717166423797607,7.204650534085253,1,14,10,1047,832,768,382,20
-1,0,0.35,-1.0,-0.0,0.9816889762878418,8.027756377319946,1,15,10,1047,832,768,382,20
-1,0,0.41,-1.0,-0.0,0.989668607711792,8.867962264113206,1,16,10,1047,832,768,382,20
0,0,0.56,-0.0,-0.0,0.9986441135406494,8.867962264113206,1,16,10,1047,832,768,382,20
0,0,0.8,-0.0,-0.0,0.008976221084594727,370.2759845197772,2,285,271,1316,1093,1031,822,46
0,0,0.89,-0.0,-0.0,0.017951488494873047,370.2759845197772,2,285,271,1316,1093,1031,822,46
0,0,0.8,-0.0,-0.0,0.027925729751586914,370.2759845197772,2,285,271,1316,1093,1031,822,46
2,0,0.3,2.0,-0.0,0.0359041690826416,368.8290443548053,2,283,271,1316,1093,1031,822,46
2,1,0.2,2.0,1.0,0.04488015174865723,366.69346928066426,2,281,270,1316,1093,1031,822,46
3,2,0.39,3.0,2.0,0.05436229705810547,363.1450504667903,2,278,268,1316,1093,1031,822,46
2,3,0.0,2.0,3.0,0.06234598159790039,359.623836162882,2,276,265,1316,1093,1031,822,46
2,3,0.0,2.0,3.0,0.06932234764099121,356.1042073098108,2,274,262,1316,1093,1031,822,46
4,3,0.0,4.0,3.0,0.0773003101348877,351.14034799791375,2,270,259,1316,1093,1031,822,46
4,4,0.0,4.0,4.0,0.08527970314025879,345.48473509766995,2,266,255,1316,1093,1031,822,46
5,4,0.01,5.0,4.0,0.09425640106201172,339.1077187799233,2,261,251,1316,1093,1031,822,46
3,5,0.0,3.0,5.0,0.10123658180236816,333.4828186603107,2,258,246,1316,1093,1031,822,46
5,6,0.0,5.0,6.0,0.11121058464050293,325.72481987951477,2,253,240,1316,1093,1031,822,46
5,6,0.0,5.0,6.0,0.11918830871582031,317.96920682079195,2,248,234,1316,1093,1031,822,46
5,8,0.0,5.0,8.0,0.12816500663757324,308.85087012090236,2,243,226,1316,1093,1031,822,46
7,8,0.0,7.0,8.0,0.13614344596862793,298.27869521647403,2,236,218,1316,1093,1031,822,46
8,7,0.0,8.0,7.0,0.14512014389038086,287.65253902068787,2,228,211,1316,1093,1031,822,46
7,8,0.0,7.0,8.0,0.1521012783050537,277.0833217624732,2,221,203,1316,1093,1031,822,46
9,8,0.0,9.0,8.0,0.163071870803833,265.0433995077825,2,212,195,1316,1093,1031,822,46
9,8,0.0,9.0,8.0,0.17005348205566406,253.0036231646244,2,203,187,1316,1093,1031,822,46
9,9,0.0,9.0,9.0,0.17803239822387695,240.28691574022434,2,194,178,1316,1093,1031,822,46
9,8,0.0,9.0,8.0,0.1850135326385498,228.24689052802225,2,185,170,1316,1093,1031,822,46
8,8,0.0,8.0,8.0,0.19498705863952637,216.94374340665772,2,177,162,1316,1093,1031,822,46
7,8,0.0,7.0,8.0,0.20296645164489746,206.38177782901587,2,170,154,1316,1093,1031,822,46
6,7,0.0,6.0,7.0,0.21194148063659668,197.238507078122,2,164,147,1316,1093,1031,822,46
6,6,0.0,6.0,6.0,0.2209181785583496,188.7663807123312,2,158,141,1316,1093,1031,822,46
6,6,0.0,6.0,6.0,0.22989368438720703,180.2953516438583,2,152,135,1316,1093,1031,822,46
6,5,0.0,6.0,5.0,0.23886966705322266,172.48913013259843,2,146,130,1316,1093,1031,822,46
6,5,0.0,6.0,5.0,0.24884343147277832,164.6832437912346,2,140,125,1316,1093,1031,822,46
6,5,0.0,6.0,5.0,0.2568223476409912,156.8777362543792,2,134,120,1316,1093,1031,822,46
5,5,0.0,5.0,5.0,0.26579809188842773,149.81782315490494,2,129,115,1316,1093,1031,822,46
5,4,0.0,5.0,4.0,0.27477455139160156,143.42415690037308,2,124,111,1316,1093,1031,822,46
4,4,0.0,4.0,4.0,0.2837505340576172,137.77624202599088,2,120,107,1316,1093,1031,822,46
4,3,0.0,4.0,3.0,0.29372406005859375,132.79473675320358,2,116,104,1316,1093,1031,822,46
4,3,0.0,4.0,3.0,0.30170202255249023,127.81445554057476,2,112,101,1316,1093,1031,822,46
4,3,0.0,4.0,3.0,0.31267333030700684,122.83552379307312,2,108,98,1316,1093,1031,822,46
4,3,0.0,4.0,3.0,0.3196544647216797,117.85808461000738,2,104,95,1316,1093,1031,822,46
4,3,0.0,4.0,3.0,0.3286309242248535,112.88230201170424,2,100,92,1316,1093,1031,822,46
3,3,0.0,3.0,3.0,0.3366096019744873,108.64345787011217,2,97,89,1316,1093,1031,822,46
3,3,0.0,3.0,3.0,0.3475806713104248,104.40486646906389,2,94,86,1316,1093,1031,822,46
3,3,0.0,3.0,3.0,0.3555591106414795,100.1665539016173,2,91,83,1316,1093,1031,822,46
3,3,0.0,3.0,3.0,0.3645350933074951,95.92854997854805,2,88,80,1316,1093,1031,822,46
3,3,0.0,3.0,3.0,0.37351107597351074,91.69088891450794,2,85,77,1316,1093,1031,822,46
3,3,0.0,3.0,3.0,0.3834846019744873,87.45361017187261,2,82,74,1316,1093,1031,822,46
3,3,0.01,3.0,3.0,0.3914635181427002,83.21675950620975,2,79,71,1316,1093,1031,822,46
3,3,0.01,3.0,3.0,0.4004392623901367,78.9803902718557,2,76,68,1316,1093,1031,822,46
3,3,0.01,3.0,3.0,0.40941524505615234,74.74456506629922,2,73,65,1316,1093,1031,822,46
3,3,0.01,3.0,3.0,0.41839122772216797,70.50935782048768,2,70,62,1316,1093,1031,822,46
2,3,0.02,2.0,3.0,0.42836499214172363,67.02777349240623,2,68,59,1316,1093,1031,822,46
2,3,0.02,2.0,3.0,0.4363434314727783,63.55634003352961,2,66,56,1316,1093,1031,822,46
2,3,0.02,2.0,3.0,0.444321870803833,60.09632964216891,2,64,53,1316,1093,1031,822,46
2,2,0.03,2.0,2.0,0.4523005485534668,57.2807573457052,2,62,51,1316,1093,1031,822,46
2,2,0.04,2.0,2.0,0.4612770080566406,54.466121627457255,2,60,49,1316,1093,1031,822,46
2,2,0.05,2.0,2.0,0.4682581424713135,51.65252842335616,2,58,47,1316,1093,1031,822,46
2,2,0.06,2.0,2.0,0.4772341251373291,48.84010022264724,2,56,45,1316,1093,1031,822,46
2,2,0.06,2.0,2.0,0.48421621322631836,46.02897942168927,2,54,43,1316,1093,1031,822,46
2,2,0.08,2.0,2.0,0.4941897392272949,43.21933252457322,2,52,41,1316,1093,1031,822,46
2,2,0.09,2.0,2.0,0.5021681785583496,40.41135544995076,2,50,39,1316,1093,1031,822,46
1,2,0.11,1.0,2.0,0.5131387710571289,38.40032573203501,2,49,37,1316,1093,1031,822,46
1,1,0.14,1.0,1.0,0.5201206207275391,37.0,2,48,36,1316,1093,1031,822,46
1,1,0.15,1.0,1.0,0.5300936698913574,35.60034129593445,2,47,35,1316,1093,1031,822,46
1,1,0.16,1.0,1.0,0.5380721092224121,34.201398584300364,2,46,34,1316,1093,1031,822,46
1,1,0.19,1.0,1.0,0.5480458736419678,32.80322571321482,2,45,33,1316,1093,1031,822,46
1,1,0.27,1.0,1.0,0.555027961730957,31.405882034941776,2,44,32,1316,1093,1031,822,46
1,1,0.34,1.0,1.0,0.5640032291412354,30.009433122794285,2,43,31,1316,1093,1031,822,46
1,1,0.34,1.0,1.0,0.5729801654815674,28.61395160225576,2,42,30,1316,1093,1031,822,46
1,1,0.39,1.0,1.0,0.5819554328918457,27.219518117958877,2,41,29,1316,1093,1031,822,46
1,1,0.4,1.0,1.0,0.5919287204742432,25.82622246293481,2,40,28,1316,1093,1031,822,46
1,1,0.45,1.0,1.0,0.5989105701446533,24.434164902525687,2,39,27,1316,1093,1031,822,46
1,1,0.5,1.0,1.0,0.6088833808898926,23.04345773288535,2,38,26,1316,1093,1031,822,46
1,1,0.57,1.0,1.0,0.6168625354766846,21.654227123532216,2,37,25,1316,1093,1031,822,46
1,1,0.6,1.0,1.0,0.008976221084594727,1278.4983443697931,3,-1102,-658,178,411,1279,1068,10
-2,1,0.41,-2.0,1.0,0.018949270248413086,1277.2952078207265,3,-1100,-659,178,411,1279,1068,10
-1,0,0.71,-1.0,-0.0,0.029920578002929688,1276.4374740891574,3,-1099,-659,178,411,1279,1068,10
0,-1,0.19,-0.0,-1.0,0.03690171241760254,1275.9234949832094,3,-1099,-658,178,411,1279,1068,10
-1,0,0.0,-1.0,-0.0,0.04488062858581543,1275.0656233178047,3,-1098,-658,178,411,1279,1068,10
-4,0,0.02,-4.0,-0.0,0.052858591079711914,1271.636205032585,3,-1094,-658,178,411,1279,1068,10
-5,0,0.13,-5.0,-0.0,0.06083822250366211,1267.3541173745618,3,-1089,-658,178,411,1279,1068,10
-7,-2,0.05,-7.0,-2.0,0.0688161849975586,1260.3299964831308,3,-1082,-656,178,411,1279,1068,10
-10,-2,0.0,-10.0,-2.0,0.07680010795593262,1250.746789762968,3,-1072,-654,178,411,1279,1068,10
-9,-2,0.0,-9.0,-2.0,0.08477401733398438,1242.0256613237757,3,-1063,-652,178,411,1279,1068,10
-11,-5,0.0,-11.0,-5.0,0.09275293350219727,1230.035627016484,3,-1052,-647,178,411,1279,1068,10
-14,-6,0.0,-14.0,-6.0,0.10175037384033203,1214.9692619078564,3,-1038,-641,178,411,1279,1068,10
-15,-5,0.0,-15.0,-5.0,0.11170268058776855,1199.584990774831,3,-1023,-636,178,411,1279,1068,10
-14,-8,0.0,-14.0,-8.0,0.11968040466308594,1183.471707698589,3,-1009,-628,178,411,1279,1068,10
-12,-7,0.0,-12.0,-7.0,0.12966656684875488,1169.5850331074375,3,-997,-621,178,411,1279,1068,10
-11,-10,0.0,-11.0,-10.0,0.1376330852508545,1154.9642235862277,3,-986,-611,178,411,1279,1068,10
-13,-11,0.0,-13.0,-11.0,0.14760661125183105,1138.122478127344,3,-973,-600,178,411,1279,1068,10
-12,-11,0.0,-12.0,-11.0,0.15558695793151855,1122.1388556872662,3,-961,-589,178,411,1279,1068,10
-12,-12,0.0,-12.0,-12.0,0.1655590534210205,1105.6439573508694,3,-949,-577,178,411,1279,1068,10
-13,-12,0.0,-13.0,-12.0,0.17354083061218262,1088.3073675778464,3,-936,-565,178,411,1279,1068,10
-14,-12,0.0,-14.0,-12.0,0.18253469467163086,1070.1246439366926,3,-922,-553,178,411,1279,1068,10
-14,-12,0.0,-14.0,-12.0,0.19148945808410645,1051.950803017813,3,-908,-541,178,411,1279,1068,10
-15,-12,0.0,-15.0,-12.0,0.2004859447479248,1032.9258162315841,3,-893,-529,178,411,1279,1068,10
-17,-12,0.0,-17.0,-12.0,0.2094426155090332,1012.1848406263239,3,-876,-517,178,411,1279,1068,10
-18,-12,0.0,-18.0,-12.0,0.21841716766357422,990.5847527960641,3,-858,-505,178,411,1279,1068,10
-18,-11,0.0,-18.0,-11.0,0.22938919067382812,969.4926885308067,3,-840,-494,178,411,1279,1068,10
-18,-12,0.0,-18.0,-12.0,0.23636960983276367,947.8945377112832,3,-822,-482,178,411,1279,1068,10
-18,-12,0.0,-18.0,-12.0,0.24634289741516113,926.298018896207,3,-804,-470,178,411,1279,1068,10
-17,-12,0.0,-17.0,-12.0,0.2533249855041504,905.5674055225127,3,-787,-458,178,411,1279,1068,10
-17,-12,0.0,-17.0,-12.0,0.26329779624938965,884.8404351342998,3,-770,-446,178,411,1279,1068,10
-16,-12,0.0,-16.0,-12.0,0.2722744941711426,864.9839078971519,3,-754,-434,178,411,1279,1068,10
-15,-12,0.0,-15.0,-12.0,0.2812507152557373,846.002350173018,3,-739,-422,178,411,1279,1068,10
-14,-12,0.0,-14.0,-12.0,0.2892289161682129,827.9015548070493,3,-725,-410,178,411,1279,1068,10
-13,-11,0.0,-13.0,-11.0,0.2982044219970703,811.1770641227307,3,-712,-399,178,411,1279,1068,10
-13,-11,0.0,-13.0,-11.0,0.3061840534210205,794.4654464077856,3,-699,-388,178,411,1279,1068,10
-12,-10,0.0,-12.0,-10.0,0.31615638732910156,779.1256276898492,3,-687,-378,178,411,1279,1068,10
-12,-10,0.0,-12.0,-10.0,0.3251330852508545,763.7971123775114,3,-675,-368,178,411,1279,1068,10
-12,-10,0.0,-12.0,-10.0,0.3331115245819092,748.4805903273156,3,-663,-358,178,411,1279,1068,10
-11,-9,0.0,-11.0,-9.0,0.34109020233154297,734.5302563113967,3,-652,-349,178,411,1279,1068,10
-11,-9,0.0,-11.0,-9.0,0.3500661849975586,720.5901046734306,3,-641,-340,178,411,1279,1068,10
-10,-9,0.0,-10.0,-9.0,0.3590428829193115,707.5461388569865,3,-631,-331,178,411,1279,1068,10
-10,-9,0.0,-10.0,-9.0,0.36801934242248535,694.5176909842953,3,-621,-322,178,411,1279,1068,10
-10,-9,0.0,-10.0,-9.0,0.3779919147491455,681.5056445507204,3,-611,-313,178,411,1279,1068,10
-10,-8,0.0,-10.0,-8.0,0.3859703540802002,668.9629069911786,3,-601,-305,178,411,1279,1068,10
-10,-8,0.0,-10.0,-8.0,0.3969414234161377,656.430268433491,3,-591,-297,178,411,1279,1068,10
-10,-8,0.0,-10.0,-8.0,0.4049203395843506,643.908314016703,3,-581,-289,178,411,1279,1068,10
-10,-8,0.0,-10.0,-8.0,0.4138967990875244,631.3976744143555,3,-571,-281,178,411,1279,1068,10
-10,-8,0.0,-10.0,-8.0,0.42287230491638184,618.8990302925627,3,-561,-273,178,411,1279,1068,10
-10,-7,0.0,-10.0,-7.0,0.4328453540802002,606.8472031479755,3,-551,-266,178,411,1279,1068,10
-10,-7,0.0,-10.0,-7.0,0.4422433376312256,594.801633875734,3,-541,-259,178,411,1279,1068,10
-10,-7,0.0,-10.0,-7.0,0.4511990547180176,582.762707221205,3,-531,-252,178,411,1279,1068,10
-10,-7,0.0,-10.0,-7.0,0.4601755142211914,570.7308398896137,3,-521,-245,178,411,1279,1068,10
-10,-7,0.0,-10.0,-7.0,0.46816277503967285,558.7064839080707,3,-511,-238,178,411,1279,1068,10
-10,-7,0.0,-10.0,-7.0,0.4791247844696045,546.6901304174291,3,-501,-231,178,411,1279,1068,10
-10,-7,0.0,-10.0,-7.0,0.48610544204711914,534.6823139588697,3,-491,-224,178,411,1279,1068,10
-10,-7,0.0,-10.0,-7.0,0.49408531188964844,522.683617331446,3,-481,-217,178,411,1279,1068,10
-10,-6,0.0,-10.0,-6.0,0.5020627975463867,511.10270295746363,3,-471,-211,178,411,1279,1068,10
-10,-6,0.0,-10.0,-6.0,0.5110392570495605,499.52551967170103,3,-461,-205,178,411,1279,1068,10
-10,-6,0.0,-10.0,-6.0,0.5190179347991943,487.9523303525403,3,-451,-199,178,411,1279,1068,10
-10,-6,0.0,-10.0,-6.0,0.5299892425537109,476.3834230631545,3,-441,-193,178,411,1279,1068,10
-9,-6,0.0,-9.0,-6.0,0.5389647483825684,465.73665674132496,3,-432,-187,178,411,1279,1068,10
-9,-6,0.0,-9.0,-6.0,0.548938512802124,455.09781568705586,3,-423,-181,178,411,1279,1068,10
-8,-6,0.0,-8.0,-6.0,0.5549228191375732,445.3887209955418,3,-415,-175,178,411,1279,1068,10
-8,-6,0.0,-8.0,-6.0,0.5649006366729736,435.6926366528036,3,-407,-169,178,411,1279,1068,10
-7,-5,0.0,-7.0,-5.0,0.5728747844696045,427.31470018957253,3,-400,-164,178,411,1279,1068,10
-7,-5,0.0,-7.0,-5.0,0.5828478336334229,418.94575124654807,3,-393,-159,178,411,1279,1068,10
-7,-5,0.0,-7.0,-5.0,0.5908269882202148,410.5863327877855,3,-386,-154,178,411,1279,1068,10
-7,-5,0.0,-7.0,-5.0,0.6008002758026123,402.23703171494606,3,-379,-149,178,411,1279,1068,10
-7,-5,0.0,-7.0,-5.0,0.6087784767150879,393.8984833262719,3,-372,-144,178,411,1279,1068,10
-7,-4,0.0,-7.0,-4.0,0.6187553405761719,385.9283821878376,3,-365,-140,178,411,1279,1068,10
-7,-4,0.0,-7.0,-4.0,0.6267306804656982,377.96213912082743,3,-358,-136,178,411,1279,1068,10
-7,-4,0.0,-7.0,-4.0,0.6367156505584717,370.0,3,-351,-132,178,411,1279,1068,10
-7,-4,0.0,-7.0,-4.0,0.6446833610534668,362.04223190254277,3,-344,-128,178,411,1279,1068,10
-7,-4,0.0,-7.0,-4.0,0.6516647338867188,354.0891254271006,3,-337,-124,178,411,1279,1068,10
-7,-4,0.0,-7.0,-4.0,0.6616380214691162,346.14099732158877,3,-330,-120,178,411,1279,1068,10
-7,-4,0.0,-7.0,-4.0,0.6696262359619141,338.1981934684389,3,-323,-116,178,411,1279,1068,10
-7,-4,0.0,-7.0,-4.0,0.6775960922241211,330.2610922848042,3,-316,-112,178,411,1279,1068,10
-7,-4,0.0,-7.0,-4.0,0.6855745315551758,322.3301086059759,3,-309,-108,178,411,1279,1068,10
-7,-4,0.0,-7.0,-4.0,0.6935532093048096,314.4056981332675,3,-302,-104,178,411,1279,1068,10
-7,-4,0.0,-7.0,-4.0,0.702528715133667,306.4883625434504,3,-295,-100,178,411,1279,1068,10
-7,-4,0.0,-7.0,-4.0,0.7105081081390381,298.5786553761644,3,-288,-96,178,411,1279,1068,10
-7,-4,0.0,-7.0,-4.0,0.7194838523864746,290.67718883945037,3,-281,-92,178,411,1279,1068,10
-7,-3,0.0,-7.0,-3.0,0.7294573783874512,283.0919991947017,3,-274,-89,178,411,1279,1068,10
-7,-3,0.0,-7.0,-3.0,0.736438512802124,275.5084668953862,3,-267,-86,178,411,1279,1068,10
-6,-3,0.0,-6.0,-3.0,0.7464120388031006,268.87953556262653,3,-261,-83,178,411,1279,1068,10
-6,-3,0.0,-6.0,-3.0,0.7533931732177734,262.25456029785533,3,-255,-80,178,411,1279,1068,10
-6,-3,0.0,-6.0,-3.0,0.7633669376373291,255.6338427756457,3,-249,-77,178,411,1279,1068,10
-6,-3,0.0,-6.0,-3.0,0.7703478336334229,249.01771591761076,3,-243,-74,178,411,1279,1068,10
-6,-3,0.0,-6.0,-3.0,0.7813186645507812,242.40654801358835,3,-237,-71,178,411,1279,1068,10
-6,-2,0.0,-6.0,-2.0,0.7873036861419678,236.0850472343733,3,-231,-69,178,411,1279,1068,10
-6,-2,0.0,-6.0,-2.0,0.797276496887207,229.76371099469355,3,-225,-67,178,411,1279,1068,10
-6,-2,0.0,-6.0,-2.0,0.805255651473999,223.44255295369118,3,-219,-65,178,411,1279,1068,10
-6,-2,0.0,-6.0,-2.0,0.8142316341400146,217.12158832495322,3,-213,-63,178,411,1279,1068,10
-6,-2,0.0,-6.0,-2.0,0.8232197761535645,210.8008341040414,3,-207,-61,178,411,1279,1068,10
-6,-2,0.0,-6.0,-2.0,0.8321831226348877,204.4803093371785,3,-201,-59,178,411,1279,1068,10
-5,-2,0.0,-5.0,-2.0,0.8421571254730225,199.12006270820123,3,-196,-57,178,411,1279,1068,10
-5,-2,0.0,-5.0,-2.0,0.8508784770965576,193.76116320851014,3,-191,-55,178,411,1279,1068,10
-4,-2,0.0,-4.0,-2.0,0.8598554134368896,189.36563482261982,3,-187,-53,178,411,1279,1068,10
-4,-2,0.0,-4.0,-2.0,0.8688304424285889,184.97368238785077,3,-183,-51,178,411,1279,1068,10
-4,-2,0.0,-4.0,-2.0,0.8798017501831055,180.58555978308226,3,-179,-49,178,411,1279,1068,10
-4,-2,0.0,-4.0,-2.0,0.8867824077606201,176.2015452472743,3,-175,-47,178,411,1279,1068,10
-4,-2,0.0,-4.0,-2.0,0.8967564105987549,171.8219443394965,3,-171,-45,178,411,1279,1068,10
-4,-2,0.0,-4.0,-2.0,0.9047348499298096,167.44709333589824,3,-167,-43,178,411,1279,1068,10
-4,-2,0.0,-4.0,-2.0,0.9127147197723389,163.0773631397161,3,-163,-41,178,411,1279,1068,10
-4,-1,0.0,-4.0,-1.0,0.9206929206848145,158.95426191471816,3,-159,-40,178,411,1279,1068,10
-4,-1,0.0,-4.0,-1.0,0.9306654930114746,154.8311609167624,3,-155,-39,178,411,1279,1068,10
-4,-1,0.01,-4.0,-1.0,0.9386444091796875,150.7080601638849,3,-151,-38,178,411,1279,1068,10
-4,-1,0.01,-4.0,-1.0,0.947620153427124,146.58495967608397,3,-147,-37,178,411,1279,1068,10
-4,-1,0.01,-4.0,-1.0,0.9555995464324951,142.46185947559457,3,-143,-36,178,411,1279,1068,10
-4,-1,0.01,-4.0,-1.0,0.9655725955963135,138.33875958721003,3,-139,-35,178,411,1279,1068,10
-4,-1,0.0,-4.0,-1.0,0.9725542068481445,134.21566003866087,3,-135,-34,178,411,1279,1068,10
-4,-1,0.0,-4.0,-1.0,0.982527494430542,130.09256086106296,3,-131,-33,178,411,1279,1068,10
-4,-1,0.0,-4.0,-1.0,0.9905071258544922,125.96946208945045,3,-127,-32,178,411,1279,1068,10
-4,-1,0.0,-4.0,-1.0,1.0004799365997314,121.84636376341263,3,-123,-31,178,411,1279,1068,10
-4,-1,0.0,-4.0,-1.0,1.0094554424285889,117.723265927859,3,-119,-30,178,411,1279,1068,10
-4,-1,0.0,-4.0,-1.0,1.0184319019317627,113.6001686339442,3,-115,-29,178,411,1279,1068,10
-4,-1,0.0,-4.0,-1.0,1.0264108180999756,109.47707194019246,3,-111,-28,178,411,1279,1068,10
-4,-1,0.0,-4.0,-1.0,1.035386562347412,105.35397591387454,3,-107,-27,178,411,1279,1068,10
-4,-1,0.0,-4.0,-1.0,1.0453605651855469,101.23088063270491,3,-103,-26,178,411,1279,1068,10
-4,-1,0.0,-4.0,-1.0,1.0533380508422852,97.1077861869505,3,-99,-25,178,411,1279,1068,10
-4,-1,0.0,-4.0,-1.0,1.0633127689361572,92.98469268207153,3,-95,-24,178,411,1279,1068,10
-4,-1,0.0,-4.0,-1.0,1.0712909698486328,88.86160024205851,3,-91,-23,178,411,1279,1068,10
-4,-1,0.0,-4.0,-1.0,1.0792698860168457,84.73850901368932,3,-87,-22,178,411,1279,1068,10
-4,-1,0.0,-4.0,-1.0,1.0872485637664795,80.61541917201598,3,-83,-21,178,411,1279,1068,10
-4,-1,0.01,-4.0,-1.0,1.0952281951904297,76.49233092751734,3,-79,-20,178,411,1279,1068,10
-4,-1,0.01,-4.0,-1.0,1.1022088527679443,72.3692445355388,3,-75,-19,178,411,1279,1068,10
-4,-1,0.01,-4.0,-1.0,1.1111841201782227,68.24616030891995,3,-71,-18,178,411,1279,1068,10
-4,-1,0.01,-4.0,-1.0,1.1191635131835938,64.12307863514182,3,-67,-17,178,411,1279,1068,10
-4,0,0.01,-4.0,-0.0,1.1281394958496094,60.25335240430181,3,-63,-17,178,411,1279,1068,10
-4,0,0.01,-4.0,-0.0,1.137115478515625,56.40032573203501,3,-59,-17,178,411,1279,1068,10
-4,0,0.01,-4.0,-0.0,1.1450939178466797,52.56735185849702,3,-55,-17,178,411,1279,1068,10
-4,0,0.01,-4.0,-0.0,1.1520752906799316,48.75872022286245,3,-51,-17,178,411,1279,1068,10
-4,0,0.01,-4.0,-0.0,1.160055160522461,44.9799959983992,3,-47,-17,178,411,1279,1068,10
-4,0,0.01,-4.0,-0.0,1.1690301895141602,41.238512086787566,3,-43,-17,178,411,1279,1068,10
-4,0,0.01,-4.0,-0.0,1.1780061721801758,37.5440947723653,3,-39,-17,178,411,1279,1068,10
-3,0,0.01,-3.0,-0.0,1.1869821548461914,34.81205847478876,3,-36,-17,178,411,1279,1068,10
-3,0,0.01,-3.0,-0.0,1.197953462600708,32.12142238654117,3,-33,-17,178,411,1279,1068,10
-2,0,0.02,-2.0,-0.0,1.2059321403503418,30.355339059327378,3,-31,-17,178,411,1279,1068,10
-2,0,0.04,-2.0,-0.0,1.2149078845977783,28.61547262794322,3,-29,-17,178,411,1279,1068,10
-2,0,0.07,-2.0,-0.0,1.2238843441009521,26.906112267087632,3,-27,-17,178,411,1279,1068,10
-2,0,0.08,-2.0,-0.0,1.2328600883483887,25.23243291566195,3,-25,-17,178,411,1279,1068,10
-2,0,0.05,-2.0,-0.0,1.242833137512207,23.600699292150182,3,-23,-17,178,411,1279,1068,10
-2,0,0.04,-2.0,-0.0,1.2498152256011963,22.018512172212592,3,-21,-17,178,411,1279,1068,10
-2,0,0.05,-2.0,-0.0,1.2597882747650146,20.495097567963924,3,-19,-17,178,411,1279,1068,10
-2,0,0.07,-2.0,-0.0,1.2677671909332275,19.041630560342615,3,-17,-17,178,411,1279,1068,10
-2,0,0.1,-2.0,-0.0,1.2767438888549805,17.67156809750927,3,-15,-17,178,411,1279,1068,10
-2,0,0.19,-2.0,-0.0,1.2857191562652588,16.400934559032695,3,-13,-17,178,411,1279,1068,10
-2,0,0.21,-2.0,-0.0,1.2936983108520508,15.248456731316587,3,-11,-17,178,411,1279,1068,10
-1,0,0.26,-1.0,-0.0,1.3026738166809082,14.72308292331602,3,-10,-17,178,411,1279,1068,10
-1,0,0.33,-1.0,-0.0,1.3126475811004639,14.235384061671343,3,-9,-17,178,411,1279,1068,10
-1,0,0.33,-1.0,-0.0,1.3206260204315186,13.788294228055936,3,-8,-17,178,411,1279,1068,10
-1,0,0.4,-1.0,-0.0,1.3305995464324951,13.384776310850235,3,-7,-17,178,411,1279,1068,10
-1,0,0.51,-1.0,-0.0,1.3385779857635498,13.027756377319946,3,-6,-17,178,411,1279,1068,10
-1,0,0.57,-1.0,-0.0,1.3485522270202637,12.72004514666935,3,-5,-17,178,411,1279,1068,10
-1,-1,0.67,-1.0,-1.0,1.3565309047698975,11.492422502470642,3,-4,-16,178,411,1279,1068,10
-1,0,0.66,-1.0,-0.0,1.365506887435913,11.278820596099706,3,-3,-16,178,411,1279,1068,10
-1,0,0.61,-1.0,-0.0,1.3734869956970215,11.124515496597098,3,-2,-16,178,411,1279,1068,10
-1,-1,0.62,-1.0,-1.0,1.3844552040100098,10.033296378372908,3,-1,-15,178,411,1279,1068,10
-1,-1,0.64,-1.0,-1.0,1.3924343585968018,9.0,3,0,-14,178,411,1279,1068,10
-1,-1,0.74,-1.0,-1.0,1.399416446685791,8.038404810405298,3,1,-13,178,411,1279,1068,10
-1,-1,0.76,-1.0,-1.0,1.4063973426818848,7.165525060596439,3,2,-12,178,411,1279,1068,10
0,-1,0.72,-0.0,-1.0,1.4153735637664795,6.180339887498949,3,2,-11,178,411,1279,1068,10
0,-1,0.68,-0.0,-1.0,1.4243507385253906,5.198039027185569,3,2,-10,178,411,1279,1068,10
0,-1,0.61,-0.0,-1.0,1.4343228340148926,4.219544457292887,3,2,-9,178,411,1279,1068,10
0,-1,0.59,-0.0,-1.0,0.008976221084594727,316.6122650963195,4,226,226,402,645,176,420,6
0,-1,0.62,-0.0,-1.0,0.01695704460144043,317.3201523476161,4,226,227,402,645,176,420,6
-1,-1,0.51,-1.0,-1.0,0.025931596755981445,318.7343624793597,4,227,228,402,645,176,420,6
0,-1,0.21,-0.0,-1.0,0.03490734100341797,319.4437935516824,4,227,229,402,645,176,420,6
1,0,0.09,1.0,-0.0,0.04488086700439453,318.74057872764513,4,226,229,402,645,176,420,6
2,0,0.08,2.0,-0.0,0.05285930633544922,317.3388830597997,4,224,229,402,645,176,420,6
2,1,0.0,2.0,1.0,0.06283307075500488,315.2263345482269,4,222,228,402,645,176,420,6
2,1,0.0,2.0,1.0,0.07081198692321777,313.1154852265229,4,220,227,402,645,176,420,6
2,0,0.0,2.0,-0.0,0.07879185676574707,311.7268657105713,4,218,227,402,645,176,420,6
2,1,0.0,2.0,1.0,0.08577108383178711,309.62117650600703,4,216,226,402,645,176,420,6
2,2,0.01,2.0,2.0,0.09574484825134277,306.7934795956816,4,214,224,402,645,176,420,6
1,2,0.0,1.0,2.0,0.10372376441955566,304.6572768520192,4,213,222,402,645,176,420,6
1,3,0.0,1.0,3.0,0.1127004623413086,301.8032152061392,4,212,219,402,645,176,420,6
1,1,0.0,1.0,1.0,0.12067890167236328,300.3891889965758,4,211,218,402,645,176,420,6
0,4,0.0,-0.0,4.0,0.13065195083618164,297.5278689239985,4,211,214,402,645,176,420,6
2,3,0.0,2.0,3.0,0.13962841033935547,293.98821525441036,4,209,211,402,645,176,420,6
3,3,0.0,3.0,3.0,0.14960145950317383,289.7456233660889,4,206,208,402,645,176,420,6
2,4,0.0,2.0,4.0,0.15857720375061035,285.4995667241114,4,204,204,402,645,176,420,6
4,4,0.0,4.0,4.0,0.16655635833740234,279.842712474619,4,200,200,402,645,176,420,6
4,5,0.0,4.0,5.0,0.17553305625915527,273.4796556710819,4,196,195,402,645,176,420,6
5,5,0.0,5.0,5.0,0.18351149559020996,266.40861159213154,4,191,190,402,645,176,420,6
5,5,0.0,5.0,5.0,0.19248700141906738,259.33756879257686,4,186,185,402,645,176,420,6
5,5,0.0,5.0,5.0,0.20046544075012207,252.266527378738,4,181,180,402,645,176,420,6
5,6,0.0,5.0,6.0,0.20844507217407227,244.4914139924858,4,176,174,402,645,176,420,6
5,6,0.0,5.0,6.0,0.2174210548400879,236.7185850116757,4,171,168,402,645,176,420,6
5,5,0.0,5.0,5.0,0.2263963222503662,229.64780248263682,4,166,163,402,645,176,420,6
5,6,0.0,5.0,6.0,0.23537254333496094,221.8777445635739,4,161,157,402,645,176,420,6
5,5,0.0,5.0,5.0,0.2453463077545166,214.8072542409917,4,156,152,402,645,176,420,6
5,5,0.0,5.0,5.0,0.2533252239227295,207.7368026710095,4,151,147,402,645,176,420,6
5,5,0.0,5.0,5.0,0.26329874992370605,200.66639388961548,4,146,142,402,645,176,420,6
5,5,0.0,5.0,5.0,0.2702803611755371,193.596032513375,4,141,137,402,645,176,420,6
5,4,0.0,5.0,4.0,0.28025317192077637,187.22355269524328,4,136,133,402,645,176,420,6
5,4,0.0,5.0,4.0,0.28823208808898926,180.85320231097418,4,131,129,402,645,176,420,6
5,4,0.0,5.0,4.0,0.29621052742004395,174.48521065147935,4,126,125,402,645,176,420,6
5,4,0.0,5.0,4.0,0.3061840534210205,168.1198410471445,4,121,121,402,645,176,420,6
5,3,0.0,5.0,3.0,0.31516027450561523,162.46903033498444,4,116,118,402,645,176,420,6
5,3,0.0,5.0,3.0,0.3221430778503418,156.8311609167624,4,111,115,402,645,176,420,6
5,3,0.0,5.0,3.0,0.33211469650268555,151.20765220960988,4,106,112,402,645,176,420,6
4,3,0.0,4.0,3.0,0.34009456634521484,146.2816130673835,4,102,109,402,645,176,420,6
4,2,0.0,4.0,2.0,0.3500669002532959,142.09651959988565,4,98,107,402,645,176,420,6
4,2,0.0,4.0,2.0,0.3590431213378906,137.92906016858268,4,94,105,402,645,176,420,6
3,2,0.0,3.0,2.0,0.3670217990875244,134.44089638822936,4,91,103,402,645,176,420,6
3,2,0.0,3.0,2.0,0.3769958019256592,130.9589489358587,4,88,101,402,645,176,420,6
2,2,0.0,2.0,2.0,0.38497447967529297,128.13733259449805,4,86,99,402,645,176,420,6
2,2,0.0,2.0,2.0,0.39494800567626953,125.31601614763451,4,84,97,402,645,176,420,6
1,2,0.0,1.0,2.0,0.4029262065887451,123.15070352558483,4,83,95,402,645,176,420,6
1,2,0.0,1.0,2.0,0.41190242767333984,120.98790263570072,4,82,93,402,645,176,420,6
1,2,0.0,1.0,2.0,0.4208793640136719,118.82774724995944,4,81,91,402,645,176,420,6
1,2,0.01,1.0,2.0,0.43085193634033203,116.6703806294607,4,80,89,402,645,176,420,6
1,3,0.01,1.0,3.0,0.4388303756713867,113.77756633874505,4,79,86,402,645,176,420,6
1,3,0.02,1.0,3.0,0.4488036632537842,110.89907813498755,4,78,83,402,645,176,420,6
1,3,0.07,1.0,3.0,0.45678281784057617,108.03603018840326,4,77,80,402,645,176,420,6
1,3,0.07,1.0,3.0,0.46675562858581543,105.18964830333815,4,76,77,402,645,176,420,6
1,4,0.09,1.0,4.0,0.4747347831726074,101.66135867644753,4,75,73,402,645,176,420,6
1,4,0.07,1.0,4.0,0.4827141761779785,98.17806086301516,4,74,69,402,645,176,420,6
1,4,0.05,1.0,4.0,0.490692138671875,94.74456506629922,4,73,65,402,645,176,420,6
1,4,0.04,1.0,4.0,0.4986703395843506,91.36630754670864,4,72,61,402,645,176,420,6
2,4,0.02,2.0,4.0,0.5086464881896973,87.27181176868004,4,70,57,402,645,176,420,6
2,4,0.02,2.0,4.0,0.5176208019256592,83.21484790916237,4,68,53,402,645,176,420,6
2,4,0.02,2.0,4.0,0.5265963077545166,79.20097323024831,4,66,49,402,645,176,420,6
3,3,0.01,3.0,3.0,0.5355720520019531,75.00640999302557,4,63,46,402,645,176,420,6
3,3,0.01,3.0,3.0,0.5455460548400879,70.81734213584231,4,60,43,402,645,176,420,6
3,3,0.01,3.0,3.0,0.5525274276733398,66.63476143421474,4,57,40,402,645,176,420,6
3,2,0.0,3.0,2.0,0.5625011920928955,63.03029607687671,4,54,38,402,645,176,420,6
3,2,0.0,3.0,2.0,0.5694820880889893,59.42595614005443,4,51,36,402,645,176,420,6
3,1,0.0,3.0,1.0,0.5794556140899658,56.405386961116584,4,48,35,402,645,176,420,6
3,1,0.0,3.0,1.0,0.587435245513916,53.4003546088143,4,45,34,402,645,176,420,6
3,1,0.0,3.0,1.0,0.5974087715148926,50.41348144429457,4,42,33,402,645,176,420,6
3,0,0.0,3.0,-0.0,0.6063852310180664,48.088159097779204,4,39,33,402,645,176,420,6
3,0,0.0,3.0,-0.0,0.6143631935119629,45.83646178829912,4,36,33,402,645,176,420,6
3,0,0.0,3.0,-0.0,0.6223411560058594,43.66904755831214,4,33,33,402,645,176,420,6
2,0,0.0,2.0,-0.0,0.6303203105926514,42.27692569068709,4,31,33,402,645,176,420,6
2,0,0.0,2.0,-0.0,0.639296293258667,40.93176527297759,4,29,33,402,645,176,420,6
1,0,0.0,1.0,-0.0,0.6482748985290527,40.278170016764804,4,28,33,402,645,176,420,6
1,0,0.01,1.0,-0.0,0.655254602432251,39.638011210655684,4,27,33,402,645,176,420,6
0,0,0.01,-0.0,-0.0,0.6662271022796631,39.638011210655684,4,27,33,402,645,176,420,6
0,0,0.02,-0.0,-0.0,0.6742048263549805,39.638011210655684,4,27,33,402,645,176,420,6
0,0,0.03,-0.0,-0.0,0.6841764450073242,39.638011210655684,4,27,33,402,645,176,420,6
0,0,0.03,-0.0,-0.0,0.6921567916870117,39.638011210655684,4,27,33,402,645,176,420,6
0,1,0.06,-0.0,1.0,0.7011415958404541,38.86884283091664,4,27,32,402,645,176,420,6
0,1,0.12,-0.0,1.0,0.7091102600097656,38.10960958218893,4,27,31,402,645,176,420,6
0,1,0.27,-0.0,1.0,0.7180860042572021,37.36087214122113,4,27,30,402,645,176,420,6
0,1,0.3,-0.0,1.0,0.729058027267456,36.6232255123179,4,27,29,402,645,176,420,6
0,1,0.37,-0.0,1.0,0.7350406646728516,35.897300677553446,4,27,28,402,645,176,420,6
0,2,0.41,-0.0,2.0,0.74601149559021,34.48332962798263,4,27,26,402,645,176,420,6
0,2,0.4,-0.0,2.0,0.7529935836791992,33.124783736376884,4,27,24,402,645,176,420,6
0,2,0.37,-0.0,2.0,0.761969804763794,31.828149534535996,4,27,22,402,645,176,420,6
0,1,0.32,-0.0,1.0,0.7699475288391113,31.205262752974143,4,27,21,402,645,176,420,6
0,2,0.26,-0.0,2.0,0.7799215316772461,30.015148038438355,4,27,19,402,645,176,420,6
0,2,0.3,-0.0,2.0,0.787900447845459,28.906112267087632,4,27,17,402,645,176,420,6
0,2,0.28,-0.0,2.0,0.7968769073486328,27.886890422961002,4,27,15,402,645,176,420,6
0,1,0.3,-0.0,1.0,0.8058528900146484,27.4138126514911,4,27,14,402,645,176,420,6
1,1,0.23,1.0,1.0,0.8148281574249268,26.068883707497267,4,26,13,402,645,176,420,6
1,1,0.2,1.0,1.0,0.8238523006439209,24.730849247724095,4,25,12,402,645,176,420,6
1,1,0.14,1.0,1.0,0.8328282833099365,23.40075756488817,4,24,11,402,645,176,420,6
1,1,0.12,1.0,1.0,0.8428018093109131,22.079872407968907,4,23,10,402,645,176,420,6
1,0,0.11,1.0,-0.0,0.8507804870605469,21.166091947189145,4,22,10,402,645,176,420,6
1,0,0.1,1.0,-0.0,0.8597569465637207,20.259406699226016,4,21,10,402,645,176,420,6
1,0,0.08,1.0,-0.0,0.8687331676483154,19.360679774997898,4,20,10,402,645,176,420,6
1,0,0.06,1.0,-0.0,0.8797035217285156,18.470910553583888,4,19,10,402,645,176,420,6
1,0,0.05,1.0,-0.0,0.8876824378967285,17.591260281974,4,18,10,402,645,176,420,6
1,0,0.06,1.0,-0.0,0.8966584205627441,16.72308292331602,4,17,10,402,645,176,420,6
1,0,0.07,1.0,-0.0,0.905634880065918,15.867962264113206,4,16,10,402,645,176,420,6
1,0,0.09,1.0,-0.0,0.9146103858947754,15.027756377319946,4,15,10,402,645,176,420,6
1,0,0.1,1.0,-0.0,0.9225888252258301,14.204650534085253,4,14,10,402,645,176,420,6
1,0,0.12,1.0,-0.0,0.9325623512268066,13.401219466856727,4,13,10,402,645,176,420,6
1,0,0.12,1.0,-0.0,0.9405429363250732,12.620499351813308,4,12,10,402,645,176,420,6
1,0,0.14,1.0,-0.0,0.9495177268981934,11.866068747318506,4,11,10,402,645,176,420,6
1,0,0.16,1.0,-0.0,0.9594910144805908,11.142135623730951,4,10,10,402,645,176,420,6
1,0,0.2,1.0,-0.0,0.9674704074859619,10.45362404707371,4,9,10,402,645,176,420,6
1,0,0.23,1.0,-0.0,0.9764456748962402,9.806248474865697,4,8,10,402,645,176,420,6
1,0,0.28,1.0,-0.0,0.9864184856414795,9.206555615733702,4,7,10,402,645,176,420,6
1,0,0.3,1.0,-0.0,0.9953961372375488,8.661903789690601,4,6,10,402,645,176,420,6
1,0,0.28,1.0,-0.0,1.003373622894287,8.180339887498949,4,5,10,402,645,176,420,6
1,0,0.28,1.0,-0.0,1.0123496055603027,7.7703296142690075,4,4,10,402,645,176,420,6
0,0,0.32,-0.0,-0.0,1.0208334922790527,7.7703296142690075,4,4,10,402,645,176,420,6
0,0,0.33,-0.0,-0.0,1.0308067798614502,7.7703296142690075,4,4,10,402,645,176,420,6
0,1,0.35,-0.0,1.0,1.0387864112854004,6.848857801796104,4,4,9,402,645,176,420,6
0,1,0.33,-0.0,1.0,1.0477614402770996,5.944271909999159,4,4,8,402,645,176,420,6
0,1,0.41,-0.0,1.0,1.0567386150360107,5.062257748298549,4,4,7,402,645,176,420,6
0,1,0.54,-0.0,1.0,1.0667109489440918,4.211102550927978,4,4,6,402,645,176,420,6
0,1,0.59,-0.0,1.0,1.0746896266937256,3.4031242374328485,4,4,5,402,645,176,420,6
0,1,0.59,-0.0,1.0,1.084662914276123,2.6568542494923806,4,4,4,402,645,176,420,6
0,1,0.57,-0.0,1.0,0.00897669792175293,367.12812008196556,5,365,159,763,801,398,641,62
0,1,0.56,-0.0,1.0,0.016955137252807617,366.72980778412875,5,365,158,763,801,398,641,62
1,0,0.39,1.0,-0.0,0.024934053421020508,365.8122981965151,5,364,158,763,801,398,641,62
3,0,0.07,3.0,-0.0,0.0329129695892334,363.06217783491985,5,361,158,763,801,398,641,62
2,1,0.11,2.0,1.0,0.04188990592956543,360.8290443548053,5,359,157,763,801,398,641,62
5,1,0.1,5.0,1.0,0.05086469650268555,355.8488076755569,5,354,156,763,801,398,641,62
3,1,0.0,3.0,1.0,0.057846784591674805,352.70040396121556,5,351,155,763,801,398,641,62
5,1,0.0,5.0,1.0,0.06582498550415039,347.7241740369896,5,346,154,763,801,398,641,62
5,2,0.0,5.0,2.0,0.07380414009094238,342.34300582708124,5,341,152,763,801,398,641,62
6,1,0.0,6.0,1.0,0.0827798843383789,336.458841232593,5,335,151,763,801,398,641,62
5,2,0.0,5.0,2.0,0.09175634384155273,331.0787207224418,5,330,149,763,801,398,641,62
4,2,0.0,4.0,2.0,0.09973430633544922,326.61012289922667,5,326,147,763,801,398,641,62
5,4,0.0,5.0,4.0,0.10871100425720215,320.411439768258,5,321,143,763,801,398,641,62
5,4,0.0,5.0,4.0,0.11768674850463867,314.2202195700594,5,316,139,763,801,398,641,62
6,5,0.0,6.0,5.0,0.12765979766845703,306.7217789838257,5,310,134,763,801,398,641,62
6,4,0.0,6.0,4.0,0.13563895225524902,299.6297022349928,5,304,130,763,801,398,641,62
7,4,0.0,7.0,4.0,0.14461493492126465,291.62206992082855,5,297,126,763,801,398,641,62
6,4,0.0,6.0,4.0,0.15359091758728027,284.53922101697594,5,291,122,763,801,398,641,62
7,4,0.0,7.0,4.0,0.16356492042541504,276.5386154615384,5,284,118,763,801,398,641,62
8,4,0.0,8.0,4.0,0.17154312133789062,267.6168113151033,5,276,114,763,801,398,641,62
8,4,0.0,8.0,4.0,0.18051958084106445,258.6963927977012,5,268,110,763,801,398,641,62
9,4,0.0,9.0,4.0,0.18949484825134277,248.85174646587433,5,259,106,763,801,398,641,62
8,4,0.0,8.0,4.0,0.19946885108947754,239.93357119412133,5,251,102,763,801,398,641,62
8,4,0.0,8.0,4.0,0.20844483375549316,231.01717500957835,5,243,98,763,801,398,641,62
8,3,0.0,8.0,3.0,0.21642374992370605,222.4758371127315,5,235,95,763,801,398,641,62
8,3,0.0,8.0,3.0,0.22539997100830078,213.9346851713738,5,227,92,763,801,398,641,62
8,3,0.0,8.0,3.0,0.2343766689300537,205.39373934180236,5,219,89,763,801,398,641,62
8,3,0.0,8.0,3.0,0.2453463077545166,196.85302280198084,5,211,86,763,801,398,641,62
8,3,0.0,8.0,3.0,0.25232815742492676,188.31256233968907,5,203,83,763,801,398,641,62
8,2,0.0,8.0,2.0,0.2623019218444824,180.1539722572133,5,195,81,763,801,398,641,62
8,2,0.0,8.0,2.0,0.26928281784057617,172.00246303924493,5,187,79,763,801,398,641,62
8,2,0.0,8.0,2.0,0.27726149559020996,163.85892332659543,5,179,77,763,801,398,641,62
7,2,0.0,7.0,2.0,0.28524065017700195,156.6406139405859,5,172,75,763,801,398,641,62
7,2,0.0,7.0,2.0,0.2942163944244385,149.42727066604982,5,165,73,763,801,398,641,62
6,2,0.0,6.0,2.0,0.30219507217407227,143.13213373757299,5,159,71,763,801,398,641,62
6,2,0.0,6.0,2.0,0.3121681213378906,136.83920876839238,5,153,69,763,801,398,641,62
6,2,0.0,6.0,2.0,0.3201475143432617,130.54875425084526,5,147,67,763,801,398,641,62
5,2,0.0,5.0,2.0,0.3301205635070801,125.16977940690063,5,142,65,763,801,398,641,62
5,2,0.0,5.0,2.0,0.33809947967529297,119.79124643028851,5,137,63,763,801,398,641,62
5,2,0.0,5.0,2.0,0.3470757007598877,114.41320435228707,5,132,61,763,801,398,641,62
5,2,0.0,5.0,2.0,0.3560514450073242,109.03570973148243,5,127,59,763,801,398,641,62
5,2,0.0,5.0,2.0,0.3660244941711426,103.65882815471105,5,122,57,763,801,398,641,62
5,2,0.0,5.0,2.0,0.3750011920928955,98.28263611173776,5,117,55,763,801,398,641,62
5,2,0.0,5.0,2.0,0.3829801082611084,92.90722335683259,5,112,53,763,801,398,641,62
5,2,0.0,5.0,2.0,0.3919565677642822,87.53269591129698,5,107,51,763,801,398,641,62
5,2,0.0,5.0,2.0,0.3999345302581787,82.1591799192624,5,102,49,763,801,398,641,62
5,2,0.0,5.0,2.0,0.40990781784057617,76.78682665335315,5,97,47,763,801,398,641,62
5,2,0.0,5.0,2.0,0.416888952255249,71.41581909060729,5,92,45,763,801,398,641,62
4,2,0.0,4.0,2.0,0.4268631935119629,66.94386147176351,5,88,43,763,801,398,641,62
4,2,0.0,4.0,2.0,0.4348416328430176,62.47192091746055,5,84,41,763,801,398,641,62
4,2,0.0,4.0,2.0,0.44282007217407227,58.0,5,80,39,763,801,398,641,62
4,2,0.0,4.0,2.0,0.4517960548400879,53.528101836016646,5,76,37,763,801,398,641,62
4,2,0.0,4.0,2.0,0.46177005767822266,49.05623023850174,5,72,35,763,801,398,641,62
3,2,0.0,3.0,2.0,0.46974802017211914,45.48529270389177,5,69,33,763,801,398,641,62
3,2,0.0,3.0,2.0,0.48071885108947754,41.91776189653656,5,66,31,763,801,398,641,62
3,2,0.0,3.0,2.0,0.4877009391784668,38.35416353759881,5,63,29,763,801,398,641,62
3,1,0.01,3.0,1.0,0.4966766834259033,35.21178142898739,5,60,28,763,801,398,641,62
3,1,0.01,3.0,1.0,0.5046560764312744,32.071388124885914,5,57,27,763,801,398,641,62
2,1,0.01,2.0,1.0,0.5156257152557373,29.83584469702052,5,55,26,763,801,398,641,62
2,1,0.02,2.0,1.0,0.5216104984283447,27.60034129593445,5,53,25,763,801,398,641,62
2,1,0.04,2.0,1.0,0.530585527420044,25.36488268416781,5,51,24,763,801,398,641,62
2,1,0.05,2.0,1.0,0.5395617485046387,23.12947441089743,5,49,23,763,801,398,641,62
2,1,0.08,2.0,1.0,0.5485377311706543,20.894122981316485,5,47,22,763,801,398,641,62
1,1,0.13,1.0,1.0,0.5585117340087891,19.566787519082126,5,46,21,763,801,398,641,62
1,0,0.19,1.0,-0.0,0.5664901733398438,18.658836071740545,5,45,21,763,801,398,641,62
1,0,0.21,1.0,-0.0,0.5734720230102539,17.754486972995622,5,44,21,763,801,398,641,62
1,0,0.24,1.0,-0.0,0.5824484825134277,16.853944456021594,5,43,21,763,801,398,641,62
1,0,0.31,1.0,-0.0,0.5904262065887451,15.957427527495582,5,42,21,763,801,398,641,62
1,0,0.49,1.0,-0.0,0.6004002094268799,15.065171225124082,5,41,21,763,801,398,641,62
1,0,0.61,1.0,-0.0,0.6093759536743164,14.177427992306072,5,40,21,763,801,398,641,62
1,0,0.65,1.0,-0.0,0.006981372833251953,565.3713829324454,6,435,372,1159,1152,723,780,15
1,1,0.68,1.0,1.0,0.01595759391784668,563.9614698033485,6,434,371,1159,1152,723,780,15
-1,0,0.46,-1.0,-0.0,0.024933338165283203,564.7219603968349,6,435,371,1159,1152,723,780,15
1,-1,0.17,1.0,-1.0,0.034906864166259766,564.611756352159,6,434,372,1159,1152,723,780,15
3,1,0.15,3.0,1.0,0.04288625717163086,561.6844467716696,6,431,371,1159,1152,723,780,15
2,3,0.03,2.0,3.0,0.05285930633544922,558.2123494758408,6,429,368,1159,1152,723,780,15
3,3,0.0,3.0,3.0,0.06083846092224121,553.9821744048558,6,426,365,1159,1152,723,780,15
1,3,0.0,1.0,3.0,0.07081151008605957,551.2732305959153,6,425,362,1159,1152,723,780,15
4,2,0.0,4.0,2.0,0.07879185676574707,546.9323063335447,6,421,360,1159,1152,723,780,15
3,6,0.0,3.0,6.0,0.08876371383666992,540.7590711252531,6,418,354,1159,1152,723,780,15
4,6,0.0,4.0,6.0,0.09674263000488281,533.8326913195984,6,414,348,1159,1152,723,780,15
3,6,0.0,3.0,6.0,0.10571789741516113,527.6821485705316,6,411,342,1159,1152,723,780,15
3,6,0.0,3.0,6.0,0.11369776725769043,521.5451730930857,6,408,336,1159,1152,723,780,15
3,7,0.0,3.0,7.0,0.12267422676086426,514.7911459578439,6,405,329,1159,1152,723,780,15
3,7,0.0,3.0,7.0,0.1326465606689453,508.06116141677774,6,402,322,1159,1152,723,780,15
7,8,0.0,7.0,8.0,0.14261937141418457,497.59984145855617,6,395,314,1159,1152,723,780,15
6,6,0.0,6.0,6.0,0.15059876441955566,489.17033365569125,6,389,308,1159,1152,723,780,15
6,8,0.0,6.0,8.0,0.1595745086669922,479.506937257836,6,383,300,1159,1152,723,780,15
7,8,0.0,7.0,8.0,0.16954803466796875,469.0672221441001,6,376,292,1159,1152,723,780,15
7,8,0.0,7.0,8.0,0.17752695083618164,458.63612402819433,6,369,284,1159,1152,723,780,15
8,8,0.0,8.0,8.0,0.1875002384185791,447.41940979672074,6,361,276,1159,1152,723,780,15
8,8,0.0,8.0,8.0,0.1954796314239502,436.2076262881766,6,353,268,1159,1152,723,780,15
8,8,0.0,8.0,8.0,0.20545291900634766,425.001157405857,6,345,260,1159,1152,723,780,15
8,8,0.0,8.0,8.0,0.21542787551879883,413.8004277564366,6,337,252,1159,1152,723,780,15
8,7,0.0,8.0,7.0,0.22440195083618164,403.2023890715411,6,329,245,1159,1152,723,780,15
8,7,0.0,8.0,7.0,0.23038673400878906,392.60605601016607,6,321,238,1159,1152,723,780,15
8,7,0.0,8.0,7.0,0.23936247825622559,382.0115679513914,6,313,231,1159,1152,723,780,15
8,7,0.0,8.0,7.0,0.24933528900146484,371.41907985723975,6,305,224,1159,1152,723,780,15
8,6,0.0,8.0,6.0,0.25831103324890137,361.41959774148825,6,297,218,1159,1152,723,780,15
8,7,0.0,8.0,7.0,0.26629066467285156,350.8295683701949,6,289,211,1159,1152,723,780,15
8,6,0.0,8.0,6.0,0.2752664089202881,340.8304184512907,6,281,205,1159,1152,723,780,15
8,6,0.0,8.0,6.0,0.28523993492126465,330.8313188560232,6,273,199,1159,1152,723,780,15
8,5,0.0,8.0,5.0,0.29321837425231934,321.42198464780034,6,265,194,1159,1152,723,780,15
8,5,0.0,8.0,5.0,0.3031923770904541,312.0141062711804,6,257,189,1159,1152,723,780,15
8,5,0.0,8.0,5.0,0.3121683597564697,302.6078164387973,6,249,184,1159,1152,723,780,15
8,5,0.0,8.0,5.0,0.3201470375061035,293.2032644725903,6,241,179,1159,1152,723,780,15
8,4,0.0,8.0,4.0,0.32712817192077637,284.40006863417176,6,233,175,1159,1152,723,780,15
8,4,0.0,8.0,4.0,0.33411121368408203,275.6057324259365,6,225,171,1159,1152,723,780,15
7,4,0.0,7.0,4.0,0.34308528900146484,267.6142749385035,6,218,167,1159,1152,723,780,15
7,4,0.0,7.0,4.0,0.35206127166748047,259.62708039507163,6,211,163,1159,1152,723,780,15
6,4,0.0,6.0,4.0,0.3610379695892334,252.43399931389104,6,205,159,1159,1152,723,780,15
6,4,0.0,6.0,4.0,0.37101078033447266,245.24194734421155,6,199,155,1159,1152,723,780,15
6,3,0.0,6.0,3.0,0.37898993492126465,238.6684757961428,6,193,152,1159,1152,723,780,15
6,4,0.0,6.0,4.0,0.3879661560058594,231.4806071780261,6,187,148,1159,1152,723,780,15
6,3,0.0,6.0,3.0,0.3969426155090332,224.91808898833224,6,181,145,1159,1152,723,780,15
6,3,0.0,6.0,3.0,0.40691542625427246,218.36414976655004,6,175,142,1159,1152,723,780,15
6,3,0.0,6.0,3.0,0.41489601135253906,211.81956036881164,6,169,139,1159,1152,723,780,15
6,3,0.0,6.0,3.0,0.4248673915863037,205.2851855405836,6,163,136,1159,1152,723,780,15
6,3,0.0,6.0,3.0,0.4328465461730957,198.7619984350852,6,157,133,1159,1152,723,780,15
6,3,0.0,6.0,3.0,0.4408252239227295,192.25109786397664,6,151,130,1159,1152,723,780,15
6,3,0.0,6.0,3.0,0.4498012065887451,185.753728887407,6,145,127,1159,1152,723,780,15
5,3,0.0,5.0,3.0,0.45877671241760254,180.01871564097536,6,140,124,1159,1152,723,780,15
5,3,0.0,5.0,3.0,0.4687511920928955,174.289823211343,6,135,121,1159,1152,723,780,15
5,3,0.0,5.0,3.0,0.4767293930053711,168.56765077883796,6,130,118,1159,1152,723,780,15
5,3,0.0,5.0,3.0,0.4876997470855713,162.85287751463028,6,125,115,1159,1152,723,780,15
5,3,0.0,5.0,3.0,0.4936842918395996,157.14627622946554,6,120,112,1159,1152,723,780,15
5,3,0.0,5.0,3.0,0.5036578178405762,151.44872987815333,6,115,109,1159,1152,723,780,15
5,3,0.0,5.0,3.0,0.5116379261016846,145.7612516314265,6,110,106,1159,1152,723,780,15
5,3,0.0,5.0,3.0,0.5216100215911865,140.08500943332058,6,105,103,1159,1152,723,780,15
5,3,0.0,5.0,3.0,0.5295891761779785,134.4213562373095,6,100,100,1159,1152,723,780,15
5,3,0.0,5.0,3.0,0.5387403964996338,128.77186748365804,6,95,97,1159,1152,723,780,15
4,3,0.0,4.0,3.0,0.5467185974121094,123.83195328359201,6,91,94,1159,1152,723,780,15
4,3,0.0,4.0,3.0,0.5556950569152832,118.89678312014172,6,87,91,1159,1152,723,780,15
3,3,0.0,3.0,3.0,0.5637025833129883,114.6552506059644,6,84,88,1159,1152,723,780,15
3,2,0.0,3.0,2.0,0.5726494789123535,111.1397477566293,6,81,86,1159,1152,723,780,15
3,2,0.0,3.0,2.0,0.5816466808319092,107.6298390472568,6,78,84,1159,1152,723,780,15
3,2,0.0,3.0,2.0,0.5916197299957275,104.12605455067681,6,75,82,1159,1152,723,780,15
2,2,0.0,2.0,2.0,0.6005971431732178,101.30050784737807,6,73,80,1159,1152,723,780,15
2,2,0.0,2.0,2.0,0.609551191329956,98.47511554864494,6,71,78,1159,1152,723,780,15
2,2,0.01,2.0,2.0,0.6195249557495117,95.6498904042279,6,69,76,1159,1152,723,780,15
2,2,0.01,2.0,2.0,0.6265065670013428,92.82484660644363,6,67,74,1159,1152,723,780,15
2,2,0.02,2.0,2.0,0.6350016593933105,90.0,6,65,72,1159,1152,723,780,15
2,2,0.02,2.0,2.0,0.6429696083068848,87.17536832951598,6,63,70,1159,1152,723,780,15
2,2,0.03,2.0,2.0,0.6539404392242432,84.35097153287424,6,61,68,1159,1152,723,780,15
2,3,0.03,2.0,3.0,0.661919355392456,80.78382538941898,6,59,65,1159,1152,723,780,15
2,3,0.05,2.0,3.0,0.6679031848907471,77.21995013059554,6,57,62,1159,1152,723,780,15
2,3,0.07,2.0,3.0,0.6778767108917236,73.65977932030313,6,55,59,1159,1152,723,780,15
2,3,0.09,2.0,3.0,0.687849760055542,70.10382610480494,6,53,56,1159,1152,723,780,15
2,3,0.06,2.0,3.0,0.6948308944702148,66.55270219373317,6,51,53,1159,1152,723,780,15
2,3,0.06,2.0,3.0,0.7038073539733887,63.00714249274856,6,49,50,1159,1152,723,780,15
2,3,0.04,2.0,3.0,0.7117860317230225,59.468037431535464,6,47,47,1159,1152,723,780,15
2,3,0.03,2.0,3.0,0.7227566242218018,55.93647591023825,6,45,44,1159,1152,723,780,15
2,3,0.03,2.0,3.0,0.7297396659851074,52.413803110051795,6,43,41,1159,1152,723,780,15
2,3,0.03,2.0,3.0,0.7382237911224365,48.90169943749474,6,41,38,1159,1152,723,780,15
2,3,0.03,2.0,3.0,0.7462029457092285,45.40229002629561,6,39,35,1159,1152,723,780,15
2,3,0.02,2.0,3.0,0.7561752796173096,41.91829923454004,6,37,32,1159,1152,723,780,15
2,2,0.02,2.0,2.0,0.7641544342041016,39.09772228646444,6,35,30,1159,1152,723,780,15
2,2,0.02,2.0,2.0,0.7731306552886963,36.278170016764804,6,33,28,1159,1152,723,780,15
2,2,0.01,2.0,2.0,0.7831034660339355,33.45985664828782,6,31,26,1159,1152,723,780,15
2,2,0.01,2.0,2.0,0.7910819053649902,30.64306044943742,6,29,24,1159,1152,723,780,15
2,1,0.01,2.0,1.0,0.8000588417053223,28.4682957019364,6,27,23,1159,1152,723,780,15
2,1,0.02,2.0,1.0,0.8090343475341797,26.301651610693426,6,25,22,1159,1152,723,780,15
1,1,0.02,1.0,1.0,0.8180112838745117,24.89043743820395,6,24,21,1159,1152,723,780,15
1,0,0.02,1.0,-0.0,0.8269875049591064,24.144823004794873,6,23,21,1159,1152,723,780,15
1,0,0.02,1.0,-0.0,0.837468147277832,23.4138126514911,6,22,21,1159,1152,723,780,15
1,0,0.02,1.0,-0.0,0.8444490432739258,22.698484809834994,6,21,21,1159,1152,723,780,15
1,0,0.03,1.0,-0.0,0.8544254302978516,22.0,6,20,21,1159,1152,723,780,15
0,0,0.05,-0.0,-0.0,0.8624019622802734,22.0,6,20,21,1159,1152,723,780,15
0,0,0.07,-0.0,-0.0,0.8723745346069336,22.0,6,20,21,1159,1152,723,780,15
0,0,0.08,-0.0,-0.0,0.8803541660308838,22.0,6,20,21,1159,1152,723,780,15
0,0,0.09,-0.0,-0.0,0.890326738357544,22.0,6,20,21,1159,1152,723,780,15
0,0,0.15,-0.0,-0.0,0.8983063697814941,22.0,6,20,21,1159,1152,723,780,15
0,0,0.26,-0.0,-0.0,0.9072813987731934,22.0,6,20,21,1159,1152,723,780,15
0,0,0.37,-0.0,-0.0,0.9172561168670654,22.0,6,20,21,1159,1152,723,780,15
0,0,0.4,-0.0,-0.0,0.9242367744445801,22.0,6,20,21,1159,1152,723,780,15
0,0,0.41,-0.0,-0.0,0.9332127571105957,22.0,6,20,21,1159,1152,723,780,15
0,1,0.51,-0.0,1.0,0.9433259963989258,21.284271247461902,6,20,20,1159,1152,723,780,15
0,1,0.58,-0.0,1.0,0.9523024559020996,20.586228448267445,6,20,19,1159,1152,723,780,15
0,1,0.58,-0.0,1.0,0.9602804183959961,19.90724809414742,6,20,18,1159,1152,723,780,15
0,1,0.64,-0.0,1.0,0.9702544212341309,19.248809496813376,6,20,17,1159,1152,723,780,15
1,1,0.71,1.0,1.0,0.9782330989837646,17.839484696748443,6,19,16,1159,1152,723,780,15
1,1,0.76,1.0,1.0,0.9882063865661621,16.430749027719962,6,18,15,1159,1152,723,780,15
1,1,0.78,1.0,1.0,0.9961967468261719,15.022715545545239,6,17,14,1159,1152,723,780,15
1,1,0.73,1.0,1.0,1.005162239074707,13.615528128088304,6,16,13,1159,1152,723,780,15
1,1,0.66,1.0,1.0,1.0141382217407227,12.209372712298546,6,15,12,1159,1152,723,780,15
1,1,0.63,1.0,1.0,1.0231130123138428,10.804493814764857,6,14,11,1159,1152,723,780,15
1,1,0.58,1.0,1.0,1.032090663909912,9.401219466856727,6,13,10,1159,1152,723,780,15
1,1,0.53,1.0,1.0,1.0420629978179932,8.0,6,12,9,1159,1152,723,780,15
1,1,0.45,1.0,1.0,0.006982088088989258,1000.7756539093177,7,-740,-719,408,425,1147,1143,63
1,1,0.18,1.0,1.0,0.015958070755004883,1002.1897212032261,7,-741,-720,408,425,1147,1143,63
0,-1,0.09,-0.0,-1.0,0.025931358337402344,1001.493099250547,7,-741,-719,408,425,1147,1143,63
2,-3,0.01,2.0,-3.0,0.03390955924987793,1000.8454341615318,7,-743,-716,408,425,1147,1143,63
-2,-2,0.0,-2.0,-2.0,0.04288601875305176,998.0174925626873,7,-741,-714,408,425,1147,1143,63
-1,-2,0.02,-1.0,-2.0,0.05086517333984375,995.909927890465,7,-740,-712,408,425,1147,1143,63
-5,-2,0.0,-5.0,-2.0,0.05884385108947754,990.9222083896601,7,-735,-710,408,425,1147,1143,63
-7,-6,0.0,-7.0,-6.0,0.06682252883911133,981.719112093773,7,-728,-704,408,425,1147,1143,63
-9,-4,0.0,-9.0,-4.0,0.07579898834228516,972.4744640497834,7,-719,-700,408,425,1147,1143,63
-10,-4,0.0,-10.0,-4.0,0.08477425575256348,962.5275537195735,7,-709,-696,408,425,1147,1143,63
-13,-5,0.0,-13.0,-5.0,0.09275364875793457,949.7634781128424,7,-696,-691,408,425,1147,1143,63
-16,-7,0.0,-16.0,-7.0,0.09973454475402832,933.497796783383,7,-680,-684,408,425,1147,1143,63
-17,-7,0.0,-17.0,-7.0,0.10771346092224121,916.5747991583567,7,-663,-677,408,425,1147,1143,63
-18,-7,0.0,-18.0,-7.0,0.11668896675109863,899.0134407630892,7,-645,-670,408,425,1147,1143,63
-15,-9,0.0,-15.0,-9.0,0.1266632080078125,882.1379961429707,7,-630,-661,408,425,1147,1143,63
-13,-12,0.0,-13.0,-12.0,0.13464140892028809,864.4831098351325,7,-617,-649,408,425,1147,1143,63
-13,-13,0.0,-13.0,-13.0,0.14461541175842285,846.1043267479645,7,-604,-636,408,425,1147,1143,63
-12,-10,0.0,-12.0,-10.0,0.15259432792663574,830.5915505620978,7,-592,-626,408,425,1147,1143,63
-10,-12,0.0,-10.0,-12.0,0.1625680923461914,815.0023640628908,7,-582,-614,408,425,1147,1143,63
-10,-11,0.0,-10.0,-11.0,0.17254018783569336,800.1395791321696,7,-572,-603,408,425,1147,1143,63
-11,-11,0.0,-11.0,-11.0,0.18051910400390625,784.5887444049238,7,-561,-592,408,425,1147,1143,63
-11,-10,0.0,-11.0,-10.0,0.19049310684204102,769.7646345837209,7,-550,-582,408,425,1147,1143,63
-11,-10,0.0,-11.0,-10.0,0.1984715461730957,754.942109827435,7,-539,-572,408,425,1147,1143,63
-12,-10,0.0,-12.0,-10.0,0.20744776725769043,739.4368890441319,7,-527,-562,408,425,1147,1143,63
-13,-10,0.0,-13.0,-10.0,0.21642303466796875,723.2545989253231,7,-514,-552,408,425,1147,1143,63
-13,-10,0.0,-13.0,-10.0,0.22440242767333984,707.0819737671419,7,-501,-542,408,425,1147,1143,63
-12,-10,0.0,-12.0,-10.0,0.23337841033935547,691.59601438148,7,-489,-532,408,425,1147,1143,63
-12,-11,0.0,-12.0,-11.0,0.24135780334472656,675.3780857302978,7,-477,-521,408,425,1147,1143,63
-11,-11,0.0,-11.0,-11.0,0.2513301372528076,659.837173290494,7,-466,-510,408,425,1147,1143,63
-10,-11,0.0,-10.0,-11.0,0.259310245513916,644.9711532306686,7,-456,-499,408,425,1147,1143,63
-10,-10,0.0,-10.0,-10.0,0.2672874927520752,630.8436371228479,7,-446,-489,408,425,1147,1143,63
-9,-10,0.0,-9.0,-10.0,0.27726149559020996,617.3903145482665,7,-437,-479,408,425,1147,1143,63
-9,-10,0.0,-9.0,-10.0,0.284243106842041,603.93700474929,7,-428,-469,408,425,1147,1143,63
-9,-9,0.0,-9.0,-9.0,0.2942171096801758,591.2226289681211,7,-419,-460,408,425,1147,1143,63
-9,-9,0.0,-9.0,-9.0,0.30219602584838867,578.5088186400587,7,-410,-451,408,425,1147,1143,63
-9,-8,0.0,-9.0,-8.0,0.31316542625427246,566.5366097570926,7,-401,-443,408,425,1147,1143,63
-9,-8,0.0,-9.0,-8.0,0.3191497325897217,554.5672463517747,7,-392,-435,408,425,1147,1143,63
-9,-8,0.0,-9.0,-8.0,0.3301200866699219,542.6009065543743,7,-383,-427,408,425,1147,1143,63
-8,-8,0.0,-8.0,-8.0,0.33710217475891113,531.3041881401916,7,-375,-419,408,425,1147,1143,63
-8,-8,0.0,-8.0,-8.0,0.34510135650634766,520.0081669086221,7,-367,-411,408,425,1147,1143,63
-8,-8,0.0,-8.0,-8.0,0.3530600070953369,508.7128866351071,7,-359,-403,408,425,1147,1143,63
-8,-8,0.0,-8.0,-8.0,0.36303257942199707,497.4183948350019,7,-351,-395,408,425,1147,1143,63
-8,-8,0.0,-8.0,-8.0,0.37200927734375,486.1247431713165,7,-343,-387,408,425,1147,1143,63
-8,-7,0.0,-8.0,-7.0,0.3809845447540283,475.5816814690401,7,-335,-380,408,425,1147,1143,63
-8,-7,0.0,-8.0,-7.0,0.3889646530151367,465.04233690280915,7,-327,-373,408,425,1147,1143,63
-7,-7,0.0,-7.0,-7.0,0.3989372253417969,455.1645811862481,7,-320,-366,408,425,1147,1143,63
-7,-7,0.0,-7.0,-7.0,0.4079132080078125,445.28772816439437,7,-313,-359,408,425,1147,1143,63
-7,-7,0.0,-7.0,-7.0,0.4158916473388672,435.4118351843143,7,-306,-352,408,425,1147,1143,63
-7,-7,0.0,-7.0,-7.0,0.4248692989349365,425.5369645494218,7,-299,-345,408,425,1147,1143,63
-7,-6,0.0,-7.0,-6.0,0.4328465461730957,416.4203839790941,7,-292,-339,408,425,1147,1143,63
-7,-6,0.0,-7.0,-6.0,0.43982815742492676,407.308110807911,7,-285,-333,408,425,1147,1143,63
-6,-6,0.0,-6.0,-6.0,0.44780683517456055,398.8488106299702,7,-279,-327,408,425,1147,1143,63
-6,-6,0.0,-6.0,-6.0,0.45578598976135254,390.3905551860412,7,-273,-321,408,425,1147,1143,63
-6,-6,0.0,-6.0,-6.0,0.46575927734375,381.93340867505503,7,-267,-315,408,425,1147,1143,63
-6,-6,0.0,-6.0,-6.0,0.47573280334472656,373.47744065645986,7,-261,-309,408,425,1147,1143,63
-6,-6,0.0,-6.0,-6.0,0.4827146530151367,365.0227266205817,7,-255,-303,408,425,1147,1143,63
-6,-5,0.0,-6.0,-5.0,0.48969459533691406,357.33619455312174,7,-249,-298,408,425,1147,1143,63
-6,-5,0.0,-6.0,-5.0,0.49966931343078613,349.6546991697331,7,-243,-293,408,425,1147,1143,63
-6,-5,0.0,-6.0,-5.0,0.5076475143432617,341.9785516621566,7,-237,-288,408,425,1147,1143,63
-6,-5,0.0,-6.0,-5.0,0.5166232585906982,334.3080891521566,7,-231,-283,408,425,1147,1143,63
-6,-5,0.0,-6.0,-5.0,0.5255990028381348,326.64367742209566,7,-225,-278,408,425,1147,1143,63
-6,-5,0.0,-6.0,-5.0,0.5355727672576904,318.9857139941572,7,-219,-273,408,425,1147,1143,63
-6,-5,0.0,-6.0,-5.0,0.5455465316772461,311.33463161065083,7,-213,-268,408,425,1147,1143,63
-5,-4,0.0,-5.0,-4.0,0.5545227527618408,305.0952246016001,7,-208,-264,408,425,1147,1143,63
-5,-4,0.0,-5.0,-4.0,0.5635032653808594,298.8620923962012,7,-203,-260,408,425,1147,1143,63
-5,-4,0.0,-5.0,-4.0,0.5714778900146484,292.6355975476122,7,-198,-256,408,425,1147,1143,63
-5,-4,0.0,-5.0,-4.0,0.5804533958435059,286.4161306550126,7,-193,-252,408,425,1147,1143,63
-5,-4,0.0,-5.0,-4.0,0.589432954788208,280.20411308335883,7,-188,-248,408,425,1147,1143,63
-5,-4,0.0,-5.0,-4.0,0.5984055995941162,274.0,7,-183,-244,408,425,1147,1143,63
-5,-4,0.0,-5.0,-4.0,0.6073825359344482,267.80428377116687,7,-178,-240,408,425,1147,1143,63
-5,-4,0.0,-5.0,-4.0,0.6153602600097656,261.61749776799064,7,-173,-236,408,425,1147,1143,63
-5,-3,0.0,-5.0,-3.0,0.6233389377593994,256.2507615307573,7,-168,-233,408,425,1147,1143,63
-5,-3,0.0,-5.0,-3.0,0.6323153972625732,250.9024654024863,7,-163,-230,408,425,1147,1143,63
-4,-3,0.0,-4.0,-3.0,0.6412909030914307,246.1461708196597,7,-159,-227,408,425,1147,1143,63
-4,-3,0.0,-4.0,-3.0,0.6492698192596436,241.3986049890858,7,-155,-224,408,425,1147,1143,63
-3,-3,0.01,-3.0,-3.0,0.6572492122650146,237.22565127146208,7,-152,-221,408,425,1147,1143,63
-3,-3,0.01,-3.0,-3.0,0.665226936340332,233.0549185302179,7,-149,-218,408,425,1147,1143,63
-3,-3,0.02,-3.0,-3.0,0.6742041110992432,228.88651369395836,7,-146,-215,408,425,1147,1143,63
-3,-3,0.02,-3.0,-3.0,0.6821818351745605,224.72055060162842,7,-143,-212,408,425,1147,1143,63
-3,-3,0.03,-3.0,-3.0,0.6911592483520508,220.55715056424057,7,-140,-209,408,425,1147,1143,63
-3,-3,0.03,-3.0,-3.0,0.7011337280273438,216.39644298170498,7,-137,-206,408,425,1147,1143,63
-3,-3,0.02,-3.0,-3.0,0.7111077308654785,212.2385660210979,7,-134,-203,408,425,1147,1143,63
-3,-3,0.03,-3.0,-3.0,0.7180891036987305,208.08366736354034,7,-131,-200,408,425,1147,1143,63
-3,-3,0.04,-3.0,-3.0,0.7260680198669434,203.93190502781866,7,-128,-197,408,425,1147,1143,63
-3,-3,0.05,-3.0,-3.0,0.7360410690307617,199.7834482799839,7,-125,-194,408,425,1147,1143,63
-3,-3,0.06,-3.0,-3.0,0.7450168132781982,195.63847863944022,7,-122,-191,408,425,1147,1143,63
-3,-3,0.07,-3.0,-3.0,0.7529962062835693,191.49719099350446,7,-119,-188,408,425,1147,1143,63
-3,-3,0.06,-3.0,-3.0,0.7629694938659668,187.35979483412234,7,-116,-185,408,425,1147,1143,63
-3,-3,0.04,-3.0,-3.0,0.7709484100341797,183.2265156324025,7,-113,-182,408,425,1147,1143,63
-3,-3,0.04,-3.0,-3.0,0.7799239158630371,179.09759636892565,7,-110,-179,408,425,1147,1143,63
-3,-3,0.04,-3.0,-3.0,0.78890061378479,174.9732992404598,7,-107,-176,408,425,1147,1143,63
-3,-3,0.04,-3.0,-3.0,0.7978761196136475,170.8539075668341,7,-104,-173,408,425,1147,1143,63
-3,-3,0.05,-3.0,-3.0,0.8078494071960449,166.73972792537162,7,-101,-170,408,425,1147,1143,63
-3,-3,0.05,-3.0,-3.0,0.8148312568664551,162.63109254456012,7,-98,-167,408,425,1147,1143,63
-3,-3,0.05,-3.0,-3.0,0.8238070011138916,158.52836199366047,7,-95,-164,408,425,1147,1143,63
-3,-3,0.05,-3.0,-3.0,0.8327834606170654,154.43192821086663,7,-92,-161,408,425,1147,1143,63
-3,-3,0.05,-3.0,-3.0,0.8417589664459229,150.34221791960084,7,-89,-158,408,425,1147,1143,63
-3,-3,0.05,-3.0,-3.0,0.8507354259490967,146.2596964907703,7,-86,-155,408,425,1147,1143,63
-3,-3,0.05,-3.0,-3.0,0.8607087135314941,142.18487231857176,7,-83,-152,408,425,1147,1143,63
-3,-2,0.05,-3.0,-2.0,0.868687629699707,139.0,7,-80,-150,408,425,1147,1143,63
-3,-2,0.05,-3.0,-2.0,0.8776640892028809,135.83225107874077,7,-77,-148,408,425,1147,1143,63
-3,-2,0.05,-3.0,-2.0,0.8856430053710938,132.682619724881,7,-74,-146,408,425,1147,1143,63
-3,-2,0.06,-3.0,-2.0,0.8946187496185303,129.55217220579732,7,-71,-144,408,425,1147,1143,63
-3,-2,0.06,-3.0,-2.0,0.901599645614624,126.44205283214521,7,-68,-142,408,425,1147,1143,63
-3,-2,0.07,-3.0,-2.0,0.9125699996948242,123.35349040433132,7,-65,-140,408,425,1147,1143,63
-3,-2,0.07,-3.0,-2.0,0.9205493927001953,120.28780519261954,7,-62,-138,408,425,1147,1143,63
-3,-2,0.07,-3.0,-2.0,0.9295253753662109,117.24641648282767,7,-59,-136,408,425,1147,1143,63
-3,-2,0.06,-3.0,-2.0,0.9385020732879639,114.23085071705668,7,-56,-134,408,425,1147,1143,63
-3,-2,0.06,-3.0,-2.0,0.947476863861084,111.24275025462634,7,-53,-132,408,425,1147,1143,63
-3,-2,0.06,-3.0,-2.0,0.9564535617828369,108.2838827718412,7,-50,-130,408,425,1147,1143,63
-3,-2,0.06,-3.0,-2.0,0.9654295444488525,105.35615130972272,7,-47,-128,408,425,1147,1143,63
-3,-3,0.06,-3.0,-3.0,0.9744062423706055,101.51792331605563,7,-44,-125,408,425,1147,1143,63
-3,-2,0.06,-3.0,-2.0,0.9833815097808838,98.65338406690356,7,-41,-123,408,425,1147,1143,63
-3,-2,0.06,-3.0,-2.0,0.9923584461212158,95.82665335015349,7,-38,-121,408,425,1147,1143,63
-3,-3,0.06,-3.0,-3.0,1.0003366470336914,92.08127396155761,7,-35,-118,408,425,1147,1143,63
-3,-2,0.05,-3.0,-2.0,1.0107977390289307,89.33287165193059,7,-32,-116,408,425,1147,1143,63
-3,-2,0.05,-3.0,-2.0,1.0177783966064453,86.63077828527702,7,-29,-114,408,425,1147,1143,63
-3,-2,0.06,-3.0,-2.0,1.0277528762817383,83.97825881443848,7,-26,-112,408,425,1147,1143,63
-3,-2,0.06,-3.0,-2.0,1.0357308387756348,81.37882362794157,7,-23,-110,408,425,1147,1143,63
-3,-2,0.06,-3.0,-2.0,1.0447072982788086,78.83624174196785,7,-20,-108,408,425,1147,1143,63
-2,-2,0.06,-2.0,-2.0,1.0536839962005615,76.5174404457249,7,-18,-106,408,425,1147,1143,63
-2,-2,0.06,-2.0,-2.0,1.0626592636108398,74.22357150372724,7,-16,-104,408,425,1147,1143,63
-2,-2,0.06,-2.0,-2.0,1.0706393718719482,71.95630140987001,7,-14,-102,408,425,1147,1143,63
-1,-2,0.07,-1.0,-2.0,1.0786168575286865,69.84145972763385,7,-13,-100,408,425,1147,1143,63
-1,-2,0.09,-1.0,-2.0,1.0875980854034424,67.73196037757987,7,-12,-98,408,425,1147,1143,63
0,-2,0.1,-0.0,-2.0,1.0965690612792969,65.74709297958259,7,-12,-96,408,425,1147,1143,63
0,-2,0.09,-0.0,-2.0,1.1050541400909424,63.76286192385707,7,-12,-94,408,425,1147,1143,63
1,-2,0.08,1.0,-2.0,1.1130321025848389,61.913938674452936,7,-13,-92,408,425,1147,1143,63
1,-1,0.07,1.0,-1.0,1.1210112571716309,61.070625065761334,7,-14,-91,408,425,1147,1143,63
2,-1,0.07,2.0,-1.0,1.1309845447540283,60.41115905621152,7,-16,-90,408,425,1147,1143,63
2,-1,0.07,2.0,-1.0,1.138963222503662,59.80198235721508,7,-18,-89,408,425,1147,1143,63
2,-1,0.07,2.0,-1.0,1.1479387283325195,59.24411338142782,7,-20,-88,408,425,1147,1143,63
2,-1,0.06,2.0,-1.0,1.1579127311706543,58.738509013689324,7,-22,-87,408,425,1147,1143,63
2,-1,0.04,2.0,-1.0,1.1668882369995117,58.28605714219886,7,-24,-86,408,425,1147,1143,63
2,-1,0.04,2.0,-1.0,1.1768732070922852,57.88756943465155,7,-26,-85,408,425,1147,1143,63
2,-2,0.03,2.0,-2.0,1.1848411560058594,56.59566199304621,7,-28,-83,408,425,1147,1143,63
2,-2,0.03,2.0,-2.0,1.1948144435882568,55.37708029332781,7,-30,-81,408,425,1147,1143,63
1,-2,0.05,1.0,-2.0,1.2027926445007324,53.86459803710851,7,-31,-79,408,425,1147,1143,63
1,-2,0.07,1.0,-2.0,1.2127668857574463,52.38465086573187,7,-32,-77,408,425,1147,1143,63
0,-2,0.1,-0.0,-2.0,1.220745325088501,50.541400527584756,7,-32,-75,408,425,1147,1143,63
0,-1,0.12,-0.0,-1.0,1.2307190895080566,49.62257748298549,7,-32,-74,408,425,1147,1143,63
0,-1,0.14,-0.0,-1.0,1.2386977672576904,48.7057087039567,7,-32,-73,408,425,1147,1143,63
-1,-1,0.16,-1.0,-1.0,1.2476730346679688,47.390050389064044,7,-31,-72,408,425,1147,1143,63
0,-1,0.15,-0.0,-1.0,1.2576470375061035,46.47257579298626,7,-31,-71,408,425,1147,1143,63
-1,-1,0.25,-1.0,-1.0,1.2666230201721191,45.15773105863909,7,-30,-70,408,425,1147,1143,63
0,-1,0.43,-0.0,-1.0,1.2746014595031738,44.23961722390672,7,-30,-69,408,425,1147,1143,63
0,-1,0.61,-0.0,-1.0,1.2845747470855713,43.32361670424818,7,-30,-68,408,425,1147,1143,63
0,-1,0.65,-0.0,-1.0,1.2945482730865479,42.40980860893181,7,-30,-67,408,425,1147,1143,63
1,-1,0.6,1.0,-1.0,1.301530122756958,41.91776189653656,7,-31,-66,408,425,1147,1143,63
1,0,0.54,1.0,-0.0,1.3105058670043945,42.348483283568996,7,-32,-66,408,425,1147,1143,63
1,-1,0.57,1.0,-1.0,1.319481372833252,41.89718787443039,7,-33,-65,408,425,1147,1143,63
1,0,0.67,1.0,-0.0,1.3294556140899658,42.355299740373226,7,-34,-65,408,425,1147,1143,63
1,0,0.74,1.0,-0.0,1.3374345302581787,42.824115301167,7,-35,-65,408,425,1147,1143,63
0,0,0.76,-0.0,-0.0,1.3464102745056152,42.824115301167,7,-35,-65,408,425,1147,1143,63
0,0,0.69,-0.0,-0.0,1.3553860187530518,42.824115301167,7,-35,-65,408,425,1147,1143,63
0,0,0.6,-0.0,-0.0,1.3653595447540283,42.824115301167,7,-35,-65,408,425,1147,1143,63
0,0,0.58,-0.0,-0.0,1.373337984085083,42.824115301167,7,-35,-65,408,425,1147,1143,63
0,0,0.68,-0.0,-0.0,1.3823144435882568,42.824115301167,7,-35,-65,408,425,1147,1143,63
0,0,0.78,-0.0,-0.0,1.3912906646728516,42.824115301167,7,-35,-65,408,425,1147,1143,63
0,0,0.82,-0.0,-0.0,1.400266408920288,42.824115301167,7,-35,-65,408,425,1147,1143,63
0,0,0.81,-0.0,-0.0,1.4092438220977783,42.824115301167,7,-35,-65,408,425,1147,1143,63
0,0,0.69,-0.0,-0.0,1.4182183742523193,42.824115301167,7,-35,-65,408,425,1147,1143,63
0,0,0.71,-0.0,-0.0,1.427194595336914,42.824115301167,7,-35,-65,408,425,1147,1143,63
0,0,0.73,-0.0,-0.0,1.437168836593628,42.824115301167,7,-35,-65,408,425,1147,1143,63
0,0,0.69,-0.0,-0.0,1.4461448192596436,42.824115301167,7,-35,-65,408,425,1147,1143,63
0,0,0.73,-0.0,-0.0,1.45512056350708,42.824115301167,7,-35,-65,408,425,1147,1143,63
0,0,0.78,-0.0,-0.0,1.464097023010254,42.824115301167,7,-35,-65,408,425,1147,1143,63
0,0,0.77,-0.0,-0.0,1.4720773696899414,42.824115301167,7,-35,-65,408,425,1147,1143,63
0,0,0.78,-0.0,-0.0,1.4820494651794434,42.824115301167,7,-35,-65,408,425,1147,1143,63
0,0,0.75,-0.0,-0.0,1.4900269508361816,42.824115301167,7,-35,-65,408,425,1147,1143,63
0,0,0.71,-0.0,-0.0,1.4990031719207764,42.824115301167,7,-35,-65,408,425,1147,1143,63
0,0,0.73,-0.0,-0.0,1.508976936340332,42.824115301167,7,-35,-65,408,425,1147,1143,63
0,0,0.73,-0.0,-0.0,1.516955852508545,42.824115301167,7,-35,-65,408,425,1147,1143,63
0,0,0.73,-0.0,-0.0,1.5249342918395996,42.824115301167,7,-35,-65,408,425,1147,1143,63
0,0,0.73,-0.0,-0.0,1.5329132080078125,42.824115301167,7,-35,-65,408,425,1147,1143,63
0,0,0.73,-0.0,-0.0,1.5418891906738281,42.824115301167,7,-35,-65,408,425,1147,1143,63
0,0,0.73,-0.0,-0.0,1.5508651733398438,42.824115301167,7,-35,-65,408,425,1147,1143,63
0,0,0.73,-0.0,-0.0,1.5598416328430176,42.824115301167,7,-35,-65,408,425,1147,1143,63
0,0,0.73,-0.0,-0.0,1.568816900253296,42.824115301167,7,-35,-65,408,425,1147,1143,63
0,0,0.73,-0.0,-0.0,1.5787909030914307,42.824115301167,7,-35,-65,408,425,1147,1143,63
0,0,0.73,-0.0,-0.0,1.5867698192596436,42.824115301167,7,-35,-65,408,425,1147,1143,63
0,0,0.73,-0.0,-0.0,1.5967423915863037,42.824115301167,7,-35,-65,408,425,1147,1143,63
0,0,0.73,-0.0,-0.0,1.6047217845916748,42.824115301167,7,-35,-65,408,425,1147,1143,63
0,0,0.73,-0.0,-0.0,1.6136975288391113,42.824115301167,7,-35,-65,408,425,1147,1143,63
0,0,0.73,-0.0,-0.0,1.6226739883422852,42.824115301167,7,-35,-65,408,425,1147,1143,63
0,0,0.73,-0.0,-0.0,1.6316494941711426,42.824115301167,7,-35,-65,408,425,1147,1143,63
0,0,0.73,-0.0,-0.0,1.6416242122650146,42.824115301167,7,-35,-65,408,425,1147,1143,63
0,0,0.73,-0.0,-0.0,1.650599479675293,42.824115301167,7,-35,-65,408,425,1147,1143,63
0,0,0.73,-0.0,-0.0,1.6585781574249268,42.824115301167,7,-35,-65,408,425,1147,1143,63
0,0,0.73,-0.0,-0.0,1.6665575504302979,42.824115301167,7,-35,-65,408,425,1147,1143,63
0,0,0.73,-0.0,-0.0,1.6755328178405762,42.824115301167,7,-35,-65,408,425,1147,1143,63
0,0,0.73,-0.0,-0.0,1.6845085620880127,42.824115301167,7,-35,-65,408,425,1147,1143,63
0,0,0.73,-0.0,-0.0,1.6944820880889893,42.824115301167,7,-35,-65,408,425,1147,1143,63
0,0,0.73,-0.0,-0.0,1.7024617195129395,42.824115301167,7,-35,-65,408,425,1147,1143,63
0,0,0.73,-0.0,-0.0,1.7124340534210205,42.824115301167,7,-35,-65,408,425,1147,1143,63
0,0,0.73,-0.0,-0.0,1.7204134464263916,42.824115301167,7,-35,-65,408,425,1147,1143,63
0,0,0.73,-0.0,-0.0,1.730386734008789,42.824115301167,7,-35,-65,408,425,1147,1143,63
0,0,0.73,-0.0,-0.0,1.7383661270141602,42.824115301167,7,-35,-65,408,425,1147,1143,63
0,0,0.73,-0.0,-0.0,1.7483384609222412,42.824115301167,7,-35,-65,408,425,1147,1143,63
0,0,0.73,-0.0,-0.0,1.756317377090454,42.824115301167,7,-35,-65,408,425,1147,1143,63
0,0,0.73,-0.0,-0.0,1.765293836593628,42.824115301167,7,-35,-65,408,425,1147,1143,63
0,0,0.73,-0.0,-0.0,1.7752668857574463,42.824115301167,7,-35,-65,408,425,1147,1143,63
0,0,0.73,-0.0,-0.0,1.7832460403442383,42.824115301167,7,-35,-65,408,425,1147,1143,63
0,0,0.73,-0.0,-0.0,1.7922227382659912,42.824115301167,7,-35,-65,408,425,1147,1143,63
0,0,0.73,-0.0,-0.0,1.8021948337554932,42.824115301167,7,-35,-65,408,425,1147,1143,63
0,0,0.73,-0.0,-0.0,1.8111708164215088,42.824115301167,7,-35,-65,408,425,1147,1143,63
0,0,0.73,-0.0,-0.0,1.8191502094268799,42.824115301167,7,-35,-65,408,425,1147,1143,63
0,0,0.73,-0.0,-0.0,1.8291237354278564,42.824115301167,7,-35,-65,408,425,1147,1143,63
0,0,0.73,-0.0,-0.0,1.8371026515960693,42.824115301167,7,-35,-65,408,425,1147,1143,63
0,0,0.73,-0.0,-0.0,1.847076654434204,42.824115301167,7,-35,-65,408,425,1147,1143,63
0,0,0.73,-0.0,-0.0,1.8550546169281006,42.824115301167,7,-35,-65,408,425,1147,1143,63
0,0,0.73,-0.0,-0.0,1.8630340099334717,42.824115301167,7,-35,-65,408,425,1147,1143,63
0,0,0.73,-0.0,-0.0,1.8700141906738281,42.824115301167,7,-35,-65,408,425,1147,1143,63
0,0,0.73,-0.0,-0.0,1.8799877166748047,42.824115301167,7,-35,-65,408,425,1147,1143,63
0,0,0.73,-0.0,-0.0,1.8879661560058594,42.824115301167,7,-35,-65,408,425,1147,1143,63
0,0,0.73,-0.0,-0.0,1.897939920425415,42.824115301167,7,-35,-65,408,425,1147,1143,63
0,0,0.73,-0.0,-0.0,1.9069154262542725,42.824115301167,7,-35,-65,408,425,1147,1143,63
0,0,0.73,-0.0,-0.0,1.9148948192596436,42.824115301167,7,-35,-65,408,425,1147,1143,63
0,0,0.73,-0.0,-0.0,1.924868106842041,42.824115301167,7,-35,-65,408,425,1147,1143,63
0,0,0.73,-0.0,-0.0,1.9338440895080566,42.824115301167,7,-35,-65,408,425,1147,1143,63
0,0,0.73,-0.0,-0.0,1.9408254623413086,42.824115301167,7,-35,-65,408,425,1147,1143,63
0,0,0.73,-0.0,-0.0,1.9498016834259033,42.824115301167,7,-35,-65,408,425,1147,1143,63
0,0,0.73,-0.0,-0.0,1.9577817916870117,42.824115301167,7,-35,-65,408,425,1147,1143,63
0,0,0.73,-0.0,-0.0,1.96575927734375,42.824115301167,7,-35,-65,408,425,1147,1143,63
0,0,0.73,-0.0,-0.0,1.973738431930542,42.824115301167,7,-35,-65,408,425,1147,1143,63
0,0,0.73,-0.0,-0.0,1.9827146530151367,42.824115301167,7,-35,-65,408,425,1147,1143,63
0,0,0.73,-0.0,-0.0,1.9926881790161133,42.824115301167,7,-35,-65,408,425,1147,1143,63
0,0,0.73,-0.0,-0.0,1.9996685981750488,42.824115301167,7,-35,-65,408,425,1147,1143,63
0,0,0.73,-0.0,-0.0,2.008645534515381,42.824115301167,7,-35,-65,408,425,1147,1143,63
0,0,0.73,-0.0,-0.0,2.017620801925659,42.824115301167,7,-35,-65,408,425,1147,1143,63
0,0,0.73,-0.0,-0.0,2.0285911560058594,42.824115301167,7,-35,-65,408,425,1147,1143,63
0,0,0.73,-0.0,-0.0,2.0365703105926514,42.824115301167,7,-35,-65,408,425,1147,1143,63
0,0,0.73,-0.0,-0.0,2.0475406646728516,42.824115301167,7,-35,-65,408,425,1147,1143,63
0,0,0.73,-0.0,-0.0,2.05452299118042,42.824115301167,7,-35,-65,408,425,1147,1143,63
0,0,0.73,-0.0,-0.0,2.065492630004883,42.824115301167,7,-35,-65,408,425,1147,1143,63
0,0,0.73,-0.0,-0.0,2.073472023010254,42.824115301167,7,-35,-65,408,425,1147,1143,63
0,0,0.73,-0.0,-0.0,2.0824549198150635,42.824115301167,7,-35,-65,408,425,1147,1143,63
0,0,0.73,-0.0,-0.0,2.088432550430298,42.824115301167,7,-35,-65,408,425,1147,1143,63
0,0,0.73,-0.0,-0.0,2.098405599594116,42.824115301167,7,-35,-65,408,425,1147,1143,63
0,0,0.73,-0.0,-0.0,2.1073813438415527,42.824115301167,7,-35,-65,408,425,1147,1143,63
0,0,0.73,-0.0,-0.0,2.115360975265503,42.824115301167,7,-35,-65,408,425,1147,1143,63
0,0,0.73,-0.0,-0.0,2.1233391761779785,42.824115301167,7,-35,-65,408,425,1147,1143,63
0,0,0.73,-0.0,-0.0,2.133312463760376,42.824115301167,7,-35,-65,408,425,1147,1143,63
0,0,0.73,-0.0,-0.0,2.1422886848449707,42.824115301167,7,-35,-65,408,425,1147,1143,63
0,0,0.73,-0.0,-0.0,2.1502676010131836,42.824115301167,7,-35,-65,408,425,1147,1143,63
0,0,0.73,-0.0,-0.0,2.1582467555999756,42.824115301167,7,-35,-65,408,425,1147,1143,63
0,0,0.73,-0.0,-0.0,2.1662251949310303,42.824115301167,7,-35,-65,408,425,1147,1143,63
0,0,0.73,-0.0,-0.0,2.174203872680664,42.824115301167,7,-35,-65,408,425,1147,1143,63
0,0,0.73,-0.0,-0.0,2.182182788848877,42.824115301167,7,-35,-65,408,425,1147,1143,63
0,0,0.73,-0.0,-0.0,2.1921558380126953,42.824115301167,7,-35,-65,408,425,1147,1143,63
0,0,0.73,-0.0,-0.0,2.20013427734375,42.824115301167,7,-35,-65,408,425,1147,1143,63
0,0,0.73,-0.0,-0.0,2.2091104984283447,42.824115301167,7,-35,-65,408,425,1147,1143,63
0,0,0.73,-0.0,-0.0,2.2180862426757812,42.824115301167,7,-35,-65,408,425,1147,1143,63
0,0,0.73,-0.0,-0.0,2.228060007095337,42.824115301167,7,-35,-65,408,425,1147,1143,63
0,0,0.73,-0.0,-0.0,2.23603892326355,42.824115301167,7,-35,-65,408,425,1147,1143,63
0,0,0.73,-0.0,-0.0,2.2460122108459473,42.824115301167,7,-35,-65,408,425,1147,1143,63
0,0,0.73,-0.0,-0.0,2.2539913654327393,42.824115301167,7,-35,-65,408,425,1147,1143,63
0,0,0.73,-0.0,-0.0,2.263965606689453,42.824115301167,7,-35,-65,408,425,1147,1143,63
0,0,0.73,-0.0,-0.0,2.272940158843994,42.824115301167,7,-35,-65,408,425,1147,1143,63
0,0,0.73,-0.0,-0.0,2.280919075012207,42.824115301167,7,-35,-65,408,425,1147,1143,63
0,0,0.73,-0.0,-0.0,2.288897752761841,42.824115301167,7,-35,-65,408,425,1147,1143,63
0,0,0.73,-0.0,-0.0,2.2988710403442383,42.824115301167,7,-35,-65,408,425,1147,1143,63
0,0,0.73,-0.0,-0.0,2.306849718093872,42.824115301167,7,-35,-65,408,425,1147,1143,63
0,0,0.73,-0.0,-0.0,2.3158316612243652,42.824115301167,7,-35,-65,408,425,1147,1143,63
0,0,0.73,-0.0,-0.0,2.32480525970459,42.824115301167,7,-35,-65,408,425,1147,1143,63
0,0,0.73,-0.0,-0.0,2.3327808380126953,42.824115301167,7,-35,-65,408,425,1147,1143,63
0,0,0.73,-0.0,-0.0,2.34175705909729,42.824115301167,7,-35,-65,408,425,1147,1143,63
0,0,0.73,-0.0,-0.0,2.3497350215911865,42.824115301167,7,-35,-65,408,425,1147,1143,63
0,0,0.73,-0.0,-0.0,2.3577141761779785,42.824115301167,7,-35,-65,408,425,1147,1143,63
0,0,0.73,-0.0,-0.0,2.365692615509033,42.824115301167,7,-35,-65,408,425,1147,1143,63
0,0,0.73,-0.0,-0.0,2.374669313430786,42.824115301167,7,-35,-65,408,425,1147,1143,63
0,0,0.73,-0.0,-0.0,2.382648229598999,42.824115301167,7,-35,-65,408,425,1147,1143,63
0,0,0.73,-0.0,-0.0,2.3916244506835938,42.824115301167,7,-35,-65,408,425,1147,1143,63
0,0,0.73,-0.0,-0.0,2.401597023010254,42.824115301167,7,-35,-65,408,425,1147,1143,63
0,0,0.73,-0.0,-0.0,2.409576416015625,42.824115301167,7,-35,-65,408,425,1147,1143,63
0,0,0.73,-0.0,-0.0,2.4185519218444824,42.824115301167,7,-35,-65,408,425,1147,1143,63
0,0,0.73,-0.0,-0.0,2.42852520942688,42.824115301167,7,-35,-65,408,425,1147,1143,63
0,0,0.73,-0.0,-0.0,2.436504364013672,42.824115301167,7,-35,-65,408,425,1147,1143,63
0,0,0.73,-0.0,-0.0,2.4464781284332275,42.824115301167,7,-35,-65,408,425,1147,1143,63
0,0,0.73,-0.0,-0.0,2.4544565677642822,42.824115301167,7,-35,-65,408,425,1147,1143,63
0,0,0.73,-0.0,-0.0,2.464430332183838,42.824115301167,7,-35,-65,408,425,1147,1143,63
0,0,0.73,-0.0,-0.0,2.4724111557006836,42.824115301167,7,-35,-65,408,425,1147,1143,63
0,0,0.73,-0.0,-0.0,2.4824059009552,42.824115301167,7,-35,-65,408,425,1147,1143,63
0,0,0.73,-0.0,-0.0,2.4903602600097656,42.824115301167,7,-35,-65,408,425,1147,1143,63
0,0,0.73,-0.0,-0.0,2.4993371963500977,42.824115301167,7,-35,-65,408,425,1147,1143,63
0,0,0.73,-0.0,-0.0,2.5073153972625732,42.824115301167,7,-35,-65,408,425,1147,1143,63
0,0,0.73,-0.0,-0.0,2.51728892326355,42.824115301167,7,-35,-65,408,425,1147,1143,63
0,0,0.73,-0.0,-0.0,2.5262653827667236,42.824115301167,7,-35,-65,408,425,1147,1143,63
0,0,0.73,-0.0,-0.0,2.5342442989349365,42.824115301167,7,-35,-65,408,425,1147,1143,63
0,0,0.73,-0.0,-0.0,2.543219566345215,42.824115301167,7,-35,-65,408,425,1147,1143,63
0,0,0.73,-0.0,-0.0,2.553192615509033,42.824115301167,7,-35,-65,408,425,1147,1143,63
0,0,0.73,-0.0,-0.0,2.5611732006073,42.824115301167,7,-35,-65,408,425,1147,1143,63
0,0,0.73,-0.0,-0.0,2.57014799118042,42.824115301167,7,-35,-65,408,425,1147,1143,63
0,0,0.73,-0.0,-0.0,2.5791258811950684,42.824115301167,7,-35,-65,408,425,1147,1143,63
0,0,0.73,-0.0,-0.0,2.5871026515960693,42.824115301167,7,-35,-65,408,425,1147,1143,63
0,0,0.73,-0.0,-0.0,2.597076416015625,42.824115301167,7,-35,-65,408,425,1147,1143,63
0,0,0.73,-0.0,-0.0,2.6040585041046143,42.824115301167,7,-35,-65,408,425,1147,1143,63
0,0,0.73,-0.0,-0.0,2.614065408706665,42.824115301167,7,-35,-65,408,425,1147,1143,63
0,0,0.73,-0.0,-0.0,2.6210134029388428,42.824115301167,7,-35,-65,408,425,1147,1143,63
0,0,0.73,-0.0,-0.0,2.6309866905212402,42.824115301167,7,-35,-65,408,425,1147,1143,63
0,0,0.73,-0.0,-0.0,2.638964891433716,42.824115301167,7,-35,-65,408,425,1147,1143,63
0,0,0.73,-0.0,-0.0,2.6489381790161133,42.824115301167,7,-35,-65,408,425,1147,1143,63
0,0,0.73,-0.0,-0.0,2.656916856765747,42.824115301167,7,-35,-65,408,425,1147,1143,63
0,0,0.73,-0.0,-0.0,2.665893077850342,42.824115301167,7,-35,-65,408,425,1147,1143,63
0,0,0.73,-0.0,-0.0,2.676863193511963,42.824115301167,7,-35,-65,408,425,1147,1143,63
0,0,0.73,-0.0,-0.0,2.684842109680176,42.824115301167,7,-35,-65,408,425,1147,1143,63
0,0,0.73,-0.0,-0.0,2.692824125289917,42.824115301167,7,-35,-65,408,425,1147,1143,63
0,0,0.73,-0.0,-0.0,2.702796697616577,42.824115301167,7,-35,-65,408,425,1147,1143,63
0,0,0.73,-0.0,-0.0,2.710784435272217,42.824115301167,7,-35,-65,408,425,1147,1143,63
0,0,0.73,-0.0,-0.0,2.718752861022949,42.824115301167,7,-35,-65,408,425,1147,1143,63
0,0,0.73,-0.0,-0.0,2.7287256717681885,42.824115301167,7,-35,-65,408,425,1147,1143,63
0,0,0.73,-0.0,-0.0,2.737701416015625,42.824115301167,7,-35,-65,408,425,1147,1143,63
0,0,0.73,-0.0,-0.0,2.745680093765259,42.824115301167,7,-35,-65,408,425,1147,1143,63
0,0,0.73,-0.0,-0.0,2.752661943435669,42.824115301167,7,-35,-65,408,425,1147,1143,63
0,0,0.73,-0.0,-0.0,2.7616379261016846,42.824115301167,7,-35,-65,408,425,1147,1143,63
0,0,0.73,-0.0,-0.0,2.7686188220977783,42.824115301167,7,-35,-65,408,425,1147,1143,63
0,0,0.73,-0.0,-0.0,2.778592109680176,42.824115301167,7,-35,-65,408,425,1147,1143,63
0,0,0.73,-0.0,-0.0,2.7855732440948486,42.824115301167,7,-35,-65,408,425,1147,1143,63
0,0,0.73,-0.0,-0.0,2.795546770095825,42.824115301167,7,-35,-65,408,425,1147,1143,63
0,0,0.73,-0.0,-0.0,2.8025283813476562,42.824115301167,7,-35,-65,408,425,1147,1143,63
0,0,0.73,-0.0,-0.0,2.812501907348633,42.824115301167,7,-35,-65,408,425,1147,1143,63
0,0,0.73,-0.0,-0.0,2.820481061935425,42.824115301167,7,-35,-65,408,425,1147,1143,63
0,0,0.73,-0.0,-0.0,2.830454111099243,42.824115301167,7,-35,-65,408,425,1147,1143,63
0,0,0.73,-0.0,-0.0,2.838433027267456,42.824115301167,7,-35,-65,408,425,1147,1143,63
0,0,0.73,-0.0,-0.0,2.8484067916870117,42.824115301167,7,-35,-65,408,425,1147,1143,63
0,0,0.73,-0.0,-0.0,2.8563857078552246,42.824115301167,7,-35,-65,408,425,1147,1143,63
0,0,0.73,-0.0,-0.0,2.866358518600464,42.824115301167,7,-35,-65,408,425,1147,1143,63
0,0,0.73,-0.0,-0.0,2.874337673187256,42.824115301167,7,-35,-65,408,425,1147,1143,63
0,0,0.73,-0.0,-0.0,2.883335828781128,42.824115301167,7,-35,-65,408,425,1147,1143,63
0,0,0.73,-0.0,-0.0,2.893286943435669,42.824115301167,7,-35,-65,408,425,1147,1143,63
0,0,0.73,-0.0,-0.0,2.9022631645202637,42.824115301167,7,-35,-65,408,425,1147,1143,63
