dx,dy,button,rx,ry,time,distance,targetID,directionX,directionY,targetX,targetY,initMouseX,initMouseY,targetSize
-3,4,0.13,-3.0,4.0,0.03889799118041992,962.5703059419407,1,-478,847,389,1171,870,320,20
-5,4,0.0,-5.0,4.0,0.045877695083618164,956.632298239615,1,-473,843,389,1171,870,320,20
2,3,0.21,2.0,3.0,0.05385637283325195,955.0,1,-475,840,389,1171,870,320,20
0,5,0.55,-0.0,5.0,0.06383085250854492,950.6508210583073,1,-475,835,389,1171,870,320,20
-1,5,1.0,-1.0,5.0,0.07083272933959961,945.8116969361695,1,-474,830,389,1171,870,320,20
-2,7,0.91,-2.0,7.0,0.0797879695892334,938.7428524104938,1,-472,823,389,1171,870,320,20
-5,6,0.0,-5.0,6.0,0.08876323699951172,931.0515395024865,1,-467,817,389,1171,870,320,20
-4,7,0.0,-4.0,7.0,0.09773945808410645,922.9892818248236,1,-463,810,389,1171,870,320,20
-5,10,0.0,-5.0,10.0,0.10671567916870117,911.8264478740019,1,-458,800,389,1171,870,320,20
-6,8,0.0,-6.0,8.0,0.11668920516967773,901.9035036669176,1,-452,792,389,1171,870,320,20
-7,11,0.0,-7.0,11.0,0.12466716766357422,888.8804147382453,1,-445,781,389,1171,870,320,20
-5,8,0.0,-5.0,8.0,0.13563919067382812,879.4543271017349,1,-440,773,389,1171,870,320,20
-4,13,0.01,-4.0,13.0,0.14361786842346191,866.1826293644493,1,-436,760,389,1171,870,320,20
-2,11,0.0,-2.0,11.0,0.15359163284301758,855.654087958926,1,-434,749,389,1171,870,320,20
-5,13,0.0,-5.0,13.0,0.16157102584838867,841.9019896678255,1,-429,736,389,1171,870,320,20
-7,11,0.0,-7.0,11.0,0.17154312133789062,828.873649604039,1,-422,725,389,1171,870,320,20
-6,15,0.0,-6.0,15.0,0.18051910400390625,812.8948900072232,1,-416,710,389,1171,870,320,20
-6,13,0.0,-6.0,13.0,0.18949508666992188,798.6463998559568,1,-410,697,389,1171,870,320,20
-7,13,0.0,-7.0,13.0,0.19647645950317383,783.8923100773807,1,-403,684,389,1171,870,320,20
-6,13,0.0,-6.0,13.0,0.20546722412109375,769.6473561809852,1,-397,671,389,1171,870,320,20
-7,15,0.0,-7.0,15.0,0.21343183517456055,753.1749471779062,1,-390,656,389,1171,870,320,20
-6,14,0.0,-6.0,14.0,0.2234053611755371,738.0775360883389,1,-384,642,389,1171,870,320,20
-5,13,0.0,-5.0,13.0,0.2313840389251709,724.3582232126225,1,-379,629,389,1171,870,320,20
-4,14,0.0,-4.0,14.0,0.23936200141906738,710.3124322125782,1,-375,615,389,1171,870,320,20
-4,13,0.0,-4.0,13.0,0.24833893775939941,697.1386002757876,1,-371,602,389,1171,870,320,20
-4,13,0.0,-4.0,13.0,0.25731468200683594,683.9812677587198,1,-367,589,389,1171,870,320,20
-4,12,0.0,-4.0,12.0,0.2652933597564697,671.6876117401578,1,-363,577,389,1171,870,320,20
-4,12,0.0,-4.0,12.0,0.276263952255249,659.4072004393141,1,-359,565,389,1171,870,320,20
-4,12,0.0,-4.0,12.0,0.28524017333984375,647.1407763942213,1,-355,553,389,1171,870,320,20
-4,12,0.0,-4.0,12.0,0.2922213077545166,634.8891377593516,1,-351,541,389,1171,870,320,20
-4,11,0.0,-4.0,11.0,0.3021972179412842,623.4895421394106,1,-347,530,389,1171,870,320,20
-5,12,0.0,-5.0,12.0,0.31017398834228516,610.7157159279923,1,-342,518,389,1171,870,320,20
-5,11,0.0,-5.0,11.0,0.31815242767333984,598.7840339562134,1,-337,507,389,1171,870,320,20
-5,11,0.0,-5.0,11.0,0.32613158226013184,586.858442178713,1,-332,496,389,1171,870,320,20
-5,10,0.0,-5.0,10.0,0.3361043930053711,575.768725692999,1,-327,486,389,1171,870,320,20
-5,10,0.0,-5.0,10.0,0.3440837860107422,564.6825210496662,1,-322,476,389,1171,870,320,20
-5,10,0.0,-5.0,10.0,0.35405611991882324,553.6000354861593,1,-317,466,389,1171,870,320,20
-5,10,0.0,-5.0,10.0,0.3620476722717285,542.5214927946242,1,-312,456,389,1171,870,320,20
-5,9,0.0,-5.0,9.0,0.37101125717163086,532.2711498872128,1,-307,447,389,1171,870,320,20
-5,9,0.0,-5.0,9.0,0.3809847831726074,522.0225559128108,1,-302,438,389,1171,870,320,20
-5,9,0.0,-5.0,9.0,0.3879659175872803,511.77581392778256,1,-297,429,389,1171,870,320,20
-5,9,0.0,-5.0,9.0,0.3969423770904541,501.53103522660285,1,-292,420,389,1171,870,320,20
-5,8,0.0,-5.0,8.0,0.4073805809020996,492.10855400002896,1,-287,412,389,1171,870,320,20
-5,8,0.0,-5.0,8.0,0.4173576831817627,482.6865129065337,1,-282,404,389,1171,870,320,20
-5,8,0.0,-5.0,8.0,0.4263296127319336,473.26493768946244,1,-277,396,389,1171,870,320,20
-5,8,0.0,-5.0,8.0,0.4343080520629883,463.8438561382853,1,-272,388,389,1171,870,320,20
-5,8,0.0,-5.0,8.0,0.4402921199798584,454.42329829585424,1,-267,380,389,1171,870,320,20
-5,8,0.0,-5.0,8.0,0.44926881790161133,445.0032966913537,1,-262,372,389,1171,870,320,20
-5,8,0.0,-5.0,8.0,0.4572467803955078,435.58388660273613,1,-257,364,389,1171,870,320,20
-5,7,0.0,-5.0,7.0,0.4672203063964844,426.98169298038107,1,-252,357,389,1171,870,320,20
-5,7,0.0,-5.0,7.0,0.47519898414611816,418.37950464512187,1,-247,350,389,1171,870,320,20
-5,7,0.0,-5.0,7.0,0.48616957664489746,409.7773219219923,1,-242,343,389,1171,870,320,20
-5,7,0.0,-5.0,7.0,0.4931521415710449,401.17514516322603,1,-237,336,389,1171,870,320,20
-5,7,0.0,-5.0,7.0,0.5021276473999023,392.57297475116235,1,-232,329,389,1171,870,320,20
-5,7,0.0,-5.0,7.0,0.5091092586517334,383.97081110153323,1,-227,322,389,1171,870,320,20
-5,7,0.0,-5.0,7.0,0.5190823078155518,375.36865466719007,1,-222,315,389,1171,870,320,20
-5,7,0.0,-5.0,7.0,0.5270609855651855,366.76650594234087,1,-217,308,389,1171,870,320,20
-5,6,0.0,-5.0,6.0,0.537034273147583,358.982384403375,1,-212,302,389,1171,870,320,20
-5,6,0.0,-5.0,6.0,0.5450129508972168,351.19939091864484,1,-207,296,389,1171,870,320,20
-5,6,0.0,-5.0,6.0,0.5539891719818115,343.4176000144871,1,-202,290,389,1171,870,320,20
-5,6,0.0,-5.0,6.0,0.5639631748199463,335.6370929168338,1,-197,284,389,1171,870,320,20
-5,6,0.0,-5.0,6.0,0.5709445476531982,327.8579583197649,1,-192,278,389,1171,870,320,20
-5,6,0.0,-5.0,6.0,0.5809171199798584,320.0802932621092,1,-187,272,389,1171,870,320,20
-5,6,0.0,-5.0,6.0,0.5888955593109131,312.3042041301975,1,-182,266,389,1171,870,320,20
-5,6,0.0,-5.0,6.0,0.5978734493255615,304.52980780841744,1,-177,260,389,1171,870,320,20
-5,5,0.0,-5.0,5.0,0.6068477630615234,297.5857603986244,1,-172,255,389,1171,870,320,20
-5,5,0.0,-5.0,5.0,0.6168217658996582,290.647634283059,1,-167,250,389,1171,870,320,20
-5,5,0.0,-5.0,5.0,0.6247999668121338,283.7158490786631,1,-162,245,389,1171,870,320,20
-5,5,0.0,-5.0,5.0,0.6347746849060059,276.7908645685912,1,-157,240,389,1171,870,320,20
-5,5,0.0,-5.0,5.0,0.6417553424835205,269.8731855680354,1,-152,235,389,1171,870,320,20
-5,5,0.0,-5.0,5.0,0.6517300605773926,262.96336750560505,1,-147,230,389,1171,870,320,20
-5,5,0.0,-5.0,5.0,0.6607043743133545,256.0620228442985,1,-142,225,389,1171,870,320,20
-5,5,0.0,-5.0,5.0,0.6696803569793701,249.16982849089516,1,-137,220,389,1171,870,320,20
-5,5,0.0,-5.0,5.0,0.6786673069000244,242.28753437298482,1,-132,215,389,1171,870,320,20
-5,5,0.0,-5.0,5.0,0.6876327991485596,235.41597340026587,1,-127,210,389,1171,870,320,20
-5,5,0.0,-5.0,5.0,0.6976070404052734,228.55607307297797,1,-122,205,389,1171,870,320,20
-5,5,0.0,-5.0,5.0,0.7055850028991699,221.70886905770354,1,-117,200,389,1171,870,320,20
-5,5,0.0,-5.0,5.0,0.713564395904541,214.87552112224222,1,-112,195,389,1171,870,320,20
-5,5,0.0,-5.0,5.0,0.7225399017333984,208.05733191066977,1,-107,190,389,1171,870,320,20
-5,5,0.0,-5.0,5.0,0.7315173149108887,201.25576915199264,1,-102,185,389,1171,870,320,20
-5,5,0.0,-5.0,5.0,0.7404923439025879,194.47249203743763,1,-97,180,389,1171,870,320,20
-5,5,0.0,-5.0,5.0,0.7504653930664062,187.70938268074178,1,-92,175,389,1171,870,320,20
-5,4,0.0,-5.0,4.0,0.7574467658996582,181.8593234638338,1,-87,171,389,1171,870,320,20
-5,4,0.0,-5.0,4.0,0.7674200534820557,176.04569331215382,1,-82,167,389,1171,870,320,20
-5,4,0.0,-5.0,4.0,0.7744019031524658,170.2720166858961,1,-77,163,389,1171,870,320,20
-5,4,0.0,-5.0,4.0,0.7843747138977051,164.54225849346628,1,-72,159,389,1171,870,320,20
-4,4,0.0,-4.0,4.0,0.792353630065918,159.26015479137433,1,-68,155,389,1171,870,320,20
-4,4,0.0,-4.0,4.0,0.8023271560668945,154.00304875214974,1,-64,151,389,1171,870,320,20
-4,4,0.0,-4.0,4.0,0.8103060722351074,148.7734234687909,1,-60,147,389,1171,870,320,20
-4,4,0.0,-4.0,4.0,0.820279598236084,143.57408635573907,1,-56,143,389,1171,870,320,20
-4,3,0.0,-4.0,3.0,0.8282580375671387,139.34523762075577,1,-52,140,389,1171,870,320,20
-4,4,0.0,-4.0,4.0,0.8382313251495361,134.22205101855957,1,-48,136,389,1171,870,320,20
-4,3,0.0,-4.0,3.0,0.84720778465271,130.089257261219,1,-44,133,389,1171,870,320,20
-4,3,0.0,-4.0,3.0,0.8561832904815674,126.01470508735443,1,-40,130,389,1171,870,320,20
-4,3,0.0,-4.0,3.0,0.8641631603240967,122.00378782444085,1,-36,127,389,1171,870,320,20
-4,3,0.0,-4.0,3.0,0.8721411228179932,118.06248474865697,1,-32,124,389,1171,870,320,20
-4,3,0.0,-4.0,3.0,0.8801193237304688,114.19742348374221,1,-28,121,389,1171,870,320,20
-4,3,0.0,-4.0,3.0,0.8890960216522217,110.41594578792295,1,-24,118,389,1171,870,320,20
-4,3,0.0,-4.0,3.0,0.8980727195739746,106.72617529928752,1,-20,115,389,1171,870,320,20
-4,3,0.0,-4.0,3.0,0.9085512161254883,103.13708498984761,1,-16,112,389,1171,870,320,20
-4,3,0.0,-4.0,3.0,0.917527437210083,99.65856099730654,1,-12,109,389,1171,870,320,20
-4,3,0.0,-4.0,3.0,0.924508810043335,96.30145812734649,1,-8,106,389,1171,870,320,20
-4,3,0.0,-4.0,3.0,0.9324867725372314,93.07764064044152,1,-4,103,389,1171,870,320,20
-4,3,0.0,-4.0,3.0,0.9414632320404053,90.0,1,0,100,389,1171,870,320,20
-4,3,0.0,-4.0,3.0,0.9514367580413818,87.082439194738,1,4,97,389,1171,870,320,20
-4,2,0.0,-4.0,2.0,0.9594159126281738,85.33624704172071,1,8,95,389,1171,870,320,20
-4,2,0.0,-4.0,2.0,0.969388484954834,83.7709976485267,1,12,93,389,1171,870,320,20
-4,2,0.0,-4.0,2.0,0.9773678779602051,82.39588735436226,1,16,91,389,1171,870,320,20
-3,2,0.0,-3.0,2.0,0.9863440990447998,81.00549433962765,1,19,89,389,1171,870,320,20
-3,1,0.01,-3.0,1.0,0.9963169097900391,80.70832376358854,1,22,88,389,1171,870,320,20
-2,1,0.01,-2.0,1.0,1.0048019886016846,80.24965373894794,1,24,87,389,1171,870,320,20
-2,1,0.04,-2.0,1.0,1.0127809047698975,79.8443097808648,1,26,86,389,1171,870,320,20
-1,1,0.11,-1.0,1.0,1.021756887435913,79.1852005660132,1,27,85,389,1171,870,320,20
-1,1,0.2,-1.0,1.0,1.0307338237762451,78.54377448471462,1,28,84,389,1171,870,320,20
0,1,0.25,-0.0,1.0,1.0397095680236816,77.5956619930462,1,28,83,389,1171,870,320,20
0,1,0.33,-0.0,1.0,1.048685073852539,76.64871608973787,1,28,82,389,1171,870,320,20
0,1,0.38,-0.0,1.0,1.0586585998535156,75.70297544426332,1,28,81,389,1171,870,320,20
0,1,0.41,-0.0,1.0,1.0686326026916504,74.75848040166836,1,28,80,389,1171,870,320,20
0,2,0.37,-0.0,2.0,1.0766119956970215,72.87339742040264,1,28,78,389,1171,870,320,20
0,2,0.41,-0.0,2.0,1.0855870246887207,70.99382692526635,1,28,76,389,1171,870,320,20
0,2,0.36,-0.0,2.0,1.0945637226104736,69.12016177940993,1,28,74,389,1171,870,320,20
0,2,0.39,-0.0,2.0,1.1026923656463623,67.25283166331187,1,28,72,389,1171,870,320,20
0,3,0.46,-0.0,3.0,1.1086757183074951,64.46475676452586,1,28,69,389,1171,870,320,20
0,2,0.43,-0.0,2.0,1.118649959564209,62.61542535852834,1,28,67,389,1171,870,320,20
0,2,0.41,-0.0,2.0,1.1266281604766846,60.77428911688199,1,28,65,389,1171,870,320,20
1,2,0.45,1.0,2.0,1.136601448059082,58.54195795277518,1,27,63,389,1171,870,320,20
1,2,0.33,1.0,2.0,1.144580364227295,56.30987860040162,1,26,61,389,1171,870,320,20
1,2,0.28,1.0,2.0,1.1535563468933105,54.07807737440318,1,25,59,389,1171,870,320,20
1,2,0.27,1.0,2.0,1.1625328063964844,51.84658438426491,1,24,57,389,1171,870,320,20
1,2,0.28,1.0,2.0,1.172511339187622,49.61543424315552,1,23,55,389,1171,870,320,20
1,2,0.29,1.0,2.0,1.1814839839935303,47.38466694161429,1,22,53,389,1171,870,320,20
1,2,0.29,1.0,2.0,1.1884634494781494,45.154328932550705,1,21,51,389,1171,870,320,20
1,2,0.27,1.0,2.0,1.1974408626556396,42.92447448959697,1,20,49,389,1171,870,320,20
1,2,0.24,1.0,2.0,1.2064154148101807,40.695167422546305,1,19,47,389,1171,870,320,20
1,2,0.26,1.0,2.0,1.2153916358947754,38.46648326421054,1,18,45,389,1171,870,320,20
1,2,0.25,1.0,2.0,1.2243671417236328,36.238512086787566,1,17,43,389,1171,870,320,20
1,2,0.25,1.0,2.0,1.2333433628082275,34.01136216933077,1,16,41,389,1171,870,320,20
1,2,0.27,1.0,2.0,1.2423193454742432,31.785164831552358,1,15,39,389,1171,870,320,20
1,2,0.28,1.0,2.0,1.2522943019866943,29.560080889704963,1,14,37,389,1171,870,320,20
1,2,0.28,1.0,2.0,1.2592742443084717,27.336309405188942,1,13,35,389,1171,870,320,20
1,1,0.3,1.0,1.0,1.2692487239837646,26.055512754639892,1,12,34,389,1171,870,320,20
1,1,0.3,1.0,1.0,1.2772276401519775,24.785054261852174,1,11,33,389,1171,870,320,20
0,1,0.32,-0.0,1.0,1.2891955375671387,23.837848631377263,1,11,32,389,1171,870,320,20
0,1,0.33,-0.0,1.0,1.2981712818145752,22.89376840679705,1,11,31,389,1171,870,320,20
0,1,0.34,-0.0,1.0,1.3061506748199463,21.953090617340916,1,11,30,389,1171,870,320,20
0,1,0.37,-0.0,1.0,1.313131332397461,21.016124838541646,1,11,29,389,1171,870,320,20
1,1,0.41,1.0,1.0,1.3221077919006348,19.732137494637012,1,10,28,389,1171,870,320,20
0,1,0.45,-0.0,1.0,1.3280918598175049,18.792360097775937,1,10,27,389,1171,870,320,20
0,1,0.45,-0.0,1.0,1.3370671272277832,17.85677655436824,1,10,26,389,1171,870,320,20
0,1,0.43,-0.0,1.0,1.3460431098937988,16.92582403567252,1,10,25,389,1171,870,320,20
0,1,0.41,-0.0,1.0,1.3550195693969727,16.0,1,10,24,389,1171,870,320,20
0,1,0.45,-0.0,1.0,1.364992618560791,15.079872407968907,1,10,23,389,1171,870,320,20
0,1,0.52,-0.0,1.0,1.372971534729004,14.166091947189145,1,10,22,389,1171,870,320,20
0,1,0.6,-0.0,1.0,1.3819479942321777,13.259406699226016,1,10,21,389,1171,870,320,20
0,1,0.62,-0.0,1.0,1.390923261642456,12.360679774997898,1,10,20,389,1171,870,320,20
0,1,0.62,-0.0,1.0,1.3998997211456299,11.470910553583888,1,10,19,389,1171,870,320,20
0,1,0.61,-0.0,1.0,1.4088754653930664,10.591260281974002,1,10,18,389,1171,870,320,20
0,1,0.6,-0.0,1.0,1.4178524017333984,9.72308292331602,1,10,17,389,1171,870,320,20
0,1,0.59,-0.0,1.0,0.007978439331054688,1077.0704645577855,2,1057,-352,1436,803,379,1154,75
1,1,0.55,1.0,1.0,0.018949031829833984,1076.4383682988475,2,1056,-353,1436,803,379,1154,75
5,1,0.09,5.0,1.0,0.025931358337402344,1072.0162307198214,2,1051,-354,1436,803,379,1154,75
4,0,0.0,4.0,-0.0,0.03490710258483887,1068.2262211873187,2,1047,-354,1436,803,379,1154,75
3,0,0.0,3.0,-0.0,0.042885541915893555,1065.3846878472143,2,1044,-354,1436,803,379,1154,75
4,-1,0.0,4.0,-1.0,0.052858829498291016,1061.2754663562325,2,1040,-353,1436,803,379,1154,75
5,-2,0.0,5.0,-2.0,0.05884385108947754,1055.8979824301991,2,1035,-351,1436,803,379,1154,75
6,0,0.0,6.0,-0.0,0.06981325149536133,1050.2175495272324,2,1029,-351,1436,803,379,1154,75
8,-2,0.0,8.0,-2.0,0.07878971099853516,1042.0004633919302,2,1021,-349,1436,803,379,1154,75
12,-3,0.0,12.0,-3.0,0.08876323699951172,1029.6756770452769,2,1009,-346,1436,803,379,1154,75
11,-3,0.0,11.0,-3.0,0.09574460983276367,1018.297588360743,2,998,-343,1436,803,379,1154,75
12,-5,0.0,12.0,-5.0,0.10372447967529297,1005.324325725923,2,986,-338,1436,803,379,1154,75
14,-5,0.0,14.0,-5.0,0.11170220375061035,990.4594882524566,2,972,-333,1436,803,379,1154,75
17,-6,0.0,17.0,-6.0,0.11968135833740234,972.4325138413167,2,955,-327,1436,803,379,1154,75
19,-4,0.0,19.0,-4.0,0.12765955924987793,953.1641278091223,2,936,-323,1436,803,379,1154,75
17,-6,0.0,17.0,-6.0,0.13663578033447266,935.1368216460068,2,919,-317,1436,803,379,1154,75
20,-6,0.0,20.0,-6.0,0.14561247825622559,914.2738827488117,2,899,-311,1436,803,379,1154,75
19,-6,0.0,19.0,-6.0,0.15459656715393066,894.3565375300697,2,880,-305,1436,803,379,1154,75
19,-6,0.0,19.0,-6.0,0.16156911849975586,874.4395207582344,2,861,-299,1436,803,379,1154,75
19,-7,0.0,19.0,-7.0,0.16954779624938965,854.1947037544602,2,842,-292,1436,803,379,1154,75
20,-7,0.0,20.0,-7.0,0.17752695083618164,833.0051723984174,2,822,-285,1436,803,379,1154,75
20,-7,0.0,20.0,-7.0,0.18650293350219727,811.8156454731499,2,802,-278,1436,803,379,1154,75
20,-7,0.0,20.0,-7.0,0.19647622108459473,790.6261233189779,2,782,-271,1436,803,379,1154,75
20,-7,0.0,20.0,-7.0,0.20345711708068848,769.4366063119903,2,762,-264,1436,803,379,1154,75
20,-7,0.0,20.0,-7.0,0.2124330997467041,748.2470948688699,2,742,-257,1436,803,379,1154,75
20,-7,0.0,20.0,-7.0,0.22240757942199707,727.0575894525228,2,722,-250,1436,803,379,1154,75
20,-6,0.0,20.0,-6.0,0.23138427734375,706.1958019257106,2,702,-244,1436,803,379,1154,75
20,-7,0.0,20.0,-7.0,0.24135613441467285,685.0062326600789,2,682,-237,1436,803,379,1154,75
20,-6,0.0,20.0,-6.0,0.2483382225036621,664.1454913211666,2,662,-231,1436,803,379,1154,75
20,-6,0.0,20.0,-6.0,0.2563164234161377,643.2859692805666,2,642,-225,1436,803,379,1154,75
20,-5,0.0,20.0,-5.0,0.2672913074493408,622.7605626285948,2,622,-220,1436,803,379,1154,75
19,-6,0.0,19.0,-6.0,0.2752668857574463,602.8476381139498,2,603,-214,1436,803,379,1154,75
19,-5,0.0,19.0,-5.0,0.2832448482513428,583.2717146541506,2,584,-209,1436,803,379,1154,75
18,-5,0.0,18.0,-5.0,0.29122352600097656,564.6410890223506,2,566,-204,1436,803,379,1154,75
17,-4,0.0,17.0,-4.0,0.3011970520019531,547.2953020519676,2,549,-200,1436,803,379,1154,75
17,-4,0.0,17.0,-4.0,0.31017374992370605,529.9567884768644,2,532,-196,1436,803,379,1154,75
16,-4,0.0,16.0,-4.0,0.3191494941711426,513.5633478538142,2,516,-192,1436,803,379,1154,75
16,-4,0.0,16.0,-4.0,0.3281252384185791,497.1760009584856,2,500,-188,1436,803,379,1154,75
15,-3,0.0,15.0,-3.0,0.3371012210845947,482.0857347298229,2,485,-185,1436,803,379,1154,75
15,-3,0.0,15.0,-3.0,0.3450798988342285,467.0079364454492,2,470,-182,1436,803,379,1154,75
14,-3,0.0,14.0,-3.0,0.3530585765838623,452.87447371750244,2,456,-179,1436,803,379,1154,75
14,-3,0.0,14.0,-3.0,0.36303186416625977,438.75203625418146,2,442,-176,1436,803,379,1154,75
14,-2,0.0,14.0,-2.0,0.3700129985809326,425.01731569282117,2,428,-174,1436,803,379,1154,75
13,-3,0.0,13.0,-3.0,0.3799872398376465,411.84964074843595,2,415,-171,1436,803,379,1154,75
13,-2,0.0,13.0,-2.0,0.38796544075012207,399.07912126126837,2,402,-169,1436,803,379,1154,75
12,-2,0.0,12.0,-2.0,0.3969447612762451,387.25110488954533,2,390,-167,1436,803,379,1154,75
12,-2,0.0,12.0,-2.0,0.40592026710510254,375.4427232962172,2,378,-165,1436,803,379,1154,75
11,-2,0.0,11.0,-2.0,0.4158914089202881,364.56942114658085,2,367,-163,1436,803,379,1154,75
11,-2,0.0,11.0,-2.0,0.4238698482513428,353.713449986048,2,356,-161,1436,803,379,1154,75
11,-2,0.0,11.0,-2.0,0.4328467845916748,342.87629565425635,2,345,-159,1436,803,379,1154,75
10,-2,0.0,10.0,-2.0,0.4428215026855469,332.9648631964933,2,335,-157,1436,803,379,1154,75
10,-2,0.0,10.0,-2.0,0.4527933597564697,323.06943774777665,2,325,-155,1436,803,379,1154,75
10,-2,0.0,10.0,-2.0,0.4607720375061035,313.191376250187,2,315,-153,1436,803,379,1154,75
10,-2,0.0,10.0,-2.0,0.4707448482513428,303.3321906608307,2,305,-151,1436,803,379,1154,75
10,-2,0.0,10.0,-2.0,0.4797208309173584,293.4935702854142,2,295,-149,1436,803,379,1154,75
10,-2,0.0,10.0,-2.0,0.4877002239227295,283.67740799750766,2,285,-147,1436,803,379,1154,75
9,-2,0.0,9.0,-2.0,0.4966773986816406,274.7707491090208,2,276,-145,1436,803,379,1154,75
9,-2,0.0,9.0,-2.0,0.5046546459197998,265.8828156234685,2,267,-143,1436,803,379,1154,75
9,-2,0.0,9.0,-2.0,0.5136322975158691,257.0153057240388,2,258,-141,1436,803,379,1154,75
9,-2,0.0,9.0,-2.0,0.5236043930053711,248.17012466245478,2,249,-139,1436,803,379,1154,75
9,-2,0.0,9.0,-2.0,0.5315825939178467,239.34941650019817,2,240,-137,1436,803,379,1154,75
8,-2,0.0,8.0,-2.0,0.5385642051696777,231.41944787961995,2,232,-135,1436,803,379,1154,75
8,-2,0.0,8.0,-2.0,0.5475404262542725,223.50911692299752,2,224,-133,1436,803,379,1154,75
8,-2,0.0,8.0,-2.0,0.5575144290924072,215.62026838715852,2,216,-131,1436,803,379,1154,75
8,-2,0.0,8.0,-2.0,0.5674877166748047,207.7549795203358,2,208,-129,1436,803,379,1154,75
8,-2,0.0,8.0,-2.0,0.5744681358337402,199.9155967850154,2,200,-127,1436,803,379,1154,75
8,-2,0.0,8.0,-2.0,0.5834441184997559,192.1047795223836,2,192,-125,1436,803,379,1154,75
8,-2,0.0,8.0,-2.0,0.592421293258667,184.32555207205516,2,184,-123,1436,803,379,1154,75
8,-2,0.0,8.0,-2.0,0.6013967990875244,176.58136622842358,2,176,-121,1436,803,379,1154,75
8,-2,0.0,8.0,-2.0,0.6103739738464355,168.8761763779384,2,168,-119,1436,803,379,1154,75
8,-2,0.0,8.0,-2.0,0.6193487644195557,161.2145302443794,2,160,-117,1436,803,379,1154,75
8,-2,0.0,8.0,-2.0,0.6293222904205322,153.60167890131504,2,152,-115,1436,803,379,1154,75
7,-2,0.0,7.0,-2.0,0.637300968170166,146.83144453547658,2,145,-113,1436,803,379,1154,75
7,-2,0.0,7.0,-2.0,0.6462771892547607,140.1016657177453,2,138,-111,1436,803,379,1154,75
7,-2,0.0,7.0,-2.0,0.6562511920928955,133.41713528867922,2,131,-109,1436,803,379,1154,75
7,-2,0.0,7.0,-2.0,0.6642305850982666,126.783393541592,2,124,-107,1436,803,379,1154,75
7,-2,0.0,7.0,-2.0,0.6712102890014648,120.20687007888682,2,117,-105,1436,803,379,1154,75
6,-2,0.0,6.0,-2.0,0.6811838150024414,114.42654985173505,2,111,-103,1436,803,379,1154,75
6,-2,0.0,6.0,-2.0,0.690159797668457,108.69145479402695,2,105,-101,1436,803,379,1154,75
6,-2,0.0,6.0,-2.0,0.6971421241760254,103.0071426749364,2,99,-99,1436,803,379,1154,75
6,-2,0.0,6.0,-2.0,0.7061171531677246,97.38005804433931,2,93,-97,1436,803,379,1154,75
6,-2,0.0,6.0,-2.0,0.7150936126708984,91.81770064707723,2,87,-95,1436,803,379,1154,75
6,-2,0.0,6.0,-2.0,0.7220747470855713,86.3288287465668,2,81,-93,1436,803,379,1154,75
6,-2,0.0,6.0,-2.0,0.7310512065887451,80.92370414806346,2,75,-91,1436,803,379,1154,75
6,-2,0.0,6.0,-2.0,0.740027666091919,75.61438629233834,2,69,-89,1436,803,379,1154,75
6,-2,0.0,6.0,-2.0,0.7470085620880127,70.41508273980894,2,63,-87,1436,803,379,1154,75
6,-2,0.0,6.0,-2.0,0.7569818496704102,65.34256201600583,2,57,-85,1436,803,379,1154,75
6,-2,0.0,6.0,-2.0,0.7639632225036621,60.41663102366043,2,51,-83,1436,803,379,1154,75
5,-2,0.0,5.0,-2.0,0.7719416618347168,56.150415994776964,2,46,-81,1436,803,379,1154,75
5,-2,0.0,5.0,-2.0,0.7799208164215088,52.00561780022652,2,41,-79,1436,803,379,1154,75
4,-2,0.01,4.0,-2.0,0.7888965606689453,48.42833253669417,2,37,-77,1436,803,379,1154,75
4,-2,0.01,4.0,-2.0,0.7978723049163818,44.93900170248598,2,33,-75,1436,803,379,1154,75
4,-2,0.02,4.0,-2.0,0.8068487644195557,41.54934754662193,2,29,-73,1436,803,379,1154,75
3,-2,0.04,3.0,-2.0,0.8178195953369141,38.61084578286372,2,26,-71,1436,803,379,1154,75
3,-2,0.07,3.0,-2.0,0.8258018493652344,35.73238618387272,2,23,-69,1436,803,379,1154,75
2,-2,0.15,2.0,-2.0,0.8357720375061035,33.21395872616783,2,21,-67,1436,803,379,1154,75
2,-2,0.27,2.0,-2.0,0.8437521457672119,30.72001181334805,2,19,-65,1436,803,379,1154,75
2,-2,0.4,2.0,-2.0,0.8537242412567139,28.253352404301808,2,17,-63,1436,803,379,1154,75
2,-2,0.58,2.0,-2.0,0.8617029190063477,25.81719509815764,2,15,-61,1436,803,379,1154,75
2,-1,0.7,2.0,-1.0,0.007978439331054688,281.2107916403903,3,-190,249,1233,1112,1421,864,64
-1,-1,0.74,-1.0,-1.0,0.01595902442932129,281.402297375115,3,-189,250,1233,1112,1421,864,64
-1,0,0.9,-1.0,-0.0,0.024933576583862305,280.80025575437116,3,-188,250,1233,1112,1421,864,64
-1,-1,0.76,-1.0,-1.0,0.03390932083129883,281.0015974400131,3,-187,251,1233,1112,1421,864,64
-1,0,0.5,-1.0,-0.0,0.04188823699951172,280.40518561637225,3,-186,251,1233,1112,1421,864,64
-1,-1,0.15,-1.0,-1.0,0.050864219665527344,280.61637832973497,3,-185,252,1233,1112,1421,864,64
-1,0,0.54,-1.0,-0.0,0.05884289741516113,280.0256399721023,3,-184,252,1233,1112,1421,864,64
-1,0,0.1,-1.0,-0.0,0.06682205200195312,279.4369920224635,3,-183,252,1233,1112,1421,864,64
-1,1,0.36,-1.0,1.0,0.07579779624938965,278.0403199585499,3,-182,251,1233,1112,1421,864,64
-1,3,0.11,-1.0,3.0,0.08377623558044434,275.02605752606735,3,-181,248,1233,1112,1421,864,64
-3,1,0.75,-3.0,1.0,0.09375,272.4552512274998,3,-178,247,1233,1112,1421,864,64
-3,4,0.22,-3.0,4.0,0.10272622108459473,267.4561737550255,3,-175,243,1233,1112,1421,864,64
-4,3,0.0,-4.0,3.0,0.10970711708068848,262.6879705722648,3,-171,240,1233,1112,1421,864,64
-4,4,0.0,-4.0,4.0,0.1186833381652832,257.110705439975,3,-167,236,1233,1112,1421,864,64
-5,4,0.0,-5.0,4.0,0.12766003608703613,250.9628950940388,3,-162,232,1233,1112,1421,864,64
-5,5,0.0,-5.0,5.0,0.137864351272583,244.0036231646244,3,-157,227,1233,1112,1421,864,64
-6,5,0.0,-6.0,5.0,0.1458437442779541,236.48649872945197,3,-151,222,1233,1112,1421,864,64
-6,6,0.0,-6.0,6.0,0.15581631660461426,228.155722597063,3,-145,216,1233,1112,1421,864,64
-5,5,0.0,-5.0,5.0,0.16379570960998535,221.2212471338059,3,-140,211,1233,1112,1421,864,64
-5,6,0.0,-5.0,6.0,0.17277145385742188,213.45875417267155,3,-135,205,1233,1112,1421,864,64
-5,5,0.0,-5.0,5.0,0.1817483901977539,206.53720883753127,3,-130,200,1233,1112,1421,864,64
-4,5,0.0,-4.0,5.0,0.19072365760803223,200.16588896735024,3,-126,195,1233,1112,1421,864,64
-4,5,0.0,-4.0,5.0,0.2006971836090088,193.79636843846714,3,-122,190,1233,1112,1421,864,64
-4,5,0.0,-4.0,5.0,0.20967340469360352,187.4288039433292,3,-118,185,1233,1112,1421,864,64
-4,5,0.0,-4.0,5.0,0.2176513671875,181.06337085477645,3,-114,180,1233,1112,1421,864,64
-4,5,0.0,-4.0,5.0,0.2256309986114502,174.70026608594387,3,-110,175,1233,1112,1421,864,64
-3,5,0.0,-3.0,5.0,0.23360991477966309,168.8706051168264,3,-107,170,1233,1112,1421,864,64
-4,5,0.0,-4.0,5.0,0.2425849437713623,162.50963986394095,3,-103,165,1233,1112,1421,864,64
-3,4,0.0,-3.0,4.0,0.2505640983581543,157.52836199366047,3,-100,161,1233,1112,1421,864,64
-3,4,0.0,-3.0,4.0,0.2595407962799072,152.54809671194118,3,-97,157,1233,1112,1421,864,64
-3,4,0.0,-3.0,4.0,0.2695133686065674,147.56892826989863,3,-94,153,1233,1112,1421,864,64
-3,4,0.0,-3.0,4.0,0.2784895896911621,142.59095051004218,3,-91,149,1233,1112,1421,864,64
-3,4,0.0,-3.0,4.0,0.28746891021728516,137.61426826773743,3,-88,145,1233,1112,1421,864,64
-3,4,0.0,-3.0,4.0,0.2944474220275879,132.63899902513984,3,-85,141,1233,1112,1421,864,64
-3,4,0.0,-3.0,4.0,0.30442047119140625,127.66527487215245,3,-82,137,1233,1112,1421,864,64
-3,4,0.0,-3.0,4.0,0.3114016056060791,122.69324484281788,3,-79,133,1233,1112,1421,864,64
-3,4,0.0,-3.0,4.0,0.32137513160705566,117.7230777134908,3,-76,129,1233,1112,1421,864,64
-3,4,0.0,-3.0,4.0,0.32935452461242676,112.75496537252184,3,-73,125,1233,1112,1421,864,64
-3,4,0.0,-3.0,4.0,0.339327335357666,107.78912690191609,3,-70,121,1233,1112,1421,864,64
-3,3,0.0,-3.0,3.0,0.3473074436187744,103.69450983735487,3,-67,118,1233,1112,1421,864,64
-3,4,0.0,-3.0,4.0,0.35727930068969727,98.73637596323374,3,-64,114,1233,1112,1421,864,64
-3,3,0.0,-3.0,3.0,0.36426210403442383,94.65701717630967,3,-61,111,1233,1112,1421,864,64
-3,3,0.0,-3.0,3.0,0.37323713302612305,90.58874336577564,3,-58,108,1233,1112,1421,864,64
-3,3,0.0,-3.0,3.0,0.3822140693664551,86.53269591129698,3,-55,105,1233,1112,1421,864,64
-3,3,0.0,-3.0,3.0,0.3911893367767334,82.49017425089369,3,-52,102,1233,1112,1421,864,64
-3,2,0.0,-3.0,2.0,0.40116333961486816,79.35977729862789,3,-49,100,1233,1112,1421,864,64
-3,2,0.0,-3.0,2.0,0.4111359119415283,76.25894882179486,3,-46,98,1233,1112,1421,864,64
-3,2,0.0,-3.0,2.0,0.4181182384490967,73.19030373565806,3,-43,96,1233,1112,1421,864,64
-4,2,0.0,-4.0,2.0,0.42809104919433594,69.76934705499491,3,-39,94,1233,1112,1421,864,64
-4,1,0.0,-4.0,1.0,0.43607115745544434,67.36800289831733,3,-35,93,1233,1112,1421,864,64
-5,1,0.0,-5.0,1.0,0.4440484046936035,64.76776322722355,3,-30,92,1233,1112,1421,864,64
-5,1,0.0,-5.0,1.0,0.4520268440246582,62.37160589923221,3,-25,91,1233,1112,1421,864,64
-6,1,0.0,-6.0,1.0,0.4610137939453125,59.98369420718001,3,-19,90,1233,1112,1421,864,64
-6,0,0.0,-6.0,-0.0,0.47197413444519043,58.93404203047393,3,-13,90,1233,1112,1421,864,64
-6,0,0.0,-6.0,-0.0,0.4799525737762451,58.27181176868004,3,-7,90,1233,1112,1421,864,64
-6,0,0.0,-6.0,-0.0,0.48892927169799805,58.00555538409837,3,-1,90,1233,1112,1421,864,64
-5,-1,0.0,-5.0,-1.0,0.49690771102905273,59.08786966440702,3,4,91,1233,1112,1421,864,64
-4,-1,0.01,-4.0,-1.0,0.5068812370300293,60.347171044921566,3,8,92,1233,1112,1421,864,64
-3,-1,0.03,-3.0,-1.0,0.5138623714447021,61.64827814754524,3,11,93,1233,1112,1421,864,64
-3,-1,0.05,-3.0,-1.0,0.5228378772735596,63.036834964133774,3,14,94,1233,1112,1421,864,64
-2,-1,0.06,-2.0,-1.0,0.5318145751953125,64.33794683301072,3,16,95,1233,1112,1421,864,64
-2,-1,0.07,-2.0,-1.0,0.5407898426055908,65.67292357659824,3,18,96,1233,1112,1421,864,64
-1,0,0.13,-1.0,-0.0,0.5507638454437256,65.86214794290998,3,19,96,1233,1112,1421,864,64
-1,0,0.17,-1.0,-0.0,0.5587430000305176,66.0612053770501,3,20,96,1233,1112,1421,864,64
-1,0,0.3,-1.0,-0.0,0.567718505859375,66.2700361249552,3,21,96,1233,1112,1421,864,64
0,1,0.52,-0.0,1.0,0.5756974220275879,65.29337079164233,3,21,95,1233,1112,1421,864,64
0,1,0.76,-0.0,1.0,0.5846738815307617,64.317184344228,3,21,94,1233,1112,1421,864,64
1,1,0.83,1.0,1.0,0.5926525592803955,63.12623192369179,3,20,93,1233,1112,1421,864,64
1,1,0.86,1.0,1.0,0.6006312370300293,61.941471140279674,3,19,92,1233,1112,1421,864,64
2,1,0.85,2.0,1.0,0.6096069812774658,60.57429448826494,3,17,91,1233,1112,1421,864,64
2,1,0.71,2.0,1.0,0.619581937789917,59.2414379544733,3,15,90,1233,1112,1421,864,64
2,1,0.56,2.0,1.0,0.6275591850280762,57.94442728707543,3,13,89,1233,1112,1421,864,64
2,2,0.39,2.0,2.0,0.6355385780334473,55.69264507357501,3,11,87,1233,1112,1421,864,64
2,2,0.42,2.0,2.0,0.6435160636901855,53.47514258543241,3,9,85,1233,1112,1421,864,64
2,2,0.63,2.0,2.0,0.6524937152862549,51.2946576918352,3,7,83,1233,1112,1421,864,64
2,2,0.56,2.0,2.0,0.661468505859375,49.15417426109393,3,5,81,1233,1112,1421,864,64
2,2,0.64,2.0,2.0,0.6714417934417725,47.05694150420949,3,3,79,1233,1112,1421,864,64
1,2,0.52,1.0,2.0,0.6794219017028809,45.02596964660685,3,2,77,1233,1112,1421,864,64
1,2,0.4,1.0,2.0,0.6883974075317383,43.0066663703967,3,1,75,1233,1112,1421,864,64
1,2,0.39,1.0,2.0,0.6973729133605957,41.0,3,0,73,1233,1112,1421,864,64
1,2,0.26,1.0,2.0,0.7073462009429932,39.00704190430693,3,-1,71,1233,1112,1421,864,64
1,2,0.32,1.0,2.0,0.715325117111206,37.02897942168927,3,-2,69,1233,1112,1421,864,64
1,2,0.48,1.0,2.0,0.7243008613586426,35.067130548428864,3,-3,67,1233,1112,1421,864,64
1,2,0.56,1.0,2.0,0.7342743873596191,33.12296062065974,3,-4,65,1233,1112,1421,864,64
1,2,0.56,1.0,2.0,0.7422530651092529,31.198101237299845,3,-5,63,1233,1112,1421,864,64
1,2,0.51,1.0,2.0,0.008976459503173828,397.01972112653965,4,393,-177,1632,874,1238,1049,69
1,2,0.43,1.0,2.0,0.017952442169189453,396.9350299059012,4,392,-179,1632,874,1238,1049,69
1,2,0.15,1.0,2.0,0.027925968170166016,396.86192683967795,4,391,-181,1632,874,1238,1049,69
0,0,0.05,-0.0,-0.0,0.035904645919799805,396.86192683967795,4,391,-181,1632,874,1238,1049,69
2,-1,0.04,2.0,-1.0,0.046875,394.6268773653841,4,389,-180,1632,874,1238,1049,69
3,-2,0.32,3.0,-2.0,0.054854393005371094,391.0647009573954,4,386,-178,1632,874,1238,1049,69
5,-1,0.0,5.0,-1.0,0.06482744216918945,386.1071291944473,4,381,-177,1632,874,1238,1049,69
5,1,0.0,5.0,1.0,0.07280683517456055,382.0048076645269,4,376,-178,1632,874,1238,1049,69
7,-1,0.0,7.0,-1.0,0.0827798843383789,375.255421466839,4,369,-177,1632,874,1238,1049,69
9,-2,0.0,9.0,-2.0,0.09175562858581543,366.2811511925087,4,360,-175,1632,874,1238,1049,69
11,-1,0.0,11.0,-1.0,0.10073184967041016,355.97051170569296,4,349,-174,1632,874,1238,1049,69
7,0,0.0,7.0,-0.0,0.10871076583862305,349.7186469276676,4,342,-174,1632,874,1238,1049,69
6,-2,0.0,6.0,-2.0,0.11768651008605957,343.46523018683456,4,336,-172,1632,874,1238,1049,69
6,-2,0.0,6.0,-2.0,0.12566637992858887,337.2142238654117,4,330,-170,1632,874,1238,1049,69
7,0,0.0,7.0,-0.0,0.13364386558532715,331.0054794109261,4,323,-170,1632,874,1238,1049,69
8,-3,0.0,8.0,-3.0,0.14262080192565918,322.5305036038291,4,315,-167,1632,874,1238,1049,69
8,-4,0.0,8.0,-4.0,0.1515958309173584,313.588837565305,4,307,-163,1632,874,1238,1049,69
6,-5,0.0,6.0,-5.0,0.1595749855041504,305.94852551526094,4,301,-158,1632,874,1238,1049,69
8,-2,0.0,8.0,-2.0,0.16755390167236328,297.94125986385,4,293,-156,1632,874,1238,1049,69
8,-4,0.0,8.0,-4.0,0.17752718925476074,289.0,4,285,-152,1632,874,1238,1049,69
9,-4,0.0,9.0,-4.0,0.18650245666503906,279.1772660970141,4,276,-148,1632,874,1238,1049,69
10,-5,0.0,10.0,-5.0,0.19647693634033203,268.00165562460086,4,266,-143,1632,874,1238,1049,69
10,-4,0.0,10.0,-4.0,0.20345759391784668,257.30224853234483,4,256,-139,1632,874,1238,1049,69
9,-4,0.0,9.0,-4.0,0.21343088150024414,247.48534597737057,4,247,-135,1632,874,1238,1049,69
9,-5,0.0,9.0,-5.0,0.22141003608703613,237.189970316013,4,238,-130,1632,874,1238,1049,69
9,-5,0.0,9.0,-5.0,0.2313859462738037,226.89461473936177,4,229,-125,1632,874,1238,1049,69
9,-4,0.0,9.0,-4.0,0.24035954475402832,217.0796686312932,4,220,-121,1632,874,1238,1049,69
9,-4,0.0,9.0,-4.0,0.24933552742004395,207.26748641290231,4,211,-117,1632,874,1238,1049,69
8,-4,0.0,8.0,-4.0,0.25731420516967773,198.3316594870359,4,203,-113,1632,874,1238,1049,69
7,-4,0.0,7.0,-4.0,0.26629018783569336,190.26992665089986,4,196,-109,1632,874,1238,1049,69
7,-4,0.0,7.0,-4.0,0.276263952255249,182.208232960727,4,189,-105,1632,874,1238,1049,69
7,-4,0.0,7.0,-4.0,0.2842428684234619,174.1465829649865,4,182,-101,1632,874,1238,1049,69
7,-3,0.0,7.0,-3.0,0.2922229766845703,166.57168294652163,4,175,-98,1632,874,1238,1049,69
7,-3,0.0,7.0,-3.0,0.3011970520019531,159.0,4,168,-95,1632,874,1238,1049,69
7,-3,0.0,7.0,-3.0,0.31017470359802246,151.43192821086663,4,161,-92,1632,874,1238,1049,69
7,-3,0.0,7.0,-3.0,0.31815242767333984,143.867928531256,4,154,-89,1632,874,1238,1049,69
7,-2,0.0,7.0,-2.0,0.32613110542297363,136.8156901458411,4,147,-87,1632,874,1238,1049,69
7,-2,0.0,7.0,-2.0,0.3361043930053711,129.783393541592,4,140,-85,1632,874,1238,1049,69
7,-2,0.0,7.0,-2.0,0.3450808525085449,122.77372228788855,4,133,-83,1632,874,1238,1049,69
7,-2,0.0,7.0,-2.0,0.3530588150024414,115.78985279383915,4,126,-81,1632,874,1238,1049,69
7,-2,0.0,7.0,-2.0,0.36004114151000977,108.83556979968259,4,119,-79,1632,874,1238,1049,69
7,-1,0.0,7.0,-1.0,0.369016170501709,102.48443134658254,4,112,-78,1632,874,1238,1049,69
7,-1,0.0,7.0,-1.0,0.37898969650268555,96.20752666416791,4,105,-77,1632,874,1238,1049,69
7,-2,0.0,7.0,-2.0,0.3859710693359375,89.40583454602137,4,98,-75,1632,874,1238,1049,69
6,-1,0.0,6.0,-1.0,0.3969440460205078,84.06777714516353,4,92,-74,1632,874,1238,1049,69
6,-1,0.0,6.0,-1.0,0.4029262065887451,78.80514172678478,4,86,-73,1632,874,1238,1049,69
6,-1,0.0,6.0,-1.0,0.4129002094268799,73.62899237658968,4,80,-72,1632,874,1238,1049,69
5,-1,0.0,5.0,-1.0,0.41988134384155273,69.27632836231156,4,75,-71,1632,874,1238,1049,69
5,-1,0.0,5.0,-1.0,0.4298546314239502,64.99494936611666,4,70,-70,1632,874,1238,1049,69
5,-1,0.0,5.0,-1.0,0.4378349781036377,60.794514609232536,4,65,-69,1632,874,1238,1049,69
5,-1,0.0,5.0,-1.0,0.44780755043029785,56.686272390037075,4,60,-68,1632,874,1238,1049,69
5,-1,0.0,5.0,-1.0,0.45578527450561523,52.683331731077345,4,55,-67,1632,874,1238,1049,69
5,-1,0.0,5.0,-1.0,0.4657585620880127,48.80096617793781,4,50,-66,1632,874,1238,1049,69
4,-1,0.0,4.0,-1.0,0.4737379550933838,45.63039620647382,4,46,-65,1632,874,1238,1049,69
4,-1,0.01,4.0,-1.0,0.4827139377593994,42.550636836018555,4,42,-64,1632,874,1238,1049,69
4,-1,0.02,4.0,-1.0,0.4936857223510742,39.57309290766564,4,38,-63,1632,874,1238,1049,69
3,-1,0.02,3.0,-1.0,0.5006661415100098,37.19691004531025,4,35,-62,1632,874,1238,1049,69
3,-2,0.04,3.0,-2.0,0.510638952255249,34.0,4,32,-60,1632,874,1238,1049,69
3,-2,0.08,3.0,-2.0,0.518618106842041,30.8459713474939,4,29,-58,1632,874,1238,1049,69
2,-2,0.16,2.0,-2.0,0.5285909175872803,28.16912416947821,4,27,-56,1632,874,1238,1049,69
2,-2,0.21,2.0,-2.0,0.5355722904205322,25.506302187247357,4,25,-54,1632,874,1238,1049,69
2,-2,0.33,2.0,-2.0,0.5455467700958252,22.859475903318,4,23,-52,1632,874,1238,1049,69
2,-2,0.49,2.0,-2.0,0.5535247325897217,20.230987451824994,4,21,-50,1632,874,1238,1049,69
2,-1,0.6,2.0,-1.0,0.5644950866699219,18.55473337388365,4,19,-49,1632,874,1238,1049,69
1,-1,0.67,1.0,-1.0,0.006982326507568359,530.9093283470838,5,-542,-128,1072,794,1613,923,52
-1,-1,0.69,-1.0,-1.0,0.014960765838623047,529.7067572020337,5,-541,-127,1072,794,1613,923,52
1,0,0.89,1.0,-0.0,0.021941661834716797,530.68033915345,5,-542,-127,1072,794,1613,923,52
-2,-1,0.84,-2.0,-1.0,0.03191542625427246,528.505184826977,5,-540,-126,1072,794,1613,923,52
-1,0,0.04,-1.0,-0.0,0.03936171531677246,527.531390257138,5,-539,-126,1072,794,1613,923,52
-4,-1,0.11,-4.0,-1.0,0.04933524131774902,523.4087731370878,5,-535,-125,1072,794,1613,923,52
0,-2,0.18,-0.0,-2.0,0.057314157485961914,522.9571932309476,5,-535,-123,1072,794,1613,923,52
-1,-1,0.1,-1.0,-1.0,0.06728768348693848,521.7590711252531,5,-534,-122,1072,794,1613,923,52
-4,-3,0.18,-4.0,-3.0,0.07526731491088867,517.195176709072,5,-530,-119,1072,794,1613,923,52
-3,0,0.0,-3.0,-0.0,0.08424186706542969,514.2684517904039,5,-527,-119,1072,794,1613,923,52
-4,-2,0.01,-4.0,-2.0,0.09321880340576172,509.9272338666883,5,-523,-117,1072,794,1613,923,52
-6,0,0.01,-6.0,-0.0,0.10219407081604004,504.0735797981257,5,-517,-117,1072,794,1613,923,52
-11,0,0.0,-11.0,-0.0,0.1121680736541748,493.3505559831433,5,-506,-117,1072,794,1613,923,52
-9,-2,0.0,-9.0,-2.0,0.11914920806884766,484.13135563303695,5,-497,-115,1072,794,1613,923,52
-12,-1,0.0,-12.0,-1.0,0.12812590599060059,472.21782384816385,5,-485,-114,1072,794,1613,923,52
-10,-2,0.0,-10.0,-2.0,0.1376180648803711,462.02561408188404,5,-475,-112,1072,794,1613,923,52
-13,-3,0.0,-13.0,-3.0,0.14558744430541992,448.68410548490033,5,-462,-109,1072,794,1613,923,52
-11,-3,0.0,-11.0,-3.0,0.15456271171569824,437.28932644730764,5,-451,-106,1072,794,1613,923,52
-11,-2,0.0,-11.0,-2.0,0.16553378105163574,426.1238768302333,5,-440,-104,1072,794,1613,923,52
-11,-3,0.0,-11.0,-3.0,0.1725163459777832,414.72894164100455,5,-429,-101,1072,794,1613,923,52
-10,-3,0.0,-10.0,-3.0,0.1804943084716797,404.3080292069856,5,-419,-98,1072,794,1613,923,52
-9,-4,0.0,-9.0,-4.0,0.18847274780273438,394.6376112522512,5,-410,-94,1072,794,1613,923,52
-9,-3,0.0,-9.0,-3.0,0.19844627380371094,385.19581709934744,5,-401,-91,1072,794,1613,923,52
-9,-3,0.0,-9.0,-3.0,0.2054276466369629,375.756144943671,5,-392,-88,1072,794,1613,923,52
-9,-5,0.0,-9.0,-5.0,0.21540093421936035,365.89029077026134,5,-383,-83,1072,794,1613,923,52
-9,-3,0.0,-9.0,-3.0,0.2223823070526123,356.4604554721965,5,-374,-80,1072,794,1613,923,52
-9,-4,0.0,-9.0,-4.0,0.23235702514648438,346.8283787481849,5,-365,-76,1072,794,1613,923,52
-9,-3,0.0,-9.0,-3.0,0.23933672904968262,337.40748478808194,5,-356,-73,1072,794,1613,923,52
-9,-4,0.0,-9.0,-4.0,0.24931049346923828,327.79372521287036,5,-347,-69,1072,794,1613,923,52
-9,-3,0.0,-9.0,-3.0,0.25728940963745117,318.3835071544513,5,-338,-66,1072,794,1613,923,52
-9,-3,0.0,-9.0,-3.0,0.26726269721984863,308.9776111921512,5,-329,-63,1072,794,1613,923,52
-9,-3,0.0,-9.0,-3.0,0.2742455005645752,299.5764119219941,5,-320,-60,1072,794,1613,923,52
-8,-4,0.0,-8.0,-4.0,0.28421711921691895,290.9858040985432,5,-312,-56,1072,794,1613,923,52
-8,-3,0.0,-8.0,-3.0,0.29219627380371094,282.58548248418947,5,-304,-53,1072,794,1613,923,52
-8,-3,0.0,-8.0,-3.0,0.3021700382232666,274.1932710771512,5,-296,-50,1072,794,1613,923,52
-8,-3,0.0,-8.0,-3.0,0.3101484775543213,265.8098696069069,5,-288,-47,1072,794,1613,923,52
-7,-3,0.0,-7.0,-3.0,0.32012128829956055,258.4239792985113,5,-281,-44,1072,794,1613,923,52
-7,-3,0.0,-7.0,-3.0,0.32810139656066895,251.0505369061753,5,-274,-41,1072,794,1613,923,52
-7,-3,0.0,-7.0,-3.0,0.33707666397094727,243.69056342408425,5,-267,-38,1072,794,1613,923,52
-7,-3,0.0,-7.0,-3.0,0.34705018997192383,236.34519244689812,5,-260,-35,1072,794,1613,923,52
-6,-2,0.0,-6.0,-2.0,0.3550286293029785,230.13473017144707,5,-254,-33,1072,794,1613,923,52
-6,-2,0.0,-6.0,-2.0,0.3659994602203369,223.92999019725505,5,-248,-31,1072,794,1613,923,52
-6,-2,0.0,-6.0,-2.0,0.373978853225708,217.73140954747709,5,-242,-29,1072,794,1613,923,52
-6,-2,0.0,-6.0,-2.0,0.38295555114746094,211.53947040439405,5,-236,-27,1072,794,1613,923,52
-6,-1,0.0,-6.0,-1.0,0.3909339904785156,205.46490014686893,5,-230,-26,1072,794,1613,923,52
-6,-2,0.0,-6.0,-2.0,0.4009060859680176,199.28204544525957,5,-224,-24,1072,794,1613,923,52
-6,-1,0.0,-6.0,-1.0,0.40888524055480957,193.20994502987313,5,-218,-23,1072,794,1613,923,52
-6,-1,0.0,-6.0,-1.0,0.41885900497436523,187.13845265460665,5,-212,-22,1072,794,1613,923,52
-6,-1,0.0,-6.0,-1.0,0.4268369674682617,181.06762180505189,5,-206,-21,1072,794,1613,923,52
-6,-1,0.0,-6.0,-1.0,0.4368155002593994,174.9975124224178,5,-200,-20,1072,794,1613,923,52
-6,-1,0.0,-6.0,-1.0,0.4457874298095703,168.92819190666086,5,-194,-19,1072,794,1613,923,52
-6,-1,0.0,-6.0,-1.0,0.45476293563842773,162.85973631242842,5,-188,-18,1072,794,1613,923,52
-6,-1,0.0,-6.0,-1.0,0.46373915672302246,156.7922317824256,5,-182,-17,1072,794,1613,923,52
-6,-1,0.0,-6.0,-1.0,0.4727158546447754,150.72577627499618,5,-176,-16,1072,794,1613,923,52
-6,-1,0.0,-6.0,-1.0,0.4816913604736328,144.66048165876012,5,-170,-15,1072,794,1613,923,52
-6,-1,0.0,-6.0,-1.0,0.49066710472106934,138.59647626847908,5,-164,-14,1072,794,1613,923,52
-6,-1,0.0,-6.0,-1.0,0.4976484775543213,132.5339080449353,5,-158,-13,1072,794,1613,923,52
-6,-1,0.0,-6.0,-1.0,0.5056271553039551,126.47294842036735,5,-152,-12,1072,794,1613,923,52
-6,-1,0.0,-6.0,-1.0,0.5136058330535889,120.4137971640651,5,-146,-11,1072,794,1613,923,52
-6,-1,0.0,-6.0,-1.0,0.5215845108032227,114.356688476182,5,-140,-10,1072,794,1613,923,52
-6,-1,0.0,-6.0,-1.0,0.5315580368041992,108.30189872075525,5,-134,-9,1072,794,1613,923,52
-6,-1,0.0,-6.0,-1.0,0.5385396480560303,102.24975633505119,5,-128,-8,1072,794,1613,923,52
-6,-1,0.0,-6.0,-1.0,0.5485134124755859,96.20065466273084,5,-122,-7,1072,794,1613,923,52
-6,-1,0.0,-6.0,-1.0,0.5554945468902588,90.15506876585283,5,-116,-6,1072,794,1613,923,52
-6,-1,0.0,-6.0,-1.0,0.5654683113098145,84.11357772772621,5,-110,-5,1072,794,1613,923,52
-6,-1,0.0,-6.0,-1.0,0.5724494457244873,78.0768946500615,5,-104,-4,1072,794,1613,923,52
-6,-1,0.0,-6.0,-1.0,0.5824224948883057,72.04590761474952,5,-98,-3,1072,794,1613,923,52
-6,0,0.0,-6.0,-0.0,0.5913991928100586,66.04890004774636,5,-92,-3,1072,794,1613,923,52
-6,0,0.0,-6.0,-0.0,0.6013717651367188,60.05230967266364,5,-86,-3,1072,794,1613,923,52
-5,0,0.0,-5.0,-0.0,0.6093521118164062,55.05553651663777,5,-81,-3,1072,794,1613,923,52
-5,0,0.0,-5.0,-0.0,0.6173295974731445,50.05918747922567,5,-76,-3,1072,794,1613,923,52
-5,0,0.0,-5.0,-0.0,0.6263065338134766,45.06335201775947,5,-71,-3,1072,794,1613,923,52
-5,0,0.0,-5.0,-0.0,0.6362788677215576,40.06814663663572,5,-66,-3,1072,794,1613,923,52
-4,0,0.0,-4.0,-0.0,0.6432614326477051,36.07253821135398,5,-62,-3,1072,794,1613,923,52
-4,0,0.0,-4.0,-0.0,0.6522367000579834,32.077534382926416,5,-58,-3,1072,794,1613,923,52
-3,0,0.0,-3.0,-0.0,0.660214900970459,29.081757415681643,5,-55,-3,1072,794,1613,923,52
-3,0,0.0,-3.0,-0.0,0.6701953411102295,26.08646657242167,5,-52,-3,1072,794,1613,923,52
-3,0,0.01,-3.0,-0.0,0.6791648864746094,23.09175083453431,5,-49,-3,1072,794,1613,923,52
-3,0,0.01,-3.0,-0.0,0.6881403923034668,20.09772228646444,5,-46,-3,1072,794,1613,923,52
-3,0,0.01,-3.0,-0.0,0.695122480392456,17.104524124504614,5,-43,-3,1072,794,1613,923,52
-3,-1,0.02,-3.0,-1.0,0.7031011581420898,14.049968789001575,5,-40,-2,1072,794,1613,923,52
-3,-1,0.02,-3.0,-1.0,0.7120780944824219,11.013511046643494,5,-37,-1,1072,794,1613,923,52
-3,-1,0.02,-3.0,-1.0,0.7200589179992676,8.0,5,-34,0,1072,794,1613,923,52
-3,-1,0.03,-3.0,-1.0,0.729032039642334,5.016124838541646,5,-31,1,1072,794,1613,923,52
-3,-1,0.05,-3.0,-1.0,0.7370107173919678,2.071337695236398,5,-28,2,1072,794,1613,923,52
-3,-1,0.06,-3.0,-1.0,0.7459871768951416,-0.820643375971656,5,-25,3,1072,794,1613,923,52
-3,-1,0.09,-3.0,-1.0,0.754962682723999,-3.639320225002102,5,-22,4,1072,794,1613,923,52
-3,-1,0.08,-3.0,-1.0,0.7659332752227783,-6.353117295611501,5,-19,5,1072,794,1613,923,52
-3,-1,0.06,-3.0,-1.0,0.7729146480560303,-8.91199250936494,5,-16,6,1072,794,1613,923,52
-3,-1,0.08,-3.0,-1.0,0.7818918228149414,-11.2351769397666,5,-13,7,1072,794,1613,923,52
-3,-1,0.12,-3.0,-1.0,0.7918639183044434,-13.193751525134303,5,-10,8,1072,794,1613,923,52
-3,-1,0.12,-3.0,-1.0,0.8008410930633545,-14.59824574900862,5,-7,9,1072,794,1613,923,52
-3,-1,0.17,-3.0,-1.0,0.8088192939758301,-15.229670385730993,5,-4,10,1072,794,1613,923,52
-2,0,0.2,-2.0,-0.0,0.817795991897583,-15.801960972814431,5,-2,10,1072,794,1613,923,52
-2,0,0.24,-2.0,-0.0,0.825775146484375,-16.0,5,0,10,1072,794,1613,923,52
-1,0,0.33,-1.0,-0.0,0.8337523937225342,-15.95012437887911,5,1,10,1072,794,1613,923,52
-1,0,0.44,-1.0,-0.0,0.8417320251464844,-15.801960972814431,5,2,10,1072,794,1613,923,52
0,0,0.58,-0.0,-0.0,0.8517045974731445,-15.801960972814431,5,2,10,1072,794,1613,923,52
0,0,0.7,-0.0,-0.0,0.00797891616821289,704.3906698623193,6,-423,-604,647,180,1070,784,66
0,1,0.62,-0.0,1.0,0.017952680587768555,705.2099972230125,6,-423,-605,647,180,1070,784,66
-1,-1,0.55,-1.0,-1.0,0.026929855346679688,703.8174807915458,6,-422,-604,647,180,1070,784,66
2,-2,0.11,2.0,-2.0,0.03490757942199707,703.3287309347639,6,-424,-602,647,180,1070,784,66
-3,0,0.0,-3.0,-0.0,0.043883323669433594,701.6053362180267,6,-421,-602,647,180,1070,784,66
4,-2,0.0,4.0,-2.0,0.05086469650268555,702.2720584926371,6,-425,-600,647,180,1070,784,66
1,-2,0.0,1.0,-2.0,0.06083822250366211,701.2206752741304,6,-426,-598,647,180,1070,784,66
1,-5,0.05,1.0,-5.0,0.0688169002532959,697.7379831375949,6,-427,-593,647,180,1070,784,66
3,-3,0.04,3.0,-3.0,0.07779288291931152,697.0684899377592,6,-430,-590,647,180,1070,784,66
7,-5,0.0,7.0,-5.0,0.08676886558532715,697.2013420968219,6,-437,-585,647,180,1070,784,66
4,-8,0.0,4.0,-8.0,0.09674286842346191,693.2299911185161,6,-441,-577,647,180,1070,784,66
2,-6,0.0,2.0,-6.0,0.1047213077545166,689.6963401041962,6,-443,-571,647,180,1070,784,66
3,-8,0.0,3.0,-8.0,0.1156919002532959,685.2513487630914,6,-446,-563,647,180,1070,784,66
2,-5,0.0,2.0,-5.0,0.12267374992370605,682.5892676668649,6,-448,-558,647,180,1070,784,66
1,-8,0.0,1.0,-8.0,0.13264727592468262,677.0007042250029,6,-449,-550,647,180,1070,784,66
-1,-7,0.0,-1.0,-7.0,0.1406254768371582,670.9552542598144,6,-448,-543,647,180,1070,784,66
-3,-8,0.0,-3.0,-8.0,0.148604154586792,662.8807369082722,6,-445,-535,647,180,1070,784,66
-6,-9,0.0,-6.0,-9.0,0.15658307075500488,652.1255359421367,6,-439,-526,647,180,1070,784,66
-5,-11,0.0,-5.0,-11.0,0.16655635833740234,640.4842240171629,6,-434,-515,647,180,1070,784,66
-10,-12,0.0,-10.0,-12.0,0.17453551292419434,624.8639677015302,6,-424,-503,647,180,1070,784,66
-11,-14,0.0,-11.0,-14.0,0.18351197242736816,607.0703086380433,6,-413,-489,647,180,1070,784,66
-14,-13,0.0,-14.0,-13.0,0.19148993492126465,588.1094911527274,6,-399,-476,647,180,1070,784,66
-14,-14,0.0,-14.0,-14.0,0.20247364044189453,568.3892250448124,6,-385,-462,647,180,1070,784,66
-15,-14,0.0,-15.0,-14.0,0.2094426155090332,548.0370039851163,6,-370,-448,647,180,1070,784,66
-14,-14,0.0,-14.0,-14.0,0.21841812133789062,528.3305621467622,6,-356,-434,647,180,1070,784,66
-13,-12,0.0,-13.0,-12.0,0.22539949417114258,510.8133871099534,6,-343,-422,647,180,1070,784,66
-12,-12,0.0,-12.0,-12.0,0.2343754768371582,493.9354799214036,6,-331,-410,647,180,1070,784,66
-10,-11,0.0,-10.0,-11.0,0.2423543930053711,479.09569418224953,6,-321,-399,647,180,1070,784,66
-9,-10,0.0,-9.0,-10.0,0.24933576583862305,465.663213000518,6,-312,-389,647,180,1070,784,66
-7,-9,0.0,-7.0,-9.0,0.25731468200683594,454.2627627882106,6,-305,-380,647,180,1070,784,66
-6,-9,0.0,-6.0,-9.0,0.2652933597564697,443.48924436969196,6,-299,-371,647,180,1070,784,66
-6,-8,0.0,-6.0,-8.0,0.2732722759246826,433.4954447794748,6,-293,-363,647,180,1070,784,66
-6,-7,0.0,-6.0,-7.0,0.2812511920928955,424.28000174947516,6,-287,-356,647,180,1070,784,66
-6,-6,0.0,-6.0,-6.0,0.28823184967041016,415.8440709199577,6,-281,-350,647,180,1070,784,66
-6,-6,0.0,-6.0,-6.0,0.29920291900634766,407.41003621625157,6,-275,-344,647,180,1070,784,66
-6,-6,0.0,-6.0,-6.0,0.3061840534210205,398.97800869951703,6,-269,-338,647,180,1070,784,66
-6,-6,0.0,-6.0,-6.0,0.3161580562591553,390.54810824745755,6,-263,-332,647,180,1070,784,66
-6,-6,0.0,-6.0,-6.0,0.3221414089202881,382.12046444375636,6,-257,-326,647,180,1070,784,66
-6,-6,0.0,-6.0,-6.0,0.3331122398376465,373.69521757699584,6,-251,-320,647,180,1070,784,66
-6,-6,0.0,-6.0,-6.0,0.34009456634521484,365.2725197650473,6,-245,-314,647,180,1070,784,66
-6,-6,0.0,-6.0,-6.0,0.3500678539276123,356.85253622363416,6,-239,-308,647,180,1070,784,66
-6,-5,0.0,-6.0,-5.0,0.3580465316772461,349.227680839575,6,-233,-303,647,180,1070,784,66
-5,-5,0.0,-5.0,-5.0,0.36801934242248535,342.217270391436,6,-228,-298,647,180,1070,784,66
-5,-5,0.0,-5.0,-5.0,0.376995325088501,335.2091796791601,6,-223,-293,647,180,1070,784,66
-5,-5,0.0,-5.0,-5.0,0.3859736919403076,328.20354372569494,6,-218,-288,647,180,1070,784,66
-5,-5,0.0,-5.0,-5.0,0.39295434951782227,321.2005081871001,6,-213,-283,647,180,1070,784,66
-5,-4,0.0,-5.0,-4.0,0.4029266834259033,315.0014367786432,6,-208,-279,647,180,1070,784,66
-5,-4,0.0,-5.0,-4.0,0.41190409660339355,308.80988868082795,6,-203,-275,647,180,1070,784,66
-5,-4,0.0,-5.0,-4.0,0.4208807945251465,302.6262802582658,6,-198,-271,647,180,1070,784,66
-5,-4,0.0,-5.0,-4.0,0.43085217475891113,296.4510585807853,6,-193,-267,647,180,1070,784,66
-5,-4,0.0,-5.0,-4.0,0.4388306140899658,290.28470424689135,6,-188,-263,647,180,1070,784,66
-5,-4,0.0,-5.0,-4.0,0.44780707359313965,284.1277345171816,6,-183,-259,647,180,1070,784,66
-5,-4,0.0,-5.0,-4.0,0.45578670501708984,277.9807067970616,6,-178,-255,647,180,1070,784,66
-5,-4,0.0,-5.0,-4.0,0.46476173400878906,271.8442225137291,6,-173,-251,647,180,1070,784,66
-4,-4,0.0,-4.0,-4.0,0.47274041175842285,266.2824752637548,6,-169,-247,647,180,1070,784,66
-4,-4,0.0,-4.0,-4.0,0.4827132225036621,260.7243605831835,6,-165,-243,647,180,1070,784,66
-4,-3,0.0,-4.0,-3.0,0.4906935691833496,256.0,6,-161,-240,647,180,1070,784,66
-4,-3,0.01,-4.0,-3.0,0.5006663799285889,251.28506819739937,6,-157,-237,647,180,1070,784,66
-3,-3,0.01,-3.0,-3.0,0.5086455345153809,247.12854192316786,6,-154,-234,647,180,1070,784,66
-3,-3,0.01,-3.0,-3.0,0.5176217555999756,242.9746365157494,6,-151,-231,647,180,1070,784,66
-3,-3,0.01,-3.0,-3.0,0.527594804763794,238.8234721285121,6,-148,-228,647,180,1070,784,66
-3,-3,0.01,-3.0,-3.0,0.5355720520019531,234.67517628648346,6,-145,-225,647,180,1070,784,66
-3,-3,0.02,-3.0,-3.0,0.5435521602630615,230.52988445335757,6,-142,-222,647,180,1070,784,66
-3,-3,0.03,-3.0,-3.0,0.5525269508361816,226.38774065094134,6,-139,-219,647,180,1070,784,66
-3,-3,0.03,-3.0,-3.0,0.5634975433349609,222.24889813670106,6,-136,-216,647,180,1070,784,66
-3,-3,0.03,-3.0,-3.0,0.571476936340332,218.11352014576994,6,-133,-213,647,180,1070,784,66
-3,-3,0.03,-3.0,-3.0,0.5814497470855713,213.9817807045694,6,-130,-210,647,180,1070,784,66
-3,-3,0.02,-3.0,-3.0,0.5894303321838379,209.85386552410483,6,-127,-207,647,180,1070,784,66
-3,-3,0.02,-3.0,-3.0,0.5991165637969971,205.72997298202839,6,-124,-204,647,180,1070,784,66
-3,-3,0.02,-3.0,-3.0,0.6070964336395264,201.61031520374377,6,-121,-201,647,180,1070,784,66
-3,-3,0.02,-3.0,-3.0,0.6170687675476074,197.4951192541829,6,-118,-198,647,180,1070,784,66
-3,-3,0.03,-3.0,-3.0,0.6250474452972412,193.38462845343543,6,-115,-195,647,180,1070,784,66
-3,-3,0.03,-3.0,-3.0,0.634023904800415,189.27910383119686,6,-112,-192,647,180,1070,784,66
-3,-3,0.03,-3.0,-3.0,0.6420023441314697,185.17882573705452,6,-109,-189,647,180,1070,784,66
-3,-3,0.03,-3.0,-3.0,0.6509785652160645,181.0840956259946,6,-106,-186,647,180,1070,784,66
-3,-3,0.03,-3.0,-3.0,0.6609513759613037,176.99523804124703,6,-103,-183,647,180,1070,784,66
-3,-3,0.03,-3.0,-3.0,0.6689307689666748,172.91260281974002,6,-100,-180,647,180,1070,784,66
-3,-3,0.03,-3.0,-3.0,0.6779074668884277,168.83656754909404,6,-97,-177,647,180,1070,784,66
-3,-3,0.03,-3.0,-3.0,0.686882495880127,164.76754030932378,6,-94,-174,647,180,1070,784,66
-3,-3,0.03,-3.0,-3.0,0.6958625316619873,160.70596273734063,6,-91,-171,647,180,1070,784,66
-3,-3,0.03,-3.0,-3.0,0.7048385143280029,156.65231345807516,6,-88,-168,647,180,1070,784,66
-3,-3,0.03,-3.0,-3.0,0.7138149738311768,152.60711193270586,6,-85,-165,647,180,1070,784,66
-3,-3,0.03,-3.0,-3.0,0.7227904796600342,148.57092278225608,6,-82,-162,647,180,1070,784,66
-3,-3,0.03,-3.0,-3.0,0.7327659130096436,144.54436065389405,6,-79,-159,647,180,1070,784,66
-3,-3,0.04,-3.0,-3.0,0.7417402267456055,140.5280957078709,6,-76,-156,647,180,1070,784,66
-3,-3,0.04,-3.0,-3.0,0.7517147064208984,136.5228598154243,6,-73,-153,647,180,1070,784,66
-3,-3,0.04,-3.0,-3.0,0.7596926689147949,132.5294535724685,6,-70,-150,647,180,1070,784,66
-3,-3,0.04,-3.0,-3.0,0.7686691284179688,128.54875425084526,6,-67,-147,647,180,1070,784,66
-3,-3,0.04,-3.0,-3.0,0.7776448726654053,124.58172482873766,6,-64,-144,647,180,1070,784,66
-3,-3,0.04,-3.0,-3.0,0.7866203784942627,120.62942426501507,6,-61,-141,647,180,1070,784,66
-3,-3,0.04,-3.0,-3.0,0.7955970764160156,116.69301920931383,6,-58,-138,647,180,1070,784,66
-3,-3,0.04,-3.0,-3.0,0.8045728206634521,112.7737973711325,6,-55,-135,647,180,1070,784,66
-3,-3,0.04,-3.0,-3.0,0.8145465850830078,108.8731828077456,6,-52,-132,647,180,1070,784,66
-3,-3,0.04,-3.0,-3.0,0.8225250244140625,104.99275343292487,6,-49,-129,647,180,1070,784,66
-3,-3,0.04,-3.0,-3.0,0.83249831199646,101.13426109685773,6,-46,-126,647,180,1070,784,66
-3,-3,0.04,-3.0,-3.0,0.8404779434204102,97.29965464267354,6,-43,-123,647,180,1070,784,66
-3,-3,0.04,-3.0,-3.0,0.8504505157470703,93.49110640673517,6,-40,-120,647,180,1070,784,66
-3,-3,0.04,-3.0,-3.0,0.8584299087524414,89.71104269787622,6,-37,-117,647,180,1070,784,66
-3,-3,0.04,-3.0,-3.0,0.8674056529998779,85.96217886370441,6,-34,-114,647,180,1070,784,66
-3,-3,0.04,-3.0,-3.0,0.8763816356658936,82.24755962709145,6,-31,-111,647,180,1070,784,66
-3,-3,0.04,-3.0,-3.0,0.8853573799133301,78.57060544785082,6,-28,-108,647,180,1070,784,66
-3,-3,0.04,-3.0,-3.0,0.8943336009979248,74.93516572461452,6,-25,-105,647,180,1070,784,66
-3,-3,0.04,-3.0,-3.0,0.9033091068267822,71.34557968596465,6,-22,-102,647,180,1070,784,66
-2,-3,0.04,-2.0,-3.0,0.912285566329956,68.0,6,-20,-99,647,180,1070,784,66
-2,-3,0.04,-2.0,-3.0,0.9212613105773926,64.67292357659824,6,-18,-96,647,180,1070,784,66
-2,-2,0.04,-2.0,-2.0,0.9312348365783691,62.351979528481735,6,-16,-94,647,180,1070,784,66
-1,-2,0.05,-1.0,-2.0,0.939213752746582,60.2148056909416,6,-15,-92,647,180,1070,784,66
-1,-2,0.06,-1.0,-2.0,0.9492006301879883,58.082380293885606,6,-14,-90,647,180,1070,784,66
0,-2,0.07,-0.0,-2.0,0.9571652412414551,56.10667763978185,6,-14,-88,647,180,1070,784,66
0,-2,0.06,-0.0,-2.0,0.967139720916748,54.13208364316786,6,-14,-86,647,180,1070,784,66
1,-2,0.06,1.0,-2.0,0.9761264324188232,52.328775919967356,6,-15,-84,647,180,1070,784,66
1,-1,0.07,1.0,-1.0,0.9850914478302002,51.528101836016646,6,-16,-83,647,180,1070,784,66
1,-1,0.08,1.0,-1.0,0.9920728206634521,50.74365647617735,6,-17,-82,647,180,1070,784,66
1,-1,0.1,1.0,-1.0,1.0020461082458496,49.97590011563598,6,-18,-81,647,180,1070,784,66
1,-1,0.11,1.0,-1.0,1.0120198726654053,49.225300242686856,6,-19,-80,647,180,1070,784,66
1,-1,0.11,1.0,-1.0,1.0200016498565674,48.492330927517344,6,-20,-79,647,180,1070,784,66
1,-1,0.09,1.0,-1.0,1.027977466583252,47.77747210701756,6,-21,-78,647,180,1070,784,66
1,-1,0.09,1.0,-1.0,1.0359561443328857,47.081208782085696,6,-22,-77,647,180,1070,784,66
1,-1,0.1,1.0,-1.0,1.0459294319152832,46.40403012442127,6,-23,-76,647,180,1070,784,66
1,-1,0.16,1.0,-1.0,1.0539076328277588,45.746428490440124,6,-24,-75,647,180,1070,784,66
1,-1,0.24,1.0,-1.0,1.0628838539123535,45.108898340714035,6,-25,-74,647,180,1070,784,66
1,-1,0.34,1.0,-1.0,1.07185959815979,44.491935064237495,6,-26,-73,647,180,1070,784,66
1,-1,0.42,1.0,-1.0,1.0818336009979248,43.89603370785778,6,-27,-72,647,180,1070,784,66
1,0,0.42,1.0,-0.0,1.0898127555847168,44.252831663311866,6,-28,-72,647,180,1070,784,66
1,0,0.42,1.0,-0.0,1.0997860431671143,44.62087348130012,6,-29,-72,647,180,1070,784,66
1,0,0.43,1.0,-0.0,1.106766939163208,45.0,6,-30,-72,647,180,1070,784,66
1,0,0.45,1.0,-0.0,1.1167404651641846,45.390050389064044,6,-31,-72,647,180,1070,784,66
1,0,0.52,1.0,-0.0,1.1257166862487793,45.79086241436883,6,-32,-72,647,180,1070,784,66
1,0,0.57,1.0,-0.0,1.1356897354125977,46.202272694664515,6,-33,-72,647,180,1070,784,66
1,0,0.62,1.0,-0.0,1.1446664333343506,46.62411694957753,6,-34,-72,647,180,1070,784,66
1,0,0.64,1.0,-0.0,1.1536426544189453,47.05623023850174,6,-35,-72,647,180,1070,784,66
1,0,0.66,1.0,-0.0,1.1606237888336182,47.49844718999243,6,-36,-72,647,180,1070,784,66
1,0,0.67,1.0,-0.0,1.1686019897460938,47.95060222135473,6,-37,-72,647,180,1070,784,66
1,0,0.69,1.0,-0.0,1.1765801906585693,48.41252974819048,6,-38,-72,647,180,1070,784,66
1,0,0.71,1.0,-0.0,1.1845600605010986,48.88406438373708,6,-39,-72,647,180,1070,784,66
1,0,0.73,1.0,-0.0,1.1925392150878906,49.365041127896006,6,-40,-72,647,180,1070,784,66
1,0,0.75,1.0,-0.0,1.2025120258331299,49.85529554590944,6,-41,-72,647,180,1070,784,66
0,0,0.75,-0.0,-0.0,1.2124857902526855,49.85529554590944,6,-41,-72,647,180,1070,784,66
0,0,0.69,-0.0,-0.0,1.2194666862487793,49.85529554590944,6,-41,-72,647,180,1070,784,66
0,0,0.61,-0.0,-0.0,1.227445125579834,49.85529554590944,6,-41,-72,647,180,1070,784,66
0,0,0.58,-0.0,-0.0,1.236421823501587,49.85529554590944,6,-41,-72,647,180,1070,784,66
0,0,0.6,-0.0,-0.0,1.2424066066741943,49.85529554590944,6,-41,-72,647,180,1070,784,66
0,0,0.68,-0.0,-0.0,1.2513818740844727,49.85529554590944,6,-41,-72,647,180,1070,784,66
0,0,0.72,-0.0,-0.0,1.2593603134155273,49.85529554590944,6,-41,-72,647,180,1070,784,66
0,0,0.69,-0.0,-0.0,1.2673392295837402,49.85529554590944,6,-41,-72,647,180,1070,784,66
0,0,0.62,-0.0,-0.0,1.2743206024169922,49.85529554590944,6,-41,-72,647,180,1070,784,66
0,0,0.63,-0.0,-0.0,1.2842938899993896,49.85529554590944,6,-41,-72,647,180,1070,784,66
0,0,0.65,-0.0,-0.0,1.2922735214233398,49.85529554590944,6,-41,-72,647,180,1070,784,66
0,0,0.62,-0.0,-0.0,1.30224609375,49.85529554590944,6,-41,-72,647,180,1070,784,66
0,0,0.66,-0.0,-0.0,1.3112225532531738,49.85529554590944,6,-41,-72,647,180,1070,784,66
0,0,0.71,-0.0,-0.0,1.3192009925842285,49.85529554590944,6,-41,-72,647,180,1070,784,66
0,0,0.71,-0.0,-0.0,1.3281779289245605,49.85529554590944,6,-41,-72,647,180,1070,784,66
0,0,0.73,-0.0,-0.0,1.336155652999878,49.85529554590944,6,-41,-72,647,180,1070,784,66
0,0,0.7,-0.0,-0.0,1.3451321125030518,49.85529554590944,6,-41,-72,647,180,1070,784,66
0,0,0.67,-0.0,-0.0,1.3531107902526855,49.85529554590944,6,-41,-72,647,180,1070,784,66
0,0,0.69,-0.0,-0.0,1.3620872497558594,49.85529554590944,6,-41,-72,647,180,1070,784,66
0,0,0.69,-0.0,-0.0,1.3720602989196777,49.85529554590944,6,-41,-72,647,180,1070,784,66
0,0,0.69,-0.0,-0.0,1.3810369968414307,49.85529554590944,6,-41,-72,647,180,1070,784,66
0,0,0.69,-0.0,-0.0,1.3890149593353271,49.85529554590944,6,-41,-72,647,180,1070,784,66
0,0,0.69,-0.0,-0.0,1.3999850749969482,49.85529554590944,6,-41,-72,647,180,1070,784,66
0,0,0.69,-0.0,-0.0,1.4069666862487793,49.85529554590944,6,-41,-72,647,180,1070,784,66
0,0,0.69,-0.0,-0.0,1.4149456024169922,49.85529554590944,6,-41,-72,647,180,1070,784,66
0,0,0.69,-0.0,-0.0,1.4219272136688232,49.85529554590944,6,-41,-72,647,180,1070,784,66
0,0,0.69,-0.0,-0.0,1.4328982830047607,49.85529554590944,6,-41,-72,647,180,1070,784,66
0,0,0.69,-0.0,-0.0,1.4399113655090332,49.85529554590944,6,-41,-72,647,180,1070,784,66
0,0,0.69,-0.0,-0.0,1.4478580951690674,49.85529554590944,6,-41,-72,647,180,1070,784,66
0,0,0.69,-0.0,-0.0,1.455836296081543,49.85529554590944,6,-41,-72,647,180,1070,784,66
0,0,0.69,-0.0,-0.0,1.463815689086914,49.85529554590944,6,-41,-72,647,180,1070,784,66
0,0,0.69,-0.0,-0.0,1.4727914333343506,49.85529554590944,6,-41,-72,647,180,1070,784,66
0,0,0.69,-0.0,-0.0,1.482764482498169,49.85529554590944,6,-41,-72,647,180,1070,784,66
0,0,0.69,-0.0,-0.0,1.4907538890838623,49.85529554590944,6,-41,-72,647,180,1070,784,66
0,0,0.69,-0.0,-0.0,1.501715898513794,49.85529554590944,6,-41,-72,647,180,1070,784,66
0,0,0.69,-0.0,-0.0,1.5086963176727295,49.85529554590944,6,-41,-72,647,180,1070,784,66
0,0,0.69,-0.0,-0.0,1.518690586090088,49.85529554590944,6,-41,-72,647,180,1070,784,66
0,0,0.69,-0.0,-0.0,1.5266501903533936,49.85529554590944,6,-41,-72,647,180,1070,784,66
0,0,0.69,-0.0,-0.0,1.535623550415039,49.85529554590944,6,-41,-72,647,180,1070,784,66
0,0,0.69,-0.0,-0.0,1.5455968379974365,49.85529554590944,6,-41,-72,647,180,1070,784,66
0,0,0.69,-0.0,-0.0,1.5535964965820312,49.85529554590944,6,-41,-72,647,180,1070,784,66
0,0,0.69,-0.0,-0.0,1.5615558624267578,49.85529554590944,6,-41,-72,647,180,1070,784,66
0,0,0.69,-0.0,-0.0,1.5725266933441162,49.85529554590944,6,-41,-72,647,180,1070,784,66
0,0,0.69,-0.0,-0.0,1.5805044174194336,49.85529554590944,6,-41,-72,647,180,1070,784,66
0,0,0.69,-0.0,-0.0,1.588484287261963,49.85529554590944,6,-41,-72,647,180,1070,784,66
0,0,0.69,-0.0,-0.0,1.6005756855010986,49.85529554590944,6,-41,-72,647,180,1070,784,66
0,0,0.69,-0.0,-0.0,1.6075570583343506,49.85529554590944,6,-41,-72,647,180,1070,784,66
0,0,0.69,-0.0,-0.0,1.616532802581787,49.85529554590944,6,-41,-72,647,180,1070,784,66
0,0,0.69,-0.0,-0.0,1.6245126724243164,49.85529554590944,6,-41,-72,647,180,1070,784,66
0,0,0.69,-0.0,-0.0,1.634486198425293,49.85529554590944,6,-41,-72,647,180,1070,784,66
0,0,0.69,-0.0,-0.0,1.6414680480957031,49.85529554590944,6,-41,-72,647,180,1070,784,66
0,0,0.69,-0.0,-0.0,1.6524372100830078,49.85529554590944,6,-41,-72,647,180,1070,784,66
0,0,0.69,-0.0,-0.0,1.6584229469299316,49.85529554590944,6,-41,-72,647,180,1070,784,66
0,0,0.69,-0.0,-0.0,1.6683943271636963,49.85529554590944,6,-41,-72,647,180,1070,784,66
0,0,0.69,-0.0,-0.0,1.6763734817504883,49.85529554590944,6,-41,-72,647,180,1070,784,66
0,0,0.69,-0.0,-0.0,1.6863467693328857,49.85529554590944,6,-41,-72,647,180,1070,784,66
0,0,0.69,-0.0,-0.0,1.696319818496704,49.85529554590944,6,-41,-72,647,180,1070,784,66
0,0,0.69,-0.0,-0.0,1.703301191329956,49.85529554590944,6,-41,-72,647,180,1070,784,66
0,0,0.69,-0.0,-0.0,1.7122783660888672,49.85529554590944,6,-41,-72,647,180,1070,784,66
0,0,0.69,-0.0,-0.0,1.7212536334991455,49.85529554590944,6,-41,-72,647,180,1070,784,66
0,0,0.69,-0.0,-0.0,1.7302513122558594,49.85529554590944,6,-41,-72,647,180,1070,784,66
0,0,0.69,-0.0,-0.0,1.7392387390136719,49.85529554590944,6,-41,-72,647,180,1070,784,66
0,0,0.69,-0.0,-0.0,1.7491865158081055,49.85529554590944,6,-41,-72,647,180,1070,784,66
0,0,0.69,-0.0,-0.0,1.757157564163208,49.85529554590944,6,-41,-72,647,180,1070,784,66
0,0,0.69,-0.0,-0.0,1.7671327590942383,49.85529554590944,6,-41,-72,647,180,1070,784,66
0,0,0.69,-0.0,-0.0,1.7751107215881348,49.85529554590944,6,-41,-72,647,180,1070,784,66
0,0,0.69,-0.0,-0.0,1.7850854396820068,49.85529554590944,6,-41,-72,647,180,1070,784,66
0,0,0.69,-0.0,-0.0,1.7930629253387451,49.85529554590944,6,-41,-72,647,180,1070,784,66
0,0,0.69,-0.0,-0.0,1.803037405014038,49.85529554590944,6,-41,-72,647,180,1070,784,66
0,0,0.69,-0.0,-0.0,1.8110146522521973,49.85529554590944,6,-41,-72,647,180,1070,784,66
0,0,0.69,-0.0,-0.0,1.819990873336792,49.85529554590944,6,-41,-72,647,180,1070,784,66
0,0,0.69,-0.0,-0.0,1.8289685249328613,49.85529554590944,6,-41,-72,647,180,1070,784,66
0,0,0.69,-0.0,-0.0,1.8369662761688232,49.85529554590944,6,-41,-72,647,180,1070,784,66
0,0,0.69,-0.0,-0.0,1.8459224700927734,49.85529554590944,6,-41,-72,647,180,1070,784,66
0,0,0.69,-0.0,-0.0,1.8539011478424072,49.85529554590944,6,-41,-72,647,180,1070,784,66
0,0,0.69,-0.0,-0.0,1.8629074096679688,49.85529554590944,6,-41,-72,647,180,1070,784,66
