dx,dy,button,rx,ry,time,distance,targetID,directionX,directionY,targetX,targetY,initMouseX,initMouseY,targetSize,score
0,0,0,-0.0,-0.0,0.3569345474243164,717.7939268776568,1,-450,572,510,1172,960,600,20,169.34
0,2,0,-0.0,2.0,0.5100016593933105,716.2231062146122,1,-450,570,510,1172,960,600,20,13.15
0,5,0,-0.0,5.0,0.5178706645965576,712.3053370978232,1,-450,565,510,1172,960,600,20,27.78
-3,6,0,-3.0,6.0,0.5257775783538818,705.7443677738582,1,-447,559,510,1172,960,600,20,42.59
-5,7,0,-5.0,7.0,0.5338187217712402,697.1548628129485,1,-442,552,510,1172,960,600,20,52.47
-5,8,0,-5.0,8.0,0.5421955585479736,687.7857837474191,1,-437,544,510,1172,960,600,20,54.07
-5,9,0,-5.0,9.0,0.5500566959381104,677.6401675295009,1,-432,535,510,1172,960,600,20,55.84
-6,9,0,-6.0,9.0,0.5579535961151123,666.8692635952677,1,-426,526,510,1172,960,600,20,58.19
-6,10,0,-6.0,10.0,0.5659077167510986,655.3239812301973,1,-420,516,510,1172,960,600,20,59.47
-8,15,0,-8.0,15.0,0.5739316940307617,638.6485951576554,1,-412,501,510,1172,960,600,20,71.43
-10,17,0,-10.0,17.0,0.5818805694580078,619.1740617666943,1,-402,484,510,1172,960,600,20,76.03
-10,17,0,-10.0,17.0,0.5898525714874268,599.7155074294897,1,-392,467,510,1172,960,600,20,74.46
-10,16,0,-10.0,16.0,0.5988686084747314,581.0372238700368,1,-382,451,510,1172,960,600,20,71.74
-11,17,0,-11.0,17.0,0.6058685779571533,560.9614698033485,1,-371,434,510,1172,960,600,20,72.76
-10,13,0,-10.0,13.0,0.6136996746063232,544.5827260202034,1,-361,421,510,1172,960,600,20,65.7
-9,12,0,-9.0,12.0,0.6218717098236084,529.6156039256092,1,-352,409,510,1172,960,600,20,61.35
-8,11,0,-8.0,11.0,0.6297755241394043,516.0608329841712,1,-344,398,510,1172,960,600,20,56.95
-7,10,0,-7.0,10.0,0.6378555297851562,503.91925435811413,1,-337,388,510,1172,960,600,20,52.47
-6,9,0,-6.0,9.0,0.6456475257873535,493.19181233402435,1,-331,379,510,1172,960,600,20,47.86
-6,6,0,-6.0,6.0,0.6537766456604004,484.7261868953371,1,-325,373,510,1172,960,600,20,41.66
-5,6,0,-5.0,6.0,0.661834716796875,476.91785754888883,1,-320,367,510,1172,960,600,20,40.35
-4,4,0,-4.0,4.0,0.6698646545410156,471.27435003332556,1,-316,363,510,1172,960,600,20,31.44
-3,3,0,-3.0,3.0,0.6777575016021729,467.04192687855016,1,-313,360,510,1172,960,600,20,25.7
-3,5,0,-3.0,5.0,0.6856935024261475,461.3013897709193,1,-310,355,510,1172,960,600,20,30.21
-3,4,0,-3.0,4.0,0.6937055587768555,456.31534394656154,1,-307,351,510,1172,960,600,20,28.27
-3,4,0,-3.0,4.0,0.7019796371459961,451.3296001775737,1,-304,347,510,1172,960,600,20,28.08
-3,4,0,-3.0,4.0,0.709688663482666,446.3441683641854,1,-301,343,510,1172,960,600,20,27.88
-5,4,0,-5.0,4.0,0.7176597118377686,440.0411092333677,1,-296,339,510,1172,960,600,20,31.29
-4,6,0,-4.0,6.0,0.7257885932922363,432.89163460151286,1,-292,333,510,1172,960,600,20,34.11
-5,5,0,-5.0,5.0,0.7337386608123779,425.83597832212064,1,-287,328,510,1172,960,600,20,34.32
-4,6,0,-4.0,6.0,0.7417147159576416,418.68753189240294,1,-283,322,510,1172,960,600,20,33.4
-5,6,0,-5.0,6.0,0.7497684955596924,410.880030412468,1,-278,316,510,1172,960,600,20,36.78
-6,7,0,-6.0,7.0,0.7578935623168945,401.66126852061274,1,-272,309,510,1172,960,600,20,40.69
-5,6,0,-5.0,6.0,0.7661106586456299,393.8539339909914,1,-267,303,510,1172,960,600,20,35.84
-4,6,0,-4.0,6.0,0.7740015983581543,386.7089613305956,1,-263,297,510,1172,960,600,20,31.73
-4,6,0,-4.0,6.0,0.7818586826324463,379.56642565806413,1,-259,291,510,1172,960,600,20,31.33
-5,6,0,-5.0,6.0,0.7897117137908936,371.7603960601466,1,-254,285,510,1172,960,600,20,34.44
-4,5,0,-4.0,5.0,0.7976396083831787,365.3664875824692,1,-250,280,510,1172,960,600,20,29.59
-4,6,0,-4.0,6.0,0.8058176040649414,358.2281901212888,1,-246,274,510,1172,960,600,20,30.15
-5,7,0,-5.0,7.0,0.8136386871337891,349.6804137008297,1,-241,267,510,1172,960,600,20,33.62
-5,7,0,-5.0,7.0,0.8220596313476562,341.1353015576759,1,-236,260,510,1172,960,600,20,33.05
-7,8,0,-7.0,8.0,0.8301305770874023,330.50697496527147,1,-229,252,510,1172,960,600,20,38.95
-6,8,0,-6.0,8.0,0.8379795551300049,320.55256768024054,1,-223,244,510,1172,960,600,20,35.08
-7,8,0,-7.0,8.0,0.8459277153015137,309.924991208877,1,-216,236,510,1172,960,600,20,37.28
-8,9,0,-8.0,9.0,0.8537046909332275,297.88471868541967,1,-208,227,510,1172,960,600,20,39.26
-7,9,0,-7.0,9.0,0.8619105815887451,286.52150006365474,1,-201,218,510,1172,960,600,20,35.38
-8,8,0,-8.0,8.0,0.869748592376709,275.21746089606785,1,-193,210,510,1172,960,600,20,35.17
-7,8,0,-7.0,8.0,0.8781065940856934,264.5906043549196,1,-186,202,510,1172,960,600,20,33.67
-7,7,0,-7.0,7.0,0.8858845233917236,254.69982999616752,1,-179,195,510,1172,960,600,20,31.07
-4,5,0,-4.0,5.0,0.894033670425415,248.3118270617898,1,-175,190,510,1172,960,600,20,23.13
-4,4,0,-4.0,4.0,0.9020545482635498,242.65985039178662,1,-171,186,510,1172,960,600,20,21.73
-5,6,0,-5.0,6.0,0.9100015163421631,234.85914318236107,1,-166,180,510,1172,960,600,20,25.6
-4,5,0,-4.0,5.0,0.9179596900939941,228.47222060441337,1,-162,175,510,1172,960,600,20,21.94
-4,5,0,-4.0,5.0,0.9259285926818848,222.08619088605855,1,-158,170,510,1172,960,600,20,21.53
-3,5,0,-3.0,5.0,0.9339406490325928,216.38462845343543,1,-155,165,510,1172,960,600,20,18.41
-2,4,0,-2.0,4.0,0.9419186115264893,212.10357943986403,1,-153,161,510,1172,960,600,20,14.61
-4,6,0,-4.0,6.0,0.9497785568237305,205.00232556881798,1,-149,155,510,1172,960,600,20,20.72
-3,6,0,-3.0,6.0,0.9584925174713135,198.60728654579637,1,-146,149,510,1172,960,600,20,18.24
-4,8,0,-4.0,8.0,0.9660305976867676,190.11246837716035,1,-142,141,510,1172,960,600,20,21.16
-3,8,0,-3.0,8.0,0.9741065502166748,182.37983262286096,1,-139,133,510,1172,960,600,20,18.93
-4,8,0,-4.0,8.0,0.9818925857543945,173.98369492974098,1,-135,125,510,1172,960,600,20,19.62
-4,7,0,-4.0,7.0,0.9898805618286133,166.30938715791623,1,-131,118,510,1172,960,600,20,18.15
-4,7,0,-4.0,7.0,0.9978024959564209,158.67127793433,1,-127,111,510,1172,960,600,20,17.46
-3,6,0,-3.0,6.0,1.0058536529541016,152.48384535085327,1,-124,105,510,1172,960,600,20,14.59
-3,6,0,-3.0,6.0,1.0138707160949707,146.33937443907084,1,-121,99,510,1172,960,600,20,14.07
-4,6,0,-4.0,6.0,1.0218615531921387,139.4590244849738,1,-117,93,510,1172,960,600,20,15.08
-4,7,0,-4.0,7.0,1.0299036502838135,132.00352108310554,1,-113,86,510,1172,960,600,20,14.91
-3,6,0,-3.0,6.0,1.0379066467285156,126.01470508735443,1,-110,80,510,1172,960,600,20,12.31
-3,5,0,-3.0,5.0,1.0461184978485107,120.66751700403586,1,-107,75,510,1172,960,600,20,11.29
-3,4,0,-3.0,4.0,1.0539727210998535,115.92458060283545,1,-104,71,510,1172,960,600,20,10.53
-2,4,0,-2.0,4.0,1.0621216297149658,112.03687967167957,1,-102,67,510,1172,960,600,20,8.43
-3,4,0,-3.0,4.0,1.0699305534362793,107.34564329364768,1,-99,63,510,1172,960,600,20,9.83
-2,4,0,-2.0,4.0,1.0779635906219482,103.53413583587978,1,-97,59,510,1172,960,600,20,7.81
-4,5,0,-4.0,5.0,1.085977554321289,97.54068997360952,1,-93,54,510,1172,960,600,20,10.74
-6,5,0,-6.0,5.0,1.0938315391540527,89.84988733093293,1,-87,49,510,1172,960,600,20,12.83
-6,5,0,-6.0,5.0,1.1017875671386719,82.17917335276988,1,-81,44,510,1172,960,600,20,12.04
-6,5,0,-6.0,5.0,1.1098597049713135,74.53401682163222,1,-75,39,510,1172,960,600,20,11.22
-6,4,0,-6.0,4.0,1.1178405284881592,67.3692445355388,1,-69,35,510,1172,960,600,20,11.04
-6,4,0,-6.0,4.0,1.1263155937194824,60.21395872616783,1,-63,31,510,1172,960,600,20,10.28
-4,2,0,-4.0,2.0,1.134016513824463,55.74191965557441,1,-59,29,510,1172,960,600,20,10.92
-4,2,0,-4.0,2.0,1.1420745849609375,51.26989472816156,1,-55,27,510,1172,960,600,20,10.62
-2,2,0,-2.0,2.0,1.1498997211456299,48.60034129593445,1,-53,25,510,1172,960,600,20,4.74
-2,1,0,-2.0,1.0,1.1580476760864258,46.36488268416781,1,-51,24,510,1172,960,600,20,7.59
-2,2,0,-2.0,2.0,1.165947675704956,43.71219600798314,1,-49,22,510,1172,960,600,20,4.44
-2,0,0,-2.0,-0.0,1.1739046573638916,41.894122981316485,1,-47,22,510,1172,960,600,20,3.46
-1,1,0,-1.0,1.0,1.1817526817321777,40.566787519082126,1,-46,21,510,1172,960,600,20,3.33
-1,0,0,-1.0,-0.0,1.1978175640106201,39.658836071740545,1,-45,21,510,1172,960,600,20,2.69
-1,1,0,-1.0,1.0,1.206390619277954,38.33218389437829,1,-44,20,510,1172,960,600,20,3.26
-1,0,0,-1.0,-0.0,1.214019536972046,37.4236228055175,1,-43,20,510,1172,960,600,20,2.65
-1,0,0,-1.0,-0.0,1.2219555377960205,36.51881339845203,1,-42,20,510,1172,960,600,20,2.61
0,1,0,-0.0,1.0,1.2300925254821777,36.09772228646444,1,-42,19,510,1172,960,600,20,0.82
-1,0,0,-1.0,-0.0,1.2379226684570312,35.18849411078001,1,-41,19,510,1172,960,600,20,2.62
-1,1,0,-1.0,1.0,1.2460095882415771,33.86342439892262,1,-40,18,510,1172,960,600,20,3.14
-1,0,0,-1.0,-0.0,1.253814697265625,32.95346318982906,1,-39,18,510,1172,960,600,20,2.58
-1,1,0,-1.0,1.0,1.2617816925048828,31.6293165929973,1,-38,17,510,1172,960,600,20,3.07
-2,0,0,-2.0,-0.0,1.26997971534729,29.812058474788763,1,-36,17,510,1172,960,600,20,3.04
-2,0,0,-2.0,-0.0,1.2779545783996582,28.013155617496423,1,-34,17,510,1172,960,600,20,2.9
-1,1,0,-1.0,1.0,1.2860186100006104,26.674241641784498,1,-33,16,510,1172,960,600,20,3.07
-2,1,0,-2.0,1.0,1.294257640838623,24.438350715445125,1,-31,15,510,1172,960,600,20,7.31
-2,1,0,-2.0,1.0,1.3019826412200928,22.202484376209235,1,-29,14,510,1172,960,600,20,7.17
-2,2,0,-2.0,2.0,1.310145616531372,19.546573405388315,1,-27,12,510,1172,960,600,20,3.27
-3,1,0,-3.0,1.0,1.3180255889892578,16.40075756488817,1,-24,11,510,1172,960,600,20,4.99
-2,1,0,-2.0,1.0,1.3259947299957275,14.166091947189145,1,-22,10,510,1172,960,600,20,5.86
-1,1,0,-1.0,1.0,1.333824634552002,12.847319317591726,1,-21,9,510,1172,960,600,20,2.43
-1,0,0,-1.0,-0.0,1.341895580291748,11.931712199461309,1,-20,9,510,1172,960,600,20,2.14
-2,1,0,-2.0,1.0,1.3497655391693115,9.697715603592208,1,-18,8,510,1172,960,600,20,5.38
-1,1,0,-1.0,1.0,1.357886552810669,8.384776310850235,1,-17,7,510,1172,960,600,20,2.19
-2,0,0,-2.0,-0.0,1.3658576011657715,6.552945357246848,1,-15,7,510,1172,960,600,20,2.03
-2,1,0,-2.0,1.0,1.3738796710968018,4.317821063276353,1,-13,6,510,1172,960,600,20,5.49
-2,0,0,-2.0,-0.0,1.3819315433502197,2.5299640861416677,1,-11,6,510,1172,960,600,20,1.55
-2,1,0,-2.0,1.0,1.3898036479949951,0.2956301409870008,1,-9,5,510,1172,960,600,20,4.78
-2,0,0,-2.0,-0.0,1.3978455066680908,-1.3976747329573733,1,-7,5,510,1172,960,600,20,0.85
-1,0,0,-1.0,-0.0,1.405686616897583,-2.189750324093346,1,-6,5,510,1172,960,600,20,0.7
-2,1,0,-2.0,1.0,1.4136977195739746,-4.343145750507619,1,-4,4,510,1172,960,600,20,1.47
-2,1,0,-2.0,1.0,1.421696662902832,-6.39444872453601,1,-2,3,510,1172,960,600,20,0.38
-2,1,0,-2.0,1.0,1.4298136234283447,-8.0,1,0,2,510,1172,960,600,20,-1.28
-2,1,0,-2.0,1.0,1.4379136562347412,-7.76393202250021,1,2,1,510,1172,960,600,20,-1.39
-2,1,0,-2.0,1.0,1.4464035034179688,-6.0,1,4,0,510,1172,960,600,20,-1.44
-4,1,0,-4.0,1.0,1.4539966583251953,-1.9377422517014509,1,8,-1,510,1172,960,600,20,0.33
-2,1,0,-2.0,1.0,1.4621145725250244,0.19803902718556898,1,10,-2,510,1172,960,600,20,0.92
-2,1,0,-2.0,1.0,1.4698936939239502,2.369316876852981,1,12,-3,510,1172,960,600,20,1.45
-2,1,0,-2.0,1.0,1.4778926372528076,4.560219778561036,1,14,-4,510,1172,960,600,20,1.88
-1,0,0,-1.0,-0.0,1.501835584640503,5.524174696260024,1,15,-4,510,1172,960,600,20,2.47
0,0,1,-0.0,-0.0,1.50581955909729,5.524174696260024,1,15,-4,510,1172,960,600,20,28.55
0,1,1,-0.0,1.0,-0.0008103847503662109,1197.9313145062563,2,885,-844,1380,333,495,1176,50,7.29
0,0,0,-0.0,-0.0,0.06853461265563965,1197.9313145062563,2,885,-844,1380,333,495,1176,50,227.47
0,-1,0,-0.0,-1.0,0.1423325538635254,1197.2413836881813,2,885,-843,1380,333,495,1176,50,4.07
0,-2,0,-0.0,-2.0,0.15053772926330566,1195.8628096555321,2,885,-841,1380,333,495,1176,50,6.98
2,-3,0,2.0,-3.0,0.15818572044372559,1192.3467049283865,2,883,-838,1380,333,495,1176,50,17.29
3,-5,0,3.0,-5.0,0.16631460189819336,1186.7297553497644,2,880,-833,1380,333,495,1176,50,24.72
4,-6,0,4.0,-6.0,0.17431068420410156,1179.7012077689637,2,876,-827,1380,333,495,1176,50,29.75
5,-8,0,5.0,-8.0,0.1823277473449707,1170.5760118035155,2,871,-819,1380,333,495,1176,50,36.21
6,-10,0,6.0,-10.0,0.1906137466430664,1159.3588983074344,2,865,-809,1380,333,495,1176,50,42.17
9,-13,0,9.0,-13.0,0.19855165481567383,1143.910603938556,2,856,-796,1380,333,495,1176,50,53.52
13,-18,0,13.0,-18.0,0.20617055892944336,1122.1412293174717,2,843,-778,1380,333,495,1176,50,67.33
15,-19,0,15.0,-19.0,0.2141256332397461,1098.2386211308797,2,828,-759,1380,333,495,1176,50,71.03
19,-19,0,19.0,-19.0,0.22222256660461426,1071.394545772643,2,809,-740,1380,333,495,1176,50,76.97
20,-19,0,20.0,-19.0,0.23038172721862793,1043.8133606949343,2,789,-721,1380,333,495,1176,50,77.94
22,-17,0,22.0,-17.0,0.2384495735168457,1016.1075832977108,2,767,-704,1380,333,495,1176,50,75.45
24,-18,0,24.0,-18.0,0.24615859985351562,986.2591161517408,2,743,-686,1380,333,495,1176,50,77.36
24,-17,0,24.0,-17.0,0.25413060188293457,957.1008094895351,2,719,-669,1380,333,495,1176,50,74.66
24,-16,0,24.0,-16.0,0.2621285915374756,928.6424906640852,2,695,-653,1380,333,495,1176,50,72.02
25,-18,0,25.0,-18.0,0.27027273178100586,898.1061694084814,2,670,-635,1380,333,495,1176,50,73.97
25,-19,0,25.0,-19.0,0.2782456874847412,866.8974156258106,2,645,-616,1380,333,495,1176,50,73.64
27,-23,0,27.0,-23.0,0.28632164001464844,831.4887623314155,2,618,-593,1380,333,495,1176,50,78.03
27,-24,0,27.0,-24.0,0.2948136329650879,795.3913700179933,2,591,-569,1380,333,495,1176,50,77.29
26,-24,0,26.0,-24.0,0.3022427558898926,760.0159234053791,2,565,-545,1380,333,495,1176,50,75.04
24,-20,0,24.0,-20.0,0.31020474433898926,728.8607298433843,2,541,-525,1380,333,495,1176,50,66.92
21,-17,0,21.0,-17.0,0.31824755668640137,701.955294361352,2,520,-508,1380,333,495,1176,50,59.76
18,-14,0,18.0,-14.0,0.3262646198272705,679.3010719855537,2,502,-494,1380,333,495,1176,50,52.39
16,-13,0,16.0,-13.0,0.3343057632446289,658.7813978165829,2,486,-481,1380,333,495,1176,50,48.47
14,-11,0,14.0,-11.0,0.34205055236816406,641.0960891643186,2,472,-470,1380,333,495,1176,50,43.0
13,-11,0,13.0,-11.0,0.35017967224121094,624.1240251292506,2,459,-459,1380,333,495,1176,50,41.59
12,-11,0,12.0,-11.0,0.3581817150115967,607.8609641935581,2,447,-448,1380,333,495,1176,50,40.52
11,-11,0,11.0,-11.0,0.3661496639251709,592.3046249624249,2,436,-437,1380,333,495,1176,50,40.68
11,-10,0,11.0,-10.0,0.37427663803100586,577.4566374437251,2,425,-427,1380,333,495,1176,50,36.89
9,-9,0,9.0,-9.0,0.38225865364074707,564.7287512068579,2,416,-418,1380,333,495,1176,50,34.73
8,-6,0,8.0,-6.0,0.3902626037597656,554.834459134674,2,408,-412,1380,333,495,1176,50,26.0
8,-5,0,8.0,-5.0,0.39820361137390137,545.656639320003,2,400,-407,1380,333,495,1176,50,23.76
6,-5,0,6.0,-5.0,0.40616655349731445,537.8854235099715,2,394,-402,1380,333,495,1176,50,21.91
6,-5,0,6.0,-5.0,0.41414976119995117,530.1153033379642,2,388,-397,1380,333,495,1176,50,21.72
6,-5,0,6.0,-5.0,0.422135591506958,522.3463254649655,2,382,-392,1380,333,495,1176,50,21.52
6,-6,0,6.0,-6.0,0.4301576614379883,513.861763349377,2,376,-386,1380,333,495,1176,50,24.76
5,-6,0,5.0,-6.0,0.4384186267852783,506.07532422435145,2,371,-380,1380,333,495,1176,50,21.52
5,-7,0,5.0,-7.0,0.4462566375732422,497.5753534180501,2,366,-373,1380,333,495,1176,50,21.79
5,-5,0,5.0,-5.0,0.45418572425842285,490.50460715690986,2,361,-368,1380,333,495,1176,50,21.69
5,-6,0,5.0,-6.0,0.46221375465393066,482.7203954934251,2,356,-362,1380,333,495,1176,50,20.91
6,-6,0,6.0,-6.0,0.4701535701751709,474.2354154104054,2,350,-356,1380,333,495,1176,50,24.02
5,-5,0,5.0,-5.0,0.47819066047668457,467.16460661043067,2,345,-351,1380,333,495,1176,50,21.24
7,-5,0,7.0,-5.0,0.4861886501312256,458.69411821935563,2,338,-346,1380,333,495,1176,50,20.57
8,-6,0,8.0,-6.0,0.49418067932128906,448.8143096192853,2,330,-340,1380,333,495,1176,50,22.84
9,-6,0,9.0,-6.0,0.5021336078643799,438.246154868014,2,321,-334,1380,333,495,1176,50,23.18
8,-8,0,8.0,-8.0,0.5101027488708496,426.9347298006649,2,313,-326,1380,333,495,1176,50,26.7
9,-8,0,9.0,-8.0,0.5182466506958008,414.9318128983172,2,304,-318,1380,333,495,1176,50,25.83
7,-8,0,7.0,-8.0,0.5261456966400146,404.3122406826994,2,297,-310,1380,333,495,1176,50,24.1
6,-9,0,6.0,-9.0,0.5341787338256836,393.6669320593639,2,291,-301,1380,333,495,1176,50,22.06
6,-9,0,6.0,-9.0,0.5423357486724854,383.0306361046925,2,285,-292,1380,333,495,1176,50,21.64
6,-7,0,6.0,-7.0,0.5501606464385986,373.8307911884437,2,279,-285,1380,333,495,1176,50,20.56
6,-8,0,6.0,-8.0,0.5580337047576904,363.91901470614675,2,273,-277,1380,333,495,1176,50,20.38
6,-7,0,6.0,-7.0,0.566063642501831,354.7222669267632,2,267,-270,1380,333,495,1176,50,19.86
6,-8,0,6.0,-8.0,0.5740137100219727,344.8175225702536,2,261,-262,1380,333,495,1176,50,19.67
6,-7,0,6.0,-7.0,0.5823185443878174,335.62445840513925,2,255,-255,1380,333,495,1176,50,19.15
6,-8,0,6.0,-8.0,0.5899937152862549,325.7278146939589,2,249,-247,1380,333,495,1176,50,18.94
7,-8,0,7.0,-8.0,0.5980026721954346,315.1249770305027,2,242,-239,1380,333,495,1176,50,20.34
8,-9,0,8.0,-9.0,0.6061856746673584,303.10973774028713,2,234,-230,1380,333,495,1176,50,21.65
8,-9,0,8.0,-9.0,0.6141536235809326,291.09650425147066,2,226,-221,1380,333,495,1176,50,21.08
9,-9,0,9.0,-9.0,0.6221127510070801,278.3694117738306,2,217,-212,1380,333,495,1176,50,23.05
8,-8,0,8.0,-8.0,0.6300806999206543,267.056501382866,2,209,-204,1380,333,495,1176,50,21.0
8,-7,0,8.0,-7.0,0.6381707191467285,256.44271175498574,2,201,-197,1380,333,495,1176,50,18.34
9,-8,0,9.0,-8.0,0.6462695598602295,244.4160351575236,2,192,-189,1380,333,495,1176,50,19.39
8,-7,0,8.0,-7.0,0.6540536880493164,233.80494585691366,2,184,-182,1380,333,495,1176,50,17.3
9,-8,0,9.0,-8.0,0.6620707511901855,221.78127967899024,2,175,-174,1380,333,495,1176,50,18.21
8,-6,0,8.0,-6.0,0.6701867580413818,211.8818270783979,2,167,-168,1380,333,495,1176,50,14.59
9,-7,0,9.0,-7.0,0.6781587600708008,200.5770378385176,2,158,-161,1380,333,495,1176,50,15.46
9,-7,0,9.0,-7.0,0.686173677444458,189.28252378577213,2,149,-154,1380,333,495,1176,50,14.84
8,-8,0,8.0,-8.0,0.6943507194519043,177.97044119772713,2,141,-146,1380,333,495,1176,50,16.69
8,-7,0,8.0,-7.0,0.7022807598114014,167.37983262286096,2,133,-139,1380,333,495,1176,50,13.83
8,-6,0,8.0,-6.0,0.7100996971130371,157.5212316416915,2,125,-133,1380,333,495,1176,50,11.94
8,-7,0,8.0,-7.0,0.7182846069335938,146.9447585708852,2,117,-126,1380,333,495,1176,50,12.63
7,-6,0,7.0,-6.0,0.7262656688690186,137.78820596099706,2,110,-120,1380,333,495,1176,50,11.03
6,-5,0,6.0,-5.0,0.7341437339782715,130.05160431288675,2,104,-115,1380,333,495,1176,50,9.53
6,-6,0,6.0,-6.0,0.7422275543212891,121.57762448614045,2,98,-109,1380,333,495,1176,50,10.9
6,-5,0,6.0,-5.0,0.7501566410064697,113.85243966167826,2,92,-104,1380,333,495,1176,50,8.77
8,-6,0,8.0,-6.0,0.758171558380127,104.07362240210043,2,84,-98,1380,333,495,1176,50,8.99
7,-6,0,7.0,-6.0,0.7661845684051514,94.97082978791136,2,77,-92,1380,333,495,1176,50,8.58
6,-6,0,6.0,-6.0,0.774134635925293,86.5212984142491,2,71,-86,1380,333,495,1176,50,8.59
5,-5,0,5.0,-5.0,0.7820415496826172,79.48444860360799,2,66,-81,1380,333,495,1176,50,7.53
4,-4,0,4.0,-4.0,0.7902755737304688,73.85848471426213,2,62,-77,1380,333,495,1176,50,6.6
4,-4,0,4.0,-4.0,0.7981805801391602,68.23625904121208,2,58,-73,1380,333,495,1176,50,6.33
4,-5,0,4.0,-5.0,0.8063216209411621,61.833173384369644,2,54,-68,1380,333,495,1176,50,9.52
5,-4,0,5.0,-4.0,0.8142967224121094,55.60397012554654,2,49,-64,1380,333,495,1176,50,5.06
5,-4,0,5.0,-4.0,0.822434663772583,49.4043009509531,2,44,-60,1380,333,495,1176,50,4.69
5,-3,0,5.0,-3.0,0.8303897380828857,44.06518659932803,2,39,-57,1380,333,495,1176,50,3.51
4,-3,0,4.0,-3.0,0.8382515907287598,39.350602172784676,2,35,-54,1380,333,495,1176,50,3.46
4,-3,0,4.0,-3.0,0.8462755680084229,34.682493245507096,2,31,-51,1380,333,495,1176,50,3.18
3,-4,0,3.0,-4.0,0.8542237281799316,29.708317466359723,2,28,-47,1380,333,495,1176,50,4.84
3,-2,0,3.0,-2.0,0.8621857166290283,26.478150704935004,2,25,-45,1380,333,495,1176,50,2.3
2,-3,0,2.0,-3.0,0.8701956272125244,22.885279575251516,2,23,-42,1380,333,495,1176,50,4.6
2,-3,0,2.0,-3.0,0.8783226013183594,19.294469180700204,2,21,-39,1380,333,495,1176,50,4.39
2,-2,0,2.0,-2.0,0.8863036632537842,16.593268686170845,2,19,-37,1380,333,495,1176,50,2.57
1,-1,0,1.0,-1.0,0.8942286968231201,15.249223594996216,2,18,-36,1380,333,495,1176,50,2.39
1,-1,0,1.0,-1.0,0.9023706912994385,13.910152916687437,2,17,-35,1380,333,495,1176,50,2.32
0,-1,0,-0.0,-1.0,0.9102396965026855,13.013155617496423,2,17,-34,1380,333,495,1176,50,1.83
0,-1,0,-0.0,-1.0,0.9181807041168213,12.12142238654117,2,17,-33,1380,333,495,1176,50,1.78
1,-1,0,1.0,-1.0,0.9261445999145508,10.777087639996637,2,16,-32,1380,333,495,1176,50,2.32
1,-2,0,1.0,-2.0,0.942246675491333,8.541019662496844,2,15,-30,1380,333,495,1176,50,7.19
1,-2,0,1.0,-2.0,0.9502296447753906,6.304951684997057,2,14,-28,1380,333,495,1176,50,7.16
1,-2,0,1.0,-2.0,0.9581427574157715,4.0688837074972675,2,13,-26,1380,333,495,1176,50,7.14
1,-3,0,1.0,-3.0,0.966261625289917,0.9422435421456932,2,12,-23,1380,333,495,1176,50,3.02
2,-3,0,2.0,-3.0,0.9741706848144531,-2.639320225002102,2,10,-20,1380,333,495,1176,50,3.19
1,-1,0,1.0,-1.0,0.9821436405181885,-3.976203958371361,2,9,-19,1380,333,495,1176,50,1.9
1,-1,0,1.0,-1.0,0.990182638168335,-5.302284396407792,2,8,-18,1380,333,495,1176,50,1.76
0,0,1,-0.0,-0.0,1.0060346126556396,-5.302284396407792,2,8,-18,1380,333,495,1176,50,25.42
0,0,0,-0.0,-0.0,0.08064103126525879,410.8078276270591,3,-347,-257,1025,94,1372,351,42,119.24
-1,-2,0,-1.0,-2.0,0.2345571517944336,408.81507651547076,3,-346,-255,1025,94,1372,351,42,6.86
-8,-6,0,-8.0,-6.0,0.24252104759216309,398.81543563809083,3,-338,-249,1025,94,1372,351,42,27.19
-11,-9,0,-11.0,-9.0,0.250446081161499,384.62174497923553,3,-327,-240,1025,94,1372,351,42,31.51
-7,-8,0,-7.0,-8.0,0.25855422019958496,374.25181846514,3,-320,-232,1025,94,1372,351,42,23.46
-6,-7,0,-6.0,-7.0,0.2665691375732422,365.29134082969034,3,-314,-225,1025,94,1372,351,42,20.75
-10,-7,0,-10.0,-7.0,0.27443504333496094,353.08555171243916,3,-304,-218,1025,94,1372,351,42,28.58
-14,-9,0,-14.0,-9.0,0.2823810577392578,336.4646835702794,3,-290,-209,1025,94,1372,351,42,32.01
-16,-9,0,-16.0,-9.0,0.290485143661499,318.22853653547486,3,-274,-200,1025,94,1372,351,42,31.69
-20,-11,0,-20.0,-11.0,0.29855823516845703,295.602274154814,3,-254,-189,1025,94,1372,351,42,34.13
-22,-13,0,-22.0,-13.0,0.3064920902252197,270.20439557122074,3,-232,-176,1025,94,1372,351,42,34.53
-22,-13,0,-22.0,-13.0,0.3145902156829834,244.8364158650955,3,-210,-163,1025,94,1372,351,42,32.16
-20,-11,0,-20.0,-11.0,0.3225681781768799,222.31872102244824,3,-190,-152,1025,94,1372,351,42,27.75
-17,-10,0,-17.0,-10.0,0.33048319816589355,202.8146554629522,3,-173,-142,1025,94,1372,351,42,24.1
-15,-8,0,-15.0,-8.0,0.3385441303253174,186.17142660125697,3,-158,-134,1025,94,1372,351,42,20.27
-12,-7,0,-12.0,-7.0,0.34650111198425293,172.5071058126807,3,-146,-127,1025,94,1372,351,42,17.21
-10,-6,0,-10.0,-6.0,0.3545091152191162,161.03571078225283,3,-136,-121,1025,94,1372,351,42,14.77
-9,-6,0,-9.0,-6.0,0.36246323585510254,150.3300907604966,3,-127,-115,1025,94,1372,351,42,13.86
-6,-5,0,-6.0,-5.0,0.370589017868042,142.52675622050356,3,-121,-110,1025,94,1372,351,42,12.65
-4,-3,0,-4.0,-3.0,0.3789181709289551,137.54967675779096,3,-117,-107,1025,94,1372,351,42,9.01
-2,-3,0,-2.0,-3.0,0.3865220546722412,134.05160431288675,3,-115,-104,1025,94,1372,351,42,6.3
-1,0,0,-1.0,-0.0,0.39452123641967773,133.31137352768266,3,-114,-104,1025,94,1372,351,42,1.99
-1,-2,0,-1.0,-2.0,0.40261006355285645,131.22680447279973,3,-113,-102,1025,94,1372,351,42,4.32
-1,-1,0,-1.0,-1.0,0.41857409477233887,129.81445554057476,3,-112,-101,1025,94,1372,351,42,6.16
0,-1,0,-0.0,-1.0,0.426699161529541,129.14659503298768,3,-112,-100,1025,94,1372,351,42,1.71
-1,-1,0,-1.0,-1.0,0.442594051361084,127.73466307488647,3,-111,-99,1025,94,1372,351,42,6.02
-1,-1,0,-1.0,-1.0,0.45061206817626953,126.32277488562318,3,-110,-98,1025,94,1372,351,42,6.0
-2,-1,0,-2.0,-1.0,0.4585452079772949,124.16542288024377,3,-108,-97,1025,94,1372,351,42,4.74
-4,0,0,-4.0,-0.0,0.4665191173553467,121.21462653327893,3,-104,-97,1025,94,1372,351,42,3.94
-2,-1,0,-2.0,-1.0,0.4745042324066162,119.07141035914503,3,-102,-96,1025,94,1372,351,42,4.54
-3,-2,0,-3.0,-2.0,0.4825282096862793,115.517398158623,3,-99,-94,1025,94,1372,351,42,6.42
-5,-2,0,-5.0,-2.0,0.49052000045776367,110.52946437965906,3,-94,-92,1025,94,1372,351,42,6.27
-3,-3,0,-3.0,-3.0,0.4985342025756836,106.28707711311466,3,-91,-89,1025,94,1372,351,42,9.64
-3,-4,0,-3.0,-4.0,0.5065741539001465,101.34786471369249,3,-88,-85,1025,94,1372,351,42,7.19
-4,-3,0,-4.0,-3.0,0.5145580768585205,96.38824472663352,3,-84,-82,1025,94,1372,351,42,7.31
-2,-4,0,-2.0,-4.0,0.5225470066070557,92.17243480636087,3,-82,-78,1025,94,1372,351,42,5.33
-2,-1,0,-2.0,-1.0,0.5305590629577637,90.03603018840326,3,-80,-77,1025,94,1372,351,42,4.04
-2,-2,0,-2.0,-2.0,0.5384600162506104,87.2081327812286,3,-78,-75,1025,94,1372,351,42,7.7
-1,-2,0,-1.0,-2.0,0.546485185623169,85.10372283760829,3,-77,-73,1025,94,1372,351,42,3.74
-1,-2,0,-1.0,-2.0,0.5547270774841309,83.00480758118829,3,-76,-71,1025,94,1372,351,42,3.67
-1,-2,0,-1.0,-2.0,0.5625450611114502,80.91172650877817,3,-75,-69,1025,94,1372,351,42,3.6
-1,-1,0,-1.0,-1.0,0.5705740451812744,79.4987562112089,3,-74,-68,1025,94,1372,351,42,5.86
-1,-3,0,-1.0,-3.0,0.5785841941833496,76.74456506629922,3,-73,-65,1025,94,1372,351,42,3.42
-2,-3,0,-2.0,-3.0,0.5865452289581299,73.26027795418386,3,-71,-62,1025,94,1372,351,42,4.73
-1,-3,0,-1.0,-3.0,0.5945281982421875,70.54780172128658,3,-70,-59,1025,94,1372,351,42,3.19
-2,-2,0,-2.0,-2.0,0.6025121212005615,67.72992730753249,3,-68,-57,1025,94,1372,351,42,5.69
-2,-3,0,-2.0,-3.0,0.6105000972747803,64.27602242131137,3,-66,-54,1025,94,1372,351,42,4.31
-3,-3,0,-3.0,-3.0,0.6185882091522217,60.05553651663777,3,-63,-51,1025,94,1372,351,42,5.97
-2,-3,0,-2.0,-3.0,0.6266641616821289,56.62087348130012,3,-61,-48,1025,94,1372,351,42,4.0
-2,-2,0,-2.0,-2.0,0.6346731185913086,53.81310045707235,3,-59,-46,1025,94,1372,351,42,4.94
-2,-2,0,-2.0,-2.0,0.6426761150360107,51.00694410957877,3,-57,-44,1025,94,1372,351,42,4.82
-1,-2,0,-1.0,-2.0,0.6504621505737305,49.0,3,-56,-42,1025,94,1372,351,42,2.67
-1,-2,0,-1.0,-2.0,0.6584720611572266,47.007352543677214,3,-55,-40,1025,94,1372,351,42,2.58
-1,-1,0,-1.0,-1.0,0.6666610240936279,45.610809933523555,3,-54,-39,1025,94,1372,351,42,3.85
-1,-1,0,-1.0,-1.0,0.6746270656585693,44.215028942721474,3,-53,-38,1025,94,1372,351,42,3.8
-1,-1,0,-1.0,-1.0,0.6824600696563721,42.8200595424354,3,-52,-37,1025,94,1372,351,42,3.76
-2,-2,0,-2.0,-2.0,0.6905732154846191,40.032778078668514,3,-50,-35,1025,94,1372,351,42,4.13
-1,-1,0,-1.0,-1.0,0.6987872123718262,38.64059020499378,3,-49,-34,1025,94,1372,351,42,3.61
-3,-1,0,-3.0,-1.0,0.7065660953521729,35.61271941887264,3,-46,-33,1025,94,1372,351,42,3.34
-4,-1,0,-4.0,-1.0,0.7145321369171143,31.80151512977634,3,-42,-32,1025,94,1372,351,42,3.01
-3,-1,0,-3.0,-1.0,0.7225930690765381,28.8196748283246,3,-39,-31,1025,94,1372,351,42,2.92
-3,-1,0,-3.0,-1.0,0.7305421829223633,25.861498055439924,3,-36,-30,1025,94,1372,351,42,2.73
-4,-1,0,-4.0,-1.0,0.7385201454162598,22.185645763378368,3,-32,-29,1025,94,1372,351,42,2.35
-4,-1,0,-4.0,-1.0,0.7469692230224609,18.59797974644666,3,-28,-28,1025,94,1372,351,42,2.05
-3,-1,0,-3.0,-1.0,0.754594087600708,15.796738985948195,3,-25,-27,1025,94,1372,351,42,1.95
-3,-1,0,-3.0,-1.0,0.7626352310180664,13.058772731852805,3,-22,-26,1025,94,1372,351,42,1.72
-3,0,0,-3.0,-0.0,0.7705821990966797,11.202484376209235,3,-19,-26,1025,94,1372,351,42,0.7
-2,-1,0,-2.0,-1.0,0.778569221496582,9.23243291566195,3,-17,-25,1025,94,1372,351,42,1.65
-3,-1,0,-3.0,-1.0,0.7865481376647949,6.784887978899608,3,-14,-24,1025,94,1372,351,42,1.04
-2,0,0,-2.0,-0.0,0.7945561408996582,5.832815729997478,3,-12,-24,1025,94,1372,351,42,0.3
-1,-1,0,-1.0,-1.0,0.8025450706481934,4.495097567963924,3,-11,-23,1025,94,1372,351,42,2.12
-1,0,0,-1.0,-0.0,0.8106541633605957,4.079872407968907,3,-10,-23,1025,94,1372,351,42,0.33
-1,0,0,-1.0,-0.0,0.8188951015472412,3.6981780704569367,3,-9,-23,1025,94,1372,351,42,0.27
0,-1,0,-0.0,-1.0,0.8504970073699951,2.7697286480094263,3,-9,-22,1025,94,1372,351,42,1.92
0,0,1,-0.0,-0.0,0.8656721115112305,2.7697286480094263,3,-9,-22,1025,94,1372,351,42,27.74
-1,0,1,-1.0,-0.0,0.04952263832092285,397.9088629424901,4,-382,167,651,283,1034,116,39,4.52
-1,0,1,-1.0,-0.0,0.07347273826599121,396.99278839902985,4,-381,167,651,283,1034,116,39,4.51
0,0,0,-0.0,-0.0,0.07604265213012695,396.99278839902985,4,-381,167,651,283,1034,116,39,116.61
-1,0,0,-1.0,-0.0,0.08147263526916504,396.07710127155894,4,-380,167,651,283,1034,116,39,4.51
-1,0,0,-1.0,-0.0,0.08938980102539062,395.16180412973864,4,-379,167,651,283,1034,116,39,4.5
-1,0,0,-1.0,-0.0,0.09737777709960938,394.2468995648969,4,-378,167,651,283,1034,116,39,4.49
-1,0,0,-1.0,-0.0,0.10537958145141602,393.33239019024444,4,-377,167,651,283,1034,116,39,4.48
0,1,0,-0.0,1.0,0.11344075202941895,392.92839183528,4,-377,166,651,283,1034,116,39,1.67
-2,1,0,-2.0,1.0,0.12156081199645996,390.69500851242987,4,-375,165,651,283,1034,116,39,10.55
-3,0,0,-3.0,-0.0,0.12949466705322266,387.9508569839852,4,-372,165,651,283,1034,116,39,9.03
-2,0,0,-2.0,-0.0,0.1373286247253418,386.123437979093,4,-370,165,651,283,1034,116,39,6.77
-3,2,0,-3.0,2.0,0.14554858207702637,382.56942114658085,4,-367,163,651,283,1034,116,39,12.07
-4,1,0,-4.0,1.0,0.15342164039611816,378.5084904753608,4,-363,162,651,283,1034,116,39,13.1
-6,3,0,-6.0,3.0,0.16133880615234375,371.8068576675696,4,-357,159,651,283,1034,116,39,20.07
-8,4,0,-8.0,4.0,0.16941475868225098,362.87170620510756,4,-349,155,651,283,1034,116,39,23.84
-14,8,0,-14.0,8.0,0.17729759216308594,346.83329536825926,4,-335,147,651,283,1034,116,39,32.57
-19,9,0,-19.0,9.0,0.18529558181762695,325.81879299133334,4,-316,138,651,283,1034,116,39,38.28
-24,9,0,-24.0,9.0,0.19332480430603027,300.22562553780045,4,-292,129,651,283,1034,116,39,39.71
-27,11,0,-27.0,11.0,0.2014167308807373,271.0844704564517,4,-265,118,651,283,1034,116,39,40.38
-25,11,0,-25.0,11.0,0.2094566822052002,243.77176408434752,4,-240,107,651,283,1034,116,39,38.0
-17,11,0,-17.0,11.0,0.2173306941986084,223.78591392418136,4,-223,96,651,283,1034,116,39,27.23
-14,9,0,-14.0,9.0,0.22538065910339355,207.38462845343543,4,-209,87,651,283,1034,116,39,22.92
-11,6,0,-11.0,6.0,0.23343181610107422,194.92755783208483,4,-198,81,651,283,1034,116,39,19.18
-8,5,0,-8.0,5.0,0.24141168594360352,185.63626267111115,4,-190,76,651,283,1034,116,39,14.93
-7,3,0,-7.0,3.0,0.24940872192382812,178.02284131541703,4,-183,73,651,283,1034,116,39,15.14
-6,3,0,-6.0,3.0,0.2573416233062744,171.33917095542893,4,-177,70,651,283,1034,116,39,12.48
-5,1,0,-5.0,1.0,0.2655196189880371,166.32404053441098,4,-172,69,651,283,1034,116,39,9.49
-4,1,0,-4.0,1.0,0.2734086513519287,162.24017214734707,4,-168,68,651,283,1034,116,39,8.68
-3,0,0,-3.0,-0.0,0.2813897132873535,159.4628812946827,4,-165,68,651,283,1034,116,39,5.68
-2,0,0,-2.0,-0.0,0.28929662704467773,157.61540136692497,4,-163,68,651,283,1034,116,39,4.49
0,1,0,-0.0,1.0,0.2974886894226074,157.23280057923384,4,-163,67,651,283,1034,116,39,1.03
-2,1,0,-2.0,1.0,0.31353759765625,155.0028735394907,4,-161,66,651,283,1034,116,39,7.12
-2,2,0,-2.0,2.0,0.3213317394256592,152.39719951037708,4,-159,64,651,283,1034,116,39,5.3
-2,2,0,-2.0,2.0,0.32938671112060547,149.7986966774329,4,-157,62,651,283,1034,116,39,5.23
-3,2,0,-3.0,2.0,0.33736371994018555,146.27552752903256,4,-154,60,651,283,1034,116,39,7.07
-3,2,0,-3.0,2.0,0.3454008102416992,142.75598906995685,4,-151,58,651,283,1034,116,39,6.95
-3,2,0,-3.0,2.0,0.3533515930175781,139.24032355881985,4,-148,56,651,283,1034,116,39,6.84
-4,2,0,-4.0,2.0,0.36168980598449707,134.79206741571556,4,-144,54,651,283,1034,116,39,8.68
-3,2,0,-3.0,2.0,0.3695685863494873,131.28306624500314,4,-141,52,651,283,1034,116,39,6.59
-3,2,0,-3.0,2.0,0.37749266624450684,127.77874505527018,4,-138,50,651,283,1034,116,39,6.47
-3,1,0,-3.0,1.0,0.38562679290771484,124.6175476743702,4,-135,49,651,283,1034,116,39,8.7
-1,1,0,-1.0,1.0,0.39346766471862793,123.33762678926468,4,-134,48,651,283,1034,116,39,3.3
-2,0,0,-2.0,-0.0,0.40138673782348633,121.45639892863551,4,-132,48,651,283,1034,116,39,4.23
-2,0,0,-2.0,-0.0,0.4094197750091553,119.57849761056005,4,-130,48,651,283,1034,116,39,4.18
-3,1,0,-3.0,1.0,0.41756176948547363,116.41787178950938,4,-127,47,651,283,1034,116,39,8.31
-2,0,0,-2.0,-0.0,0.42538976669311523,114.5440002396214,4,-125,47,651,283,1034,116,39,4.08
-4,1,0,-4.0,1.0,0.43398380279541016,110.4488315899375,4,-121,46,651,283,1034,116,39,7.48
-4,2,0,-4.0,2.0,0.4420735836029053,106.0,4,-117,44,651,283,1034,116,39,7.81
-5,1,0,-5.0,1.0,0.44956469535827637,100.97082978791136,4,-112,43,651,283,1034,116,39,7.45
-7,3,0,-7.0,3.0,0.45757460594177246,93.36102527122117,4,-105,40,651,283,1034,116,39,10.68
-6,2,0,-6.0,2.0,0.4654667377471924,87.04244433244644,4,-99,38,651,283,1034,116,39,9.45
-8,3,0,-8.0,3.0,0.47336769104003906,78.49871794028884,4,-91,35,651,283,1034,116,39,11.88
-9,2,0,-9.0,2.0,0.481433629989624,69.3911760301898,4,-82,33,651,283,1034,116,39,8.37
-9,4,0,-9.0,4.0,0.48938775062561035,59.54934754662193,4,-73,29,651,283,1034,116,39,9.87
-9,3,0,-9.0,3.0,0.4974987506866455,50.07966415668217,4,-64,26,651,283,1034,116,39,8.5
-8,4,0,-8.0,4.0,0.5057697296142578,41.166435825965294,4,-56,22,651,283,1034,116,39,7.28
-9,2,0,-9.0,2.0,0.513678789138794,32.07837115648854,4,-47,20,651,283,1034,116,39,5.72
-6,2,0,-6.0,2.0,0.5214126110076904,25.77722635447622,4,-41,18,651,283,1034,116,39,5.55
-7,2,0,-7.0,2.0,0.5294246673583984,18.57658845611187,4,-34,16,651,283,1034,116,39,4.54
-5,2,0,-5.0,2.0,0.5376336574554443,13.202484376209235,4,-29,14,651,283,1034,116,39,5.03
-5,2,0,-5.0,2.0,0.5462946891784668,7.832815729997478,4,-24,12,651,283,1034,116,39,4.48
-3,1,0,-3.0,1.0,0.5536966323852539,4.7065391822593945,4,-21,11,651,283,1034,116,39,3.19
-2,0,0,-2.0,-0.0,0.5615286827087402,2.9544984001001495,4,-19,11,651,283,1034,116,39,1.4
-1,1,0,-1.0,1.0,0.5700945854187012,1.5912602819740016,4,-18,10,651,283,1034,116,39,2.3
-2,0,0,-2.0,-0.0,0.5775237083435059,-0.13203773588679368,4,-16,10,651,283,1034,116,39,1.18
-1,0,0,-1.0,-0.0,0.5853936672210693,-0.9722436226800539,4,-15,10,651,283,1034,116,39,1.22
-1,0,0,-1.0,-0.0,0.5934827327728271,-1.7953494659147466,4,-14,10,651,283,1034,116,39,1.11
-1,0,0,-1.0,-0.0,0.601388692855835,-2.598780533143273,4,-13,10,651,283,1034,116,39,1.01
-1,1,0,-1.0,1.0,0.6095366477966309,-4.0,4,-12,9,651,283,1034,116,39,3.01
-1,0,0,-1.0,-0.0,0.6181995868682861,-4.787329596448105,4,-11,9,651,283,1034,116,39,0.86
-2,0,0,-2.0,-0.0,0.6258447170257568,-6.272077938642145,4,-9,9,651,283,1034,116,39,0.35
-1,0,0,-1.0,-0.0,0.6336996555328369,-6.958405421207704,4,-8,9,651,283,1034,116,39,0.47
-1,1,0,-1.0,1.0,0.641629695892334,-8.36985418726535,4,-7,8,651,283,1034,116,39,3.78
-1,0,0,-1.0,-0.0,0.6494846343994141,-9.0,4,-6,8,651,283,1034,116,39,0.23
-1,0,0,-1.0,-0.0,0.6575307846069336,-9.566018867943397,4,-5,8,651,283,1034,116,39,0.07
-2,0,0,-2.0,-0.0,0.6653625965118408,-10.45599625468247,4,-3,8,651,283,1034,116,39,-0.63
-1,0,0,-1.0,-0.0,0.6734857559204102,-10.753788748764679,4,-2,8,651,283,1034,116,39,-0.38
-1,1,0,-1.0,1.0,0.6815736293792725,-11.928932188134524,4,-1,7,651,283,1034,116,39,0.34
-1,0,0,-1.0,-0.0,0.6893715858459473,-12.0,4,0,7,651,283,1034,116,39,-0.7
-1,0,0,-1.0,-0.0,0.6977376937866211,-11.928932188134524,4,1,7,651,283,1034,116,39,1.05
0,1,0,-0.0,1.0,0.7135965824127197,-12.917237469701782,4,1,6,651,283,1034,116,39,2.32
0,0,1,-0.0,-0.0,0.7204787731170654,-12.917237469701782,4,1,6,651,283,1034,116,39,23.32
0,0,0,-0.0,-0.0,0.0696403980255127,1448.5669458639572,5,1239,762,1889,1039,650,277,13,252.04
0,2,0,-0.0,2.0,0.12356448173522949,1447.5202096978219,5,1239,760,1889,1039,650,277,13,19.01
0,1,0,-0.0,1.0,0.13167238235473633,1446.9975911886434,5,1239,759,1889,1039,650,277,13,10.22
0,2,0,-0.0,2.0,0.13983654975891113,1445.9538560160925,5,1239,757,1889,1039,650,277,13,18.95
0,3,0,-0.0,3.0,0.14773249626159668,1444.3920159736126,5,1239,754,1889,1039,650,277,13,27.0
1,2,0,1.0,2.0,0.15599751472473145,1442.4985329643935,5,1238,752,1889,1039,650,277,13,32.7
0,3,0,-0.0,3.0,0.1638164520263672,1440.9433299200077,5,1238,749,1889,1039,650,277,13,26.86
0,4,0,-0.0,4.0,0.17161035537719727,1438.8768113579788,5,1238,745,1889,1039,650,277,13,34.25
-2,5,0,-2.0,5.0,0.17965054512023926,1438.0221604947758,5,1240,740,1889,1039,650,277,13,15.33
-1,3,0,-1.0,3.0,0.1875443458557129,1437.346805171924,5,1241,737,1889,1039,650,277,13,12.39
-1,5,0,-1.0,5.0,0.19555449485778809,1435.6615414167086,5,1242,732,1889,1039,650,277,13,28.47
0,5,0,-0.0,5.0,0.20351243019104004,1433.1292506234456,5,1242,727,1889,1039,650,277,13,40.46
3,7,0,3.0,7.0,0.21175551414489746,1427.0111653438014,5,1239,720,1889,1039,650,277,13,79.24
5,9,0,5.0,9.0,0.22018742561340332,1418.1759020570457,5,1234,711,1889,1039,650,277,13,99.72
8,10,0,8.0,10.0,0.22780537605285645,1406.2595370540078,5,1226,701,1889,1039,650,277,13,117.52
12,13,0,12.0,13.0,0.23581337928771973,1389.399584348512,5,1214,688,1889,1039,650,277,13,137.71
16,15,0,16.0,15.0,0.24353551864624023,1368.0935193792307,5,1198,673,1889,1039,650,277,13,150.29
19,15,0,19.0,15.0,0.25153541564941406,1344.1870240822195,5,1179,658,1889,1039,650,277,13,155.68
19,13,0,19.0,13.0,0.25952839851379395,1321.2622197591552,5,1160,645,1889,1039,650,277,13,152.69
21,13,0,21.0,13.0,0.2676854133605957,1296.591647447503,5,1139,632,1889,1039,650,277,13,155.77
24,14,0,24.0,14.0,0.27560949325561523,1268.8133196668443,5,1115,618,1889,1039,650,277,13,160.7
25,13,0,25.0,13.0,0.28438544273376465,1240.645498929026,5,1090,605,1889,1039,650,277,13,159.24
28,15,0,28.0,15.0,0.2916874885559082,1208.884356636466,5,1062,590,1889,1039,650,277,13,163.09
29,14,0,29.0,14.0,0.2996864318847656,1176.7362343312222,5,1033,576,1889,1039,650,277,13,159.93
31,16,0,31.0,16.0,0.3076744079589844,1141.869330542462,5,1002,560,1889,1039,650,277,13,161.4
32,16,0,32.0,16.0,0.3155524730682373,1106.1312872138792,5,970,544,1889,1039,650,277,13,159.2
34,18,0,34.0,18.0,0.3235664367675781,1067.6722032352332,5,936,526,1889,1039,650,277,13,159.62
34,17,0,34.0,17.0,0.33166050910949707,1029.7050738506596,5,902,509,1889,1039,650,277,13,155.18
34,18,0,34.0,18.0,0.3395223617553711,991.2487152160187,5,868,491,1889,1039,650,277,13,152.94
33,17,0,33.0,17.0,0.3476555347442627,954.1567580348534,5,835,474,1889,1039,650,277,13,147.92
30,15,0,30.0,15.0,0.3555715084075928,920.663908868798,5,805,459,1889,1039,650,277,13,140.78
29,15,0,29.0,15.0,0.36361241340637207,888.0425045824164,5,776,444,1889,1039,650,277,13,137.16
26,14,0,26.0,14.0,0.37180638313293457,858.5229898620395,5,750,430,1889,1039,650,277,13,131.2
25,12,0,25.0,12.0,0.37967348098754883,830.8685679364472,5,725,418,1889,1039,650,277,13,125.07
24,12,0,24.0,12.0,0.38768434524536133,804.0845634870474,5,701,406,1889,1039,650,277,13,121.7
24,13,0,24.0,13.0,0.3956763744354248,776.8013796615332,5,677,393,1889,1039,650,277,13,120.71
21,11,0,21.0,11.0,0.4035375118255615,753.117909155093,5,656,382,1889,1039,650,277,13,112.78
20,12,0,20.0,12.0,0.41164636611938477,729.7961674268221,5,636,370,1889,1039,650,277,13,111.2
17,8,0,17.0,8.0,0.4197084903717041,711.0808880454143,5,619,362,1889,1039,650,277,13,99.22
15,9,0,15.0,9.0,0.4276294708251953,693.5891651533777,5,604,353,1889,1039,650,277,13,97.13
14,8,0,14.0,8.0,0.43567848205566406,677.4654343856754,5,590,345,1889,1039,650,277,13,92.73
17,7,0,17.0,7.0,0.4437384605407715,659.2616026797278,5,573,338,1889,1039,650,277,13,93.11
17,7,0,17.0,7.0,0.4516153335571289,641.0680026086902,5,556,331,1889,1039,650,277,13,91.45
17,7,0,17.0,7.0,0.4596593379974365,622.8855221739486,5,539,324,1889,1039,650,277,13,89.77
20,7,0,20.0,7.0,0.46756649017333984,602.1529412902646,5,519,317,1889,1039,650,277,13,91.97
18,7,0,18.0,7.0,0.47567033767700195,583.152781543124,5,501,310,1889,1039,650,277,13,87.37
18,7,0,18.0,7.0,0.4835543632507324,564.173657757003,5,483,303,1889,1039,650,277,13,85.47
20,7,0,20.0,7.0,0.49163055419921875,543.5316187445451,5,463,296,1889,1039,650,277,13,85.88
19,8,0,19.0,8.0,0.49956750869750977,523.2258497087987,5,444,288,1889,1039,650,277,13,83.65
20,7,0,20.0,7.0,0.5078074932098389,502.6619702710239,5,424,281,1889,1039,650,277,13,81.43
20,8,0,20.0,8.0,0.5159125328063965,481.5910171444917,5,404,273,1889,1039,650,277,13,80.09
20,7,0,20.0,7.0,0.5238933563232422,461.1316730858656,5,384,266,1889,1039,650,277,13,76.68
21,6,0,21.0,6.0,0.5315535068511963,440.5075587266133,5,363,260,1889,1039,650,277,13,74.25
20,6,0,20.0,6.0,0.5396003723144531,420.8079193267154,5,343,254,1889,1039,650,277,13,70.75
19,5,0,19.0,5.0,0.5476474761962891,402.6281928599641,5,324,249,1889,1039,650,277,13,66.35
18,4,0,18.0,4.0,0.5556545257568359,385.9961734507111,5,306,245,1889,1039,650,277,13,61.95
18,4,0,18.0,4.0,0.5640664100646973,369.53295461250804,5,288,241,1889,1039,650,277,13,59.79
15,5,0,15.0,5.0,0.5716514587402344,354.86701151532264,5,273,236,1889,1039,650,277,13,55.56
15,4,0,15.0,4.0,0.5798013210296631,340.9697393145402,5,258,232,1889,1039,650,277,13,52.46
13,4,0,13.0,4.0,0.5876023769378662,328.6774566653691,5,245,228,1889,1039,650,277,13,48.29
12,4,0,12.0,4.0,0.59578537940979,317.21045775160184,5,233,224,1889,1039,650,277,13,45.53
11,3,0,11.0,3.0,0.6036515235900879,307.2491021535417,5,222,221,1889,1039,650,277,13,41.15
11,5,0,11.0,5.0,0.6116013526916504,295.95529470436514,5,211,216,1889,1039,650,277,13,43.3
10,4,0,10.0,4.0,0.6195905208587646,286.138665705175,5,201,212,1889,1039,650,277,13,39.1
8,4,0,8.0,4.0,0.6280455589294434,277.74812774712717,5,193,208,1889,1039,650,277,13,35.36
8,4,0,8.0,4.0,0.6357784271240234,269.3924472457442,5,185,204,1889,1039,650,277,13,34.49
8,6,0,8.0,6.0,0.6437735557556152,259.58049627184596,5,177,198,1889,1039,650,277,13,37.59
6,5,0,6.0,5.0,0.6514463424682617,251.8565492672234,5,171,193,1889,1039,650,277,13,32.69
5,5,0,5.0,5.0,0.6595413684844971,244.79872407968904,5,166,188,1889,1039,650,277,13,31.59
5,5,0,5.0,5.0,0.667588472366333,237.74166652421167,5,161,183,1889,1039,650,277,13,30.97
5,6,0,5.0,6.0,0.675633430480957,229.93431289238112,5,156,177,1889,1039,650,277,13,32.93
4,6,0,4.0,6.0,0.683692455291748,222.79029699705362,5,152,171,1889,1039,650,277,13,28.93
4,7,0,4.0,7.0,0.6915943622589111,214.90722034374522,5,148,164,1889,1039,650,277,13,29.24
5,7,0,5.0,7.0,0.6996333599090576,206.3628969476542,5,143,157,1889,1039,650,277,13,30.52
6,8,0,6.0,8.0,0.7076995372772217,196.41047403728888,5,137,149,1889,1039,650,277,13,32.14
6,9,0,6.0,9.0,0.7157175540924072,185.73158320944412,5,131,140,1889,1039,650,277,13,31.38
6,9,0,6.0,9.0,0.723684549331665,175.06904760339356,5,125,131,1889,1039,650,277,13,30.02
6,9,0,6.0,9.0,0.7317085266113281,164.42593699317015,5,119,122,1889,1039,650,277,13,28.64
6,8,0,6.0,8.0,0.7396354675292969,154.51479682571323,5,113,114,1889,1039,650,277,13,26.9
5,8,0,5.0,8.0,0.747577428817749,145.32745950421557,5,108,106,1889,1039,650,277,13,24.13
5,8,0,5.0,8.0,0.7555794715881348,136.1724305201258,5,103,98,1889,1039,650,277,13,22.94
7,8,0,7.0,8.0,0.763688325881958,125.59027319676784,5,96,90,1889,1039,650,277,13,24.58
7,8,0,7.0,8.0,0.7716524600982666,115.01652779682617,5,89,82,1889,1039,650,277,13,23.1
7,9,0,7.0,9.0,0.7796053886413574,103.78615577567146,5,82,73,1889,1039,650,277,13,21.48
6,9,0,6.0,9.0,0.7878954410552979,93.35793878699377,5,76,64,1889,1039,650,277,13,18.75
7,8,0,7.0,8.0,0.7957453727722168,82.86506625215557,5,69,56,1889,1039,650,277,13,18.08
4,7,0,4.0,7.0,0.8035564422607422,75.40024569987489,5,65,49,1889,1039,650,277,13,13.29
4,6,0,4.0,6.0,0.8117344379425049,68.63243262818116,5,61,43,1889,1039,650,277,13,12.01
3,6,0,3.0,6.0,0.819751501083374,62.796802251267465,5,58,37,1889,1039,650,277,13,9.92
3,5,0,3.0,5.0,0.82755446434021,57.631753079732135,5,55,32,1889,1039,650,277,13,8.86
2,4,0,2.0,4.0,0.8355245590209961,53.941638282582836,5,53,28,1889,1039,650,277,13,6.68
3,4,0,3.0,4.0,0.8436975479125977,49.46169849544819,5,50,24,1889,1039,650,277,13,7.52
3,4,0,3.0,4.0,0.8515985012054443,45.07837115648854,5,47,20,1889,1039,650,277,13,6.91
3,4,0,3.0,4.0,0.8596863746643066,40.8187996428785,5,44,16,1889,1039,650,277,13,6.28
3,3,0,3.0,3.0,0.8676774501800537,37.01162633521314,5,41,13,1889,1039,650,277,13,5.86
2,3,0,2.0,3.0,0.8756535053253174,34.26164427839479,5,39,10,1889,1039,650,277,13,4.08
1,1,0,1.0,1.0,0.8837225437164307,33.05124837953327,5,38,9,1889,1039,650,277,13,2.97
2,3,0,2.0,3.0,0.8916075229644775,30.496575181789318,5,36,6,1889,1039,650,277,13,3.47
3,2,0,3.0,2.0,0.8996925354003906,27.241540277189323,5,33,4,1889,1039,650,277,13,4.68
3,4,0,3.0,4.0,0.9076783657073975,24.0,5,30,0,1889,1039,650,277,13,3.27
4,3,0,4.0,3.0,0.9157583713531494,20.1725046566048,5,26,-3,1889,1039,650,277,13,3.66
4,4,0,4.0,4.0,0.9235165119171143,17.08679276123039,5,22,-7,1889,1039,650,277,13,2.24
3,2,0,3.0,2.0,0.9317295551300049,15.02379604162864,5,19,-9,1889,1039,650,277,13,1.65
3,2,0,3.0,2.0,0.939873456954956,13.4164878389476,5,16,-11,1889,1039,650,277,13,0.97
2,1,0,2.0,1.0,0.9477674961090088,12.439088914585774,5,14,-12,1889,1039,650,277,13,0.68
1,1,0,1.0,1.0,0.9558165073394775,12.384776310850235,5,13,-13,1889,1039,650,277,13,-0.33
1,1,0,1.0,1.0,0.9636354446411133,12.439088914585774,5,12,-14,1889,1039,650,277,13,7.76
1,0,0,1.0,-0.0,1.0678224563598633,11.804493814764857,5,11,-14,1889,1039,650,277,13,1.06
0,-1,0,-0.0,-1.0,1.0837173461914062,11.029386365926403,5,11,-13,1889,1039,650,277,13,1.5
1,-1,0,1.0,-1.0,1.0923774242401123,9.620499351813308,5,10,-12,1889,1039,650,277,13,4.59
0,-2,0,-0.0,-2.0,1.0995564460754395,8.142135623730951,5,10,-10,1889,1039,650,277,13,1.4
0,-1,0,-0.0,-1.0,1.1085364818572998,7.45362404707371,5,10,-9,1889,1039,650,277,13,1.02
1,-1,0,1.0,-1.0,1.1157305240631104,6.041594578792296,5,9,-8,1889,1039,650,277,13,4.91
0,-1,0,-0.0,-1.0,1.1246323585510254,5.401754250991379,5,9,-7,1889,1039,650,277,13,0.76
1,-2,0,1.0,-2.0,1.131636381149292,3.433981132056603,5,8,-5,1889,1039,650,277,13,1.71
0,-1,0,-0.0,-1.0,1.1395514011383057,2.944271909999159,5,8,-4,1889,1039,650,277,13,0.22
0,-1,0,-0.0,-1.0,1.1475393772125244,2.5440037453175304,5,8,-3,1889,1039,650,277,13,0.01
0,-1,0,-0.0,-1.0,1.163682460784912,2.246211251235321,5,8,-2,1889,1039,650,277,13,-0.19
0,-2,0,-0.0,-2.0,1.1799414157867432,2.0,5,8,0,1889,1039,650,277,13,-0.92
0,-1,0,-0.0,-1.0,1.1877243518829346,2.062257748298549,5,8,1,1889,1039,650,277,13,5.32
0,-2,0,-0.0,-2.0,1.195697546005249,2.5440037453175304,5,8,3,1889,1039,650,277,13,0.39
0,-1,0,-0.0,-1.0,1.2035465240478516,2.944271909999159,5,8,4,1889,1039,650,277,13,1.41
0,-2,0,-0.0,-2.0,1.2117395401000977,4.0,5,8,6,1889,1039,650,277,13,0.03
0,-1,0,-0.0,-1.0,1.2276215553283691,4.63014581273465,5,8,7,1889,1039,650,277,13,1.31
0,0,1,-0.0,-0.0,1.2536604404449463,4.63014581273465,5,8,7,1889,1039,650,277,13,28.29
0,0,0,-0.0,-0.0,0.08537912368774414,848.1513994792077,6,-383,-798,1498,234,1881,1032,75,186.98
-1,0,0,-1.0,-0.0,0.12282323837280273,847.7191644810233,6,-382,-798,1498,234,1881,1032,75,1.63
-3,1,0,-3.0,1.0,0.13051414489746094,847.3313858503496,6,-379,-799,1498,234,1881,1032,75,1.15
-4,0,0,-4.0,-0.0,0.13851332664489746,845.6244954679198,6,-375,-799,1498,234,1881,1032,75,4.56
-6,0,0,-6.0,-0.0,0.14660429954528809,843.0920406412048,6,-369,-799,1498,234,1881,1032,75,6.4
-7,0,0,-7.0,-0.0,0.15452909469604492,840.1801411340774,6,-362,-799,1498,234,1881,1032,75,7.21
-11,-1,0,-11.0,-1.0,0.162506103515625,834.7826564000915,6,-351,-798,1498,234,1881,1032,75,12.55
-15,-3,0,-15.0,-3.0,0.17064714431762695,826.0880603970837,6,-336,-795,1498,234,1881,1032,75,19.07
-17,-4,0,-17.0,-4.0,0.17849016189575195,815.9021045817626,6,-319,-791,1498,234,1881,1032,75,21.7
-19,-9,0,-19.0,-9.0,0.18657231330871582,800.5702955573341,6,-300,-782,1498,234,1881,1032,75,30.45
-22,-12,0,-22.0,-12.0,0.1944413185119629,781.6476653603796,6,-278,-770,1498,234,1881,1032,75,35.48
-27,-21,0,-27.0,-21.0,0.20253419876098633,752.9379722484545,6,-251,-749,1498,234,1881,1032,75,47.51
-29,-26,0,-29.0,-26.0,0.21047711372375488,719.3154103943672,6,-222,-723,1498,234,1881,1032,75,51.57
-29,-27,0,-29.0,-27.0,0.21839523315429688,685.2638022218752,6,-193,-696,1498,234,1881,1032,75,50.44
-20,-24,0,-20.0,-24.0,0.22646117210388184,656.9113776268551,6,-173,-672,1498,234,1881,1032,75,43.67
-11,-18,0,-11.0,-18.0,0.23446226119995117,636.7655378542302,6,-162,-654,1498,234,1881,1032,75,34.03
-5,-14,0,-5.0,-14.0,0.24248814582824707,621.9757203418044,6,-157,-640,1498,234,1881,1032,75,28.1
-2,-14,0,-2.0,-14.0,0.2507362365722656,607.9038688052663,6,-155,-626,1498,234,1881,1032,75,26.78
-1,-14,0,-1.0,-14.0,0.2584712505340576,594.0784420339519,6,-154,-612,1498,234,1881,1032,75,25.39
-1,-18,0,-1.0,-18.0,0.2665541172027588,576.3881316099945,6,-153,-594,1498,234,1881,1032,75,29.71
-1,-22,0,-1.0,-22.0,0.2745981216430664,554.8513326841463,6,-152,-572,1498,234,1881,1032,75,33.3
-2,-23,0,-2.0,-23.0,0.28258824348449707,532.1230095506594,6,-150,-549,1498,234,1881,1032,75,33.94
-2,-26,0,-2.0,-26.0,0.29048824310302734,506.5374872076442,6,-148,-523,1498,234,1881,1032,75,35.57
-4,-27,0,-4.0,-27.0,0.29845714569091797,479.48039653020714,6,-144,-496,1498,234,1881,1032,75,36.2
-3,-25,0,-3.0,-25.0,0.3065371513366699,454.6523161747537,6,-141,-471,1498,234,1881,1032,75,32.75
-4,-23,0,-4.0,-23.0,0.31454014778137207,431.47945525924615,6,-137,-448,1498,234,1881,1032,75,30.65
-2,-20,0,-2.0,-20.0,0.32238221168518066,411.78614060596834,6,-135,-428,1498,234,1881,1032,75,25.99
0,-15,0,-0.0,-15.0,0.33049511909484863,397.50431528351936,6,-135,-413,1498,234,1881,1032,75,19.64
1,-12,0,1.0,-12.0,0.3386862277984619,386.43476475131325,6,-136,-401,1498,234,1881,1032,75,15.61
1,-12,0,1.0,-12.0,0.34673213958740234,375.4196891517184,6,-137,-389,1498,234,1881,1032,75,15.23
3,-11,0,3.0,-11.0,0.3547213077545166,366.0930413688631,6,-140,-378,1498,234,1881,1032,75,12.65
3,-12,0,3.0,-12.0,0.36252713203430176,355.9440163687443,6,-143,-366,1498,234,1881,1032,75,13.28
3,-12,0,3.0,-12.0,0.37043118476867676,345.9255802372048,6,-146,-354,1498,234,1881,1032,75,12.85
3,-11,0,3.0,-11.0,0.3784501552581787,336.9652390263031,6,-149,-343,1498,234,1881,1032,75,11.48
3,-10,0,3.0,-10.0,0.3863861560821533,329.0505429582095,6,-152,-333,1498,234,1881,1032,75,10.15
3,-9,0,3.0,-9.0,0.39440011978149414,322.1670920337775,6,-155,-324,1498,234,1881,1032,75,8.86
2,-10,0,2.0,-10.0,0.4023733139038086,314.062672467467,6,-157,-314,1498,234,1881,1032,75,10.15
2,-11,0,2.0,-11.0,0.4104642868041992,305.1841609426129,6,-159,-303,1498,234,1881,1032,75,10.69
1,-11,0,1.0,-11.0,0.41848325729370117,295.9624603465081,6,-160,-292,1498,234,1881,1032,75,10.96
0,-10,0,-0.0,-10.0,0.4264051914215088,287.2283146179556,6,-160,-282,1498,234,1881,1032,75,10.51
-1,-9,0,-1.0,-9.0,0.434462308883667,278.9272068056184,6,-159,-273,1498,234,1881,1032,75,10.23
-3,-11,0,-3.0,-11.0,0.4424922466278076,267.92622058458664,6,-156,-262,1498,234,1881,1032,75,12.85
-3,-12,0,-3.0,-12.0,0.45041823387145996,256.10237119477557,6,-153,-250,1498,234,1881,1032,75,12.97
-4,-14,0,-4.0,-14.0,0.45841526985168457,242.10034037958462,6,-149,-236,1498,234,1881,1032,75,14.17
-5,-15,0,-5.0,-15.0,0.4664182662963867,226.77452492611945,6,-144,-221,1498,234,1881,1032,75,14.6
-5,-13,0,-5.0,-13.0,0.47440528869628906,213.16994223927063,6,-139,-208,1498,234,1881,1032,75,13.14
-6,-11,0,-6.0,-11.0,0.48246121406555176,200.6930794112441,6,-133,-197,1498,234,1881,1032,75,13.09
-5,-10,0,-5.0,-10.0,0.4905402660369873,189.61200321253946,6,-128,-187,1498,234,1881,1032,75,11.34
-6,-9,0,-6.0,-9.0,0.4985063076019287,178.79620015190258,6,-122,-178,1498,234,1881,1032,75,13.39
-7,-9,0,-7.0,-9.0,0.5063891410827637,167.41624201613726,6,-115,-169,1498,234,1881,1032,75,11.72
-7,-8,0,-7.0,-8.0,0.5142951011657715,156.86851214160592,6,-108,-161,1498,234,1881,1032,75,9.99
-5,-7,0,-5.0,-7.0,0.5224111080169678,148.27007313648906,6,-103,-154,1498,234,1881,1032,75,10.38
-5,-7,0,-5.0,-7.0,0.5304782390594482,139.67201249773547,6,-98,-147,1498,234,1881,1032,75,10.07
-5,-5,0,-5.0,-5.0,0.5389752388000488,132.7439247808298,6,-93,-142,1498,234,1881,1032,75,6.74
-4,-6,0,-4.0,-6.0,0.5467782020568848,125.53307355735325,6,-89,-136,1498,234,1881,1032,75,10.07
-5,-5,0,-5.0,-5.0,0.5544962882995605,118.6181223379848,6,-84,-131,1498,234,1881,1032,75,6.31
-5,-5,0,-5.0,-5.0,0.56233811378479,111.71785366928881,6,-79,-126,1498,234,1881,1032,75,6.06
-5,-6,0,-5.0,-6.0,0.571068286895752,103.98226838861686,6,-74,-120,1498,234,1881,1032,75,6.82
-5,-6,0,-5.0,-6.0,0.5783822536468506,96.25539388707685,6,-69,-114,1498,234,1881,1032,75,6.51
-4,-5,0,-4.0,-5.0,0.5863721370697021,89.90941651429968,6,-65,-109,1498,234,1881,1032,75,5.95
-4,-4,0,-4.0,-4.0,0.594285249710083,84.43310915891102,6,-61,-105,1498,234,1881,1032,75,4.64
-4,-5,0,-4.0,-5.0,0.60256028175354,78.10430052782563,6,-57,-100,1498,234,1881,1032,75,5.45
-4,-4,0,-4.0,-4.0,0.6112291812896729,72.65856099730654,6,-53,-96,1498,234,1881,1032,75,4.24
-3,-5,0,-3.0,-5.0,0.6186323165893555,66.83159442096611,6,-50,-91,1498,234,1881,1032,75,6.77
-4,-5,0,-4.0,-5.0,0.6266722679138184,60.529482721892876,6,-46,-86,1498,234,1881,1032,75,4.75
-5,-4,0,-5.0,-4.0,0.6345162391662598,54.67878707749138,6,-41,-82,1498,234,1881,1032,75,3.27
-3,-6,0,-3.0,-6.0,0.6424922943115234,47.970583144992005,6,-38,-76,1498,234,1881,1032,75,8.68
-4,-4,0,-4.0,-4.0,0.6504433155059814,42.62411694957753,6,-34,-72,1498,234,1881,1032,75,3.17
-4,-5,0,-4.0,-5.0,0.658461332321167,36.40980860893181,6,-30,-67,1498,234,1881,1032,75,3.57
-6,-5,0,-6.0,-5.0,0.6663811206817627,29.483080554378645,6,-24,-62,1498,234,1881,1032,75,2.44
-5,-6,0,-5.0,-6.0,0.6745851039886475,22.135437767890075,6,-19,-56,1498,234,1881,1032,75,2.7
-6,-6,0,-6.0,-6.0,0.6829731464385986,14.662365412357957,6,-13,-50,1498,234,1881,1032,75,1.86
-5,-5,0,-5.0,-5.0,0.6903681755065918,8.705579528105758,6,-8,-45,1498,234,1881,1032,75,1.33
-5,-5,0,-5.0,-5.0,0.698566198348999,3.1123422402631604,6,-3,-40,1498,234,1881,1032,75,0.87
-5,-5,0,-5.0,-5.0,0.7065701484680176,-1.9429037140837906,6,2,-35,1498,234,1881,1032,75,0.38
-4,-5,0,-4.0,-5.0,0.7143921852111816,-6.4058829184432895,6,6,-30,1498,234,1881,1032,75,0.17
-3,-4,0,-3.0,-4.0,0.7226042747497559,-9.486367015604792,6,9,-26,1498,234,1881,1032,75,-0.04
-2,-3,0,-2.0,-3.0,0.7304062843322754,-11.504902432036076,6,11,-23,1498,234,1881,1032,75,-0.06
-1,-1,0,-1.0,-1.0,0.7384631633758545,-11.940071827716665,6,12,-22,1498,234,1881,1032,75,0.01
0,0,1,-0.0,-0.0,0.773585319519043,-11.940071827716665,6,12,-22,1498,234,1881,1032,75,23.58
-1,1,1,-1.0,1.0,0.7786731719970703,-10.580310372754187,6,13,-23,1498,234,1881,1032,75,12.01
-1,2,1,-1.0,2.0,0.005526065826416016,313.6499671676622,7,-335,72,1149,331,1485,257,58,3.06
-1,3,1,-1.0,3.0,0.013411998748779297,312.0527818388233,7,-334,69,1149,331,1485,257,58,3.11
-1,2,1,-1.0,2.0,0.021353960037231445,310.6733725213091,7,-333,67,1149,331,1485,257,58,2.99
-2,2,1,-2.0,2.0,0.029358863830566406,308.3218048095913,7,-331,65,1149,331,1485,257,58,5.01
-1,2,1,-1.0,2.0,0.037355899810791016,306.9598190260258,7,-330,63,1149,331,1485,257,58,2.93
-1,0,1,-1.0,-0.0,0.0536649227142334,305.9776111921512,7,-329,63,1149,331,1485,257,58,4.57
0,0,0,-0.0,-0.0,0.06731700897216797,305.9776111921512,7,-329,63,1149,331,1485,257,58,98.15
0,1,0,-0.0,1.0,0.0691828727722168,305.79097956784915,7,-329,62,1149,331,1485,257,58,0.58
-1,1,0,-1.0,1.0,0.0854640007019043,304.6240399012038,7,-328,61,1149,331,1485,257,58,3.25
-1,0,0,-1.0,-0.0,0.09330606460571289,303.6409475695979,7,-327,61,1149,331,1485,257,58,4.59
-1,1,0,-1.0,1.0,0.11737394332885742,302.4754892899323,7,-326,60,1149,331,1485,257,58,3.23
-4,0,0,-4.0,-0.0,0.12532901763916016,298.54236367224314,7,-322,60,1149,331,1485,257,58,8.69
-5,2,0,-5.0,2.0,0.1331479549407959,293.2623155133098,7,-317,58,1149,331,1485,257,58,10.23
-9,3,0,-9.0,3.0,0.1411428451538086,283.8721783732136,7,-308,55,1149,331,1485,257,58,15.2
-12,4,0,-12.0,4.0,0.14921283721923828,271.36144892445833,7,-296,51,1149,331,1485,257,58,17.85
-18,5,0,-18.0,5.0,0.1573789119720459,252.7800560721074,7,-278,46,1149,331,1485,257,58,22.58
-21,5,0,-21.0,5.0,0.16527700424194336,231.2498799231231,7,-257,41,1149,331,1485,257,58,23.8
-23,5,0,-23.0,5.0,0.17337584495544434,207.7530358833863,7,-234,36,1149,331,1485,257,58,23.65
-24,5,0,-24.0,5.0,0.18119192123413086,183.27576404290716,7,-210,31,1149,331,1485,257,58,22.39
-25,2,0,-25.0,2.0,0.18938684463500977,158.2591786802452,7,-185,29,1149,331,1485,257,58,20.32
-25,1,0,-25.0,1.0,0.19738197326660156,133.43152403397562,7,-160,28,1149,331,1485,257,58,17.39
-25,1,0,-25.0,1.0,0.20535683631896973,108.6735268670052,7,-135,27,1149,331,1485,257,58,14.95
-24,0,0,-24.0,-0.0,0.21335196495056152,85.23659658795863,7,-111,27,1149,331,1485,257,58,11.84
-24,0,0,-24.0,-0.0,0.2212510108947754,62.09335870413386,7,-87,27,1149,331,1485,257,58,9.29
-24,1,0,-24.0,1.0,0.22914886474609375,39.15423684555495,7,-63,26,1149,331,1485,257,58,6.83
-23,1,0,-23.0,1.0,0.23742389678955078,18.16990566028302,7,-40,25,1149,331,1485,257,58,3.95
-23,0,0,-23.0,-0.0,0.24520206451416016,1.2324329156619491,7,-17,25,1149,331,1485,257,58,0.97
-20,0,0,-20.0,-0.0,0.2533550262451172,-3.820643375971656,7,3,25,1149,331,1485,257,58,-1.49
-16,-2,0,-16.0,-2.0,0.26122093200683594,4.015148038438355,7,19,27,1149,331,1485,257,58,-1.82
-8,-3,0,-8.0,-3.0,0.2692098617553711,11.36087214122113,7,27,30,1149,331,1485,257,58,-0.02
0,-1,0,-0.0,-1.0,0.2853069305419922,12.10960958218893,7,27,31,1149,331,1485,257,58,1.25
2,0,0,2.0,-0.0,0.3012239933013916,10.824615503479755,7,25,31,1149,331,1485,257,58,0.77
3,-1,0,3.0,-1.0,0.3092799186706543,9.832975677895199,7,22,32,1149,331,1485,257,58,0.03
3,-1,0,3.0,-1.0,0.31737804412841797,9.078865529319543,7,19,33,1149,331,1485,257,58,-0.11
2,-2,0,2.0,-2.0,0.32537293434143066,9.910152916687437,7,17,35,1149,331,1485,257,58,0.05
2,0,0,2.0,-0.0,0.33329105377197266,9.078865529319543,7,15,35,1149,331,1485,257,58,0.3
1,0,0,1.0,-0.0,0.34136199951171875,8.696153649941529,7,14,35,1149,331,1485,257,58,0.37
2,0,0,2.0,-0.0,0.34927892684936523,8.0,7,12,35,1149,331,1485,257,58,0.18
5,0,0,5.0,-0.0,0.3572728633880615,6.693136595149497,7,7,35,1149,331,1485,257,58,-0.3
6,-1,0,6.0,-1.0,0.3651919364929199,7.013886210738214,7,1,36,1149,331,1485,257,58,-0.27
6,0,0,6.0,-0.0,0.3731729984283447,7.345563690772494,7,-5,36,1149,331,1485,257,58,-0.27
5,-1,0,5.0,-1.0,0.3811659812927246,9.3275357934736,7,-10,37,1149,331,1485,257,58,-0.41
5,0,0,5.0,-0.0,0.38937902450561523,10.924929555354261,7,-15,37,1149,331,1485,257,58,-0.39
3,0,0,3.0,-0.0,0.3973228931427002,12.146081222881968,7,-18,37,1149,331,1485,257,58,0.09
1,-1,0,1.0,-1.0,0.4053490161895752,13.485291572496003,7,-19,38,1149,331,1485,257,58,2.11
1,0,0,1.0,-0.0,0.4131648540496826,13.941821107167776,7,-20,38,1149,331,1485,257,58,0.91
0,0,1,-0.0,-0.0,0.4582328796386719,13.941821107167776,7,-20,38,1149,331,1485,257,58,31.07
0,1,1,-0.0,1.0,0.0011222362518310547,870.5614136700398,8,-886,-116,283,178,1169,293,47,26.14
-1,1,1,-1.0,1.0,0.009120464324951172,869.7003976699013,8,-885,-117,283,178,1169,293,47,4.18
-2,1,1,-2.0,1.0,0.01718735694885254,867.8495944883176,8,-883,-118,283,178,1169,293,47,8.41
0,1,1,-0.0,1.0,0.025200366973876953,867.9826036461094,8,-883,-119,283,178,1169,293,47,25.47
-1,0,1,-1.0,-0.0,0.03317737579345703,866.9915729938122,8,-882,-119,283,178,1169,293,47,7.29
0,1,1,-0.0,1.0,0.07320332527160645,867.1258338010418,8,-882,-120,283,178,1169,293,47,25.25
0,0,0,-0.0,-0.0,0.07704329490661621,867.1258338010418,8,-882,-120,283,178,1169,293,47,189.42
-1,0,0,-1.0,-0.0,0.08139443397521973,866.1349728809457,8,-881,-120,283,178,1169,293,47,7.27
-1,2,0,-1.0,2.0,0.08914732933044434,865.4165689585038,8,-880,-122,283,178,1169,293,47,3.19
0,2,0,-0.0,2.0,0.09704446792602539,865.6934229530451,8,-880,-124,283,178,1169,293,47,13.28
-1,1,0,-1.0,1.0,0.10510635375976562,864.8434546697971,8,-879,-125,283,178,1169,293,47,4.11
-2,2,0,-2.0,2.0,0.11321425437927246,863.1478431954795,8,-877,-127,283,178,1169,293,47,7.19
-2,2,0,-2.0,2.0,0.12110638618469238,861.4580261380412,8,-875,-129,283,178,1169,293,47,7.16
-2,2,0,-2.0,2.0,0.12906932830810547,859.774036772718,8,-873,-131,283,178,1169,293,47,7.13
-2,3,0,-2.0,3.0,0.13716530799865723,858.2474113437156,8,-871,-134,283,178,1169,293,47,6.27
-3,3,0,-3.0,3.0,0.14509940147399902,855.7451280092539,8,-868,-137,283,178,1169,293,47,9.98
-4,1,0,-4.0,1.0,0.15304946899414062,851.9514272232487,8,-864,-138,283,178,1169,293,47,15.5
-3,2,0,-3.0,2.0,0.16122031211853027,849.3078584995093,8,-861,-140,283,178,1169,293,47,10.75
-3,2,0,-3.0,2.0,0.1694793701171875,846.6712022367993,8,-858,-142,283,178,1169,293,47,10.7
-6,4,0,-6.0,4.0,0.17744731903076172,841.4188799418948,8,-852,-146,283,178,1169,293,47,19.12
-7,4,0,-7.0,4.0,0.18524646759033203,835.2103471760289,8,-845,-150,283,178,1169,293,47,22.03
-9,6,0,-9.0,6.0,0.19320225715637207,827.4304792280201,8,-836,-156,283,178,1169,293,47,26.24
-15,7,0,-15.0,7.0,0.201127290725708,814.0244918758351,8,-821,-163,283,178,1169,293,47,40.24
-22,8,0,-22.0,8.0,0.20915842056274414,794.0936298858289,8,-799,-171,283,178,1169,293,47,52.88
-27,8,0,-27.0,8.0,0.21714043617248535,769.480283666414,8,-772,-179,283,178,1169,293,47,59.74
-30,6,0,-30.0,6.0,0.22516727447509766,741.714979583897,8,-742,-185,283,178,1169,293,47,63.19
-32,3,0,-32.0,3.0,0.233384370803833,711.4685153224746,8,-710,-188,283,178,1169,293,47,65.15
-33,0,0,-33.0,-0.0,0.24179530143737793,679.6186732502915,8,-677,-188,283,178,1169,293,47,65.63
-35,-2,0,-35.0,-2.0,0.24928927421569824,645.4010771984139,8,-642,-186,283,178,1169,293,47,66.43
-34,-4,0,-34.0,-4.0,0.25733232498168945,611.6558122321106,8,-608,-182,283,178,1169,293,47,64.1
-32,-5,0,-32.0,-5.0,0.2651493549346924,579.5819446349185,8,-576,-177,283,178,1169,293,47,60.5
-34,-5,0,-34.0,-5.0,0.27310729026794434,545.6369667898844,8,-542,-172,283,178,1169,293,47,59.93
-31,-6,0,-31.0,-6.0,0.28116440773010254,514.2867018640978,8,-511,-166,283,178,1169,293,47,55.58
-30,-8,0,-30.0,-8.0,0.28921937942504883,483.2854925829892,8,-481,-158,283,178,1169,293,47,54.07
-32,-9,0,-32.0,-9.0,0.2971973419189453,450.0771607253937,8,-449,-149,283,178,1169,293,47,53.89
-30,-11,0,-30.0,-11.0,0.30522632598876953,418.1405671665212,8,-419,-138,283,178,1169,293,47,50.74
-30,-12,0,-30.0,-12.0,0.3131873607635498,385.89729761885195,8,-389,-126,283,178,1169,293,47,47.63
-27,-10,0,-27.0,-10.0,0.3212873935699463,357.13155617496426,8,-362,-116,283,178,1169,293,47,43.05
-25,-10,0,-25.0,-10.0,0.3292412757873535,330.27751131369797,8,-337,-106,283,178,1169,293,47,38.76
-22,-7,0,-22.0,-7.0,0.3372073173522949,307.19085390119454,8,-315,-99,283,178,1169,293,47,36.47
-18,-8,0,-18.0,-8.0,0.3452272415161133,287.6283953536766,8,-297,-91,283,178,1169,293,47,28.83
-14,-6,0,-14.0,-6.0,0.3531074523925781,272.4894245146516,8,-283,-85,283,178,1169,293,47,23.78
-14,-7,0,-14.0,-7.0,0.3624134063720703,257.0803456153252,8,-269,-78,283,178,1169,293,47,22.53
-13,-6,0,-13.0,-6.0,0.36951136589050293,242.93232221751458,8,-256,-72,283,178,1169,293,47,20.72
-13,-6,0,-13.0,-6.0,0.37732839584350586,228.80349481291955,8,-243,-66,283,178,1169,293,47,19.84
-12,-6,0,-12.0,-6.0,0.3853144645690918,215.66503723838562,8,-231,-60,283,178,1169,293,47,17.91
-12,-4,0,-12.0,-4.0,0.39327335357666016,203.04645540242387,8,-219,-56,283,178,1169,293,47,18.18
-13,-4,0,-13.0,-4.0,0.40130043029785156,189.46176126540982,8,-206,-52,283,178,1169,293,47,18.63
-14,-2,0,-14.0,-2.0,0.40943145751953125,175.40362899906847,8,-192,-50,283,178,1169,293,47,17.15
-13,-3,0,-13.0,-3.0,0.4173264503479004,162.06755523321746,8,-179,-47,283,178,1169,293,47,17.42
-14,-2,0,-14.0,-2.0,0.4257364273071289,148.0263137648707,8,-165,-45,283,178,1169,293,47,15.28
-11,-2,0,-11.0,-2.0,0.4334073066711426,136.89058759038946,8,-154,-43,283,178,1169,293,47,13.11
-8,-1,0,-8.0,-1.0,0.4413442611694336,128.92103211866353,8,-146,-42,283,178,1169,293,47,9.87
-7,-1,0,-7.0,-1.0,0.44923925399780273,121.92066795319431,8,-139,-41,283,178,1169,293,47,9.0
-5,-2,0,-5.0,-2.0,0.45735740661621094,116.5600229292042,8,-134,-39,283,178,1169,293,47,8.17
-5,-1,0,-5.0,-1.0,0.4652113914489746,111.48048185517482,8,-129,-38,283,178,1169,293,47,7.93
-4,-1,0,-4.0,-1.0,0.4731323719024658,107.36103712382777,8,-125,-37,283,178,1169,293,47,8.01
-4,-1,0,-4.0,-1.0,0.4812302589416504,103.24183141890805,8,-121,-36,283,178,1169,293,47,7.88
-4,-1,0,-4.0,-1.0,0.4892303943634033,99.12288892750614,8,-117,-35,283,178,1169,293,47,7.74
-3,-1,0,-3.0,-1.0,0.4973874092102051,95.96217886370441,8,-114,-34,283,178,1169,293,47,7.41
-3,0,0,-3.0,-0.0,0.5057623386383057,93.09048195265622,8,-111,-34,283,178,1169,293,47,4.4
-2,0,0,-2.0,-0.0,0.5134212970733643,91.17968295629481,8,-109,-34,283,178,1169,293,47,3.73
-1,-1,0,-1.0,-1.0,0.521268367767334,89.92918134831227,8,-108,-33,283,178,1169,293,47,2.61
-1,0,0,-1.0,-0.0,0.5292263031005859,88.97321108193691,8,-107,-33,283,178,1169,293,47,3.1
-3,-1,0,-3.0,-1.0,0.5372252464294434,85.81176406988355,8,-104,-32,283,178,1169,293,47,7.51
-3,0,0,-3.0,-0.0,0.545250415802002,82.94810050208545,8,-101,-32,283,178,1169,293,47,4.16
-3,-1,0,-3.0,-1.0,0.5532503128051758,79.7861858422619,8,-98,-31,283,178,1169,293,47,7.73
-2,-1,0,-2.0,-1.0,0.5611362457275391,77.57832768544127,8,-96,-30,283,178,1169,293,47,4.57
-2,-1,0,-2.0,-1.0,0.5692653656005859,75.37174391053561,8,-94,-29,283,178,1169,293,47,4.51
-3,-1,0,-3.0,-1.0,0.5772483348846436,72.2102935611481,8,-91,-28,283,178,1169,293,47,7.23
-3,-2,0,-3.0,-2.0,0.5851113796234131,68.76055797563569,8,-88,-26,283,178,1169,293,47,4.18
-5,-3,0,-5.0,-3.0,0.5931522846221924,63.1278120005379,8,-83,-23,283,178,1169,293,47,5.13
-6,-3,0,-6.0,-3.0,0.6012663841247559,56.55501241279521,8,-77,-20,283,178,1169,293,47,5.59
-8,-4,0,-8.0,-4.0,0.6092114448547363,47.83078426785913,8,-69,-16,283,178,1169,293,47,5.71
-9,-4,0,-9.0,-4.0,0.6172583103179932,38.18823416311342,8,-60,-12,283,178,1169,293,47,5.48
-8,-4,0,-8.0,-4.0,0.6252193450927734,29.61178575186362,8,-52,-8,283,178,1169,293,47,4.22
-8,-3,0,-8.0,-3.0,0.6330924034118652,21.28317965096906,8,-44,-5,283,178,1169,293,47,4.0
-7,-3,0,-7.0,-3.0,0.6412603855133057,14.05401462729781,8,-37,-2,283,178,1169,293,47,2.88
-8,-3,0,-8.0,-3.0,0.6491363048553467,6.017236257093817,8,-29,1,283,178,1169,293,47,2.29
-4,-2,0,-4.0,-2.0,0.6571252346038818,2.179356624028344,8,-25,3,283,178,1169,293,47,1.18
-3,-1,0,-3.0,-1.0,0.6656863689422607,-0.639320225002102,8,-22,4,283,178,1169,293,47,1.29
-3,-1,0,-3.0,-1.0,0.6732933521270752,-3.3531172956115007,8,-19,5,283,178,1169,293,47,0.94
-2,-1,0,-2.0,-1.0,0.681185245513916,-4.972243622680054,8,-17,6,283,178,1169,293,47,0.46
-1,0,0,-1.0,-0.0,0.6892063617706299,-5.911992509364939,8,-16,6,283,178,1169,293,47,1.83
-2,0,0,-2.0,-0.0,0.6972393989562988,-7.768453788272183,8,-14,6,283,178,1169,293,47,1.37
-2,0,0,-2.0,-0.0,0.7052254676818848,-9.583592135001261,8,-12,6,283,178,1169,293,47,1.07
-1,0,0,-1.0,-0.0,0.7131083011627197,-10.470035913858332,8,-11,6,283,178,1169,293,47,1.19
-1,0,0,-1.0,-0.0,0.7212743759155273,-11.338096210309399,8,-10,6,283,178,1169,293,47,1.04
-1,0,0,-1.0,-0.0,0.7292792797088623,-12.183346173608031,8,-9,6,283,178,1169,293,47,0.88
0,0,1,-0.0,-0.0,0.7470593452453613,-12.183346173608031,8,-9,6,283,178,1169,293,47,23.509999999999998
0,0,0,-0.0,-0.0,0.06970429420471191,572.4497518253659,9,602,-95,894,77,292,172,74,147.39
3,0,0,3.0,-0.0,0.09480524063110352,569.4866033145332,9,599,-95,894,77,292,172,74,8.66
4,1,0,4.0,1.0,0.10260725021362305,565.6947817925753,9,595,-96,894,77,292,172,74,8.77
6,3,0,6.0,3.0,0.11081933975219727,560.2620865248355,9,589,-99,894,77,292,172,74,10.8
6,2,0,6.0,2.0,0.11869239807128906,554.6840373036947,9,583,-101,894,77,292,172,74,11.31
8,3,0,8.0,3.0,0.1267223358154297,547.3295303165843,9,575,-104,894,77,292,172,74,13.84
8,4,0,8.0,4.0,0.13468647003173828,540.1940748136626,9,567,-108,894,77,292,172,74,13.13
7,4,0,7.0,4.0,0.14281129837036133,534.090185522392,9,560,-112,894,77,292,172,74,11.34
10,4,0,10.0,4.0,0.15094637870788574,525.0996352960923,9,550,-116,894,77,292,172,74,15.72
12,6,0,12.0,6.0,0.1587064266204834,514.6593151574621,9,538,-122,894,77,292,172,74,17.28
12,4,0,12.0,4.0,0.1666872501373291,503.8807632001715,9,526,-126,894,77,292,172,74,17.8
15,4,0,15.0,4.0,0.17467927932739258,490.27696706759343,9,511,-130,894,77,292,172,74,21.14
17,2,0,17.0,2.0,0.18287134170532227,474.33159495575865,9,494,-132,894,77,292,172,74,23.81
20,1,0,20.0,1.0,0.19068336486816406,455.3057992752066,9,474,-133,894,77,292,172,74,26.66
23,1,0,23.0,1.0,0.19866228103637695,433.48591902415103,9,451,-134,894,77,292,172,74,28.45
26,0,0,26.0,-0.0,0.2066962718963623,408.6242812055914,9,425,-134,894,77,292,172,74,30.1
28,-3,0,28.0,-3.0,0.21481728553771973,381.0550203023521,9,397,-131,894,77,292,172,74,31.33
26,-3,0,26.0,-3.0,0.22269845008850098,355.4601890638081,9,371,-128,894,77,292,172,74,28.45
28,-5,0,28.0,-5.0,0.23066926002502441,327.3871567440323,9,343,-123,894,77,292,172,74,28.98
25,-4,0,25.0,-4.0,0.23870229721069336,302.53644870617353,9,318,-119,894,77,292,172,74,25.17
24,-5,0,24.0,-5.0,0.24672341346740723,278.3284002433019,9,294,-114,894,77,292,172,74,23.66
23,-4,0,23.0,-4.0,0.25481128692626953,255.47393046218667,9,271,-110,894,77,292,172,74,21.18
22,-5,0,22.0,-5.0,0.2626793384552002,233.23323259732507,9,249,-105,894,77,292,172,74,19.83
22,-5,0,22.0,-5.0,0.27077245712280273,211.05039810490126,9,227,-100,894,77,292,172,74,18.41
20,-6,0,20.0,-6.0,0.27921032905578613,190.343352662883,9,207,-94,894,77,292,172,74,16.92
20,-7,0,20.0,-7.0,0.28681135177612305,169.24742422634034,9,187,-87,894,77,292,172,74,16.28
19,-6,0,19.0,-6.0,0.2947864532470703,149.50737250843463,9,168,-81,894,77,292,172,74,14.0
19,-6,0,19.0,-6.0,0.3028414249420166,129.8112706024386,9,149,-75,894,77,292,172,74,12.63
19,-7,0,19.0,-7.0,0.31070923805236816,109.71059948074645,9,130,-68,894,77,292,172,74,11.8
16,-7,0,16.0,-7.0,0.31876444816589355,92.29423807734048,9,114,-61,894,77,292,172,74,10.52
14,-6,0,14.0,-6.0,0.32682228088378906,77.12712210513327,9,100,-55,894,77,292,172,74,8.71
11,-5,0,11.0,-5.0,0.33484840393066406,65.08329931972223,9,89,-50,894,77,292,172,74,7.45
9,-5,0,9.0,-5.0,0.3429734706878662,54.7877987534291,9,80,-45,894,77,292,172,74,9.27
7,-4,0,7.0,-4.0,0.35161733627319336,46.72574275573791,9,73,-41,894,77,292,172,74,8.23
5,-4,0,5.0,-4.0,0.359020471572876,40.41446893184762,9,68,-37,894,77,292,172,74,4.24
4,-2,0,4.0,-2.0,0.3667442798614502,35.94518489934754,9,64,-35,894,77,292,172,74,5.78
3,-3,0,3.0,-3.0,0.37479639053344727,31.8839603971781,9,61,-32,894,77,292,172,74,2.91
3,-1,0,3.0,-1.0,0.3828604221343994,28.76473218982953,9,58,-31,894,77,292,172,74,3.53
2,-1,0,2.0,-1.0,0.39086127281188965,26.52952069707436,9,56,-30,894,77,292,172,74,5.54
1,0,0,1.0,-0.0,0.39870142936706543,25.64982043070834,9,55,-30,894,77,292,172,74,1.79
1,0,0,1.0,-0.0,0.4147353172302246,24.773780845922005,9,54,-30,894,77,292,172,74,1.76
0,0,1,-0.0,-0.0,0.4718623161315918,24.773780845922005,9,54,-30,894,77,292,172,74,34.35
0,0,0,-0.0,-0.0,0.09048271179199219,1333.6338926881153,10,924,1011,1764,1118,840,107,72,241.15
1,0,0,1.0,-0.0,0.11636877059936523,1332.959458859173,10,923,1011,1764,1118,840,107,72,3.21
2,0,0,2.0,-0.0,0.12438488006591797,1331.6117870214487,10,921,1011,1764,1118,840,107,72,5.33
2,-1,0,2.0,-1.0,0.13239765167236328,1331.0058522186362,10,919,1012,1764,1118,840,107,72,2.35
1,-1,0,1.0,-1.0,0.1403946876525879,1331.074613911033,10,918,1013,1764,1118,840,107,72,39.54
1,0,0,1.0,-0.0,0.14835476875305176,1330.4033079585251,10,917,1013,1764,1118,840,107,72,3.19
1,0,0,1.0,-0.0,0.1802687644958496,1329.7324042432324,10,916,1013,1764,1118,840,107,72,3.19
1,3,0,1.0,3.0,0.19629478454589844,1326.83711425834,10,915,1010,1764,1118,840,107,72,11.03
3,6,0,3.0,6.0,0.20436882972717285,1320.3775285664385,10,912,1004,1764,1118,840,107,72,21.73
4,8,0,4.0,8.0,0.2122948169708252,1311.7685261201198,10,908,996,1764,1118,840,107,72,27.31
7,9,0,7.0,9.0,0.22029376029968262,1300.4018856616449,10,901,987,1764,1118,840,107,72,35.62
7,11,0,7.0,11.0,0.2283017635345459,1287.560349965199,10,894,976,1764,1118,840,107,72,37.88
8,11,0,8.0,11.0,0.23624372482299805,1274.046182392056,10,886,965,1764,1118,840,107,72,39.75
9,10,0,9.0,10.0,0.24428987503051758,1260.5932284259393,10,877,955,1764,1118,840,107,72,41.72
13,12,0,13.0,12.0,0.2524096965789795,1242.9624701295968,10,864,943,1764,1118,840,107,72,48.32
16,12,0,16.0,12.0,0.26032471656799316,1223.3113197299547,10,848,931,1764,1118,840,107,72,50.82
18,16,0,18.0,16.0,0.2683587074279785,1199.3643187335467,10,830,915,1764,1118,840,107,72,58.76
22,19,0,22.0,19.0,0.2763047218322754,1170.515644324598,10,808,896,1764,1118,840,107,72,65.72
22,21,0,22.0,21.0,0.2845118045806885,1140.189185462951,10,786,875,1764,1118,840,107,72,67.6
24,21,0,24.0,21.0,0.2923617362976074,1108.5348400114344,10,762,854,1764,1118,840,107,72,67.87
25,25,0,25.0,25.0,0.30037379264831543,1073.2384775150924,10,737,829,1764,1118,840,107,72,72.45
25,26,0,25.0,26.0,0.30835771560668945,1037.1975587001677,10,712,803,1764,1118,840,107,72,72.46
26,25,0,26.0,25.0,0.3163437843322754,1001.2463545368573,10,686,778,1764,1118,840,107,72,70.12
26,27,0,26.0,27.0,0.3244047164916992,963.8004800959039,10,660,751,1764,1118,840,107,72,71.1
30,28,0,30.0,28.0,0.3323037624359131,922.9728880422011,10,630,723,1764,1118,840,107,72,72.13
31,28,0,31.0,28.0,0.3404088020324707,881.5107628796515,10,599,695,1764,1118,840,107,72,70.65
33,28,0,33.0,28.0,0.3483898639678955,838.7828301927285,10,566,667,1764,1118,840,107,72,69.51
34,27,0,34.0,27.0,0.356428861618042,796.240349898994,10,532,640,1764,1118,840,107,72,66.91
31,26,0,31.0,26.0,0.36440587043762207,756.4626174148532,10,501,614,1764,1118,840,107,72,62.42
29,23,0,29.0,23.0,0.3722717761993408,720.3497868050205,10,472,591,1764,1118,840,107,72,56.83
26,21,0,26.0,21.0,0.3802807331085205,687.7513385134428,10,446,570,1764,1118,840,107,72,51.74
25,19,0,25.0,19.0,0.38846373558044434,657.4277179346093,10,421,551,1764,1118,840,107,72,47.77
22,20,0,22.0,20.0,0.3964517116546631,628.2002710026547,10,399,531,1764,1118,840,107,72,45.81
20,20,0,20.0,20.0,0.40421485900878906,600.2090851284662,10,379,511,1764,1118,840,107,72,43.61
19,19,0,19.0,19.0,0.4124636650085449,573.6425182022658,10,360,492,1764,1118,840,107,72,40.91
16,20,0,16.0,20.0,0.4203648567199707,548.0547919502073,10,344,472,1764,1118,840,107,72,40.32
16,21,0,16.0,21.0,0.4283888339996338,521.6602908581532,10,328,451,1764,1118,840,107,72,40.67
13,19,0,13.0,19.0,0.436356782913208,498.64848265004923,10,315,432,1764,1118,840,107,72,36.01
13,18,0,13.0,18.0,0.44421887397766113,476.44511901275825,10,302,414,1764,1118,840,107,72,35.55
12,16,0,12.0,16.0,0.4523477554321289,456.44695145771794,10,290,398,1764,1118,840,107,72,31.9
12,14,0,12.0,14.0,0.4604496955871582,438.06750574153466,10,278,384,1764,1118,840,107,72,27.71
12,14,0,12.0,14.0,0.4683387279510498,419.692879031481,10,266,370,1764,1118,840,107,72,26.95
13,14,0,13.0,14.0,0.4763987064361572,400.74363189404374,10,253,356,1764,1118,840,107,72,26.21
12,13,0,12.0,13.0,0.48432183265686035,383.2016221342661,10,241,343,1764,1118,840,107,72,24.15
11,14,0,11.0,14.0,0.4922356605529785,365.4237162899073,10,230,329,1764,1118,840,107,72,24.76
11,13,0,11.0,13.0,0.5003318786621094,348.4697647410001,10,219,316,1764,1118,840,107,72,22.67
11,13,0,11.0,13.0,0.5082917213439941,331.52278840909986,10,208,303,1764,1118,840,107,72,21.92
10,11,0,10.0,11.0,0.5162076950073242,316.80022675729674,10,198,292,1764,1118,840,107,72,18.97
8,13,0,8.0,13.0,0.5243217945098877,301.55147755564633,10,190,279,1764,1118,840,107,72,20.24
10,12,0,10.0,12.0,0.5323686599731445,286.0077638815561,10,180,267,1764,1118,840,107,72,18.91
10,14,0,10.0,14.0,0.5403468608856201,268.809776746088,10,170,253,1764,1118,840,107,72,20.93
12,15,0,12.0,15.0,0.5484697818756104,249.67113959936518,10,158,238,1764,1118,840,107,72,20.06
12,16,0,12.0,16.0,0.5564227104187012,229.70660511172844,10,146,222,1764,1118,840,107,72,20.01
14,16,0,14.0,16.0,0.5643746852874756,208.6630335788388,10,132,206,1764,1118,840,107,72,18.33
13,15,0,13.0,15.0,0.5724546909332275,189.0377746068424,10,119,191,1764,1118,840,107,72,16.37
11,14,0,11.0,14.0,0.5803358554840088,171.3475343475297,10,108,177,1764,1118,840,107,72,14.79
8,13,0,8.0,13.0,0.5882928371429443,156.0833152566875,10,100,164,1764,1118,840,107,72,15.93
7,12,0,7.0,12.0,0.5963137149810791,142.1937148162078,10,93,152,1764,1118,840,107,72,13.49
5,10,0,5.0,10.0,0.604299783706665,131.05687654209268,10,88,142,1764,1118,840,107,72,10.02
4,12,0,4.0,12.0,0.6123037338256836,118.77725931156684,10,84,130,1764,1118,840,107,72,8.64
4,10,0,4.0,10.0,0.6204607486724854,108.22205101855957,10,80,120,1764,1118,840,107,72,7.75
3,9,0,3.0,9.0,0.6283237934112549,99.09256086106296,10,77,111,1764,1118,840,107,72,6.4
3,7,0,3.0,7.0,0.6362698078155518,91.6401190848708,10,74,104,1764,1118,840,107,72,5.92
1,5,0,1.0,5.0,0.6442878246307373,87.00406497347964,10,73,99,1764,1118,840,107,72,3.73
2,6,0,2.0,6.0,0.6523218154907227,81.00427342623003,10,71,93,1764,1118,840,107,72,4.48
3,5,0,3.0,5.0,0.6602277755737305,75.21151019566275,10,68,88,1764,1118,840,107,72,5.68
2,5,0,2.0,5.0,0.6683588027954102,70.04244433244644,10,66,83,1764,1118,840,107,72,4.12
0,4,0,-0.0,4.0,0.676405668258667,66.9417310909429,10,66,79,1764,1118,840,107,72,2.17
0,4,0,-0.0,4.0,0.6847808361053467,63.90495483208028,10,66,75,1764,1118,840,107,72,2.05
0,3,0,-0.0,3.0,0.692274808883667,61.67292357659824,10,66,72,1764,1118,840,107,72,1.76
0,4,0,-0.0,4.0,0.7004218101501465,58.76286192385707,10,66,68,1764,1118,840,107,72,1.83
0,5,0,-0.0,5.0,0.7087247371673584,55.2414379544733,10,66,63,1764,1118,840,107,72,1.84
0,5,0,-0.0,5.0,0.7163426876068115,51.863530545955186,10,66,58,1764,1118,840,107,72,1.66
1,6,0,1.0,6.0,0.7243666648864746,47.24061508662703,10,65,52,1764,1118,840,107,72,2.07
2,6,0,2.0,6.0,0.7321987152099609,42.00640999302557,10,63,46,1764,1118,840,107,72,2.32
3,6,0,3.0,6.0,0.7403357028961182,36.111025509279784,10,60,40,1764,1118,840,107,72,2.53
3,5,0,3.0,5.0,0.7483468055725098,30.887966032762577,10,57,35,1764,1118,840,107,72,2.39
2,6,0,2.0,6.0,0.7563216686248779,26.177166226839255,10,55,29,1764,1118,840,107,72,1.46
3,6,0,3.0,6.0,0.7642977237701416,20.859475903318,10,52,23,1764,1118,840,107,72,1.53
2,6,0,2.0,6.0,0.7722377777099609,16.810983706043572,10,50,17,1764,1118,840,107,72,0.82
1,5,0,1.0,5.0,0.7802078723907471,14.447993022517757,10,49,12,1764,1118,840,107,72,0.31
1,4,0,1.0,4.0,0.788355827331543,12.662100242385755,10,48,8,1764,1118,840,107,72,0.25
1,4,0,1.0,4.0,0.7963988780975342,11.169905660283021,10,47,4,1764,1118,840,107,72,0.09
2,2,0,2.0,2.0,0.8043167591094971,9.044422518220834,10,45,2,1764,1118,840,107,72,1.01
1,1,0,1.0,1.0,0.8122227191925049,8.011362169330773,10,44,1,1764,1118,840,107,72,1.02
0,1,0,-0.0,1.0,0.8202037811279297,8.0,10,44,0,1764,1118,840,107,72,-0.04
0,0,1,-0.0,-0.0,0.878537654876709,8.0,10,44,0,1764,1118,840,107,72,29.28
0,0,0,-0.0,-0.0,0.04539132118225098,1277.522288499893,11,-1047,-763,673,355,1720,1118,36,235.61
-1,0,0,-1.0,-0.0,0.05155038833618164,1276.7142541889311,11,-1046,-763,673,355,1720,1118,36,6.45
-1,0,0,-1.0,-0.0,0.0595393180847168,1275.9064881203742,11,-1045,-763,673,355,1720,1118,36,6.44
-1,0,0,-1.0,-0.0,0.06752443313598633,1275.098990796915,11,-1044,-763,673,355,1720,1118,36,6.44
-1,0,0,-1.0,-0.0,0.0755462646484375,1274.291762722335,11,-1043,-763,673,355,1720,1118,36,6.43
-1,0,0,-1.0,-0.0,0.09155130386352539,1273.4848044015075,11,-1042,-763,673,355,1720,1118,36,6.43
-3,0,0,-3.0,-0.0,0.09944343566894531,1271.0655530266877,11,-1039,-763,673,355,1720,1118,36,15.77
-4,0,0,-4.0,-0.0,0.10764431953430176,1267.8436919003802,11,-1035,-763,673,355,1720,1118,36,20.11
-6,-2,0,-6.0,-2.0,0.11554837226867676,1261.8288948136778,11,-1029,-761,673,355,1720,1118,36,34.89
-7,-3,0,-7.0,-3.0,0.12359738349914551,1254.4181702569324,11,-1022,-758,673,355,1720,1118,36,41.42
-10,-5,0,-10.0,-5.0,0.13174939155578613,1243.4091326766268,11,-1012,-753,673,355,1720,1118,36,55.89
-12,-6,0,-12.0,-6.0,0.13959026336669922,1230.2023073204118,11,-1000,-747,673,355,1720,1118,36,63.21
-14,-8,0,-14.0,-8.0,0.14746427536010742,1214.2000649245235,11,-986,-739,673,355,1720,1118,36,71.96
-16,-12,0,-16.0,-12.0,0.15549826622009277,1194.2000659957084,11,-970,-727,673,355,1720,1118,36,85.34
-19,-16,0,-19.0,-16.0,0.1635754108428955,1169.401364324633,11,-951,-711,673,355,1720,1118,36,93.19
-20,-15,0,-20.0,-15.0,0.17158031463623047,1144.401393667437,11,-931,-696,673,355,1720,1118,36,94.68
-22,-17,0,-22.0,-17.0,0.17948126792907715,1116.6021329082719,11,-909,-679,673,355,1720,1118,36,97.99
-23,-18,0,-23.0,-18.0,0.18754935264587402,1087.4035462219217,11,-886,-661,673,355,1720,1118,36,98.82
-23,-19,0,-23.0,-19.0,0.1953573226928711,1057.6082000431197,11,-863,-642,673,355,1720,1118,36,97.54
-25,-21,0,-25.0,-21.0,0.20341229438781738,1025.0172577670994,11,-838,-621,673,355,1720,1118,36,100.12
-28,-23,0,-28.0,-23.0,0.2113332748413086,988.8286845337691,11,-810,-598,673,355,1720,1118,36,103.45
-31,-24,0,-31.0,-24.0,0.21942424774169922,949.6347451388876,11,-779,-574,673,355,1720,1118,36,105.74
-34,-25,0,-34.0,-25.0,0.2273702621459961,907.4328716876228,11,-745,-549,673,355,1720,1118,36,107.9
-36,-26,0,-36.0,-26.0,0.23546838760375977,863.0278088687099,11,-709,-523,673,355,1720,1118,36,106.43
-38,-26,0,-38.0,-26.0,0.24339938163757324,817.0149699256895,11,-671,-497,673,355,1720,1118,36,103.49
-35,-25,0,-35.0,-25.0,0.25140929222106934,774.0101009456887,11,-636,-472,673,355,1720,1118,36,98.12
-31,-20,0,-31.0,-20.0,0.25943827629089355,737.2012976683766,11,-605,-452,673,355,1720,1118,36,87.56
-29,-17,0,-29.0,-17.0,0.2674403190612793,703.8039900139095,11,-576,-435,673,355,1720,1118,36,80.6
-22,-14,0,-22.0,-14.0,0.27542924880981445,677.8139119046126,11,-554,-421,673,355,1720,1118,36,69.56
-22,-14,0,-22.0,-14.0,0.2835693359375,651.8305755935601,11,-532,-407,673,355,1720,1118,36,67.88
-22,-14,0,-22.0,-14.0,0.29149341583251953,625.8547972951666,11,-510,-393,673,355,1720,1118,36,66.16
-22,-17,0,-22.0,-17.0,0.29950523376464844,598.0519458617106,11,-488,-376,673,355,1720,1118,36,69.59
-24,-19,0,-24.0,-19.0,0.30750536918640137,567.4442757427901,11,-464,-357,673,355,1720,1118,36,69.85
-23,-18,0,-23.0,-18.0,0.31548428535461426,538.2391571976932,11,-441,-339,673,355,1720,1118,36,66.4
-23,-18,0,-23.0,-18.0,0.32332825660705566,509.03415449095894,11,-418,-321,673,355,1720,1118,36,64.15
-23,-17,0,-23.0,-17.0,0.3313772678375244,480.4385619110945,11,-395,-304,673,355,1720,1118,36,60.7
-23,-15,0,-23.0,-15.0,0.33933138847351074,453.0679356525978,11,-372,-289,673,355,1720,1118,36,55.64
-21,-15,0,-21.0,-15.0,0.3474574089050293,427.2830560441302,11,-351,-274,673,355,1720,1118,36,52.71
-20,-14,0,-20.0,-14.0,0.35542845726013184,402.90497739988774,11,-331,-260,673,355,1720,1118,36,48.99
-17,-12,0,-17.0,-12.0,0.36331844329833984,382.12498047485116,11,-314,-248,673,355,1720,1118,36,43.39
-15,-10,0,-15.0,-10.0,0.37141942977905273,364.1583441454602,11,-299,-238,673,355,1720,1118,36,38.15
-14,-8,0,-14.0,-8.0,0.37952232360839844,348.23080154459973,11,-285,-230,673,355,1720,1118,36,33.65
-11,-7,0,-11.0,-7.0,0.3874242305755615,335.27751131369797,11,-274,-223,673,355,1720,1118,36,29.2
-11,-7,0,-11.0,-7.0,0.3953893184661865,322.3307215048327,11,-263,-216,673,355,1720,1118,36,28.41
-8,-7,0,-8.0,-7.0,0.4034862518310547,311.70592957967864,11,-255,-209,673,355,1720,1118,36,26.02
-9,-5,0,-9.0,-5.0,0.4114713668823242,301.5809756540586,11,-246,-204,673,355,1720,1118,36,22.66
-7,-7,0,-7.0,-7.0,0.41944146156311035,291.7256850827842,11,-239,-197,673,355,1720,1118,36,22.64
-7,-6,0,-7.0,-6.0,0.42754530906677246,282.50790339024365,11,-232,-191,673,355,1720,1118,36,22.97
-8,-8,0,-8.0,-8.0,0.43535327911376953,271.2490276561012,11,-224,-183,673,355,1720,1118,36,23.51
-8,-8,0,-8.0,-8.0,0.4434642791748047,259.9946042641835,11,-216,-175,673,355,1720,1118,36,22.83
-10,-9,0,-10.0,-9.0,0.4514024257659912,246.5600120955546,11,-206,-166,673,355,1720,1118,36,25.45
-10,-9,0,-10.0,-9.0,0.45942234992980957,233.127457678367,11,-196,-157,673,355,1720,1118,36,24.52
-11,-10,0,-11.0,-10.0,0.467515230178833,218.29219199965115,11,-185,-147,673,355,1720,1118,36,24.75
-11,-9,0,-11.0,-9.0,0.4753234386444092,204.08106627986098,11,-174,-138,673,355,1720,1118,36,24.68
-11,-8,0,-11.0,-8.0,0.48349428176879883,190.4922060893404,11,-163,-130,673,355,1720,1118,36,22.06
-9,-7,0,-9.0,-7.0,0.49149131774902344,179.0913493789111,11,-154,-123,673,355,1720,1118,36,20.43
-9,-7,0,-9.0,-7.0,0.4994204044342041,167.6906028855526,11,-145,-116,673,355,1720,1118,36,19.67
-9,-7,0,-9.0,-7.0,0.5075113773345947,156.28998823799375,11,-136,-109,673,355,1720,1118,36,18.88
-7,-7,0,-7.0,-7.0,0.5155653953552246,146.45364088398895,11,-129,-102,673,355,1720,1118,36,14.6
-7,-6,0,-7.0,-6.0,0.5235514640808105,137.24174696260025,11,-122,-96,673,355,1720,1118,36,14.77
-7,-7,0,-7.0,-7.0,0.5318753719329834,127.41664278891878,11,-115,-89,673,355,1720,1118,36,13.31
-7,-6,0,-7.0,-6.0,0.5393593311309814,118.20939761998804,11,-108,-83,673,355,1720,1118,36,13.37
-6,-7,0,-6.0,-7.0,0.5475094318389893,109.20062892926276,11,-102,-76,673,355,1720,1118,36,10.82
-6,-6,0,-6.0,-6.0,0.5553712844848633,100.81077392223317,11,-96,-70,673,355,1720,1118,36,10.37
-5,-5,0,-5.0,-5.0,0.5633933544158936,93.83022847155415,11,-91,-65,673,355,1720,1118,36,8.94
-5,-5,0,-5.0,-5.0,0.571357250213623,86.86181383134664,11,-86,-60,673,355,1720,1118,36,8.49
-5,-4,0,-5.0,-4.0,0.5796403884887695,80.4733466477097,11,-81,-56,673,355,1720,1118,36,9.01
-4,-5,0,-4.0,-5.0,0.5874283313751221,74.35799911215054,11,-77,-51,673,355,1720,1118,36,6.54
-4,-4,0,-4.0,-4.0,0.5954523086547852,68.82165628459296,11,-73,-47,673,355,1720,1118,36,6.48
-4,-3,0,-4.0,-3.0,0.603337287902832,63.835200250259064,11,-69,-44,673,355,1720,1118,36,7.32
-4,-4,0,-4.0,-4.0,0.6114203929901123,58.321687612368734,11,-65,-40,673,355,1720,1118,36,5.86
-4,-4,0,-4.0,-4.0,0.620004415512085,52.83078426785913,11,-61,-36,673,355,1720,1118,36,5.48
-4,-3,0,-4.0,-3.0,0.6274502277374268,47.86349520030045,11,-57,-33,673,355,1720,1118,36,6.05
-4,-4,0,-4.0,-4.0,0.6354494094848633,42.41522986797286,11,-53,-29,673,355,1720,1118,36,4.79
-4,-4,0,-4.0,-4.0,0.643451452255249,37.00909015790027,11,-49,-25,673,355,1720,1118,36,4.36
-3,-3,0,-3.0,-3.0,0.6514523029327393,32.99019513592785,11,-46,-22,673,355,1720,1118,36,3.6
-4,-3,0,-4.0,-3.0,0.6593782901763916,28.09772228646444,11,-42,-19,673,355,1720,1118,36,4.27
-3,-2,0,-3.0,-2.0,0.6673753261566162,24.5440947723653,11,-39,-17,673,355,1720,1118,36,4.04
-3,-2,0,-3.0,-2.0,0.6755373477935791,21.0,11,-36,-15,673,355,1720,1118,36,3.77
-3,-2,0,-3.0,-2.0,0.6835412979125977,17.4682957019364,11,-33,-13,673,355,1720,1118,36,3.49
-2,-2,0,-2.0,-2.0,0.6914193630218506,14.89376840679705,11,-31,-11,673,355,1720,1118,36,2.16
-2,-1,0,-2.0,-1.0,0.6994743347167969,12.675723300355934,11,-29,-10,673,355,1720,1118,36,3.74
-2,-1,0,-2.0,-1.0,0.7073464393615723,10.460498941515414,11,-27,-9,673,355,1720,1118,36,3.57
-3,-1,0,-3.0,-1.0,0.7153034210205078,7.298221281347036,11,-24,-8,673,355,1720,1118,36,7.65
-2,-1,0,-2.0,-1.0,0.7233474254608154,5.086792761230392,11,-22,-7,673,355,1720,1118,36,3.24
-3,-1,0,-3.0,-1.0,0.7314143180847168,1.9248588451712756,11,-19,-6,673,355,1720,1118,36,5.92
-3,-1,0,-3.0,-1.0,0.7393183708190918,-1.236945385759789,11,-16,-5,673,355,1720,1118,36,5.59
-4,0,0,-4.0,-0.0,0.7474033832550049,-5.0,11,-12,-5,673,355,1720,1118,36,1.33
-2,-1,0,-2.0,-1.0,0.7554502487182617,-7.2296703857309925,11,-10,-4,673,355,1720,1118,36,3.41
-2,0,0,-2.0,-0.0,0.7636294364929199,-9.05572809000084,11,-8,-4,673,355,1720,1118,36,0.88
-1,0,0,-1.0,-0.0,0.771660327911377,-9.93774225170145,11,-7,-4,673,355,1720,1118,36,0.93
-1,0,0,-1.0,-0.0,0.7796082496643066,-10.78889744907202,11,-6,-4,673,355,1720,1118,36,0.68
-1,-1,0,-1.0,-1.0,0.7875893115997314,-12.1690481051547,11,-5,-3,673,355,1720,1118,36,1.59
-1,0,0,-1.0,-0.0,0.8035423755645752,-13.0,11,-4,-3,673,355,1720,1118,36,0.29
0,0,1,-0.0,-0.0,0.8435702323913574,-13.0,11,-4,-3,673,355,1720,1118,36,23.3
0,0,0,-0.0,-0.0,0.0901641845703125,589.1384067479631,12,265,534,942,892,677,358,15,150.05
1,0,0,1.0,-0.0,0.10721802711486816,588.6945526022544,12,264,534,942,892,677,358,15,4.73
2,0,0,2.0,-0.0,0.11505603790283203,587.8108943185221,12,262,534,942,892,677,358,15,8.56
1,0,0,1.0,-0.0,0.12307500839233398,587.3710962016911,12,261,534,942,892,677,358,15,4.68
1,-1,0,1.0,-1.0,0.13167309761047363,587.8319090297695,12,260,535,942,892,677,358,15,18.55
1,-1,0,1.0,-1.0,0.13924217224121094,588.295724829265,12,259,536,942,892,677,358,15,18.46
2,-1,0,2.0,-1.0,0.1471571922302246,588.3301604991973,12,257,537,942,892,677,358,15,94.59
2,-3,0,2.0,-3.0,0.15514707565307617,590.1808771218315,12,255,540,942,892,677,358,15,5.65
2,-2,0,2.0,-2.0,0.16314220428466797,591.1412876570217,12,253,542,942,892,677,358,15,9.77
4,-4,0,4.0,-4.0,0.17116403579711914,593.0974920794121,12,249,546,942,892,677,358,15,5.14
5,-5,0,5.0,-5.0,0.17920303344726562,595.6084964552026,12,244,551,942,892,677,358,15,4.12
3,-2,0,3.0,-2.0,0.18710899353027344,596.2329566593655,12,241,553,942,892,677,358,15,14.18
1,0,0,1.0,-0.0,0.1952199935913086,595.8341397100864,12,240,553,942,892,677,358,15,4.29
1,0,0,1.0,-0.0,0.20330309867858887,595.4367186684424,12,239,553,942,892,677,358,15,4.27
1,0,0,1.0,-0.0,0.21103715896606445,595.0406962988466,12,238,553,942,892,677,358,15,4.26
1,0,0,1.0,-0.0,0.21917009353637695,594.6460753632488,12,237,553,942,892,677,358,15,4.24
1,3,0,1.0,3.0,0.22704720497131348,591.4947785904235,12,236,550,942,892,677,358,15,29.02
3,7,0,3.0,7.0,0.23507404327392578,583.8790062271632,12,233,543,942,892,677,358,15,54.61
2,7,0,2.0,7.0,0.24323606491088867,576.6582904405625,12,231,536,942,892,677,358,15,49.4
3,8,0,3.0,8.0,0.25108909606933594,568.1243343834444,12,228,528,942,892,677,358,15,55.37
2,13,0,2.0,13.0,0.25919604301452637,555.406436663024,12,226,515,942,892,677,358,15,65.71
4,14,0,4.0,14.0,0.2671360969543457,540.9826639593629,12,222,501,942,892,677,358,15,69.69
4,17,0,4.0,17.0,0.27518415451049805,523.8295394945537,12,218,484,942,892,677,358,15,73.54
4,20,0,4.0,20.0,0.2832181453704834,503.9716234782515,12,214,464,942,892,677,358,15,76.09
4,23,0,4.0,23.0,0.29113197326660156,481.4475406837463,12,210,441,942,892,677,358,15,77.44
6,28,0,6.0,28.0,0.2990691661834717,453.63543068244326,12,204,413,942,892,677,358,15,80.44
8,29,0,8.0,29.0,0.307049036026001,424.1287510709533,12,196,384,942,892,677,358,15,78.68
9,31,0,9.0,31.0,0.3150360584259033,392.4721517202419,12,187,353,942,892,677,358,15,76.3
12,30,0,12.0,30.0,0.3231019973754883,360.3608580129353,12,175,323,942,892,677,358,15,73.06
13,30,0,13.0,30.0,0.33117103576660156,327.8029271078734,12,162,293,942,892,677,358,15,69.0
14,27,0,14.0,27.0,0.33912110328674316,297.4010512465422,12,148,266,942,892,677,358,15,64.66
15,25,0,15.0,25.0,0.3471560478210449,268.26351011349107,12,133,241,942,892,677,358,15,59.3
14,21,0,14.0,21.0,0.3552420139312744,243.12197024651792,12,119,220,942,892,677,358,15,51.74
13,15,0,13.0,15.0,0.36301207542419434,223.7834482799839,12,106,205,942,892,677,358,15,43.09
11,11,0,11.0,11.0,0.37116217613220215,209.01157376399996,12,95,194,942,892,677,358,15,36.06
9,10,0,9.0,10.0,0.37912416458129883,196.1058837158589,12,86,184,942,892,677,358,15,32.44
8,9,0,8.0,9.0,0.3872389793395996,184.59592897553955,12,78,175,942,892,677,358,15,29.28
7,8,0,7.0,8.0,0.3950951099395752,174.46625030566977,12,71,167,942,892,677,358,15,26.26
7,8,0,7.0,8.0,0.403062105178833,164.39719951037708,12,64,159,942,892,677,358,15,25.02
7,6,0,7.0,6.0,0.4112520217895508,156.27277789025334,12,57,153,942,892,677,358,15,20.83
6,6,0,6.0,6.0,0.41919398307800293,148.59562975867928,12,51,147,942,892,677,358,15,19.59
5,3,0,5.0,3.0,0.4270291328430176,144.16877984557524,12,46,144,942,892,677,358,15,12.85
4,4,0,4.0,4.0,0.43512916564941406,139.1642911247477,12,42,140,942,892,677,358,15,14.2
3,4,0,3.0,4.0,0.44312500953674316,134.4814475470194,12,39,136,942,892,677,358,15,13.72
4,5,0,4.0,5.0,0.4512770175933838,128.5949851580065,12,35,131,942,892,677,358,15,15.18
5,5,0,5.0,5.0,0.4593081474304199,122.52219886953742,12,30,126,942,892,677,358,15,14.55
4,6,0,4.0,6.0,0.467271089553833,115.78436382536663,12,26,120,942,892,677,358,15,15.48
4,5,0,4.0,5.0,0.4752480983734131,110.08543888972702,12,22,115,942,892,677,358,15,13.16
4,5,0,4.0,5.0,0.4831390380859375,104.46299834474219,12,18,110,942,892,677,358,15,12.51
4,4,0,4.0,4.0,0.4911069869995117,99.92053123698928,12,14,106,942,892,677,358,15,10.24
4,4,0,4.0,4.0,0.49904799461364746,95.48902380255166,12,10,102,942,892,677,358,15,9.68
3,3,0,3.0,3.0,0.5081679821014404,92.24716620639605,12,7,99,942,892,677,358,15,7.6
3,2,0,3.0,2.0,0.5150530338287354,90.082439194738,12,4,97,942,892,677,358,15,5.23
2,1,0,2.0,1.0,0.5232040882110596,89.02083107326243,12,2,96,942,892,677,358,15,2.89
2,1,0,2.0,1.0,0.5310351848602295,88.0,12,0,95,942,892,677,358,15,2.76
1,2,0,1.0,2.0,0.5396120548248291,86.00537618869137,12,-1,93,942,892,677,358,15,5.82
2,2,0,2.0,2.0,0.5471811294555664,84.0494371207203,12,-3,91,942,892,677,358,15,4.86
2,2,0,2.0,2.0,0.5550920963287354,82.1403387922662,12,-5,89,942,892,677,358,15,4.67
1,1,0,1.0,1.0,0.563194990158081,81.20430828479978,12,-6,88,942,892,677,358,15,2.88
1,2,0,1.0,2.0,0.5711221694946289,79.28441342444185,12,-7,86,942,892,677,358,15,5.24
1,2,0,1.0,2.0,0.5790271759033203,77.38009243891595,12,-8,84,942,892,677,358,15,5.11
2,2,0,2.0,2.0,0.5871222019195557,75.60750571225353,12,-10,82,942,892,677,358,15,4.09
1,3,0,1.0,3.0,0.5952332019805908,72.76214641043707,12,-11,79,942,892,677,358,15,6.62
1,5,0,1.0,5.0,0.6060991287231445,67.96665925596525,12,-12,74,942,892,677,358,15,9.07
1,4,0,1.0,4.0,0.6111249923706055,64.19691004531025,12,-13,70,942,892,677,358,15,7.39
0,5,0,-0.0,5.0,0.6190700531005859,59.2872536767062,12,-13,65,942,892,677,358,15,9.33
0,5,0,-0.0,5.0,0.6270241737365723,54.39218191268331,12,-13,60,942,892,677,358,15,8.8
0,4,0,-0.0,4.0,0.6351289749145508,50.48912940721924,12,-13,56,942,892,677,358,15,7.49
0,5,0,-0.0,5.0,0.6430540084838867,45.630789467763066,12,-13,51,942,892,677,358,15,7.82
0,6,0,-0.0,6.0,0.6512451171875,39.84015371452148,12,-13,45,942,892,677,358,15,7.8
1,5,0,1.0,5.0,0.6590781211853027,35.37924020083418,12,-14,40,942,892,677,358,15,5.54
1,5,0,1.0,5.0,0.6670441627502441,31.078865529319543,12,-15,35,942,892,677,358,15,4.88
0,7,0,-0.0,7.0,0.6749939918518066,24.76476034853718,12,-15,28,942,892,677,358,15,5.68
2,5,0,2.0,5.0,0.6831090450286865,21.600699292150182,12,-17,23,942,892,677,358,15,2.5
1,5,0,1.0,5.0,0.6910510063171387,18.45584412271571,12,-18,18,942,892,677,358,15,2.31
1,4,0,1.0,4.0,0.6990141868591309,16.600847442411894,12,-19,14,942,892,677,358,15,1.13
1,3,0,1.0,3.0,0.7070510387420654,15.825424421026653,12,-20,11,942,892,677,358,15,0.16
0,3,0,-0.0,3.0,0.7149991989135742,14.540659228538015,12,-20,8,942,892,677,358,15,0.75
0,2,0,-0.0,2.0,0.722999095916748,13.880613017821101,12,-20,6,942,892,677,358,15,0.34
0,3,0,-0.0,3.0,0.7310152053833008,13.223748416156685,12,-20,3,942,892,677,358,15,-0.05
0,2,0,-0.0,2.0,0.7389919757843018,13.024984394500787,12,-20,1,942,892,677,358,15,-0.29
0,2,0,-0.0,2.0,0.7470459938049316,13.024984394500787,12,-20,-1,942,892,677,358,15,13.61
-1,1,0,-1.0,1.0,0.7550060749053955,12.104973174542799,12,-19,-2,942,892,677,358,15,1.12
-1,1,0,-1.0,1.0,0.7630021572113037,11.248287590894659,12,-18,-3,942,892,677,358,15,0.94
-1,2,0,-1.0,2.0,0.7710421085357666,10.72004514666935,12,-17,-5,942,892,677,358,15,-0.06
0,1,0,-0.0,1.0,0.7791380882263184,11.027756377319946,12,-17,-6,942,892,677,358,15,2.34
-1,1,0,-1.0,1.0,0.7871260643005371,10.464249196572979,12,-16,-7,942,892,677,358,15,0.38
-1,1,0,-1.0,1.0,0.7952229976654053,10.0,12,-15,-8,942,892,677,358,15,0.21
0,1,0,-0.0,1.0,0.8031730651855469,10.4928556845359,12,-15,-9,942,892,677,358,15,1.72
-1,1,0,-1.0,1.0,0.811161994934082,10.204650534085253,12,-14,-10,942,892,677,358,15,-0.04
-1,0,0,-1.0,-0.0,0.819087028503418,9.401219466856727,12,-13,-10,942,892,677,358,15,1.48
0,1,0,-0.0,1.0,0.8270339965820312,10.029386365926403,12,-13,-11,942,892,677,358,15,1.59
-1,0,0,-1.0,-0.0,0.8350591659545898,9.278820596099706,12,-12,-11,942,892,677,358,15,1.26
-1,0,0,-1.0,-0.0,0.8440251350402832,8.556349186104045,12,-11,-11,942,892,677,358,15,1.14
-1,0,0,-1.0,-0.0,0.8591861724853516,7.866068747318506,12,-10,-11,942,892,677,358,15,1.0
0,0,1,-0.0,-0.0,0.9250051975250244,7.866068747318506,12,-10,-11,942,892,677,358,15,29.25
-1,0,1,-1.0,-0.0,0.0029065608978271484,691.3083251298002,13,121,-705,1072,198,952,903,48,17.77
-1,0,1,-1.0,-0.0,0.018917560577392578,691.47816179112,13,122,-705,1072,198,952,903,48,17.65
-1,0,1,-1.0,-0.0,0.02684760093688965,691.649355480741,13,123,-705,1072,198,952,903,48,17.53
-1,0,1,-1.0,-0.0,0.03476357460021973,691.8219052250357,13,124,-705,1072,198,952,903,48,17.41
-1,0,1,-1.0,-0.0,0.0428316593170166,691.9958100436063,13,125,-705,1072,198,952,903,48,17.3
-1,-1,1,-1.0,-1.0,0.050894737243652344,691.1866889141604,13,126,-704,1072,198,952,903,48,3.45
0,0,0,-0.0,-0.0,0.05485272407531738,691.1866889141604,13,126,-704,1072,198,952,903,48,165.51
-2,0,0,-2.0,-0.0,0.058844566345214844,691.5417527999327,13,128,-704,1072,198,952,903,48,9.09
0,-1,0,-0.0,-1.0,0.06682276725769043,690.5579052813005,13,128,-703,1072,198,952,903,48,6.32
-2,-1,0,-2.0,-1.0,0.07488560676574707,689.935571322791,13,130,-702,1072,198,952,903,48,2.42
0,-1,0,-0.0,-1.0,0.08276557922363281,688.9523125707638,13,130,-701,1072,198,952,903,48,6.29
0,-1,0,-0.0,-1.0,0.0908656120300293,687.9691004531026,13,130,-700,1072,198,952,903,48,6.28
0,-1,0,-0.0,-1.0,0.11498475074768066,686.9859351632773,13,130,-699,1072,198,952,903,48,6.28
0,-1,0,-0.0,-1.0,0.13101673126220703,686.0028168958205,13,130,-698,1072,198,952,903,48,6.27
-1,0,0,-1.0,-0.0,0.1468806266784668,686.1865951987548,13,131,-698,1072,198,952,903,48,16.4
0,-2,0,-0.0,-2.0,0.20290875434875488,684.2210107021677,13,131,-696,1072,198,952,903,48,9.28
2,-4,0,2.0,-4.0,0.21079754829406738,679.9211603581754,13,129,-692,1072,198,952,903,48,15.41
3,-4,0,3.0,-4.0,0.21904373168945312,675.4426352460937,13,126,-688,1072,198,952,903,48,15.14
3,-4,0,3.0,-4.0,0.22686767578125,670.9712224257922,13,123,-684,1072,198,952,903,48,15.06
4,-7,0,4.0,-7.0,0.23487472534179688,663.3790802752146,13,119,-677,1072,198,952,903,48,23.27
3,-8,0,3.0,-8.0,0.24279475212097168,654.9823267213956,13,116,-669,1072,198,952,903,48,25.81
3,-11,0,3.0,-11.0,0.25083065032958984,643.632383876037,13,113,-658,1072,198,952,903,48,32.8
4,-16,0,4.0,-16.0,0.25899267196655273,627.1873770275342,13,109,-642,1072,198,952,903,48,42.08
6,-24,0,6.0,-24.0,0.26691675186157227,602.5245406207166,13,103,-618,1072,198,952,903,48,53.2
5,-29,0,5.0,-29.0,0.2749495506286621,573.0971445250764,13,98,-589,1072,198,952,903,48,59.61
3,-31,0,3.0,-31.0,0.2829005718231201,542.0291511927633,13,95,-558,1072,198,952,903,48,57.17
1,-31,0,1.0,-31.0,0.29096055030822754,511.31766270131607,13,94,-527,1072,198,952,903,48,53.88
0,-33,0,-0.0,-33.0,0.29891061782836914,478.86379865725075,13,94,-494,1072,198,952,903,48,52.93
0,-37,0,-0.0,-37.0,0.3069937229156494,442.56725131539184,13,94,-457,1072,198,952,903,48,53.33
0,-40,0,-0.0,-40.0,0.3150515556335449,403.46344872983,13,94,-417,1072,198,952,903,48,52.02
0,-40,0,-0.0,-40.0,0.32289862632751465,364.54214700595867,13,94,-377,1072,198,952,903,48,48.3
2,-33,0,2.0,-33.0,0.33093976974487305,332.08987629529713,13,92,-344,1072,198,952,903,48,41.37
5,-27,0,5.0,-27.0,0.33885955810546875,304.72176684850064,13,87,-317,1072,198,952,903,48,36.57
5,-19,0,5.0,-19.0,0.34703564643859863,285.07604242321986,13,82,-298,1072,198,952,903,48,30.91
4,-16,0,4.0,-16.0,0.3548746109008789,268.5884481656786,13,78,-282,1072,198,952,903,48,26.3
4,-13,0,4.0,-13.0,0.3629326820373535,254.99283144912522,13,74,-269,1072,198,952,903,48,22.56
5,-13,0,5.0,-13.0,0.37094664573669434,241.13581425375185,13,69,-256,1072,198,952,903,48,20.62
5,-14,0,5.0,-14.0,0.37900376319885254,226.3197954617253,13,64,-242,1072,198,952,903,48,20.93
5,-12,0,5.0,-12.0,0.38688063621520996,213.44683615495913,13,59,-230,1072,198,952,903,48,17.82
4,-10,0,4.0,-10.0,0.39484262466430664,202.77080940897133,13,55,-220,1072,198,952,903,48,15.4
1,-6,0,1.0,-6.0,0.4029817581176758,196.70795182774907,13,54,-214,1072,198,952,903,48,11.3
2,-5,0,2.0,-5.0,0.4109365940093994,191.37177159507232,13,52,-209,1072,198,952,903,48,9.74
1,-4,0,1.0,-4.0,0.4197087287902832,187.24866863485792,13,51,-205,1072,198,952,903,48,11.59
1,-3,0,1.0,-3.0,0.42687273025512695,184.09613163151303,13,50,-202,1072,198,952,903,48,7.91
0,-3,0,-0.0,-3.0,0.4348776340484619,181.1852821232556,13,50,-199,1072,198,952,903,48,6.13
1,-3,0,1.0,-3.0,0.44300270080566406,178.03217565526538,13,49,-196,1072,198,952,903,48,7.85
1,-3,0,1.0,-3.0,0.4508836269378662,174.8793604173143,13,48,-193,1072,198,952,903,48,7.78
1,-3,0,1.0,-3.0,0.4589507579803467,171.7268504830137,13,47,-190,1072,198,952,903,48,7.71
1,-3,0,1.0,-3.0,0.46691060066223145,168.57466084612483,13,46,-187,1072,198,952,903,48,7.63
1,-3,0,1.0,-3.0,0.474928617477417,165.42280749687984,13,45,-184,1072,198,952,903,48,7.56
1,-4,0,1.0,-4.0,0.4829366207122803,161.29975715040752,13,44,-180,1072,198,952,903,48,10.72
1,-4,0,1.0,-4.0,0.49098658561706543,157.1767093199344,13,43,-176,1072,198,952,903,48,10.63
2,-6,0,2.0,-6.0,0.4989585876464844,150.8742405273001,13,41,-170,1072,198,952,903,48,10.07
1,-5,0,1.0,-5.0,0.5068626403808594,145.77926846349644,13,40,-165,1072,198,952,903,48,9.76
2,-5,0,2.0,-5.0,0.5149617195129395,140.4506004853737,13,38,-160,1072,198,952,903,48,8.23
2,-5,0,2.0,-5.0,0.5229005813598633,135.1257364476281,13,36,-155,1072,198,952,903,48,8.03
1,-4,0,1.0,-4.0,0.5307726860046387,131.00322577288512,13,35,-151,1072,198,952,903,48,9.37
1,-4,0,1.0,-4.0,0.538902759552002,126.88074761214565,13,34,-147,1072,198,952,903,48,9.26
2,-5,0,2.0,-5.0,0.5469136238098145,121.56098378343009,13,32,-142,1072,198,952,903,48,7.57
2,-4,0,2.0,-4.0,0.5549015998840332,117.22322755127783,13,30,-138,1072,198,952,903,48,6.13
2,-5,0,2.0,-5.0,0.5628807544708252,111.91541487263319,13,28,-133,1072,198,952,903,48,7.16
3,-5,0,3.0,-5.0,0.5709977149963379,106.41855696180662,13,25,-128,1072,198,952,903,48,6.14
3,-6,0,3.0,-6.0,0.5788776874542236,99.96773773849388,13,22,-122,1072,198,952,903,48,6.78
2,-5,0,2.0,-5.0,0.5869545936584473,94.69709347747316,13,20,-117,1072,198,952,903,48,6.32
2,-6,0,2.0,-6.0,0.5948836803436279,88.44998888394787,13,18,-111,1072,198,952,903,48,7.03
3,-6,0,3.0,-6.0,0.6029965877532959,82.06601717798213,13,15,-105,1072,198,952,903,48,5.89
1,-6,0,1.0,-6.0,0.6109075546264648,75.98499887483122,13,14,-99,1072,198,952,903,48,8.73
2,-5,0,2.0,-5.0,0.6189415454864502,70.76286192385707,13,12,-94,1072,198,952,903,48,5.26
2,-5,0,2.0,-5.0,0.626929759979248,65.56003573022959,13,10,-89,1072,198,952,903,48,5.0
1,-4,0,1.0,-4.0,0.6350326538085938,61.47514258543241,13,9,-85,1072,198,952,903,48,5.29
1,-4,0,1.0,-4.0,0.6428875923156738,57.39410298049853,13,8,-81,1072,198,952,903,48,5.11
1,-5,0,1.0,-5.0,0.6509847640991211,52.321687612368734,13,7,-76,1072,198,952,903,48,5.76
0,-4,0,-0.0,-4.0,0.6588876247406006,48.3394774656273,13,7,-72,1072,198,952,903,48,5.36
1,-4,0,1.0,-4.0,0.666947603225708,44.26419266350405,13,6,-68,1072,198,952,903,48,4.63
0,-4,0,-0.0,-4.0,0.6749286651611328,40.280634719952786,13,6,-64,1072,198,952,903,48,5.17
0,-4,0,-0.0,-4.0,0.683025598526001,36.29925372672534,13,6,-60,1072,198,952,903,48,4.96
-1,-5,0,-1.0,-5.0,0.6910157203674316,31.443665102516448,13,7,-55,1072,198,952,903,48,3.39
0,-5,0,-0.0,-5.0,0.699049711227417,26.487622245457352,13,7,-50,1072,198,952,903,48,4.4
0,-4,0,-0.0,-4.0,0.7067396640777588,22.529560496527367,13,7,-46,1072,198,952,903,48,3.96
-1,-6,0,-1.0,-6.0,0.7148137092590332,16.792156108742276,13,8,-40,1072,198,952,903,48,2.76
0,-4,0,-0.0,-4.0,0.7228307723999023,12.878177829171548,13,8,-36,1072,198,952,903,48,3.09
0,-5,0,-0.0,-5.0,0.730799674987793,8.015621187164243,13,8,-31,1072,198,952,903,48,2.77
0,-4,0,-0.0,-4.0,0.7387936115264893,4.160255680657446,13,8,-27,1072,198,952,903,48,2.34
0,-4,0,-0.0,-4.0,0.747018575668335,0.3515913237718422,13,8,-23,1072,198,952,903,48,1.94
0,-4,0,-0.0,-4.0,0.7548105716705322,-3.384471871911696,13,8,-19,1072,198,952,903,48,1.49
1,-3,0,1.0,-3.0,0.7629046440124512,-6.535750803427021,13,7,-16,1072,198,952,903,48,3.42
1,-2,0,1.0,-2.0,0.7709295749664307,-8.768453788272183,13,6,-14,1072,198,952,903,48,3.95
1,-3,0,1.0,-3.0,0.7788946628570557,-11.916954026405428,13,5,-11,1072,198,952,903,48,2.88
1,-2,0,1.0,-2.0,0.7869627475738525,-14.151142198203896,13,4,-9,1072,198,952,903,48,3.94
1,-1,0,1.0,-1.0,0.7949635982513428,-15.45599625468247,13,3,-8,1072,198,952,903,48,0.99
0,0,1,-0.0,-0.0,0.8199026584625244,-15.45599625468247,13,3,-8,1072,198,952,903,48,22.65
0,0,0,-0.0,-0.0,0.07051730155944824,1003.0228374530859,14,-562,862,507,1068,1069,206,53,205.98
-3,0,0,-3.0,-0.0,0.1454622745513916,1001.3874634236101,14,-559,862,507,1068,1069,206,53,6.71
-5,0,0,-5.0,-0.0,0.15352129936218262,998.6755584086116,14,-554,862,507,1068,1069,206,53,10.41
-6,0,0,-6.0,-0.0,0.16149044036865234,995.4440758064046,14,-548,862,507,1068,1069,206,53,12.12
-4,0,0,-4.0,-0.0,0.16957831382751465,993.3036838940591,14,-544,862,507,1068,1069,206,53,8.42
-4,0,0,-4.0,-0.0,0.17763328552246094,991.1745179663124,14,-540,862,507,1068,1069,206,53,8.37
-4,0,0,-4.0,-0.0,0.18573832511901855,989.0566486654822,14,-536,862,507,1068,1069,206,53,8.31
-2,2,0,-2.0,2.0,0.19362926483154297,986.3023263827857,14,-534,860,507,1068,1069,206,53,12.54
0,1,0,-0.0,1.0,0.20161843299865723,985.4529153648231,14,-534,859,507,1068,1069,206,53,4.71
0,6,0,-0.0,6.0,0.2095794677734375,980.3622608186378,14,-534,853,507,1068,1069,206,53,18.76
-2,9,0,-2.0,9.0,0.21753931045532227,971.6773025382506,14,-532,844,507,1068,1069,206,53,29.71
-4,15,0,-4.0,15.0,0.22553229331970215,956.8657080191576,14,-528,829,507,1068,1069,206,53,44.6
-8,18,0,-8.0,18.0,0.23348236083984375,937.3903674004634,14,-520,811,507,1068,1069,206,53,54.61
-10,20,0,-10.0,20.0,0.24147725105285645,915.1593913891526,14,-510,791,507,1068,1069,206,53,59.34
-14,21,0,-14.0,21.0,0.2494513988494873,889.923577598044,14,-496,770,507,1068,1069,206,53,65.44
-17,22,0,-17.0,22.0,0.2574613094329834,862.2257595904321,14,-479,748,507,1068,1069,206,53,66.27
-18,23,0,-18.0,23.0,0.2655603885650635,833.1542352802552,14,-461,725,507,1068,1069,206,53,66.79
-18,23,0,-18.0,23.0,0.2736623287200928,804.0921635577582,14,-443,702,507,1068,1069,206,53,65.37
-18,24,0,-18.0,24.0,0.28154444694519043,774.1931016948347,14,-425,678,507,1068,1069,206,53,65.27
-20,26,0,-20.0,26.0,0.28957438468933105,741.547392673573,14,-405,652,507,1068,1069,206,53,66.79
-19,26,0,-19.0,26.0,0.29764533042907715,709.4400043511367,14,-386,626,507,1068,1069,206,53,64.72
-18,26,0,-18.0,26.0,0.3056602478027344,677.8636231543721,14,-368,600,507,1068,1069,206,53,62.8
-15,24,0,-15.0,24.0,0.31348228454589844,649.562728397593,14,-353,576,507,1068,1069,206,53,59.05
-13,22,0,-13.0,22.0,0.32160043716430664,624.0123075757874,14,-340,554,507,1068,1069,206,53,53.87
-11,22,0,-11.0,22.0,0.3295884132385254,599.511790456423,14,-329,532,507,1068,1069,206,53,49.51
-9,19,0,-9.0,19.0,0.3376133441925049,578.6230230482462,14,-320,513,507,1068,1069,206,53,43.45
-9,19,0,-9.0,19.0,0.3456273078918457,557.7439507181209,14,-311,494,507,1068,1069,206,53,42.43
-10,19,0,-10.0,19.0,0.35402631759643555,536.3397549524665,14,-301,475,507,1068,1069,206,53,42.6
-10,19,0,-10.0,19.0,0.3615434169769287,514.9408470433713,14,-291,456,507,1068,1069,206,53,41.5
-10,16,0,-10.0,16.0,0.36960434913635254,496.0737495795015,14,-281,440,507,1068,1069,206,53,39.46
-10,18,0,-10.0,18.0,0.3774993419647217,475.52268144122854,14,-271,422,507,1068,1069,206,53,38.84
-10,18,0,-10.0,18.0,0.3855154514312744,454.9750513280289,14,-261,404,507,1068,1069,206,53,37.74
-9,16,0,-9.0,16.0,0.3936023712158203,436.6532178640931,14,-252,388,507,1068,1069,206,53,34.25
-7,15,0,-7.0,15.0,0.40145444869995117,420.2667363808331,14,-245,373,507,1068,1069,206,53,30.08
-9,15,0,-9.0,15.0,0.40961527824401855,402.78899239602686,14,-236,358,507,1068,1069,206,53,32.09
-8,13,0,-8.0,13.0,0.41768336296081543,387.53234456327596,14,-228,345,507,1068,1069,206,53,29.03
-8,13,0,-8.0,13.0,0.42646026611328125,372.2762860126121,14,-220,332,507,1068,1069,206,53,28.31
-9,13,0,-9.0,13.0,0.4335143566131592,356.4682993399584,14,-211,319,507,1068,1069,206,53,28.67
-9,12,0,-9.0,12.0,0.44164037704467773,341.4955782046908,14,-202,307,507,1068,1069,206,53,25.91
-8,12,0,-8.0,12.0,0.4496283531188965,327.0736467084452,14,-194,295,507,1068,1069,206,53,26.6
-10,12,0,-10.0,12.0,0.4575953483581543,311.5574025258519,14,-184,283,507,1068,1069,206,53,24.25
-9,13,0,-9.0,13.0,0.46558237075805664,295.7530108639234,14,-175,270,507,1068,1069,206,53,25.36
-10,11,0,-10.0,11.0,0.47365546226501465,281.09281984442424,14,-165,259,507,1068,1069,206,53,21.41
-8,12,0,-8.0,12.0,0.48166441917419434,266.67387994148027,14,-157,247,507,1068,1069,206,53,22.89
-7,11,0,-7.0,11.0,0.4894893169403076,253.6354770053328,14,-150,236,507,1068,1069,206,53,22.35
-7,10,0,-7.0,10.0,0.497516393661499,241.44158240632663,14,-143,226,507,1068,1069,206,53,18.82
-7,9,0,-7.0,9.0,0.5055503845214844,230.09568524284043,14,-136,217,507,1068,1069,206,53,16.59
-6,6,0,-6.0,6.0,0.5136382579803467,221.83260479605988,14,-130,211,507,1068,1069,206,53,12.21
-6,8,0,-6.0,8.0,0.5215623378753662,211.87601812709073,14,-124,203,507,1068,1069,206,53,14.64
-6,8,0,-6.0,8.0,0.5295662879943848,201.92323269030737,14,-118,195,507,1068,1069,206,53,14.18
-6,8,0,-6.0,8.0,0.5376503467559814,191.97476918212345,14,-112,187,507,1068,1069,206,53,13.71
-6,8,0,-6.0,8.0,0.545790433883667,182.03124765284662,14,-106,179,507,1068,1069,206,53,13.23
-7,7,0,-7.0,7.0,0.5536162853240967,172.45654436173174,14,-99,172,507,1068,1069,206,53,11.35
-8,8,0,-8.0,8.0,0.5616574287414551,161.55532517100121,14,-91,164,507,1068,1069,206,53,11.76
-7,7,0,-7.0,7.0,0.569650411605835,152.05897899291685,14,-84,157,507,1068,1069,206,53,10.27
-6,7,0,-6.0,7.0,0.5775094032287598,143.06803364326444,14,-78,150,507,1068,1069,206,53,9.9
-6,5,0,-6.0,5.0,0.5856173038482666,135.8919392681427,14,-72,145,507,1068,1069,206,53,7.55
-4,4,0,-4.0,4.0,0.5935163497924805,130.54072952429985,14,-68,141,507,1068,1069,206,53,6.42
-3,3,0,-3.0,3.0,0.6016044616699219,126.5417975507041,14,-65,138,507,1068,1069,206,53,5.32
-3,3,0,-3.0,3.0,0.609628438949585,122.55638660118251,14,-62,135,507,1068,1069,206,53,5.19
-2,4,0,-2.0,4.0,0.6176042556762695,118.08677940741129,14,-60,131,507,1068,1069,206,53,8.38
-2,4,0,-2.0,4.0,0.6256833076477051,113.61733416735902,14,-58,127,507,1068,1069,206,53,8.24
-2,5,0,-2.0,5.0,0.6522092819213867,108.23859355639868,14,-56,122,507,1068,1069,206,53,8.3
-3,4,0,-3.0,4.0,0.6522293090820312,103.3560976529518,14,-53,118,507,1068,1069,206,53,5.96
-3,5,0,-3.0,5.0,0.6570563316345215,97.5677951571525,14,-50,113,507,1068,1069,206,53,7.09
-2,6,0,-2.0,6.0,0.6577622890472412,91.27318534089538,14,-48,107,507,1068,1069,206,53,7.43
-4,5,0,-4.0,5.0,0.6656293869018555,85.08555261599052,14,-44,102,507,1068,1069,206,53,5.83
-4,6,0,-4.0,6.0,0.6735894680023193,78.0,14,-40,96,507,1068,1069,206,53,6.43
-4,6,0,-4.0,6.0,0.6814944744110107,70.93296652842108,14,-36,90,507,1068,1069,206,53,6.04
-4,5,0,-4.0,5.0,0.689509391784668,64.82400563727631,14,-32,85,507,1068,1069,206,53,4.85
-3,6,0,-3.0,6.0,0.6976003646850586,58.15461959987698,14,-29,79,507,1068,1069,206,53,6.22
-4,6,0,-4.0,6.0,0.705580472946167,51.1621668954417,14,-25,73,507,1068,1069,206,53,4.89
-4,4,0,-4.0,4.0,0.7136843204498291,46.12489168102785,14,-21,69,507,1068,1069,206,53,3.2
-3,4,0,-3.0,4.0,0.7216184139251709,41.446274915668994,14,-18,65,507,1068,1069,206,53,3.35
-2,4,0,-2.0,4.0,0.7295074462890625,37.06346010171025,14,-16,61,507,1068,1069,206,53,3.97
-2,3,0,-2.0,3.0,0.7375342845916748,33.665735560705194,14,-14,58,507,1068,1069,206,53,2.91
-1,3,0,-1.0,3.0,0.745537281036377,30.515484603779164,14,-13,55,507,1068,1069,206,53,4.63
-1,3,0,-1.0,3.0,0.753453254699707,27.366656256505337,14,-12,52,507,1068,1069,206,53,4.48
-1,2,0,-1.0,2.0,0.7614314556121826,25.195702944680818,14,-11,50,507,1068,1069,206,53,2.99
-1,2,0,-1.0,2.0,0.7694532871246338,23.03060268852505,14,-10,48,507,1068,1069,206,53,2.89
-1,3,0,-1.0,3.0,0.7774434089660645,19.891175622335062,14,-9,45,507,1068,1069,206,53,3.94
-1,1,0,-1.0,1.0,0.7854723930358887,18.721359549995796,14,-8,44,507,1068,1069,206,53,1.5
0,3,0,-0.0,3.0,0.7936093807220459,15.773197148410844,14,-8,41,507,1068,1069,206,53,3.21
-1,1,0,-1.0,1.0,0.801572322845459,14.607881008493905,14,-7,40,507,1068,1069,206,53,1.43
-1,2,0,-1.0,2.0,0.8096764087677002,12.470768123342687,14,-6,38,507,1068,1069,206,53,2.42
-1,3,0,-1.0,3.0,0.8175332546234131,9.355339059327378,14,-5,35,507,1068,1069,206,53,3.13
-1,2,0,-1.0,2.0,0.8255722522735596,7.241540277189323,14,-4,33,507,1068,1069,206,53,2.14
-1,3,0,-1.0,3.0,0.8334434032440186,4.14962686336267,14,-3,30,507,1068,1069,206,53,2.66
-2,3,0,-2.0,3.0,0.8415613174438477,1.018512172212592,14,-1,27,507,1068,1069,206,53,1.21
0,3,0,-0.0,3.0,0.8495843410491943,-1.979175701071373,14,-1,24,507,1068,1069,206,53,4.64
-1,2,0,-1.0,2.0,0.8576633930206299,-4.0,14,0,22,507,1068,1069,206,53,1.36
-1,1,0,-1.0,1.0,0.8655693531036377,-4.976203958371361,14,1,21,507,1068,1069,206,53,0.61
-1,2,0,-1.0,2.0,0.8736512660980225,-6.895026825457201,14,2,19,507,1068,1069,206,53,0.95
0,2,0,-0.0,2.0,0.8814663887023926,-8.88275723137631,14,2,17,507,1068,1069,206,53,3.12
-1,1,0,-1.0,1.0,0.8896152973175049,-9.721179403900294,14,3,16,507,1068,1069,206,53,0.24
0,1,0,-0.0,1.0,0.897545337677002,-10.702941459221645,14,3,15,507,1068,1069,206,53,2.56
0,1,0,-0.0,1.0,0.9056034088134766,-11.682178936723647,14,3,14,507,1068,1069,206,53,2.44
0,1,0,-0.0,1.0,0.9136712551116943,-12.658335935873666,14,3,13,507,1068,1069,206,53,2.3
0,0,1,-0.0,-0.0,0.9205694198608398,-12.658335935873666,14,3,13,507,1068,1069,206,53,23.39
-1,1,1,-1.0,1.0,-0.00015401840209960938,1030.879782350439,15,953,-426,1456,630,504,1055,27,7.69
0,1,1,-0.0,1.0,0.007805824279785156,1031.2882743763812,15,953,-427,1456,630,504,1055,27,17.41
0,1,1,-0.0,1.0,0.015909910202026367,1031.6975638911006,15,953,-428,1456,630,504,1055,27,17.39
-1,0,1,-1.0,-0.0,0.02396082878112793,1032.609869884557,15,954,-428,1456,630,504,1055,27,9.89
0,1,1,-0.0,1.0,0.03193783760070801,1033.0195982867624,15,954,-429,1456,630,504,1055,27,17.38
0,0,0,-0.0,-0.0,0.07685494422912598,1033.0195982867624,15,954,-429,1456,630,504,1055,27,209.45
0,-1,0,-0.0,-1.0,0.10396289825439453,1032.609869884557,15,954,-428,1456,630,504,1055,27,3.6
1,-3,0,1.0,-3.0,0.11201882362365723,1030.472088749862,15,953,-425,1456,630,504,1055,27,15.87
2,-4,0,2.0,-4.0,0.1199038028717041,1027.0201921116725,15,951,-421,1456,630,504,1055,27,24.16
2,-4,0,2.0,-4.0,0.1278848648071289,1023.5760946500743,15,949,-417,1456,630,504,1055,27,24.07
3,-5,0,3.0,-5.0,0.13596296310424805,1018.82362833965,15,946,-412,1456,630,504,1055,27,31.5
4,-7,0,4.0,-7.0,0.1438307762145996,1012.3726151989822,15,942,-405,1456,630,504,1055,27,39.96
4,-7,0,4.0,-7.0,0.15184378623962402,1005.9445519752289,15,938,-398,1456,630,504,1055,27,39.69
7,-7,0,7.0,-7.0,0.15981388092041016,996.773241871659,15,931,-391,1456,630,504,1055,27,52.35
6,-6,0,6.0,-6.0,0.16787981986999512,988.9231507456049,15,925,-385,1456,630,504,1055,27,46.53
9,-8,0,9.0,-8.0,0.17587900161743164,977.5478282243619,15,916,-377,1456,630,504,1055,27,60.36
12,-9,0,12.0,-9.0,0.18399596214294434,963.0327863345575,15,904,-368,1456,630,504,1055,27,70.54
16,-11,0,16.0,-11.0,0.19185280799865723,944.0752321526245,15,888,-357,1456,630,504,1055,27,81.99
19,-11,0,19.0,-11.0,0.19986295700073242,922.3485981173009,15,869,-346,1456,630,504,1055,27,87.75
22,-14,0,22.0,-14.0,0.20785999298095703,896.7433704072814,15,847,-332,1456,630,504,1055,27,93.54
23,-14,0,23.0,-14.0,0.21582698822021484,870.2326986700617,15,824,-318,1456,630,504,1055,27,93.59
29,-16,0,29.0,-16.0,0.22379398345947266,837.4287154135848,15,795,-302,1456,630,504,1055,27,101.24
27,-16,0,27.0,-16.0,0.2317979335784912,806.5242522341849,15,768,-286,1456,630,504,1055,27,96.11
29,-15,0,29.0,-15.0,0.240034818649292,774.1226079842962,15,739,-271,1456,630,504,1055,27,96.23
30,-13,0,30.0,-13.0,0.2479419708251953,741.4832668787294,15,709,-258,1456,630,504,1055,27,94.99
28,-10,0,28.0,-10.0,0.2559359073638916,711.7516816123989,15,681,-248,1456,630,504,1055,27,90.89
27,-8,0,27.0,-8.0,0.26387596130371094,683.6462516945024,15,654,-240,1456,630,504,1055,27,84.55
26,-7,0,26.0,-7.0,0.2718198299407959,656.8305755935601,15,628,-233,1456,630,504,1055,27,80.26
23,-5,0,23.0,-5.0,0.27991390228271484,633.5361552148495,15,605,-228,1456,630,504,1055,27,72.67
21,-5,0,21.0,-5.0,0.28780579566955566,612.1279868954837,15,584,-223,1456,630,504,1055,27,68.23
21,-6,0,21.0,-6.0,0.29578280448913574,590.3721902772782,15,563,-217,1456,630,504,1055,27,67.77
17,-5,0,17.0,-5.0,0.3038327693939209,572.7132404171857,15,546,-212,1456,630,504,1055,27,59.48
18,-6,0,18.0,-6.0,0.3119227886199951,553.7627369543626,15,528,-206,1456,630,504,1055,27,61.2
18,-7,0,18.0,-7.0,0.31995391845703125,534.4495410537852,15,510,-199,1456,630,504,1055,27,62.63
18,-8,0,18.0,-8.0,0.32797694206237793,514.7736257146619,15,492,-191,1456,630,504,1055,27,59.75
18,-8,0,18.0,-8.0,0.33596181869506836,495.0993997241091,15,474,-183,1456,630,504,1055,27,58.27
19,-8,0,19.0,-8.0,0.34401988983154297,474.4935897014442,15,455,-175,1456,630,504,1055,27,58.63
16,-9,0,16.0,-9.0,0.35177087783813477,456.3367660859311,15,439,-166,1456,630,504,1055,27,51.65
18,-8,0,18.0,-8.0,0.3598308563232422,436.67210275933286,15,421,-158,1456,630,504,1055,27,53.62
17,-8,0,17.0,-8.0,0.36793088912963867,417.9477926617098,15,404,-150,1456,630,504,1055,27,50.37
18,-7,0,18.0,-7.0,0.3757967948913574,398.6369759873377,15,386,-143,1456,630,504,1055,27,51.43
17,-7,0,17.0,-7.0,0.3839378356933594,380.2645420070312,15,369,-136,1456,630,504,1055,27,47.85
16,-7,0,16.0,-7.0,0.3918337821960449,362.8324094593227,15,353,-129,1456,630,504,1055,27,44.58
16,-6,0,16.0,-6.0,0.39990782737731934,345.74503480884584,15,337,-123,1456,630,504,1055,27,44.56
15,-6,0,15.0,-6.0,0.4079468250274658,329.5974313972596,15,322,-117,1456,630,504,1055,27,40.92
13,-5,0,13.0,-5.0,0.4159359931945801,315.6715685908959,15,309,-112,1456,630,504,1055,27,37.15
11,-5,0,11.0,-5.0,0.4238288402557373,303.6275414426231,15,298,-107,1456,630,504,1055,27,31.86
9,-5,0,9.0,-5.0,0.43181395530700684,293.4718584144391,15,289,-102,1456,630,504,1055,27,27.17
9,-5,0,9.0,-5.0,0.43985581398010254,283.3258341758275,15,280,-97,1456,630,504,1055,27,26.49
7,-5,0,7.0,-5.0,0.4479248523712158,275.0850568842473,15,273,-92,1456,630,504,1055,27,21.98
7,-5,0,7.0,-5.0,0.4558079242706299,266.8660393831306,15,266,-87,1456,630,504,1055,27,21.46
8,-5,0,8.0,-5.0,0.4640488624572754,257.7175650008695,15,258,-82,1456,630,504,1055,27,22.8
8,-5,0,8.0,-5.0,0.471890926361084,248.58937287282907,15,250,-77,1456,630,504,1055,27,22.17
6,-4,0,6.0,-4.0,0.4798247814178467,241.68608128439215,15,244,-73,1456,630,504,1055,27,17.87
6,-4,0,6.0,-4.0,0.48779988288879395,234.8003228407905,15,238,-69,1456,630,504,1055,27,17.47
5,-4,0,5.0,-4.0,0.49588680267333984,228.89667215569543,15,233,-65,1456,630,504,1055,27,15.07
5,-3,0,5.0,-3.0,0.5038118362426758,223.2794955132586,15,228,-62,1456,630,504,1055,27,14.84
6,-4,0,6.0,-4.0,0.5118098258972168,216.45151993395032,15,222,-58,1456,630,504,1055,27,16.34
4,-3,0,4.0,-3.0,0.5199179649353027,211.83104767802868,15,218,-55,1456,630,504,1055,27,12.06
5,-4,0,5.0,-4.0,0.5279819965362549,206.02054698132775,15,213,-51,1456,630,504,1055,27,13.76
6,-5,0,6.0,-5.0,0.5358579158782959,199.04952251773642,15,207,-46,1456,630,504,1055,27,15.16
6,-3,0,6.0,-3.0,0.544003963470459,192.54804791094466,15,201,-43,1456,630,504,1055,27,15.01
8,-2,0,8.0,-2.0,0.5519368648529053,184.3068675946177,15,193,-41,1456,630,504,1055,27,19.49
10,-3,0,10.0,-3.0,0.5598659515380859,173.90371852908652,15,183,-38,1456,630,504,1055,27,20.4
9,-1,0,9.0,-1.0,0.5678229331970215,164.89041570584965,15,174,-37,1456,630,504,1055,27,18.0
9,-1,0,9.0,-1.0,0.5758459568023682,155.88161534045085,15,165,-36,1456,630,504,1055,27,17.31
8,-1,0,8.0,-1.0,0.5838158130645752,147.85397104206038,15,157,-35,1456,630,504,1055,27,15.8
8,-1,0,8.0,-1.0,0.5918118953704834,139.82997088267732,15,149,-34,1456,630,504,1055,27,15.21
9,0,0,9.0,-0.0,0.5998327732086182,131.06942770761603,15,140,-34,1456,630,504,1055,27,14.21
10,-1,0,10.0,-1.0,0.6079199314117432,121.12307780542466,15,130,-33,1456,630,504,1055,27,15.21
11,-2,0,11.0,-2.0,0.615973949432373,109.97154142320898,15,119,-31,1456,630,504,1055,27,16.16
12,-1,0,12.0,-1.0,0.6239619255065918,98.12605455067681,15,107,-30,1456,630,504,1055,27,14.34
13,-2,0,13.0,-2.0,0.6318459510803223,85.08159868191383,15,94,-28,1456,630,504,1055,27,14.25
12,-1,0,12.0,-1.0,0.6398217678070068,73.33075929238663,15,82,-27,1456,630,504,1055,27,11.62
9,0,0,9.0,-0.0,0.6477799415588379,64.83315488916018,15,73,-27,1456,630,504,1055,27,8.49
7,-2,0,7.0,-2.0,0.6558268070220947,57.576199954375554,15,66,-25,1456,630,504,1055,27,9.22
6,0,0,6.0,-0.0,0.6639328002929688,52.0,15,60,-25,1456,630,504,1055,27,5.76
4,-1,0,4.0,-1.0,0.671954870223999,47.92618484691127,15,56,-24,1456,630,504,1055,27,5.95
4,-1,0,4.0,-1.0,0.6798858642578125,43.859475903318,15,52,-23,1456,630,504,1055,27,5.66
3,-1,0,3.0,-1.0,0.6879518032073975,40.71219600798314,15,49,-22,1456,630,504,1055,27,5.74
3,-1,0,3.0,-1.0,0.6958639621734619,37.566787519082126,15,46,-21,1456,630,504,1055,27,5.53
2,-1,0,2.0,-1.0,0.7037978172302246,35.33218389437829,15,44,-20,1456,630,504,1055,27,6.26
2,-1,0,2.0,-1.0,0.7117669582366943,33.09772228646444,15,42,-19,1456,630,504,1055,27,6.14
2,-1,0,2.0,-1.0,0.7199838161468506,30.863424398922618,15,40,-18,1456,630,504,1055,27,6.02
3,-1,0,3.0,-1.0,0.7279038429260254,27.718546143004666,15,37,-17,1456,630,504,1055,27,5.09
4,-2,0,4.0,-2.0,0.7359278202056885,23.249137920783717,15,33,-15,1456,630,504,1055,27,6.71
2,-1,0,2.0,-1.0,0.7439048290252686,21.0147027033899,15,31,-14,1456,630,504,1055,27,5.74
2,-1,0,2.0,-1.0,0.7517449855804443,18.78049716414141,15,29,-13,1456,630,504,1055,27,5.58
1,0,0,1.0,-0.0,0.7598128318786621,17.870698080866262,15,28,-13,1456,630,504,1055,27,2.12
2,0,0,2.0,-0.0,0.767805814743042,16.068883707497267,15,26,-13,1456,630,504,1055,27,2.18
1,-1,0,1.0,-1.0,0.7759277820587158,14.730849247724095,15,25,-12,1456,630,504,1055,27,2.49
2,0,0,2.0,-0.0,0.7838218212127686,12.942243542145693,15,23,-12,1456,630,504,1055,27,2.01
1,-1,0,1.0,-1.0,0.7918648719787598,11.596747752497688,15,22,-11,1456,630,504,1055,27,2.47
1,0,0,1.0,-0.0,0.7998619079589844,10.706539182259394,15,21,-11,1456,630,504,1055,27,1.81
1,0,0,1.0,-0.0,0.8079237937927246,9.825424421026653,15,20,-11,1456,630,504,1055,27,1.73
1,0,0,1.0,-0.0,0.8159408569335938,8.95449840010015,15,19,-11,1456,630,504,1055,27,1.64
1,0,0,1.0,-0.0,0.8239219188690186,8.095023109728988,15,18,-11,1456,630,504,1055,27,1.55
1,0,0,1.0,-0.0,0.8319089412689209,7.248456731316587,15,17,-11,1456,630,504,1055,27,1.46
2,0,0,2.0,-0.0,0.839918851852417,5.601075237738275,15,15,-11,1456,630,504,1055,27,1.26
1,-1,0,1.0,-1.0,0.8479859828948975,4.204650534085253,15,14,-10,1456,630,504,1055,27,3.13
1,0,0,1.0,-0.0,0.8559079170227051,3.401219466856727,15,13,-10,1456,630,504,1055,27,1.14
1,0,0,1.0,-0.0,0.8639388084411621,2.620499351813308,15,12,-10,1456,630,504,1055,27,1.03
1,0,0,1.0,-0.0,0.87186598777771,1.866068747318506,15,11,-10,1456,630,504,1055,27,0.91
2,-1,0,2.0,-1.0,0.8799099922180176,-0.2720779386421448,15,9,-9,1456,630,504,1055,27,1.93
1,0,0,1.0,-0.0,0.895953893661499,-0.9584054212077042,15,8,-9,1456,630,504,1055,27,0.58
1,-1,0,1.0,-1.0,0.9039478302001953,-2.36985418726535,15,7,-8,1456,630,504,1055,27,3.98
1,0,0,1.0,-0.0,0.9119157791137695,-3.0,15,6,-8,1456,630,504,1055,27,0.32
1,0,0,1.0,-0.0,0.9199779033660889,-3.566018867943397,15,5,-8,1456,630,504,1055,27,0.15
1,-1,0,1.0,-1.0,0.9279179573059082,-4.937742251701451,15,4,-7,1456,630,504,1055,27,1.88
1,0,0,1.0,-0.0,0.9359338283538818,-5.384226894136091,15,3,-7,1456,630,504,1055,27,-0.2
1,0,0,1.0,-0.0,0.9439268112182617,-5.719890110719482,15,2,-7,1456,630,504,1055,27,-0.38
0,0,1,-0.0,-0.0,0.9598178863525391,-5.719890110719482,15,2,-7,1456,630,504,1055,27,25.3
-1,0,1,-1.0,-0.0,0.07593369483947754,405.5473751556551,16,68,414,1521,1051,1454,637,29,19.96
0,0,0,-0.0,-0.0,0.08079957962036133,405.5473751556551,16,68,414,1521,1051,1454,637,29,118.25
-2,0,0,-2.0,-0.0,0.08471465110778809,405.8761722222398,16,70,414,1521,1051,1454,637,29,10.84
-3,0,0,-3.0,-0.0,0.09187674522399902,406.38672671719786,16,73,414,1521,1051,1454,637,29,7.3
-4,0,0,-4.0,-0.0,0.09985470771789551,407.0997506529777,16,77,414,1521,1051,1454,637,29,5.37
-4,0,0,-4.0,-0.0,0.1078805923461914,407.8494992292867,16,81,414,1521,1051,1454,637,29,5.15
-4,0,0,-4.0,-0.0,0.11592268943786621,408.6357769995342,16,85,414,1521,1051,1454,637,29,4.94
-5,0,0,-5.0,-0.0,0.12381458282470703,409.6696826538335,16,90,414,1521,1051,1454,637,29,3.84
-5,0,0,-5.0,-0.0,0.13178467750549316,410.75993219699996,16,95,414,1521,1051,1454,637,29,3.68
-4,0,0,-4.0,-0.0,0.13988971710205078,411.6724092538768,16,99,414,1521,1051,1454,637,29,4.37
-4,-1,0,-4.0,-1.0,0.14786076545715332,413.59092600287954,16,103,415,1521,1051,1454,637,29,2.54
-4,0,0,-4.0,-0.0,0.1558825969696045,414.57204761860055,16,107,415,1521,1051,1454,637,29,4.13
-7,0,0,-7.0,-0.0,0.16387677192687988,416.37309395453616,16,114,415,1521,1051,1454,637,29,2.36
-9,0,0,-9.0,-0.0,0.17183470726013184,418.84408278270365,16,123,415,1521,1051,1454,637,29,1.77
-10,0,0,-10.0,-0.0,0.18050670623779297,421.79123442308935,16,133,415,1521,1051,1454,637,29,1.53
-14,2,0,-14.0,2.0,0.1879878044128418,424.3811127318329,16,147,413,1521,1051,1454,637,29,1.52
-18,3,0,-18.0,3.0,0.1958756446838379,427.955880150949,16,165,410,1521,1051,1454,637,29,1.05
-15,5,0,-15.0,5.0,0.20389676094055176,429.1986010808247,16,180,405,1521,1051,1454,637,29,3.02
-12,6,0,-12.0,6.0,0.21188974380493164,428.7922763554035,16,192,399,1521,1051,1454,637,29,1.52
-8,8,0,-8.0,8.0,0.2199387550354004,425.1821945388952,16,200,391,1521,1051,1454,637,29,12.99
-4,8,0,-4.0,8.0,0.22786378860473633,419.94124026185847,16,204,383,1521,1051,1454,637,29,18.14
-3,8,0,-3.0,8.0,0.2358236312866211,414.3386510694546,16,207,375,1521,1051,1454,637,29,19.12
-1,9,0,-1.0,9.0,0.24382877349853516,406.97505864362086,16,208,366,1521,1051,1454,637,29,23.86
0,9,0,-0.0,9.0,0.25179457664489746,399.1742973612952,16,208,357,1521,1051,1454,637,29,24.84
1,12,0,1.0,12.0,0.2598745822906494,388.3356807443257,16,207,345,1521,1051,1454,637,29,31.03
3,10,0,3.0,10.0,0.2677586078643799,378.2257003308172,16,204,335,1521,1051,1454,637,29,29.88
3,11,0,3.0,11.0,0.27595973014831543,367.2833591962807,16,201,324,1521,1051,1454,637,29,30.73
4,9,0,4.0,9.0,0.283949613571167,357.52927206345396,16,197,315,1521,1051,1454,637,29,28.92
5,10,0,5.0,10.0,0.29196977615356445,346.40116536992497,16,192,305,1521,1051,1454,637,29,31.34
6,10,0,6.0,10.0,0.2998015880584717,334.742024998422,16,186,295,1521,1051,1454,637,29,33.22
6,10,0,6.0,10.0,0.3077256679534912,323.08307581366347,16,180,285,1521,1051,1454,637,29,32.49
8,10,0,8.0,10.0,0.3158426284790039,310.3593686021725,16,172,275,1521,1051,1454,637,29,31.53
7,12,0,7.0,12.0,0.32378578186035156,296.47383142545203,16,165,263,1521,1051,1454,637,29,33.78
7,10,0,7.0,10.0,0.33182358741760254,284.28342226815084,16,158,253,1521,1051,1454,637,29,29.99
8,11,0,8.0,11.0,0.3398096561431885,270.7174037532655,16,150,242,1521,1051,1454,637,29,30.54
7,11,0,7.0,11.0,0.3478856086730957,257.6799587750263,16,143,231,1521,1051,1454,637,29,30.7
8,10,0,8.0,10.0,0.35581064224243164,244.97104085206132,16,135,221,1521,1051,1454,637,29,26.87
8,11,0,8.0,11.0,0.3638455867767334,231.41597340026587,16,127,210,1521,1051,1454,637,29,27.41
8,10,0,8.0,10.0,0.3717617988586426,218.72515979154468,16,119,200,1521,1051,1454,637,29,24.8
8,11,0,8.0,11.0,0.3799595832824707,205.18485349129398,16,111,189,1521,1051,1454,637,29,25.15
8,10,0,8.0,10.0,0.3878657817840576,192.51876428063383,16,103,179,1521,1051,1454,637,29,22.62
9,9,0,9.0,9.0,0.39609575271606445,180.25756098540927,16,94,170,1521,1051,1454,637,29,20.4
7,10,0,7.0,10.0,0.40392565727233887,168.12358441453978,16,87,160,1521,1051,1454,637,29,20.57
7,9,0,7.0,9.0,0.41196274757385254,156.88300090997933,16,80,151,1521,1051,1454,637,29,18.24
8,9,0,8.0,9.0,0.42000865936279297,145.21055241409096,16,72,142,1521,1051,1454,637,29,17.18
6,8,0,6.0,8.0,0.4279646873474121,135.37201879870273,16,66,134,1521,1051,1454,637,29,15.23
6,7,0,6.0,7.0,0.4358086585998535,126.45995870709916,16,60,127,1521,1051,1454,637,29,13.25
5,7,0,5.0,7.0,0.44398069381713867,118.00378782444085,16,55,120,1521,1051,1454,637,29,12.73
4,6,0,4.0,6.0,0.45187973976135254,110.88794977899188,16,51,114,1521,1051,1454,637,29,11.26
2,5,0,2.0,5.0,0.4600226879119873,105.50732195141852,16,49,109,1521,1051,1454,637,29,11.08
2,6,0,2.0,6.0,0.46816563606262207,99.21660655575224,16,47,103,1521,1051,1454,637,29,10.46
1,6,0,1.0,6.0,0.47589969635009766,93.35455276791944,16,46,97,1521,1051,1454,637,29,8.48
0,5,0,-0.0,5.0,0.48385071754455566,88.85912696499032,16,46,92,1521,1051,1454,637,29,6.36
1,6,0,1.0,6.0,0.4918696880340576,83.06183596038146,16,45,86,1521,1051,1454,637,29,7.69
2,4,0,2.0,4.0,0.4998326301574707,78.59049627256569,16,43,82,1521,1051,1454,637,29,9.83
2,3,0,2.0,3.0,0.5079066753387451,75.00561780022652,16,41,79,1521,1051,1454,637,29,7.03
2,2,0,2.0,2.0,0.5158727169036865,72.31338250816034,16,39,77,1521,1051,1454,637,29,4.78
2,2,0,2.0,2.0,0.5239815711975098,69.6301381082203,16,37,75,1521,1051,1454,637,29,4.65
3,2,0,3.0,2.0,0.5318336486816406,66.52949770115296,16,34,73,1521,1051,1454,637,29,4.13
2,2,0,2.0,2.0,0.5398547649383545,63.87810988975015,16,32,71,1521,1051,1454,637,29,4.31
2,2,0,2.0,2.0,0.5478866100311279,61.23961722390672,16,30,69,1521,1051,1454,637,29,4.17
2,2,0,2.0,2.0,0.5559077262878418,58.61542535852834,16,28,67,1521,1051,1454,637,29,4.03
2,3,0,2.0,3.0,0.5639016628265381,55.07966415668217,16,26,64,1521,1051,1454,637,29,5.43
1,4,0,1.0,4.0,0.5717496871948242,51.0,16,25,60,1521,1051,1454,637,29,5.99
1,4,0,1.0,4.0,0.5799107551574707,46.92618484691127,16,24,56,1521,1051,1454,637,29,5.72
1,4,0,1.0,4.0,0.5877687931060791,42.859475903318,16,23,52,1521,1051,1454,637,29,5.43
2,5,0,2.0,5.0,0.5958936214447021,37.478150704935004,16,21,47,1521,1051,1454,637,29,7.64
2,4,0,2.0,4.0,0.6038455963134766,33.01063709417264,16,19,43,1521,1051,1454,637,29,6.79
2,3,0,2.0,3.0,0.611839771270752,29.46262762420146,16,17,40,1521,1051,1454,637,29,4.48
1,2,0,1.0,2.0,0.6199398040771484,27.231056256176608,16,16,38,1521,1051,1454,637,29,5.27
1,3,0,1.0,3.0,0.6280467510223389,24.078865529319543,16,15,35,1521,1051,1454,637,29,5.18
0,2,0,-0.0,2.0,0.635847806930542,22.249137920783717,16,15,33,1521,1051,1454,637,29,2.45
0,1,0,-0.0,1.0,0.6438546180725098,21.341194094144583,16,15,32,1521,1051,1454,637,29,2.14
0,1,0,-0.0,1.0,0.6519267559051514,20.438350715445125,16,15,31,1521,1051,1454,637,29,2.09
1,1,0,1.0,1.0,0.6598737239837646,19.105890714493697,16,14,30,1521,1051,1454,637,29,2.53
0,1,0,-0.0,1.0,0.6677267551422119,18.202484376209235,16,14,29,1521,1051,1454,637,29,2.05
0,3,0,-0.0,3.0,0.6759436130523682,15.5296461204668,16,14,26,1521,1051,1454,637,29,2.2
1,5,0,1.0,5.0,0.6839056015014648,10.698178070456937,16,13,21,1521,1051,1454,637,29,2.85
1,5,0,1.0,5.0,0.6918807029724121,6.0,16,12,16,1521,1051,1454,637,29,2.14
1,4,0,1.0,4.0,0.6998496055603027,2.278820596099706,16,11,12,1521,1051,1454,637,29,1.56
1,2,0,1.0,2.0,0.7078616619110107,0.142135623730951,16,10,10,1521,1051,1454,637,29,1.97
0,2,0,-0.0,2.0,0.7159426212310791,-1.193751525134303,16,10,8,1521,1051,1454,637,29,0.31
1,1,0,1.0,1.0,0.7239327430725098,-2.598245749008621,16,9,7,1521,1051,1454,637,29,3.16
0,2,0,-0.0,2.0,0.7317886352539062,-3.704369859012999,16,9,5,1521,1051,1454,637,29,-0.16
0,2,0,-0.0,2.0,0.7477927207946777,-4.513167019494862,16,9,3,1521,1051,1454,637,29,-0.51
1,2,0,1.0,2.0,0.7557196617126465,-5.937742251701451,16,8,1,1521,1051,1454,637,29,-0.27
1,1,0,1.0,1.0,0.7638306617736816,-7.0,16,7,0,1521,1051,1454,637,29,0.15
0,1,0,-0.0,1.0,0.7720737457275391,-6.9289321881345245,16,7,-1,1521,1051,1454,637,29,1.93
0,1,0,-0.0,1.0,0.7799046039581299,-6.719890110719482,16,7,-2,1521,1051,1454,637,29,0.5
0,0,1,-0.0,-0.0,0.7987046241760254,-6.719890110719482,16,7,-2,1521,1051,1454,637,29,25.02
0,0,0,-0.0,-0.0,0.07854485511779785,1036.3190713184133,17,-529,-927,985,126,1514,1053,63,209.83
-1,0,0,-1.0,-0.0,0.11459589004516602,1035.823790510879,17,-528,-927,985,126,1514,1053,63,2.28
-1,0,0,-1.0,-0.0,0.12255191802978516,1035.3292174558474,17,-527,-927,985,126,1514,1053,63,2.28
-1,-1,0,-1.0,-1.0,0.13054275512695312,1033.965727148062,17,-526,-926,985,126,1514,1053,63,6.89
-4,-2,0,-4.0,-2.0,0.13854384422302246,1030.2539752575724,17,-522,-924,985,126,1514,1053,63,12.73
-3,-2,0,-3.0,-2.0,0.14655184745788574,1027.0382790806768,17,-519,-922,985,126,1514,1053,63,11.62
-4,-4,0,-4.0,-4.0,0.1545557975769043,1021.5915637131052,17,-515,-918,985,126,1514,1053,63,18.55
-4,-4,0,-4.0,-4.0,0.16260576248168945,1016.1470765847555,17,-511,-914,985,126,1514,1053,63,18.49
-7,-4,0,-7.0,-4.0,0.17054271697998047,1009.2480473425558,17,-504,-910,985,126,1514,1053,63,21.29
-8,-8,0,-8.0,-8.0,0.17858171463012695,998.378453242538,17,-496,-902,985,126,1514,1053,63,31.67
-11,-12,0,-11.0,-12.0,0.18657994270324707,982.5704218257358,17,-485,-890,985,126,1514,1053,63,42.07
-14,-15,0,-14.0,-15.0,0.19454693794250488,962.7132383137501,17,-471,-875,985,126,1514,1053,63,49.07
-19,-19,0,-19.0,-19.0,0.2026207447052002,937.0082644275305,17,-452,-856,985,126,1514,1053,63,57.65
-24,-26,0,-24.0,-26.0,0.2105567455291748,902.8543783695615,17,-428,-830,985,126,1514,1053,63,68.06
-26,-27,0,-26.0,-27.0,0.21855688095092773,867.0050111218757,17,-402,-803,985,126,1514,1053,63,68.31
-29,-29,0,-29.0,-29.0,0.22658491134643555,828.188570687483,17,-373,-774,985,126,1514,1053,63,69.6
-25,-26,0,-25.0,-26.0,0.23457789421081543,793.9896969053614,17,-348,-748,985,126,1514,1053,63,62.84
-18,-21,0,-18.0,-21.0,0.2427518367767334,767.3915079708702,17,-330,-727,985,126,1514,1053,63,52.53
-10,-16,0,-10.0,-16.0,0.25054383277893066,748.6928882579346,17,-320,-711,985,126,1514,1053,63,41.49
-7,-14,0,-7.0,-14.0,0.25855088233947754,733.0536630368315,17,-313,-697,985,126,1514,1053,63,37.5
-3,-12,0,-3.0,-12.0,0.26668572425842285,720.8809746229784,17,-310,-685,985,126,1514,1053,63,29.38
-4,-13,0,-4.0,-13.0,0.27459192276000977,707.3901407792496,17,-306,-672,985,126,1514,1053,63,31.82
-3,-16,0,-3.0,-16.0,0.2825508117675781,691.59601438148,17,-303,-656,985,126,1514,1053,63,34.33
-4,-18,0,-4.0,-18.0,0.29053473472595215,673.5885324073903,17,-299,-638,985,126,1514,1053,63,37.35
-4,-21,0,-4.0,-21.0,0.29855895042419434,652.8961909529837,17,-295,-617,985,126,1514,1053,63,40.22
-4,-20,0,-4.0,-20.0,0.3065319061279297,633.1460682711296,17,-291,-597,985,126,1514,1053,63,38.21
-4,-20,0,-4.0,-20.0,0.3145298957824707,613.43618768657,17,-287,-577,985,126,1514,1053,63,37.38
-4,-20,0,-4.0,-20.0,0.3225438594818115,593.7703578115722,17,-283,-557,985,126,1514,1053,63,36.54
-5,-22,0,-5.0,-22.0,0.33052682876586914,571.9170755584884,17,-278,-535,985,126,1514,1053,63,38.52
-3,-21,0,-3.0,-21.0,0.3386087417602539,551.9416780433528,17,-275,-514,985,126,1514,1053,63,34.96
-4,-22,0,-4.0,-22.0,0.34662890434265137,530.6983176047441,17,-271,-492,985,126,1514,1053,63,35.72
-2,-20,0,-2.0,-20.0,0.35454392433166504,512.2724914810246,17,-269,-472,985,126,1514,1053,63,31.22
-3,-20,0,-3.0,-20.0,0.3626227378845215,493.4616287203479,17,-266,-452,985,126,1514,1053,63,31.06
-1,-22,0,-1.0,-22.0,0.3706369400024414,474.0990001969911,17,-265,-430,985,126,1514,1053,63,30.49
-3,-22,0,-3.0,-22.0,0.37866783142089844,453.8793664407674,17,-262,-408,985,126,1514,1053,63,30.79
-4,-22,0,-4.0,-22.0,0.38669681549072266,433.2843956025229,17,-258,-386,985,126,1514,1053,63,30.34
-4,-23,0,-4.0,-23.0,0.3946058750152588,412.0406301909566,17,-254,-363,985,126,1514,1053,63,29.88
-6,-21,0,-6.0,-21.0,0.4025387763977051,391.45473130265685,17,-248,-342,985,126,1514,1053,63,28.57
-5,-16,0,-5.0,-16.0,0.41063594818115234,375.6017707782395,17,-243,-326,985,126,1514,1053,63,23.15
-6,-15,0,-6.0,-15.0,0.41854286193847656,360.0115087820306,17,-237,-311,985,126,1514,1053,63,22.56
-6,-13,0,-6.0,-13.0,0.42657971382141113,346.04774233510534,17,-231,-298,985,126,1514,1053,63,20.58
-5,-12,0,-5.0,-12.0,0.43462371826171875,333.51611761347397,17,-226,-286,985,126,1514,1053,63,18.36
-7,-11,0,-7.0,-11.0,0.442645788192749,320.5480052567501,17,-219,-275,985,126,1514,1053,63,19.62
-6,-10,0,-6.0,-10.0,0.4505758285522461,308.9911763560931,17,-213,-265,985,126,1514,1053,63,17.45
-6,-9,0,-6.0,-9.0,0.45856189727783203,298.21877224727024,17,-207,-256,985,126,1514,1053,63,16.8
-6,-9,0,-6.0,-9.0,0.46656179428100586,287.4493680320311,17,-201,-247,985,126,1514,1053,63,16.41
-7,-8,0,-7.0,-8.0,0.4745829105377197,276.82624969290714,17,-194,-239,985,126,1514,1053,63,17.02
-7,-8,0,-7.0,-8.0,0.48262882232666016,266.2036338943385,17,-187,-231,985,126,1514,1053,63,16.63
-8,-8,0,-8.0,-8.0,0.49089884757995605,254.95454184188088,17,-179,-223,985,126,1514,1053,63,15.56
-9,-11,0,-9.0,-11.0,0.4985477924346924,240.74252519618642,17,-170,-212,985,126,1514,1053,63,19.94
-9,-9,0,-9.0,-9.0,0.5065488815307617,228.09457732650446,17,-161,-203,985,126,1514,1053,63,15.63
-9,-9,0,-9.0,-9.0,0.5145487785339355,215.45486402179202,17,-152,-194,985,126,1514,1053,63,15.03
-8,-9,0,-8.0,-9.0,0.5225448608398438,203.43762496664223,17,-144,-185,985,126,1514,1053,63,14.85
-8,-7,0,-8.0,-7.0,0.5306239128112793,193.0089283934906,17,-136,-178,985,126,1514,1053,63,11.83
-7,-6,0,-7.0,-6.0,0.5385468006134033,184.0,17,-129,-172,985,126,1514,1053,63,10.35
-8,-6,0,-8.0,-6.0,0.5465419292449951,174.41908382621125,17,-121,-166,985,126,1514,1053,63,9.99
-7,-5,0,-7.0,-5.0,0.5545599460601807,166.27392123643713,17,-114,-161,985,126,1514,1053,63,8.57
-7,-5,0,-7.0,-5.0,0.5627448558807373,158.16923639957952,17,-107,-156,985,126,1514,1053,63,8.22
-7,-4,0,-7.0,-4.0,0.5705447196960449,150.94504664870655,17,-100,-152,985,126,1514,1053,63,7.0
-7,-5,0,-7.0,-5.0,0.5785527229309082,142.9482681718907,17,-93,-147,985,126,1514,1053,63,7.52
-8,-5,0,-8.0,-5.0,0.5865437984466553,134.4962235218677,17,-85,-142,985,126,1514,1053,63,7.2
-8,-6,0,-8.0,-6.0,0.5948057174682617,125.28499608087785,17,-77,-136,985,126,1514,1053,63,7.48
-9,-7,0,-9.0,-7.0,0.6025538444519043,114.82523787054146,17,-68,-129,985,126,1514,1053,63,7.63
-7,-8,0,-7.0,-8.0,0.610590934753418,104.50645741070792,17,-61,-121,985,126,1514,1053,63,7.86
-7,-7,0,-7.0,-7.0,0.618546724319458,95.14277624977183,17,-54,-114,985,126,1514,1053,63,6.62
-6,-6,0,-6.0,-6.0,0.6265537738800049,87.18629362155326,17,-48,-108,985,126,1514,1053,63,5.64
-5,-5,0,-5.0,-5.0,0.6347918510437012,80.61541112229978,17,-43,-103,985,126,1514,1053,63,4.78
-4,-6,0,-4.0,-6.0,0.6425988674163818,73.546640309481,17,-39,-97,985,126,1514,1053,63,5.63
-3,-5,0,-3.0,-5.0,0.6505327224731445,67.79271228182775,17,-36,-92,985,126,1514,1053,63,5.28
-4,-5,0,-4.0,-5.0,0.6585578918457031,61.69843580125827,17,-32,-87,985,126,1514,1053,63,4.29
-3,-4,0,-3.0,-4.0,0.6665568351745605,56.920418561333065,17,-29,-83,985,126,1514,1053,63,3.83
-3,-3,0,-3.0,-3.0,0.6745638847351074,53.118963379252364,17,-26,-80,985,126,1514,1053,63,2.85
-1,-3,0,-1.0,-3.0,0.6825597286224365,49.956778592036386,17,-25,-77,985,126,1514,1053,63,7.18
-2,-3,0,-2.0,-3.0,0.690544843673706,46.491935064237495,17,-23,-74,985,126,1514,1053,63,3.33
-3,-3,0,-3.0,-3.0,0.6985397338867188,42.76313442364011,17,-20,-71,985,126,1514,1053,63,2.48
-2,-2,0,-2.0,-2.0,0.7067868709564209,40.30918594402827,17,-18,-69,985,126,1514,1053,63,2.12
-2,-3,0,-2.0,-3.0,0.7145907878875732,36.911707385398586,17,-16,-66,985,126,1514,1053,63,2.83
-3,-2,0,-3.0,-2.0,0.722545862197876,34.30696746902278,17,-13,-64,985,126,1514,1053,63,1.44
-2,-3,0,-2.0,-3.0,0.7305347919464111,30.98386886924694,17,-11,-61,985,126,1514,1053,63,2.46
-3,-3,0,-3.0,-3.0,0.7385907173156738,27.54912467321779,17,-8,-58,985,126,1514,1053,63,1.71
-3,-2,0,-3.0,-2.0,0.7466328144073486,25.222771187482387,17,-5,-56,985,126,1514,1053,63,1.01
-2,-2,0,-2.0,-2.0,0.7550818920135498,23.083269131959838,17,-3,-54,985,126,1514,1053,63,1.3
-1,-1,0,-1.0,-1.0,0.7630367279052734,22.037722424704477,17,-2,-53,985,126,1514,1053,63,1.19
-2,0,0,-2.0,-0.0,0.7705428600311279,22.0,17,0,-53,985,126,1514,1053,63,-0.13
-1,-1,0,-1.0,-1.0,0.7785518169403076,21.009614495783374,17,1,-52,985,126,1514,1053,63,1.07
-1,-1,0,-1.0,-1.0,0.7865889072418213,20.039200620699383,17,2,-51,985,126,1514,1053,63,1.02
-1,0,0,-1.0,-0.0,0.7945559024810791,20.088159097779204,17,3,-51,985,126,1514,1053,63,3.99
-1,-1,0,-1.0,-1.0,0.8025789260864258,19.159744815937813,17,4,-50,985,126,1514,1053,63,0.94
-1,0,0,-1.0,-0.0,0.8185617923736572,19.24937810560445,17,5,-50,985,126,1514,1053,63,2.44
0,0,1,-0.0,-0.0,0.8355758190155029,19.24937810560445,17,5,-50,985,126,1514,1053,63,32.67
0,0,0,-0.0,-0.0,0.10734319686889648,1180.7809443119725,18,879,821,1859,997,980,176,44,225.68
1,2,0,1.0,2.0,0.19747638702392578,1178.6852210300583,18,878,819,1859,997,980,176,44,12.15
5,7,0,5.0,7.0,0.20529818534851074,1170.2554256534127,18,873,812,1859,997,980,176,44,37.95
8,4,0,8.0,4.0,0.21330738067626953,1161.6760536565737,18,865,808,1859,997,980,176,44,37.84
9,3,0,9.0,3.0,0.22131633758544922,1153.057870915301,18,856,805,1859,997,980,176,44,37.25
8,2,0,8.0,2.0,0.22940826416015625,1145.866858849929,18,848,803,1859,997,980,176,44,31.88
6,3,0,6.0,3.0,0.23729634284973145,1139.4490948810455,18,842,800,1859,997,980,176,44,29.73
6,3,0,6.0,3.0,0.24529027938842773,1133.0346315154363,18,836,797,1859,997,980,176,44,29.62
8,7,0,8.0,7.0,0.25335025787353516,1122.4142606591374,18,828,790,1859,997,980,176,44,46.14
12,11,0,12.0,11.0,0.2613341808319092,1106.1387326033976,18,816,779,1859,997,980,176,44,62.41
15,14,0,15.0,14.0,0.26938724517822266,1085.621776600659,18,801,765,1859,997,980,176,44,72.2
19,20,0,19.0,20.0,0.2775592803955078,1058.0689792786384,18,782,745,1859,997,980,176,44,83.67
22,24,0,22.0,24.0,0.28547239303588867,1025.5881824457547,18,760,721,1859,997,980,176,44,89.81
25,29,0,25.0,29.0,0.2933053970336914,987.4993808814347,18,735,692,1859,997,980,176,44,95.13
29,34,0,29.0,34.0,0.30131030082702637,943.090669315583,18,706,658,1859,997,980,176,44,99.85
33,36,0,33.0,36.0,0.30934834480285645,894.4131164491264,18,673,622,1859,997,980,176,44,101.47
34,35,0,34.0,35.0,0.3173043727874756,845.6923417894155,18,639,587,1859,997,980,176,44,98.7
34,36,0,34.0,36.0,0.3253023624420166,796.3067884357308,18,605,551,1859,997,980,176,44,95.5
35,33,0,35.0,33.0,0.33329033851623535,748.2103608755208,18,570,518,1859,997,980,176,44,92.46
35,29,0,35.0,29.0,0.34136128425598145,702.8075606669677,18,535,489,1859,997,980,176,44,85.78
33,24,0,33.0,24.0,0.34936022758483887,662.2726064953938,18,502,465,1859,997,980,176,44,77.3
31,21,0,31.0,21.0,0.3572962284088135,625.2843270155705,18,471,444,1859,997,980,176,44,70.83
29,21,0,29.0,21.0,0.365314245223999,589.7949002729591,18,442,423,1859,997,980,176,44,67.05
28,20,0,28.0,20.0,0.37340521812438965,555.7586001090767,18,414,403,1859,997,980,176,44,63.04
25,20,0,25.0,20.0,0.381298303604126,523.9029217727269,18,389,383,1859,997,980,176,44,59.1
23,20,0,23.0,20.0,0.38930320739746094,493.4852083231875,18,366,363,1859,997,980,176,44,56.05
19,18,0,19.0,18.0,0.39730024337768555,467.3199362380405,18,347,345,1859,997,980,176,44,50.91
18,18,0,18.0,18.0,0.40529632568359375,441.8642042667229,18,329,327,1859,997,980,176,44,49.7
15,18,0,15.0,18.0,0.4133033752441406,418.5417119865042,18,314,309,1859,997,980,176,44,42.95
13,16,0,13.0,16.0,0.42133522033691406,398.05951959216446,18,301,293,1859,997,980,176,44,38.25
10,14,0,10.0,14.0,0.4293482303619385,381.1401741330179,18,291,279,1859,997,980,176,44,32.37
9,13,0,9.0,13.0,0.4372832775115967,365.6596445337069,18,282,266,1859,997,980,176,44,29.57
7,12,0,7.0,12.0,0.44531917572021484,352.35411043556076,18,275,254,1859,997,980,176,44,25.58
7,12,0,7.0,12.0,0.45331335067749023,339.09278585981195,18,268,242,1859,997,980,176,44,24.83
8,12,0,8.0,12.0,0.4613032341003418,325.1310991541956,18,260,230,1859,997,980,176,44,25.26
7,11,0,7.0,11.0,0.46930432319641113,312.619186538967,18,253,219,1859,997,980,176,44,22.68
8,12,0,8.0,12.0,0.4773693084716797,298.7397699070073,18,245,207,1859,997,980,176,44,23.67
10,11,0,10.0,11.0,0.48530030250549316,284.00816982557836,18,235,196,1859,997,980,176,44,24.79
10,10,0,10.0,10.0,0.49332427978515625,269.92636057745796,18,225,186,1859,997,980,176,44,23.79
10,9,0,10.0,9.0,0.5014383792877197,256.48518811599297,18,215,177,1859,997,980,176,44,23.3
7,7,0,7.0,7.0,0.5093011856079102,246.63357943488745,18,208,170,1859,997,980,176,44,17.86
7,6,0,7.0,6.0,0.5173072814941406,237.41665328193562,18,201,164,1859,997,980,176,44,18.33
5,5,0,5.0,5.0,0.5252962112426758,230.3826459961144,18,196,159,1859,997,980,176,44,13.83
4,4,0,4.0,4.0,0.5333092212677002,224.75696545386515,18,192,155,1859,997,980,176,44,11.88
4,4,0,4.0,4.0,0.5413081645965576,219.13274352522097,18,188,151,1859,997,980,176,44,11.69
4,3,0,4.0,3.0,0.549309253692627,214.13555429032706,18,184,148,1859,997,980,176,44,12.11
3,4,0,3.0,4.0,0.5573673248291016,209.29418496797535,18,181,144,1859,997,980,176,44,9.32
5,4,0,5.0,4.0,0.5653202533721924,202.89108474992955,18,176,140,1859,997,980,176,44,14.99
3,4,0,3.0,4.0,0.5736541748046875,198.05681084665386,18,173,136,1859,997,980,176,44,8.99
3,3,0,3.0,3.0,0.5813443660736084,193.84485168750263,18,170,133,1859,997,980,176,44,9.17
3,3,0,3.0,3.0,0.5892963409423828,189.6341182323871,18,167,130,1859,997,980,176,44,9.05
3,3,0,3.0,3.0,0.597346305847168,185.4246851269154,18,164,127,1859,997,980,176,44,8.93
2,3,0,2.0,3.0,0.6053102016448975,182.00980368599937,18,162,124,1859,997,980,176,44,6.64
4,3,0,4.0,3.0,0.6133043766021729,177.01004999748127,18,158,121,1859,997,980,176,44,12.13
3,4,0,3.0,4.0,0.6212892532348633,172.20092687729377,18,155,117,1859,997,980,176,44,8.19
3,4,0,3.0,4.0,0.6293563842773438,167.40168953839878,18,152,113,1859,997,980,176,44,8.01
3,5,0,3.0,5.0,0.6373422145843506,162.0244548966251,18,149,108,1859,997,980,176,44,7.97
4,5,0,4.0,5.0,0.6453611850738525,155.85949510779568,18,145,103,1859,997,980,176,44,9.04
4,6,0,4.0,6.0,0.6536352634429932,149.14321488157222,18,141,97,1859,997,980,176,44,8.86
4,4,0,4.0,4.0,0.6612963676452637,143.58381563425817,18,137,93,1859,997,980,176,44,8.62
3,4,0,3.0,4.0,0.6693093776702881,138.86329600005092,18,134,89,1859,997,980,176,44,6.92
4,4,0,4.0,4.0,0.6772863864898682,133.32224567009067,18,130,85,1859,997,980,176,44,8.15
5,4,0,5.0,4.0,0.6853091716766357,126.94965592440957,18,125,81,1859,997,980,176,44,9.56
5,5,0,5.0,5.0,0.6932952404022217,120.04224723651762,18,120,76,1859,997,980,176,44,8.63
6,5,0,6.0,5.0,0.7013082504272461,112.30189872075525,18,114,71,1859,997,980,176,44,9.52
5,6,0,5.0,6.0,0.709301233291626,104.90941651429968,18,109,65,1859,997,980,176,44,7.72
4,6,0,4.0,6.0,0.7173812389373779,98.44085685513866,18,105,59,1859,997,980,176,44,6.38
5,6,0,5.0,6.0,0.7253153324127197,91.17685275708986,18,100,53,1859,997,980,176,44,6.82
6,8,0,6.0,8.0,0.7333002090454102,82.21612159354233,18,94,45,1859,997,980,176,44,6.95
6,8,0,6.0,8.0,0.7413432598114014,73.46203433826454,18,88,37,1859,997,980,176,44,6.22
6,7,0,6.0,7.0,0.7492983341217041,65.31551981177229,18,82,30,1859,997,980,176,44,5.57
5,7,0,5.0,7.0,0.7574021816253662,58.361682411457764,18,77,23,1859,997,980,176,44,4.33
5,5,0,5.0,5.0,0.7653062343597412,52.21590126111789,18,72,18,1859,997,980,176,44,4.05
3,6,0,3.0,6.0,0.7733063697814941,48.03570517957252,18,69,12,1859,997,980,176,44,2.27
4,5,0,4.0,5.0,0.781306266784668,43.37583651472461,18,65,7,1859,997,980,176,44,2.57
3,3,0,3.0,3.0,0.7893092632293701,40.12889826803627,18,62,4,1859,997,980,176,44,2.17
2,3,0,2.0,3.0,0.7973222732543945,38.00833275470999,18,60,1,1859,997,980,176,44,1.3
2,2,0,2.0,2.0,0.8052992820739746,36.008620049092706,18,58,-1,1859,997,980,176,44,1.55
3,1,0,3.0,1.0,0.8133623600006104,33.036351623268054,18,55,-2,1859,997,980,176,44,2.95
2,2,0,2.0,2.0,0.8212952613830566,31.150729063673246,18,53,-4,1859,997,980,176,44,1.31
5,2,0,5.0,2.0,0.8295233249664307,26.373546489791295,18,48,-6,1859,997,980,176,44,2.64
4,2,0,4.0,2.0,0.8372993469238281,22.721359549995796,18,44,-8,1859,997,980,176,44,1.9
5,3,0,5.0,3.0,0.8453013896942139,18.52159917870962,18,39,-11,1859,997,980,176,44,1.43
5,3,0,5.0,3.0,0.8533093929290771,14.76955262170047,18,34,-14,1859,997,980,176,44,0.96
6,2,0,6.0,2.0,0.861323356628418,10.249030993194197,18,28,-16,1859,997,980,176,44,1.03
5,3,0,5.0,3.0,0.8694813251495361,7.832867780352597,18,23,-19,1859,997,980,176,44,-0.02
7,3,0,7.0,3.0,0.8773331642150879,5.202941017470888,18,16,-22,1859,997,980,176,44,-0.39
7,4,0,7.0,4.0,0.8853862285614014,5.513632984395208,18,9,-26,1859,997,980,176,44,-0.53
7,4,0,7.0,4.0,0.893322229385376,8.066592756745816,18,2,-30,1859,997,980,176,44,-1.11
8,4,0,8.0,4.0,0.9013311862945557,12.525353003264136,18,-6,-34,1859,997,980,176,44,-0.97
7,4,0,7.0,4.0,0.9093053340911865,18.162171256046406,18,-13,-38,1859,997,980,176,44,-0.42
8,3,0,8.0,3.0,0.9173011779785156,24.065171225124082,18,-21,-41,1859,997,980,176,44,-0.35
6,3,0,6.0,3.0,0.9252982139587402,29.62363799656123,18,-27,-44,1859,997,980,176,44,0.37
7,3,0,7.0,3.0,0.9333503246307373,36.008620049092706,18,-34,-47,1859,997,980,176,44,0.4
4,1,0,4.0,1.0,0.9412932395935059,39.220911460055866,18,-38,-48,1859,997,980,176,44,0.76
2,1,0,2.0,1.0,0.9494311809539795,41.25345840347388,18,-40,-49,1859,997,980,176,44,1.78
-2,0,0,-2.0,-0.0,0.9813032150268555,40.00806399170998,18,-38,-49,1859,997,980,176,44,1.21
0,0,1,-0.0,-0.0,0.9863011837005615,40.00806399170998,18,-38,-49,1859,997,980,176,44,39.019999999999996
-3,0,1,-3.0,-0.0,0.9912312030792236,38.21627686929839,18,-35,-49,1859,997,980,176,44,11.25
-5,0,1,-5.0,-0.0,0.9972953796386719,35.4543296888929,18,-30,-49,1859,997,980,176,44,11.3
-3,0,1,-3.0,-0.0,1.0053703784942627,33.94640292279746,18,-27,-49,1859,997,980,176,44,10.9
-2,0,1,-2.0,-0.0,1.0134282112121582,33.00909015790027,18,-25,-49,1859,997,980,176,44,10.74
-1,0,1,-1.0,-0.0,1.0212852954864502,32.56189146281496,18,-24,-49,1859,997,980,176,44,10.65
-1,0,1,-1.0,-0.0,1.0293693542480469,32.12947441089743,18,-23,-49,1859,997,980,176,44,10.62
-1,0,1,-1.0,-0.0,1.037353277206421,31.712196007983138,18,-22,-49,1859,997,980,176,44,10.59
-1,0,1,-1.0,-0.0,1.0453603267669678,31.31041174104736,18,-21,-49,1859,997,980,176,44,10.56
-1,0,1,-1.0,-0.0,1.0532853603363037,30.924474489596967,18,-20,-49,1859,997,980,176,44,10.53
-3,-1,1,-3.0,-1.0,1.0613462924957275,28.921508225896062,18,-17,-48,1859,997,980,176,44,11.2
-2,0,1,-2.0,-0.0,1.0695011615753174,28.289163842720633,18,-15,-48,1859,997,980,176,44,10.37
-2,0,1,-2.0,-0.0,1.0773773193359375,27.729267036625423,18,-13,-48,1859,997,980,176,44,10.3
0,0,0,-0.0,-0.0,1.080888271331787,27.729267036625423,18,-13,-48,1859,997,980,176,44,25.26
-1,0,0,-1.0,-0.0,1.0853252410888672,27.477267507411923,18,-12,-48,1859,997,980,176,44,0.31
-1,-1,0,-1.0,-1.0,1.0932962894439697,26.270073544588683,18,-11,-47,1859,997,980,176,44,1.79
-1,0,0,-1.0,-0.0,1.1093122959136963,26.052055106935853,18,-10,-47,1859,997,980,176,44,0.25
0,-1,0,-0.0,-1.0,1.117321252822876,25.07440918375928,18,-10,-46,1859,997,980,176,44,3.07
-1,0,0,-1.0,-0.0,1.1253042221069336,24.872166581031863,18,-9,-46,1859,997,980,176,44,0.22
-1,0,0,-1.0,-0.0,1.1333093643188477,24.69047011971501,18,-8,-46,1859,997,980,176,44,0.19
-1,-1,0,-1.0,-1.0,1.141322374343872,23.541190146942803,18,-7,-45,1859,997,980,176,44,1.55
-2,0,0,-2.0,-0.0,1.1493003368377686,23.276925690687087,18,-5,-45,1859,997,980,176,44,0.0
-2,-1,0,-2.0,-1.0,1.15730619430542,22.10215414239989,18,-3,-44,1859,997,980,176,44,0.72
-3,-2,0,-3.0,-2.0,1.1653153896331787,20.0,18,0,-42,1859,997,980,176,44,0.86
-3,-3,0,-3.0,-3.0,1.173295259475708,17.11521443121589,18,3,-39,1859,997,980,176,44,1.1
-1,-1,0,-1.0,-1.0,1.1814231872558594,16.209946349085598,18,4,-38,1859,997,980,176,44,0.89
-1,-1,0,-1.0,-1.0,1.1893503665924072,15.336309405188942,18,5,-37,1859,997,980,176,44,0.83
0,-1,0,-0.0,-1.0,1.197303295135498,14.345563690772494,18,5,-36,1859,997,980,176,44,3.53
-1,-1,0,-1.0,-1.0,1.2053043842315674,13.510561809129406,18,6,-35,1859,997,980,176,44,0.74
0,-1,0,-0.0,-1.0,1.213308334350586,12.525353003264136,18,6,-34,1859,997,980,176,44,3.19
-1,-1,0,-1.0,-1.0,1.2212953567504883,11.734255586865999,18,7,-33,1859,997,980,176,44,0.64
-1,0,0,-1.0,-0.0,1.229325294494629,11.955853692699293,18,8,-33,1859,997,980,176,44,1.35
-1,0,0,-1.0,-0.0,1.2375242710113525,12.205262752974143,18,9,-33,1859,997,980,176,44,1.26
0,0,1,-0.0,-0.0,1.2643113136291504,12.205262752974143,18,9,-33,1859,997,980,176,44,30.54
0,0,0,-0.0,-0.0,0.0790398120880127,753.4945687758405,19,-304,-696,1546,334,1850,1030,13,174.34
-1,0,0,-1.0,-0.0,0.09907770156860352,753.0948557327997,19,-303,-696,1546,334,1850,1030,13,5.56
-2,-1,0,-2.0,-1.0,0.11500191688537598,751.3810137572766,19,-301,-695,1546,334,1850,1030,13,20.75
-3,0,0,-3.0,-0.0,0.12300682067871094,750.1937582392492,19,-298,-695,1546,334,1850,1030,13,14.52
-3,0,0,-3.0,-0.0,0.13099384307861328,749.0165561098644,19,-295,-695,1546,334,1850,1030,13,14.39
-4,0,0,-4.0,-0.0,0.13916969299316406,747.4626732625844,19,-291,-695,1546,334,1850,1030,13,18.31
-4,-1,0,-4.0,-1.0,0.14707183837890625,745.0026631111238,19,-287,-694,1546,334,1850,1030,13,27.31
-3,-1,0,-3.0,-1.0,0.15500473976135254,742.9359118108839,19,-284,-693,1546,334,1850,1030,13,23.75
-5,-2,0,-5.0,-2.0,0.16301870346069336,739.1993022004248,19,-279,-691,1546,334,1850,1030,13,38.0
-5,-2,0,-5.0,-2.0,0.17133283615112305,735.4829735064724,19,-274,-689,1546,334,1850,1030,13,37.72
-9,-4,0,-9.0,-4.0,0.17900872230529785,728.4725998973686,19,-265,-685,1546,334,1850,1030,13,58.51
-11,-5,0,-11.0,-5.0,0.18699979782104492,719.8897987986882,19,-254,-680,1546,334,1850,1030,13,65.76
-15,-9,0,-15.0,-9.0,0.195098876953125,706.2934788414112,19,-239,-671,1546,334,1850,1030,13,83.38
-16,-12,0,-16.0,-12.0,0.20301270484924316,689.7082721946032,19,-223,-659,1546,334,1850,1030,13,90.14
-19,-18,0,-19.0,-18.0,0.21100091934204102,666.6789724675508,19,-204,-641,1546,334,1850,1030,13,100.6
-23,-25,0,-23.0,-25.0,0.2190077304840088,636.0412759316958,19,-181,-616,1546,334,1850,1030,13,107.16
-26,-29,0,-26.0,-29.0,0.22699880599975586,601.1194281193775,19,-155,-587,1546,334,1850,1030,13,107.12
-23,-32,0,-23.0,-32.0,0.23536181449890137,564.4813756819761,19,-132,-555,1546,334,1850,1030,13,104.41
-22,-30,0,-22.0,-30.0,0.24304676055908203,530.4000372856065,19,-110,-525,1546,334,1850,1030,13,98.24
-18,-30,0,-18.0,-30.0,0.25099682807922363,497.4769110892773,19,-92,-495,1546,334,1850,1030,13,93.54
-13,-27,0,-13.0,-27.0,0.2590188980102539,468.6209013518052,19,-79,-468,1546,334,1850,1030,13,86.9
-12,-26,0,-12.0,-26.0,0.26711082458496094,441.0492142930127,19,-67,-442,1546,334,1850,1030,13,82.3
-11,-24,0,-11.0,-24.0,0.2750847339630127,415.7345136457295,19,-56,-418,1546,334,1850,1030,13,76.9
-10,-22,0,-10.0,-22.0,0.2830357551574707,392.6627647523656,19,-46,-396,1546,334,1850,1030,13,71.65
-9,-22,0,-9.0,-22.0,0.29105186462402344,369.8257574994029,19,-37,-374,1546,334,1850,1030,13,68.62
-6,-24,0,-6.0,-24.0,0.29900169372558594,345.370175171428,19,-31,-350,1546,334,1850,1030,13,67.84
-6,-26,0,-6.0,-26.0,0.3070046901702881,318.96307482543307,19,-25,-324,1546,334,1850,1030,13,65.86
-4,-25,0,-4.0,-25.0,0.31511783599853516,293.7365509910328,19,-21,-299,1546,334,1850,1030,13,62.02
-3,-23,0,-3.0,-23.0,0.32300376892089844,270.5863337187866,19,-18,-276,1546,334,1850,1030,13,57.4
-1,-22,0,-1.0,-22.0,0.3310048580169678,248.568261965234,19,-17,-254,1546,334,1850,1030,13,54.5
0,-18,0,-0.0,-18.0,0.3390538692474365,230.61149591682988,19,-17,-236,1546,334,1850,1030,13,46.91
1,-15,0,1.0,-15.0,0.34700775146484375,215.73181999884454,19,-18,-221,1546,334,1850,1030,13,40.66
3,-13,0,3.0,-13.0,0.35538578033447266,203.05740838343903,19,-21,-208,1546,334,1850,1030,13,35.23
4,-13,0,4.0,-13.0,0.36307382583618164,190.596032513375,19,-25,-195,1546,334,1850,1030,13,33.02
4,-11,0,4.0,-11.0,0.37102580070495605,180.27130750601393,19,-29,-184,1546,334,1850,1030,13,28.65
4,-10,0,4.0,-10.0,0.37909984588623047,171.1016657177453,19,-33,-174,1546,334,1850,1030,13,25.72
4,-9,0,4.0,-9.0,0.387042760848999,163.09760495051373,19,-37,-165,1546,334,1850,1030,13,22.84
4,-7,0,4.0,-7.0,0.3950378894805908,157.23296235748464,19,-41,-158,1546,334,1850,1030,13,18.12
2,-8,0,2.0,-8.0,0.4029998779296875,150.0416611036937,19,-43,-150,1546,334,1850,1030,13,20.48
3,-7,0,3.0,-7.0,0.4110298156738281,144.2165104108067,19,-46,-143,1546,334,1850,1030,13,17.06
3,-7,0,3.0,-7.0,0.41903185844421387,138.55794685869054,19,-49,-136,1546,334,1850,1030,13,16.19
3,-8,0,3.0,-8.0,0.42699670791625977,132.15932831336434,19,-52,-128,1546,334,1850,1030,13,16.91
2,-7,0,2.0,-7.0,0.4350147247314453,126.5028301584536,19,-54,-121,1546,334,1850,1030,13,15.26
2,-5,0,2.0,-5.0,0.44301891326904297,122.80993750483694,19,-56,-116,1546,334,1850,1030,13,10.99
1,-4,0,1.0,-4.0,0.45158886909484863,119.67020331009256,19,-57,-112,1546,334,1850,1030,13,9.84
1,-4,0,1.0,-4.0,0.4591069221496582,116.58874336577564,19,-58,-108,1546,334,1850,1030,13,9.5
0,-3,0,-0.0,-3.0,0.46701574325561523,113.95415791042844,19,-58,-105,1546,334,1850,1030,13,8.93
0,-3,0,-0.0,-3.0,0.4750196933746338,111.33712115098103,19,-58,-102,1546,334,1850,1030,13,8.73
-2,-4,0,-2.0,-4.0,0.4831717014312744,106.8716084761797,19,-56,-98,1546,334,1850,1030,13,15.05
-3,-4,0,-3.0,-4.0,0.4910109043121338,101.91200118615167,19,-53,-94,1546,334,1850,1030,13,14.41
-3,-3,0,-3.0,-3.0,0.49903273582458496,97.83159442096611,19,-50,-91,1546,334,1850,1030,13,11.6
-3,-4,0,-3.0,-4.0,0.5070037841796875,92.88377015466189,19,-47,-87,1546,334,1850,1030,13,13.46
-2,-5,0,-2.0,-5.0,0.5150249004364014,87.53608929178085,19,-45,-82,1546,334,1850,1030,13,13.83
-3,-4,0,-3.0,-4.0,0.5230157375335693,82.58893836140041,19,-42,-78,1546,334,1850,1030,13,12.58
-4,-6,0,-4.0,-6.0,0.5310378074645996,75.41252974819048,19,-38,-72,1546,334,1850,1030,13,14.93
-4,-5,0,-4.0,-5.0,0.5390088558197021,69.13321502504735,19,-34,-67,1546,334,1850,1030,13,12.42
-5,-6,0,-5.0,-6.0,0.5471339225769043,61.54257916307313,19,-29,-61,1546,334,1850,1030,13,12.47
-4,-5,0,-4.0,-5.0,0.5550878047943115,55.326992425847855,19,-25,-56,1546,334,1850,1030,13,10.59
-4,-3,0,-4.0,-3.0,0.5631058216094971,51.0087712549569,19,-21,-53,1546,334,1850,1030,13,7.29
-3,-4,0,-3.0,-4.0,0.5710127353668213,46.20153254455275,19,-18,-49,1546,334,1850,1030,13,8.26
-3,-3,0,-3.0,-3.0,0.5790379047393799,42.38388161361178,19,-15,-46,1546,334,1850,1030,13,6.34
-3,-4,0,-3.0,-4.0,0.5870668888092041,37.68065933568311,19,-12,-42,1546,334,1850,1030,13,7.04
-3,-3,0,-3.0,-3.0,0.5950179100036621,34.024992192379,19,-9,-39,1546,334,1850,1030,13,5.26
-3,-3,0,-3.0,-3.0,0.6031227111816406,30.496575181789318,19,-6,-36,1546,334,1850,1030,13,4.7
-4,-3,0,-4.0,-3.0,0.6110498905181885,27.06055050963308,19,-2,-33,1546,334,1850,1030,13,3.78
-4,-3,0,-4.0,-3.0,0.6190168857574463,24.066592756745816,19,2,-30,1546,334,1850,1030,13,2.97
-2,-2,0,-2.0,-2.0,0.6270186901092529,22.284271247461902,19,4,-28,1546,334,1850,1030,13,2.15
-2,-3,0,-2.0,-3.0,0.6350088119506836,19.709920264364882,19,6,-25,1546,334,1850,1030,13,2.72
-2,-3,0,-2.0,-3.0,0.6431708335876465,17.40939982143925,19,8,-22,1546,334,1850,1030,13,2.15
-3,-4,0,-3.0,-4.0,0.6510298252105713,15.095023109728988,19,11,-18,1546,334,1850,1030,13,1.45
-2,-4,0,-2.0,-4.0,0.6590008735656738,13.104973174542799,19,13,-14,1546,334,1850,1030,13,1.09
-3,-3,0,-3.0,-3.0,0.6670308113098145,13.4164878389476,19,16,-11,1546,334,1850,1030,13,1.72
-1,-4,0,-1.0,-4.0,0.6750097274780273,12.384776310850235,19,17,-7,1546,334,1850,1030,13,0.09
-1,-2,0,-1.0,-2.0,0.6830728054046631,12.681541692269406,19,18,-5,1546,334,1850,1030,13,2.25
-1,-3,0,-1.0,-3.0,0.6910088062286377,13.104973174542799,19,19,-2,1546,334,1850,1030,13,1.3
0,-2,0,-0.0,-2.0,0.6990158557891846,13.0,19,19,0,1546,334,1850,1030,13,-0.42
0,-3,0,-0.0,-3.0,0.707007884979248,13.235384061671343,19,19,3,1546,334,1850,1030,13,2.65
0,-2,0,-0.0,-2.0,0.7150719165802002,13.6468827043885,19,19,5,1546,334,1850,1030,13,1.77
0,-2,0,-0.0,-2.0,0.7230737209320068,14.248456731316587,19,19,7,1546,334,1850,1030,13,1.26
0,-1,0,-0.0,-1.0,0.7310128211975098,14.615528128088304,19,19,8,1546,334,1850,1030,13,2.58
0,-1,0,-0.0,-1.0,0.739006757736206,15.02379604162864,19,19,9,1546,334,1850,1030,13,2.44
0,-1,0,-0.0,-1.0,0.7470347881317139,15.470910553583888,19,19,10,1546,334,1850,1030,13,2.34
0,-1,0,-0.0,-1.0,0.7550327777862549,15.95449840010015,19,19,11,1546,334,1850,1030,13,2.27
0,-1,0,-0.0,-1.0,0.7630178928375244,16.47220505424423,19,19,12,1546,334,1850,1030,13,2.23
0,-1,0,-0.0,-1.0,0.7710137367248535,17.021728866442675,19,19,13,1546,334,1850,1030,13,2.21
0,-1,0,-0.0,-1.0,0.7950646877288818,17.600847442411894,19,19,14,1546,334,1850,1030,13,2.2
1,0,0,1.0,-0.0,0.8030169010162354,16.80350850198276,19,18,14,1546,334,1850,1030,13,1.82
1,0,0,1.0,-0.0,0.8109989166259766,16.02271554554524,19,17,14,1546,334,1850,1030,13,1.72
1,0,0,1.0,-0.0,0.8190567493438721,15.2602916254693,19,16,14,1546,334,1850,1030,13,1.62
1,0,0,1.0,-0.0,0.8272147178649902,14.518284528683193,19,15,14,1546,334,1850,1030,13,1.51
1,0,0,1.0,-0.0,0.8350298404693604,13.79898987322333,19,14,14,1546,334,1850,1030,13,1.4
2,0,0,2.0,-0.0,0.8430168628692627,12.439088914585774,19,12,14,1546,334,1850,1030,13,1.48
1,0,0,1.0,-0.0,0.8510026931762695,11.804493814764857,19,11,14,1546,334,1850,1030,13,1.06
1,0,0,1.0,-0.0,0.859036922454834,11.204650534085253,19,10,14,1546,334,1850,1030,13,0.94
1,1,0,1.0,1.0,0.867114782333374,9.811388300841896,19,9,13,1546,334,1850,1030,13,3.68
1,0,0,1.0,-0.0,0.875006914138794,9.264337522473747,19,8,13,1546,334,1850,1030,13,0.72
2,1,0,2.0,1.0,0.8830118179321289,7.416407864998739,19,6,12,1546,334,1850,1030,13,1.82
1,2,0,1.0,2.0,0.8915398120880127,5.180339887498949,19,5,10,1546,334,1850,1030,13,8.38
1,1,0,1.0,1.0,0.8991189002990723,3.848857801796104,19,4,9,1546,334,1850,1030,13,2.2
0,1,0,-0.0,1.0,0.9070467948913574,2.944271909999159,19,4,8,1546,334,1850,1030,13,1.7
1,2,0,1.0,2.0,0.9150118827819824,0.7082039324993694,19,3,6,1546,334,1850,1030,13,8.18
1,1,0,1.0,1.0,0.9230778217315674,-0.6148351928654963,19,2,5,1546,334,1850,1030,13,1.51
0,1,0,-0.0,1.0,0.931006908416748,-1.5278640450004204,19,2,4,1546,334,1850,1030,13,1.15
0,1,0,-0.0,1.0,0.9390077590942383,-2.394448724536011,19,2,3,1546,334,1850,1030,13,0.62
1,0,0,1.0,-0.0,0.9472098350524902,-2.8377223398316205,19,1,3,1546,334,1850,1030,13,-0.76
0,1,0,-0.0,1.0,0.9550087451934814,-3.76393202250021,19,1,2,1546,334,1850,1030,13,0.6
0,0,1,-0.0,-0.0,0.9570128917694092,-3.76393202250021,19,1,2,1546,334,1850,1030,13,25.85
0,1,1,-0.0,1.0,0.005005359649658203,1401.853822428713,20,-1372,377,173,710,1545,332,42,1.91
1,0,1,1.0,-0.0,0.012984275817871094,1402.8181063605,20,-1373,377,173,710,1545,332,42,8.41
0,0,0,-0.0,-0.0,0.10898423194885254,1402.8181063605,20,-1373,377,173,710,1545,332,42,247.78
0,1,0,-0.0,1.0,0.1649942398071289,1402.553651956961,20,-1373,376,173,710,1545,332,42,1.9
-3,1,0,-3.0,1.0,0.17300724983215332,1399.3960715237142,20,-1370,375,173,710,1545,332,42,21.42
-5,2,0,-5.0,2.0,0.18102622032165527,1394.0455823046832,20,-1365,373,173,710,1545,332,42,30.85
-9,5,0,-9.0,5.0,0.18907713890075684,1384.048041883266,20,-1356,368,173,710,1545,332,42,48.69
-14,6,0,-14.0,6.0,0.1970381736755371,1368.9669060808606,20,-1342,362,173,710,1545,332,42,66.2
-16,6,0,-16.0,6.0,0.20497632026672363,1351.9573919098873,20,-1326,356,173,710,1545,332,42,71.92
-22,8,0,-22.0,8.0,0.21302413940429688,1328.636988230539,20,-1304,348,173,710,1545,332,42,87.42
-29,10,0,-29.0,10.0,0.22098326683044434,1298.040939470796,20,-1275,338,173,710,1545,332,42,101.41
-37,11,0,-37.0,11.0,0.22902226448059082,1259.4581211425855,20,-1238,327,173,710,1545,332,42,113.71
-41,11,0,-41.0,11.0,0.23698735237121582,1217.0084813925953,20,-1197,316,173,710,1545,332,42,118.27
-41,11,0,-41.0,11.0,0.24500226974487305,1174.5588651337916,20,-1156,305,173,710,1545,332,42,116.02
-40,9,0,-40.0,9.0,0.25310325622558594,1133.587372181075,20,-1116,296,173,710,1545,332,42,110.37
-39,7,0,-39.0,7.0,0.2611262798309326,1094.100892296298,20,-1077,289,173,710,1545,332,42,105.37
-36,5,0,-36.0,5.0,0.26899123191833496,1058.044484717845,20,-1041,284,173,710,1545,332,42,98.25
-34,3,0,-34.0,3.0,0.2769942283630371,1024.4711856383226,20,-1007,281,173,710,1545,332,42,92.44
-35,3,0,-35.0,3.0,0.2849752902984619,989.9737879885907,20,-972,278,173,710,1545,332,42,91.9
-36,3,0,-36.0,3.0,0.29303526878356934,954.5618893745286,20,-936,275,173,710,1545,332,42,91.17
-36,4,0,-36.0,4.0,0.30099034309387207,918.91542172687,20,-900,271,173,710,1545,332,42,89.63
-36,6,0,-36.0,6.0,0.30898618698120117,882.7261753429519,20,-864,265,173,710,1545,332,42,88.66
-34,7,0,-34.0,7.0,0.3169882297515869,848.1743208355847,20,-830,258,173,710,1545,332,42,84.94
-32,9,0,-32.0,9.0,0.3249812126159668,814.9455723909302,20,-798,249,173,710,1545,332,42,82.72
-32,11,0,-32.0,11.0,0.33300328254699707,781.1221852062191,20,-766,238,173,710,1545,332,42,81.4
-31,12,0,-31.0,12.0,0.34098124504089355,747.9609873068985,20,-735,226,173,710,1545,332,42,77.57
-30,13,0,-30.0,13.0,0.34897613525390625,715.4740321287642,20,-705,213,173,710,1545,332,42,74.11
-29,13,0,-29.0,13.0,0.3569831848144531,683.9652473703934,20,-676,200,173,710,1545,332,42,70.75
-29,14,0,-29.0,14.0,0.3650171756744385,652.2050207774746,20,-647,186,173,710,1545,332,42,68.7
-28,13,0,-28.0,13.0,0.3729872703552246,621.7207791879767,20,-619,173,173,710,1545,332,42,65.27
-26,10,0,-26.0,10.0,0.38097524642944336,593.9943089167574,20,-593,163,173,710,1545,332,42,60.82
-23,9,0,-23.0,9.0,0.38898134231567383,569.4371262039676,20,-570,154,173,710,1545,332,42,55.14
-20,7,0,-20.0,7.0,0.3969993591308594,548.3057175191551,20,-550,147,173,710,1545,332,42,49.69
-19,6,0,-19.0,6.0,0.40498924255371094,528.401492535286,20,-531,141,173,710,1545,332,42,47.41
-17,4,0,-17.0,4.0,0.41297435760498047,510.94454598200366,20,-514,137,173,710,1545,332,42,43.32
-16,3,0,-16.0,3.0,0.4211263656616211,494.7130985344468,20,-498,134,173,710,1545,332,42,39.52
-16,4,0,-16.0,4.0,0.42898035049438477,478.2233968876058,20,-482,130,173,710,1545,332,42,40.62
-14,3,0,-14.0,3.0,0.4369852542877197,463.9257675149878,20,-468,127,173,710,1545,332,42,35.43
-13,3,0,-13.0,3.0,0.4449632167816162,450.59410513703415,20,-455,124,173,710,1545,332,42,33.62
-11,3,0,-11.0,3.0,0.4529893398284912,439.1923510881075,20,-444,121,173,710,1545,332,42,31.79
-9,2,0,-9.0,2.0,0.4609801769256592,429.98336998164353,20,-435,119,173,710,1545,332,42,25.44
-9,3,0,-9.0,3.0,0.46898531913757324,420.51104176452935,20,-426,116,173,710,1545,332,42,25.44
-10,2,0,-10.0,2.0,0.47704529762268066,410.3374549004526,20,-416,114,173,710,1545,332,42,26.03
-10,2,0,-10.0,2.0,0.4849703311920166,400.16505078175703,20,-406,112,173,710,1545,332,42,25.62
-13,2,0,-13.0,2.0,0.49329423904418945,387.1041533726409,20,-393,110,173,710,1545,332,42,28.98
-13,3,0,-13.0,3.0,0.5012133121490479,373.77715232774045,20,-380,107,173,710,1545,332,42,29.86
-14,2,0,-14.0,2.0,0.5089643001556396,359.76370625362915,20,-366,105,173,710,1545,332,42,28.81
-14,2,0,-14.0,2.0,0.5169873237609863,345.7601396008023,20,-352,103,173,710,1545,332,42,28.03
-14,1,0,-14.0,1.0,0.5250723361968994,332.05523647157537,20,-338,102,173,710,1545,332,42,26.34
-13,1,0,-13.0,1.0,0.5330562591552734,319.3321906608307,20,-325,101,173,710,1545,332,42,24.4
-12,1,0,-12.0,1.0,0.5409872531890869,307.58636612008115,20,-313,100,173,710,1545,332,42,22.54
-13,0,0,-13.0,-0.0,0.5491383075714111,295.22776601683796,20,-300,100,173,710,1545,332,42,22.23
-12,0,0,-12.0,-0.0,0.5569682121276855,283.86718419665965,20,-288,100,173,710,1545,332,42,20.37
-12,0,0,-12.0,-0.0,0.5650441646575928,272.55749011054036,20,-276,100,173,710,1545,332,42,19.7
-12,1,0,-12.0,1.0,0.5729801654815674,260.95212359547855,20,-264,99,173,710,1545,332,42,19.81
-12,2,0,-12.0,2.0,0.5811653137207031,249.02407300090857,20,-252,97,173,710,1545,332,42,19.98
-12,2,0,-12.0,2.0,0.5889842510223389,237.11818998280614,20,-240,95,173,710,1545,332,42,19.27
-12,2,0,-12.0,2.0,0.596973180770874,225.2376900476448,20,-228,93,173,710,1545,332,42,18.53
-12,3,0,-12.0,3.0,0.6049761772155762,213.0,20,-216,90,173,710,1545,332,42,18.75
-14,3,0,-14.0,3.0,0.6130921840667725,198.93862780330335,20,-202,87,173,710,1545,332,42,19.2
-14,3,0,-14.0,3.0,0.6209821701049805,184.91260281974002,20,-188,84,173,710,1545,332,42,18.17
-14,3,0,-14.0,3.0,0.628974199295044,170.92967462067975,20,-174,81,173,710,1545,332,42,17.1
-14,5,0,-14.0,5.0,0.6369903087615967,156.13271860387624,20,-160,76,173,710,1545,332,42,17.76
-13,3,0,-13.0,3.0,0.6450991630554199,143.12799883018133,20,-147,73,173,710,1545,332,42,14.47
-13,5,0,-13.0,5.0,0.6529912948608398,129.2664300500947,20,-134,68,173,710,1545,332,42,15.19
-14,4,0,-14.0,4.0,0.6609861850738525,115.0,20,-120,64,173,710,1545,332,42,13.38
-14,5,0,-14.0,5.0,0.668978214263916,100.31364309095659,20,-106,59,173,710,1545,332,42,12.81
-12,5,0,-12.0,5.0,0.6771101951599121,87.40664186294121,20,-94,54,173,710,1545,332,42,11.32
-14,5,0,-14.0,5.0,0.6851673126220703,72.81364506296512,20,-80,49,173,710,1545,332,42,10.2
-12,4,0,-12.0,4.0,0.6929702758789062,60.541400527584756,20,-68,45,173,710,1545,332,42,8.02
-12,5,0,-12.0,5.0,0.7009873390197754,47.81860213634101,20,-56,40,173,710,1545,332,42,7.39
-11,4,0,-11.0,4.0,0.708977222442627,36.62811813689564,20,-45,36,173,710,1545,332,42,5.55
-11,6,0,-11.0,6.0,0.7170312404632568,24.343136195018538,20,-34,30,173,710,1545,332,42,5.35
-11,5,0,-11.0,5.0,0.724980354309082,12.97057550292606,20,-23,25,173,710,1545,332,42,3.38
-10,4,0,-10.0,4.0,0.7329871654510498,3.6981780704569367,20,-13,21,173,710,1545,332,42,1.62
-8,4,0,-8.0,4.0,0.741051197052002,-3.2799548533306506,20,-5,17,173,710,1545,332,42,0.43
-7,3,0,-7.0,3.0,0.7489793300628662,-6.857864376269049,20,2,14,173,710,1545,332,42,-0.91
-7,3,0,-7.0,3.0,0.7570643424987793,-6.787329596448105,20,9,11,173,710,1545,332,42,0.15
-5,2,0,-5.0,2.0,0.7649712562561035,-4.356683022906761,20,14,9,173,710,1545,332,42,-1.25
-5,3,0,-5.0,3.0,0.7729673385620117,-1.0751411548287244,20,19,6,173,710,1545,332,42,-1.04
-3,1,0,-3.0,1.0,0.7809803485870361,1.5610283453569558,20,22,5,173,710,1545,332,42,0.34
-2,2,0,-2.0,2.0,0.7889912128448486,3.1867732448956474,20,24,3,173,710,1545,332,42,-0.05
-4,1,0,-4.0,1.0,0.7969841957092285,7.071337695236398,20,28,2,173,710,1545,332,42,1.0
-2,2,0,-2.0,2.0,0.8049793243408203,9.0,20,30,0,173,710,1545,332,42,0.29
-2,1,0,-2.0,1.0,0.8130371570587158,11.015621187164243,20,32,-1,173,710,1545,332,42,1.3
-1,0,0,-1.0,-0.0,0.8209812641143799,12.015148038438355,20,33,-1,173,710,1545,332,42,5.23
-1,0,0,-1.0,-0.0,0.8290061950683594,13.0147027033899,20,34,-1,173,710,1545,332,42,5.27
0,0,1,-0.0,-0.0,0.8729863166809082,13.0147027033899,20,34,-1,173,710,1545,332,42,30.79
0,0,0,-0.0,-0.0,0.07186412811279297,1429.561109834389,21,1459,-102,1598,609,139,711,67,250.28
1,0,0,1.0,-0.0,0.0829470157623291,1428.5635463434355,21,1458,-102,1598,609,139,711,67,7.89
3,0,0,3.0,-0.0,0.09086894989013672,1425.570875891878,21,1455,-102,1598,609,139,711,67,14.7
4,0,0,4.0,-0.0,0.09888410568237305,1421.5806955958133,21,1451,-102,1598,609,139,711,67,17.94
4,0,0,4.0,-0.0,0.10713815689086914,1417.5905693888956,21,1447,-102,1598,609,139,711,67,17.92
6,0,0,6.0,-0.0,0.11484694480895996,1411.6054824760981,21,1441,-102,1598,609,139,711,67,24.11
6,-1,0,6.0,-1.0,0.12299513816833496,1405.5499643738483,21,1435,-101,1598,609,139,711,67,23.92
7,-1,0,7.0,-1.0,0.13131499290466309,1398.4971184043648,21,1428,-100,1598,609,139,711,67,27.16
8,-2,0,8.0,-2.0,0.13915014266967773,1390.3776730017933,21,1420,-98,1598,609,139,711,67,29.04
6,-1,0,6.0,-1.0,0.14686107635498047,1384.3231812116812,21,1414,-97,1598,609,139,711,67,23.73
4,-1,0,4.0,-1.0,0.15484213829040527,1380.264306490474,21,1410,-96,1598,609,139,711,67,16.78
1,0,0,1.0,-0.0,0.16285300254821777,1379.2666178877132,21,1409,-96,1598,609,139,711,67,7.85
2,0,0,2.0,-0.0,0.2109391689300537,1377.271250504668,21,1407,-96,1598,609,139,711,67,11.24
3,-2,0,3.0,-2.0,0.21886801719665527,1374.1432052211317,21,1404,-94,1598,609,139,711,67,12.3
8,-2,0,8.0,-2.0,0.22684216499328613,1366.0282341682744,21,1396,-92,1598,609,139,711,67,28.76
14,-4,0,14.0,-4.0,0.23485612869262695,1351.798902368138,21,1382,-88,1598,609,139,711,67,44.18
21,-5,0,21.0,-5.0,0.24285411834716797,1330.5285108863693,21,1361,-83,1598,609,139,711,67,59.46
26,-5,0,26.0,-5.0,0.2509920597076416,1304.2767103333551,21,1335,-78,1598,609,139,711,67,68.55
28,-5,0,28.0,-5.0,0.25885009765625,1276.0370506597587,21,1307,-73,1598,609,139,711,67,71.28
31,-4,0,31.0,-4.0,0.2668600082397461,1244.8642337901158,21,1276,-69,1598,609,139,711,67,75.67
34,-4,0,34.0,-4.0,0.2748560905456543,1210.6997226018827,21,1242,-65,1598,609,139,711,67,79.18
35,-2,0,35.0,-2.0,0.2828550338745117,1175.6430407692753,21,1207,-63,1598,609,139,711,67,81.26
37,-2,0,37.0,-2.0,0.2908670902252197,1138.5890917894378,21,1170,-61,1598,609,139,711,67,82.85
42,-3,0,42.0,-3.0,0.2988591194152832,1096.4901504661295,21,1128,-58,1598,609,139,711,67,86.33
44,-2,0,44.0,-2.0,0.3068511486053467,1052.4455306462871,21,1084,-56,1598,609,139,711,67,87.4
49,-4,0,49.0,-4.0,0.3148519992828369,1003.3054568996538,21,1035,-52,1598,609,139,711,67,89.18
53,-4,0,53.0,-4.0,0.32289695739746094,950.1724162119277,21,982,-48,1598,609,139,711,67,90.35
55,-5,0,55.0,-5.0,0.33112001419067383,894.9967672357485,21,927,-43,1598,609,139,711,67,88.5
57,-5,0,57.0,-5.0,0.33884501457214355,837.8294896246911,21,870,-38,1598,609,139,711,67,86.76
59,-5,0,59.0,-5.0,0.34714794158935547,778.6711156620026,21,811,-33,1598,609,139,711,67,84.56
56,-4,0,56.0,-4.0,0.35495901107788086,722.5567483650715,21,755,-29,1598,609,139,711,67,79.08
54,-4,0,54.0,-4.0,0.36291003227233887,668.4456500684853,21,701,-25,1598,609,139,711,67,73.93
53,-3,0,53.0,-3.0,0.37085509300231934,615.3733492363793,21,648,-22,1598,609,139,711,67,70.18
46,-2,0,46.0,-2.0,0.3788630962371826,569.3321342913725,21,602,-20,1598,609,139,711,67,62.79
43,-1,0,43.0,-1.0,0.3868529796600342,526.3228048274091,21,559,-19,1598,609,139,711,67,57.7
41,0,0,41.0,-0.0,0.3948490619659424,485.3483384751995,21,518,-19,1598,609,139,711,67,52.35
36,1,0,36.0,1.0,0.4029531478881836,449.4147593098702,21,482,-20,1598,609,139,711,67,45.55
33,2,0,33.0,2.0,0.410844087600708,416.53865239821147,21,449,-22,1598,609,139,711,67,40.59
32,0,0,32.0,-0.0,0.41891908645629883,384.5799324680246,21,417,-22,1598,609,139,711,67,38.81
28,0,0,28.0,-0.0,0.4271280765533447,356.62161131025573,21,389,-22,1598,609,139,711,67,34.05
23,0,0,23.0,-0.0,0.43485498428344727,333.6606060105176,21,366,-22,1598,609,139,711,67,28.84
22,0,0,22.0,-0.0,0.44286108016967773,311.70277051396033,21,344,-22,1598,609,139,711,67,26.8
18,-1,0,18.0,-1.0,0.45085597038269043,293.67568014775753,21,326,-21,1598,609,139,711,67,24.68
15,-1,0,15.0,-1.0,0.45906710624694824,278.64242329952447,21,311,-20,1598,609,139,711,67,22.07
11,0,0,11.0,-0.0,0.46694111824035645,267.66592756745814,21,300,-20,1598,609,139,711,67,15.75
9,0,0,9.0,-0.0,0.47492194175720215,258.6864755178066,21,291,-20,1598,609,139,711,67,13.64
6,0,0,6.0,-0.0,0.48294496536254883,252.70089254323307,21,285,-20,1598,609,139,711,67,10.65
7,0,0,7.0,-0.0,0.4908909797668457,245.71849597757233,21,278,-20,1598,609,139,711,67,11.42
7,0,0,7.0,-0.0,0.49890613555908203,238.7370052090808,21,271,-20,1598,609,139,711,67,11.23
8,0,0,8.0,-0.0,0.5069351196289062,230.75936002348806,21,263,-20,1598,609,139,711,67,11.87
9,-1,0,9.0,-1.0,0.514862060546875,221.70963860835735,21,254,-19,1598,609,139,711,67,13.37
10,-1,0,10.0,-1.0,0.522845983505249,211.6630335788388,21,244,-18,1598,609,139,711,67,14.17
9,-1,0,9.0,-1.0,0.530879020690918,202.61409125941512,21,235,-17,1598,609,139,711,67,12.72
8,-1,0,8.0,-1.0,0.5388650894165039,194.56317804073663,21,227,-16,1598,609,139,711,67,11.36
7,-1,0,7.0,-1.0,0.5468511581420898,187.51077071199947,21,220,-15,1598,609,139,711,67,10.05
7,-2,0,7.0,-2.0,0.5548429489135742,180.39634486091836,21,213,-13,1598,609,139,711,67,8.51
9,-2,0,9.0,-2.0,0.5628471374511719,171.29635336931494,21,204,-11,1598,609,139,711,67,9.98
11,-2,0,11.0,-2.0,0.5710821151733398,160.2097306038182,21,193,-9,1598,609,139,711,67,11.09
11,-2,0,11.0,-2.0,0.5788860321044922,149.13456563760764,21,182,-7,1598,609,139,711,67,10.56
9,-2,0,9.0,-2.0,0.5869121551513672,140.07223925286226,21,173,-5,1598,609,139,711,67,8.71
9,-2,0,9.0,-2.0,0.5948741436004639,131.02743672934722,21,164,-3,1598,609,139,711,67,8.31
7,-2,0,7.0,-2.0,0.6028590202331543,124.00318468107582,21,157,-1,1598,609,139,711,67,6.61
5,-1,0,5.0,-1.0,0.6109371185302734,119.0,21,152,0,1598,609,139,711,67,5.86
4,-2,0,4.0,-2.0,0.6188499927520752,115.0135128966271,21,148,2,1598,609,139,711,67,4.0
2,0,0,2.0,-0.0,0.6268589496612549,113.01369798755184,21,146,2,1598,609,139,711,67,7.01
1,-1,0,1.0,-1.0,0.6348531246185303,112.03103116229988,21,145,3,1598,609,139,711,67,1.61
1,0,0,1.0,-0.0,0.650846004486084,111.03124660989366,21,144,3,1598,609,139,711,67,6.1
2,-1,0,2.0,-1.0,0.6588690280914307,109.0563268566381,21,142,4,1598,609,139,711,67,2.83
3,-1,0,3.0,-1.0,0.666841983795166,106.08989898623119,21,139,5,1598,609,139,711,67,3.75
3,-1,0,3.0,-1.0,0.6748509407043457,103.13228860193308,21,136,6,1598,609,139,711,67,3.68
2,-1,0,2.0,-1.0,0.6828429698944092,101.18271125595876,21,134,7,1598,609,139,711,67,2.67
3,-1,0,3.0,-1.0,0.6911871433258057,98.24404748406687,21,131,8,1598,609,139,711,67,3.54
3,-1,0,3.0,-1.0,0.6988439559936523,95.31601614763451,21,128,9,1598,609,139,711,67,3.46
5,-1,0,5.0,-1.0,0.7068619728088379,90.40583454602137,21,123,10,1598,609,139,711,67,4.71
5,0,0,5.0,-0.0,0.7148699760437012,85.4229707446997,21,118,10,1598,609,139,711,67,6.21
7,-1,0,7.0,-1.0,0.7229001522064209,78.5437134042076,21,111,11,1598,609,139,711,67,5.34
10,-1,0,10.0,-1.0,0.7308609485626221,68.71037311896953,21,101,12,1598,609,139,711,67,6.07
9,0,0,9.0,-0.0,0.7388410568237305,59.77930803794561,21,92,12,1598,609,139,711,67,6.14
8,0,0,8.0,-0.0,0.7468550205230713,51.852813742385706,21,84,12,1598,609,139,711,67,5.45
7,-1,0,7.0,-1.0,0.7549731731414795,45.08969202141856,21,77,13,1598,609,139,711,67,3.85
7,0,0,7.0,-0.0,0.7630090713500977,38.19691004531025,21,70,13,1598,609,139,711,67,4.36
9,0,0,9.0,-0.0,0.7708430290222168,29.369864518050704,21,61,13,1598,609,139,711,67,4.13
9,0,0,9.0,-0.0,0.7789700031280518,20.600373133029585,21,52,13,1598,609,139,711,67,3.5
9,0,0,9.0,-0.0,0.7869241237640381,11.922154890432402,21,43,13,1598,609,139,711,67,2.81
9,0,0,9.0,-0.0,0.7949490547180176,3.400549446402593,21,34,13,1598,609,139,711,67,2.04
6,0,0,6.0,-0.0,0.8028609752655029,-2.129301919133738,21,28,13,1598,609,139,711,67,1.43
2,0,0,2.0,-0.0,0.810858964920044,-3.9311162925027325,21,26,13,1598,609,139,711,67,1.47
0,0,1,-0.0,-0.0,0.8328549861907959,-3.9311162925027325,21,26,13,1598,609,139,711,67,25.8
0,0,0,-0.0,-0.0,0.07459807395935059,549.404996434298,22,248,507,1820,1103,1572,596,30,143.64
-1,0,0,-1.0,-0.0,0.10359001159667969,549.8451115128819,22,249,507,1820,1103,1572,596,30,10.25
-1,0,0,-1.0,-0.0,0.1116030216217041,550.2866529469806,22,250,507,1820,1103,1572,596,30,10.23
-2,0,0,-2.0,-0.0,0.12756705284118652,551.1740015225001,22,252,507,1820,1103,1572,596,30,5.56
-3,1,0,-3.0,1.0,0.13559508323669434,551.6224492552338,22,255,506,1820,1103,1572,596,30,9.72
-4,0,0,-4.0,-0.0,0.14360713958740234,553.4338132095944,22,259,506,1820,1103,1572,596,30,3.05
-5,2,0,-5.0,2.0,0.15161514282226562,553.9569403742255,22,264,504,1820,1103,1572,596,30,8.39
-6,1,0,-6.0,1.0,0.15957999229431152,555.8844016085918,22,270,503,1820,1103,1572,596,30,2.69
-9,1,0,-9.0,1.0,0.16766715049743652,559.3213386249896,22,279,502,1820,1103,1572,596,30,1.7
-12,1,0,-12.0,1.0,0.1756131649017334,564.3807038554183,22,291,501,1820,1103,1572,596,30,1.28
-14,2,0,-14.0,2.0,0.18363714218139648,569.8298897970246,22,305,499,1820,1103,1572,596,30,1.14
-16,3,0,-16.0,3.0,0.19158315658569336,575.8104603000864,22,321,496,1820,1103,1572,596,30,1.02
-16,5,0,-16.0,5.0,0.19958710670471191,580.5249784853696,22,337,491,1820,1103,1572,596,30,1.13
-14,6,0,-14.0,6.0,0.20760011672973633,583.686896465924,22,351,485,1820,1103,1572,596,30,1.58
-14,9,0,-14.0,9.0,0.21557998657226562,584.8341437430851,22,365,476,1820,1103,1572,596,30,3.98
-12,10,0,-12.0,10.0,0.22360610961914062,584.4038705247073,22,377,466,1820,1103,1572,596,30,1.97
-9,12,0,-9.0,12.0,0.23157811164855957,580.912745290785,22,386,454,1820,1103,1572,596,30,14.95
-7,12,0,-7.0,12.0,0.23961114883422852,576.4499133485439,22,393,442,1820,1103,1572,596,30,18.55
-2,12,0,-2.0,12.0,0.24773502349853516,568.8878316937253,22,395,430,1820,1103,1572,596,30,28.92
3,10,0,3.0,10.0,0.2556290626525879,559.5119668031293,22,392,420,1820,1103,1572,596,30,34.68
6,10,0,6.0,10.0,0.26357412338256836,548.1127773368315,22,386,410,1820,1103,1572,596,30,40.35
8,10,0,8.0,10.0,0.2715890407562256,535.3489801934769,22,378,400,1820,1103,1572,596,30,44.1
10,11,0,10.0,11.0,0.279587984085083,520.4857607817411,22,368,389,1820,1103,1572,596,30,49.17
12,13,0,12.0,13.0,0.28757309913635254,502.79532635975,22,356,376,1820,1103,1572,596,30,53.6
14,12,0,14.0,12.0,0.2957301139831543,484.4597080846462,22,342,364,1820,1103,1572,596,30,51.24
15,15,0,15.0,15.0,0.30359911918640137,463.25725295075245,22,327,349,1820,1103,1572,596,30,55.43
19,15,0,19.0,15.0,0.31160902976989746,439.33467840348703,22,308,334,1820,1103,1572,596,30,55.14
18,16,0,18.0,16.0,0.3196439743041992,415.37657928841804,22,290,318,1820,1103,1572,596,30,53.72
21,16,0,21.0,16.0,0.32761096954345703,389.4317000434066,22,269,302,1820,1103,1572,596,30,52.79
21,18,0,21.0,18.0,0.3355591297149658,362.04111181673545,22,248,284,1820,1103,1572,596,30,52.01
20,17,0,20.0,17.0,0.3435859680175781,336.10254912204783,22,228,267,1820,1103,1572,596,30,48.03
17,17,0,17.0,17.0,0.3515770435333252,312.14064253773176,22,211,250,1820,1103,1572,596,30,44.72
16,15,0,16.0,15.0,0.35958313941955566,290.3686296920494,22,195,235,1820,1103,1572,596,30,40.06
16,17,0,16.0,17.0,0.36759519577026367,267.07268566807386,22,179,218,1820,1103,1572,596,30,39.98
15,14,0,15.0,14.0,0.3755760192871094,246.74797038372617,22,164,204,1820,1103,1572,596,30,34.4
16,15,0,16.0,15.0,0.3835911750793457,225.05207768315609,22,148,189,1820,1103,1572,596,30,33.32
15,14,0,15.0,14.0,0.39168310165405273,204.80445855350615,22,133,175,1820,1103,1572,596,30,29.96
15,15,0,15.0,15.0,0.39957404136657715,183.80643852752857,22,118,160,1820,1103,1572,596,30,28.49
16,15,0,16.0,15.0,0.4075801372528076,162.28226081590904,22,102,145,1820,1103,1572,596,30,26.04
16,13,0,16.0,13.0,0.4156839847564697,142.54364474646383,22,86,132,1820,1103,1572,596,30,22.13
14,11,0,14.0,11.0,0.42357516288757324,125.80127840328723,22,72,121,1820,1103,1572,596,30,18.26
12,11,0,12.0,11.0,0.43156909942626953,110.29964086141668,22,60,110,1820,1103,1572,596,30,16.08
12,11,0,12.0,11.0,0.4396541118621826,95.02272492535349,22,48,99,1820,1103,1572,596,30,14.19
10,7,0,10.0,7.0,0.4476051330566406,84.53893710503444,22,38,92,1820,1103,1572,596,30,9.9
7,8,0,7.0,8.0,0.4555799961090088,74.5377015563835,22,31,84,1820,1103,1572,596,30,9.47
7,7,0,7.0,7.0,0.46366119384765625,65.65358020571685,22,24,77,1820,1103,1572,596,30,7.75
6,8,0,6.0,8.0,0.47163915634155273,56.30918594402827,22,18,69,1820,1103,1572,596,30,7.57
5,6,0,5.0,6.0,0.4795870780944824,49.32728814430156,22,13,63,1820,1103,1572,596,30,5.6
3,4,0,3.0,4.0,0.4875831604003906,44.841457201508724,22,10,59,1820,1103,1572,596,30,4.2
2,3,0,2.0,3.0,0.4956481456756592,41.568542494923804,22,8,56,1820,1103,1572,596,30,3.57
0,3,0,-0.0,3.0,0.5035820007324219,38.600373133029585,22,8,53,1820,1103,1572,596,30,4.85
0,2,0,-0.0,2.0,0.5115861892700195,36.62363799656123,22,8,51,1820,1103,1572,596,30,4.27
0,3,0,-0.0,3.0,0.5195701122283936,33.662100242385755,22,8,48,1820,1103,1572,596,30,4.54
1,4,0,1.0,4.0,0.5277411937713623,29.553338819890925,22,7,44,1820,1103,1572,596,30,5.66
0,3,0,-0.0,3.0,0.5355820655822754,26.593268686170845,22,7,41,1820,1103,1572,596,30,4.24
1,1,0,1.0,1.0,0.5436279773712158,25.44749683231337,22,6,40,1820,1103,1572,596,30,1.72
0,2,0,-0.0,2.0,0.5516190528869629,23.470768123342687,22,6,38,1820,1103,1572,596,30,3.91
1,4,0,1.0,4.0,0.559589147567749,19.365680554879162,22,5,34,1820,1103,1572,596,30,4.98
2,2,0,2.0,2.0,0.5675849914550781,17.140317359976393,22,3,32,1820,1103,1572,596,30,1.62
1,4,0,1.0,4.0,0.5755801200866699,13.071337695236398,22,2,28,1820,1103,1572,596,30,3.85
1,3,0,1.0,3.0,0.5836000442504883,10.019992006393608,22,1,25,1820,1103,1572,596,30,2.81
1,2,0,1.0,2.0,0.5916061401367188,8.0,22,0,23,1820,1103,1572,596,30,1.85
1,2,0,1.0,2.0,0.5995800495147705,6.023796041628639,22,-1,21,1820,1103,1572,596,30,1.61
1,1,0,1.0,1.0,0.6075911521911621,5.09975124224178,22,-2,20,1820,1103,1572,596,30,0.7
0,1,0,-0.0,1.0,0.6156430244445801,4.104973174542799,22,-2,19,1820,1103,1572,596,30,3.74
0,1,0,-0.0,1.0,0.6236281394958496,3.1107702762748346,22,-2,18,1820,1103,1572,596,30,3.64
0,1,0,-0.0,1.0,0.6316201686859131,2.11724276862369,22,-2,17,1820,1103,1572,596,30,3.53
0,1,0,-0.0,1.0,0.6395711898803711,1.1245154965970983,22,-2,16,1820,1103,1572,596,30,3.42
0,1,0,-0.0,1.0,0.6476070880889893,0.13274595042155646,22,-2,15,1820,1103,1572,596,30,3.29
-1,1,0,-1.0,1.0,0.6555681228637695,-0.964331152381801,22,-1,14,1820,1103,1572,596,30,0.8
-1,2,0,-1.0,2.0,0.6635751724243164,-3.0,22,0,12,1820,1103,1572,596,30,1.24
-1,2,0,-1.0,2.0,0.6716411113739014,-4.95012437887911,22,1,10,1820,1103,1572,596,30,0.78
-1,1,0,-1.0,1.0,0.6797060966491699,-5.780455542707113,22,2,9,1820,1103,1572,596,30,-0.03
-1,1,0,-1.0,1.0,0.6877200603485107,-6.45599625468247,22,3,8,1820,1103,1572,596,30,-0.29
-1,1,0,-1.0,1.0,0.6955971717834473,-6.937742251701451,22,4,7,1820,1103,1572,596,30,-0.53
0,1,0,-0.0,1.0,0.7035861015319824,-7.788897449072022,22,4,6,1820,1103,1572,596,30,0.73
0,1,0,-0.0,1.0,0.7115809917449951,-8.596875762567151,22,4,5,1820,1103,1572,596,30,0.45
-1,1,0,-1.0,1.0,0.7196149826049805,-8.596875762567151,22,5,4,1820,1103,1572,596,30,6.77
-1,1,0,-1.0,1.0,0.7275981903076172,-8.29179606750063,22,6,3,1820,1103,1572,596,30,-0.26
-1,1,0,-1.0,1.0,0.7356100082397461,-7.719890110719482,22,7,2,1820,1103,1572,596,30,-0.39
0,2,0,-0.0,2.0,0.7437241077423096,-8.0,22,7,0,1820,1103,1572,596,30,-1.16
0,0,1,-0.0,-0.0,0.7489500045776367,-8.0,22,7,0,1820,1103,1572,596,30,24.66
0,1,1,-0.0,1.0,0.7597739696502686,-7.9289321881345245,22,7,-1,1820,1103,1572,596,30,11.78
-1,0,1,-1.0,-0.0,0.7676200866699219,-6.937742251701451,22,8,-1,1820,1103,1572,596,30,12.65
0,0,0,-0.0,-0.0,0.8386070728302002,-6.937742251701451,22,8,-1,1820,1103,1572,596,30,14.96
-1,0,0,-1.0,-0.0,0.8555870056152344,-5.944614861862583,22,9,-1,1820,1103,1572,596,30,2.93
-1,0,0,-1.0,-0.0,0.8635871410369873,-4.95012437887911,22,10,-1,1820,1103,1572,596,30,3.16
-2,-1,0,-2.0,-1.0,0.8715779781341553,-3.0,22,12,0,1820,1103,1572,596,30,0.3
-3,-3,0,-3.0,-3.0,0.8795909881591797,0.29705854077835525,22,15,3,1820,1103,1572,596,30,-0.57
-4,-5,0,-4.0,-5.0,0.8875961303710938,5.615528128088304,22,19,8,1820,1103,1572,596,30,-0.57
-5,-8,0,-5.0,-8.0,0.8956000804901123,13.844410203711913,22,24,16,1820,1103,1572,596,30,-0.48
-9,-10,0,-9.0,-10.0,0.9035830497741699,27.01190307520001,22,33,26,1820,1103,1572,596,30,0.77
-11,-13,0,-11.0,-13.0,0.9115810394287109,43.7962583843564,22,44,39,1820,1103,1572,596,30,1.18
-14,-15,0,-14.0,-15.0,0.9196460247039795,64.2464510246358,22,58,54,1820,1103,1572,596,30,2.34
-16,-16,0,-16.0,-16.0,0.9275879859924316,86.86265262597475,22,74,70,1820,1103,1572,596,30,3.77
-17,-17,0,-17.0,-17.0,0.9355900287628174,110.89678312014172,22,91,87,1820,1103,1572,596,30,4.21
-17,-13,0,-17.0,-13.0,0.9435920715332031,132.18695594379278,22,108,100,1820,1103,1572,596,30,2.68
-13,-12,0,-13.0,-12.0,0.9515800476074219,149.87874332369228,22,121,112,1820,1103,1572,596,30,6.5
-10,-9,0,-10.0,-9.0,0.9598720073699951,163.33115263464205,22,131,121,1820,1103,1572,596,30,5.52
-6,-7,0,-6.0,-7.0,0.9676220417022705,172.49133313302778,22,137,128,1820,1103,1572,596,30,3.41
-4,-5,0,-4.0,-5.0,0.9755761623382568,178.82982226685345,22,141,133,1820,1103,1572,596,30,3.38
-1,-3,0,-1.0,-3.0,0.9835851192474365,181.6214637317096,22,142,136,1820,1103,1572,596,30,2.31
-2,-4,0,-2.0,-4.0,0.9915821552276611,185.83824337013107,22,144,140,1820,1103,1572,596,30,2.5
-2,-4,0,-2.0,-4.0,0.9996001720428467,190.06584308460538,22,146,144,1820,1103,1572,596,30,2.54
-3,-5,0,-3.0,-5.0,1.007585048675537,195.71782079359116,22,149,149,1820,1103,1572,596,30,2.75
-4,-7,0,-4.0,-7.0,1.0155820846557617,203.50629281556172,22,153,156,1820,1103,1572,596,30,2.49
-6,-10,0,-6.0,-10.0,1.0236690044403076,214.86300267768192,22,159,166,1820,1103,1572,596,30,2.44
-8,-10,0,-8.0,-10.0,1.0315971374511719,227.62110378118388,22,167,176,1820,1103,1572,596,30,3.7
-8,-8,0,-8.0,-8.0,1.0395829677581787,238.9310930154084,22,175,184,1820,1103,1572,596,30,5.2
-6,-4,0,-6.0,-4.0,1.0475831031799316,245.96934685897497,22,181,188,1820,1103,1572,596,30,2.9
-2,-3,0,-2.0,-3.0,1.0556330680847168,249.51843035977663,22,183,191,1820,1103,1572,596,30,3.72
1,0,0,1.0,-0.0,1.1116039752960205,248.8275952208184,22,182,191,1820,1103,1572,596,30,2.81
4,2,0,4.0,2.0,1.1195800304412842,244.6247291765559,22,178,189,1820,1103,1572,596,30,11.61
4,5,0,4.0,5.0,1.1275920867919922,238.24296633865274,22,174,184,1820,1103,1572,596,30,17.26
6,8,0,6.0,8.0,1.1356241703033447,228.3105012119288,22,168,176,1820,1103,1572,596,30,21.69
9,11,0,9.0,11.0,1.1435761451721191,214.14187744713973,22,159,165,1820,1103,1572,596,30,26.26
12,16,0,12.0,16.0,1.15159010887146,194.3083849252103,22,147,149,1820,1103,1572,596,30,28.88
15,19,0,15.0,19.0,1.1595771312713623,170.26737435393204,22,132,130,1820,1103,1572,596,30,29.16
17,19,0,17.0,19.0,1.1676101684570312,144.8311609167624,22,115,111,1820,1103,1572,596,30,27.49
18,19,0,18.0,19.0,1.1757111549377441,118.68993978605869,22,97,92,1820,1103,1572,596,30,24.78
20,18,0,20.0,18.0,1.1836681365966797,91.7941945987702,22,77,74,1820,1103,1572,596,30,21.92
18,14,0,18.0,14.0,1.1918580532073975,69.1486779456457,22,59,60,1820,1103,1572,596,30,15.54
16,13,0,16.0,13.0,1.199601173400879,48.702433234531945,22,43,47,1820,1103,1572,596,30,11.98
13,9,0,13.0,9.0,1.2076339721679688,33.41487374764082,22,30,38,1820,1103,1572,596,30,7.72
10,8,0,10.0,8.0,1.2155630588531494,21.055512754639892,22,20,30,1820,1103,1572,596,30,5.57
9,7,0,9.0,7.0,1.2235891819000244,10.495097567963924,22,11,23,1820,1103,1572,596,30,3.47
6,4,0,6.0,4.0,1.2315881252288818,4.646882704388499,22,5,19,1820,1103,1572,596,30,1.42
3,3,0,3.0,3.0,1.2398881912231445,1.1245154965970983,22,2,16,1820,1103,1572,596,30,1.01
-2,0,0,-2.0,-0.0,1.263700008392334,1.4924225024706423,22,4,16,1820,1103,1572,596,30,0.28
-3,0,0,-3.0,-0.0,1.271806001663208,2.464249196572979,22,7,16,1820,1103,1572,596,30,-0.42
-4,0,0,-4.0,-0.0,1.2797160148620605,4.416487838947599,22,11,16,1820,1103,1572,596,30,-0.62
-4,0,0,-4.0,-0.0,1.28757905960083,6.931712199461309,22,15,16,1820,1103,1572,596,30,-0.35
-4,0,0,-4.0,-0.0,1.2955970764160156,9.839484696748443,22,19,16,1820,1103,1572,596,30,-0.06
-5,0,0,-5.0,-0.0,1.3036580085754395,13.844410203711913,22,24,16,1820,1103,1572,596,30,0.05
-4,0,0,-4.0,-0.0,1.3116040229797363,17.249030993194197,22,28,16,1820,1103,1572,596,30,0.58
-4,0,0,-4.0,-0.0,1.3196041584014893,20.777087639996637,22,32,16,1820,1103,1572,596,30,0.83
-3,0,0,-3.0,-0.0,1.3276171684265137,23.483762809787713,22,35,16,1820,1103,1572,596,30,1.28
-3,0,0,-3.0,-0.0,1.3355660438537598,26.231056256176608,22,38,16,1820,1103,1572,596,30,1.44
-3,1,0,-3.0,1.0,1.343583106994629,28.657759905886145,22,41,15,1820,1103,1572,596,30,0.78
-2,0,0,-2.0,-0.0,1.351607084274292,30.541190146942803,22,43,15,1820,1103,1572,596,30,2.09
-1,0,0,-1.0,-0.0,1.367577075958252,31.486557196677836,22,44,15,1820,1103,1572,596,30,2.71
0,0,1,-0.0,-0.0,1.3905971050262451,31.486557196677836,22,44,15,1820,1103,1572,596,30,26.41
0,0,0,-0.0,-0.0,1.4815990924835205,31.486557196677836,22,44,15,1820,1103,1572,596,30,26.41
0,1,0,-0.0,1.0,1.4875831604003906,31.173585522460783,22,44,14,1820,1103,1572,596,30,0.46
0,1,0,-0.0,1.0,1.5357000827789307,30.880278987817846,22,44,13,1820,1103,1572,596,30,0.42
2,1,0,2.0,1.0,1.551584005355835,28.68065933568311,22,42,12,1820,1103,1572,596,30,3.91
1,1,0,1.0,1.0,1.5595941543579102,27.449970553582247,22,41,11,1820,1103,1572,596,30,2.08
1,1,0,1.0,1.0,1.5675840377807617,26.231056256176608,22,40,10,1820,1103,1572,596,30,2.0
2,1,0,2.0,1.0,1.5755760669708252,24.05124837953327,22,38,9,1820,1103,1572,596,30,3.46
2,2,0,2.0,2.0,1.583583116531372,21.674241641784498,22,36,7,1820,1103,1572,596,30,2.07
2,2,0,2.0,2.0,1.5916080474853516,19.365680554879162,22,34,5,1820,1103,1572,596,30,1.85
4,3,0,4.0,3.0,1.5996191501617432,15.066592756745816,22,30,2,1820,1103,1572,596,30,2.26
3,3,0,3.0,3.0,1.607652187347412,12.018512172212592,22,27,-1,1820,1103,1572,596,30,1.25
2,3,0,2.0,3.0,1.6156740188598633,10.317977802344327,22,25,-4,1820,1103,1572,596,30,0.35
2,2,0,2.0,2.0,1.623622179031372,8.769728648009426,22,23,-6,1820,1103,1572,596,30,0.49
4,2,0,4.0,2.0,1.6316540241241455,5.615528128088304,22,19,-8,1820,1103,1572,596,30,0.82
2,3,0,2.0,3.0,1.6395840644836426,5.248456731316587,22,17,-11,1820,1103,1572,596,30,-0.71
2,3,0,2.0,3.0,1.647632122039795,5.518284528683193,22,15,-14,1820,1103,1572,596,30,0.37
2,3,0,2.0,3.0,1.655616044998169,6.400934559032695,22,13,-17,1820,1103,1572,596,30,-0.38
0,0,1,-0.0,-0.0,1.659576177597046,6.400934559032695,22,13,-17,1820,1103,1572,596,30,28.81
2,2,1,2.0,2.0,1.663586139678955,6.9544984001001495,22,11,-19,1820,1103,1572,596,30,10.05
2,2,1,2.0,2.0,1.671638011932373,7.847319317591726,22,9,-21,1820,1103,1572,596,30,9.92
0,1,1,-0.0,1.0,1.6795899868011475,8.769728648009426,22,9,-22,1820,1103,1572,596,30,12.02
0,0,0,-0.0,-0.0,1.7235980033874512,8.769728648009426,22,9,-22,1820,1103,1572,596,30,19.51
0,0,1,-0.0,-0.0,1.817600965499878,8.769728648009426,22,9,-22,1820,1103,1572,596,30,29.51
-1,0,1,-1.0,-0.0,0.029191017150878906,1540.5676208057748,23,-1155,-1024,655,101,1811,1125,6,29.36
0,1,1,-0.0,1.0,0.0372769832611084,1541.2312003064826,23,-1155,-1025,655,101,1811,1125,6,51.95
-1,0,1,-1.0,-0.0,0.04526495933532715,1540.4833980318674,23,-1154,-1025,655,101,1811,1125,6,29.34
-2,0,1,-2.0,-0.0,0.05316495895385742,1538.988651060701,23,-1152,-1025,655,101,1811,1125,6,51.79
-1,1,1,-1.0,1.0,0.06116890907287598,1538.9069362318855,23,-1151,-1026,655,101,1811,1125,6,3.59
-1,0,1,-1.0,-0.0,0.06940793991088867,1538.1606016246328,23,-1150,-1026,655,101,1811,1125,6,29.26
0,0,0,-0.0,-0.0,0.07212400436401367,1538.1606016246328,23,-1150,-1026,655,101,1811,1125,6,260.14
-1,0,0,-1.0,-0.0,0.08514809608459473,1537.4145545923668,23,-1149,-1026,655,101,1811,1125,6,29.25
-1,0,0,-1.0,-0.0,0.09315800666809082,1536.6687955531215,23,-1148,-1026,655,101,1811,1125,6,29.23
0,-1,0,-0.0,-1.0,0.10121393203735352,1536.0025990881236,23,-1148,-1025,655,101,1811,1125,6,26.33
0,-1,0,-0.0,-1.0,0.11715888977050781,1535.3367641709665,23,-1148,-1024,655,101,1811,1125,6,26.31
0,-1,0,-0.0,-1.0,0.1251540184020996,1534.6712912713172,23,-1148,-1023,655,101,1811,1125,6,26.29
0,-2,0,-0.0,-2.0,0.13352704048156738,1533.3414334059992,23,-1148,-1021,655,101,1811,1125,6,46.92
0,-1,0,-0.0,-1.0,0.14114689826965332,1532.677049382454,23,-1148,-1020,655,101,1811,1125,6,26.23
1,-2,0,1.0,-2.0,0.14915704727172852,1532.097716759425,23,-1149,-1018,655,101,1811,1125,6,22.66
1,-1,0,1.0,-1.0,0.15714693069458008,1532.1837023626847,23,-1150,-1017,655,101,1811,1125,6,167.06
0,-1,0,-0.0,-1.0,0.16514205932617188,1531.5214237670323,23,-1150,-1016,655,101,1811,1125,6,26.15
1,0,0,1.0,-0.0,0.18120908737182617,1532.270985852335,23,-1151,-1016,655,101,1811,1125,6,47.25
0,-1,0,-0.0,-1.0,0.22116899490356445,1531.6093965566613,23,-1151,-1015,655,101,1811,1125,6,26.12
0,-1,0,-0.0,-1.0,0.22913908958435059,1530.948173831176,23,-1151,-1014,655,101,1811,1125,6,26.1
-2,-3,0,-2.0,-3.0,0.23714995384216309,1527.4646353313753,23,-1149,-1011,655,101,1811,1125,6,95.39
-2,-3,0,-2.0,-3.0,0.2451479434967041,1523.9816632821758,23,-1147,-1008,655,101,1811,1125,6,95.26
-4,-5,0,-4.0,-5.0,0.2531599998474121,1517.676822996918,23,-1143,-1003,655,101,1811,1125,6,132.08
-5,-6,0,-5.0,-6.0,0.2611379623413086,1509.961665079456,23,-1138,-997,655,101,1811,1125,6,144.45
-7,-10,0,-7.0,-10.0,0.2691490650177002,1498.1095896036372,23,-1131,-987,655,101,1811,1125,6,168.58
-15,-14,0,-15.0,-14.0,0.2771918773651123,1477.602917733178,23,-1116,-973,655,101,1811,1125,6,196.89
-23,-20,0,-23.0,-20.0,0.2851579189300537,1447.1234430213174,23,-1093,-953,655,101,1811,1125,6,211.45
-29,-26,0,-29.0,-26.0,0.29314303398132324,1408.178585438427,23,-1064,-927,655,101,1811,1125,6,215.02
-39,-32,0,-39.0,-32.0,0.3011970520019531,1357.753467752333,23,-1025,-895,655,101,1811,1125,6,216.57
-48,-34,0,-48.0,-34.0,0.30924010276794434,1299.2480562473495,23,-977,-861,655,101,1811,1125,6,213.04
-52,-33,0,-52.0,-33.0,0.31717991828918457,1238.4543890131445,23,-925,-828,655,101,1811,1125,6,207.59
-52,-29,0,-52.0,-29.0,0.32524991035461426,1180.439901304667,23,-873,-799,655,101,1811,1125,6,200.79
-51,-27,0,-51.0,-27.0,0.3331470489501953,1124.6825794522144,23,-822,-772,655,101,1811,1125,6,194.46
-44,-24,0,-44.0,-24.0,0.34116101264953613,1076.25344567437,23,-778,-748,655,101,1811,1125,6,186.96
-39,-24,0,-39.0,-24.0,0.34915709495544434,1031.5515936868494,23,-739,-724,655,101,1811,1125,6,181.08
-36,-23,0,-36.0,-23.0,0.35715293884277344,989.7789280600188,23,-703,-701,655,101,1811,1125,6,175.43
-30,-21,0,-30.0,-21.0,0.3651449680328369,953.7282790845057,23,-673,-680,655,101,1811,1125,6,168.65
-28,-19,0,-28.0,-19.0,0.37314796447753906,920.5507565911037,23,-645,-661,655,101,1811,1125,6,163.07
-26,-22,0,-26.0,-22.0,0.38115406036376953,886.6527412423344,23,-619,-639,655,101,1811,1125,6,160.93
-25,-20,0,-25.0,-20.0,0.38917088508605957,854.9026751327915,23,-594,-619,655,101,1811,1125,6,155.6
-23,-20,0,-23.0,-20.0,0.3971590995788574,824.5518110668359,23,-571,-599,655,101,1811,1125,6,151.64
-23,-20,0,-23.0,-20.0,0.40517306327819824,794.2107625966925,23,-548,-579,655,101,1811,1125,6,148.21
-20,-20,0,-20.0,-20.0,0.4132850170135498,765.9375787409534,23,-528,-559,655,101,1811,1125,6,144.74
-16,-19,0,-16.0,-19.0,0.4211549758911133,741.1397718170962,23,-512,-540,655,101,1811,1125,6,137.87
-15,-20,0,-15.0,-20.0,0.42914891242980957,716.3114763438715,23,-497,-520,655,101,1811,1125,6,134.19
-13,-20,0,-13.0,-20.0,0.4371669292449951,692.8850479784718,23,-484,-500,655,101,1811,1125,6,129.38
-12,-21,0,-12.0,-21.0,0.44516611099243164,669.4767653978835,23,-472,-479,655,101,1811,1125,6,126.22
-12,-20,0,-12.0,-20.0,0.4532968997955322,646.8315166256558,23,-460,-459,655,101,1811,1125,6,122.77
-10,-19,0,-10.0,-19.0,0.46131110191345215,626.3647591023825,23,-450,-440,655,101,1811,1125,6,117.43
-11,-18,0,-11.0,-18.0,0.4691441059112549,605.9375994303522,23,-439,-422,655,101,1811,1125,6,115.2
-11,-16,0,-11.0,-16.0,0.4771749973297119,586.9321994941453,23,-428,-406,655,101,1811,1125,6,111.34
-12,-13,0,-12.0,-13.0,0.48535799980163574,569.2805256165896,23,-416,-393,655,101,1811,1125,6,108.72
-11,-11,0,-11.0,-11.0,0.49320387840270996,553.7306350471474,23,-405,-382,655,101,1811,1125,6,104.39
-10,-10,0,-10.0,-10.0,0.5011599063873291,539.5946921966708,23,-395,-372,655,101,1811,1125,6,100.05
-8,-8,0,-8.0,-8.0,0.509152889251709,528.2861752389197,23,-387,-364,655,101,1811,1125,6,92.24
-7,-8,0,-7.0,-8.0,0.5171589851379395,517.7072113961933,23,-380,-356,655,101,1811,1125,6,87.75
-6,-8,0,-6.0,-8.0,0.5251479148864746,507.86201659547953,23,-374,-348,655,101,1811,1125,6,83.75
-6,-8,0,-6.0,-8.0,0.5332510471343994,498.02295356600183,23,-368,-340,655,101,1811,1125,6,82.65
-5,-8,0,-5.0,-8.0,0.5411460399627686,488.92784023675665,23,-363,-332,655,101,1811,1125,6,78.77
-6,-9,0,-6.0,-9.0,0.5491409301757812,478.43327678921406,23,-357,-323,655,101,1811,1125,6,81.97
-6,-10,0,-6.0,-10.0,0.5572459697723389,467.28714632658205,23,-351,-313,655,101,1811,1125,6,82.12
-7,-9,0,-7.0,-9.0,0.5652070045471191,456.07733553291433,23,-344,-304,655,101,1811,1125,6,81.63
-8,-11,0,-8.0,-11.0,0.5731461048126221,442.80825474636515,23,-336,-293,655,101,1811,1125,6,84.17
-10,-11,0,-10.0,-11.0,0.5811560153961182,428.0452412450461,23,-326,-282,655,101,1811,1125,6,85.69
-11,-11,0,-11.0,-11.0,0.5891649723052979,412.5309856075717,23,-315,-271,655,101,1811,1125,6,85.34
-11,-10,0,-11.0,-10.0,0.5971500873565674,397.67068772247364,23,-304,-261,655,101,1811,1125,6,83.42
-11,-10,0,-11.0,-10.0,0.6051409244537354,382.8108344772085,23,-293,-251,655,101,1811,1125,6,81.32
-11,-9,0,-11.0,-9.0,0.6131560802459717,368.6019375622253,23,-282,-242,655,101,1811,1125,6,78.58
-9,-9,0,-9.0,-9.0,0.6214640140533447,355.91224554199874,23,-273,-233,655,101,1811,1125,6,73.03
-10,-10,0,-10.0,-10.0,0.6291570663452148,341.81589290518497,23,-263,-223,655,101,1811,1125,6,73.22
-8,-11,0,-8.0,-11.0,0.6371610164642334,328.6157414840255,23,-255,-212,655,101,1811,1125,6,68.5
-7,-11,0,-7.0,-11.0,0.6451799869537354,316.22562553780045,23,-248,-201,655,101,1811,1125,6,65.07
-8,-12,0,-8.0,-12.0,0.6531779766082764,302.48486050866745,23,-240,-189,655,101,1811,1125,6,65.09
-7,-11,0,-7.0,-11.0,0.6611490249633789,290.21152774063984,23,-233,-178,655,101,1811,1125,6,60.96
-9,-13,0,-9.0,-13.0,0.6694200038909912,275.2103520719529,23,-224,-165,655,101,1811,1125,6,62.34
-10,-13,0,-10.0,-13.0,0.6771600246429443,259.48809496813374,23,-214,-152,655,101,1811,1125,6,60.68
-11,-14,0,-11.0,-14.0,0.6851580142974854,242.46486510293076,23,-203,-138,655,101,1811,1125,6,58.92
-11,-13,0,-11.0,-13.0,0.6932010650634766,226.1047795223836,23,-192,-125,655,101,1811,1125,6,55.56
-9,-12,0,-9.0,-12.0,0.7012360095977783,212.07673049402624,23,-183,-113,655,101,1811,1125,6,50.58
-7,-11,0,-7.0,-11.0,0.7091529369354248,200.42074623793906,23,-176,-102,655,101,1811,1125,6,45.57
-6,-8,0,-6.0,-8.0,0.7171618938446045,191.25756098540927,23,-170,-94,655,101,1811,1125,6,40.7
-7,-8,0,-7.0,-8.0,0.7251689434051514,181.29595763336752,23,-163,-86,655,101,1811,1125,6,40.56
-5,-6,0,-5.0,-6.0,0.7331531047821045,174.09884245810304,23,-158,-80,655,101,1811,1125,6,34.6
-4,-5,0,-4.0,-5.0,0.7412939071655273,168.29214809792072,23,-154,-75,655,101,1811,1125,6,30.56
-5,-5,0,-5.0,-5.0,0.7491769790649414,161.62381358722072,23,-149,-70,655,101,1811,1125,6,31.98
-4,-3,0,-4.0,-3.0,0.7573349475860596,156.7310239120754,23,-145,-67,655,101,1811,1125,6,27.75
-3,-3,0,-3.0,-3.0,0.76521897315979,152.7562197795003,23,-142,-64,655,101,1811,1125,6,23.79
-2,-3,0,-2.0,-3.0,0.7731659412384033,149.7121475194426,23,-140,-61,655,101,1811,1125,6,19.52
-2,-3,0,-2.0,-3.0,0.7811429500579834,146.69301920931383,23,-138,-58,655,101,1811,1125,6,19.12
-4,-4,0,-4.0,-4.0,0.789146900177002,141.4714504668656,23,-134,-54,655,101,1811,1125,6,25.8
-3,-4,0,-3.0,-4.0,0.7971498966217041,137.21768789992225,23,-131,-50,655,101,1811,1125,6,22.27
-4,-5,0,-4.0,-5.0,0.8052570819854736,131.73678042761748,23,-127,-45,655,101,1811,1125,6,24.64
-4,-3,0,-4.0,-3.0,0.8133249282836914,126.9730741346068,23,-123,-42,655,101,1811,1125,6,23.21
-4,-4,0,-4.0,-4.0,0.8211469650268555,121.91997438360288,23,-119,-38,655,101,1811,1125,6,22.64
-4,-3,0,-4.0,-3.0,0.8296389579772949,117.20815280171308,23,-115,-35,655,101,1811,1125,6,21.71
-6,-4,0,-6.0,-4.0,0.8375020027160645,110.3225485064645,23,-109,-31,655,101,1811,1125,6,24.93
-5,-3,0,-5.0,-3.0,0.8451581001281738,104.70329614269008,23,-104,-28,655,101,1811,1125,6,22.19
-7,-3,0,-7.0,-3.0,0.8531630039215088,97.16985574512923,23,-97,-25,655,101,1811,1125,6,24.68
-8,-3,0,-8.0,-3.0,0.8611559867858887,88.67878707749138,23,-89,-22,655,101,1811,1125,6,24.65
-4,-3,0,-4.0,-3.0,0.8692400455474854,84.0976463516667,23,-85,-19,655,101,1811,1125,6,16.88
-2,-1,0,-2.0,-1.0,0.8771679401397705,81.92938243034621,23,-83,-18,655,101,1811,1125,6,11.72
-3,-1,0,-3.0,-1.0,0.8851699829101562,78.78630692236935,23,-80,-17,655,101,1811,1125,6,15.1
-4,-1,0,-4.0,-1.0,0.8932170867919922,74.6659513557904,23,-76,-16,655,101,1811,1125,6,17.98
-5,-1,0,-5.0,-1.0,0.9011809825897217,69.56721022610694,23,-71,-15,655,101,1811,1125,6,20.05
-6,-2,0,-6.0,-2.0,0.9092140197753906,63.2872536767062,23,-65,-13,655,101,1811,1125,6,17.93
-6,-1,0,-6.0,-1.0,0.9172160625457764,57.207972893961475,23,-59,-12,655,101,1811,1125,6,18.31
-3,-1,0,-3.0,-1.0,0.9251658916473389,54.0701322935211,23,-56,-11,655,101,1811,1125,6,12.24
-3,-1,0,-3.0,-1.0,0.9331600666046143,50.9351462406472,23,-53,-10,655,101,1811,1125,6,11.81
-3,-1,0,-3.0,-1.0,0.9411799907684326,47.80354318352215,23,-50,-9,655,101,1811,1125,6,11.37
-1,0,0,-1.0,-0.0,0.9491879940032959,46.8196748283246,23,-49,-9,655,101,1811,1125,6,6.36
-2,-1,0,-2.0,-1.0,0.9571518898010254,44.67598976424087,23,-47,-8,655,101,1811,1125,6,8.29
-2,0,0,-2.0,-0.0,0.9651389122009277,42.70557952810576,23,-45,-8,655,101,1811,1125,6,8.48
-3,-1,0,-3.0,-1.0,0.9731550216674805,39.579337712087536,23,-42,-7,655,101,1811,1125,6,10.31
-3,-1,0,-3.0,-1.0,0.9812419414520264,36.45883931389772,23,-39,-6,655,101,1811,1125,6,9.83
-4,-1,0,-4.0,-1.0,0.9891479015350342,32.35533905932738,23,-35,-5,655,101,1811,1125,6,11.14
-4,-1,0,-4.0,-1.0,0.997154951095581,28.25699921617557,23,-31,-4,655,101,1811,1125,6,10.39
-3,-1,0,-3.0,-1.0,1.0051589012145996,25.160255680657446,23,-28,-3,655,101,1811,1125,6,8.1
-3,-1,0,-3.0,-1.0,1.0131828784942627,22.079872407968907,23,-25,-2,655,101,1811,1125,6,7.53
-2,0,0,-2.0,-0.0,1.0211999416351318,20.08679276123039,23,-23,-2,655,101,1811,1125,6,7.45
-2,-1,0,-2.0,-1.0,1.029252052307129,18.02379604162864,23,-21,-1,655,101,1811,1125,6,5.16
-1,0,0,-1.0,-0.0,1.0771501064300537,17.024984394500787,23,-20,-1,655,101,1811,1125,6,6.49
-1,0,0,-1.0,-0.0,1.0851519107818604,16.026297590440446,23,-19,-1,655,101,1811,1125,6,6.37
-1,-1,0,-1.0,-1.0,1.093214988708496,15.0,23,-18,0,655,101,1811,1125,6,2.6
-2,0,0,-2.0,-0.0,1.1011691093444824,13.0,23,-16,0,655,101,1811,1125,6,10.18
-1,0,0,-1.0,-0.0,1.1172840595245361,12.0,23,-15,0,655,101,1811,1125,6,8.62
-1,0,0,-1.0,-0.0,1.1571629047393799,11.0,23,-14,0,655,101,1811,1125,6,8.58
0,-1,0,-0.0,-1.0,1.1654589176177979,11.035668847618199,23,-14,1,655,101,1811,1125,6,10.76
-1,0,0,-1.0,-0.0,1.1731998920440674,10.038404810405298,23,-13,1,655,101,1811,1125,6,5.49
-1,0,0,-1.0,-0.0,1.1811699867248535,9.041594578792296,23,-12,1,655,101,1811,1125,6,5.31
-1,0,0,-1.0,-0.0,1.1891529560089111,8.045361017187261,23,-11,1,655,101,1811,1125,6,5.11
-1,-1,0,-1.0,-1.0,1.1976850032806396,7.198039027185569,23,-10,2,655,101,1811,1125,6,1.37
-2,0,0,-2.0,-0.0,1.2052290439605713,5.246211251235321,23,-8,2,655,101,1811,1125,6,4.24
-2,0,0,-2.0,-0.0,1.21315598487854,3.324555320336759,23,-6,2,655,101,1811,1125,6,3.49
-1,-1,0,-1.0,-1.0,1.2211709022521973,2.8309518948453007,23,-5,3,655,101,1811,1125,6,-0.08
-1,0,0,-1.0,-0.0,1.229161024093628,2.0,23,-4,3,655,101,1811,1125,6,1.46
-1,0,0,-1.0,-0.0,1.2371621131896973,1.2426406871192848,23,-3,3,655,101,1811,1125,6,0.94
-1,0,0,-1.0,-0.0,1.2451388835906982,0.6055512754639891,23,-2,3,655,101,1811,1125,6,0.33
-1,-1,0,-1.0,-1.0,1.2851529121398926,1.1231056256176606,23,-1,4,655,101,1811,1125,6,1.12
-1,0,0,-1.0,-0.0,1.293159008026123,1.0,23,0,4,655,101,1811,1125,6,-0.91
-1,0,0,-1.0,-0.0,1.3011438846588135,1.1231056256176606,23,1,4,655,101,1811,1125,6,4.9
-1,0,0,-1.0,-0.0,1.3092498779296875,1.4721359549995796,23,2,4,655,101,1811,1125,6,2.45
0,0,1,-0.0,-0.0,1.3351941108703613,1.4721359549995796,23,2,4,655,101,1811,1125,6,27.36
0,0,0,-0.0,-0.0,0.11004447937011719,588.5911497835012,24,-375,464,278,561,653,97,17,149.96
0,2,0,-0.0,2.0,0.2210524082183838,587.0369736411343,24,-375,462,278,561,653,97,17,13.27
0,7,0,-0.0,7.0,0.2290334701538086,581.6185207403173,24,-375,455,278,561,653,97,17,35.54
-3,11,0,-3.0,11.0,0.23702740669250488,571.2408825350642,24,-372,444,278,561,653,97,17,55.02
-6,14,0,-6.0,14.0,0.24502348899841309,556.6733569064509,24,-366,430,278,561,653,97,17,65.94
-10,18,0,-10.0,18.0,0.25304436683654785,536.4997704315402,24,-356,412,278,561,653,97,17,75.78
-14,21,0,-14.0,21.0,0.26105642318725586,511.46607203935855,24,-342,391,278,561,653,97,17,80.92
-17,24,0,-17.0,24.0,0.26906251907348633,482.21831871116365,24,-325,367,278,561,653,97,17,82.7
-20,23,0,-20.0,23.0,0.2770254611968994,451.7401439944091,24,-305,344,278,561,653,97,17,82.89
-19,22,0,-19.0,22.0,0.28501152992248535,422.6738905482894,24,-286,322,278,561,653,97,17,77.93
-19,19,0,-19.0,19.0,0.2932703495025635,395.8539339909914,24,-267,303,278,561,653,97,17,71.08
-18,16,0,-18.0,16.0,0.30123043060302734,371.9605242653505,24,-249,287,278,561,653,97,17,64.41
-16,12,0,-16.0,12.0,0.30903053283691406,352.43584727382483,24,-233,275,278,561,653,97,17,56.42
-13,10,0,-13.0,10.0,0.3170163631439209,336.41980198589044,24,-220,265,278,561,653,97,17,49.9
-11,8,0,-11.0,8.0,0.3250694274902344,323.25518863860833,24,-209,257,278,561,653,97,17,43.78
-8,6,0,-8.0,6.0,0.33312344551086426,313.5618136533006,24,-201,251,278,561,653,97,17,36.19
-7,6,0,-7.0,6.0,0.3410673141479492,304.50759990758627,24,-194,245,278,561,653,97,17,34.44
-8,7,0,-8.0,7.0,0.34902143478393555,294.0595967685847,24,-186,238,278,561,653,97,17,36.58
-5,6,0,-5.0,6.0,0.35701942443847656,286.25329225006135,24,-181,232,278,561,653,97,17,32.38
-6,5,0,-6.0,5.0,0.3651285171508789,278.6251907980176,24,-175,227,278,561,653,97,17,29.09
-6,6,0,-6.0,6.0,0.37306952476501465,270.21214926742505,24,-169,221,278,561,653,97,17,30.93
-5,6,0,-5.0,6.0,0.38103246688842773,262.4089495560382,24,-164,215,278,561,653,97,17,30.37
-4,5,0,-4.0,5.0,0.3890705108642578,256.0075756488817,24,-160,210,278,561,653,97,17,27.24
-3,5,0,-3.0,5.0,0.3970324993133545,250.21309029559285,24,-157,205,278,561,653,97,17,23.62
-3,5,0,-3.0,5.0,0.4050314426422119,244.42028444639706,24,-154,200,278,561,653,97,17,23.24
-3,6,0,-3.0,6.0,0.41312336921691895,237.83937845674765,24,-151,194,278,561,653,97,17,24.0
-4,5,0,-4.0,5.0,0.4210164546966553,231.43683927081898,24,-147,189,278,561,653,97,17,26.1
-4,5,0,-4.0,5.0,0.4294705390930176,225.03433223454437,24,-143,184,278,561,653,97,17,25.66
-5,7,0,-5.0,7.0,0.4371204376220703,216.43930137121706,24,-138,177,278,561,653,97,17,28.45
-5,6,0,-5.0,6.0,0.4450204372406006,208.6333307688362,24,-133,171,278,561,653,97,17,26.6
-5,5,0,-5.0,5.0,0.4530293941497803,201.61870145576228,24,-128,166,278,561,653,97,17,22.96
-6,6,0,-6.0,6.0,0.4610323905944824,193.20636172845033,24,-122,160,278,561,653,97,17,24.77
-7,8,0,-7.0,8.0,0.4690263271331787,182.60167890131504,24,-115,152,278,561,653,97,17,27.92
-9,7,0,-9.0,7.0,0.4770653247833252,171.61347388211163,24,-106,145,278,561,653,97,17,25.48
-9,9,0,-9.0,9.0,0.48515939712524414,159.0478973228936,24,-97,136,278,561,653,97,17,26.65
-7,8,0,-7.0,8.0,0.493152379989624,148.4736399525492,24,-90,128,278,561,653,97,17,23.87
-7,6,0,-7.0,6.0,0.5010373592376709,139.5567687366459,24,-83,122,278,561,653,97,17,19.72
-5,6,0,-5.0,6.0,0.5092544555664062,131.7855500400524,24,-78,116,278,561,653,97,17,18.82
-4,5,0,-4.0,5.0,0.5172414779663086,125.40539719216761,24,-74,111,278,561,653,97,17,16.6
-2,3,0,-2.0,3.0,0.5250263214111328,121.79984591670362,24,-72,108,278,561,653,97,17,14.78
-3,2,0,-3.0,2.0,0.533029317855835,118.4792473095883,24,-69,106,278,561,653,97,17,9.18
-3,3,0,-3.0,3.0,0.5410323143005371,114.3315167894194,24,-66,103,278,561,653,97,17,11.26
-3,3,0,-3.0,3.0,0.5490283966064453,110.1905241548577,24,-63,100,278,561,653,97,17,10.96
-4,4,0,-4.0,4.0,0.5570664405822754,104.6809655620682,24,-59,96,278,561,653,97,17,12.5
-4,4,0,-4.0,4.0,0.5650124549865723,99.18675291284833,24,-55,92,278,561,653,97,17,12.0
-5,5,0,-5.0,5.0,0.5730233192443848,92.34440691936945,24,-50,87,278,561,653,97,17,12.93
-5,6,0,-5.0,6.0,0.5810203552246094,84.66067126888301,24,-45,81,278,561,653,97,17,13.53
-5,7,0,-5.0,7.0,0.5890774726867676,76.11896337925236,24,-40,74,278,561,653,97,17,13.96
-4,6,0,-4.0,6.0,0.5970284938812256,68.94153624668537,24,-36,68,278,561,653,97,17,12.4
-3,4,0,-3.0,4.0,0.6050333976745605,64.00694410957877,24,-33,64,278,561,653,97,17,9.3
-2,3,0,-2.0,3.0,0.6130213737487793,60.425141578224014,24,-31,61,278,561,653,97,17,8.19
-3,4,0,-3.0,4.0,0.6210174560546875,55.50590523722971,24,-28,57,278,561,653,97,17,8.5
-3,5,0,-3.0,5.0,0.6291353702545166,49.697486947006624,24,-25,52,278,561,653,97,17,9.68
-4,5,0,-4.0,5.0,0.6370835304260254,43.478150704935004,24,-21,47,278,561,653,97,17,8.01
-3,5,0,-3.0,5.0,0.6450133323669434,37.69463863518345,24,-18,42,278,561,653,97,17,8.09
-2,5,0,-2.0,5.0,0.6530253887176514,32.311288741492746,24,-16,37,278,561,653,97,17,9.37
-3,4,0,-3.0,4.0,0.6610734462738037,27.4682957019364,24,-13,33,278,561,653,97,17,5.69
-2,4,0,-2.0,4.0,0.6690804958343506,23.016124838541646,24,-11,29,278,561,653,97,17,6.47
-2,4,0,-2.0,4.0,0.6770303249359131,18.570660511172846,24,-9,25,278,561,653,97,17,5.88
-1,4,0,-1.0,4.0,0.6850264072418213,14.472205054244231,24,-8,21,278,561,653,97,17,5.36
-1,3,0,-1.0,3.0,0.6930184364318848,11.313207915827967,24,-7,18,278,561,653,97,17,5.9
-1,3,0,-1.0,3.0,0.701047420501709,8.15549442140351,24,-6,15,278,561,653,97,17,5.41
0,2,0,-0.0,2.0,0.7091484069824219,6.317821063276353,24,-6,13,278,561,653,97,17,2.11
0,2,0,-0.0,2.0,0.7170205116271973,4.529964086141668,24,-6,11,278,561,653,97,17,1.75
-1,1,0,-1.0,1.0,0.7253265380859375,3.180339887498949,24,-5,10,278,561,653,97,17,2.23
0,1,0,-0.0,1.0,0.7330565452575684,2.295630140987001,24,-5,9,278,561,653,97,17,1.47
-1,1,0,-1.0,1.0,0.7411024570465088,0.9442719099991592,24,-4,8,278,561,653,97,17,2.03
-1,2,0,-1.0,2.0,0.7490253448486328,-1.2917960675006306,24,-3,6,278,561,653,97,17,7.8
-1,2,0,-1.0,2.0,0.7570314407348633,-3.5278640450004204,24,-2,4,278,561,653,97,17,7.72
-1,2,0,-1.0,2.0,0.7650375366210938,-5.76393202250021,24,-1,2,278,561,653,97,17,7.65
0,2,0,-0.0,2.0,0.7731304168701172,-7.0,24,-1,0,278,561,653,97,17,-2.16
-1,1,0,-1.0,1.0,0.781252384185791,-7.0,24,0,-1,278,561,653,97,17,5.05
0,2,0,-0.0,2.0,0.7890164852142334,-5.0,24,0,-3,278,561,653,97,17,6.9
-1,1,0,-1.0,1.0,0.8050284385681152,-3.8768943743823394,24,1,-4,278,561,653,97,17,-0.44
0,2,0,-0.0,2.0,0.8130455017089844,-1.9172374697017807,24,1,-6,278,561,653,97,17,1.0
-1,3,0,-1.0,3.0,0.8210184574127197,1.219544457292887,24,2,-9,278,561,653,97,17,1.5
-1,1,0,-1.0,1.0,0.8290293216705322,2.4403065089105507,24,3,-10,278,561,653,97,17,0.92
-1,2,0,-1.0,2.0,0.837045431137085,4.649110640673518,24,4,-12,278,561,653,97,17,2.13
-1,1,0,-1.0,1.0,0.8450734615325928,5.928388277184119,24,5,-13,278,561,653,97,17,1.43
0,0,1,-0.0,-0.0,0.8970315456390381,5.928388277184119,24,5,-13,278,561,653,97,17,28.67
0,0,0,-0.0,-0.0,0.06154489517211914,639.6900478515462,25,461,-483,734,91,273,574,56,157.88
2,0,0,2.0,-0.0,0.17060184478759766,638.3107383195921,25,459,-483,734,91,273,574,56,4.67
4,-1,0,4.0,-1.0,0.17853689193725586,634.8340667165501,25,455,-482,734,91,273,574,56,10.3
9,-5,0,9.0,-5.0,0.18670082092285156,625.0275645024489,25,446,-477,734,91,273,574,56,24.43
15,-6,0,15.0,-6.0,0.1945810317993164,610.4371543072975,25,431,-471,734,91,273,574,56,31.96
21,-8,0,21.0,-8.0,0.2026050090789795,590.440781320249,25,410,-463,734,91,273,574,56,39.22
25,-10,0,25.0,-10.0,0.210554838180542,566.5031539024835,25,385,-453,734,91,273,574,56,43.21
28,-12,0,28.0,-12.0,0.21854901313781738,539.3887556164644,25,357,-441,734,91,273,574,56,45.44
29,-14,0,29.0,-14.0,0.226593017578125,510.43569718212404,25,328,-427,734,91,273,574,56,45.76
29,-15,0,29.0,-15.0,0.23459386825561523,481.0628644872851,25,299,-412,734,91,273,574,56,44.41
28,-16,0,28.0,-16.0,0.2426760196685791,451.85101854638174,25,271,-396,734,91,273,574,56,42.49
26,-17,0,26.0,-17.0,0.250593900680542,423.2936959453345,25,245,-379,734,91,273,574,56,40.2
24,-16,0,24.0,-16.0,0.25855088233947754,396.9823525747863,25,221,-363,734,91,273,574,56,36.48
22,-17,0,22.0,-17.0,0.2665388584136963,371.1453369388148,25,199,-346,734,91,273,574,56,34.59
19,-18,0,19.0,-18.0,0.2746109962463379,346.1443571671234,25,180,-328,734,91,273,574,56,32.61
15,-18,0,15.0,-18.0,0.2825338840484619,323.17659375305755,25,165,-310,734,91,273,574,56,30.04
14,-18,0,14.0,-18.0,0.2905550003051758,300.7324139782994,25,151,-292,734,91,273,574,56,28.36
12,-18,0,12.0,-18.0,0.2985548973083496,279.2409477917942,25,139,-274,734,91,273,574,56,26.84
10,-20,0,10.0,-20.0,0.30655598640441895,256.8806767753826,25,129,-254,734,91,273,574,56,28.98
9,-21,0,9.0,-21.0,0.3146829605102539,234.08586379276545,25,120,-233,734,91,273,574,56,25.44
6,-25,0,6.0,-25.0,0.3225729465484619,209.19190542680835,25,114,-208,734,91,273,574,56,23.1
5,-26,0,5.0,-26.0,0.33057188987731934,184.14381914163798,25,109,-182,734,91,273,574,56,20.79
2,-25,0,2.0,-25.0,0.3385460376739502,161.99473676920633,25,107,-157,734,91,273,574,56,16.97
2,-20,0,2.0,-20.0,0.34654688835144043,144.60938560808333,25,105,-137,734,91,273,574,56,13.19
1,-14,0,1.0,-14.0,0.3545420169830322,133.07451691686057,25,104,-123,734,91,273,574,56,9.16
3,-12,0,3.0,-12.0,0.362562894821167,122.07331541616585,25,101,-111,734,91,273,574,56,8.7
2,-9,0,2.0,-9.0,0.3705418109893799,114.1442928857856,25,99,-102,734,91,273,574,56,6.52
2,-8,0,2.0,-8.0,0.3785388469696045,107.07405376311175,25,97,-94,734,91,273,574,56,5.78
3,-6,0,3.0,-6.0,0.3866429328918457,100.76334882255898,25,94,-88,734,91,273,574,56,5.83
2,-6,0,2.0,-6.0,0.3945579528808594,95.23960402403117,25,92,-82,734,91,273,574,56,4.7
1,-6,0,1.0,-6.0,0.40253496170043945,90.56221995222593,25,91,-76,734,91,273,574,56,3.67
2,-7,0,2.0,-7.0,0.4105689525604248,84.61438629233834,25,89,-69,734,91,273,574,56,4.27
2,-5,0,2.0,-5.0,0.4187428951263428,80.00462953040486,25,87,-64,734,91,273,574,56,3.74
2,-5,0,2.0,-5.0,0.426555871963501,75.46980235798269,25,85,-59,734,91,273,574,56,3.52
1,-3,0,1.0,-3.0,0.43453502655029297,72.9554357129917,25,84,-56,734,91,273,574,56,2.43
1,-2,0,1.0,-2.0,0.44254302978515625,71.02019995940222,25,83,-54,734,91,273,574,56,2.49
2,-4,0,2.0,-4.0,0.45056581497192383,67.1892851112981,25,81,-50,734,91,273,574,56,3.11
2,-4,0,2.0,-4.0,0.4585859775543213,63.4166286842826,25,79,-46,734,91,273,574,56,2.94
3,-3,0,3.0,-3.0,0.4665558338165283,59.32124598286491,25,76,-43,734,91,273,574,56,4.05
5,-4,0,5.0,-4.0,0.4745340347290039,53.00617260431454,25,71,-39,734,91,273,574,56,5.19
3,-3,0,3.0,-3.0,0.4827239513397217,48.941536246685374,25,68,-36,734,91,273,574,56,3.64
3,-3,0,3.0,-3.0,0.49060797691345215,44.89718787443039,25,65,-33,734,91,273,574,56,3.45
2,-1,0,2.0,-1.0,0.4985508918762207,42.661163307718056,25,63,-32,734,91,273,574,56,6.99
1,0,0,1.0,-0.0,0.506537914276123,41.77105417004964,25,62,-32,734,91,273,574,56,2.02
2,-1,0,2.0,-1.0,0.5145838260650635,39.53517601961218,25,60,-31,734,91,273,574,56,6.51
1,0,0,1.0,-0.0,0.5228519439697266,38.64833081180653,25,59,-31,734,91,273,574,56,1.97
3,-1,0,3.0,-1.0,0.530552864074707,35.52952069707436,25,56,-30,734,91,273,574,56,3.86
1,0,0,1.0,-0.0,0.5385358333587646,34.64982043070834,25,55,-30,734,91,273,574,56,1.9
1,0,0,1.0,-0.0,0.5465328693389893,33.773780845922005,25,54,-30,734,91,273,574,56,1.87
1,0,0,1.0,-0.0,0.5546879768371582,32.90155991434045,25,53,-30,734,91,273,574,56,1.84
1,0,0,1.0,-0.0,0.5625638961791992,32.03332407921454,25,52,-30,734,91,273,574,56,1.81
3,1,0,3.0,1.0,0.570551872253418,29.982756057296896,25,49,-31,734,91,273,574,56,1.14
4,1,0,4.0,1.0,0.5785508155822754,27.21775076911409,25,45,-32,734,91,273,574,56,1.22
3,0,0,3.0,-0.0,0.586601972579956,24.80151512977634,25,42,-32,734,91,273,574,56,1.59
2,1,0,2.0,1.0,0.5945758819580078,23.855568649856693,25,40,-33,734,91,273,574,56,0.49
3,1,0,3.0,1.0,0.6025388240814209,22.24937810560445,25,37,-34,734,91,273,574,56,0.63
3,0,0,3.0,-0.0,0.6105778217315674,20.08326112068523,25,34,-34,734,91,273,574,56,1.17
2,0,0,2.0,-0.0,0.6185410022735596,18.69047011971501,25,32,-34,734,91,273,574,56,1.04
2,0,0,2.0,-0.0,0.6265809535980225,17.343136195018538,25,30,-34,734,91,273,574,56,0.96
2,0,0,2.0,-0.0,0.634552001953125,16.045431091090478,25,28,-34,734,91,273,574,56,0.87
2,0,0,2.0,-0.0,0.6425559520721436,14.80186911806539,25,26,-34,734,91,273,574,56,0.79
2,0,0,2.0,-0.0,0.6505458354949951,13.617304093369626,25,24,-34,734,91,273,574,56,0.7
2,0,0,2.0,-0.0,0.6587569713592529,12.496913462633174,25,22,-34,734,91,273,574,56,0.62
3,0,0,3.0,-0.0,0.6666319370269775,10.948684188300895,25,19,-34,734,91,273,574,56,0.44
1,0,0,1.0,-0.0,0.6746640205383301,10.470768123342687,25,18,-34,734,91,273,574,56,0.53
3,-1,0,3.0,-1.0,0.6825330257415771,8.249137920783717,25,15,-33,734,91,273,574,56,0.82
0,0,1,-0.0,-0.0,0.685528039932251,8.249137920783717,25,15,-33,734,91,273,574,56,29.36
4,0,1,4.0,-0.0,0.6907508373260498,6.785054261852174,25,11,-33,734,91,273,574,56,9.97
2,0,1,2.0,-0.0,0.005397319793701172,770.9614386330469,26,-710,318,15,442,723,124,14,8.36
1,-1,1,1.0,-1.0,0.01343226432800293,772.2830037925888,26,-711,319,15,442,723,124,14,10.9
1,0,1,1.0,-0.0,0.02138829231262207,773.1954883232792,26,-712,319,15,442,723,124,14,14.34
1,-1,1,1.0,-1.0,0.029400110244750977,774.5171143359562,26,-713,320,15,442,723,124,14,10.92
1,0,1,1.0,-0.0,0.0374293327331543,775.4295495442385,26,-714,320,15,442,723,124,14,14.37
1,0,1,1.0,-0.0,0.04540824890136719,776.3421985313953,26,-715,320,15,442,723,124,14,14.37
0,0,0,-0.0,-0.0,0.0953981876373291,776.3421985313953,26,-715,320,15,442,723,124,14,177.47
0,1,0,-0.0,1.0,0.1494143009185791,775.9342245680667,26,-715,319,15,442,723,124,14,5.4
0,3,0,-0.0,3.0,0.15742826461791992,774.7167006019508,26,-715,316,15,442,723,124,14,14.19
-1,5,0,-1.0,5.0,0.16540312767028809,771.7920133129255,26,-714,311,15,442,723,124,14,30.18
0,4,0,-0.0,4.0,0.17341232299804688,770.2033196017629,26,-714,307,15,442,723,124,14,17.84
0,6,0,-0.0,6.0,0.18140125274658203,767.852889263504,26,-714,301,15,442,723,124,14,24.87
-2,7,0,-2.0,7.0,0.18940424919128418,763.3116252530531,26,-712,294,15,442,723,124,14,42.23
-2,7,0,-2.0,7.0,0.19751715660095215,758.8126402717573,26,-710,287,15,442,723,124,14,41.78
-3,10,0,-3.0,10.0,0.20544719696044922,752.3273338949415,26,-707,277,15,442,723,124,14,53.81
-4,13,0,-4.0,13.0,0.21338725090026855,743.9360824997025,26,-703,264,15,442,723,124,14,63.07
-6,14,0,-6.0,14.0,0.2214043140411377,733.4788990916621,26,-697,250,15,442,723,124,14,71.35
-8,18,0,-8.0,18.0,0.22945523262023926,720.0110040432676,26,-689,232,15,442,723,124,14,80.7
-11,19,0,-11.0,19.0,0.23742032051086426,703.6708098690982,26,-678,213,15,442,723,124,14,87.42
-12,17,0,-12.0,17.0,0.2454061508178711,687.2420327234588,26,-666,196,15,442,723,124,14,86.5
-14,14,0,-14.0,14.0,0.25351619720458984,669.9254020939087,26,-652,182,15,442,723,124,14,87.54
-14,11,0,-14.0,11.0,0.2615182399749756,653.5187355404842,26,-638,171,15,442,723,124,14,84.49
-12,7,0,-12.0,7.0,0.2694113254547119,640.1259537369831,26,-626,164,15,442,723,124,14,76.33
-13,4,0,-13.0,4.0,0.27739620208740234,626.5368971101841,26,-613,160,15,442,723,124,14,78.17
-14,3,0,-14.0,3.0,0.2855212688446045,612.2333970321691,26,-599,157,15,442,723,124,14,78.9
-15,3,0,-15.0,3.0,0.29341626167297363,596.9635750606158,26,-584,154,15,442,723,124,14,79.71
-15,2,0,-15.0,2.0,0.3013942241668701,581.952459881101,26,-569,152,15,442,723,124,14,76.93
-18,3,0,-18.0,3.0,0.30940723419189453,563.7906796716288,26,-551,149,15,442,723,124,14,82.29
-20,4,0,-20.0,4.0,0.31740713119506836,543.4416408666772,26,-531,145,15,442,723,124,14,84.58
-22,4,0,-22.0,4.0,0.3254833221435547,521.1685337087017,26,-509,141,15,442,723,124,14,84.87
-23,4,0,-23.0,4.0,0.3334193229675293,497.9405905648703,26,-486,137,15,442,723,124,14,83.51
-25,5,0,-25.0,5.0,0.3413963317871094,472.525807438974,26,-461,132,15,442,723,124,14,83.57
-25,6,0,-25.0,6.0,0.3493921756744385,446.8413819827363,26,-436,126,15,442,723,124,14,81.56
-27,6,0,-27.0,6.0,0.3574082851409912,419.2405424170723,26,-409,120,15,442,723,124,14,79.61
-26,7,0,-26.0,7.0,0.36559033393859863,392.32192526832284,26,-383,113,15,442,723,124,14,76.74
-23,6,0,-23.0,6.0,0.37338733673095703,368.5649078388448,26,-360,107,15,442,723,124,14,70.35
-21,5,0,-21.0,5.0,0.38140320777893066,347.0127116361784,26,-339,102,15,442,723,124,14,64.71
-18,6,0,-18.0,6.0,0.3893921375274658,328.04775778984106,26,-321,96,15,442,723,124,14,60.11
-16,4,0,-16.0,4.0,0.39739513397216797,311.5733824411575,26,-305,92,15,442,723,124,14,54.44
-14,3,0,-14.0,3.0,0.4053971767425537,297.3057672802144,26,-291,89,15,442,723,124,14,48.9
-13,4,0,-13.0,4.0,0.4134342670440674,283.70431713340616,26,-278,85,15,442,723,124,14,49.15
-14,3,0,-14.0,3.0,0.42150115966796875,269.4416755845616,26,-264,82,15,442,723,124,14,45.69
-13,4,0,-13.0,4.0,0.4294593334197998,255.84025566872361,26,-251,78,15,442,723,124,14,45.96
-13,4,0,-13.0,4.0,0.4374382495880127,242.23884127479008,26,-238,74,15,442,723,124,14,44.39
-12,3,0,-12.0,3.0,0.44544315338134766,229.8902699563661,26,-226,71,15,442,723,124,14,38.91
-10,3,0,-10.0,3.0,0.4534342288970947,219.45087767549057,26,-216,68,15,442,723,124,14,36.27
-9,3,0,-9.0,3.0,0.4613831043243408,209.96543503516867,26,-207,65,15,442,723,124,14,33.47
-8,4,0,-8.0,4.0,0.4694082736968994,201.13937638034758,26,-199,61,15,442,723,124,14,28.87
-7,3,0,-7.0,3.0,0.4776182174682617,193.5691900566984,26,-192,58,15,442,723,124,14,26.37
-8,3,0,-8.0,3.0,0.4854872226715088,185.04426573058618,26,-184,55,15,442,723,124,14,27.93
-6,2,0,-6.0,2.0,0.4935932159423828,178.72291188757515,26,-178,53,15,442,723,124,14,24.07
-6,2,0,-6.0,2.0,0.501406192779541,172.4017837146554,26,-172,51,15,442,723,124,14,23.52
-5,1,0,-5.0,1.0,0.5094001293182373,167.3244102241565,26,-167,50,15,442,723,124,14,19.33
-4,1,0,-4.0,1.0,0.51776123046875,163.20575783445165,26,-163,49,15,442,723,124,14,17.66
-4,1,0,-4.0,1.0,0.525402307510376,159.0873264279969,26,-159,48,15,442,723,124,14,17.38
-3,1,0,-3.0,1.0,0.5333912372589111,155.92636373527768,26,-156,47,15,442,723,124,14,15.35
-3,1,0,-3.0,1.0,0.5414032936096191,152.76545308670458,26,-153,46,15,442,723,124,14,15.18
-3,1,0,-3.0,1.0,0.549396276473999,149.60459763365824,26,-150,45,15,442,723,124,14,15.0
-3,2,0,-3.0,2.0,0.5574402809143066,146.16004700965587,26,-147,43,15,442,723,124,14,12.68
-3,1,0,-3.0,1.0,0.5657432079315186,143.0,26,-144,42,15,442,723,124,14,14.44
-4,2,0,-4.0,2.0,0.5734691619873047,138.60219778561037,26,-140,40,15,442,723,124,14,15.01
-5,1,0,-5.0,1.0,0.5814762115478516,133.52046114356443,26,-135,39,15,442,723,124,14,17.01
-5,2,0,-5.0,2.0,0.5894532203674316,128.1628647225265,26,-130,37,15,442,723,124,14,16.83
-6,3,0,-6.0,3.0,0.5974471569061279,121.57682528356344,26,-124,34,15,442,723,124,14,17.39
-7,2,0,-7.0,2.0,0.6054062843322754,114.29715577869086,26,-117,32,15,442,723,124,14,20.84
-6,1,0,-6.0,1.0,0.6133871078491211,108.24755962709145,26,-111,31,15,442,723,124,14,16.2
-6,2,0,-6.0,2.0,0.6213982105255127,101.93117092916977,26,-105,29,15,442,723,124,14,16.89
-7,3,0,-7.0,3.0,0.6294162273406982,94.39033484509261,26,-98,26,15,442,723,124,14,16.31
-7,2,0,-7.0,2.0,0.6374633312225342,87.11163583744573,26,-91,24,15,442,723,124,14,17.59
-8,3,0,-8.0,3.0,0.6453931331634521,78.61541917201598,26,-83,21,15,442,723,124,14,15.85
-8,3,0,-8.0,3.0,0.6533992290496826,70.12976079309465,26,-75,18,15,442,723,124,14,14.69
-9,3,0,-9.0,3.0,0.6615571975708008,60.683085036070864,26,-66,15,15,442,723,124,14,14.51
-7,3,0,-7.0,3.0,0.6694653034210205,53.207972893961475,26,-59,12,15,442,723,124,14,11.22
-5,1,0,-5.0,1.0,0.6774001121520996,48.10898293381942,26,-54,11,15,442,723,124,14,12.84
-3,1,0,-3.0,1.0,0.6853861808776855,44.97114584074513,26,-51,10,15,442,723,124,14,7.42
-2,0,0,-2.0,-0.0,0.693411111831665,43.00999900019995,26,-49,10,15,442,723,124,14,5.46
-2,0,0,-2.0,-0.0,0.7014431953430176,41.05205510693585,26,-47,10,15,442,723,124,14,5.32
-2,0,0,-2.0,-0.0,0.7094392776489258,39.09772228646444,26,-45,10,15,442,723,124,14,5.17
-2,0,0,-2.0,-0.0,0.7174062728881836,37.14748010928823,26,-43,10,15,442,723,124,14,5.01
-2,0,0,-2.0,-0.0,0.7254011631011963,35.20189569201838,26,-41,10,15,442,723,124,14,4.85
-2,0,0,-2.0,-0.0,0.7337522506713867,33.26164427839479,26,-39,10,15,442,723,124,14,4.69
-2,0,0,-2.0,-0.0,0.7414181232452393,31.3275357934736,26,-37,10,15,442,723,124,14,4.53
-1,0,0,-1.0,-0.0,0.7493922710418701,30.36308338453881,26,-36,10,15,442,723,124,14,3.56
-2,1,0,-2.0,1.0,0.7574112415313721,28.17101079013795,26,-34,9,15,442,723,124,14,4.93
-2,1,0,-2.0,1.0,0.7655003070831299,25.984845004941285,26,-32,8,15,442,723,124,14,4.72
-2,1,0,-2.0,1.0,0.7734363079071045,23.805843601498726,26,-30,7,15,442,723,124,14,4.49
-1,0,0,-1.0,-0.0,0.781440258026123,22.832867780352597,26,-29,7,15,442,723,124,14,3.55
-2,0,0,-2.0,-0.0,0.7894313335418701,20.892651361962706,26,-27,7,15,442,723,124,14,4.06
-1,1,0,-1.0,1.0,0.7974112033843994,19.68332812825267,26,-26,6,15,442,723,124,14,2.38
-2,0,0,-2.0,-0.0,0.8054013252258301,17.73863375370596,26,-24,6,15,442,723,124,14,3.93
-2,1,0,-2.0,1.0,0.813690185546875,15.561028345356956,26,-22,5,15,442,723,124,14,3.96
-3,0,0,-3.0,-0.0,0.8214192390441895,12.6468827043885,26,-19,5,15,442,723,124,14,4.01
-3,1,0,-3.0,1.0,0.8293852806091309,9.492422502470642,26,-16,4,15,442,723,124,14,5.49
-2,1,0,-2.0,1.0,0.8373982906341553,7.317821063276353,26,-14,3,15,442,723,124,14,3.27
-2,1,0,-2.0,1.0,0.845454216003418,5.165525060596439,26,-12,2,15,442,723,124,14,2.83
-1,0,0,-1.0,-0.0,0.8533992767333984,4.180339887498949,26,-11,2,15,442,723,124,14,3.16
-2,0,0,-2.0,-0.0,0.8613841533660889,2.219544457292887,26,-9,2,15,442,723,124,14,2.92
-1,0,0,-1.0,-0.0,0.8694062232971191,1.2462112512353212,26,-8,2,15,442,723,124,14,2.5
-1,0,0,-1.0,-0.0,0.8776931762695312,0.28010988928051805,26,-7,2,15,442,723,124,14,2.22
-1,0,0,-1.0,-0.0,0.88545823097229,-0.675444679663241,26,-6,2,15,442,723,124,14,1.9
-1,0,0,-1.0,-0.0,0.9013931751251221,-1.6148351928654963,26,-5,2,15,442,723,124,14,1.53
-1,0,0,-1.0,-0.0,0.9094452857971191,-2.5278640450004204,26,-4,2,15,442,723,124,14,1.09
-1,0,0,-1.0,-0.0,0.9255592823028564,-3.394448724536011,26,-3,2,15,442,723,124,14,0.56
0,0,1,-0.0,-0.0,0.9474050998687744,-3.394448724536011,26,-3,2,15,442,723,124,14,25.96
0,0,0,-0.0,-0.0,0.08436274528503418,517.2327883205917,27,396,366,414,806,18,440,45,138.28
1,1,0,1.0,1.0,0.10044574737548828,515.8196723809942,27,395,365,414,806,18,440,45,8.92
2,0,0,2.0,-0.0,0.10838794708251953,514.3524960322269,27,393,365,414,806,18,440,45,5.29
2,0,0,2.0,-0.0,0.11641073226928711,512.8887734847311,27,391,365,414,806,18,440,45,5.26
3,1,0,3.0,1.0,0.12443184852600098,510.01503738146346,27,388,364,414,806,18,440,45,9.72
4,0,0,4.0,-0.0,0.13234877586364746,507.1049045321731,27,384,364,414,806,18,440,45,8.98
5,1,0,5.0,1.0,0.14034390449523926,502.7951981487636,27,379,363,414,806,18,440,45,12.76
7,1,0,7.0,1.0,0.14856791496276855,497.0645431928481,27,372,362,414,806,18,440,45,15.76
7,2,0,7.0,2.0,0.15634679794311523,490.66460771151344,27,365,360,414,806,18,440,45,17.42
8,2,0,8.0,2.0,0.1643528938293457,483.58184302840624,27,357,358,414,806,18,440,45,18.57
11,3,0,11.0,3.0,0.17242693901062012,473.72270474530416,27,346,355,414,806,18,440,45,23.72
14,5,0,14.0,5.0,0.180344820022583,460.4147593098702,27,332,350,414,806,18,440,45,29.31
18,7,0,18.0,7.0,0.1884617805480957,443.02150487907545,27,314,343,414,806,18,440,45,34.52
20,8,0,20.0,8.0,0.19633889198303223,423.7140338827127,27,294,335,414,806,18,440,45,35.9
22,10,0,22.0,10.0,0.20434188842773438,401.8030202818286,27,272,325,414,806,18,440,45,37.68
23,13,0,23.0,13.0,0.21237587928771973,377.18041034098854,27,249,312,414,806,18,440,45,39.05
24,12,0,24.0,12.0,0.22036290168762207,353.0,27,225,300,414,806,18,440,45,36.62
24,13,0,24.0,13.0,0.22834277153015137,328.3855019831728,27,201,287,414,806,18,440,45,35.2
23,12,0,23.0,12.0,0.23633384704589844,305.5805244516224,27,178,275,414,806,18,440,45,31.77
20,13,0,20.0,13.0,0.24437594413757324,283.9542449452205,27,158,262,414,806,18,440,45,29.35
19,12,0,19.0,12.0,0.25233888626098633,264.04370295463593,27,139,250,414,806,18,440,45,26.3
19,13,0,19.0,13.0,0.2606208324432373,243.64826368715455,27,120,237,414,806,18,440,45,25.2
15,12,0,15.0,12.0,0.26834893226623535,226.29418035870273,27,105,225,414,806,18,440,45,21.64
12,13,0,12.0,13.0,0.27635884284973145,209.50161986474308,27,93,212,414,806,18,440,45,20.51
10,10,0,10.0,10.0,0.28435683250427246,196.38727069131113,27,83,202,414,806,18,440,45,16.41
8,9,0,8.0,9.0,0.2925689220428467,185.06037766796427,27,75,193,414,806,18,440,45,14.41
7,9,0,7.0,9.0,0.3003509044647217,174.16319736382766,27,68,184,414,806,18,440,45,13.68
7,8,0,7.0,8.0,0.3083508014678955,164.27130750601393,27,61,176,414,806,18,440,45,12.02
8,11,0,8.0,11.0,0.31647372245788574,151.3032025093593,27,53,165,414,806,18,440,45,13.89
7,12,0,7.0,12.0,0.32437872886657715,137.76545308670458,27,46,153,414,806,18,440,45,13.81
6,11,0,6.0,11.0,0.3323657512664795,125.52626884728022,27,40,142,414,806,18,440,45,12.29
5,9,0,5.0,9.0,0.34034180641174316,115.52817893071949,27,35,133,414,806,18,440,45,10.17
4,10,0,4.0,10.0,0.3483548164367676,104.84636376341263,27,31,123,414,806,18,440,45,10.83
2,10,0,2.0,10.0,0.3566868305206299,94.66190466471906,27,29,113,414,806,18,440,45,11.14
2,12,0,2.0,12.0,0.36434388160705566,82.546640309481,27,27,101,414,806,18,440,45,10.57
3,10,0,3.0,10.0,0.3723568916320801,72.11163583744573,27,24,91,414,806,18,440,45,10.47
2,11,0,2.0,11.0,0.38034987449645996,60.969874050766165,27,22,80,414,806,18,440,45,8.83
3,11,0,3.0,11.0,0.3884298801422119,49.56814934033156,27,19,69,414,806,18,440,45,11.36
1,11,0,1.0,11.0,0.3966188430786133,38.728905802755904,27,18,58,414,806,18,440,45,6.02
1,8,0,1.0,8.0,0.4047098159790039,30.810983706043572,27,17,50,414,806,18,440,45,4.84
2,7,0,2.0,7.0,0.41234588623046875,23.541190146942803,27,15,43,414,806,18,440,45,5.99
2,8,0,2.0,8.0,0.4204108715057373,15.336309405188942,27,13,35,414,806,18,440,45,4.79
0,8,0,-0.0,8.0,0.42865777015686035,7.966648127543394,27,13,27,414,806,18,440,45,2.2
1,7,0,1.0,7.0,0.43635082244873047,1.323807579381203,27,12,20,414,806,18,440,45,1.86
1,6,0,1.0,6.0,0.44434595108032227,-4.195506185235143,27,11,14,414,806,18,440,45,1.08
1,4,0,1.0,4.0,0.4523477554321289,-7.857864376269049,27,10,10,414,806,18,440,45,0.7
0,5,0,-0.0,5.0,0.4603397846221924,-10.819660112501051,27,10,5,414,806,18,440,45,-0.76
2,3,0,2.0,3.0,0.4683709144592285,-13.753788748764679,27,8,2,414,806,18,440,45,-0.25
0,4,0,-0.0,4.0,0.47658276557922363,-13.753788748764679,27,8,-2,414,806,18,440,45,4.61
1,4,0,1.0,4.0,0.48433876037597656,-12.780455542707113,27,7,-6,414,806,18,440,45,-1.68
2,3,0,2.0,3.0,0.49236583709716797,-11.704369859013,27,5,-9,414,806,18,440,45,-1.38
1,3,0,1.0,3.0,0.5005519390106201,-9.350889359326482,27,4,-12,414,806,18,440,45,-0.56
0,1,0,-0.0,1.0,0.508375883102417,-8.398529491264556,27,4,-13,414,806,18,440,45,1.79
1,0,0,1.0,-0.0,0.5163538455963135,-8.658335935873666,27,3,-13,414,806,18,440,45,-0.16
0,1,0,-0.0,1.0,0.5323638916015625,-7.682178936723647,27,3,-14,414,806,18,440,45,2.3
0,0,1,-0.0,-0.0,0.5603508949279785,-7.682178936723647,27,3,-14,414,806,18,440,45,24.75
-1,0,1,-1.0,-0.0,0.01380777359008789,702.8920371761567,28,658,250,1068,1070,411,820,3,44.38
-2,0,1,-2.0,-0.0,0.0216677188873291,704.7619995437556,28,660,250,1068,1070,411,820,3,26.49
-1,1,1,-1.0,1.0,0.02968764305114746,705.3441087741867,28,661,249,1068,1070,411,820,3,59.15
0,0,0,-0.0,-0.0,0.07568669319152832,705.3441087741867,28,661,249,1068,1070,411,820,3,167.56
1,0,0,1.0,-0.0,0.0936746597290039,704.4083923515512,28,660,249,1068,1070,411,820,3,40.41
3,0,0,3.0,-0.0,0.10169577598571777,701.6023057178221,28,657,249,1068,1070,411,820,3,79.66
4,-1,0,4.0,-1.0,0.11003971099853516,698.2202800262589,28,653,250,1068,1070,411,820,3,86.14
6,-2,0,6.0,-2.0,0.11767768859863281,693.3435748964629,28,647,252,1068,1070,411,820,3,99.75
7,-2,0,7.0,-2.0,0.1259467601776123,687.5608179384011,28,640,254,1068,1070,411,820,3,105.51
7,-2,0,7.0,-2.0,0.13367676734924316,681.8067076413354,28,633,256,1068,1070,411,820,3,104.77
7,-2,0,7.0,-2.0,0.14168882369995117,676.0819743576105,28,626,258,1068,1070,411,820,3,104.02
8,-5,0,8.0,-5.0,0.14968562126159668,670.6345732613829,28,618,263,1068,1070,411,820,3,101.2
10,-4,0,10.0,-4.0,0.15779376029968262,663.0429202995842,28,608,267,1068,1070,411,820,3,111.84
11,-4,0,11.0,-4.0,0.16570162773132324,654.6294685262401,28,597,271,1068,1070,411,820,3,114.09
14,-5,0,14.0,-5.0,0.17368578910827637,644.0310070066399,28,583,276,1068,1070,411,820,3,119.26
14,-7,0,14.0,-7.0,0.18169879913330078,634.4919354327009,28,569,283,1068,1070,411,820,3,115.09
17,-8,0,17.0,-8.0,0.18967676162719727,623.0072114967903,28,552,291,1068,1070,411,820,3,118.49
19,-7,0,19.0,-7.0,0.1977376937866211,609.6496540570542,28,533,298,1068,1070,411,820,3,120.4
21,-8,0,21.0,-8.0,0.2057178020477295,595.4729666967313,28,512,306,1068,1070,411,820,3,119.75
22,-7,0,22.0,-7.0,0.21370482444763184,580.4370129257338,28,490,313,1068,1070,411,820,3,118.99
23,-6,0,23.0,-6.0,0.22168374061584473,564.5528268871087,28,467,319,1068,1070,411,820,3,117.91
23,-5,0,23.0,-5.0,0.23001670837402344,548.6471595487418,28,444,324,1068,1070,411,820,3,115.77
23,-3,0,23.0,-3.0,0.23770761489868164,532.0759795751446,28,421,327,1068,1070,411,820,3,114.27
20,0,0,20.0,-0.0,0.24568867683410645,516.4263232577175,28,401,327,1068,1070,411,820,3,111.28
17,0,0,17.0,-0.0,0.25368261337280273,503.36593858031296,28,384,327,1068,1070,411,820,3,106.06
16,2,0,16.0,2.0,0.26167774200439453,489.9674123605354,28,368,325,1068,1070,411,820,3,104.89
12,4,0,12.0,4.0,0.2696957588195801,478.350602377842,28,356,321,1068,1070,411,820,3,101.02
12,5,0,12.0,5.0,0.2776756286621094,466.1102653549802,28,344,316,1068,1070,411,820,3,100.55
10,7,0,10.0,7.0,0.2856767177581787,454.0131866221022,28,334,309,1068,1070,411,820,3,99.86
12,7,0,12.0,7.0,0.29378175735473633,440.4612100739996,28,322,302,1068,1070,411,820,3,99.23
13,10,0,13.0,10.0,0.3021416664123535,424.14115303037886,28,309,292,1068,1070,411,820,3,100.75
15,11,0,15.0,11.0,0.3097248077392578,405.69029985973356,28,294,281,1068,1070,411,820,3,99.15
15,15,0,15.0,15.0,0.31769275665283203,384.48281414351015,28,279,266,1068,1070,411,820,3,99.27
16,16,0,16.0,16.0,0.3256876468658447,361.86223281019477,28,263,250,1068,1070,411,820,3,95.97
14,16,0,14.0,16.0,0.33371782302856445,340.69723440496267,28,249,234,1068,1070,411,820,3,89.91
13,16,0,13.0,16.0,0.341693639755249,320.27869521647403,28,236,218,1068,1070,411,820,3,85.31
12,17,0,12.0,17.0,0.34982776641845703,299.9601302498389,28,224,201,1068,1070,411,820,3,80.83
11,15,0,11.0,15.0,0.35767269134521484,281.78083386255156,28,213,186,1068,1070,411,820,3,76.3
12,14,0,12.0,14.0,0.3657956123352051,263.5467822522134,28,201,172,1068,1070,411,820,3,73.28
10,13,0,10.0,13.0,0.37370777130126953,247.51961693194363,28,191,159,1068,1070,411,820,3,68.37
11,13,0,11.0,13.0,0.381685733795166,230.76712450216058,28,180,146,1068,1070,411,820,3,65.67
11,13,0,11.0,13.0,0.3896946907043457,214.05813167606567,28,169,133,1068,1070,411,820,3,62.1
10,10,0,10.0,10.0,0.3976926803588867,200.02238681301145,28,159,123,1068,1070,411,820,3,58.25
7,9,0,7.0,9.0,0.40567660331726074,189.0,28,152,114,1068,1070,411,820,3,52.62
7,9,0,7.0,9.0,0.4136826992034912,178.02513789968157,28,145,105,1068,1070,411,820,3,50.27
6,7,0,6.0,7.0,0.42178964614868164,169.07351351694948,28,139,98,1068,1070,411,820,3,46.55
5,7,0,5.0,7.0,0.4296846389770508,160.9783936208777,28,134,91,1068,1070,411,820,3,43.38
3,4,0,3.0,4.0,0.43768978118896484,156.25775020646836,28,131,87,1068,1070,411,820,3,36.1
4,5,0,4.0,5.0,0.4458897113800049,150.17208737065187,28,127,82,1068,1070,411,820,3,38.26
2,3,0,2.0,3.0,0.45398569107055664,146.87156589419075,28,125,79,1068,1070,411,820,3,29.68
2,2,0,2.0,2.0,0.4616837501525879,144.11374848717816,28,123,77,1068,1070,411,820,3,27.82
2,4,0,2.0,4.0,0.46969175338745117,140.315250415516,28,121,73,1068,1070,411,820,3,30.07
3,3,0,3.0,3.0,0.4777047634124756,136.20058308913997,28,118,70,1068,1070,411,820,3,31.56
5,4,0,5.0,4.0,0.485689640045166,129.86252328302402,28,113,66,1068,1070,411,820,3,36.02
6,5,0,6.0,5.0,0.49381065368652344,122.1665539016173,28,107,61,1068,1070,411,820,3,36.11
6,5,0,6.0,5.0,0.5017087459564209,114.48592987892508,28,101,56,1068,1070,411,820,3,34.42
6,4,0,6.0,4.0,0.509671688079834,107.30050784737807,28,95,52,1068,1070,411,820,3,33.4
4,3,0,4.0,3.0,0.5177175998687744,102.3537614216338,28,91,49,1068,1070,411,820,3,28.43
2,2,0,2.0,2.0,0.5257086753845215,99.64790112068906,28,89,47,1068,1070,411,820,3,21.22
3,2,0,3.0,2.0,0.5336837768554688,96.06183596038146,28,86,45,1068,1070,411,820,3,24.79
2,2,0,2.0,2.0,0.5417037010192871,93.36630754670864,28,84,43,1068,1070,411,820,3,20.25
1,1,0,1.0,1.0,0.5496776103973389,92.02150289046077,28,83,42,1068,1070,411,820,3,13.97
3,2,0,3.0,2.0,0.5576767921447754,88.44271909999159,28,80,40,1068,1070,411,820,3,23.33
5,3,0,5.0,3.0,0.5658876895904541,82.6301381082203,28,75,37,1068,1070,411,820,3,26.8
5,4,0,5.0,4.0,0.5738046169281006,76.38862965578342,28,70,33,1068,1070,411,820,3,24.63
7,4,0,7.0,4.0,0.581676721572876,68.35416353759881,28,63,29,1068,1070,411,820,3,25.78
9,4,0,9.0,4.0,0.5900537967681885,58.50630218724736,28,54,25,1068,1070,411,820,3,26.53
8,5,0,8.0,5.0,0.5978147983551025,49.15974481593781,28,46,20,1068,1070,411,820,3,21.26
7,3,0,7.0,3.0,0.6056976318359375,41.5440947723653,28,39,17,1068,1070,411,820,3,22.15
6,4,0,6.0,4.0,0.6136767864227295,34.4682957019364,28,33,13,1068,1070,411,820,3,16.18
6,2,0,6.0,2.0,0.6217737197875977,28.154759474226502,28,27,11,1068,1070,411,820,3,15.93
5,3,0,5.0,3.0,0.6297087669372559,22.40939982143925,28,22,8,1068,1070,411,820,3,12.82
5,2,0,5.0,2.0,0.6377208232879639,17.027756377319946,28,17,6,1068,1070,411,820,3,13.46
4,1,0,4.0,1.0,0.6456706523895264,12.92838827718412,28,13,5,1068,1070,411,820,3,10.31
4,2,0,4.0,2.0,0.6539576053619385,8.486832980505138,28,9,3,1068,1070,411,820,3,9.25
5,3,0,5.0,3.0,0.6621806621551514,3.0,28,4,0,1068,1070,411,820,3,6.23
4,2,0,4.0,2.0,0.6696906089782715,1.0,28,0,-2,1068,1070,411,820,3,1.02
4,1,0,4.0,1.0,0.6776716709136963,4.0,28,-4,-3,1068,1070,411,820,3,-1.46
2,1,0,2.0,1.0,0.6856896877288818,6.211102550927978,28,-6,-4,1068,1070,411,820,3,2.8
3,1,0,3.0,1.0,0.6936736106872559,9.295630140987,28,-9,-5,1068,1070,411,820,3,1.95
1,0,0,1.0,-0.0,0.7017037868499756,10.180339887498949,28,-10,-5,1068,1070,411,820,3,4.5
2,0,0,2.0,-0.0,0.7099215984344482,12.0,28,-12,-5,1068,1070,411,820,3,2.72
0,1,0,-0.0,1.0,0.7176897525787354,12.416407864998739,28,-12,-6,1068,1070,411,820,3,6.1
1,0,0,1.0,-0.0,0.7257328033447266,13.317821063276353,28,-13,-6,1068,1070,411,820,3,4.98
1,0,0,1.0,-0.0,0.7336826324462891,14.231546211727817,28,-14,-6,1068,1070,411,820,3,5.15
1,1,0,1.0,1.0,0.7417066097259521,15.552945357246848,28,-15,-7,1068,1070,411,820,3,4.29
1,0,0,1.0,-0.0,0.7496926784515381,16.46424919657298,28,-16,-7,1068,1070,411,820,3,5.39
1,0,0,1.0,-0.0,0.7576737403869629,17.384776310850235,28,-17,-7,1068,1070,411,820,3,5.54
1,1,0,1.0,1.0,0.7658646106719971,18.697715603592208,28,-18,-8,1068,1070,411,820,3,4.55
1,1,0,1.0,1.0,0.7736706733703613,20.02379604162864,28,-19,-9,1068,1070,411,820,3,4.75
1,1,0,1.0,1.0,0.7818737030029297,21.360679774997898,28,-20,-10,1068,1070,411,820,3,4.93
-1,0,0,-1.0,-0.0,0.8296828269958496,20.470910553583888,28,-19,-10,1068,1070,411,820,3,5.09
-1,0,0,-1.0,-0.0,0.8377578258514404,19.591260281974,28,-18,-10,1068,1070,411,820,3,4.92
-2,0,0,-2.0,-0.0,0.8457126617431641,17.867962264113206,28,-16,-10,1068,1070,411,820,3,6.44
-2,-1,0,-2.0,-1.0,0.8537638187408447,15.643316977093239,28,-14,-9,1068,1070,411,820,3,9.22
-3,-1,0,-3.0,-1.0,0.8616816997528076,12.601470508735444,28,-11,-8,1068,1070,411,820,3,8.11
-2,-1,0,-2.0,-1.0,0.8696796894073486,10.40175425099138,28,-9,-7,1068,1070,411,820,3,7.44
-2,0,0,-2.0,-0.0,0.8777756690979004,8.899494936611665,28,-7,-7,1068,1070,411,820,3,4.17
-1,0,0,-1.0,-0.0,0.8858096599578857,8.219544457292887,28,-6,-7,1068,1070,411,820,3,2.5
-1,-1,0,-1.0,-1.0,0.9016766548156738,6.810249675906654,28,-5,-6,1068,1070,411,820,3,6.83
-1,0,0,-1.0,-0.0,0.9096758365631104,6.211102550927978,28,-4,-6,1068,1070,411,820,3,1.85
-1,0,0,-1.0,-0.0,0.9257376194000244,5.708203932499369,28,-3,-6,1068,1070,411,820,3,1.35
-1,-1,0,-1.0,-1.0,0.9337716102600098,4.385164807134504,28,-2,-5,1068,1070,411,820,3,4.12
-1,0,0,-1.0,-0.0,0.9416887760162354,4.0990195135927845,28,-1,-5,1068,1070,411,820,3,0.2
-1,0,0,-1.0,-0.0,0.9496846199035645,4.0,28,0,-5,1068,1070,411,820,3,-0.58
-1,0,0,-1.0,-0.0,0.9577348232269287,4.0990195135927845,28,1,-5,1068,1070,411,820,3,7.83
-1,-1,0,-1.0,-1.0,0.965674638748169,3.4721359549995796,28,2,-4,1068,1070,411,820,3,0.88
-1,0,0,-1.0,-0.0,0.9816787242889404,4.0,28,3,-4,1068,1070,411,820,3,3.69
-1,0,0,-1.0,-0.0,0.9896726608276367,4.656854249492381,28,4,-4,1068,1070,411,820,3,3.48
-1,0,0,-1.0,-0.0,0.9977526664733887,5.4031242374328485,28,5,-4,1068,1070,411,820,3,3.54
0,-1,0,-0.0,-1.0,1.0056977272033691,4.830951894845301,28,5,-3,1068,1070,411,820,3,1.5
0,0,1,-0.0,-0.0,1.0377066135406494,4.830951894845301,28,5,-3,1068,1070,411,820,3,18.35
0,0,0,-0.0,-0.0,1.1436877250671387,4.830951894845301,28,5,-3,1068,1070,411,820,3,18.35
0,-1,0,-0.0,-1.0,1.1896836757659912,4.385164807134504,28,5,-2,1068,1070,411,820,3,0.9
0,-1,0,-0.0,-1.0,1.2136847972869873,4.0990195135927845,28,5,-1,1068,1070,411,820,3,0.2
1,0,0,1.0,-0.0,1.2217376232147217,3.1231056256176606,28,4,-1,1068,1070,411,820,3,4.09
0,-1,0,-0.0,-1.0,1.2297327518463135,3.0,28,4,0,1068,1070,411,820,3,-0.68
1,0,0,1.0,-0.0,1.2536847591400146,2.0,28,3,0,1068,1070,411,820,3,9.36
0,0,1,-0.0,-0.0,1.3297066688537598,2.0,28,3,0,1068,1070,411,820,3,27.51
0,0,0,-0.0,-0.0,0.0570375919342041,961.7282894018906,29,-770,-625,295,445,1065,1070,61,201.1
-2,-1,0,-2.0,-1.0,0.23405957221984863,959.5453501482385,29,-768,-624,295,445,1065,1070,61,9.57
-3,-2,0,-3.0,-2.0,0.24211668968200684,955.9558813658956,29,-765,-622,295,445,1065,1070,61,14.69
-2,-2,0,-2.0,-2.0,0.25002169609069824,953.1424108439224,29,-763,-620,295,445,1065,1070,61,12.35
-4,-4,0,-4.0,-4.0,0.2580146789550781,947.5157287737113,29,-759,-616,295,445,1065,1070,61,20.06
-5,-6,0,-5.0,-6.0,0.2660036087036133,939.8535971990824,29,-754,-610,295,445,1065,1070,61,24.35
-9,-8,0,-9.0,-8.0,0.27400851249694824,927.8251406180567,29,-745,-602,295,445,1065,1070,61,36.0
-13,-13,0,-13.0,-13.0,0.2820115089416504,909.5451026959802,29,-732,-589,295,445,1065,1070,61,46.97
-20,-18,0,-20.0,-18.0,0.29001951217651367,882.6801192093536,29,-712,-571,295,445,1065,1070,61,60.78
-25,-22,0,-25.0,-22.0,0.29800963401794434,849.4145780006152,29,-687,-549,295,445,1065,1070,61,68.14
-29,-23,0,-29.0,-23.0,0.3061835765838623,812.4013295336136,29,-658,-526,295,445,1065,1070,61,72.6
-30,-21,0,-30.0,-21.0,0.31404852867126465,775.8591688378311,29,-628,-505,295,445,1065,1070,61,67.96
-31,-21,0,-31.0,-21.0,0.32205653190612793,738.5473310083121,29,-597,-484,295,445,1065,1070,61,66.5
-31,-17,0,-31.0,-17.0,0.33005762100219727,703.7881165568165,29,-566,-467,295,445,1065,1070,61,60.95
-29,-14,0,-29.0,-14.0,0.33802247047424316,672.5510657596358,29,-537,-453,295,445,1065,1070,61,55.13
-28,-15,0,-28.0,-15.0,0.3460664749145508,641.5094936037763,29,-509,-438,295,445,1065,1070,61,53.52
-26,-14,0,-26.0,-14.0,0.35401248931884766,612.7013303238137,29,-483,-424,295,445,1065,1070,61,49.58
-26,-16,0,-26.0,-16.0,0.36202263832092285,582.6279458202996,29,-457,-408,295,445,1065,1070,61,49.71
-26,-17,0,-26.0,-17.0,0.37000560760498047,551.9295490005642,29,-431,-391,295,445,1065,1070,61,48.82
-27,-19,0,-27.0,-19.0,0.37801456451416016,519.1812087098392,29,-404,-372,295,445,1065,1070,61,49.12
-28,-19,0,-28.0,-19.0,0.3860294818878174,485.737336247823,29,-376,-353,295,445,1065,1070,61,47.43
-27,-19,0,-27.0,-19.0,0.3941526412963867,453.0703882458539,29,-349,-334,295,445,1065,1070,61,44.78
-27,-17,0,-27.0,-17.0,0.4020726680755615,421.85506525876195,29,-322,-317,295,445,1065,1070,61,41.1
-26,-15,0,-26.0,-15.0,0.41001367568969727,392.8711387645177,29,-296,-302,295,445,1065,1070,61,37.12
-21,-11,0,-21.0,-11.0,0.4180176258087158,370.38231729186043,29,-275,-291,295,445,1065,1070,61,29.99
-16,-9,0,-16.0,-9.0,0.42600560188293457,352.890323722081,29,-259,-282,295,445,1065,1070,61,24.49
-13,-8,0,-13.0,-8.0,0.43401455879211426,338.2281901212888,29,-246,-274,295,445,1065,1070,61,21.15
-10,-7,0,-10.0,-7.0,0.4420206546783447,326.3495474951526,29,-236,-267,295,445,1065,1070,61,18.05
-10,-8,0,-10.0,-8.0,0.4500105381011963,313.7397271192261,29,-226,-259,295,445,1065,1070,61,18.74
-10,-10,0,-10.0,-10.0,0.4581446647644043,299.6316125616595,29,-216,-249,295,445,1065,1070,61,20.86
-10,-10,0,-10.0,-10.0,0.4662904739379883,285.5265440497835,29,-206,-239,295,445,1065,1070,61,20.21
-11,-10,0,-11.0,-10.0,0.4740104675292969,270.77566390916667,29,-195,-229,295,445,1065,1070,61,19.45
-12,-12,0,-12.0,-12.0,0.48220157623291016,253.86264283980728,29,-183,-217,295,445,1065,1070,61,20.94
-14,-12,0,-14.0,-12.0,0.4900326728820801,235.68025895801895,29,-169,-205,295,445,1065,1070,61,19.97
-14,-14,0,-14.0,-14.0,0.4980146884918213,215.97967395701622,29,-155,-191,295,445,1065,1070,61,20.53
-15,-14,0,-15.0,-14.0,0.5060305595397949,195.67454442182884,29,-140,-177,295,445,1065,1070,61,19.12
-16,-13,0,-16.0,-13.0,0.514014482498169,175.60155641434235,29,-124,-164,295,445,1065,1070,61,17.02
-13,-11,0,-13.0,-11.0,0.52201247215271,159.02380802428036,29,-111,-153,295,445,1065,1070,61,14.09
-9,-9,0,-9.0,-9.0,0.5300085544586182,146.4652940382329,29,-102,-144,295,445,1065,1070,61,11.68
-8,-7,0,-8.0,-7.0,0.5381665229797363,136.14752480852673,29,-94,-137,295,445,1065,1070,61,9.41
-5,-6,0,-5.0,-6.0,0.5461056232452393,128.3729774930054,29,-89,-131,295,445,1065,1070,61,8.94
-4,-5,0,-4.0,-5.0,0.5543994903564453,121.99013125857877,29,-85,-126,295,445,1065,1070,61,8.17
-4,-6,0,-4.0,-6.0,0.5620145797729492,114.77914214416384,29,-81,-120,295,445,1065,1070,61,10.79
-5,-6,0,-5.0,-6.0,0.5700516700744629,107.01094846763161,29,-76,-114,295,445,1065,1070,61,8.09
-5,-7,0,-5.0,-7.0,0.5780215263366699,98.41339493993607,29,-71,-107,295,445,1065,1070,61,9.53
-7,-7,0,-7.0,-7.0,0.5860195159912109,88.72657663724664,29,-64,-100,295,445,1065,1070,61,7.26
-5,-7,0,-5.0,-7.0,0.594031572341919,80.13627921806692,29,-59,-93,295,445,1065,1070,61,8.27
-6,-7,0,-6.0,-7.0,0.6020276546478271,71.01980003939822,29,-53,-86,295,445,1065,1070,61,6.72
-4,-6,0,-4.0,-6.0,0.6101856231689453,63.81364506296512,29,-49,-80,295,445,1065,1070,61,7.57
-4,-7,0,-4.0,-7.0,0.618119478225708,55.75546629807339,29,-45,-73,295,445,1065,1070,61,7.68
-4,-7,0,-4.0,-7.0,0.6260106563568115,47.69813382572325,29,-41,-66,295,445,1065,1070,61,7.24
-4,-8,0,-4.0,-8.0,0.6342556476593018,38.796802251267465,29,-37,-58,295,445,1065,1070,61,5.73
-4,-6,0,-4.0,-6.0,0.6423065662384033,31.587336360651285,29,-33,-52,295,445,1065,1070,61,6.93
-4,-6,0,-4.0,-6.0,0.6500215530395508,24.378304497290095,29,-29,-46,295,445,1065,1070,61,6.5
-3,-5,0,-3.0,-5.0,0.6580185890197754,18.548944375753422,29,-26,-41,295,445,1065,1070,61,6.1
-3,-5,0,-3.0,-5.0,0.6660184860229492,12.720018726587654,29,-23,-36,295,445,1065,1070,61,5.75
-3,-4,0,-3.0,-4.0,0.6741435527801514,7.735924528226413,29,-20,-32,295,445,1065,1070,61,4.14
-2,-4,0,-2.0,-4.0,0.6820135116577148,3.2866339541864775,29,-18,-28,295,445,1065,1070,61,3.63
-3,-5,0,-3.0,-5.0,0.6900386810302734,-2.5409395645080366,29,-15,-23,295,445,1065,1070,61,4.77
-2,-5,0,-2.0,-5.0,0.6980125904083252,-7.796396688825482,29,-13,-18,295,445,1065,1070,61,1.98
-2,-3,0,-2.0,-3.0,0.7060546875,-11.398924762261725,29,-11,-15,295,445,1065,1070,61,4.17
-1,-2,0,-1.0,-2.0,0.7140405178070068,-13.598780533143273,29,-10,-13,295,445,1065,1070,61,2.29
0,-1,0,-0.0,-1.0,0.7220175266265869,-14.379500648186692,29,-10,-12,295,445,1065,1070,61,0.79
0,0,1,-0.0,-0.0,0.8880255222320557,-14.379500648186692,29,-10,-12,295,445,1065,1070,61,22.93
0,0,0,-0.0,-0.0,0.12146306037902832,686.0723551119665,30,605,334,910,791,305,457,11,164.77
2,0,0,2.0,-0.0,0.16742897033691406,684.3221307922734,30,603,334,910,791,305,457,11,23.37
6,-1,0,6.0,-1.0,0.17540216445922852,679.5684772175827,30,597,335,910,791,305,457,11,48.66
9,-1,0,9.0,-1.0,0.18348312377929688,672.2296508570781,30,588,336,910,791,305,457,11,63.75
10,0,0,10.0,-0.0,0.1914219856262207,663.5656287904726,30,578,336,910,791,305,457,11,69.73
10,0,0,10.0,-0.0,0.19940614700317383,654.939391156491,30,568,336,910,791,305,457,11,68.97
14,2,0,14.0,2.0,0.20743298530578613,641.8941180749753,30,554,334,910,791,305,457,11,84.05
19,5,0,19.0,5.0,0.21541500091552734,623.0652832309711,30,535,329,910,791,305,457,11,96.02
22,6,0,22.0,6.0,0.22342395782470703,601.2161330746651,30,513,323,910,791,305,457,11,98.74
25,10,0,25.0,10.0,0.23145103454589844,574.7525334140421,30,488,313,910,791,305,457,11,102.31
29,12,0,29.0,12.0,0.23954010009765625,543.8916104296002,30,459,301,910,791,305,457,11,102.89
30,13,0,30.0,13.0,0.24740314483642578,511.70591248794517,30,429,288,910,791,305,457,11,99.96
30,14,0,30.0,14.0,0.2554330825805664,479.02169372870054,30,399,274,910,791,305,457,11,96.21
32,15,0,32.0,15.0,0.2634010314941406,444.1881565669335,30,367,259,910,791,305,457,11,92.79
30,15,0,30.0,15.0,0.27140307426452637,411.0588900624526,30,337,244,910,791,305,457,11,87.16
28,14,0,28.0,14.0,0.2794361114501953,380.2025441245164,30,309,230,910,791,305,457,11,81.15
23,11,0,23.0,11.0,0.28749608993530273,355.2179895563241,30,286,219,910,791,305,457,11,72.97
19,10,0,19.0,10.0,0.29552507400512695,334.0722636843067,30,267,209,910,791,305,457,11,66.66
13,8,0,13.0,8.0,0.3033881187438965,318.908937820493,30,254,201,910,791,305,457,11,57.88
10,8,0,10.0,8.0,0.3114001750946045,306.1028768751585,30,244,193,910,791,305,457,11,55.37
8,8,0,8.0,8.0,0.31994009017944336,294.8683044271268,30,236,185,910,791,305,457,11,48.32
7,8,0,7.0,8.0,0.327376127243042,284.4304752440558,30,229,177,910,791,305,457,11,44.95
6,7,0,6.0,7.0,0.33538818359375,275.4086303950005,30,223,170,910,791,305,457,11,40.82
6,8,0,6.0,8.0,0.3433990478515625,265.80066469637774,30,217,162,910,791,305,457,11,40.68
5,7,0,5.0,7.0,0.3513920307159424,257.6194966105906,30,212,155,910,791,305,457,11,36.49
5,9,0,5.0,9.0,0.359389066696167,248.3081127796739,30,207,146,910,791,305,457,11,37.55
4,9,0,4.0,9.0,0.3674311637878418,239.90406284910833,30,203,137,910,791,305,457,11,34.41
5,10,0,5.0,10.0,0.37547802925109863,230.22967499871268,30,198,127,910,791,305,457,11,36.01
5,10,0,5.0,10.0,0.38341498374938965,220.69448376068033,30,193,117,910,791,305,457,11,34.6
6,10,0,6.0,10.0,0.39141106605529785,210.44836968517538,30,187,107,910,791,305,457,11,34.79
7,11,0,7.0,11.0,0.39944005012512207,199.0,30,180,96,910,791,305,457,11,35.2
6,10,0,6.0,10.0,0.40740299224853516,189.09276132818556,30,174,86,910,791,305,457,11,31.5
7,9,0,7.0,9.0,0.41539812088012695,178.89671013914307,30,167,77,910,791,305,457,11,30.94
7,8,0,7.0,8.0,0.42362213134765625,169.24408167854654,30,160,69,910,791,305,457,11,29.04
5,7,0,5.0,7.0,0.431408166885376,161.94010902116963,30,155,62,910,791,305,457,11,23.96
7,6,0,7.0,6.0,0.4393930435180664,153.24032355881985,30,148,56,910,791,305,457,11,26.02
5,6,0,5.0,6.0,0.4473891258239746,146.48927354766738,30,143,50,910,791,305,457,11,21.4
6,4,0,6.0,4.0,0.45539212226867676,139.51643505151932,30,137,46,910,791,305,457,11,22.07
4,4,0,4.0,4.0,0.4634101390838623,134.47401191619892,30,133,42,910,791,305,457,11,17.11
3,2,0,3.0,2.0,0.4714350700378418,131.01470508735443,30,130,40,910,791,305,457,11,13.95
1,1,0,1.0,1.0,0.4794039726257324,129.7664646712972,30,129,39,910,791,305,457,11,6.62
1,0,0,1.0,-0.0,0.48740315437316895,128.80956617521784,30,128,39,910,791,305,457,11,6.27
1,1,0,1.0,1.0,0.49538516998291016,127.56319247815361,30,127,38,910,791,305,457,11,6.54
2,1,0,2.0,1.0,0.5034470558166504,125.36103712382777,30,125,37,910,791,305,457,11,10.91
2,0,0,2.0,-0.0,0.5114991664886475,123.4445405612866,30,123,37,910,791,305,457,11,9.28
3,2,0,3.0,2.0,0.5194151401519775,120.0,30,120,35,910,791,305,457,11,13.1
3,0,0,3.0,-0.0,0.5276000499725342,117.12288892750614,30,117,35,910,791,305,457,11,11.6
3,1,0,3.0,1.0,0.5354080200195312,113.96217886370441,30,114,34,910,791,305,457,11,14.82
5,2,0,5.0,2.0,0.5434191226959229,108.6001760562016,30,109,32,910,791,305,457,11,17.54
4,1,0,4.0,1.0,0.5514030456542969,104.48059188732951,30,105,31,910,791,305,457,11,15.9
5,2,0,5.0,2.0,0.5593960285186768,99.12012293500234,30,100,29,910,791,305,457,11,16.57
4,1,0,4.0,1.0,0.5674750804901123,95.0,30,96,28,910,791,305,457,11,15.22
5,2,0,5.0,2.0,0.5754151344299316,89.64142856064674,30,91,26,910,791,305,457,11,15.58
6,2,0,6.0,2.0,0.5833959579467773,83.32326986700618,30,85,24,910,791,305,457,11,17.17
6,2,0,6.0,2.0,0.5913910865783691,77.00609733428362,30,79,22,910,791,305,457,11,16.37
4,2,0,4.0,2.0,0.5994570255279541,72.62087348130012,30,75,20,910,791,305,457,11,11.64
5,2,0,5.0,2.0,0.6073930263519287,67.27724399837061,30,70,18,910,791,305,457,11,12.97
4,2,0,4.0,2.0,0.6154401302337646,62.911707385398586,30,66,16,910,791,305,457,11,10.58
5,1,0,5.0,1.0,0.6233890056610107,57.81719509815764,30,61,15,910,791,305,457,11,13.07
4,2,0,4.0,2.0,0.631397008895874,53.463663928973865,30,57,13,910,791,305,457,11,9.6
3,2,0,3.0,2.0,0.6394941806793213,50.10898293381942,30,54,11,910,791,305,457,11,7.46
4,1,0,4.0,1.0,0.6474511623382568,45.99019513592785,30,50,10,910,791,305,457,11,10.76
3,0,0,3.0,-0.0,0.655501127243042,43.05205510693585,30,47,10,910,791,305,457,11,7.28
3,1,0,3.0,1.0,0.6637551784515381,39.91102314577124,30,44,9,910,791,305,457,11,8.03
3,1,0,3.0,1.0,0.6714329719543457,36.773197148410844,30,41,8,910,791,305,457,11,7.68
3,0,0,3.0,-0.0,0.6794371604919434,33.8329756778952,30,38,8,910,791,305,457,11,6.61
2,1,0,2.0,1.0,0.6874020099639893,31.674241641784498,30,36,7,910,791,305,457,11,5.28
2,0,0,2.0,-0.0,0.6953911781311035,29.713109915419565,30,34,7,910,791,305,457,11,5.36
1,0,0,1.0,-0.0,0.7033901214599609,28.734255586866,30,33,7,910,791,305,457,11,4.18
2,0,0,2.0,-0.0,0.7114169597625732,26.78049716414141,30,31,7,910,791,305,457,11,5.05
2,1,0,2.0,1.0,0.7194371223449707,24.614185789921695,30,29,6,910,791,305,457,11,4.9
3,0,0,3.0,-0.0,0.7274320125579834,21.68332812825267,30,26,6,910,791,305,457,11,5.49
3,1,0,3.0,1.0,0.7357301712036133,18.53720459187964,30,23,5,910,791,305,457,11,6.38
3,1,0,3.0,1.0,0.7435100078582764,15.396078054371138,30,20,4,910,791,305,457,11,5.88
3,1,0,3.0,1.0,0.7513999938964844,12.262676501632068,30,17,3,910,791,305,457,11,5.33
3,1,0,3.0,1.0,0.7594051361083984,9.142135623730951,30,14,2,910,791,305,457,11,4.69
2,1,0,2.0,1.0,0.7674210071563721,7.041594578792296,30,12,1,910,791,305,457,11,2.89
2,0,0,2.0,-0.0,0.7754039764404297,5.04987562112089,30,10,1,910,791,305,457,11,4.52
2,1,0,2.0,1.0,0.783390998840332,3.0,30,8,0,910,791,305,457,11,2.09
1,1,0,1.0,1.0,0.7914130687713623,2.0710678118654755,30,7,-1,910,791,305,457,11,0.5
1,1,0,1.0,1.0,0.7994611263275146,1.324555320336759,30,6,-2,910,791,305,457,11,0.03
2,0,0,2.0,-0.0,0.8074309825897217,-0.5278640450004204,30,4,-2,910,791,305,457,11,1.45
1,1,0,1.0,1.0,0.8154881000518799,-0.7573593128807152,30,3,-3,910,791,305,457,11,-1.16
2,1,0,2.0,1.0,0.8234550952911377,-0.8768943743823394,30,1,-4,910,791,305,457,11,-1.83
2,1,0,2.0,1.0,0.8313980102539062,0.09901951359278449,30,-1,-5,910,791,305,457,11,-0.85
2,0,0,2.0,-0.0,0.8393840789794922,0.8309518948453007,30,-3,-5,910,791,305,457,11,-0.3
1,1,0,1.0,1.0,0.8474760055541992,2.2111025509279782,30,-4,-6,910,791,305,457,11,1.92
1,0,0,1.0,-0.0,0.8634359836578369,2.810249675906654,30,-5,-6,910,791,305,457,11,1.22
1,0,0,1.0,-0.0,0.9113950729370117,3.4852813742385695,30,-6,-6,910,791,305,457,11,1.3
0,0,1,-0.0,-0.0,0.938399076461792,3.4852813742385695,30,-6,-6,910,791,305,457,11,27.95
0,1,1,-0.0,1.0,0.030789613723754883,730.0164471904538,31,605,-460,1521,338,916,797,60,5.29
0,0,0,-0.0,-0.0,0.0937964916229248,730.0164471904538,31,605,-460,1521,338,916,797,60,171.06
2,-1,0,2.0,-1.0,0.13489556312561035,727.8192396607518,31,603,-459,1521,338,916,797,60,8.86
1,-2,0,1.0,-2.0,0.14278268814086914,725.812807512548,31,602,-457,1521,338,916,797,60,7.14
1,-1,0,1.0,-1.0,0.15077662467956543,724.4116913197992,31,601,-456,1521,338,916,797,60,7.22
1,-2,0,1.0,-2.0,0.15887856483459473,722.4068048602431,31,600,-454,1521,338,916,797,60,7.12
3,-3,0,3.0,-3.0,0.16678166389465332,718.2045174950496,31,597,-451,1521,338,916,797,60,14.07
2,-4,0,2.0,-4.0,0.17477869987487793,714.2002418704257,31,595,-447,1521,338,916,797,60,11.94
4,-5,0,4.0,-5.0,0.18288469314575195,708.0006775064641,31,591,-442,1521,338,916,797,60,17.69
4,-7,0,4.0,-7.0,0.1908276081085205,700.6120721696295,31,587,-435,1521,338,916,797,60,19.46
5,-9,0,5.0,-9.0,0.19877052307128906,691.2489168102785,31,582,-426,1521,338,916,797,60,23.24
6,-10,0,6.0,-10.0,0.2068614959716797,680.5153059575846,31,576,-416,1521,338,916,797,60,25.74
7,-12,0,7.0,-12.0,0.21477556228637695,667.8373736050542,31,569,-404,1521,338,916,797,60,28.88
11,-13,0,11.0,-13.0,0.2227776050567627,651.3552670963952,31,558,-391,1521,338,916,797,60,35.37
15,-14,0,15.0,-14.0,0.23082852363586426,631.0431150840315,31,543,-377,1521,338,916,797,60,41.04
20,-15,0,20.0,-15.0,0.23883366584777832,606.0605317106226,31,523,-362,1521,338,916,797,60,47.61
20,-15,0,20.0,-15.0,0.246781587600708,581.0793729132084,31,503,-347,1521,338,916,797,60,46.4
20,-15,0,20.0,-15.0,0.25478148460388184,556.099820849657,31,483,-332,1521,338,916,797,60,45.15
21,-15,0,21.0,-15.0,0.26287055015563965,530.2972425418494,31,462,-317,1521,338,916,797,60,45.56
24,-16,0,24.0,-16.0,0.27082252502441406,501.4555484704248,31,438,-301,1521,338,916,797,60,47.38
23,-14,0,23.0,-14.0,0.2787785530090332,474.5730868764207,31,415,-287,1521,338,916,797,60,42.54
23,-14,0,23.0,-14.0,0.286792516708374,447.69550971303886,31,392,-273,1521,338,916,797,60,40.96
23,-13,0,23.0,-13.0,0.2947967052459717,421.3989366403071,31,369,-260,1521,338,916,797,60,38.31
20,-14,0,20.0,-14.0,0.30277156829833984,396.9859482465436,31,349,-246,1521,338,916,797,60,38.09
19,-14,0,19.0,-14.0,0.3108365535736084,373.3906295391602,31,330,-232,1521,338,916,797,60,34.84
18,-13,0,18.0,-13.0,0.31876254081726074,351.1889295349486,31,312,-219,1521,338,916,797,60,32.8
16,-13,0,16.0,-13.0,0.3267855644226074,330.6272313622475,31,296,-206,1521,338,916,797,60,28.45
17,-15,0,17.0,-15.0,0.3348395824432373,308.11536492741646,31,279,-191,1521,338,916,797,60,28.15
16,-14,0,16.0,-14.0,0.34277963638305664,287.0141952657641,31,263,-177,1521,338,916,797,60,25.76
15,-15,0,15.0,-15.0,0.3507826328277588,266.2228890548467,31,248,-162,1521,338,916,797,60,23.62
16,-16,0,16.0,-16.0,0.3588416576385498,244.11676344215067,31,232,-146,1521,338,916,797,60,23.06
15,-17,0,15.0,-17.0,0.36676955223083496,222.4480144505003,31,217,-129,1521,338,916,797,60,20.9
16,-17,0,16.0,-17.0,0.37520265579223633,200.09780529157595,31,201,-112,1521,338,916,797,60,19.81
16,-16,0,16.0,-16.0,0.3828256130218506,178.42504647954382,31,185,-96,1521,338,916,797,60,17.91
15,-12,0,15.0,-12.0,0.3907816410064697,159.62067397834025,31,170,-84,1521,338,916,797,60,15.63
14,-10,0,14.0,-10.0,0.39878368377685547,142.66151858477326,31,156,-74,1521,338,916,797,60,13.87
12,-6,0,12.0,-6.0,0.40676450729370117,129.24823389915505,31,144,-68,1521,338,916,797,60,13.84
8,-5,0,8.0,-5.0,0.4147796630859375,119.88328792764054,31,136,-63,1521,338,916,797,60,9.27
6,-3,0,6.0,-3.0,0.4228026866912842,113.17821063276352,31,130,-60,1521,338,916,797,60,9.26
4,-2,0,4.0,-2.0,0.4308135509490967,108.70832707519762,31,126,-58,1521,338,916,797,60,7.86
5,-3,0,5.0,-3.0,0.4387977123260498,102.91350570954029,31,121,-55,1521,338,916,797,60,6.95
4,-3,0,4.0,-3.0,0.44678664207458496,98.03515142334936,31,117,-52,1521,338,916,797,60,5.44
4,-2,0,4.0,-2.0,0.4549117088317871,93.5677951571525,31,113,-50,1521,338,916,797,60,7.12
3,-3,0,3.0,-3.0,0.46278858184814453,89.6202324023825,31,110,-47,1521,338,916,797,60,4.06
3,-1,0,3.0,-1.0,0.47078466415405273,86.46887996370532,31,107,-46,1521,338,916,797,60,5.66
1,-2,0,1.0,-2.0,0.4787895679473877,84.76933388322858,31,106,-44,1521,338,916,797,60,2.04
1,0,0,1.0,-0.0,0.4869844913482666,83.84638773364749,31,105,-44,1521,338,916,797,60,2.51
2,-1,0,2.0,-1.0,0.518824577331543,81.61541112229978,31,103,-43,1521,338,916,797,60,5.41
3,0,0,3.0,-0.0,0.526808500289917,78.85311203635843,31,100,-43,1521,338,916,797,60,3.25
2,-1,0,2.0,-1.0,0.5347855091094971,76.62082348209472,31,98,-42,1521,338,916,797,60,5.52
3,0,0,3.0,-0.0,0.5427706241607666,73.87011119662864,31,95,-42,1521,338,916,797,60,3.13
2,-1,0,2.0,-1.0,0.5508127212524414,71.6366075781753,31,93,-41,1521,338,916,797,60,5.68
4,-1,0,4.0,-1.0,0.55887770652771,67.57561170702442,31,89,-40,1521,338,916,797,60,4.7
3,-1,0,3.0,-1.0,0.5667886734008789,64.42986815621421,31,86,-39,1521,338,916,797,60,5.01
4,-1,0,4.0,-1.0,0.5747745037078857,60.376988221560026,31,82,-38,1521,338,916,797,60,4.45
2,0,0,2.0,-0.0,0.5829365253448486,58.56635930193812,31,80,-38,1521,338,916,797,60,2.5
1,-1,0,1.0,-1.0,0.590923547744751,57.23531395025755,31,79,-37,1521,338,916,797,60,2.68
3,0,0,3.0,-0.0,0.5988075733184814,54.528101836016646,31,76,-37,1521,338,916,797,60,2.68
4,-2,0,4.0,-2.0,0.6067817211151123,50.05623023850174,31,72,-35,1521,338,916,797,60,7.45
5,-1,0,5.0,-1.0,0.6147646903991699,45.13321502504735,31,67,-34,1521,338,916,797,60,3.79
5,-2,0,5.0,-2.0,0.6227686405181885,39.77105417004964,31,62,-32,1521,338,916,797,60,5.15
4,-2,0,4.0,-2.0,0.630779504776001,35.299310869258036,31,58,-30,1521,338,916,797,60,6.93
4,-1,0,4.0,-1.0,0.6387627124786377,31.29437168288782,31,54,-29,1521,338,916,797,60,3.34
4,-3,0,4.0,-3.0,0.6467885971069336,26.356011214421486,31,50,-26,1521,338,916,797,60,3.92
5,-2,0,5.0,-2.0,0.6549155712127686,21.0,31,45,-24,1521,338,916,797,60,4.34
4,-2,0,4.0,-2.0,0.6628026962280273,16.529560496527367,31,41,-22,1521,338,916,797,60,5.71
6,-3,0,6.0,-3.0,0.670771598815918,9.824615503479755,31,35,-19,1521,338,916,797,60,5.53
4,-3,0,4.0,-3.0,0.6788506507873535,4.885527085024819,31,31,-16,1521,338,916,797,60,3.12
5,-3,0,5.0,-3.0,0.6867825984954834,-0.9311162925027325,31,26,-13,1521,338,916,797,60,3.94
5,-4,0,5.0,-4.0,0.6947846412658691,-7.152680682408274,31,21,-9,1521,338,916,797,60,1.87
6,-3,0,6.0,-3.0,0.7027726173400879,-13.84450557859649,31,15,-6,1521,338,916,797,60,3.09
4,-3,0,4.0,-3.0,0.7109096050262451,-18.59824574900862,31,11,-3,1521,338,916,797,60,0.68
3,-3,0,3.0,-3.0,0.7192566394805908,-22.0,31,8,0,1521,338,916,797,60,-0.64
4,-2,0,4.0,-2.0,0.7267765998840332,-25.52786404500042,31,4,2,1521,338,916,797,60,-1.36
1,0,0,1.0,-0.0,0.7347755432128906,-26.394448724536012,31,3,2,1521,338,916,797,60,0.06
0,0,1,-0.0,-0.0,0.7431604862213135,-26.394448724536012,31,3,2,1521,338,916,797,60,19.98
-1,2,1,-1.0,2.0,0.07629203796386719,698.9714279883144,32,174,678,1691,1016,1518,336,3,58.87
-2,2,1,-2.0,2.0,0.08429694175720215,697.5356111180016,32,176,676,1691,1016,1518,336,3,52.4
0,0,0,-0.0,-0.0,0.08627200126647949,697.5356111180016,32,176,676,1691,1016,1518,336,3,166.43
-1,3,0,-1.0,3.0,0.09228396415710449,694.8864849959367,32,177,673,1691,1016,1518,336,3,76.25
-2,2,0,-2.0,2.0,0.10028481483459473,693.465261910198,32,179,671,1691,1016,1518,336,3,51.85
-3,3,0,-3.0,3.0,0.10836100578308105,691.3496226618456,32,182,668,1691,1016,1518,336,3,66.36
-4,2,0,-4.0,2.0,0.11630082130432129,690.4853577625487,32,186,666,1691,1016,1518,336,3,35.77
-5,3,0,-5.0,3.0,0.12433981895446777,688.9637671646244,32,191,663,1691,1016,1518,336,3,53.67
-7,3,0,-7.0,3.0,0.13232088088989258,688.0602295880963,32,198,660,1691,1016,1518,336,3,36.82
-10,5,0,-10.0,5.0,0.14038681983947754,686.2328571888862,32,208,655,1691,1016,1518,336,3,60.01
-13,4,0,-13.0,4.0,0.14832091331481934,686.4896362855225,32,221,651,1691,1016,1518,336,3,89.33
-14,5,0,-14.0,5.0,0.15634799003601074,686.4161767081133,32,235,646,1691,1016,1518,336,3,3.75
-15,5,0,-15.0,5.0,0.1642930507659912,687.026889009434,32,250,641,1691,1016,1518,336,3,55.84
-15,5,0,-15.0,5.0,0.17228984832763672,688.0,32,265,636,1691,1016,1518,336,3,40.4
-13,6,0,-13.0,6.0,0.18028998374938965,687.6101945222711,32,278,630,1691,1016,1518,336,3,18.2
-10,5,0,-10.0,5.0,0.18829989433288574,687.163498014825,32,288,625,1691,1016,1518,336,3,20.55
-8,5,0,-8.0,5.0,0.19634604454040527,686.0342058442214,32,296,620,1691,1016,1518,336,3,43.37
-7,7,0,-7.0,7.0,0.2042849063873291,682.7967534289703,32,303,613,1691,1016,1518,336,3,82.16
-5,7,0,-5.0,7.0,0.21242189407348633,678.7793759742935,32,308,606,1691,1016,1518,336,3,90.45
-4,8,0,-4.0,8.0,0.2203350067138672,673.4983320957881,32,312,598,1691,1016,1518,336,3,100.39
-2,10,0,-2.0,10.0,0.228287935256958,665.5883287307091,32,314,588,1691,1016,1518,336,3,113.6
-1,10,0,-1.0,10.0,0.2362959384918213,657.262105851461,32,315,578,1691,1016,1518,336,3,114.45
0,13,0,-0.0,13.0,0.2443408966064453,645.8771135231173,32,315,565,1691,1016,1518,336,3,121.94
1,11,0,1.0,11.0,0.25229787826538086,635.7982412036013,32,314,554,1691,1016,1518,336,3,117.88
4,13,0,4.0,13.0,0.2602999210357666,622.5230549065527,32,310,541,1691,1016,1518,336,3,123.85
6,15,0,6.0,15.0,0.26828503608703613,606.5294231557842,32,304,526,1691,1016,1518,336,3,126.22
7,15,0,7.0,15.0,0.2764320373535156,590.0414537069291,32,297,511,1691,1016,1518,336,3,125.2
9,16,0,9.0,16.0,0.28436994552612305,571.6857777175892,32,288,495,1691,1016,1518,336,3,126.46
8,16,0,8.0,16.0,0.29233884811401367,553.8342094716222,32,280,479,1691,1016,1518,336,3,122.02
9,17,0,9.0,17.0,0.30029797554016113,534.6164672599228,32,271,462,1691,1016,1518,336,3,120.93
10,16,0,10.0,16.0,0.3082919120788574,515.7562287965187,32,261,446,1691,1016,1518,336,3,118.32
12,17,0,12.0,17.0,0.3164699077606201,495.02620898496883,32,249,429,1691,1016,1518,336,3,115.33
11,16,0,11.0,16.0,0.3243088722229004,475.6686480145301,32,238,413,1691,1016,1518,336,3,111.55
11,16,0,11.0,16.0,0.3324258327484131,456.3160832509611,32,227,397,1691,1016,1518,336,3,108.5
13,17,0,13.0,17.0,0.3402838706970215,435.11466382133955,32,214,380,1691,1016,1518,336,3,105.63
11,16,0,11.0,16.0,0.3482799530029297,415.7793181049175,32,203,364,1691,1016,1518,336,3,101.84
10,15,0,10.0,15.0,0.3562948703765869,397.81073205218536,32,193,349,1691,1016,1518,336,3,98.09
11,16,0,11.0,16.0,0.3643498420715332,378.49044783762344,32,182,333,1691,1016,1518,336,3,95.49
11,16,0,11.0,16.0,0.372344970703125,359.18051030004386,32,171,317,1691,1016,1518,336,3,92.07
12,16,0,12.0,16.0,0.3802988529205322,339.414453277178,32,159,301,1691,1016,1518,336,3,88.33
12,18,0,12.0,18.0,0.38827991485595703,317.9012386303948,32,147,283,1691,1016,1518,336,3,85.74
13,17,0,13.0,17.0,0.3963799476623535,296.8455975837145,32,134,266,1691,1016,1518,336,3,80.84
12,16,0,12.0,16.0,0.40433788299560547,277.1797979724624,32,122,250,1691,1016,1518,336,3,76.38
12,15,0,12.0,15.0,0.41231203079223633,258.47061490658245,32,110,235,1691,1016,1518,336,3,71.92
11,13,0,11.0,13.0,0.42028093338012695,242.0740627874558,32,99,222,1691,1016,1518,336,3,67.17
8,12,0,8.0,12.0,0.4282858371734619,227.86895813980541,32,91,210,1691,1016,1518,336,3,63.55
7,12,0,7.0,12.0,0.4363219738006592,214.08137994721903,32,84,198,1691,1016,1518,336,3,60.96
6,11,0,6.0,11.0,0.44429802894592285,201.6153992173349,32,78,187,1691,1016,1518,336,3,57.69
5,10,0,5.0,10.0,0.45229291915893555,190.4627901186024,32,73,177,1691,1016,1518,336,3,54.77
3,9,0,3.0,9.0,0.4603569507598877,181.0,32,70,168,1691,1016,1518,336,3,51.12
3,9,0,3.0,9.0,0.4683248996734619,171.53985046939155,32,67,159,1691,1016,1518,336,3,49.18
3,8,0,3.0,8.0,0.47643399238586426,163.00304875214974,32,64,151,1691,1016,1518,336,3,47.12
4,7,0,4.0,7.0,0.4843578338623047,155.0,32,60,144,1691,1016,1518,336,3,43.53
3,5,0,3.0,5.0,0.4922969341278076,149.23315213360866,32,57,139,1691,1016,1518,336,3,38.5
3,5,0,3.0,5.0,0.5003349781036377,143.4714504668656,32,54,134,1691,1016,1518,336,3,37.4
2,3,0,2.0,3.0,0.5082859992980957,139.9432509913121,32,52,131,1691,1016,1518,336,3,30.49
2,3,0,2.0,3.0,0.5163240432739258,136.41906709041507,32,50,128,1691,1016,1518,336,3,29.91
1,2,0,1.0,2.0,0.5243098735809326,134.19245541079576,32,49,126,1691,1016,1518,336,3,25.08
0,1,0,-0.0,1.0,0.5403070449829102,133.2609399639374,32,49,125,1691,1016,1518,336,3,13.83
1,0,0,1.0,-0.0,0.5482790470123291,132.8992158304148,32,48,125,1691,1016,1518,336,3,5.77
0,2,0,-0.0,2.0,0.5562949180603027,131.03408650799233,32,48,123,1691,1016,1518,336,3,20.79
2,2,0,2.0,2.0,0.5642800331115723,128.4488315899375,32,46,121,1691,1016,1518,336,3,24.12
1,2,0,1.0,2.0,0.572808027267456,126.22421153223941,32,45,119,1691,1016,1518,336,3,24.0
2,3,0,2.0,3.0,0.5803229808807373,122.71337841963576,32,43,116,1691,1016,1518,336,3,27.69
1,2,0,1.0,2.0,0.5882949829101562,120.49074038789952,32,42,114,1691,1016,1518,336,3,23.2
1,3,0,1.0,3.0,0.5962769985198975,117.33004690272035,32,41,111,1691,1016,1518,336,3,28.14
0,2,0,-0.0,2.0,0.6042909622192383,115.45600027478189,32,41,109,1691,1016,1518,336,3,19.2
1,3,0,1.0,3.0,0.6122839450836182,112.29607230614837,32,40,106,1691,1016,1518,336,3,27.19
2,4,0,2.0,4.0,0.6203629970550537,107.84851859350222,32,38,102,1691,1016,1518,336,3,28.83
1,4,0,1.0,4.0,0.6282858848571777,103.75208828467335,32,37,98,1691,1016,1518,336,3,27.21
2,2,0,2.0,2.0,0.6363070011138916,101.18121158021175,32,35,96,1691,1016,1518,336,3,20.4
2,3,0,2.0,3.0,0.6443119049072266,97.68130522039117,32,33,93,1691,1016,1518,336,3,23.68
3,3,0,3.0,3.0,0.6522979736328125,93.86832980505137,32,30,90,1691,1016,1518,336,3,22.97
3,3,0,3.0,3.0,0.6603188514709473,90.09335870413386,32,27,87,1691,1016,1518,336,3,22.19
3,3,0,3.0,3.0,0.6682889461517334,86.36131867136622,32,24,84,1691,1016,1518,336,3,21.4
3,4,0,3.0,4.0,0.6762988567352295,81.71033792700887,32,21,80,1691,1016,1518,336,3,22.79
2,4,0,2.0,4.0,0.6844408512115479,77.33900688673555,32,19,76,1691,1016,1518,336,3,22.31
3,3,0,3.0,3.0,0.6922879219055176,73.73285756613352,32,16,73,1691,1016,1518,336,3,18.83
1,3,0,1.0,3.0,0.7002859115600586,70.58910531638176,32,15,70,1691,1016,1518,336,3,19.55
3,4,0,3.0,4.0,0.7083499431610107,66.08203932499369,32,12,66,1691,1016,1518,336,3,19.38
2,3,0,2.0,3.0,0.7162890434265137,62.788713735268246,32,10,63,1691,1016,1518,336,3,16.76
4,4,0,4.0,4.0,0.7242929935455322,58.30430001273095,32,6,59,1691,1016,1518,336,3,17.28
2,5,0,2.0,5.0,0.7322909832000732,53.147945482723536,32,4,54,1691,1016,1518,336,3,18.29
3,3,0,3.0,3.0,0.7403359413146973,50.0098029794274,32,1,51,1691,1016,1518,336,3,13.46
2,5,0,2.0,5.0,0.748466968536377,45.010868281309364,32,-1,46,1691,1016,1518,336,3,16.08
3,4,0,3.0,4.0,0.7562830448150635,41.190046219457976,32,-4,42,1691,1016,1518,336,3,13.04
2,4,0,2.0,4.0,0.7643029689788818,37.47076812334269,32,-6,38,1691,1016,1518,336,3,12.5
1,2,0,1.0,2.0,0.7724509239196777,35.6742416417845,32,-7,36,1691,1016,1518,336,3,8.7
0,2,0,-0.0,2.0,0.7806758880615234,33.713109915419565,32,-7,34,1691,1016,1518,336,3,10.53
1,2,0,1.0,2.0,0.7882869243621826,31.984845004941285,32,-8,32,1691,1016,1518,336,3,7.94
1,2,0,1.0,2.0,0.7962818145751953,30.32091952673165,32,-9,30,1691,1016,1518,336,3,7.48
0,2,0,-0.0,2.0,0.804373025894165,28.410882339705484,32,-9,28,1691,1016,1518,336,3,9.11
1,1,0,1.0,1.0,0.8122968673706055,27.792360097775937,32,-10,27,1691,1016,1518,336,3,3.36
0,2,0,-0.0,2.0,0.8202769756317139,25.92582403567252,32,-10,25,1691,1016,1518,336,3,8.4
0,2,0,-0.0,2.0,0.828312873840332,24.079872407968907,32,-10,23,1691,1016,1518,336,3,8.0
0,1,0,-0.0,1.0,0.8362770080566406,23.166091947189145,32,-10,22,1691,1016,1518,336,3,5.58
0,2,0,-0.0,2.0,0.8443448543548584,21.360679774997898,32,-10,20,1691,1016,1518,336,3,7.36
0,2,0,-0.0,2.0,0.8535490036010742,19.591260281974,32,-10,18,1691,1016,1518,336,3,6.92
0,1,0,-0.0,1.0,0.8602800369262695,18.72308292331602,32,-10,17,1691,1016,1518,336,3,4.74
0,1,0,-0.0,1.0,0.8682780265808105,17.867962264113206,32,-10,16,1691,1016,1518,336,3,4.56
0,2,0,-0.0,2.0,0.8843040466308594,16.204650534085253,32,-10,14,1691,1016,1518,336,3,5.94
-1,1,0,-1.0,1.0,0.8922948837280273,14.811388300841896,32,-9,13,1691,1016,1518,336,3,7.06
-1,0,0,-1.0,-0.0,0.9003360271453857,14.264337522473747,32,-8,13,1691,1016,1518,336,3,2.44
-1,1,0,-1.0,1.0,0.9083080291748047,12.892443989449804,32,-7,12,1691,1016,1518,336,3,6.27
0,1,0,-0.0,1.0,0.9242839813232422,12.038404810405298,32,-7,11,1691,1016,1518,336,3,3.97
-2,0,0,-2.0,-0.0,0.9322879314422607,11.083045973594572,32,-5,11,1691,1016,1518,336,3,2.8
-1,1,0,-1.0,1.0,0.9403138160705566,9.770329614269007,32,-4,10,1691,1016,1518,336,3,5.07
-1,0,0,-1.0,-0.0,0.9482769966125488,9.44030650891055,32,-3,10,1691,1016,1518,336,3,1.03
-1,1,0,-1.0,1.0,0.956291913986206,8.219544457292887,32,-2,9,1691,1016,1518,336,3,4.17
-1,0,0,-1.0,-0.0,0.9642820358276367,8.055385138137417,32,-1,9,1691,1016,1518,336,3,0.17
0,1,0,-0.0,1.0,0.9723260402679443,7.062257748298549,32,-1,8,1691,1016,1518,336,3,5.79
-1,0,0,-1.0,-0.0,1.0282819271087646,7.0,32,0,8,1691,1016,1518,336,3,-0.38
0,1,0,-0.0,1.0,1.0602929592132568,6.0,32,0,7,1691,1016,1518,336,3,9.66
-1,0,0,-1.0,-0.0,1.0682809352874756,6.0710678118654755,32,1,7,1691,1016,1518,336,3,9.16
0,1,0,-0.0,1.0,1.0762898921966553,5.082762530298219,32,1,6,1691,1016,1518,336,3,5.07
-1,2,0,-1.0,2.0,1.084285020828247,3.4721359549995796,32,2,4,1691,1016,1518,336,3,2.89
0,1,0,-0.0,1.0,1.0923199653625488,2.605551275463989,32,2,3,1691,1016,1518,336,3,2.49
0,0,1,-0.0,-0.0,1.1063039302825928,2.605551275463989,32,2,3,1691,1016,1518,336,3,27.69
0,1,1,-0.0,1.0,1.109632968902588,1.8284271247461903,32,2,2,1691,1016,1518,336,3,11.66
0,1,1,-0.0,1.0,1.1162829399108887,1.2360679774997898,32,2,1,1691,1016,1518,336,3,10.55
0,1,1,-0.0,1.0,1.1242878437042236,1.0,32,2,0,1691,1016,1518,336,3,9.05
1,2,1,1.0,2.0,1.1323130130767822,1.2360679774997898,32,1,-2,1691,1016,1518,336,3,13.43
1,2,1,1.0,2.0,1.1402850151062012,3.0,32,0,-4,1691,1016,1518,336,3,10.1
1,2,1,1.0,2.0,1.1482930183410645,5.082762530298219,32,-1,-6,1691,1016,1518,336,3,1.34
0,1,1,-0.0,1.0,1.1644229888916016,6.0710678118654755,32,-1,-7,1691,1016,1518,336,3,5.12
1,0,1,1.0,-0.0,1.1722888946533203,6.280109889280518,32,-2,-7,1691,1016,1518,336,3,6.77
0,1,1,-0.0,1.0,1.180279016494751,7.246211251235321,32,-2,-8,1691,1016,1518,336,3,4.66
0,0,0,-0.0,-0.0,1.227376937866211,7.246211251235321,32,-2,-8,1691,1016,1518,336,3,19.06
0,0,1,-0.0,-0.0,1.3452990055084229,7.246211251235321,32,-2,-8,1691,1016,1518,336,3,19.06
0,0,0,-0.0,-0.0,1.4072978496551514,7.246211251235321,32,-2,-8,1691,1016,1518,336,3,19.06
1,0,0,1.0,-0.0,1.428351879119873,7.54400374531753,32,-3,-8,1691,1016,1518,336,3,6.1
1,-2,0,1.0,-2.0,1.4364049434661865,6.211102550927978,32,-4,-6,1691,1016,1518,336,3,2.88
0,-1,0,-0.0,-1.0,1.4443259239196777,5.4031242374328485,32,-4,-5,1691,1016,1518,336,3,2.76
0,-1,0,-0.0,-1.0,1.4522929191589355,4.656854249492381,32,-4,-4,1691,1016,1518,336,3,2.28
0,-2,0,-0.0,-2.0,1.4606058597564697,3.4721359549995796,32,-4,-2,1691,1016,1518,336,3,2.0
0,-1,0,-0.0,-1.0,1.4683020114898682,3.1231056256176606,32,-4,-1,1691,1016,1518,336,3,0.24
0,-1,0,-0.0,-1.0,1.476287841796875,3.0,32,-4,0,1691,1016,1518,336,3,-0.68
0,-1,0,-0.0,-1.0,1.484292984008789,3.1231056256176606,32,-4,1,1691,1016,1518,336,3,6.97
0,-1,0,-0.0,-1.0,1.4922809600830078,3.4721359549995796,32,-4,2,1691,1016,1518,336,3,4.5
0,0,1,-0.0,-0.0,1.5673480033874512,3.4721359549995796,32,-4,2,1691,1016,1518,336,3,17.95
0,0,0,-0.0,-0.0,1.6612999439239502,3.4721359549995796,32,-4,2,1691,1016,1518,336,3,17.95
-1,0,0,-1.0,-0.0,1.7723770141601562,2.605551275463989,32,-3,2,1691,1016,1518,336,3,2.49
-1,0,0,-1.0,-0.0,1.7883260250091553,1.8284271247461903,32,-2,2,1691,1016,1518,336,3,1.66
-1,0,0,-1.0,-0.0,1.804291009902954,1.2360679774997898,32,-1,2,1691,1016,1518,336,3,0.55
-1,0,0,-1.0,-0.0,1.8202779293060303,1.0,32,0,2,1691,1016,1518,336,3,-0.95
-1,0,0,-1.0,-0.0,1.8362839221954346,1.2360679774997898,32,1,2,1691,1016,1518,336,3,4.4
0,0,1,-0.0,-0.0,1.8963029384613037,1.2360679774997898,32,1,2,1691,1016,1518,336,3,27.29
0,0,0,-0.0,-0.0,0.1438157558441162,809.3367153610022,33,-787,-235,903,779,1690,1014,24,181.9
-2,0,0,-2.0,-0.0,0.23480772972106934,807.4205269579229,33,-785,-235,903,779,1690,1014,24,15.41
-4,0,0,-4.0,-0.0,0.24284076690673828,803.5893574587643,33,-781,-235,903,779,1690,1014,24,26.46
-6,-1,0,-6.0,-1.0,0.2508258819580078,797.5560511786691,33,-775,-234,903,779,1690,1014,24,38.39
-6,-3,0,-6.0,-3.0,0.2588057518005371,790.9458263170685,33,-769,-231,903,779,1690,1014,24,40.43
-7,-3,0,-7.0,-3.0,0.2668027877807617,783.3791548689217,33,-762,-228,903,779,1690,1014,24,44.8
-10,-4,0,-10.0,-4.0,0.274796724319458,772.6527894553107,33,-752,-224,903,779,1690,1014,24,56.48
-15,-7,0,-15.0,-7.0,0.28286170959472656,756.2825001260929,33,-737,-217,903,779,1690,1014,24,71.31
-22,-8,0,-22.0,-8.0,0.29081177711486816,732.9201299468286,33,-715,-209,903,779,1690,1014,24,85.44
-28,-10,0,-28.0,-10.0,0.2987947463989258,703.2412180516444,33,-687,-199,903,779,1690,1014,24,92.92
-29,-10,0,-29.0,-10.0,0.30682992935180664,672.6057259474244,33,-658,-189,903,779,1690,1014,24,91.84
-29,-9,0,-29.0,-9.0,0.31501078605651855,642.2484237657742,33,-629,-180,903,779,1690,1014,24,89.85
-30,-10,0,-30.0,-10.0,0.3228027820587158,610.6564060539328,33,-599,-170,903,779,1690,1014,24,87.82
-32,-11,0,-32.0,-11.0,0.3308138847351074,576.8718026871384,33,-567,-159,903,779,1690,1014,24,86.78
-29,-9,0,-29.0,-9.0,0.3387947082519531,546.5194714600378,33,-538,-150,903,779,1690,1014,24,81.1
-27,-8,0,-27.0,-8.0,0.3468208312988281,518.3630831798156,33,-511,-142,903,779,1690,1014,24,76.54
-24,-8,0,-24.0,-8.0,0.3549039363861084,493.0990001969911,33,-487,-134,903,779,1690,1014,24,69.61
-19,-7,0,-19.0,-7.0,0.36280393600463867,472.9257675149878,33,-468,-127,903,779,1690,1014,24,60.28
-14,-5,0,-14.0,-5.0,0.37081193923950195,458.1063709417263,33,-454,-122,903,779,1690,1014,24,50.18
-9,-4,0,-9.0,-4.0,0.3787877559661865,448.3791915367157,33,-445,-118,903,779,1690,1014,24,37.56
-8,-3,0,-8.0,-3.0,0.3868427276611328,439.87830220093554,33,-437,-115,903,779,1690,1014,24,34.55
-6,-3,0,-6.0,-3.0,0.39481687545776367,433.31449560956355,33,-431,-112,903,779,1690,1014,24,27.86
-8,-3,0,-8.0,-3.0,0.4028737545013428,424.81803992051425,33,-423,-109,903,779,1690,1014,24,33.74
-8,-4,0,-8.0,-4.0,0.41080284118652344,416.07709586007985,33,-415,-105,903,779,1690,1014,24,33.0
-10,-3,0,-10.0,-3.0,0.4188969135284424,405.6469801159826,33,-405,-102,903,779,1690,1014,24,38.41
-11,-4,0,-11.0,-4.0,0.42702293395996094,394.00492607848986,33,-394,-98,903,779,1690,1014,24,39.28
-13,-5,0,-13.0,-5.0,0.43485093116760254,380.186180276664,33,-381,-93,903,779,1690,1014,24,42.23
-13,-6,0,-13.0,-6.0,0.4428067207336426,366.1441524075177,33,-368,-87,903,779,1690,1014,24,40.99
-13,-5,0,-13.0,-5.0,0.45081281661987305,352.3473617305332,33,-355,-82,903,779,1690,1014,24,40.02
-12,-4,0,-12.0,-4.0,0.45884180068969727,339.75701840901485,33,-343,-78,903,779,1690,1014,24,37.5
-11,-4,0,-11.0,-4.0,0.466843843460083,328.14702703389895,33,-332,-74,903,779,1690,1014,24,34.59
-13,-4,0,-13.0,-4.0,0.474956750869751,314.58995697969647,33,-319,-70,903,779,1690,1014,24,37.44
-15,-5,0,-15.0,-5.0,0.4828217029571533,298.871356030111,33,-304,-65,903,779,1690,1014,24,38.91
-16,-4,0,-16.0,-4.0,0.49080586433410645,282.3891981714003,33,-288,-61,903,779,1690,1014,24,39.78
-16,-5,0,-16.0,-5.0,0.4988067150115967,265.7048793233565,33,-272,-56,903,779,1690,1014,24,37.26
-17,-5,0,-17.0,-5.0,0.5068008899688721,248.049995193232,33,-255,-51,903,779,1690,1014,24,36.79
-17,-5,0,-17.0,-5.0,0.514805793762207,230.404620418011,33,-238,-46,903,779,1690,1014,24,34.9
-15,-3,0,-15.0,-3.0,0.5228028297424316,215.1079038695043,33,-223,-43,903,779,1690,1014,24,33.5
-16,-4,0,-16.0,-4.0,0.5308108329772949,198.6418761785035,33,-207,-39,903,779,1690,1014,24,31.08
-13,-3,0,-13.0,-3.0,0.5388298034667969,185.3119357768303,33,-194,-36,903,779,1690,1014,24,26.99
-11,-3,0,-11.0,-3.0,0.546839714050293,173.9516066077408,33,-183,-33,903,779,1690,1014,24,22.96
-10,-2,0,-10.0,-2.0,0.5548019409179688,163.75551200460256,33,-173,-31,903,779,1690,1014,24,22.44
-8,-1,0,-8.0,-1.0,0.5628087520599365,155.70509831248424,33,-165,-30,903,779,1690,1014,24,18.18
-6,-2,0,-6.0,-2.0,0.5709748268127441,149.4465855941215,33,-159,-28,903,779,1690,1014,24,14.2
-6,-1,0,-6.0,-1.0,0.5791299343109131,143.36408851468863,33,-153,-27,903,779,1690,1014,24,16.45
-6,-1,0,-6.0,-1.0,0.5868098735809326,137.2816130673835,33,-147,-26,903,779,1690,1014,24,16.08
-7,-1,0,-7.0,-1.0,0.5948038101196289,130.21462653327893,33,-140,-25,903,779,1690,1014,24,15.8
-7,-1,0,-7.0,-1.0,0.6027998924255371,123.14806694880988,33,-133,-24,903,779,1690,1014,24,15.29
-6,-1,0,-6.0,-1.0,0.6108007431030273,117.06587465321729,33,-127,-23,903,779,1690,1014,24,14.68
-5,0,0,-5.0,-0.0,0.6189358234405518,112.1491039033307,33,-122,-23,903,779,1690,1014,24,10.14
-5,-1,0,-5.0,-1.0,0.6268987655639648,107.05040949110591,33,-117,-22,903,779,1690,1014,24,13.13
-5,-1,0,-5.0,-1.0,0.634941816329956,101.95174417269794,33,-112,-21,903,779,1690,1014,24,12.83
-5,-1,0,-5.0,-1.0,0.6428067684173584,96.85311203635843,33,-107,-20,903,779,1690,1014,24,12.53
-2,-1,0,-2.0,-1.0,0.6508629322052002,94.70520137275409,33,-105,-19,903,779,1690,1014,24,5.49
-3,0,0,-3.0,-0.0,0.6587908267974854,91.75451797391764,33,-102,-19,903,779,1690,1014,24,6.96
-3,0,0,-3.0,-0.0,0.6667947769165039,88.80674580602232,33,-99,-19,903,779,1690,1014,24,6.82
-3,-1,0,-3.0,-1.0,0.6748619079589844,85.67292357659824,33,-96,-18,903,779,1690,1014,24,7.35
-3,-1,0,-3.0,-1.0,0.6827998161315918,82.54099639838793,33,-93,-17,903,779,1690,1014,24,7.19
-3,0,0,-3.0,-0.0,0.6908817291259766,79.59148432032315,33,-90,-17,903,779,1690,1014,24,6.52
-3,-1,0,-3.0,-1.0,0.6988089084625244,76.45903006477066,33,-87,-16,903,779,1690,1014,24,6.98
-3,-2,0,-3.0,-2.0,0.7068178653717041,73.15867542417507,33,-84,-14,903,779,1690,1014,24,5.48
-4,-1,0,-4.0,-1.0,0.7149448394775391,69.04936767180853,33,-80,-13,903,779,1690,1014,24,8.22
-4,-1,0,-4.0,-1.0,0.7228078842163086,64.94153624668537,33,-76,-12,903,779,1690,1014,24,7.95
-5,-1,0,-5.0,-1.0,0.7313008308410645,59.847059786744225,33,-71,-11,903,779,1690,1014,24,9.3
-4,-2,0,-4.0,-2.0,0.7388699054718018,55.60177512462228,33,-67,-9,903,779,1690,1014,24,5.8
-5,-1,0,-5.0,-1.0,0.7468178272247314,50.51399843235114,33,-62,-8,903,779,1690,1014,24,8.18
-5,-1,0,-5.0,-1.0,0.7548558712005615,45.42821606144492,33,-57,-7,903,779,1690,1014,24,7.76
-3,-2,0,-3.0,-2.0,0.7628798484802246,42.230987451824994,33,-54,-5,903,779,1690,1014,24,3.87
-3,-1,0,-3.0,-1.0,0.7708168029785156,39.15662224971465,33,-51,-4,903,779,1690,1014,24,4.68
-4,-1,0,-4.0,-1.0,0.7791128158569336,35.095647357266465,33,-47,-3,903,779,1690,1014,24,5.43
-3,0,0,-3.0,-0.0,0.7868227958679199,32.10215414239989,33,-44,-3,903,779,1690,1014,24,6.02
-3,-1,0,-3.0,-1.0,0.7948527336120605,29.048751503547585,33,-41,-2,903,779,1690,1014,24,4.06
-4,0,0,-4.0,-0.0,0.8028159141540527,25.05401462729781,33,-37,-2,903,779,1690,1014,24,6.42
-3,-1,0,-3.0,-1.0,0.8108029365539551,22.0147027033899,33,-34,-1,903,779,1690,1014,24,3.61
-3,-1,0,-3.0,-1.0,0.8188447952270508,19.0,33,-31,0,903,779,1690,1014,24,3.31
-4,-1,0,-4.0,-1.0,0.8268337249755859,15.018512172212592,33,-27,1,903,779,1690,1014,24,3.56
-5,-1,0,-5.0,-1.0,0.8348398208618164,10.090722034374522,33,-22,2,903,779,1690,1014,24,3.41
-5,-1,0,-5.0,-1.0,0.8428127765655518,5.262676501632068,33,-17,3,903,779,1690,1014,24,2.59
-6,-1,0,-6.0,-1.0,0.8509228229522705,-0.2953000892803743,33,-11,4,903,779,1690,1014,24,1.65
-5,-1,0,-5.0,-1.0,0.8588008880615234,-4.189750324093346,33,-6,5,903,779,1690,1014,24,0.06
-5,-1,0,-5.0,-1.0,0.866844892501831,-5.917237469701781,33,-1,6,903,779,1690,1014,24,-1.62
-3,0,0,-3.0,-0.0,0.8747837543487549,-5.675444679663241,33,2,6,903,779,1690,1014,24,-0.58
-1,0,0,-1.0,-0.0,0.8828048706054688,-5.291796067500631,33,3,6,903,779,1690,1014,24,0.24
0,0,1,-0.0,-0.0,0.9288089275360107,-5.291796067500631,33,3,6,903,779,1690,1014,24,25.42
0,-1,1,-0.0,-1.0,0.004465818405151367,828.7785341300756,34,-443,-724,457,48,900,773,40,5.32
0,0,0,-0.0,-0.0,0.07944869995117188,828.7785341300756,34,-443,-724,457,48,900,773,40,184.47
0,-1,0,-0.0,-1.0,0.13244390487670898,827.92570429254,34,-443,-723,457,48,900,773,40,5.32
1,-2,0,1.0,-2.0,0.14043784141540527,826.7449438880636,34,-444,-721,457,48,900,773,40,5.82
1,-2,0,1.0,-2.0,0.14857172966003418,825.5684478503204,34,-445,-719,457,48,900,773,40,5.79
1,-3,0,1.0,-3.0,0.1564488410949707,823.5472719415314,34,-446,-716,457,48,900,773,40,9.44
0,-2,0,-0.0,-2.0,0.16445374488830566,821.8503429945254,34,-446,-714,457,48,900,773,40,8.77
1,-3,0,1.0,-3.0,0.1724567413330078,819.8392703368901,34,-447,-711,457,48,900,773,40,9.37
0,-6,0,-0.0,-6.0,0.18053174018859863,814.7658354293137,34,-447,-705,457,48,900,773,40,21.31
0,-9,0,-0.0,-9.0,0.1884467601776123,807.1789407377343,34,-447,-696,457,48,900,773,40,29.34
-2,-11,0,-2.0,-11.0,0.19654369354248047,796.8537200747757,34,-445,-685,457,48,900,773,40,37.54
-4,-14,0,-4.0,-14.0,0.20446372032165527,782.9458263170685,34,-441,-671,457,48,900,773,40,46.55
-6,-14,0,-6.0,-14.0,0.21244573593139648,767.9555825044963,34,-435,-657,457,48,900,773,40,49.19
-8,-17,0,-8.0,-17.0,0.22043085098266602,749.3692221553966,34,-427,-640,457,48,900,773,40,56.16
-9,-16,0,-9.0,-16.0,0.22843575477600098,731.0659092250161,34,-418,-624,457,48,900,773,40,55.63
-11,-16,0,-11.0,-16.0,0.2365427017211914,711.6508730261995,34,-407,-608,457,48,900,773,40,58.61
-13,-17,0,-13.0,-17.0,0.2444899082183838,690.2936012664059,34,-394,-591,457,48,900,773,40,59.39
-16,-17,0,-16.0,-17.0,0.25254178047180176,667.2845116834803,34,-378,-574,457,48,900,773,40,59.59
-18,-20,0,-18.0,-20.0,0.2605297565460205,640.6935749649757,34,-360,-554,457,48,900,773,40,63.38
-21,-21,0,-21.0,-21.0,0.2684447765350342,611.6723834393902,34,-339,-533,457,48,900,773,40,64.21
-21,-18,0,-21.0,-18.0,0.2766258716583252,585.267709365038,34,-318,-515,457,48,900,773,40,58.75
-21,-18,0,-21.0,-18.0,0.2844548225402832,558.9801378285787,34,-297,-497,457,48,900,773,40,56.84
-19,-17,0,-19.0,-17.0,0.2924458980560303,534.6927077220323,34,-278,-480,457,48,900,773,40,52.77
-16,-14,0,-16.0,-14.0,0.30043983459472656,514.6026561849463,34,-262,-466,457,48,900,773,40,45.75
-13,-16,0,-13.0,-16.0,0.30844783782958984,494.2966070275012,34,-249,-450,457,48,900,773,40,45.77
-10,-16,0,-10.0,-16.0,0.31644487380981445,475.4563552927745,34,-239,-434,457,48,900,773,40,44.1
-8,-16,0,-8.0,-16.0,0.3244438171386719,457.582453614033,34,-231,-418,457,48,900,773,40,42.04
-7,-15,0,-7.0,-15.0,0.33272480964660645,441.06940909151626,34,-224,-403,457,48,900,773,40,38.53
-4,-14,0,-4.0,-14.0,0.34050679206848145,426.90155515504756,34,-220,-389,457,48,900,773,40,32.69
-4,-16,0,-4.0,-16.0,0.34844470024108887,411.02784132814435,34,-216,-373,457,48,900,773,40,34.17
-3,-16,0,-3.0,-16.0,0.3564448356628418,395.7138438878359,34,-213,-357,457,48,900,773,40,32.22
-4,-16,0,-4.0,-16.0,0.36445188522338867,379.9524971793525,34,-209,-341,457,48,900,773,40,32.17
-5,-15,0,-5.0,-15.0,0.37243175506591797,364.56728930058523,34,-204,-326,457,48,900,773,40,31.15
-5,-13,0,-5.0,-13.0,0.38045787811279297,350.9043003255692,34,-199,-313,457,48,900,773,40,28.32
-4,-13,0,-4.0,-13.0,0.3884437084197998,337.80581325629686,34,-195,-300,457,48,900,773,40,26.4
-4,-12,0,-4.0,-12.0,0.39644670486450195,325.5792239125495,34,-191,-288,457,48,900,773,40,24.65
-3,-10,0,-3.0,-10.0,0.40454673767089844,315.60095351473603,34,-188,-278,457,48,900,773,40,20.8
-2,-8,0,-2.0,-8.0,0.4124329090118408,307.86582621554203,34,-186,-270,457,48,900,773,40,16.84
-1,-7,0,-1.0,-7.0,0.4204437732696533,301.54937412472134,34,-185,-263,457,48,900,773,40,13.95
-2,-8,0,-2.0,-8.0,0.4284508228302002,293.86939959161356,34,-183,-255,457,48,900,773,40,16.18
-2,-7,0,-2.0,-7.0,0.43674683570861816,287.02605752606735,34,-181,-248,457,48,900,773,40,14.75
-3,-7,0,-3.0,-7.0,0.4444458484649658,279.60807732769825,34,-178,-241,457,48,900,773,40,15.96
-3,-7,0,-3.0,-7.0,0.4524517059326172,272.20027378495047,34,-175,-234,457,48,900,773,40,15.64
-4,-6,0,-4.0,-6.0,0.4605138301849365,265.0,34,-171,-228,457,48,900,773,40,16.94
-4,-7,0,-4.0,-7.0,0.46843981742858887,257.0018050482704,34,-167,-221,457,48,900,773,40,16.73
-3,-7,0,-3.0,-7.0,0.4764668941497803,249.6145396672813,34,-164,-214,457,48,900,773,40,14.72
-4,-8,0,-4.0,-8.0,0.48444485664367676,240.83711392361323,34,-160,-206,457,48,900,773,40,16.52
-4,-9,0,-4.0,-9.0,0.4924447536468506,231.2866888635369,34,-156,-197,457,48,900,773,40,16.69
-5,-11,0,-5.0,-11.0,0.5004549026489258,219.57671005337727,34,-151,-186,457,48,900,773,40,18.46
-5,-10,0,-5.0,-10.0,0.5085337162017822,208.67444107289296,34,-146,-176,457,48,900,773,40,17.18
-4,-9,0,-4.0,-9.0,0.5164427757263184,199.20994502987313,34,-142,-167,457,48,900,773,40,14.87
-5,-8,0,-5.0,-8.0,0.52445387840271,189.88091861815357,34,-137,-159,457,48,900,773,40,15.14
-4,-7,0,-4.0,-7.0,0.5324428081512451,181.97277044195835,34,-133,-152,457,48,900,773,40,12.93
-5,-7,0,-5.0,-7.0,0.5404407978057861,173.4140636044856,34,-128,-145,457,48,900,773,40,14.08
-5,-6,0,-5.0,-6.0,0.5487558841705322,165.60711193270586,34,-123,-139,457,48,900,773,40,14.44
-7,-7,0,-7.0,-7.0,0.5565328598022461,155.72706109191037,34,-116,-132,457,48,900,773,40,14.99
-6,-8,0,-6.0,-8.0,0.5644598007202148,145.75886099994776,34,-110,-124,457,48,900,773,40,14.21
-5,-6,0,-5.0,-6.0,0.5724368095397949,137.95252451290546,34,-105,-118,457,48,900,773,40,13.09
-5,-5,0,-5.0,-5.0,0.5804338455200195,130.89400253157845,34,-100,-113,457,48,900,773,40,11.43
-5,-5,0,-5.0,-5.0,0.5884509086608887,123.83671297690307,34,-95,-108,457,48,900,773,40,11.06
-3,-3,0,-3.0,-3.0,0.5964539051055908,119.60300856356929,34,-92,-105,457,48,900,773,40,8.5
-2,-3,0,-2.0,-3.0,0.6044578552246094,116.02940858505562,34,-90,-102,457,48,900,773,40,6.93
-2,-3,0,-2.0,-3.0,0.6124587059020996,112.45754036671525,34,-88,-99,457,48,900,773,40,6.8
-1,-4,0,-1.0,-4.0,0.6204466819763184,108.81770064707723,34,-87,-95,457,48,900,773,40,5.0
-2,-4,0,-2.0,-4.0,0.6284377574920654,104.52309022827855,34,-85,-91,457,48,900,773,40,6.18
-1,-5,0,-1.0,-5.0,0.6364407539367676,100.21647141718975,34,-84,-86,457,48,900,773,40,5.06
-3,-5,0,-3.0,-5.0,0.6444458961486816,94.5512985522207,34,-81,-81,457,48,900,773,40,7.05
-2,-4,0,-2.0,-4.0,0.652479887008667,90.3177229641729,34,-79,-77,457,48,900,773,40,5.49
-2,-3,0,-2.0,-3.0,0.6604418754577637,86.7941945987702,34,-77,-74,457,48,900,773,40,5.5
-1,-3,0,-1.0,-3.0,0.6684517860412598,84.00480758118829,34,-76,-71,457,48,900,773,40,3.76
-2,-3,0,-2.0,-3.0,0.6764428615570068,80.4987562112089,34,-74,-68,457,48,900,773,40,5.19
-3,-3,0,-3.0,-3.0,0.6844878196716309,76.26006440887103,34,-71,-65,457,48,900,773,40,7.67
-3,-4,0,-3.0,-4.0,0.6924357414245605,71.35097153287424,34,-68,-61,457,48,900,773,40,6.0
-2,-3,0,-2.0,-3.0,0.7004287242889404,67.86353054595519,34,-66,-58,457,48,900,773,40,4.71
-3,-3,0,-3.0,-3.0,0.7086458206176758,63.630138108220294,34,-63,-55,457,48,900,773,40,6.76
-2,-3,0,-2.0,-3.0,0.716437816619873,60.15609770940699,34,-61,-52,457,48,900,773,40,4.4
-3,-3,0,-3.0,-3.0,0.7244486808776855,55.92759709091287,34,-58,-49,457,48,900,773,40,6.23
-1,-2,0,-1.0,-2.0,0.7324397563934326,53.878278269055514,34,-57,-47,457,48,900,773,40,2.98
-2,-2,0,-2.0,-2.0,0.7404398918151855,51.06335201775947,34,-55,-45,457,48,900,773,40,5.22
-2,-2,0,-2.0,-2.0,0.7484688758850098,48.24954212300622,34,-53,-43,457,48,900,773,40,5.1
-2,-3,0,-2.0,-3.0,0.756497859954834,44.81512169239521,34,-51,-40,457,48,900,773,40,3.74
-2,-3,0,-2.0,-3.0,0.7645556926727295,41.40032573203501,34,-49,-37,457,48,900,773,40,3.54
-1,-2,0,-1.0,-2.0,0.7725057601928711,39.405386961116584,34,-48,-35,457,48,900,773,40,2.49
-2,-2,0,-2.0,-2.0,0.780634880065918,36.61271941887264,34,-46,-33,457,48,900,773,40,4.2
-2,-3,0,-2.0,-3.0,0.7884547710418701,33.25410782277739,34,-44,-30,457,48,900,773,40,3.07
-2,-1,0,-2.0,-1.0,0.7964358329772949,31.039200620699383,34,-42,-29,457,48,900,773,40,4.08
-2,-2,0,-2.0,-2.0,0.8044607639312744,28.25971404805462,34,-40,-27,457,48,900,773,40,3.74
-3,-2,0,-3.0,-2.0,0.8125438690185547,24.654227123532216,34,-37,-25,457,48,900,773,40,7.43
-3,-1,0,-3.0,-1.0,0.8205478191375732,21.617304093369626,34,-34,-24,457,48,900,773,40,3.0
-3,-1,0,-3.0,-1.0,0.8284387588500977,18.600518131237564,34,-31,-23,457,48,900,773,40,2.78
-3,-1,0,-3.0,-1.0,0.8364439010620117,15.608987629529715,34,-28,-22,457,48,900,773,40,2.55
-3,0,0,-3.0,-0.0,0.8445208072662354,13.301651610693426,34,-25,-22,457,48,900,773,40,1.27
-3,-1,0,-3.0,-1.0,0.8524818420410156,10.4138126514911,34,-22,-21,457,48,900,773,40,1.99
-1,0,0,-1.0,-0.0,0.8604416847229004,9.698484809834994,34,-21,-21,457,48,900,773,40,1.02
-1,0,0,-1.0,-0.0,0.8684368133544922,9.0,34,-20,-21,457,48,900,773,40,0.96
0,0,1,-0.0,-0.0,0.871431827545166,9.0,34,-20,-21,457,48,900,773,40,29.58
0,0,0,-0.0,-0.0,0.11473655700683594,242.72590972130098,35,-253,63,224,132,477,69,37,84.0
-1,0,0,-1.0,-0.0,0.12173771858215332,241.75565441391262,35,-252,63,224,132,477,69,37,4.66
-1,0,0,-1.0,-0.0,0.13772964477539062,240.78562556679998,35,-251,63,224,132,477,69,37,4.65
-2,0,0,-2.0,-0.0,0.2337646484375,238.8462575160479,35,-249,63,224,132,477,69,37,6.44
-6,1,0,-6.0,1.0,0.24172472953796387,232.78476827750126,35,-243,62,224,132,477,69,37,14.42
-8,4,0,-8.0,4.0,0.25000667572021484,224.05164738129753,35,-235,58,224,132,477,69,37,16.42
-11,3,0,-11.0,3.0,0.2577335834503174,212.6534196581529,35,-224,55,224,132,477,69,37,21.55
-17,5,0,-17.0,5.0,0.26575350761413574,194.9530464679949,35,-207,50,224,132,477,69,37,25.42
-23,4,0,-23.0,4.0,0.2737255096435547,171.66285877841239,35,-184,46,224,132,477,69,37,26.56
-25,4,0,-25.0,4.0,0.2817225456237793,146.45364088398895,35,-159,42,224,132,477,69,37,24.45
-30,2,0,-30.0,2.0,0.2897326946258545,117.05924625881784,35,-129,40,224,132,477,69,37,21.45
-26,0,0,-26.0,-0.0,0.2978055477142334,92.4943437466371,35,-103,40,224,132,477,69,37,15.99
-26,-1,0,-26.0,-1.0,0.30601072311401367,69.23531395025755,35,-77,41,224,132,477,69,37,12.17
-24,0,0,-24.0,-0.0,0.3137366771697998,49.00746227100382,35,-53,41,224,132,477,69,37,8.55
-22,1,0,-22.0,1.0,0.32172155380249023,32.60632371551998,35,-31,40,224,132,477,69,37,5.32
-17,4,0,-17.0,4.0,0.32994961738586426,20.626415831655933,35,-14,36,224,132,477,69,37,2.99
-16,2,0,-16.0,2.0,0.3378715515136719,16.058772731852805,35,2,34,224,132,477,69,37,0.03
-13,1,0,-13.0,1.0,0.345733642578125,18.249137920783717,35,15,33,224,132,477,69,37,-1.4
-7,1,0,-7.0,1.0,0.35373663902282715,20.8329756778952,35,22,32,224,132,477,69,37,-0.64
-2,0,0,-2.0,-0.0,0.36173367500305176,22.0,35,24,32,224,132,477,69,37,0.7
0,0,1,-0.0,-0.0,0.4937405586242676,22.0,35,24,32,224,132,477,69,37,33.510000000000005
0,1,1,-0.0,1.0,0.5777466297149658,21.204591567825318,35,24,31,224,132,477,69,37,11.45
0,0,0,-0.0,-0.0,0.5837185382843018,21.204591567825318,35,24,31,224,132,477,69,37,23.27
1,0,0,1.0,-0.0,0.5856976509094238,20.600518131237564,35,23,31,224,132,477,69,37,0.89
2,2,0,2.0,2.0,0.5938756465911865,17.805027579936315,35,21,29,224,132,477,69,37,3.73
3,3,0,3.0,3.0,0.6017374992370605,13.622776601683793,35,18,26,224,132,477,69,37,3.62
3,2,0,3.0,2.0,0.6097395420074463,10.301943396169811,35,15,24,224,132,477,69,37,2.11
2,3,0,2.0,3.0,0.617863655090332,6.698178070456937,35,13,21,224,132,477,69,37,5.37
3,3,0,3.0,3.0,0.6257495880126953,2.5912602819740016,35,10,18,224,132,477,69,37,2.38
3,3,0,3.0,3.0,0.6337325572967529,-1.4470546427531517,35,7,15,224,132,477,69,37,1.77
1,3,0,1.0,3.0,0.6417245864868164,-4.583592135001261,35,6,12,224,132,477,69,37,2.82
1,4,0,1.0,4.0,0.6498756408691406,-8.566018867943397,35,5,8,224,132,477,69,37,1.32
1,3,0,1.0,3.0,0.6580226421356201,-11.596875762567151,35,4,5,224,132,477,69,37,0.83
1,4,0,1.0,4.0,0.6657295227050781,-14.83772233983162,35,3,1,224,132,477,69,37,-1.33
0,3,0,-0.0,3.0,0.6737337112426758,-14.39444872453601,35,3,-2,224,132,477,69,37,-2.21
0,3,0,-0.0,3.0,0.6817455291748047,-12.1690481051547,35,3,-5,224,132,477,69,37,-1.55
0,3,0,-0.0,3.0,0.6897757053375244,-9.45599625468247,35,3,-8,224,132,477,69,37,-0.37
0,2,0,-0.0,2.0,0.69773268699646,-7.559693491089449,35,3,-10,224,132,477,69,37,0.85
0,0,1,-0.0,-0.0,0.703716516494751,-7.559693491089449,35,3,-10,224,132,477,69,37,24.78
0,1,1,-0.0,1.0,0.7060534954071045,-6.598245749008621,35,3,-11,224,132,477,69,37,11.870000000000001
0,1,1,-0.0,1.0,0.7137446403503418,-5.630683123147019,35,3,-12,224,132,477,69,37,12.05
0,0,0,-0.0,-0.0,0.8147356510162354,-5.630683123147019,35,3,-12,224,132,477,69,37,15.32
0,1,0,-0.0,1.0,0.8817436695098877,-4.658335935873666,35,3,-13,224,132,477,69,37,2.22
1,1,0,1.0,1.0,0.8897366523742676,-3.857864376269049,35,2,-14,224,132,477,69,37,0.19
2,2,0,2.0,2.0,0.8978486061096191,-2.0,35,0,-16,224,132,477,69,37,-0.3
2,3,0,2.0,3.0,0.9057865142822266,1.104973174542799,35,-2,-19,224,132,477,69,37,0.17
1,2,0,1.0,2.0,0.9137675762176514,3.2132034355964265,35,-3,-21,224,132,477,69,37,1.37
2,2,0,2.0,2.0,0.9217205047607422,5.5372045918796395,35,-5,-23,224,132,477,69,37,0.47
0,1,0,-0.0,1.0,0.9297516345977783,6.515301344262525,35,-5,-24,224,132,477,69,37,2.78
1,0,0,1.0,-0.0,0.9377775192260742,6.738633753705962,35,-6,-24,224,132,477,69,37,1.3
0,2,0,-0.0,2.0,0.9457366466522217,8.683328128252668,35,-6,-26,224,132,477,69,37,2.15
0,1,0,-0.0,1.0,0.961822509765625,9.658633371878661,35,-6,-27,224,132,477,69,37,2.78
0,0,1,-0.0,-0.0,0.9907846450805664,9.658633371878661,35,-6,-27,224,132,477,69,37,29.78
0,0,0,-0.0,-0.0,0.07144570350646973,1609.1266084727397,36,1385,854,1615,1013,230,159,36,266.34
1,0,0,1.0,-0.0,0.186842679977417,1608.2754994157663,36,1384,854,1615,1013,230,159,36,7.6
3,1,0,3.0,1.0,0.1944587230682373,1605.1974618018598,36,1381,853,1615,1013,230,159,36,23.21
9,4,0,9.0,4.0,0.20244479179382324,1595.4388739583535,36,1372,849,1615,1013,230,159,36,58.57
10,7,0,10.0,7.0,0.21041274070739746,1583.25201014706,36,1362,842,1615,1013,230,159,36,69.59
14,9,0,14.0,9.0,0.21839475631713867,1566.611308807305,36,1348,833,1615,1013,230,159,36,86.49
19,11,0,19.0,11.0,0.22639966011047363,1544.6659911830168,36,1329,822,1615,1013,230,159,36,101.34
27,14,0,27.0,14.0,0.23439884185791016,1514.340693188039,36,1302,808,1615,1013,230,159,36,118.95
33,20,0,33.0,20.0,0.24244070053100586,1475.7553347185074,36,1269,788,1615,1013,230,159,36,134.07
39,22,0,39.0,22.0,0.25040769577026367,1431.0189784816484,36,1230,766,1615,1013,230,159,36,139.67
43,24,0,43.0,24.0,0.2583956718444824,1381.8332043497182,36,1187,742,1615,1013,230,159,36,142.49
47,27,0,47.0,27.0,0.2664048671722412,1327.6689786124966,36,1140,715,1615,1013,230,159,36,145.17
49,29,0,49.0,29.0,0.27443981170654297,1270.7501697381072,36,1091,686,1615,1013,230,159,36,144.84
51,27,0,51.0,27.0,0.2824108600616455,1213.2111922818117,36,1040,659,1615,1013,230,159,36,140.6
54,27,0,54.0,27.0,0.2903866767883301,1153.1618163174548,36,986,632,1615,1013,230,159,36,138.46
51,25,0,51.0,25.0,0.2983968257904053,1096.7528874149643,36,935,607,1615,1013,230,159,36,131.37
47,24,0,47.0,24.0,0.3064126968383789,1044.2772707725605,36,888,583,1615,1013,230,159,36,124.39
44,21,0,44.0,21.0,0.31456685066223145,995.9921104229559,36,844,562,1615,1013,230,159,36,116.72
42,21,0,42.0,21.0,0.32239484786987305,949.4114946598474,36,802,541,1615,1013,230,159,36,111.97
36,18,0,36.0,18.0,0.3304097652435303,909.515498522801,36,766,523,1615,1013,230,159,36,101.98
32,17,0,32.0,17.0,0.3384108543395996,873.5110767679782,36,734,506,1615,1013,230,159,36,95.13
29,16,0,29.0,16.0,0.3464357852935791,840.5598406634217,36,705,490,1615,1013,230,159,36,89.21
27,17,0,27.0,17.0,0.35441064834594727,808.6879701556084,36,678,473,1615,1013,230,159,36,86.7
24,14,0,24.0,14.0,0.3624107837677002,780.9974968671679,36,654,459,1615,1013,230,159,36,78.33
21,13,0,21.0,13.0,0.3704047203063965,756.3416558599957,36,633,446,1615,1013,230,159,36,72.55
18,13,0,18.0,13.0,0.37842369079589844,734.1396146992923,36,615,433,1615,1013,230,159,36,68.68
17,11,0,17.0,11.0,0.38663387298583984,713.9070979297851,36,598,422,1615,1013,230,159,36,63.03
14,10,0,14.0,10.0,0.39443373680114746,696.7027354082255,36,584,412,1615,1013,230,159,36,57.78
14,11,0,14.0,11.0,0.4024007320404053,678.9225208012724,36,570,401,1615,1013,230,159,36,56.34
12,10,0,12.0,10.0,0.41041064262390137,663.3552670963952,36,558,391,1615,1013,230,159,36,50.62
13,11,0,13.0,11.0,0.41844868659973145,646.3982239590952,36,545,380,1615,1013,230,159,36,52.48
13,10,0,13.0,10.0,0.4264068603515625,630.0154319150123,36,532,370,1615,1013,230,159,36,51.36
14,11,0,14.0,11.0,0.43441176414489746,612.2420170061656,36,518,359,1615,1013,230,159,36,52.84
13,10,0,13.0,10.0,0.4424717426300049,595.8615479079953,36,505,349,1615,1013,230,159,36,49.62
14,10,0,14.0,10.0,0.4504966735839844,578.6590316085059,36,491,339,1615,1013,230,159,36,51.37
14,10,0,14.0,10.0,0.4584238529205322,561.4566420363132,36,477,329,1615,1013,230,159,36,50.45
15,11,0,15.0,11.0,0.466444730758667,542.8636197864861,36,462,318,1615,1013,230,159,36,51.25
16,11,0,16.0,11.0,0.47440266609191895,523.4471350002694,36,446,307,1615,1013,230,159,36,53.07
16,11,0,16.0,11.0,0.482501745223999,504.0306504411403,36,430,296,1615,1013,230,159,36,51.91
16,11,0,16.0,11.0,0.4906296730041504,484.61416613541644,36,414,285,1615,1013,230,159,36,50.73
16,11,0,16.0,11.0,0.4984147548675537,465.1976821136459,36,398,274,1615,1013,230,159,36,49.53
14,10,0,14.0,10.0,0.5064058303833008,447.99570813474236,36,384,264,1615,1013,230,159,36,44.04
15,10,0,15.0,10.0,0.5144486427307129,429.96986505790767,36,369,254,1615,1013,230,159,36,44.31
14,9,0,14.0,9.0,0.522486686706543,413.335136523794,36,355,245,1615,1013,230,159,36,40.57
15,9,0,15.0,9.0,0.530444860458374,395.87920943193075,36,340,236,1615,1013,230,159,36,39.85
15,9,0,15.0,9.0,0.5385007858276367,378.42653796132265,36,325,227,1615,1013,230,159,36,38.68
17,11,0,17.0,11.0,0.5463888645172119,358.19144062564743,36,308,216,1615,1013,230,159,36,41.43
17,11,0,17.0,11.0,0.5544657707214355,337.9578626747835,36,291,205,1615,1013,230,159,36,39.86
17,11,0,17.0,11.0,0.5624098777770996,317.72607882021913,36,274,194,1615,1013,230,159,36,38.26
18,12,0,18.0,12.0,0.5704007148742676,296.10189429546585,36,256,182,1615,1013,230,159,36,38.29
19,13,0,19.0,13.0,0.5784096717834473,273.08418026406036,36,237,169,1615,1013,230,159,36,38.01
20,12,0,20.0,12.0,0.5864007472991943,249.83950418114205,36,217,157,1615,1013,230,159,36,34.4
18,12,0,18.0,12.0,0.594397783279419,228.22347572885897,36,199,145,1615,1013,230,159,36,32.02
17,11,0,17.0,11.0,0.6024258136749268,208.00884938426637,36,182,134,1615,1013,230,159,36,28.66
16,10,0,16.0,10.0,0.6103956699371338,189.20038610002638,36,166,124,1615,1013,230,159,36,25.51
15,10,0,15.0,10.0,0.6184008121490479,171.20095137181525,36,151,114,1615,1013,230,159,36,23.76
14,10,0,14.0,10.0,0.62640380859375,154.00290695217916,36,137,104,1615,1013,230,159,36,22.49
12,9,0,12.0,9.0,0.6351597309112549,139.00318468107582,36,125,95,1615,1013,230,159,36,20.98
11,7,0,11.0,7.0,0.642460823059082,126.01388821915754,36,114,88,1615,1013,230,159,36,15.94
11,9,0,11.0,9.0,0.6503958702087402,111.80754985747168,36,103,79,1615,1013,230,159,36,16.86
11,8,0,11.0,8.0,0.6584248542785645,98.21101496846157,36,92,71,1615,1013,230,159,36,15.49
11,7,0,11.0,7.0,0.6664278507232666,85.23274674249446,36,81,64,1615,1013,230,159,36,12.51
10,7,0,10.0,7.0,0.6744577884674072,73.0494371207203,36,71,57,1615,1013,230,159,36,11.7
10,6,0,10.0,6.0,0.6824038028717041,61.51100552753688,36,61,51,1615,1013,230,159,36,9.33
7,5,0,7.0,5.0,0.6906788349151611,52.9365914038728,36,54,46,1615,1013,230,159,36,8.29
7,4,0,7.0,4.0,0.6985318660736084,45.0317380372777,36,47,42,1615,1013,230,159,36,6.29
4,2,0,4.0,2.0,0.7064228057861328,40.728187440104094,36,43,40,1615,1013,230,159,36,4.27
2,1,0,2.0,1.0,0.7143948078155518,38.586217403180434,36,41,39,1615,1013,230,159,36,3.31
1,1,0,1.0,1.0,0.7224087715148926,37.17245689653489,36,40,38,1615,1013,230,159,36,5.97
1,0,0,1.0,-0.0,0.7304427623748779,36.45181356024793,36,39,38,1615,1013,230,159,36,1.37
0,1,0,-0.0,1.0,0.7385127544403076,35.75872022286245,36,39,37,1615,1013,230,159,36,1.28
1,1,0,1.0,1.0,0.7465057373046875,34.3450093132096,36,38,36,1615,1013,230,159,36,5.88
1,1,0,1.0,1.0,0.7543997764587402,32.93132631298737,36,37,35,1615,1013,230,159,36,5.83
1,1,0,1.0,1.0,0.7624087333679199,31.51767361255979,36,36,34,1615,1013,230,159,36,5.78
1,1,0,1.0,1.0,0.7704317569732666,30.104053883222775,36,35,33,1615,1013,230,159,36,5.73
1,2,0,1.0,2.0,0.7784597873687744,28.010868281309364,36,34,31,1615,1013,230,159,36,2.73
2,2,0,2.0,2.0,0.786402702331543,25.185645763378368,36,32,29,1615,1013,230,159,36,5.52
1,2,0,1.0,2.0,0.7944107055664062,23.10960958218893,36,31,27,1615,1013,230,159,36,2.51
1,2,0,1.0,2.0,0.8024387359619141,21.05124837953327,36,30,25,1615,1013,230,159,36,2.38
0,1,0,-0.0,1.0,0.8104476928710938,20.41874542459709,36,30,24,1615,1013,230,159,36,0.96
1,2,0,1.0,2.0,0.818443775177002,18.400549446402593,36,29,22,1615,1013,230,159,36,2.14
1,1,0,1.0,1.0,0.834406852722168,17.0,36,28,21,1615,1013,230,159,36,3.64
1,3,0,1.0,3.0,0.8424797058105469,14.449961479175904,36,27,18,1615,1013,230,159,36,1.53
1,2,0,1.0,2.0,0.85040283203125,12.528675044947494,36,26,16,1615,1013,230,159,36,1.66
2,2,0,2.0,2.0,0.8584468364715576,9.784887978899608,36,24,14,1615,1013,230,159,36,2.77
2,2,0,2.0,2.0,0.8663947582244873,7.059928172283335,36,22,12,1615,1013,230,159,36,2.5
2,3,0,2.0,3.0,0.8744237422943115,3.931712199461309,36,20,9,1615,1013,230,159,36,1.38
2,1,0,2.0,1.0,0.8824937343597412,1.6977156035922079,36,18,8,1615,1013,230,159,36,4.69
2,2,0,2.0,2.0,0.8903908729553223,-0.9119925093649393,36,16,6,1615,1013,230,159,36,1.51
1,1,0,1.0,1.0,0.8984057903289795,-2.1886116991581037,36,15,5,1615,1013,230,159,36,1.43
1,1,0,1.0,1.0,0.9146356582641602,-3.439780221438964,36,14,4,1615,1013,230,159,36,1.24
0,1,0,-0.0,1.0,0.9224166870117188,-3.6821789367236466,36,14,3,1615,1013,230,159,36,-0.12
1,1,0,1.0,1.0,0.9304087162017822,-4.847053562034095,36,13,2,1615,1013,230,159,36,0.85
0,0,1,-0.0,-0.0,0.9483928680419922,-4.847053562034095,36,13,2,1615,1013,230,159,36,25.54
0,1,1,-0.0,1.0,-0.00013494491577148438,490.71678010084156,37,-471,-238,1131,774,1602,1011,74,4.32
1,0,1,1.0,-0.0,0.015844106674194336,491.60949669865,37,-472,-238,1131,774,1602,1011,74,3.72
0,0,0,-0.0,-0.0,0.09485101699829102,491.60949669865,37,-472,-238,1131,774,1602,1011,74,133.88
-2,0,0,-2.0,-0.0,0.12786006927490234,489.8244489391129,37,-470,-238,1131,774,1602,1011,74,4.79
-1,0,0,-1.0,-0.0,0.1358799934387207,488.93250517533136,37,-469,-238,1131,774,1602,1011,74,3.33
-1,0,0,-1.0,-0.0,0.14384198188781738,488.04095078384125,37,-468,-238,1131,774,1602,1011,74,3.32
-3,-1,0,-3.0,-1.0,0.1519019603729248,484.9137859838538,37,-465,-237,1131,774,1602,1011,74,8.43
-3,-3,0,-3.0,-3.0,0.15985393524169922,480.880295048962,37,-462,-234,1131,774,1602,1011,74,8.77
-5,-5,0,-5.0,-5.0,0.16838908195495605,474.1653352879086,37,-457,-229,1131,774,1602,1011,74,12.54
-6,-5,0,-6.0,-5.0,0.1759049892425537,466.5642957954823,37,-451,-224,1131,774,1602,1011,74,14.07
-10,-8,0,-10.0,-8.0,0.18384003639221191,454.0570231653346,37,-441,-216,1131,774,1602,1011,74,20.04
-12,-11,0,-12.0,-11.0,0.19183802604675293,438.46398391465993,37,-429,-205,1131,774,1602,1011,74,22.62
-18,-13,0,-18.0,-13.0,0.19995403289794922,416.6353160855094,37,-411,-192,1131,774,1602,1011,74,28.52
-21,-15,0,-21.0,-15.0,0.2078571319580078,391.2861193174488,37,-390,-177,1131,774,1602,1011,74,30.27
-26,-18,0,-26.0,-18.0,0.21586203575134277,360.2115305476416,37,-364,-159,1131,774,1602,1011,74,32.75
-30,-17,0,-30.0,-17.0,0.22387313842773438,325.93250061133955,37,-334,-142,1131,774,1602,1011,74,33.3
-28,-14,0,-28.0,-14.0,0.2318429946899414,294.6926287996162,37,-306,-128,1131,774,1602,1011,74,30.11
-25,-10,0,-25.0,-10.0,0.24002504348754883,267.77040538739976,37,-281,-118,1131,774,1602,1011,74,27.38
-20,-7,0,-20.0,-7.0,0.24787306785583496,246.62298919516383,37,-261,-111,1131,774,1602,1011,74,21.21
-15,-6,0,-15.0,-6.0,0.25585103034973145,230.47149380821872,37,-246,-105,1131,774,1602,1011,74,18.41
-12,-6,0,-12.0,-6.0,0.26396608352661133,217.08069584287588,37,-234,-99,1131,774,1602,1011,74,14.91
-11,-5,0,-11.0,-5.0,0.2718510627746582,205.00206610688264,37,-223,-94,1131,774,1602,1011,74,14.52
-8,-5,0,-8.0,-5.0,0.2799060344696045,195.69293070482394,37,-215,-89,1131,774,1602,1011,74,10.23
-9,-5,0,-9.0,-5.0,0.2879059314727783,185.46797522340154,37,-206,-84,1131,774,1602,1011,74,10.94
-9,-6,0,-9.0,-6.0,0.29583096504211426,174.87968283910564,37,-197,-78,1131,774,1602,1011,74,10.05
-9,-5,0,-9.0,-5.0,0.30384016036987305,164.67548190099856,37,-188,-73,1131,774,1602,1011,74,10.07
-10,-4,0,-10.0,-4.0,0.3120701313018799,153.90573590125572,37,-178,-69,1131,774,1602,1011,74,12.73
-11,-5,0,-11.0,-5.0,0.31984496116638184,141.84350701101786,37,-167,-64,1131,774,1602,1011,74,11.24
-11,-6,0,-11.0,-6.0,0.32785916328430176,129.43316977093238,37,-156,-58,1131,774,1602,1011,74,9.78
-12,-5,0,-12.0,-5.0,0.33583903312683105,116.44380078712857,37,-144,-53,1131,774,1602,1011,74,11.01
-13,-6,0,-13.0,-6.0,0.3438420295715332,102.17614738165446,37,-131,-47,1131,774,1602,1011,74,9.9
-11,-5,0,-11.0,-5.0,0.35195302963256836,90.13772060250254,37,-120,-42,1131,774,1602,1011,74,8.53
-10,-5,0,-10.0,-5.0,0.3598439693450928,79.05602095539895,37,-110,-37,1131,774,1602,1011,74,7.16
-7,-2,0,-7.0,-2.0,0.36791110038757324,71.78419002777932,37,-103,-35,1131,774,1602,1011,74,7.07
-7,-3,0,-7.0,-3.0,0.3758859634399414,64.19288512538814,37,-96,-32,1131,774,1602,1011,74,6.28
-8,-3,0,-8.0,-3.0,0.38384294509887695,55.655275079188016,37,-88,-29,1131,774,1602,1011,74,7.11
-9,-4,0,-9.0,-4.0,0.3918290138244629,45.86132994346639,37,-79,-25,1131,774,1602,1011,74,5.71
-10,-4,0,-10.0,-4.0,0.3998379707336426,35.12489168102785,37,-69,-21,1131,774,1602,1011,74,5.76
-9,-2,0,-9.0,-2.0,0.40784215927124023,25.93647591023825,37,-60,-19,1131,774,1602,1011,74,5.07
-9,-3,0,-9.0,-3.0,0.4158611297607422,16.450912059571067,37,-51,-16,1131,774,1602,1011,74,6.6
-7,-2,0,-7.0,-2.0,0.4238860607147217,9.173585522460783,37,-44,-14,1131,774,1602,1011,74,5.55
-7,-3,0,-7.0,-3.0,0.43183016777038574,1.600518131237564,37,-37,-11,1131,774,1602,1011,74,3.51
-6,-1,0,-6.0,-1.0,0.4401841163635254,-4.427005050195341,37,-31,-10,1131,774,1602,1011,74,2.91
-7,-1,0,-7.0,-1.0,0.4478440284729004,-11.367988764047407,37,-24,-9,1131,774,1602,1011,74,2.02
-5,-1,0,-5.0,-1.0,0.4558391571044922,-16.384471871911696,37,-19,-8,1131,774,1602,1011,74,1.96
-5,0,0,-5.0,-0.0,0.46382904052734375,-20.8754845034029,37,-14,-8,1131,774,1602,1011,74,0.37
-3,0,0,-3.0,-0.0,0.4718339443206787,-23.398529491264554,37,-11,-8,1131,774,1602,1011,74,0.23
-1,0,0,-1.0,-0.0,0.4799520969390869,-24.193751525134303,37,-10,-8,1131,774,1602,1011,74,0.7
-1,0,0,-1.0,-0.0,0.4958350658416748,-24.958405421207704,37,-9,-8,1131,774,1602,1011,74,0.56
0,0,1,-0.0,-0.0,0.5098259449005127,-24.958405421207704,37,-9,-8,1131,774,1602,1011,74,20.3
-1,0,1,-1.0,-0.0,0.06015419960021973,1042.2319820948426,38,-1055,-51,84,731,1140,782,28,11.74
0,0,0,-0.0,-0.0,0.08518624305725098,1042.2319820948426,38,-1055,-51,84,731,1140,782,28,210.5
-1,0,0,-1.0,-0.0,0.09215331077575684,1041.2331495930177,38,-1054,-51,84,731,1140,782,28,11.74
-3,1,0,-3.0,1.0,0.10015034675598145,1038.2856076180078,38,-1051,-52,84,731,1140,782,28,21.5
-5,1,0,-5.0,1.0,0.1083221435546875,1033.3418735064497,38,-1046,-53,84,731,1140,782,28,33.1
-6,0,0,-6.0,-0.0,0.11646914482116699,1027.3496050798694,38,-1040,-53,84,731,1140,782,28,40.26
-9,0,0,-9.0,-0.0,0.12415337562561035,1018.3613708387195,38,-1031,-53,84,731,1140,782,28,53.46
-11,0,0,-11.0,-0.0,0.1322782039642334,1007.376032614825,38,-1020,-53,84,731,1140,782,28,60.87
-13,-2,0,-13.0,-2.0,0.14023327827453613,994.290632704678,38,-1007,-51,84,731,1140,782,28,66.89
-13,-1,0,-13.0,-1.0,0.14816737174987793,981.2567507934824,38,-994,-50,84,731,1140,782,28,67.72
-12,-3,0,-12.0,-3.0,0.15616917610168457,969.1241020339193,38,-982,-47,84,731,1140,782,28,61.94
-11,-3,0,-11.0,-3.0,0.16415619850158691,957.996399170285,38,-971,-44,84,731,1140,782,28,57.91
-10,-3,0,-10.0,-3.0,0.17226314544677734,947.8742121504246,38,-961,-41,84,731,1140,782,28,53.78
-9,-4,0,-9.0,-4.0,0.18016624450683594,938.71874128727,38,-952,-37,84,731,1140,782,28,49.25
-8,-4,0,-8.0,-4.0,0.1884012222290039,930.5766247372418,38,-944,-33,84,731,1140,782,28,44.82
-7,-3,0,-7.0,-3.0,0.1961512565612793,923.4801331228305,38,-937,-30,84,731,1140,782,28,40.45
-7,-5,0,-7.0,-5.0,0.20421814918518066,916.3359608227557,38,-930,-25,84,731,1140,782,28,39.82
-11,-6,0,-11.0,-6.0,0.21223115921020508,905.1963881565244,38,-919,-19,84,731,1140,782,28,55.04
-11,-6,0,-11.0,-6.0,0.22022724151611328,894.0930569055134,38,-908,-13,84,731,1140,782,28,54.51
-14,-6,0,-14.0,-6.0,0.22816920280456543,880.0274045016741,38,-894,-7,84,731,1140,782,28,63.55
-16,-8,0,-16.0,-8.0,0.2361433506011963,864.0005694758974,38,-878,1,84,731,1140,782,28,68.02
-19,-6,0,-19.0,-6.0,0.24416232109069824,845.0285210631833,38,-859,7,84,731,1140,782,28,74.82
-20,-6,0,-20.0,-6.0,0.2521531581878662,825.1007090927764,38,-839,13,84,731,1140,782,28,75.9
-20,-5,0,-20.0,-5.0,0.26018333435058594,805.1977783172999,38,-819,18,84,731,1140,782,28,74.94
-21,-3,0,-21.0,-3.0,0.2681703567504883,784.2762679674249,38,-798,21,84,731,1140,782,28,76.47
-20,-2,0,-20.0,-2.0,0.27614927291870117,764.3399000436763,38,-778,23,84,731,1140,782,28,73.68
-22,-2,0,-22.0,-2.0,0.2844693660736084,742.4132468432847,38,-756,25,84,731,1140,782,28,76.31
-23,-2,0,-23.0,-2.0,0.29219532012939453,719.4971029254308,38,-733,27,84,731,1140,782,28,76.65
-24,-1,0,-24.0,-1.0,0.30016517639160156,695.5526759867797,38,-709,28,84,731,1140,782,28,77.36
-25,0,0,-25.0,-0.0,0.30818819999694824,670.5728595262889,38,-684,28,84,731,1140,782,28,78.1
-28,0,0,-28.0,-0.0,0.3161962032318115,642.5972890592833,38,-656,28,84,731,1140,782,28,80.33
-29,0,0,-29.0,-0.0,0.32427120208740234,613.6248879705138,38,-627,28,84,731,1140,782,28,79.33
-27,1,0,-27.0,1.0,0.3321561813354492,586.6071927641227,38,-600,27,84,731,1140,782,28,76.16
-27,2,0,-27.0,2.0,0.34015321731567383,559.5451159237606,38,-573,25,84,731,1140,782,28,73.01
-25,1,0,-25.0,1.0,0.34815025329589844,534.5252956792422,38,-548,24,84,731,1140,782,28,69.75
-24,2,0,-24.0,2.0,0.3561532497406006,510.4616287203479,38,-524,22,84,731,1140,782,28,64.85
-24,1,0,-24.0,1.0,0.3641812801361084,486.4408056903434,38,-500,21,84,731,1140,782,28,64.94
-24,2,0,-24.0,2.0,0.37219715118408203,462.3790507568527,38,-476,19,84,731,1140,782,28,60.88
-24,1,0,-24.0,1.0,0.38015222549438477,438.35826509526714,38,-452,18,84,731,1140,782,28,60.8
-23,1,0,-23.0,1.0,0.3881652355194092,415.3366977093852,38,-429,17,84,731,1140,782,28,57.43
-21,2,0,-21.0,2.0,0.3962361812591553,394.2756421830722,38,-408,15,84,731,1140,782,28,51.09
-20,1,0,-20.0,1.0,0.4042782783508301,374.25249516261965,38,-388,14,84,731,1140,782,28,49.55
-19,1,0,-19.0,1.0,0.41216325759887695,355.2289262774519,38,-369,13,84,731,1140,782,28,46.52
-18,0,0,-18.0,-0.0,0.4201693534851074,337.2406582387637,38,-351,13,84,731,1140,782,28,42.99
-17,1,0,-17.0,1.0,0.42829132080078125,320.21549934136806,38,-334,12,84,731,1140,782,28,40.86
-18,1,0,-18.0,1.0,0.4362173080444336,302.1913977324494,38,-316,11,84,731,1140,782,28,40.69
-19,1,0,-19.0,1.0,0.44418835639953613,283.1683024819437,38,-297,10,84,731,1140,782,28,40.24
-18,0,0,-18.0,-0.0,0.452167272567749,265.17915394957413,38,-279,10,84,731,1140,782,28,36.86
-17,0,0,-17.0,-0.0,0.46016716957092285,248.19077024182218,38,-262,10,84,731,1140,782,28,34.2
-16,0,0,-16.0,-0.0,0.4681713581085205,232.20316813558676,38,-246,10,84,731,1140,782,28,31.66
-16,0,0,-16.0,-0.0,0.4761972427368164,216.21728866442677,38,-230,10,84,731,1140,782,28,30.16
-13,-1,0,-13.0,-1.0,0.48418331146240234,203.27862297059966,38,-217,11,84,731,1140,782,28,24.51
-11,0,0,-11.0,-0.0,0.49238133430480957,192.29348026537338,38,-206,11,84,731,1140,782,28,22.55
-11,0,0,-11.0,-0.0,0.5002462863922119,181.31000998412753,38,-195,11,84,731,1140,782,28,21.68
-11,0,0,-11.0,-0.0,0.5082013607025146,170.32851108821987,38,-184,11,84,731,1140,782,28,20.79
-10,0,0,-10.0,-0.0,0.5161721706390381,160.34735443934903,38,-174,11,84,731,1140,782,28,18.93
-10,1,0,-10.0,1.0,0.5242362022399902,150.30459518832697,38,-164,10,84,731,1140,782,28,18.84
-11,0,0,-11.0,-0.0,0.5321612358093262,139.32644912082193,38,-153,10,84,731,1140,782,28,18.29
-10,1,0,-10.0,1.0,0.5402393341064453,129.28293687665675,38,-143,9,84,731,1140,782,28,17.34
-9,0,0,-9.0,-0.0,0.548201322555542,120.30189872075525,38,-134,9,84,731,1140,782,28,15.02
-7,0,0,-7.0,-0.0,0.5562002658843994,113.3184982632139,38,-127,9,84,731,1140,782,28,12.65
-6,1,0,-6.0,1.0,0.5642311573028564,107.26417442921878,38,-121,8,84,731,1140,782,28,10.99
-4,0,0,-4.0,-0.0,0.5722651481628418,103.27318534089538,38,-117,8,84,731,1140,782,28,9.19
-5,0,0,-5.0,-0.0,0.580167293548584,98.28535078094559,38,-112,8,84,731,1140,782,28,9.93
-4,0,0,-4.0,-0.0,0.5881693363189697,94.29589096544707,38,-108,8,84,731,1140,782,28,8.74
-5,0,0,-5.0,-0.0,0.5961592197418213,89.31021246711285,38,-103,8,84,731,1140,782,28,9.4
-5,0,0,-5.0,-0.0,0.6041581630706787,84.32598842625484,38,-98,8,84,731,1140,782,28,9.1
-4,0,0,-4.0,-0.0,0.6122281551361084,80.33981132056604,38,-94,8,84,731,1140,782,28,8.02
-3,0,0,-3.0,-0.0,0.6202921867370605,77.35097153287424,38,-91,8,84,731,1140,782,28,6.99
-4,0,0,-4.0,-0.0,0.6281933784484863,73.36704184073076,38,-87,8,84,731,1140,782,28,7.63
-3,0,0,-3.0,-0.0,0.6366462707519531,70.38009243891595,38,-84,8,84,731,1140,782,28,6.67
-2,0,0,-2.0,-0.0,0.6442673206329346,68.38931969618392,38,-82,8,84,731,1140,782,28,5.74
-2,0,0,-2.0,-0.0,0.652482271194458,66.39900496896712,38,-80,8,84,731,1140,782,28,5.67
-1,0,0,-1.0,-0.0,0.6601712703704834,65.40403012442127,38,-79,8,84,731,1140,782,28,4.78
-2,0,0,-2.0,-0.0,0.6681473255157471,63.41446893184762,38,-77,8,84,731,1140,782,28,5.55
-1,0,0,-1.0,-0.0,0.6761603355407715,62.419892698171196,38,-76,8,84,731,1140,782,28,4.7
-3,0,0,-3.0,-0.0,0.6842403411865234,59.43704787094863,38,-73,8,84,731,1140,782,28,6.13
-3,0,0,-3.0,-0.0,0.6922903060913086,56.45565981523414,38,-70,8,84,731,1140,782,28,5.97
-3,1,0,-3.0,1.0,0.7001521587371826,53.36467917239716,38,-67,7,84,731,1140,782,28,5.07
-3,1,0,-3.0,1.0,0.7081592082977295,50.280634719952786,38,-64,6,84,731,1140,782,28,4.89
-3,1,0,-3.0,1.0,0.7161593437194824,47.204574992397426,38,-61,5,84,731,1140,782,28,4.7
-2,0,0,-2.0,-0.0,0.7242171764373779,45.21148537234985,38,-59,5,84,731,1140,782,28,5.38
-4,1,0,-4.0,1.0,0.7321732044219971,41.14526271584895,38,-55,4,84,731,1140,782,28,5.43
-5,0,0,-5.0,-0.0,0.7401721477508545,36.15974481593781,38,-50,4,84,731,1140,782,28,6.63
-6,2,0,-6.0,2.0,0.7481632232666016,30.045431091090478,38,-44,2,84,731,1140,782,28,5.0
-8,2,0,-8.0,2.0,0.7561733722686768,22.0,38,-36,0,84,731,1140,782,28,5.14
-8,3,0,-8.0,3.0,0.7641572952270508,14.160255680657446,38,-28,-3,84,731,1140,782,28,3.44
-7,2,0,-7.0,2.0,0.7721562385559082,7.587033144922902,38,-21,-5,84,731,1140,782,28,2.44
-5,1,0,-5.0,1.0,0.7801761627197266,3.0880074906350607,38,-16,-6,84,731,1140,782,28,1.59
-4,1,0,-4.0,1.0,0.7884602546691895,-0.10755601055019604,38,-12,-7,84,731,1140,782,28,0.64
-4,1,0,-4.0,1.0,0.796227216720581,-2.686291501015239,38,-8,-8,84,731,1140,782,28,-0.14
-3,1,0,-3.0,1.0,0.8041691780090332,-3.704369859012999,38,-5,-9,84,731,1140,782,28,-0.84
-2,0,0,-2.0,-0.0,0.8121683597564697,-4.513167019494862,38,-3,-9,84,731,1140,782,28,-0.5
-1,0,0,-1.0,-0.0,0.8202242851257324,-4.780455542707113,38,-2,-9,84,731,1140,782,28,-0.31
0,0,1,-0.0,-0.0,0.8601803779602051,-4.780455542707113,38,-2,-9,84,731,1140,782,28,25.560000000000002
0,0,0,-0.0,-0.0,0.08809804916381836,1812.9434208984312,39,1760,-560,1846,180,86,740,68,283.16
1,1,0,1.0,1.0,0.10910892486572266,1812.294126080674,39,1759,-561,1846,180,86,740,68,3.26
2,0,0,2.0,-0.0,0.11710190773010254,1810.38878764755,39,1757,-561,1846,180,86,740,68,9.94
2,0,0,2.0,-0.0,0.12511897087097168,1808.4836498596128,39,1755,-561,1846,180,86,740,68,9.93
3,0,0,3.0,-0.0,0.13310003280639648,1805.6263207510378,39,1752,-561,1846,180,86,740,68,13.52
4,0,0,4.0,-0.0,0.14109301567077637,1801.8172567006773,39,1748,-561,1846,180,86,740,68,17.01
4,0,0,4.0,-0.0,0.14910006523132324,1798.0090065280792,39,1744,-561,1846,180,86,740,68,16.98
6,1,0,6.0,1.0,0.15736794471740723,1792.6055950861423,39,1738,-562,1846,180,86,740,68,22.01
10,1,0,10.0,1.0,0.16510605812072754,1783.4028172092173,39,1728,-563,1846,180,86,740,68,34.63
16,2,0,16.0,2.0,0.17310595512390137,1768.8225092892533,39,1712,-565,1846,180,86,740,68,50.02
23,2,0,23.0,2.0,0.1811521053314209,1747.6312749836875,39,1689,-567,1846,180,86,740,68,66.33
28,1,0,28.0,1.0,0.1891639232635498,1721.432995018608,39,1661,-568,1846,180,86,740,68,76.86
34,0,0,34.0,-0.0,0.19713091850280762,1689.2971305030367,39,1627,-568,1846,180,86,740,68,87.61
38,-2,0,38.0,-2.0,0.20514202117919922,1652.7948897242961,39,1589,-566,1846,180,86,740,68,94.27
41,-5,0,41.0,-5.0,0.21311306953430176,1612.519055462159,39,1548,-561,1846,180,86,740,68,99.28
43,-6,0,43.0,-6.0,0.22110295295715332,1570.0729409849166,39,1505,-555,1846,180,86,740,68,101.13
45,-9,0,45.0,-9.0,0.22910809516906738,1524.7546311077956,39,1460,-546,1846,180,86,740,68,103.9
43,-9,0,43.0,-9.0,0.2371070384979248,1481.3408857415548,39,1417,-537,1846,180,86,740,68,99.83
41,-8,0,41.0,-8.0,0.24508905410766602,1440.1835028245296,39,1376,-529,1846,180,86,740,68,95.13
38,-9,0,38.0,-9.0,0.25321102142333984,1401.494339940078,39,1338,-520,1846,180,86,740,68,90.61
36,-10,0,36.0,-10.0,0.2610969543457031,1364.321851363269,39,1302,-510,1846,180,86,740,68,87.54
35,-11,0,35.0,-11.0,0.26920509338378906,1327.723173042157,39,1267,-499,1846,180,86,740,68,85.91
37,-13,0,37.0,-13.0,0.2770979404449463,1288.5339315117778,39,1230,-486,1846,180,86,740,68,88.84
35,-14,0,35.0,-14.0,0.2851080894470215,1250.838122099434,39,1195,-472,1846,180,86,740,68,86.95
34,-15,0,34.0,-15.0,0.2931520938873291,1213.7058948325923,39,1161,-457,1846,180,86,740,68,83.25
32,-13,0,32.0,-13.0,0.30110692977905273,1179.1681664138735,39,1129,-444,1846,180,86,740,68,79.51
33,-13,0,33.0,-13.0,0.30910611152648926,1143.6998768786555,39,1096,-431,1846,180,86,740,68,80.31
32,-13,0,32.0,-13.0,0.31716299057006836,1109.1622806933406,39,1064,-418,1846,180,86,740,68,76.95
31,-13,0,31.0,-13.0,0.3251371383666992,1075.5557669626164,39,1033,-405,1846,180,86,740,68,73.88
34,-14,0,34.0,-14.0,0.33326292037963867,1038.791685277249,39,999,-391,1846,180,86,740,68,76.84
33,-13,0,33.0,-13.0,0.3410921096801758,1003.3234789591913,39,966,-378,1846,180,86,740,68,74.76
33,-13,0,33.0,-13.0,0.3491029739379883,967.8552789699718,39,933,-365,1846,180,86,740,68,73.32
33,-11,0,33.0,-11.0,0.3571901321411133,933.1173661970919,39,900,-354,1846,180,86,740,68,68.91
32,-10,0,32.0,-10.0,0.36514997482299805,899.6808876698719,39,868,-344,1846,180,86,740,68,65.52
34,-10,0,34.0,-10.0,0.37308692932128906,864.3941228659056,39,834,-334,1846,180,86,740,68,65.92
32,-11,0,32.0,-11.0,0.38111209869384766,830.5999074716583,39,802,-323,1846,180,86,740,68,63.44
33,-13,0,33.0,-13.0,0.38911008834838867,795.132679370437,39,769,-310,1846,180,86,740,68,65.37
32,-13,0,32.0,-13.0,0.39711594581604004,760.5929775677608,39,737,-297,1846,180,86,740,68,63.17
33,-13,0,33.0,-13.0,0.4051370620727539,725.1258130244288,39,704,-284,1846,180,86,740,68,62.04
30,-11,0,30.0,-11.0,0.41310811042785645,693.1897964080629,39,674,-273,1846,180,86,740,68,55.64
30,-10,0,30.0,-10.0,0.42109012603759766,661.6328054368914,39,644,-263,1846,180,86,740,68,52.98
28,-9,0,28.0,-9.0,0.42949891090393066,632.3122391191686,39,616,-254,1846,180,86,740,68,48.99
26,-8,0,26.0,-8.0,0.4372849464416504,605.2307877441449,39,590,-246,1846,180,86,740,68,45.11
24,-7,0,24.0,-7.0,0.44510912895202637,580.3915689525695,39,566,-239,1846,180,86,740,68,41.32
22,-7,0,22.0,-7.0,0.45310306549072266,557.4051065048391,39,544,-232,1846,180,86,740,68,38.53
19,-5,0,19.0,-5.0,0.46109700202941895,537.9737756226242,39,525,-227,1846,180,86,740,68,33.06
19,-6,0,19.0,-6.0,0.46919703483581543,518.1566806622917,39,506,-221,1846,180,86,740,68,33.22
17,-6,0,17.0,-6.0,0.47717714309692383,500.1778729973753,39,489,-215,1846,180,86,740,68,30.85
16,-7,0,16.0,-7.0,0.48511505126953125,482.7136537774089,39,473,-208,1846,180,86,740,68,32.14
16,-7,0,16.0,-7.0,0.4931619167327881,465.24943665466463,39,457,-201,1846,180,86,740,68,31.5
15,-8,0,15.0,-8.0,0.5011849403381348,448.2996993571528,39,442,-193,1846,180,86,740,68,27.72
14,-8,0,14.0,-8.0,0.50913405418396,432.2713802068491,39,428,-185,1846,180,86,740,68,25.67
14,-8,0,14.0,-8.0,0.5170941352844238,416.24993059410906,39,414,-177,1846,180,86,740,68,25.04
12,-7,0,12.0,-7.0,0.525109052658081,402.46763912116097,39,402,-170,1846,180,86,740,68,21.98
15,-8,0,15.0,-8.0,0.5331161022186279,385.5390327490399,39,387,-162,1846,180,86,740,68,25.08
15,-8,0,15.0,-8.0,0.5410990715026855,368.6164427839479,39,372,-154,1846,180,86,740,68,24.35
17,-8,0,17.0,-8.0,0.5491440296173096,349.8502312100385,39,355,-146,1846,180,86,740,68,26.08
16,-8,0,16.0,-8.0,0.5572469234466553,332.0122948754591,39,339,-138,1846,180,86,740,68,23.94
17,-10,0,17.0,-10.0,0.5650999546051025,312.5082971589569,39,322,-128,1846,180,86,740,68,23.54
17,-10,0,17.0,-10.0,0.5730960369110107,293.03057960991964,39,305,-118,1846,180,86,740,68,22.48
16,-10,0,16.0,-10.0,0.5811140537261963,274.5206638136253,39,289,-108,1846,180,86,740,68,20.54
16,-9,0,16.0,-9.0,0.589155912399292,256.3962809679215,39,273,-99,1846,180,86,740,68,19.64
15,-9,0,15.0,-9.0,0.5971100330352783,239.24714088165678,39,258,-90,1846,180,86,740,68,17.81
13,-8,0,13.0,-8.0,0.6052601337432861,224.3582783655287,39,245,-82,1846,180,86,740,68,15.39
12,-7,0,12.0,-7.0,0.613102912902832,210.77336456403913,39,233,-75,1846,180,86,740,68,13.98
12,-7,0,12.0,-7.0,0.6211440563201904,197.22499864850255,39,221,-68,1846,180,86,740,68,13.29
11,-6,0,11.0,-6.0,0.629094123840332,184.96118377465902,39,210,-62,1846,180,86,740,68,12.06
11,-7,0,11.0,-7.0,0.6371090412139893,172.46065000382035,39,199,-55,1846,180,86,740,68,11.22
11,-6,0,11.0,-6.0,0.6451230049133301,160.28072472584614,39,188,-49,1846,180,86,740,68,10.79
11,-5,0,11.0,-5.0,0.6531100273132324,148.3869512876401,39,177,-44,1846,180,86,740,68,10.53
10,-4,0,10.0,-4.0,0.66115403175354,137.72361514946044,39,167,-40,1846,180,86,740,68,9.76
10,-5,0,10.0,-5.0,0.6691670417785645,126.85397104206038,39,157,-35,1846,180,86,740,68,8.71
11,-4,0,11.0,-4.0,0.6771020889282227,115.25481566770299,39,146,-31,1846,180,86,740,68,9.32
12,-4,0,12.0,-4.0,0.6851749420166016,102.69308687713507,39,134,-27,1846,180,86,740,68,9.3
12,-6,0,12.0,-6.0,0.6931219100952148,89.79418403139947,39,122,-21,1846,180,86,740,68,7.58
14,-5,0,14.0,-5.0,0.7013590335845947,75.17875251164945,39,108,-16,1846,180,86,740,68,7.88
14,-5,0,14.0,-5.0,0.7091019153594971,60.641428560646744,39,94,-11,1846,180,86,740,68,6.8
13,-5,0,13.0,-5.0,0.7171640396118164,47.2219182240853,39,81,-6,1846,180,86,740,68,5.38
11,-4,0,11.0,-4.0,0.7251250743865967,36.02856560004639,39,70,-2,1846,180,86,740,68,4.22
9,-3,0,9.0,-3.0,0.733130931854248,27.008196170678573,39,61,1,1846,180,86,740,68,3.35
5,-2,0,5.0,-2.0,0.7411019802093506,22.080299571239813,39,56,3,1846,180,86,740,68,2.29
2,-1,0,2.0,-1.0,0.7491099834442139,20.147945482723536,39,54,4,1846,180,86,740,68,1.69
1,0,0,1.0,-0.0,0.7570970058441162,19.150729063673246,39,53,4,1846,180,86,740,68,4.28
1,-1,0,1.0,-1.0,0.7651031017303467,18.23983154643591,39,52,5,1846,180,86,740,68,0.9
1,0,0,1.0,-0.0,0.7731161117553711,17.24451190127583,39,51,5,1846,180,86,740,68,3.95
1,-1,0,1.0,-1.0,0.7811751365661621,16.358713248056688,39,50,6,1846,180,86,740,68,0.84
1,0,0,1.0,-0.0,0.789107084274292,15.365980188789933,39,49,6,1846,180,86,740,68,3.65
1,-1,0,1.0,-1.0,0.7972230911254883,14.507731342539614,39,48,7,1846,180,86,740,68,0.78
2,0,0,2.0,-0.0,0.8051459789276123,12.529560496527367,39,46,7,1846,180,86,740,68,3.36
1,-1,0,1.0,-1.0,0.8130950927734375,11.705579528105758,39,45,8,1846,180,86,740,68,0.7
1,0,0,1.0,-0.0,0.8211069107055664,10.721359549995796,39,44,8,1846,180,86,740,68,3.1
0,0,1,-0.0,-0.0,0.8561100959777832,10.721359549995796,39,44,8,1846,180,86,740,68,30.1
0,1,1,-0.0,1.0,0.8610949516296387,10.553338819890925,39,44,7,1846,180,86,740,68,10.13
0,3,1,-0.0,3.0,0.8691210746765137,10.181444068749045,39,44,4,1846,180,86,740,68,9.8
0,3,1,-0.0,3.0,0.8771510124206543,10.011362169330773,39,44,1,1846,180,86,740,68,9.71
0,4,1,-0.0,4.0,0.8851139545440674,10.10215414239989,39,44,-3,1846,180,86,740,68,11.35
0,2,1,-0.0,2.0,0.8930869102478027,10.28317965096906,39,44,-5,1846,180,86,740,68,10.83
0,1,1,-0.0,1.0,0.9012439250946045,10.407206622349037,39,44,-6,1846,180,86,740,68,11.46
0,0,0,-0.0,-0.0,0.964108943939209,10.407206622349037,39,44,-6,1846,180,86,740,68,20.0
-1,1,0,-1.0,1.0,0.9812121391296387,11.541190146942803,39,45,-7,1846,180,86,740,68,1.2
-4,3,0,-4.0,3.0,0.9894440174102783,16.009999000199947,39,49,-10,1846,180,86,740,68,0.89
-6,5,0,-6.0,5.0,0.9971020221710205,23.008771254956898,39,55,-15,1846,180,86,740,68,0.63
-9,7,0,-9.0,7.0,1.0051219463348389,33.675697262754525,39,64,-22,1846,180,86,740,68,0.75
-12,9,0,-12.0,9.0,1.0132780075073242,48.079230015881606,39,76,-31,1846,180,86,740,68,0.99
-15,9,0,-15.0,9.0,1.0211410522460938,65.40321926376429,39,91,-40,1846,180,86,740,68,2.02
-15,10,0,-15.0,10.0,1.0291080474853516,83.2006825918689,39,106,-50,1846,180,86,740,68,1.96
-16,10,0,-16.0,10.0,1.0371041297912598,101.95587519485872,39,122,-60,1846,180,86,740,68,2.58
-15,8,0,-15.0,8.0,1.0450959205627441,118.9477034806342,39,137,-68,1846,180,86,740,68,4.37
-12,7,0,-12.0,7.0,1.0530900955200195,132.8112706024386,39,149,-75,1846,180,86,740,68,3.68
-11,7,0,-11.0,7.0,1.0611510276794434,145.78876494375282,39,160,-82,1846,180,86,740,68,3.26
-10,6,0,-10.0,6.0,1.0692119598388672,157.42622599842477,39,170,-88,1846,180,86,740,68,3.87
-7,5,0,-7.0,5.0,1.0771639347076416,165.9449924354196,39,177,-93,1846,180,86,740,68,3.08
-6,6,0,-6.0,6.0,1.0851061344146729,174.06249061279644,39,183,-99,1846,180,86,740,68,2.1
-3,3,0,-3.0,3.0,1.0931949615478516,178.13203435596427,39,186,-102,1846,180,86,740,68,2.48
-1,0,0,-1.0,-0.0,1.101119041442871,179.00938946440834,39,187,-102,1846,180,86,740,68,2.71
5,-1,0,5.0,-1.0,1.181102991104126,174.1465829649865,39,182,-101,1846,180,86,740,68,6.19
9,-4,0,9.0,-4.0,1.1891019344329834,164.33809518093088,39,173,-97,1846,180,86,740,68,10.85
12,-5,0,12.0,-5.0,1.1971380710601807,151.43192821086663,39,161,-92,1846,180,86,740,68,11.73
14,-6,0,14.0,-6.0,1.2051639556884766,136.30854353202602,39,147,-86,1846,180,86,740,68,12.09
13,-6,0,13.0,-6.0,1.213197946548462,122.06408939919524,39,134,-80,1846,180,86,740,68,11.16
13,-6,0,13.0,-6.0,1.2210979461669922,107.83441049336369,39,121,-74,1846,180,86,740,68,10.28
12,-7,0,12.0,-7.0,1.2291021347045898,93.94530081249565,39,109,-67,1846,180,86,740,68,11.38
14,-6,0,14.0,-6.0,1.237191915512085,78.89818421923357,39,95,-61,1846,180,86,740,68,8.46
13,-7,0,13.0,-7.0,1.2451181411743164,64.18350166906862,39,82,-54,1846,180,86,740,68,8.34
12,-6,0,12.0,-6.0,1.2531030178070068,50.87638069569178,39,70,-48,1846,180,86,740,68,6.64
10,-5,0,10.0,-5.0,1.2611830234527588,39.81734213584231,39,60,-43,1846,180,86,740,68,5.39
6,-2,0,6.0,-2.0,1.2691400051116943,33.801179930735714,39,54,-41,1846,180,86,740,68,3.22
4,-2,0,4.0,-2.0,1.2774109840393066,29.41135544995076,39,50,-39,1846,180,86,740,68,3.55
1,0,0,1.0,-0.0,1.2850940227508545,28.625873247404705,39,49,-39,1846,180,86,740,68,1.38
0,0,1,-0.0,-0.0,1.35715913772583,28.625873247404705,39,49,-39,1846,180,86,740,68,35.53
0,0,0,-0.0,-0.0,0.11237668991088867,586.905237749675,40,-580,-113,1217,106,1797,219,8,149.69
-2,1,0,-2.0,1.0,0.182356595993042,585.1349590713489,40,-578,-114,1217,106,1797,219,8,27.19
-8,4,0,-8.0,4.0,0.19037175178527832,578.0859043131005,40,-570,-118,1217,106,1797,219,8,67.53
-15,8,0,-15.0,8.0,0.19838666915893555,565.1230095506594,40,-555,-126,1217,106,1797,219,8,87.25
-21,12,0,-21.0,12.0,0.20643973350524902,547.5432893255071,40,-534,-138,1217,106,1797,219,8,94.67
-26,13,0,-26.0,13.0,0.21443581581115723,525.9669801034778,40,-508,-151,1217,106,1797,219,8,97.78
-32,18,0,-32.0,18.0,0.22236275672912598,501.1108789166988,40,-476,-169,1217,106,1797,219,8,97.88
-35,17,0,-35.0,17.0,0.2308816909790039,474.61989093642984,40,-441,-186,1217,106,1797,219,8,95.77
-37,15,0,-37.0,15.0,0.2385725975036621,447.2394043077355,40,-404,-201,1217,106,1797,219,8,92.66
-37,14,0,-37.0,14.0,0.24639558792114258,421.3398641086913,40,-367,-215,1217,106,1797,219,8,87.74
-35,11,0,-35.0,11.0,0.2543516159057617,397.62171256046406,40,-332,-226,1217,106,1797,219,8,82.51
-34,6,0,-34.0,6.0,0.2623608112335205,373.6612238501591,40,-298,-232,1217,106,1797,219,8,79.32
-31,3,0,-31.0,3.0,0.27046680450439453,351.6880655855633,40,-267,-235,1217,106,1797,219,8,74.41
-29,-1,0,-29.0,-1.0,0.27839159965515137,329.7663853655727,40,-238,-234,1217,106,1797,219,8,71.19
-27,-6,0,-27.0,-6.0,0.2863636016845703,306.65253902068787,40,-211,-228,1217,106,1797,219,8,68.82
-23,-9,0,-23.0,-9.0,0.29436373710632324,284.62605564986677,40,-188,-219,1217,106,1797,219,8,64.77
-21,-11,0,-21.0,-11.0,0.30266571044921875,262.74519677025114,40,-167,-208,1217,106,1797,219,8,61.29
-17,-11,0,-17.0,-11.0,0.31078076362609863,243.6065427245411,40,-150,-197,1217,106,1797,219,8,56.25
-13,-13,0,-13.0,-13.0,0.31836962699890137,225.40139493908924,40,-137,-184,1217,106,1797,219,8,53.64
-8,-11,0,-8.0,-11.0,0.32634758949279785,211.8008341040414,40,-129,-173,1217,106,1797,219,8,49.67
-4,-11,0,-4.0,-11.0,0.3344876766204834,200.6191584383046,40,-125,-162,1217,106,1797,219,8,41.07
-1,-10,0,-1.0,-10.0,0.34235358238220215,192.16319736382766,40,-124,-152,1217,106,1797,219,8,34.5
0,-10,0,-0.0,-10.0,0.35036277770996094,184.52055590836773,40,-124,-142,1217,106,1797,219,8,31.62
0,-10,0,-0.0,-10.0,0.3585326671600342,177.10770276274835,40,-124,-132,1217,106,1797,219,8,30.14
0,-8,0,-0.0,-8.0,0.3663628101348877,171.36248173426378,40,-124,-124,1217,106,1797,219,8,25.68
-1,-9,0,-1.0,-9.0,0.3744378089904785,164.3864602632884,40,-123,-115,1217,106,1797,219,8,27.78
-1,-8,0,-1.0,-8.0,0.38239574432373047,158.27445886522005,40,-122,-107,1217,106,1797,219,8,25.18
-1,-8,0,-1.0,-8.0,0.3903827667236328,152.33937443907084,40,-121,-99,1217,106,1797,219,8,24.03
-2,-7,0,-2.0,-7.0,0.39835476875305176,146.41608956491322,40,-119,-92,1217,106,1797,219,8,23.6
-3,-11,0,-3.0,-11.0,0.40636563301086426,137.4814475470194,40,-116,-81,1217,106,1797,219,8,27.4
-4,-10,0,-4.0,-10.0,0.4143517017364502,128.60844618650805,40,-112,-71,1217,106,1797,219,8,26.17
-5,-10,0,-5.0,-10.0,0.42234373092651367,119.1665539016173,40,-107,-61,1217,106,1797,219,8,25.52
-7,-10,0,-7.0,-10.0,0.43053674697875977,108.25417586887359,40,-100,-51,1217,106,1797,219,8,25.53
-7,-9,0,-7.0,-9.0,0.4383697509765625,98.04410811016969,40,-93,-42,1217,106,1797,219,8,23.18
-7,-8,0,-7.0,-8.0,0.4463846683502197,88.47702417357513,40,-86,-34,1217,106,1797,219,8,21.04
-6,-6,0,-6.0,-6.0,0.4543647766113281,80.75848040166836,40,-80,-28,1217,106,1797,219,8,18.11
-2,-6,0,-2.0,-6.0,0.4624016284942627,77.04319835741924,40,-78,-22,1217,106,1797,219,8,10.82
-2,-4,0,-2.0,-4.0,0.4703648090362549,74.10249675906654,40,-76,-18,1217,106,1797,219,8,9.24
-1,-3,0,-1.0,-3.0,0.47836875915527344,72.48529270389177,40,-75,-15,1217,106,1797,219,8,5.75
-1,-3,0,-1.0,-3.0,0.486419677734375,70.96665925596525,40,-74,-12,1217,106,1797,219,8,5.35
-1,-2,0,-1.0,-2.0,0.4944617748260498,69.68174807915459,40,-73,-10,1217,106,1797,219,8,4.87
-1,-1,0,-1.0,-1.0,0.5024237632751465,68.56031973468694,40,-72,-9,1217,106,1797,219,8,4.97
-1,-1,0,-1.0,-1.0,0.5104045867919922,67.449282711585,40,-71,-8,1217,106,1797,219,8,4.87
-2,-1,0,-2.0,-1.0,0.5183577537536621,65.35416353759881,40,-69,-7,1217,106,1797,219,8,8.1
-2,-1,0,-2.0,-1.0,0.5264256000518799,63.268120235368556,40,-67,-6,1217,106,1797,219,8,7.9
-3,0,0,-3.0,-0.0,0.5344126224517822,60.280634719952786,40,-64,-6,1217,106,1797,219,8,11.32
-2,-1,0,-2.0,-1.0,0.5423617362976074,58.20128616033595,40,-62,-5,1217,106,1797,219,8,7.51
-2,0,0,-2.0,-0.0,0.5503838062286377,56.207972893961475,40,-60,-5,1217,106,1797,219,8,9.26
-2,-1,0,-2.0,-1.0,0.5583956241607666,54.137767414994535,40,-58,-4,1217,106,1797,219,8,7.18
-3,0,0,-3.0,-0.0,0.5663735866546631,51.14526271584895,40,-55,-4,1217,106,1797,219,8,10.83
-3,-1,0,-3.0,-1.0,0.5744187831878662,48.08646657242167,40,-52,-3,1217,106,1797,219,8,8.94
-4,-1,0,-4.0,-1.0,0.5824687480926514,44.041648597857254,40,-48,-2,1217,106,1797,219,8,10.19
-4,0,0,-4.0,-0.0,0.5903627872467041,40.04543109109048,40,-44,-2,1217,106,1797,219,8,11.63
-4,-1,0,-4.0,-1.0,0.5984077453613281,36.01249804748511,40,-40,-1,1217,106,1797,219,8,9.14
-4,0,0,-4.0,-0.0,0.606360673904419,32.013886210738214,40,-36,-1,1217,106,1797,219,8,11.28
-3,0,0,-3.0,-0.0,0.614370584487915,29.015148038438355,40,-33,-1,1217,106,1797,219,8,9.81
-3,-1,0,-3.0,-1.0,0.6223597526550293,26.0,40,-30,0,1217,106,1797,219,8,6.46
-4,0,0,-4.0,-0.0,0.6303677558898926,22.0,40,-26,0,1217,106,1797,219,8,12.27
-2,0,0,-2.0,-0.0,0.6384487152099609,20.0,40,-24,0,1217,106,1797,219,8,9.9
-2,0,0,-2.0,-0.0,0.6466867923736572,18.0,40,-22,0,1217,106,1797,219,8,9.77
-3,0,0,-3.0,-0.0,0.6544907093048096,15.0,40,-19,0,1217,106,1797,219,8,10.66
-3,0,0,-3.0,-0.0,0.6623647212982178,12.0,40,-16,0,1217,106,1797,219,8,10.42
-2,0,0,-2.0,-0.0,0.6703696250915527,10.0,40,-14,0,1217,106,1797,219,8,9.29
-3,0,0,-3.0,-0.0,0.6784086227416992,7.0,40,-11,0,1217,106,1797,219,8,10.01
-2,0,0,-2.0,-0.0,0.6863646507263184,5.0,40,-9,0,1217,106,1797,219,8,8.99
-1,0,0,-1.0,-0.0,0.694664716720581,4.0,40,-8,0,1217,106,1797,219,8,7.92
-1,0,0,-1.0,-0.0,0.7024657726287842,3.0,40,-7,0,1217,106,1797,219,8,7.88
-1,0,0,-1.0,-0.0,0.710364580154419,2.0,40,-6,0,1217,106,1797,219,8,7.85
-1,0,0,-1.0,-0.0,0.7663576602935791,1.0,40,-5,0,1217,106,1797,219,8,7.82
-1,0,0,-1.0,-0.0,0.7743597030639648,0.0,40,-4,0,1217,106,1797,219,8,7.79
-1,-1,0,-1.0,-1.0,0.782362699508667,-0.8377223398316205,40,-3,1,1217,106,1797,219,8,-0.25
0,0,1,-0.0,-0.0,0.8603618144989014,-0.8377223398316205,40,-3,1,1217,106,1797,219,8,26.69
0,0,0,-0.0,-0.0,0.11586976051330566,744.8216945088149,41,419,617,1639,722,1220,105,3,173.14
0,1,0,-0.0,1.0,0.2158949375152588,743.9946308531357,41,419,616,1639,722,1220,105,3,37.45
0,7,0,-0.0,7.0,0.22390389442443848,738.2171534806264,41,419,609,1639,722,1220,105,3,110.37
1,7,0,1.0,7.0,0.23184585571289062,731.8901691249515,41,418,602,1639,722,1220,105,3,113.46
1,9,0,1.0,9.0,0.23985576629638672,723.9399975170359,41,417,593,1639,722,1220,105,3,120.36
3,12,0,3.0,12.0,0.24820971488952637,712.4122230520023,41,414,581,1639,722,1220,105,3,130.45
5,12,0,5.0,12.0,0.25586986541748047,699.7438904478582,41,409,569,1639,722,1220,105,3,132.08
5,15,0,5.0,15.0,0.2638547420501709,684.6617241759963,41,404,554,1639,722,1220,105,3,133.89
6,17,0,6.0,17.0,0.27185583114624023,667.4108018277383,41,398,537,1639,722,1220,105,3,134.54
8,18,0,8.0,18.0,0.2798447608947754,648.2002772642661,41,390,519,1639,722,1220,105,3,134.44
10,20,0,10.0,20.0,0.28786778450012207,626.2168683956132,41,380,499,1639,722,1220,105,3,134.0
12,20,0,12.0,20.0,0.2958557605743408,603.040561551954,41,368,479,1639,722,1220,105,3,132.26
14,19,0,14.0,19.0,0.303851842880249,579.4446571379566,41,354,460,1639,722,1220,105,3,131.12
14,17,0,14.0,17.0,0.31193971633911133,557.4344187100219,41,340,443,1639,722,1220,105,3,126.5
17,18,0,17.0,18.0,0.3198678493499756,532.8108279156578,41,323,425,1639,722,1220,105,3,123.06
16,18,0,16.0,18.0,0.3278927803039551,508.80192231885513,41,307,407,1639,722,1220,105,3,119.48
18,18,0,18.0,18.0,0.3358597755432129,483.6049937835969,41,289,389,1639,722,1220,105,3,115.38
19,19,0,19.0,19.0,0.3439037799835205,457.0392996239515,41,270,370,1639,722,1220,105,3,111.65
17,20,0,17.0,20.0,0.3518998622894287,430.86687763707926,41,253,350,1639,722,1220,105,3,108.06
18,20,0,18.0,20.0,0.3598928451538086,404.123437979093,41,235,330,1639,722,1220,105,3,103.26
19,20,0,19.0,20.0,0.3679049015045166,376.8306498948967,41,216,310,1639,722,1220,105,3,98.29
17,19,0,17.0,19.0,0.3758518695831299,351.5365229306036,41,199,291,1639,722,1220,105,3,93.24
19,18,0,19.0,18.0,0.38389086723327637,326.0,41,180,273,1639,722,1220,105,3,87.81
19,18,0,19.0,18.0,0.39190173149108887,300.57254516948325,41,161,255,1639,722,1220,105,3,82.78
19,16,0,19.0,16.0,0.39984989166259766,277.0017985553331,41,142,239,1639,722,1220,105,3,77.1
16,13,0,16.0,13.0,0.4078488349914551,257.75084540924695,41,126,226,1639,722,1220,105,3,71.36
15,11,0,15.0,11.0,0.4158947467803955,240.96280705926685,41,111,215,1639,722,1220,105,3,66.46
13,11,0,13.0,11.0,0.42386674880981445,225.3183598385248,41,98,204,1639,722,1220,105,3,62.78
12,11,0,12.0,11.0,0.43198180198669434,210.29363454680788,41,86,193,1639,722,1220,105,3,59.37
9,8,0,9.0,8.0,0.4398527145385742,199.38463014912097,41,77,185,1639,722,1220,105,3,53.82
7,8,0,7.0,8.0,0.4479029178619385,189.33917095542893,41,70,177,1639,722,1220,105,3,51.34
5,6,0,5.0,6.0,0.45590686798095703,181.9371476764629,41,65,171,1639,722,1220,105,3,46.39
4,7,0,4.0,7.0,0.4640679359436035,173.9771413642365,41,61,164,1639,722,1220,105,3,46.76
4,7,0,4.0,7.0,0.47185373306274414,166.0269439342048,41,57,157,1639,722,1220,105,3,45.17
4,7,0,4.0,7.0,0.4798598289489746,158.08802594790095,41,53,150,1639,722,1220,105,3,43.55
2,6,0,2.0,6.0,0.4878697395324707,151.76452467768817,41,51,144,1639,722,1220,105,3,42.42
2,6,0,2.0,6.0,0.4958658218383789,145.44111444536333,41,49,138,1639,722,1220,105,3,41.22
2,5,0,2.0,5.0,0.5038797855377197,140.06027080648894,41,47,133,1639,722,1220,105,3,37.67
0,4,0,-0.0,4.0,0.5120038986206055,136.2953021774598,41,47,129,1639,722,1220,105,3,30.03
1,3,0,1.0,3.0,0.5198748111724854,133.13426109685773,41,46,126,1639,722,1220,105,3,30.53
0,3,0,-0.0,3.0,0.5278568267822266,130.3202193114221,41,46,123,1639,722,1220,105,3,25.61
0,4,0,-0.0,4.0,0.5358738899230957,126.58134659894448,41,46,119,1639,722,1220,105,3,28.37
1,5,0,1.0,5.0,0.5438687801361084,121.56018929489298,41,45,114,1639,722,1220,105,3,31.8
0,6,0,-0.0,6.0,0.5518379211425781,116.0,41,45,108,1639,722,1220,105,3,30.71
1,7,0,1.0,7.0,0.5598609447479248,109.16805344563369,41,44,101,1639,722,1220,105,3,31.84
0,7,0,-0.0,7.0,0.5679128170013428,102.78824596263297,41,44,94,1639,722,1220,105,3,29.27
1,9,0,1.0,9.0,0.5758388042449951,94.25754563287887,41,43,85,1639,722,1220,105,3,30.0
2,6,0,2.0,6.0,0.5844097137451172,88.00561780022652,41,41,79,1639,722,1220,105,3,27.57
2,5,0,2.0,5.0,0.5918548107147217,82.64807230295268,41,39,74,1639,722,1220,105,3,25.87
2,4,0,2.0,4.0,0.5998568534851074,78.17701686727027,41,37,70,1639,722,1220,105,3,25.39
1,3,0,1.0,3.0,0.6079578399658203,75.05918747922567,41,36,67,1639,722,1220,105,3,19.61
1,2,0,1.0,2.0,0.6159088611602783,72.824115301167,41,35,65,1639,722,1220,105,3,18.76
1,2,0,1.0,2.0,0.6238498687744141,70.58910531638176,41,34,63,1639,722,1220,105,3,18.44
0,2,0,-0.0,2.0,0.6318597793579102,68.83552104767315,41,34,61,1639,722,1220,105,3,12.91
2,2,0,2.0,2.0,0.6398508548736572,66.11929677819934,41,32,59,1639,722,1220,105,3,16.49
1,3,0,1.0,3.0,0.647850751876831,63.007812023221035,41,31,56,1639,722,1220,105,3,17.6
3,4,0,3.0,4.0,0.6560308933258057,58.0592922409336,41,28,52,1639,722,1220,105,3,20.04
2,3,0,2.0,3.0,0.6638479232788086,54.47071299343465,41,26,49,1639,722,1220,105,3,17.93
3,3,0,3.0,3.0,0.6718728542327881,50.42956348249516,41,23,46,1639,722,1220,105,3,16.32
3,2,0,3.0,2.0,0.6798498630523682,47.33218389437829,41,20,44,1639,722,1220,105,3,13.45
2,3,0,2.0,3.0,0.6880087852478027,43.77722635447622,41,18,41,1639,722,1220,105,3,15.26
3,3,0,3.0,3.0,0.6958558559417725,39.85339643163099,41,15,38,1639,722,1220,105,3,13.84
2,3,0,2.0,3.0,0.7038578987121582,36.33630940518894,41,13,35,1639,722,1220,105,3,13.48
3,2,0,3.0,2.0,0.7118587493896484,33.48187929913333,41,10,33,1639,722,1220,105,3,10.41
1,3,0,1.0,3.0,0.7198989391326904,30.32091952673165,41,9,30,1639,722,1220,105,3,14.54
2,3,0,2.0,3.0,0.727888822555542,26.892651361962706,41,7,27,1639,722,1220,105,3,11.13
1,2,0,1.0,2.0,0.7359747886657715,24.709920264364882,41,6,25,1639,722,1220,105,3,9.55
2,3,0,2.0,3.0,0.7438459396362305,21.360679774997898,41,4,22,1639,722,1220,105,3,9.71
1,3,0,1.0,3.0,0.7518887519836426,18.235384061671343,41,3,19,1639,722,1220,105,3,10.18
2,2,0,2.0,2.0,0.7599077224731445,16.029386365926403,41,1,17,1639,722,1220,105,3,6.48
1,2,0,1.0,2.0,0.7678737640380859,14.0,41,0,15,1639,722,1220,105,3,6.62
1,2,0,1.0,2.0,0.7758398056030273,12.038404810405298,41,-1,13,1639,722,1220,105,3,5.96
0,1,0,-0.0,1.0,0.7838559150695801,11.041594578792296,41,-1,12,1639,722,1220,105,3,6.85
1,2,0,1.0,2.0,0.7918448448181152,9.198039027185569,41,-2,10,1639,722,1220,105,3,4.98
0,1,0,-0.0,1.0,0.8078899383544922,8.219544457292887,41,-2,9,1639,722,1220,105,3,5.15
0,1,0,-0.0,1.0,0.8161158561706543,7.246211251235321,41,-2,8,1639,722,1220,105,3,4.85
0,1,0,-0.0,1.0,0.8239989280700684,6.280109889280518,41,-2,7,1639,722,1220,105,3,4.51
0,2,0,-0.0,2.0,0.8319089412689209,4.385164807134504,41,-2,5,1639,722,1220,105,3,4.88
1,2,0,1.0,2.0,0.8398618698120117,3.2426406871192848,41,-3,3,1639,722,1220,105,3,1.61
0,2,0,-0.0,2.0,0.8478589057922363,2.1622776601683795,41,-3,1,1639,722,1220,105,3,1.25
1,1,0,1.0,1.0,0.855928897857666,3.0,41,-4,0,1639,722,1220,105,3,1.86
-1,0,0,-1.0,-0.0,0.9599988460540771,2.0,41,-3,0,1639,722,1220,105,3,9.36
-1,-1,0,-1.0,-1.0,0.9758808612823486,1.2360679774997898,41,-2,1,1639,722,1220,105,3,0.52
-1,-1,0,-1.0,-1.0,0.9838438034057617,1.2360679774997898,41,-1,2,1639,722,1220,105,3,8.51
-1,-1,0,-1.0,-1.0,0.9918427467346191,2.0,41,0,3,1639,722,1220,105,3,1.54
0,-1,0,-0.0,-1.0,0.9998917579650879,3.0,41,0,4,1639,722,1220,105,3,9.43
0,0,1,-0.0,-0.0,1.0068488121032715,3.0,41,0,4,1639,722,1220,105,3,27.81
-1,0,1,-1.0,-0.0,1.0115509033203125,3.1231056256176606,41,1,4,1639,722,1220,105,3,6.97
0,0,0,-0.0,-0.0,1.1538608074188232,3.1231056256176606,41,1,4,1639,722,1220,105,3,17.84
0,0,1,-0.0,-0.0,1.240872859954834,3.1231056256176606,41,1,4,1639,722,1220,105,3,17.84
0,1,1,-0.0,1.0,1.271857738494873,2.1622776601683795,41,1,3,1639,722,1220,105,3,13.41
0,1,1,-0.0,1.0,1.2878618240356445,1.2360679774997898,41,1,2,1639,722,1220,105,3,12.5
0,1,1,-0.0,1.0,1.2959089279174805,0.41421356237309515,41,1,1,1639,722,1220,105,3,11.15
0,1,1,-0.0,1.0,1.3118457794189453,0.0,41,1,0,1639,722,1220,105,3,8.94
0,1,1,-0.0,1.0,1.3358588218688965,0.41421356237309515,41,1,-1,1639,722,1220,105,3,12.21
0,0,0,-0.0,-0.0,1.3388378620147705,0.41421356237309515,41,1,-1,1639,722,1220,105,3,17.05
1,0,0,1.0,-0.0,1.3438477516174316,0.0,41,0,-1,1639,722,1220,105,3,-1.06
0,1,0,-0.0,1.0,1.3518528938293457,1.0,41,0,-2,1639,722,1220,105,3,9.29
0,1,0,-0.0,1.0,1.3678538799285889,2.0,41,0,-3,1639,722,1220,105,3,9.36
0,1,0,-0.0,1.0,1.3758528232574463,3.0,41,0,-4,1639,722,1220,105,3,9.43
1,0,0,1.0,-0.0,1.3838598728179932,3.1231056256176606,41,-1,-4,1639,722,1220,105,3,6.97
0,1,0,-0.0,1.0,1.4398648738861084,4.0990195135927845,41,-1,-5,1639,722,1220,105,3,4.17
0,0,1,-0.0,-0.0,1.4450478553771973,4.0990195135927845,41,-1,-5,1639,722,1220,105,3,18.13
0,1,1,-0.0,1.0,1.4558489322662354,5.082762530298219,41,-1,-6,1639,722,1220,105,3,4.68
0,1,1,-0.0,1.0,1.4641838073730469,6.0710678118654755,41,-1,-7,1639,722,1220,105,3,5.12
0,0,0,-0.0,-0.0,1.5388658046722412,6.0710678118654755,41,-1,-7,1639,722,1220,105,3,18.71
-1,0,0,-1.0,-0.0,1.6958539485931396,6.0,41,0,-7,1639,722,1220,105,3,-0.44
-1,0,0,-1.0,-0.0,1.7278978824615479,6.0710678118654755,41,1,-7,1639,722,1220,105,3,9.16
0,0,1,-0.0,-0.0,1.828852891921997,6.0710678118654755,41,1,-7,1639,722,1220,105,3,18.71
-1,0,1,-1.0,-0.0,1.8798749446868896,6.280109889280518,41,2,-7,1639,722,1220,105,3,6.77
0,-1,1,-0.0,-1.0,1.8878629207611084,5.324555320336759,41,2,-6,1639,722,1220,105,3,4.12
0,-1,1,-0.0,-1.0,1.9041948318481445,4.385164807134504,41,2,-5,1639,722,1220,105,3,3.67
0,0,0,-0.0,-0.0,1.9488537311553955,4.385164807134504,41,2,-5,1639,722,1220,105,3,18.21
0,-2,0,-0.0,-2.0,1.9519188404083252,2.605551275463989,41,2,-3,1639,722,1220,105,3,3.61
1,0,0,1.0,-0.0,1.9678559303283691,2.1622776601683795,41,1,-3,1639,722,1220,105,3,0.34
0,-1,0,-0.0,-1.0,1.9758927822113037,1.2360679774997898,41,1,-2,1639,722,1220,105,3,2.5
0,-1,0,-0.0,-1.0,1.983888864517212,0.41421356237309515,41,1,-1,1639,722,1220,105,3,1.15
1,0,0,1.0,-0.0,1.991858720779419,0.0,41,0,-1,1639,722,1220,105,3,-1.06
0,-1,0,-0.0,-1.0,1.9998478889465332,-1.0,41,0,0,1639,722,1220,105,3,9.14
0,0,1,-0.0,-0.0,2.103872776031494,-1.0,41,0,0,1639,722,1220,105,3,26.64
0,0,0,-0.0,-0.0,0.06882643699645996,442.4006745357768,42,-284,380,1355,1102,1639,722,64,125.12
-1,0,0,-1.0,-0.0,0.24682831764221191,441.8027015541385,42,-283,380,1355,1102,1639,722,64,1.95
-5,1,0,-5.0,1.0,0.254819393157959,438.02659499224086,42,-278,379,1355,1102,1639,722,64,7.64
-3,1,0,-3.0,1.0,0.2629423141479492,435.44946250905025,42,-275,378,1355,1102,1639,722,64,5.91
-4,2,0,-4.0,2.0,0.2708923816680908,431.48354879110866,42,-271,376,1355,1102,1639,722,64,8.49
-4,2,0,-4.0,2.0,0.27881646156311035,427.52693065804095,42,-267,374,1355,1102,1639,722,64,8.42
-5,5,0,-5.0,5.0,0.2868814468383789,420.55386419740137,42,-262,369,1355,1102,1639,722,64,14.31
-8,7,0,-8.0,7.0,0.2948143482208252,410.2216638745777,42,-254,362,1355,1102,1639,722,64,18.14
-10,10,0,-10.0,10.0,0.302809476852417,396.2989610073786,42,-244,352,1355,1102,1639,722,64,22.44
-13,12,0,-13.0,12.0,0.3108513355255127,379.04865892008456,42,-231,340,1355,1102,1639,722,64,25.01
-17,16,0,-17.0,16.0,0.3188133239746094,356.2937032711192,42,-214,324,1355,1102,1639,722,64,28.99
-25,19,0,-25.0,19.0,0.32685232162475586,326.81192845277593,42,-189,305,1355,1102,1639,722,64,31.69
-23,19,0,-23.0,19.0,0.3348114490509033,298.6841393233126,42,-166,286,1355,1102,1639,722,64,28.92
-23,18,0,-23.0,18.0,0.3428163528442383,271.7647115778921,42,-143,268,1355,1102,1639,722,64,26.08
-18,16,0,-18.0,16.0,0.3509974479675293,249.298773548695,42,-125,252,1355,1102,1639,722,64,21.88
-14,13,0,-14.0,13.0,0.3587923049926758,231.51850029931484,42,-111,239,1355,1102,1639,722,64,17.7
-9,11,0,-9.0,11.0,0.36693239212036133,217.77589955798376,42,-102,228,1355,1102,1639,722,64,14.72
-6,10,0,-6.0,10.0,0.37487125396728516,206.20159529272678,42,-96,218,1355,1102,1639,722,64,13.66
-5,10,0,-5.0,10.0,0.382859468460083,195.03523955544875,42,-91,208,1355,1102,1639,722,64,14.05
-5,11,0,-5.0,11.0,0.3908214569091797,182.9534833400008,42,-86,197,1355,1102,1639,722,64,15.43
-4,9,0,-4.0,9.0,0.39887428283691406,173.10485123467947,42,-82,188,1355,1102,1639,722,64,14.04
-3,10,0,-3.0,10.0,0.40688443183898926,162.74342094150447,42,-79,178,1355,1102,1639,722,64,11.14
-3,11,0,-3.0,11.0,0.41480445861816406,151.48024416813925,42,-76,167,1355,1102,1639,722,64,10.9
-2,12,0,-2.0,12.0,0.4228034019470215,139.75855146105536,42,-74,155,1355,1102,1639,722,64,9.87
-2,10,0,-2.0,10.0,0.43079638481140137,129.8919392681427,42,-72,145,1355,1102,1639,722,64,8.56
-2,9,0,-2.0,9.0,0.43880724906921387,120.95751043999115,42,-70,136,1355,1102,1639,722,64,7.77
-1,8,0,-1.0,8.0,0.44683146476745605,113.41320435228707,42,-69,128,1355,1102,1639,722,64,6.29
-1,7,0,-1.0,7.0,0.45480942726135254,106.7984149765407,42,-68,121,1355,1102,1639,722,64,5.63
-1,7,0,-1.0,7.0,0.4629182815551758,100.23085872821065,42,-67,114,1355,1102,1639,722,64,5.34
-1,5,0,-1.0,5.0,0.4707944393157959,95.4244874425634,42,-66,109,1355,1102,1639,722,64,4.58
0,6,0,-0.0,6.0,0.4788053035736084,90.3315167894194,42,-66,103,1355,1102,1639,722,64,3.86
-1,6,0,-1.0,6.0,0.4868142604827881,84.76472069936193,42,-65,97,1355,1102,1639,722,64,4.35
-1,5,0,-1.0,5.0,0.4948554039001465,80.0714058089752,42,-64,92,1355,1102,1639,722,64,3.93
-1,6,0,-1.0,6.0,0.5028252601623535,74.60675400742676,42,-63,86,1355,1102,1639,722,64,3.89
0,4,0,-0.0,4.0,0.5108113288879395,71.40696301506973,42,-63,82,1355,1102,1639,722,64,2.51
0,4,0,-0.0,4.0,0.5191552639007568,68.26464980241042,42,-63,78,1355,1102,1639,722,64,2.38
0,4,0,-0.0,4.0,0.5268104076385498,65.18538984847466,42,-63,74,1355,1102,1639,722,64,2.25
0,3,0,-0.0,3.0,0.5348193645477295,62.92101980067429,42,-63,71,1355,1102,1639,722,64,1.91
0,2,0,-0.0,2.0,0.542809247970581,61.43446901438462,42,-63,69,1355,1102,1639,722,64,1.64
0,3,0,-0.0,3.0,0.5508782863616943,59.2414379544733,42,-63,66,1355,1102,1639,722,64,1.77
0,2,0,-0.0,2.0,0.5587923526763916,57.805345052507874,42,-63,64,1355,1102,1639,722,64,1.51
0,2,0,-0.0,2.0,0.5668013095855713,56.3911760301898,42,-63,62,1355,1102,1639,722,64,1.46
0,2,0,-0.0,2.0,0.5748214721679688,55.0,42,-63,60,1355,1102,1639,722,64,1.41
0,2,0,-0.0,2.0,0.5828592777252197,53.632937588290176,42,-63,58,1355,1102,1639,722,64,1.36
0,1,0,-0.0,1.0,0.5909173488616943,52.95881355103778,42,-63,57,1355,1102,1639,722,64,1.18
-1,2,0,-1.0,2.0,0.5988073348999023,50.87943049997388,42,-62,55,1355,1102,1639,722,64,2.65
-1,1,0,-1.0,1.0,0.6068143844604492,49.46778504415104,42,-61,54,1355,1102,1639,722,64,4.86
-1,2,0,-1.0,2.0,0.6148574352264404,47.39773296511683,42,-60,52,1355,1102,1639,722,64,2.56
-1,1,0,-1.0,1.0,0.6228072643280029,45.98717843338096,42,-59,51,1355,1102,1639,722,64,4.62
-1,2,0,-1.0,2.0,0.6309902667999268,43.92759709091287,42,-58,49,1355,1102,1639,722,64,2.47
-2,3,0,-2.0,3.0,0.6388423442840576,40.47068372797375,42,-56,46,1355,1102,1639,722,64,3.15
-3,3,0,-3.0,3.0,0.6468133926391602,36.24954212300622,42,-53,43,1355,1102,1639,722,64,4.62
-3,4,0,-3.0,4.0,0.6552364826202393,31.41135544995076,42,-50,39,1355,1102,1639,722,64,3.33
-4,4,0,-4.0,4.0,0.6628644466400146,25.8013840664737,42,-46,35,1355,1102,1639,722,64,4.2
-4,3,0,-4.0,3.0,0.6708114147186279,20.80151512977634,42,-42,32,1355,1102,1639,722,64,7.01
-4,2,0,-4.0,2.0,0.679084300994873,16.41487374764082,42,-38,30,1355,1102,1639,722,64,3.18
-2,1,0,-2.0,1.0,0.6869254112243652,14.22769732530488,42,-36,29,1355,1102,1639,722,64,2.92
-3,1,0,-3.0,1.0,0.6948034763336182,11.278170016764804,42,-33,28,1355,1102,1639,722,64,2.07
-3,1,0,-3.0,1.0,0.7028703689575195,8.36087214122113,42,-30,27,1355,1102,1639,722,64,1.89
-2,0,0,-2.0,-0.0,0.7107982635498047,6.897300677553446,42,-28,27,1355,1102,1639,722,64,0.95
-1,1,0,-1.0,1.0,0.7190983295440674,5.483329627982627,42,-27,26,1355,1102,1639,722,64,5.62
0,0,1,-0.0,-0.0,0.747833251953125,5.483329627982627,42,-27,26,1355,1102,1639,722,64,28.54
0,0,0,-0.0,-0.0,0.07934308052062988,132.05332385522155,43,140,-54,1522,1022,1382,1076,37,55.96
-1,1,0,-1.0,1.0,0.12134623527526855,133.34728276384746,43,141,-55,1522,1022,1382,1076,37,2.9
-1,0,0,-1.0,-0.0,0.12935519218444824,134.27934856703322,43,142,-55,1522,1022,1382,1076,37,3.49
-1,0,0,-1.0,-0.0,0.1613752841949463,135.2122710490253,43,143,-55,1522,1022,1382,1076,37,3.5
-1,0,0,-1.0,-0.0,0.17734026908874512,136.1460346554526,43,144,-55,1522,1022,1382,1076,37,3.52
-1,0,0,-1.0,-0.0,0.1854701042175293,137.08062419270823,43,145,-55,1522,1022,1382,1076,37,3.53
-1,-1,0,-1.0,-1.0,0.20137310028076172,137.66630977832037,43,146,-54,1522,1022,1382,1076,37,2.73
0,-4,0,-0.0,-4.0,0.20934724807739258,136.3243337908834,43,146,-50,1522,1022,1382,1076,37,2.01
1,-6,0,1.0,-6.0,0.2173311710357666,133.52887513606112,43,145,-44,1522,1022,1382,1076,37,3.76
2,-7,0,2.0,-7.0,0.22539019584655762,129.70917371646217,43,143,-37,1522,1022,1382,1076,37,4.84
5,-7,0,5.0,-7.0,0.23335623741149902,123.22322755127783,43,138,-30,1522,1022,1382,1076,37,7.65
6,-9,0,6.0,-9.0,0.24133014678955078,115.66001645967279,43,132,-21,1522,1022,1382,1076,37,7.97
7,-9,0,7.0,-9.0,0.2493600845336914,107.57467897629681,43,125,-12,1522,1022,1382,1076,37,7.94
7,-8,0,7.0,-8.0,0.2573401927947998,100.06777714516353,43,118,-4,1522,1022,1382,1076,37,7.13
8,-8,0,8.0,-8.0,0.26541614532470703,92.07270324653611,43,110,4,1522,1022,1382,1076,37,7.0
8,-6,0,8.0,-6.0,0.2733771800994873,84.48902380255166,43,102,10,1522,1022,1382,1076,37,6.5
9,-6,0,9.0,-6.0,0.2813451290130615,76.36630754670864,43,93,16,1522,1022,1382,1076,37,6.29
8,-4,0,8.0,-4.0,0.2893502712249756,69.32124598286491,43,85,20,1522,1022,1382,1076,37,5.47
7,-2,0,7.0,-2.0,0.29746413230895996,63.04319835741924,43,78,22,1522,1022,1382,1076,37,5.12
7,-1,0,7.0,-1.0,0.3053872585296631,56.632432628181164,43,71,23,1522,1022,1382,1076,37,5.15
6,0,0,6.0,-0.0,0.31337714195251465,50.949256703752795,43,65,23,1522,1022,1382,1076,37,4.97
4,0,0,4.0,-0.0,0.3213651180267334,47.19202405202648,43,61,23,1522,1022,1382,1076,37,3.9
3,0,0,3.0,-0.0,0.3294041156768799,44.39390995922599,43,58,23,1522,1022,1382,1076,37,3.34
4,0,0,4.0,-0.0,0.3373451232910156,40.69412236331676,43,54,23,1522,1022,1382,1076,37,3.49
4,0,0,4.0,-0.0,0.34540224075317383,37.036351623268054,43,50,23,1522,1022,1382,1076,37,3.24
3,1,0,3.0,1.0,0.35334324836730957,33.894122981316485,43,47,22,1522,1022,1382,1076,37,4.78
4,1,0,4.0,1.0,0.3614211082458496,29.853944456021594,43,43,21,1522,1022,1382,1076,37,4.11
4,1,0,4.0,1.0,0.36933207511901855,25.829214001622255,43,39,20,1522,1022,1382,1076,37,3.82
3,1,0,3.0,1.0,0.3773350715637207,22.70626487409524,43,36,19,1522,1022,1382,1076,37,3.93
5,2,0,5.0,2.0,0.3853421211242676,17.355339059327378,43,31,17,1522,1022,1382,1076,37,4.58
3,1,0,3.0,1.0,0.3933250904083252,14.249030993194197,43,28,16,1522,1022,1382,1076,37,3.35
4,1,0,4.0,1.0,0.4013330936431885,10.301943396169811,43,24,15,1522,1022,1382,1076,37,2.63
3,1,0,3.0,1.0,0.40933918952941895,7.238858928247925,43,21,14,1522,1022,1382,1076,37,2.62
2,1,0,2.0,1.0,0.41733407974243164,5.021728866442675,43,19,13,1522,1022,1382,1076,37,3.4
2,0,0,2.0,-0.0,0.42533016204833984,3.400934559032695,43,17,13,1522,1022,1382,1076,37,1.08
0,1,0,-0.0,1.0,0.43334317207336426,2.808652046684813,43,17,12,1522,1022,1382,1076,37,0.58
1,0,0,1.0,-0.0,0.44133615493774414,2.0,43,16,12,1522,1022,1382,1076,37,1.16
1,0,0,1.0,-0.0,0.44944119453430176,1.2093727122985456,43,15,12,1522,1022,1382,1076,37,1.07
0,1,0,-0.0,1.0,0.4653491973876953,0.6010752377382751,43,15,11,1522,1022,1382,1076,37,0.56
1,0,0,1.0,-0.0,0.4815332889556885,-0.19550618523514274,43,14,11,1522,1022,1382,1076,37,1.04
1,0,0,1.0,-0.0,0.48934316635131836,-0.9706136340735974,43,13,11,1522,1022,1382,1076,37,0.94
1,0,0,1.0,-0.0,0.5053431987762451,-1.721179403900294,43,12,11,1522,1022,1382,1076,37,0.84
0,0,1,-0.0,-0.0,0.5183312892913818,-1.721179403900294,43,12,11,1522,1022,1382,1076,37,26.44
1,0,1,1.0,-0.0,0.0007772445678710938,871.9109698060607,44,-311,-837,1200,174,1510,1011,42,12.24
0,0,0,-0.0,-0.0,0.08173823356628418,871.9109698060607,44,-311,-837,1200,174,1510,1011,42,190.03
-2,0,0,-2.0,-0.0,0.13677525520324707,871.2163414777831,44,-309,-837,1200,174,1510,1011,42,3.46
-1,0,0,-1.0,-0.0,0.1447312831878662,870.8705062956169,44,-308,-837,1200,174,1510,1011,42,1.98
-2,0,0,-2.0,-0.0,0.15274930000305176,870.18179963462,44,-306,-837,1200,174,1510,1011,42,3.43
-2,0,0,-2.0,-0.0,0.1607203483581543,869.4970522129762,44,-304,-837,1200,174,1510,1011,42,3.41
-3,-1,0,-3.0,-1.0,0.16883635520935059,867.5364370694091,44,-301,-836,1200,174,1510,1011,42,9.04
-4,-3,0,-4.0,-3.0,0.1767561435699463,863.3630476224117,44,-297,-833,1200,174,1510,1011,42,17.95
-4,-5,0,-4.0,-5.0,0.1847212314605713,857.3125867252501,44,-293,-828,1200,174,1510,1011,42,25.08
-5,-7,0,-5.0,-7.0,0.1927483081817627,849.0488492033077,44,-288,-821,1200,174,1510,1011,42,32.09
-7,-9,0,-7.0,-9.0,0.2007143497467041,838.2467631594546,44,-281,-812,1200,174,1510,1011,42,38.82
-9,-14,0,-9.0,-14.0,0.208726167678833,822.082439622603,44,-272,-798,1200,174,1510,1011,42,51.7
-11,-17,0,-11.0,-17.0,0.21695423126220703,802.4573455862787,44,-261,-781,1200,174,1510,1011,42,57.96
-10,-18,0,-10.0,-18.0,0.2247462272644043,782.2247506146707,44,-251,-763,1200,174,1510,1011,42,58.61
-10,-18,0,-10.0,-18.0,0.23273420333862305,762.0108556080178,44,-241,-745,1200,174,1510,1011,42,57.64
-9,-16,0,-9.0,-16.0,0.24073123931884766,744.0261433441343,44,-232,-729,1200,174,1510,1011,42,52.61
-6,-13,0,-6.0,-13.0,0.24877023696899414,729.8208840995301,44,-226,-716,1200,174,1510,1011,42,44.95
-5,-11,0,-5.0,-11.0,0.25676417350769043,717.8274494088589,44,-221,-705,1200,174,1510,1011,42,39.6
-5,-11,0,-5.0,-11.0,0.2647252082824707,705.8369830986863,44,-216,-694,1200,174,1510,1011,42,39.19
-5,-13,0,-5.0,-13.0,0.2727231979370117,691.9389875718679,44,-211,-681,1200,174,1510,1011,42,43.72
-5,-16,0,-5.0,-16.0,0.2807292938232422,675.1759834984255,44,-206,-665,1200,174,1510,1011,42,51.07
-6,-18,0,-6.0,-18.0,0.2887413501739502,656.2067631085797,44,-200,-647,1200,174,1510,1011,42,53.11
-7,-18,0,-7.0,-18.0,0.29676032066345215,636.943766594076,44,-193,-629,1200,174,1510,1011,42,51.42
-8,-20,0,-8.0,-20.0,0.3047361373901367,615.4793790846644,44,-185,-609,1200,174,1510,1011,42,53.66
-7,-25,0,-7.0,-25.0,0.31272435188293457,589.5243647881713,44,-178,-584,1200,174,1510,1011,42,59.96
-9,-28,0,-9.0,-28.0,0.32074522972106934,560.1170278007693,44,-169,-556,1200,174,1510,1011,42,62.58
-7,-29,0,-7.0,-29.0,0.3287322521209717,530.3374647164837,44,-162,-527,1200,174,1510,1011,42,59.55
-8,-30,0,-8.0,-30.0,0.3367311954498291,499.31240615614774,44,-154,-497,1200,174,1510,1011,42,59.12
-9,-33,0,-9.0,-33.0,0.3447272777557373,465.1285838129661,44,-145,-464,1200,174,1510,1011,42,59.53
-9,-32,0,-9.0,-32.0,0.35272932052612305,431.90175535098115,44,-136,-432,1200,174,1510,1011,42,56.17
-11,-30,0,-11.0,-30.0,0.36072826385498047,399.98574797729196,44,-125,-402,1200,174,1510,1011,42,51.87
-10,-26,0,-10.0,-26.0,0.36881017684936523,372.19333666785354,44,-115,-376,1200,174,1510,1011,42,45.62
-8,-20,0,-8.0,-20.0,0.3767881393432617,350.7324306540929,44,-107,-356,1200,174,1510,1011,42,37.64
-7,-16,0,-7.0,-16.0,0.38472914695739746,333.400902933387,44,-100,-340,1200,174,1510,1011,42,31.56
-7,-16,0,-7.0,-16.0,0.39273619651794434,316.08307581366347,44,-93,-324,1200,174,1510,1011,42,30.4
-6,-14,0,-6.0,-14.0,0.400745153427124,300.9767072320605,44,-87,-310,1200,174,1510,1011,42,27.03
-6,-14,0,-6.0,-14.0,0.4087371826171875,285.88271375233893,44,-81,-296,1200,174,1510,1011,42,26.07
-6,-13,0,-6.0,-13.0,0.41672229766845703,271.76953393411685,44,-75,-283,1200,174,1510,1011,42,23.86
-4,-11,0,-4.0,-11.0,0.42476534843444824,260.1138559374119,44,-71,-272,1200,174,1510,1011,42,21.27
-2,-11,0,-2.0,-11.0,0.43273115158081055,248.96666460879942,44,-69,-261,1200,174,1510,1011,42,20.34
-2,-10,0,-2.0,-10.0,0.44074535369873047,238.78837541352772,44,-67,-251,1200,174,1510,1011,42,19.0
-1,-8,0,-1.0,-8.0,0.44875621795654297,230.80349481291955,44,-66,-243,1200,174,1510,1011,42,15.05
0,-8,0,-0.0,-8.0,0.4567391872406006,223.09219569662608,44,-66,-235,1200,174,1510,1011,42,13.52
-1,-9,0,-1.0,-9.0,0.46472835540771484,214.16164653276266,44,-65,-226,1200,174,1510,1011,42,15.21
0,-7,0,-0.0,-7.0,0.47292113304138184,207.44255295369118,44,-65,-219,1200,174,1510,1011,42,11.69
0,-7,0,-0.0,-7.0,0.48073434829711914,200.74083972060717,44,-65,-212,1200,174,1510,1011,42,11.4
0,-6,0,-0.0,-6.0,0.48874616622924805,195.01157376399996,44,-65,-206,1200,174,1510,1011,42,10.04
0,-6,0,-0.0,-6.0,0.49674224853515625,189.2974084481309,44,-65,-200,1200,174,1510,1011,42,9.8
0,-6,0,-0.0,-6.0,0.5047292709350586,183.59960899278374,44,-65,-194,1200,174,1510,1011,42,9.57
0,-5,0,-0.0,-5.0,0.5127413272857666,178.86495440671933,44,-65,-189,1200,174,1510,1011,42,8.31
0,-4,0,-0.0,-4.0,0.5207493305206299,175.08671551127577,44,-65,-185,1200,174,1510,1011,42,7.09
1,-4,0,1.0,-4.0,0.5287423133850098,171.6577275896298,44,-66,-181,1200,174,1510,1011,42,5.8
0,-5,0,-0.0,-5.0,0.5367343425750732,166.9680823969857,44,-66,-176,1200,174,1510,1011,42,7.82
0,-6,0,-0.0,-6.0,0.5447893142700195,161.36227680087788,44,-66,-170,1200,174,1510,1011,42,8.56
-1,-6,0,-1.0,-6.0,0.5527842044830322,155.41145087550296,44,-65,-164,1200,174,1510,1011,42,9.48
-2,-5,0,-2.0,-5.0,0.5607302188873291,150.0263137648707,44,-63,-159,1200,174,1510,1011,42,12.49
-2,-6,0,-2.0,-6.0,0.5687212944030762,143.7118696390761,44,-61,-153,1200,174,1510,1011,42,11.07
-1,-6,0,-1.0,-6.0,0.5767371654510498,137.7734234687909,44,-60,-147,1200,174,1510,1011,42,8.78
-2,-7,0,-2.0,-7.0,0.5847511291503906,130.53877391611692,44,-58,-140,1200,174,1510,1011,42,10.47
-2,-7,0,-2.0,-7.0,0.5927281379699707,123.30869689661813,44,-56,-133,1200,174,1510,1011,42,10.09
-2,-6,0,-2.0,-6.0,0.6009283065795898,117.00362314084367,44,-54,-127,1200,174,1510,1011,42,9.64
-3,-6,0,-3.0,-6.0,0.6087291240692139,110.30879635424276,44,-51,-121,1200,174,1510,1011,42,9.93
-2,-7,0,-2.0,-7.0,0.6167323589324951,103.08464852672147,44,-49,-114,1200,174,1510,1011,42,9.11
-2,-5,0,-2.0,-5.0,0.6247882843017578,97.70130580579136,44,-47,-109,1200,174,1510,1011,42,9.5
-3,-6,0,-3.0,-6.0,0.6327433586120605,91.0044641967453,44,-44,-103,1200,174,1510,1011,42,9.2
-2,-5,0,-2.0,-5.0,0.6407322883605957,85.62082348209472,44,-42,-98,1200,174,1510,1011,42,9.16
-3,-5,0,-3.0,-5.0,0.6487653255462646,79.84641788382967,44,-39,-93,1200,174,1510,1011,42,7.07
-2,-5,0,-2.0,-5.0,0.6567542552947998,74.46203433826454,44,-37,-88,1200,174,1510,1011,42,9.06
-3,-6,0,-3.0,-6.0,0.6650261878967285,67.76936408468859,44,-34,-82,1200,174,1510,1011,42,7.95
-2,-6,0,-2.0,-6.0,0.6727283000946045,61.462112512353215,44,-32,-76,1200,174,1510,1011,42,7.38
-2,-5,0,-2.0,-5.0,0.6807231903076172,56.077882690172544,44,-30,-71,1200,174,1510,1011,42,8.28
-2,-4,0,-2.0,-4.0,0.6887321472167969,51.61542535852834,44,-28,-67,1200,174,1510,1011,42,6.34
-2,-4,0,-2.0,-4.0,0.6967573165893555,47.15423684555495,44,-26,-63,1200,174,1510,1011,42,6.11
-3,-4,0,-3.0,-4.0,0.7047293186187744,42.324560795950255,44,-23,-59,1200,174,1510,1011,42,4.28
-2,-3,0,-2.0,-3.0,0.712731122970581,38.80802621722272,44,-21,-56,1200,174,1510,1011,42,3.97
-3,-4,0,-3.0,-4.0,0.720731258392334,34.02726596879042,44,-18,-52,1200,174,1510,1011,42,3.75
-2,-3,0,-2.0,-3.0,0.7287442684173584,30.54609587543949,44,-16,-49,1200,174,1510,1011,42,3.45
-2,-3,0,-2.0,-3.0,0.7367572784423828,27.08326112068523,44,-14,-46,1200,174,1510,1011,42,3.23
-2,-2,0,-2.0,-2.0,0.7447452545166016,24.607017003965517,44,-12,-44,1200,174,1510,1011,42,2.11
-3,-2,0,-3.0,-2.0,0.7527482509613037,21.95346318982906,44,-9,-42,1200,174,1510,1011,42,1.44
-2,-1,0,-2.0,-1.0,0.7608082294464111,20.593268686170845,44,-7,-41,1200,174,1510,1011,42,0.9
-2,-2,0,-2.0,-2.0,0.7688591480255127,18.319206502675,44,-5,-39,1200,174,1510,1011,42,1.54
-2,-2,0,-2.0,-2.0,0.7767362594604492,16.12142238654117,44,-3,-37,1200,174,1510,1011,42,1.36
-2,-3,0,-2.0,-3.0,0.7848002910614014,13.0147027033899,44,-1,-34,1200,174,1510,1011,42,1.72
-2,-2,0,-2.0,-2.0,0.7928471565246582,11.015621187164243,44,1,-32,1200,174,1510,1011,42,0.95
-1,-2,0,-1.0,-2.0,0.800727128982544,9.066592756745816,44,2,-30,1200,174,1510,1011,42,1.59
-2,-3,0,-2.0,-3.0,0.808793306350708,6.294688127912362,44,4,-27,1200,174,1510,1011,42,0.99
-2,-2,0,-2.0,-2.0,0.8167262077331543,4.709920264364882,44,6,-25,1200,174,1510,1011,42,0.35
-1,-2,0,-1.0,-2.0,0.8247301578521729,3.0416305603426146,44,7,-23,1200,174,1510,1011,42,0.83
-1,-1,0,-1.0,-1.0,0.8327252864837646,2.4093998214392514,44,8,-22,1200,174,1510,1011,42,0.26
0,-1,0,-0.0,-1.0,0.8407292366027832,1.472205054244231,44,8,-21,1200,174,1510,1011,42,1.99
0,0,1,-0.0,-0.0,0.8697593212127686,1.472205054244231,44,8,-21,1200,174,1510,1011,42,27.36
0,-1,1,-0.0,-1.0,0.04893064498901367,607.1834142526071,45,521,329,1713,523,1192,195,19,13.88
-1,0,1,-1.0,-0.0,0.0568697452545166,608.0291727301068,45,522,329,1713,523,1192,195,19,10.14
-1,0,1,-1.0,-0.0,0.08086061477661133,608.8753919683159,45,523,329,1713,523,1192,195,19,10.15
-1,0,1,-1.0,-0.0,0.08884572982788086,609.7220700767025,45,524,329,1713,523,1192,195,19,10.15
-1,0,1,-1.0,-0.0,0.09685063362121582,610.5692051740467,45,525,329,1713,523,1192,195,19,10.16
0,0,0,-0.0,-0.0,0.09988570213317871,610.5692051740467,45,525,329,1713,523,1192,195,19,153.41
-2,0,0,-2.0,-0.0,0.10513973236083984,612.2648388569886,45,527,329,1713,523,1192,195,19,5.98
-1,0,0,-1.0,-0.0,0.11289358139038086,613.1133337262593,45,528,329,1713,523,1192,195,19,10.17
-1,0,0,-1.0,-0.0,0.12884759902954102,613.9622781517353,45,529,329,1713,523,1192,195,19,10.18
-1,2,0,-1.0,2.0,0.19286274909973145,613.7591829913068,45,530,327,1713,523,1192,195,19,1.75
-2,5,0,-2.0,5.0,0.20085573196411133,612.8585048063586,45,532,322,1713,523,1192,195,19,6.88
-1,4,0,-1.0,4.0,0.2088615894317627,611.6552988575864,45,533,318,1713,523,1192,195,19,9.12
5,3,0,5.0,3.0,0.21685361862182617,605.8243651645565,45,528,315,1713,523,1192,195,19,40.73
10,4,0,10.0,4.0,0.22484564781188965,595.1895397969084,45,518,311,1713,523,1192,195,19,54.91
7,4,0,7.0,4.0,0.23289871215820312,587.1291806311783,45,511,307,1713,523,1192,195,19,48.0
7,4,0,7.0,4.0,0.24084877967834473,579.0688735173798,45,504,303,1713,523,1192,195,19,47.61
6,6,0,6.0,6.0,0.24884867668151855,570.8387706940612,45,498,297,1713,523,1192,195,19,45.02
8,6,0,8.0,6.0,0.25711774826049805,560.8956044750653,45,490,291,1713,523,1192,195,19,51.33
9,5,0,9.0,5.0,0.2648437023162842,550.6043245008029,45,481,286,1713,523,1192,195,19,53.28
9,6,0,9.0,6.0,0.2728595733642578,539.8023323565599,45,472,280,1713,523,1192,195,19,53.54
10,6,0,10.0,6.0,0.28087759017944336,528.1405775027614,45,462,274,1713,523,1192,195,19,56.98
12,9,0,12.0,9.0,0.2890477180480957,513.2307918918608,45,450,265,1713,523,1192,195,19,61.06
16,11,0,16.0,11.0,0.29686474800109863,493.86379865725075,45,434,254,1713,523,1192,195,19,68.36
20,13,0,20.0,13.0,0.3049006462097168,470.0375768141785,45,414,241,1713,523,1192,195,19,73.0
22,15,0,22.0,15.0,0.3128476142883301,443.48204384262584,45,392,226,1713,523,1192,195,19,72.92
24,16,0,24.0,16.0,0.32085275650024414,414.7027259765979,45,368,210,1713,523,1192,195,19,72.05
25,15,0,25.0,15.0,0.32888269424438477,385.55544604022384,45,343,195,1713,523,1192,195,19,70.21
26,16,0,26.0,16.0,0.336864709854126,355.04670030093666,45,317,179,1713,523,1192,195,19,67.1
24,13,0,24.0,13.0,0.3448357582092285,327.7565886512096,45,293,166,1713,523,1192,195,19,61.81
22,11,0,22.0,11.0,0.35284876823425293,303.1954516004357,45,271,155,1713,523,1192,195,19,55.24
19,8,0,19.0,8.0,0.36091065406799316,282.7413237784459,45,252,147,1713,523,1192,195,19,47.78
14,6,0,14.0,6.0,0.3688497543334961,267.63152387246106,45,238,141,1713,523,1192,195,19,39.86
9,5,0,9.0,5.0,0.37690258026123047,257.3400082601185,45,229,136,1713,523,1192,195,19,33.33
7,4,0,7.0,4.0,0.38484668731689453,249.2789190003706,45,222,132,1713,523,1192,195,19,28.96
5,4,0,5.0,4.0,0.3932316303253174,242.93848455525804,45,217,128,1713,523,1192,195,19,22.56
4,3,0,4.0,3.0,0.40091371536254883,237.969633760914,45,213,125,1713,523,1192,195,19,19.34
3,3,0,3.0,3.0,0.408841609954834,233.86621831782205,45,210,122,1713,523,1192,195,19,15.83
2,2,0,2.0,2.0,0.4168586730957031,231.13329631685815,45,208,120,1713,523,1192,195,19,11.89
2,2,0,2.0,2.0,0.4248616695404053,228.40261161158273,45,206,118,1713,523,1192,195,19,11.79
2,2,0,2.0,2.0,0.43287062644958496,225.67424230196207,45,204,116,1713,523,1192,195,19,11.68
2,2,0,2.0,2.0,0.4408607482910156,222.94827009486403,45,202,114,1713,523,1192,195,19,11.57
3,2,0,3.0,2.0,0.44884467124938965,219.3527972239447,45,199,112,1713,523,1192,195,19,15.5
3,2,0,3.0,2.0,0.4569356441497803,215.75764725588314,45,196,110,1713,523,1192,195,19,15.34
5,3,0,5.0,3.0,0.4651176929473877,209.92921230388603,45,191,107,1713,523,1192,195,19,21.33
6,4,0,6.0,4.0,0.4728517532348633,202.74040710265956,45,185,103,1713,523,1192,195,19,22.45
7,3,0,7.0,3.0,0.4809396266937256,195.16659863944446,45,178,100,1713,523,1192,195,19,22.23
7,4,0,7.0,4.0,0.48885560035705566,187.1045639448506,45,171,96,1713,523,1192,195,19,24.99
7,4,0,7.0,4.0,0.4968585968017578,179.04254837669055,45,164,92,1713,523,1192,195,19,24.35
8,5,0,8.0,5.0,0.5048625469207764,169.61970775925036,45,156,87,1713,523,1192,195,19,23.96
6,4,0,6.0,4.0,0.512859582901001,162.4322023425004,45,150,83,1713,523,1192,195,19,19.52
8,3,0,8.0,3.0,0.5209336280822754,153.9846618550347,45,142,80,1713,523,1192,195,19,19.86
6,3,0,6.0,3.0,0.5288476943969727,147.28499608087785,45,136,77,1713,523,1192,195,19,18.24
6,2,0,6.0,2.0,0.536853551864624,141.08331019803634,45,130,75,1713,523,1192,195,19,15.32
4,2,0,4.0,2.0,0.5450787544250488,136.6193668438371,45,126,73,1713,523,1192,195,19,13.81
5,2,0,5.0,2.0,0.5528995990753174,131.29255147726127,45,121,71,1713,523,1192,195,19,13.76
4,1,0,4.0,1.0,0.5608377456665039,127.34148304899725,45,117,70,1713,523,1192,195,19,10.43
3,2,0,3.0,2.0,0.5688495635986328,123.74034804836094,45,114,68,1713,523,1192,195,19,11.95
4,1,0,4.0,1.0,0.5769166946411133,119.79829191413992,45,110,67,1713,523,1192,195,19,10.0
3,1,0,3.0,1.0,0.584850549697876,116.7179382586272,45,107,66,1713,523,1192,195,19,8.83
3,1,0,3.0,1.0,0.5928826332092285,113.64175471673585,45,104,65,1713,523,1192,195,19,8.66
2,1,0,2.0,1.0,0.6008477210998535,111.41594578792295,45,102,64,1713,523,1192,195,19,8.31
3,1,0,3.0,1.0,0.609137773513794,108.34564329364768,45,99,63,1713,523,1192,195,19,8.39
3,2,0,3.0,2.0,0.6170516014099121,104.74093370462545,45,96,61,1713,523,1192,195,19,11.9
4,2,0,4.0,2.0,0.625098705291748,100.29318368498559,45,92,59,1713,523,1192,195,19,11.09
4,2,0,4.0,2.0,0.6328606605529785,95.84750831564858,45,88,57,1713,523,1192,195,19,10.78
4,2,0,4.0,2.0,0.6408426761627197,91.40418317978589,45,84,55,1713,523,1192,195,19,10.46
6,2,0,6.0,2.0,0.6488447189331055,85.30270409696638,45,78,53,1713,523,1192,195,19,10.72
5,3,0,5.0,3.0,0.6568517684936523,79.48163651289458,45,73,50,1713,523,1192,195,19,12.02
5,2,0,5.0,2.0,0.6649036407470703,74.23460818673925,45,68,48,1713,523,1192,195,19,9.29
4,3,0,4.0,3.0,0.6728556156158447,69.2368199762746,45,64,45,1713,523,1192,195,19,11.26
4,2,0,4.0,2.0,0.6808466911315918,64.81734213584231,45,60,43,1713,523,1192,195,19,8.41
4,2,0,4.0,2.0,0.6889157295227051,60.40461079784254,45,56,41,1713,523,1192,195,19,8.04
4,1,0,4.0,1.0,0.6971995830535889,56.60487786742691,45,52,40,1713,523,1192,195,19,6.02
3,3,0,3.0,3.0,0.7049176692962646,52.40032573203501,45,49,37,1713,523,1192,195,19,7.62
4,2,0,4.0,2.0,0.7128345966339111,48.0087712549569,45,45,35,1713,523,1192,195,19,7.0
3,2,0,3.0,2.0,0.720855712890625,44.41348144429457,45,42,33,1713,523,1192,195,19,7.42
3,2,0,3.0,2.0,0.7288446426391602,40.8196748283246,45,39,31,1713,523,1192,195,19,7.12
4,2,0,4.0,2.0,0.7368526458740234,36.45327270945405,45,35,29,1713,523,1192,195,19,6.0
4,2,0,4.0,2.0,0.7448716163635254,32.10960958218893,45,31,27,1713,523,1192,195,19,5.54
3,2,0,3.0,2.0,0.7529716491699219,28.53664875824692,45,28,25,1713,523,1192,195,19,5.68
3,1,0,3.0,1.0,0.760852575302124,25.655446902326915,45,25,24,1713,523,1192,195,19,3.52
2,2,0,2.0,2.0,0.7688586711883545,22.827660925679098,45,23,22,1713,523,1192,195,19,7.18
1,1,0,1.0,1.0,0.7768886089324951,21.4138126514911,45,22,21,1713,523,1192,195,19,6.28
1,1,0,1.0,1.0,0.7848615646362305,20.0,45,21,20,1713,523,1192,195,19,6.19
1,1,0,1.0,1.0,0.7928407192230225,18.586228448267445,45,20,19,1713,523,1192,195,19,6.1
0,1,0,-0.0,1.0,0.8008465766906738,17.90724809414742,45,20,18,1713,523,1192,195,19,1.21
1,2,0,1.0,2.0,0.808936595916748,15.839484696748443,45,19,16,1713,523,1192,195,19,2.75
1,3,0,1.0,3.0,0.8168697357177734,13.203603311174518,45,18,13,1713,523,1192,195,19,2.14
0,2,0,-0.0,2.0,0.8250946998596191,12.095023109728988,45,18,11,1713,523,1192,195,19,0.78
1,2,0,1.0,2.0,0.8328397274017334,10.235384061671343,45,17,9,1713,523,1192,195,19,1.74
1,2,0,1.0,2.0,0.8409607410430908,8.464249196572979,45,16,7,1713,523,1192,195,19,1.43
1,1,0,1.0,1.0,0.8489787578582764,7.15549442140351,45,15,6,1713,523,1192,195,19,2.1
1,2,0,1.0,2.0,0.8568456172943115,5.560219778561036,45,14,4,1713,523,1192,195,19,0.91
1,0,0,1.0,-0.0,0.8648526668548584,4.601470508735444,45,13,4,1713,523,1192,195,19,2.37
1,2,0,1.0,2.0,0.8728697299957275,3.1655250605964387,45,12,2,1713,523,1192,195,19,0.48
1,0,0,1.0,-0.0,0.8808495998382568,2.180339887498949,45,11,2,1713,523,1192,195,19,2.94
1,2,0,1.0,2.0,0.8889045715332031,1.0,45,10,0,1713,523,1192,195,19,-0.03
2,1,0,2.0,1.0,0.8970925807952881,-0.9377422517014509,45,8,-1,1713,523,1192,195,19,0.94
1,1,0,1.0,1.0,0.904848575592041,-1.719890110719482,45,7,-2,1713,523,1192,195,19,-0.11
2,0,0,2.0,-0.0,0.9129266738891602,-3.6148351928654963,45,5,-2,1713,523,1192,195,19,1.24
0,1,0,-0.0,1.0,0.9209296703338623,-3.1690481051546993,45,5,-3,1713,523,1192,195,19,0.3
1,0,0,1.0,-0.0,0.9288406372070312,-4.0,45,4,-3,1713,523,1192,195,19,0.52
1,1,0,1.0,1.0,0.9368577003479004,-4.0,45,3,-4,1713,523,1192,195,19,7.84
0,0,1,-0.0,-0.0,0.9898767471313477,-4.0,45,3,-4,1713,523,1192,195,19,25.78
0,0,0,-0.0,-0.0,0.11505699157714844,839.720628310952,46,-826,242,884,769,1710,527,42,185.89
-2,0,0,-2.0,-0.0,0.1550431251525879,837.8014904504998,46,-824,242,884,769,1710,527,42,10.32
-2,-1,0,-2.0,-1.0,0.16320204734802246,836.1656782676264,46,-822,243,884,769,1710,527,42,7.86
-5,0,0,-5.0,-0.0,0.17109012603759766,831.3719845231892,46,-817,243,884,769,1710,527,42,20.69
-5,-1,0,-5.0,-1.0,0.1791551113128662,826.8679142413635,46,-812,244,884,769,1710,527,42,18.91
-7,-2,0,-7.0,-2.0,0.18778705596923828,820.7487748728834,46,-805,246,884,769,1710,527,42,23.94
-9,-1,0,-9.0,-1.0,0.19508600234985352,812.4416596259152,46,-796,247,884,769,1710,527,42,30.91
-12,-1,0,-12.0,-1.0,0.20311903953552246,801.2894867380952,46,-784,248,884,769,1710,527,42,38.48
-12,0,0,-12.0,-0.0,0.2110600471496582,789.8563374605886,46,-772,248,884,769,1710,527,42,39.19
-12,1,0,-12.0,1.0,0.21907901763916016,778.1301521028975,46,-760,247,884,769,1710,527,42,39.98
-12,2,0,-12.0,2.0,0.22704601287841797,766.1016452784228,46,-748,245,884,769,1710,527,42,40.92
-11,3,0,-11.0,3.0,0.23506498336791992,754.7145093396152,46,-737,242,884,769,1710,527,42,40.34
-14,3,0,-14.0,3.0,0.24318599700927734,740.4788243936925,46,-723,239,884,769,1710,527,42,45.6
-19,6,0,-19.0,6.0,0.25104808807373047,720.5557969566416,46,-704,233,884,769,1710,527,42,58.13
-25,5,0,-25.0,5.0,0.2591850757598877,695.2576352123585,46,-679,228,884,769,1710,527,42,63.2
-27,7,0,-27.0,7.0,0.2673299312591553,667.4366347021344,46,-652,221,884,769,1710,527,42,65.83
-31,8,0,-31.0,8.0,0.2750520706176758,635.5135185203729,46,-621,213,884,769,1710,527,42,68.81
-32,7,0,-32.0,7.0,0.2830331325531006,602.9847754552991,46,-589,206,884,769,1710,527,42,66.72
-33,9,0,-33.0,9.0,0.2910430431365967,568.8686294421835,46,-556,197,884,769,1710,527,42,66.59
-35,9,0,-35.0,9.0,0.2990579605102539,532.8817563343281,46,-521,188,884,769,1710,527,42,65.37
-32,10,0,-32.0,10.0,0.30712413787841797,499.3892773683947,46,-489,178,884,769,1710,527,42,61.34
-31,9,0,-31.0,9.0,0.3151090145111084,467.18541559534526,46,-458,169,884,769,1710,527,42,57.13
-27,8,0,-27.0,8.0,0.32303595542907715,439.08912180141795,46,-431,161,884,769,1710,527,42,51.07
-25,7,0,-25.0,7.0,0.33106398582458496,413.225747739583,46,-406,154,884,769,1710,527,42,46.6
-23,6,0,-23.0,6.0,0.33924102783203125,389.60077934655703,46,-383,148,884,769,1710,527,42,42.3
-20,6,0,-20.0,6.0,0.3472120761871338,368.7858386344994,46,-363,142,884,769,1710,527,42,38.3
-19,5,0,-19.0,5.0,0.35505104064941406,349.2769233965303,46,-344,137,884,769,1710,527,42,35.06
-17,5,0,-17.0,5.0,0.36304306983947754,331.6372073392143,46,-327,132,884,769,1710,527,42,32.14
-18,5,0,-18.0,5.0,0.3711390495300293,313.0808285430339,46,-309,127,884,769,1710,527,42,31.68
-15,5,0,-15.0,5.0,0.3790459632873535,297.30802691732424,46,-294,122,884,769,1710,527,42,28.34
-15,6,0,-15.0,6.0,0.3870370388031006,281.15393427853957,46,-279,116,884,769,1710,527,42,29.47
-13,6,0,-13.0,6.0,0.39504003524780273,266.84718167805636,46,-266,110,884,769,1710,527,42,25.6
-13,7,0,-13.0,7.0,0.4030470848083496,252.16295502867882,46,-253,103,884,769,1710,527,42,23.93
-14,6,0,-14.0,6.0,0.4113149642944336,236.93410011086166,46,-239,97,884,769,1710,527,42,25.45
-12,5,0,-12.0,5.0,0.4194369316101074,223.9346851713738,46,-227,92,884,769,1710,527,42,23.02
-12,5,0,-12.0,5.0,0.42705512046813965,210.93533581582605,46,-215,87,884,769,1710,527,42,22.23
-11,4,0,-11.0,4.0,0.43503713607788086,199.238507078122,46,-204,83,884,769,1710,527,42,19.16
-10,3,0,-10.0,3.0,0.44304609298706055,188.84756372185979,46,-194,80,884,769,1710,527,42,16.2
-10,4,0,-10.0,4.0,0.45103907585144043,178.07787421006887,46,-184,76,884,769,1710,527,42,18.25
-11,4,0,-11.0,4.0,0.4590420722961426,166.3846311734236,46,-173,72,884,769,1710,527,42,17.07
-11,3,0,-11.0,3.0,0.4671659469604492,155.08236708995025,46,-162,69,884,769,1710,527,42,14.71
-9,3,0,-9.0,3.0,0.47505712509155273,145.6283289239858,46,-153,66,884,769,1710,527,42,13.34
-7,3,0,-7.0,3.0,0.483173131942749,138.0125781188394,46,-146,63,884,769,1710,527,42,14.2
-6,3,0,-6.0,3.0,0.49113893508911133,131.31546211727817,46,-140,60,884,769,1710,527,42,10.9
-4,2,0,-4.0,2.0,0.4990501403808594,126.85127662620977,46,-136,58,884,769,1710,527,42,8.82
-3,2,0,-3.0,2.0,0.5070559978485107,123.30869689661813,46,-133,56,884,769,1710,527,42,6.46
-1,1,0,-1.0,1.0,0.5150890350341797,122.0,46,-132,55,884,769,1710,527,42,3.39
-1,0,0,-1.0,-0.0,0.5311379432678223,121.07744367069671,46,-131,55,884,769,1710,527,42,2.98
0,1,0,-0.0,1.0,0.5390779972076416,120.69333082400175,46,-131,54,884,769,1710,527,42,0.89
-1,1,0,-1.0,1.0,0.5470390319824219,119.38874598770374,46,-130,53,884,769,1710,527,42,3.33
-2,1,0,-2.0,1.0,0.5550501346588135,117.15932831336434,46,-128,52,884,769,1710,527,42,6.31
-2,1,0,-2.0,1.0,0.5631029605865479,114.93012911051031,46,-126,51,884,769,1710,527,42,6.26
-1,1,0,-1.0,1.0,0.5710539817810059,113.6291201783626,46,-125,50,884,769,1710,527,42,3.25
-3,1,0,-3.0,1.0,0.5790519714355469,110.47243057006287,46,-122,49,884,769,1710,527,42,7.3
-2,1,0,-2.0,1.0,0.5870559215545654,108.24395537122808,46,-120,48,884,769,1710,527,42,6.09
-3,2,0,-3.0,2.0,0.5950500965118408,104.7179382586272,46,-117,46,884,769,1710,527,42,5.84
-2,2,0,-2.0,2.0,0.6030769348144531,102.13001258832064,46,-115,44,884,769,1710,527,42,4.12
-4,1,0,-4.0,1.0,0.6111280918121338,98.03780911962384,46,-111,43,884,769,1710,527,42,6.81
-3,2,0,-3.0,2.0,0.6190390586853027,94.52056094046635,46,-108,41,884,769,1710,527,42,5.51
-3,2,0,-3.0,2.0,0.6270520687103271,91.00892821556681,46,-105,39,884,769,1710,527,42,5.38
-3,1,0,-3.0,1.0,0.6350741386413574,87.84851859350222,46,-102,38,884,769,1710,527,42,7.41
-5,2,0,-5.0,2.0,0.6430449485778809,82.46496991735899,46,-97,36,884,769,1710,527,42,9.02
-5,3,0,-5.0,3.0,0.651047945022583,76.73944955850733,46,-92,33,884,769,1710,527,42,6.5
-5,2,0,-5.0,2.0,0.6590321063995361,71.35799911215054,46,-87,31,884,769,1710,527,42,8.17
-7,3,0,-7.0,3.0,0.6671149730682373,63.758480401668365,46,-80,28,884,769,1710,527,42,8.21
-6,3,0,-6.0,3.0,0.6750729084014893,57.108898340714035,46,-74,25,884,769,1710,527,42,6.56
-6,3,0,-6.0,3.0,0.6830620765686035,50.47027354082255,46,-68,22,884,769,1710,527,42,6.11
-7,3,0,-7.0,3.0,0.6911370754241943,42.89053137985315,46,-61,19,884,769,1710,527,42,6.55
-7,2,0,-7.0,2.0,0.6990530490875244,35.61271941887264,46,-54,17,884,769,1710,527,42,7.71
-6,3,0,-6.0,3.0,0.7071149349212646,29.0,46,-48,14,884,769,1710,527,42,4.75
-5,1,0,-5.0,1.0,0.7153170108795166,23.922154890432402,46,-43,13,884,769,1710,527,42,4.99
-4,2,0,-4.0,2.0,0.7230479717254639,19.52159917870962,46,-39,11,884,769,1710,527,42,3.75
-2,0,0,-2.0,-0.0,0.7310459613800049,17.600518131237564,46,-37,11,884,769,1710,527,42,2.69
-2,1,0,-2.0,1.0,0.7390539646148682,15.400549446402593,46,-35,10,884,769,1710,527,42,3.29
-1,0,0,-1.0,-0.0,0.7470419406890869,14.440090293338699,46,-34,10,884,769,1710,527,42,2.55
-1,0,0,-1.0,-0.0,0.7631559371948242,13.481879299133332,46,-33,10,884,769,1710,527,42,2.5
-1,0,0,-1.0,-0.0,0.7710399627685547,12.526109228480422,46,-32,10,884,769,1710,527,42,2.44
-1,0,0,-1.0,-0.0,0.7790570259094238,11.57299494980466,46,-31,10,884,769,1710,527,42,2.39
0,0,1,-0.0,-0.0,0.8051071166992188,11.57299494980466,46,-31,10,884,769,1710,527,42,30.35
-1,0,1,-1.0,-0.0,0.057799577713012695,1074.0227692758178,47,959,-488,1873,271,915,759,4,47.27
-1,0,1,-1.0,-0.0,0.07370162010192871,1074.9141098527775,47,960,-488,1873,271,915,759,4,47.29
0,1,1,-0.0,1.0,0.0898747444152832,1075.3676252793193,47,960,-489,1873,271,915,759,4,74.4
0,0,0,-0.0,-0.0,0.10069775581359863,1075.3676252793193,47,960,-489,1873,271,915,759,4,214.24
1,-1,0,1.0,-1.0,0.2180616855621338,1074.0227692758178,47,959,-488,1873,271,915,759,4,54.57
3,-4,0,3.0,-4.0,0.22571158409118652,1069.5372135395019,47,956,-484,1873,271,915,759,4,111.21
5,-5,0,5.0,-5.0,0.23370862007141113,1062.8201726113193,47,951,-479,1873,271,915,759,4,131.53
9,-8,0,9.0,-8.0,0.24190568923950195,1051.1880174024009,47,942,-471,1873,271,915,759,4,154.96
9,-9,0,9.0,-9.0,0.2496957778930664,1039.121030428259,47,933,-462,1873,271,915,759,4,155.05
14,-10,0,14.0,-10.0,0.2577037811279297,1022.1411035594656,47,919,-452,1873,271,915,759,4,166.22
14,-13,0,14.0,-13.0,0.2657136917114258,1003.8558544841303,47,905,-439,1873,271,915,759,4,165.9
17,-12,0,17.0,-12.0,0.2737298011779785,983.3288791058546,47,888,-427,1873,271,915,759,4,167.91
20,-12,0,20.0,-12.0,0.28171277046203613,960.106542956652,47,868,-415,1873,271,915,759,4,169.44
22,-11,0,22.0,-11.0,0.2897067070007324,935.5137332327457,47,846,-404,1873,271,915,759,4,169.99
24,-11,0,24.0,-11.0,0.29769277572631836,909.1163482234308,47,822,-393,1873,271,915,759,4,168.83
23,-10,0,23.0,-10.0,0.3057997226715088,884.0530458161069,47,799,-383,1873,271,915,759,4,164.25
26,-11,0,26.0,-11.0,0.31383657455444336,855.8537171336382,47,773,-372,1873,271,915,759,4,163.26
26,-11,0,26.0,-11.0,0.32170677185058594,827.6565554493015,47,747,-361,1873,271,915,759,4,160.01
26,-10,0,26.0,-10.0,0.32970166206359863,799.8989961335529,47,721,-351,1873,271,915,759,4,155.84
27,-11,0,27.0,-11.0,0.33792757987976074,770.8104554158155,47,694,-340,1873,271,915,759,4,153.52
29,-12,0,29.0,-12.0,0.34575557708740234,739.4910653541282,47,665,-328,1873,271,915,759,4,151.0
28,-12,0,28.0,-12.0,0.35369873046875,709.0731326663946,47,637,-316,1873,271,915,759,4,146.9
28,-12,0,28.0,-12.0,0.3616945743560791,678.6592392673444,47,609,-304,1873,271,915,759,4,142.94
28,-12,0,28.0,-12.0,0.369708776473999,648.2499519415592,47,581,-292,1873,271,915,759,4,138.88
26,-11,0,26.0,-11.0,0.3777127265930176,620.0819881655472,47,555,-281,1873,271,915,759,4,133.76
25,-11,0,25.0,-11.0,0.3859257698059082,592.8108943185221,47,530,-270,1873,271,915,759,4,129.74
26,-11,0,26.0,-11.0,0.39371275901794434,564.6542155494831,47,504,-259,1873,271,915,759,4,125.95
24,-9,0,24.0,-9.0,0.4017035961151123,539.2023651093923,47,480,-250,1873,271,915,759,4,120.15
21,-10,0,21.0,-10.0,0.40984463691711426,515.9584925454934,47,459,-240,1873,271,915,759,4,116.78
22,-9,0,22.0,-9.0,0.4178736209869385,492.2974812802509,47,437,-231,1873,271,915,759,4,112.43
19,-8,0,19.0,-8.0,0.42571568489074707,471.76470953417373,47,418,-223,1873,271,915,759,4,107.19
19,-10,0,19.0,-10.0,0.43369078636169434,450.29415207362564,47,399,-213,1873,271,915,759,4,107.16
17,-10,0,17.0,-10.0,0.441861629486084,430.588719224161,47,382,-203,1873,271,915,759,4,101.17
18,-12,0,18.0,-12.0,0.4497096538543701,409.06812087536053,47,364,-191,1873,271,915,759,4,98.04
18,-12,0,18.0,-12.0,0.4579195976257324,387.5600082143956,47,346,-179,1873,271,915,759,4,94.46
18,-12,0,18.0,-12.0,0.46570873260498047,366.06657006579667,47,328,-167,1873,271,915,759,4,90.79
14,-11,0,14.0,-11.0,0.4737067222595215,348.6165997211199,47,314,-156,1873,271,915,759,4,84.17
14,-10,0,14.0,-10.0,0.4818136692047119,331.64052511647924,47,300,-146,1873,271,915,759,4,81.19
14,-9,0,14.0,-9.0,0.4897346496582031,315.11985116040904,47,286,-137,1873,271,915,759,4,78.38
15,-8,0,15.0,-8.0,0.4977126121520996,298.13663555121025,47,271,-129,1873,271,915,759,4,77.05
14,-6,0,14.0,-6.0,0.5057117938995361,282.91753192810023,47,257,-123,1873,271,915,759,4,72.97
12,-5,0,12.0,-5.0,0.5137667655944824,269.93565415369864,47,245,-118,1873,271,915,759,4,68.12
12,-4,0,12.0,-4.0,0.5217297077178955,257.3935234349539,47,233,-114,1873,271,915,759,4,64.3
11,-4,0,11.0,-4.0,0.529808759689331,245.7579463912308,47,222,-110,1873,271,915,759,4,61.42
9,-4,0,9.0,-4.0,0.5377047061920166,235.91805311913595,47,213,-106,1873,271,915,759,4,58.37
7,-3,0,7.0,-3.0,0.545703649520874,228.31500168247834,47,206,-103,1873,271,915,759,4,52.69
6,-3,0,6.0,-3.0,0.5537006855010986,221.60679774997897,47,200,-100,1873,271,915,759,4,51.97
7,-3,0,7.0,-3.0,0.5617117881774902,214.00462958001617,47,193,-97,1873,271,915,759,4,50.37
6,-4,0,6.0,-4.0,0.5697085857391357,206.84922791334424,47,187,-93,1873,271,915,759,4,47.37
7,-3,0,7.0,-3.0,0.5777137279510498,199.24611797498108,47,180,-90,1873,271,915,759,4,48.02
5,-3,0,5.0,-3.0,0.585702657699585,193.4328529188478,47,175,-87,1873,271,915,759,4,42.66
5,-2,0,5.0,-2.0,0.593700647354126,188.06577808748213,47,170,-85,1873,271,915,759,4,40.56
4,-2,0,4.0,-2.0,0.6016967296600342,183.59364213248256,47,166,-83,1873,271,915,759,4,39.87
4,-1,0,4.0,-1.0,0.6096956729888916,179.57092278225608,47,162,-82,1873,271,915,759,4,33.66
3,-1,0,3.0,-1.0,0.6177396774291992,176.4432682955566,47,159,-81,1873,271,915,759,4,30.02
3,-2,0,3.0,-2.0,0.6260287761688232,172.86280336309378,47,156,-79,1873,271,915,759,4,31.89
3,-1,0,3.0,-1.0,0.6337206363677979,169.73526137634053,47,153,-78,1873,271,915,759,4,29.25
3,-2,0,3.0,-2.0,0.6417076587677002,166.15469068687915,47,150,-76,1873,271,915,759,4,31.07
3,-1,0,3.0,-1.0,0.6497116088867188,163.0272704737008,47,147,-75,1873,271,915,759,4,28.47
3,-2,0,3.0,-2.0,0.6577086448669434,159.4465855941215,47,144,-73,1873,271,915,759,4,30.23
3,-2,0,3.0,-2.0,0.665827751159668,155.8670326572334,47,141,-71,1873,271,915,759,4,29.74
6,-2,0,6.0,-2.0,0.6738336086273193,149.61134522191932,47,135,-69,1873,271,915,759,4,35.96
5,-3,0,5.0,-3.0,0.6818366050720215,143.79437574886077,47,130,-66,1873,271,915,759,4,35.07
5,-4,0,5.0,-4.0,0.6897068023681641,137.5313584826006,47,125,-62,1873,271,915,759,4,33.48
6,-3,0,6.0,-3.0,0.6977195739746094,130.82319074619463,47,119,-59,1873,271,915,759,4,36.97
6,-4,0,6.0,-4.0,0.705723762512207,123.67418191498204,47,113,-55,1873,271,915,759,4,33.13
6,-4,0,6.0,-4.0,0.7137117385864258,116.53269591129698,47,107,-51,1873,271,915,759,4,31.74
6,-5,0,6.0,-5.0,0.7217066287994385,108.98198051936178,47,101,-46,1873,271,915,759,4,30.0
5,-4,0,5.0,-4.0,0.7297077178955078,102.78549517943789,47,96,-42,1873,271,915,759,4,27.04
5,-4,0,5.0,-4.0,0.7377007007598877,96.6154146165801,47,91,-38,1873,271,915,759,4,25.81
4,-3,0,4.0,-3.0,0.7458746433258057,91.77632963600144,47,87,-35,1873,271,915,759,4,22.89
4,-2,0,4.0,-2.0,0.753706693649292,87.31965069345043,47,83,-33,1873,271,915,759,4,22.94
3,-2,0,3.0,-2.0,0.7616996765136719,83.7962703152066,47,80,-31,1873,271,915,759,4,19.13
5,-2,0,5.0,-2.0,0.769906759262085,78.4114419718985,47,75,-29,1873,271,915,759,4,25.11
4,-2,0,4.0,-2.0,0.777991771697998,73.96051605933177,47,71,-27,1873,271,915,759,4,20.58
5,-2,0,5.0,-2.0,0.7857146263122559,68.57619995437555,47,66,-25,1873,271,915,759,4,23.01
4,-1,0,4.0,-1.0,0.7937047481536865,64.48308055437865,47,62,-24,1873,271,915,759,4,18.15
3,-2,0,3.0,-2.0,0.8017067909240723,60.96824596572466,47,59,-22,1873,271,915,759,4,15.73
3,-1,0,3.0,-1.0,0.809727668762207,57.80802621722272,47,56,-21,1873,271,915,759,4,16.88
1,-1,0,1.0,-1.0,0.8177785873413086,56.52349955359813,47,55,-20,1873,271,915,759,4,8.34
0,-1,0,-0.0,-1.0,0.8258466720581055,56.18934610390462,47,55,-19,1873,271,915,759,4,2.42
2,-1,0,2.0,-1.0,0.8336915969848633,53.97320787662612,47,53,-18,1873,271,915,759,4,12.62
1,-2,0,1.0,-2.0,0.8417837619781494,52.405882034941776,47,52,-16,1873,271,915,759,4,8.05
4,-2,0,4.0,-2.0,0.8497447967529297,48.0,47,48,-14,1873,271,915,759,4,15.41
2,-1,0,2.0,-1.0,0.857691764831543,45.80167361086848,47,46,-13,1873,271,915,759,4,11.2
3,-2,0,3.0,-2.0,0.8656966686248779,42.384682042344295,47,43,-11,1873,271,915,759,4,12.23
3,-2,0,3.0,-2.0,0.8736906051635742,39.0,47,40,-9,1873,271,915,759,4,11.55
3,0,0,3.0,-0.0,0.881746768951416,36.07886552931954,47,37,-9,1873,271,915,759,4,11.02
2,-2,0,2.0,-2.0,0.8897275924682617,33.6931365951495,47,35,-7,1873,271,915,759,4,8.47
1,-1,0,1.0,-1.0,0.8977127075195312,32.52535300326414,47,34,-6,1873,271,915,759,4,5.61
3,-2,0,3.0,-2.0,0.9056925773620605,29.25699921617557,47,31,-4,1873,271,915,759,4,9.55
3,-2,0,3.0,-2.0,0.9137067794799805,26.071337695236398,47,28,-2,1873,271,915,759,4,8.76
2,-2,0,2.0,-2.0,0.9217367172241211,24.0,47,26,0,1873,271,915,759,4,6.23
2,0,0,2.0,-0.0,0.9297177791595459,22.0,47,24,0,1873,271,915,759,4,12.27
1,-1,0,1.0,-1.0,0.9376926422119141,21.021728866442675,47,23,1,1873,271,915,759,4,3.75
1,0,0,1.0,-0.0,0.9457137584686279,20.02271554554524,47,22,1,1873,271,915,759,4,7.69
1,0,0,1.0,-0.0,0.9537017345428467,19.02379604162864,47,21,1,1873,271,915,759,4,7.56
1,0,0,1.0,-0.0,0.9618005752563477,18.024984394500787,47,20,1,1873,271,915,759,4,7.43
2,0,0,2.0,-0.0,0.9698667526245117,16.027756377319946,47,18,1,1873,271,915,759,4,8.84
1,0,0,1.0,-0.0,0.9777047634124756,15.029386365926403,47,17,1,1873,271,915,759,4,6.99
1,0,0,1.0,-0.0,0.9857876300811768,14.031219541881399,47,16,1,1873,271,915,759,4,6.84
2,0,0,2.0,-0.0,0.9938836097717285,12.035668847618199,47,14,1,1873,271,915,759,4,7.98
3,0,0,3.0,-0.0,1.0016987323760986,9.045361017187261,47,11,1,1873,271,915,759,4,8.17
2,-1,0,2.0,-1.0,1.0097107887268066,7.219544457292887,47,9,2,1873,271,915,759,4,3.8
1,0,0,1.0,-0.0,1.0257318019866943,6.246211251235321,47,8,2,1873,271,915,759,4,4.18
1,0,0,1.0,-0.0,1.0337817668914795,5.280109889280518,47,7,2,1873,271,915,759,4,3.85
1,0,0,1.0,-0.0,1.041698694229126,4.324555320336759,47,6,2,1873,271,915,759,4,3.48
1,0,0,1.0,-0.0,1.0497117042541504,3.3851648071345037,47,5,2,1873,271,915,759,4,3.06
1,0,0,1.0,-0.0,1.0657427310943604,2.4721359549995796,47,4,2,1873,271,915,759,4,2.55
1,0,0,1.0,-0.0,1.0737106800079346,1.6055512754639891,47,3,2,1873,271,915,759,4,1.93
1,0,0,1.0,-0.0,1.0897107124328613,0.8284271247461903,47,2,2,1873,271,915,759,4,1.15
1,0,0,1.0,-0.0,1.09769868850708,0.2360679774997898,47,1,2,1873,271,915,759,4,0.13
1,1,0,1.0,1.0,1.1057157516479492,-1.0,47,0,1,1873,271,915,759,4,0.85
1,0,0,1.0,-0.0,1.1216926574707031,-0.5857864376269049,47,-1,1,1873,271,915,759,4,1.37
1,1,0,1.0,1.0,1.13773775100708,0.0,47,-2,0,1873,271,915,759,4,0.64
0,0,1,-0.0,-0.0,1.2127106189727783,0.0,47,-2,0,1873,271,915,759,4,26.93
1,0,1,1.0,-0.0,0.06010127067565918,927.8790499325032,48,-925,237,951,508,1875,271,54,6.26
0,0,0,-0.0,-0.0,0.10982823371887207,927.8790499325032,48,-925,237,951,508,1875,271,54,197.0
-1,0,0,-1.0,-0.0,0.17988038063049316,926.9103731483373,48,-924,237,951,508,1875,271,54,6.04
-2,1,0,-2.0,1.0,0.18784427642822266,924.7247501247406,48,-922,236,951,508,1875,271,54,10.28
-4,2,0,-4.0,2.0,0.1958463191986084,920.3542104197353,48,-918,234,951,508,1875,271,54,17.04
-5,3,0,-5.0,3.0,0.2039022445678711,914.7696108921757,48,-913,231,951,508,1875,271,54,20.11
-9,5,0,-9.0,5.0,0.21189141273498535,904.8218713895913,48,-904,226,951,508,1875,271,54,31.69
-11,4,0,-11.0,4.0,0.21984124183654785,893.1809604637557,48,-893,222,951,508,1875,271,54,36.7
-12,6,0,-12.0,6.0,0.22788119316101074,880.0926082820871,48,-881,216,951,508,1875,271,54,38.67
-15,6,0,-15.0,6.0,0.23595619201660156,864.098198853527,48,-866,210,951,508,1875,271,54,44.93
-17,7,0,-17.0,7.0,0.24382734298706055,845.9318415546543,48,-849,203,951,508,1875,271,54,48.43
-18,7,0,-18.0,7.0,0.2518472671508789,826.8014991788197,48,-831,196,951,508,1875,271,54,49.69
-16,6,0,-16.0,6.0,0.25983428955078125,809.8542286443918,48,-815,190,951,508,1875,271,54,45.24
-16,5,0,-16.0,5.0,0.26792240142822266,793.1377933006136,48,-799,185,951,508,1875,271,54,44.95
-16,5,0,-16.0,5.0,0.27596235275268555,776.4233006329852,48,-783,180,951,508,1875,271,54,44.39
-21,4,0,-21.0,4.0,0.2838883399963379,755.0613786653832,48,-762,176,951,508,1875,271,54,52.33
-26,4,0,-26.0,4.0,0.29183435440063477,728.8306688670419,48,-736,172,951,508,1875,271,54,57.59
-28,2,0,-28.0,2.0,0.2998383045196533,701.1236158785127,48,-708,170,951,508,1875,271,54,57.24
-32,2,0,-32.0,2.0,0.30791425704956055,669.56299069072,48,-676,168,951,508,1875,271,54,60.13
-33,2,0,-33.0,2.0,0.3158533573150635,637.0820732409511,48,-643,166,951,508,1875,271,54,59.24
-35,1,0,-35.0,1.0,0.3241863250732422,602.9912697807804,48,-608,165,951,508,1875,271,54,58.6
-36,3,0,-36.0,3.0,0.33185625076293945,567.4981076504786,48,-572,162,951,508,1875,271,54,58.0
-35,3,0,-35.0,3.0,0.3399841785430908,533.0446410778341,48,-537,159,951,508,1875,271,54,54.73
-33,3,0,-33.0,3.0,0.3481593132019043,500.5907504875346,48,-504,156,951,508,1875,271,54,50.72
-35,5,0,-35.0,5.0,0.35585927963256836,465.70883897084695,48,-469,151,951,508,1875,271,54,50.74
-32,5,0,-32.0,5.0,0.36382341384887695,433.74396360668686,48,-437,146,951,508,1875,271,54,46.08
-31,6,0,-31.0,6.0,0.3718392848968506,402.4601262049831,48,-406,140,951,508,1875,271,54,43.56
-30,5,0,-30.0,5.0,0.3798964023590088,372.50093867223893,48,-376,135,951,508,1875,271,54,40.03
-27,5,0,-27.0,5.0,0.3880422115325928,345.4258315423354,48,-349,130,951,508,1875,271,54,35.87
-25,4,0,-25.0,4.0,0.3958563804626465,320.6377424849034,48,-324,126,951,508,1875,271,54,32.05
-23,5,0,-23.0,5.0,0.40387630462646484,297.4102341172362,48,-301,121,951,508,1875,271,54,29.57
-21,5,0,-21.0,5.0,0.41193222999572754,276.07754783223385,48,-280,116,951,508,1875,271,54,26.75
-19,5,0,-19.0,5.0,0.4200572967529297,256.6229891951638,48,-261,111,951,508,1875,271,54,24.16
-19,6,0,-19.0,6.0,0.42788124084472656,236.79727064547126,48,-242,105,951,508,1875,271,54,23.63
-17,4,0,-17.0,4.0,0.43584537506103516,219.62927644543743,48,-225,101,951,508,1875,271,54,19.78
-14,5,0,-14.0,5.0,0.4438283443450928,204.81242417092315,48,-211,96,951,508,1875,271,54,18.27
-13,4,0,-13.0,4.0,0.45185232162475586,191.33002542023394,48,-198,92,951,508,1875,271,54,15.92
-10,3,0,-10.0,3.0,0.459827184677124,181.00240383226344,48,-188,89,951,508,1875,271,54,12.91
-9,3,0,-9.0,3.0,0.46788930892944336,171.58751219550538,48,-179,86,951,508,1875,271,54,12.05
-7,3,0,-7.0,3.0,0.47583436965942383,163.97905644337024,48,-172,83,951,508,1875,271,54,11.64
-7,3,0,-7.0,3.0,0.4838383197784424,156.3712082089225,48,-165,80,951,508,1875,271,54,11.33
-8,3,0,-8.0,3.0,0.49186038970947266,147.8656627242753,48,-157,77,951,508,1875,271,54,10.78
-8,3,0,-8.0,3.0,0.49984025955200195,139.3640586184408,48,-149,74,951,508,1875,271,54,10.39
-8,4,0,-8.0,4.0,0.507817268371582,130.41982086128797,48,-141,70,951,508,1875,271,54,13.28
-10,3,0,-10.0,3.0,0.5158202648162842,120.13938969562162,48,-131,67,951,508,1875,271,54,9.87
-8,3,0,-8.0,3.0,0.5238392353057861,111.65424623862049,48,-123,64,951,508,1875,271,54,9.04
-7,3,0,-7.0,3.0,0.5319263935089111,104.06105447462264,48,-116,61,951,508,1875,271,54,8.79
-3,2,0,-3.0,2.0,0.5398483276367188,100.47548783981962,48,-113,59,951,508,1875,271,54,6.05
-4,1,0,-4.0,1.0,0.5478732585906982,96.47064428438041,48,-109,58,951,508,1875,271,54,5.11
-4,2,0,-4.0,2.0,0.5558211803436279,92.0,48,-105,56,951,508,1875,271,54,7.96
-5,1,0,-5.0,1.0,0.563880205154419,87.12712210513327,48,-100,55,951,508,1875,271,54,5.02
-5,2,0,-5.0,2.0,0.5718543529510498,81.78419002777932,48,-95,53,951,508,1875,271,54,6.27
-4,1,0,-4.0,1.0,0.5798392295837402,77.80935072788114,48,-91,52,951,508,1875,271,54,4.5
-4,2,0,-4.0,2.0,0.5878372192382812,73.34440691936945,48,-87,50,951,508,1875,271,54,6.64
-4,2,0,-4.0,2.0,0.595853328704834,68.88013350011565,48,-83,48,951,508,1875,271,54,6.47
-4,2,0,-4.0,2.0,0.6038262844085693,64.4166286842826,48,-79,46,951,508,1875,271,54,6.29
-2,2,0,-2.0,2.0,0.6118912696838379,61.68483523128404,48,-77,44,951,508,1875,271,54,3.68
-2,1,0,-2.0,1.0,0.6198382377624512,59.45229898620394,48,-75,43,951,508,1875,271,54,5.44
-1,2,0,-1.0,2.0,0.6283903121948242,57.599054368237475,48,-74,41,951,508,1875,271,54,2.14
-3,1,0,-3.0,1.0,0.6361043453216553,54.492330927517344,48,-71,40,951,508,1875,271,54,4.14
-2,2,0,-2.0,2.0,0.6438393592834473,51.77182237323191,48,-69,38,951,508,1875,271,54,3.42
-3,3,0,-3.0,3.0,0.6518402099609375,47.70609078247904,48,-66,35,951,508,1875,271,54,3.66
-4,3,0,-4.0,3.0,0.659846305847168,42.77105417004964,48,-62,32,951,508,1875,271,54,4.56
-5,3,0,-5.0,3.0,0.6678273677825928,36.953107821277925,48,-57,29,951,508,1875,271,54,5.73
-5,3,0,-5.0,3.0,0.6758463382720947,31.137767414994535,48,-52,26,951,508,1875,271,54,5.38
-5,3,0,-5.0,3.0,0.683887243270874,25.32590180780452,48,-47,23,951,508,1875,271,54,5.02
-5,3,0,-5.0,3.0,0.6918272972106934,19.518813398452032,48,-42,20,951,508,1875,271,54,4.62
-7,4,0,-7.0,4.0,0.7000012397766113,11.483762809787713,48,-35,16,951,508,1875,271,54,4.58
-5,3,0,-5.0,3.0,0.7081453800201416,5.695565448543633,48,-30,13,951,508,1875,271,54,3.57
-6,3,0,-6.0,3.0,0.7158372402191162,-1.0,48,-24,10,951,508,1875,271,54,4.14
-5,3,0,-5.0,3.0,0.7238402366638184,-6.751543268683413,48,-19,7,951,508,1875,271,54,2.39
-2,1,0,-2.0,1.0,0.731849193572998,-8.972243622680054,48,-17,6,951,508,1875,271,54,3.02
-2,1,0,-2.0,1.0,0.7398252487182617,-11.188611699158104,48,-15,5,951,508,1875,271,54,2.74
-1,1,0,-1.0,1.0,0.7478492259979248,-12.439780221438964,48,-14,4,951,508,1875,271,54,1.08
0,0,1,-0.0,-0.0,0.752833366394043,-12.439780221438964,48,-14,4,951,508,1875,271,54,23.45
0,0,0,-0.0,-0.0,0.09407949447631836,714.0110802473879,49,274,668,1239,1172,965,504,17,168.8
-1,1,0,-1.0,1.0,0.2150876522064209,713.466561941716,49,275,667,1239,1172,965,504,17,5.56
-1,3,0,-1.0,3.0,0.22307848930358887,711.0771863993461,49,276,664,1239,1172,965,504,17,21.13
-2,5,0,-2.0,5.0,0.231095552444458,707.2377227188175,49,278,659,1239,1172,965,504,17,30.74
-1,7,0,-1.0,7.0,0.23911046981811523,701.1861532771209,49,279,652,1239,1172,965,504,17,43.6
-1,9,0,-1.0,9.0,0.24707651138305664,693.3194707121712,49,280,643,1239,1172,965,504,17,51.91
0,9,0,-0.0,9.0,0.25504350662231445,685.0771962775864,49,280,634,1239,1172,965,504,17,53.45
0,11,0,-0.0,11.0,0.2631046772003174,675.0292819491709,49,280,623,1239,1172,965,504,17,59.95
3,12,0,3.0,12.0,0.2711186408996582,662.8576600144028,49,277,611,1239,1172,965,504,17,67.49
4,14,0,4.0,14.0,0.2790546417236328,648.4586811064349,49,273,597,1239,1172,965,504,17,73.1
6,14,0,6.0,14.0,0.28708362579345703,633.2316274171136,49,267,583,1239,1172,965,504,17,76.2
6,15,0,6.0,15.0,0.2950625419616699,617.0959926283323,49,261,568,1239,1172,965,504,17,76.43
7,16,0,7.0,16.0,0.30305957794189453,599.6347587161222,49,254,552,1239,1172,965,504,17,78.91
7,16,0,7.0,16.0,0.31107354164123535,582.1737032433756,49,247,536,1239,1172,965,504,17,77.48
9,18,0,9.0,18.0,0.31923365592956543,562.0596460020653,49,238,518,1239,1172,965,504,17,80.22
7,17,0,7.0,17.0,0.32706665992736816,543.6901304174291,49,231,501,1239,1172,965,504,17,75.28
8,18,0,8.0,18.0,0.3350646495819092,523.9943608723687,49,223,483,1239,1172,965,504,17,76.85
9,19,0,9.0,19.0,0.3430595397949219,502.9716234782515,49,214,464,1239,1172,965,504,17,77.24
9,22,0,9.0,22.0,0.35105156898498535,479.2258203338571,49,205,442,1239,1172,965,504,17,77.29
11,21,0,11.0,21.0,0.35907459259033203,455.54827148852576,49,194,421,1239,1172,965,504,17,74.62
10,21,0,10.0,21.0,0.36711549758911133,432.29081298614443,49,184,400,1239,1172,965,504,17,72.94
9,19,0,9.0,19.0,0.3750736713409424,411.26841044848584,49,175,381,1239,1172,965,504,17,67.97
10,20,0,10.0,20.0,0.3830575942993164,388.92064698123227,49,165,361,1239,1172,965,504,17,66.23
10,20,0,10.0,20.0,0.3910956382751465,366.5744251814317,49,155,341,1239,1172,965,504,17,63.65
10,20,0,10.0,20.0,0.39905762672424316,344.23003846918,49,145,321,1239,1172,965,504,17,61.0
8,19,0,8.0,19.0,0.4070596694946289,323.621772505968,49,137,302,1239,1172,965,504,17,57.07
8,18,0,8.0,18.0,0.41508054733276367,303.9246703933499,49,129,284,1239,1172,965,504,17,54.74
9,18,0,9.0,18.0,0.4230666160583496,283.81500989496755,49,120,266,1239,1172,965,504,17,51.41
10,17,0,10.0,17.0,0.43108057975769043,264.21498856602295,49,110,249,1239,1172,965,504,17,47.17
11,18,0,11.0,18.0,0.4390685558319092,243.32051249350897,49,99,231,1239,1172,965,504,17,45.47
11,14,0,11.0,14.0,0.44714856147766113,226.1644721130855,49,88,217,1239,1172,965,504,17,38.77
11,12,0,11.0,12.0,0.4550755023956299,210.98401768165638,49,77,205,1239,1172,965,504,17,34.38
11,13,0,11.0,13.0,0.46322154998779297,195.02709178826356,49,66,192,1239,1172,965,504,17,33.31
10,11,0,10.0,11.0,0.4710676670074463,181.46503635235712,49,56,181,1239,1172,965,504,17,28.94
8,10,0,8.0,10.0,0.47905755043029785,169.6091213873882,49,48,171,1239,1172,965,504,17,25.8
7,8,0,7.0,8.0,0.4871175289154053,160.0773631397161,49,41,163,1239,1172,965,504,17,21.67
5,8,0,5.0,8.0,0.4950594902038574,151.1257364476281,49,36,155,1239,1172,965,504,17,20.56
4,6,0,4.0,6.0,0.5031294822692871,144.3975065412817,49,32,149,1239,1172,965,504,17,16.62
3,7,0,3.0,7.0,0.5111095905303955,136.9310180741169,49,29,142,1239,1172,965,504,17,17.94
2,5,0,2.0,5.0,0.5190765857696533,131.6352391053204,49,27,137,1239,1172,965,504,17,14.4
1,4,0,1.0,4.0,0.5271744728088379,127.51752654177244,49,26,133,1239,1172,965,504,17,13.76
1,4,0,1.0,4.0,0.5351066589355469,123.40015220691336,49,25,129,1239,1172,965,504,17,13.5
1,3,0,1.0,3.0,0.5430946350097656,120.26534995859171,49,24,126,1239,1172,965,504,17,10.45
0,1,0,-0.0,1.0,0.551053524017334,119.283148923964,49,24,125,1239,1172,965,504,17,5.49
0,2,0,-0.0,2.0,0.5590674877166748,117.31959144523253,49,24,123,1239,1172,965,504,17,7.56
0,1,0,-0.0,1.0,0.5671424865722656,116.33824833895642,49,24,122,1239,1172,965,504,17,5.4
1,1,0,1.0,1.0,0.575075626373291,115.1665539016173,49,23,121,1239,1172,965,504,17,4.25
0,2,0,-0.0,2.0,0.5832266807556152,113.2023102090055,49,23,119,1239,1172,965,504,17,7.45
0,2,0,-0.0,2.0,0.5911686420440674,111.23925528113634,49,23,117,1239,1172,965,504,17,7.36
0,2,0,-0.0,2.0,0.5990705490112305,109.27744881263405,49,23,115,1239,1172,965,504,17,7.28
-1,3,0,-1.0,3.0,0.6070775985717773,106.54256850621083,49,24,112,1239,1172,965,504,17,7.22
0,4,0,-0.0,4.0,0.6150646209716797,102.63453348751464,49,24,108,1239,1172,965,504,17,10.19
0,5,0,-0.0,5.0,0.6230745315551758,97.75916035975324,49,24,103,1239,1172,965,504,17,11.2
0,5,0,-0.0,5.0,0.6310615539550781,92.89598604503551,49,24,98,1239,1172,965,504,17,10.79
0,4,0,-0.0,4.0,0.6392815113067627,89.01546268507923,49,24,94,1239,1172,965,504,17,9.19
2,4,0,2.0,4.0,0.6470625400543213,84.64987857520376,49,22,90,1239,1172,965,504,17,9.71
2,5,0,2.0,5.0,0.6552245616912842,79.32124598286491,49,20,85,1239,1172,965,504,17,11.01
2,4,0,2.0,4.0,0.6630825996398926,74.97590011563598,49,18,81,1239,1172,965,504,17,8.93
2,3,0,2.0,3.0,0.671048641204834,71.62411694957753,49,16,78,1239,1172,965,504,17,6.93
1,4,0,1.0,4.0,0.6790676116943359,67.50496672405067,49,15,74,1239,1172,965,504,17,10.38
0,2,0,-0.0,2.0,0.6870956420898438,65.54590403278758,49,15,72,1239,1172,965,504,17,5.8
0,2,0,-0.0,2.0,0.6950654983520508,63.58910531638176,49,15,70,1239,1172,965,504,17,5.69
1,3,0,1.0,3.0,0.7030634880065918,60.447059834590405,49,14,67,1239,1172,965,504,17,7.75
0,3,0,-0.0,3.0,0.7110536098480225,57.513357416636794,49,14,64,1239,1172,965,504,17,6.54
1,3,0,1.0,3.0,0.7190706729888916,54.369864518050704,49,13,61,1239,1172,965,504,17,7.47
0,3,0,-0.0,3.0,0.7270774841308594,51.43904440685432,49,13,58,1239,1172,965,504,17,6.19
2,3,0,2.0,3.0,0.7350466251373291,48.089214649520635,49,11,55,1239,1172,965,504,17,5.59
1,3,0,1.0,3.0,0.7430524826049805,44.952809179494906,49,10,52,1239,1172,965,504,17,6.74
1,1,0,1.0,1.0,0.7510545253753662,43.78802950489621,49,9,51,1239,1172,965,504,17,2.7
1,3,0,1.0,3.0,0.7593104839324951,40.662100242385755,49,8,48,1239,1172,965,504,17,6.25
1,2,0,1.0,2.0,0.7670576572418213,38.52956049652737,49,7,46,1239,1172,965,504,17,4.38
2,3,0,2.0,3.0,0.7750496864318848,35.289721643826724,49,5,43,1239,1172,965,504,17,4.46
0,3,0,-0.0,3.0,0.783144474029541,32.311288741492746,49,5,40,1239,1172,965,504,17,5.98
2,3,0,2.0,3.0,0.791252613067627,29.12142238654117,49,3,37,1239,1172,965,504,17,3.94
1,2,0,1.0,2.0,0.7990756034851074,27.05709628591621,49,2,35,1239,1172,965,504,17,3.44
1,3,0,1.0,3.0,0.8071575164794922,24.015621187164243,49,1,32,1239,1172,965,504,17,4.34
1,3,0,1.0,3.0,0.8150546550750732,21.0,49,0,29,1239,1172,965,504,17,3.99
1,3,0,1.0,3.0,0.8232345581054688,18.019223662515376,49,-1,26,1239,1172,965,504,17,3.61
2,4,0,2.0,4.0,0.8310446739196777,14.203603311174518,49,-3,22,1239,1172,965,504,17,2.89
1,3,0,1.0,3.0,0.8390665054321289,11.4164878389476,49,-4,19,1239,1172,965,504,17,2.47
1,3,0,1.0,3.0,0.8470785617828369,8.763054614240211,49,-5,16,1239,1172,965,504,17,1.96
1,2,0,1.0,2.0,0.8550496101379395,7.231546211727817,49,-6,14,1239,1172,965,504,17,0.98
1,1,0,1.0,1.0,0.8630557060241699,6.7648230602334,49,-7,13,1239,1172,965,504,17,0.06
0,1,0,-0.0,1.0,0.8710684776306152,5.892443989449804,49,-7,12,1239,1172,965,504,17,1.62
0,1,0,-0.0,1.0,0.8791165351867676,5.038404810405298,49,-7,11,1239,1172,965,504,17,1.47
0,1,0,-0.0,1.0,0.8950974941253662,4.206555615733702,49,-7,10,1239,1172,965,504,17,1.31
0,1,0,-0.0,1.0,0.911043643951416,3.401754250991379,49,-7,9,1239,1172,965,504,17,1.14
0,1,0,-0.0,1.0,0.919062614440918,2.63014581273465,49,-7,8,1239,1172,965,504,17,0.95
0,1,0,-0.0,1.0,0.9437675476074219,1.8994949366116654,49,-7,7,1239,1172,965,504,17,0.76
0,1,0,-0.0,1.0,1.0310606956481934,1.219544457292887,49,-7,6,1239,1172,965,504,17,0.56
0,0,1,-0.0,-0.0,1.0320255756378174,1.219544457292887,49,-7,6,1239,1172,965,504,17,27.29
0,0,0,-0.0,-0.0,1.1191174983978271,1.219544457292887,49,-7,6,1239,1172,965,504,17,17.29
-1,0,0,-1.0,-0.0,1.143059492111206,0.48528137423856954,49,-6,6,1239,1172,965,504,17,0.66
-1,0,0,-1.0,-0.0,1.1590855121612549,-0.18975032409334602,49,-5,6,1239,1172,965,504,17,0.42
-1,0,0,-1.0,-0.0,1.1750714778900146,-0.7888974490720218,49,-4,6,1239,1172,965,504,17,0.17
-1,-1,0,-1.0,-1.0,1.1910696029663086,-0.38422689413609135,49,-3,7,1239,1172,965,504,17,0.41
-1,0,0,-1.0,-0.0,1.1990644931793213,-0.719890110719482,49,-2,7,1239,1172,965,504,17,-0.29
-1,-1,0,-1.0,-1.0,1.2070555686950684,0.06225774829854913,49,-1,8,1239,1172,965,504,17,0.13
-1,-2,0,-1.0,-2.0,1.2150566577911377,2.0,49,0,10,1239,1172,965,504,17,0.24
-2,-3,0,-2.0,-3.0,1.2231616973876953,5.152946437965905,49,2,13,1239,1172,965,504,17,-0.07
0,-1,0,-0.0,-1.0,1.2311596870422363,6.142135623730951,49,2,14,1239,1172,965,504,17,3.33
2,0,0,2.0,-0.0,1.3033576011657715,6.0,49,0,14,1239,1172,965,504,17,-0.62
1,0,0,1.0,-0.0,1.3110496997833252,6.035668847618199,49,-1,14,1239,1172,965,504,17,7.11
0,0,1,-0.0,-0.0,1.3360865116119385,6.035668847618199,49,-1,14,1239,1172,965,504,17,28.7
1,1,1,1.0,1.0,0.00323486328125,911.9894179301692,50,-931,-162,310,997,1240,1158,66,3.88
0,1,1,-0.0,1.0,0.011246919631958008,912.1613618848371,50,-931,-163,310,997,1240,1158,66,15.55
0,1,1,-0.0,1.0,0.027360916137695312,912.3343323925139,50,-931,-164,310,997,1240,1158,66,15.47
0,1,1,-0.0,1.0,0.035553932189941406,912.5083288898094,50,-931,-165,310,997,1240,1158,66,15.39
0,1,1,-0.0,1.0,0.043295860290527344,912.6833508104073,50,-931,-166,310,997,1240,1158,66,15.31
0,0,0,-0.0,-0.0,0.10331487655639648,912.6833508104073,50,-931,-166,310,997,1240,1158,66,195.13
0,0,1,-0.0,-0.0,0.16726207733154297,912.6833508104073,50,-931,-166,310,997,1240,1158,66,195.13
0,0,0,-0.0,-0.0,0.2122499942779541,912.6833508104073,50,-931,-166,310,997,1240,1158,66,195.13
-1,0,0,-1.0,-0.0,0.23524808883666992,911.698893828081,50,-930,-166,310,997,1240,1158,66,5.92
-2,0,0,-2.0,-0.0,0.24325895309448242,909.7300780180932,50,-928,-166,310,997,1240,1158,66,8.59
-2,0,0,-2.0,-0.0,0.25132107734680176,907.7613937657094,50,-926,-166,310,997,1240,1158,66,8.58
-2,0,0,-2.0,-0.0,0.25923705101013184,905.7928418985734,50,-924,-166,310,997,1240,1158,66,8.57
-4,0,0,-4.0,-0.0,0.26723694801330566,901.8561386651959,50,-920,-166,310,997,1240,1158,66,13.64
-5,-2,0,-5.0,-2.0,0.27527308464050293,896.5810884479095,50,-915,-164,310,997,1240,1158,66,16.72
-10,-4,0,-10.0,-4.0,0.28323793411254883,886.0348197973785,50,-905,-160,310,997,1240,1158,66,28.35
-13,-7,0,-13.0,-7.0,0.2912440299987793,872.0265189484782,50,-892,-153,310,997,1240,1158,66,34.28
-20,-9,0,-20.0,-9.0,0.29924488067626953,850.8099343184597,50,-872,-144,310,997,1240,1158,66,46.35
-25,-9,0,-25.0,-9.0,0.3072478771209717,824.6910865807106,50,-847,-135,310,997,1240,1158,66,53.04
-29,-11,0,-29.0,-11.0,0.3153369426727295,794.3451516749221,50,-818,-124,310,997,1240,1158,66,57.12
-30,-8,0,-30.0,-8.0,0.32326292991638184,763.4923100695951,50,-788,-116,310,997,1240,1158,66,57.21
-32,-9,0,-32.0,-9.0,0.33153486251831055,730.5345440777385,50,-756,-107,310,997,1240,1158,66,57.9
-33,-8,0,-33.0,-8.0,0.3392350673675537,696.7465313381078,50,-723,-99,310,997,1240,1158,66,57.51
-34,-7,0,-34.0,-7.0,0.3473989963531494,662.1150983829945,50,-689,-92,310,997,1240,1158,66,57.09
-31,-6,0,-31.0,-6.0,0.3552510738372803,630.5962627983977,50,-658,-86,310,997,1240,1158,66,52.51
-30,-5,0,-30.0,-5.0,0.363278865814209,600.2021794024402,50,-628,-81,310,997,1240,1158,66,50.42
-27,-4,0,-27.0,-4.0,0.37125205993652344,572.9125349421317,50,-601,-77,310,997,1240,1158,66,46.48
-26,-3,0,-26.0,-3.0,0.3792459964752197,546.7421840784057,50,-575,-74,310,997,1240,1158,66,44.39
-23,-3,0,-23.0,-3.0,0.38724803924560547,523.5473924114639,50,-552,-71,310,997,1240,1158,66,40.96
-22,-3,0,-22.0,-3.0,0.39524292945861816,501.3444581915302,50,-530,-68,310,997,1240,1158,66,38.4
-21,-2,0,-21.0,-2.0,0.40354394912719727,480.26114210994,50,-509,-66,310,997,1240,1158,66,35.11
-21,-2,0,-21.0,-2.0,0.411236047744751,459.1788292887048,50,-488,-64,310,997,1240,1158,66,34.14
-22,-2,0,-22.0,-2.0,0.41924190521240234,437.1063709417263,50,-466,-62,310,997,1240,1158,66,33.97
-20,-2,0,-20.0,-2.0,0.4272480010986328,417.0177774266257,50,-446,-60,310,997,1240,1158,66,31.3
-20,-2,0,-20.0,-2.0,0.4352889060974121,396.93022689734204,50,-426,-58,310,997,1240,1158,66,30.35
-16,0,0,-16.0,-0.0,0.4432508945465088,381.08211745981015,50,-410,-58,310,997,1240,1158,66,23.79
-15,-1,0,-15.0,-1.0,0.451279878616333,366.09146821248885,50,-395,-57,310,997,1240,1158,66,23.11
-15,0,0,-15.0,-0.0,0.4593088626861572,351.251219906977,50,-380,-57,310,997,1240,1158,66,21.54
-12,0,0,-12.0,-0.0,0.46737194061279297,339.38823826753713,50,-368,-57,310,997,1240,1158,66,18.04
-14,-1,0,-14.0,-1.0,0.47525501251220703,325.40200892294115,50,-354,-56,310,997,1240,1158,66,20.44
-16,-1,0,-16.0,-1.0,0.4832489490509033,309.4456161202827,50,-338,-55,310,997,1240,1158,66,21.44
-18,-1,0,-18.0,-1.0,0.49129486083984375,291.5242671973854,50,-320,-54,310,997,1240,1158,66,22.13
-19,-2,0,-19.0,-2.0,0.4993438720703125,272.45867150892934,50,-301,-52,310,997,1240,1158,66,22.74
-21,-1,0,-21.0,-1.0,0.5075888633728027,251.6067462306542,50,-280,-51,310,997,1240,1158,66,21.98
-23,-2,0,-23.0,-2.0,0.5152468681335449,228.6295090390226,50,-257,-49,310,997,1240,1158,66,22.29
-23,-1,0,-23.0,-1.0,0.5232319831848145,205.8723508487326,50,-234,-48,310,997,1240,1158,66,20.1
-21,-2,0,-21.0,-2.0,0.531282901763916,184.91053209975877,50,-213,-46,310,997,1240,1158,66,18.19
-18,-2,0,-18.0,-2.0,0.5392439365386963,166.90247622278218,50,-195,-44,310,997,1240,1158,66,15.61
-17,-1,0,-17.0,-1.0,0.5472609996795654,150.12017911743098,50,-178,-43,310,997,1240,1158,66,13.39
-13,-1,0,-13.0,-1.0,0.5552549362182617,137.26156348395253,50,-165,-42,310,997,1240,1158,66,10.81
-12,-2,0,-12.0,-2.0,0.5632500648498535,125.14234094637652,50,-153,-40,310,997,1240,1158,66,10.75
-10,-2,0,-10.0,-2.0,0.5712399482727051,114.96283317103658,50,-143,-38,310,997,1240,1158,66,9.87
-9,-2,0,-9.0,-2.0,0.5793468952178955,105.7515765676196,50,-134,-36,310,997,1240,1158,66,9.48
-8,-2,0,-8.0,-2.0,0.5872550010681152,97.50670480860362,50,-126,-34,310,997,1240,1158,66,9.64
-6,-2,0,-6.0,-2.0,0.595257043838501,91.1933975700802,50,-120,-32,310,997,1240,1158,66,7.35
-5,-1,0,-5.0,-1.0,0.6032419204711914,86.10499569707393,50,-115,-31,310,997,1240,1158,66,6.61
-7,-3,0,-7.0,-3.0,0.6112558841705322,78.57060544785082,50,-108,-28,310,997,1240,1158,66,6.26
-8,-4,0,-8.0,-4.0,0.6192798614501953,69.83968105745953,50,-100,-24,310,997,1240,1158,66,5.77
-7,-4,0,-7.0,-4.0,0.6272330284118652,62.12623192369179,50,-93,-20,310,997,1240,1158,66,4.74
-8,-4,0,-8.0,-4.0,0.6353728771209717,53.49277426467485,50,-85,-16,310,997,1240,1158,66,4.79
-5,-2,0,-5.0,-2.0,0.6432368755340576,48.21576201698781,50,-80,-14,310,997,1240,1158,66,4.2
-2,-1,0,-2.0,-1.0,0.6514449119567871,46.07591289387686,50,-78,-13,310,997,1240,1158,66,2.93
-2,-1,0,-2.0,-1.0,0.6592569351196289,43.941536246685374,50,-76,-12,310,997,1240,1158,66,2.86
-2,-1,0,-2.0,-1.0,0.6672489643096924,41.81310045707235,50,-74,-11,310,997,1240,1158,66,2.79
-2,-1,0,-2.0,-1.0,0.6752650737762451,39.69112738154499,50,-72,-10,310,997,1240,1158,66,2.72
-2,-1,0,-2.0,-1.0,0.6833090782165527,37.576199954375554,50,-70,-9,310,997,1240,1158,66,2.64
-1,0,0,-1.0,-0.0,0.6913008689880371,36.58448102845921,50,-69,-9,310,997,1240,1158,66,3.73
0,0,1,-0.0,-0.0,0.7312579154968262,36.58448102845921,50,-69,-9,310,997,1240,1158,66,37.97
-1,0,1,-1.0,-0.0,0.7792818546295166,35.59300255857006,50,-68,-9,310,997,1240,1158,66,13.71
-1,0,1,-1.0,-0.0,0.7952580451965332,34.60177512462228,50,-67,-9,310,997,1240,1158,66,13.68
-1,0,1,-1.0,-0.0,0.8032529354095459,33.610809933523555,50,-66,-9,310,997,1240,1158,66,13.65
0,0,0,-0.0,-0.0,0.8353099822998047,33.610809933523555,50,-66,-9,310,997,1240,1158,66,27.06
-1,0,0,-1.0,-0.0,0.9072549343109131,32.62011886609167,50,-65,-9,310,997,1240,1158,66,3.63
-1,0,0,-1.0,-0.0,0.9232339859008789,31.629714528226103,50,-64,-9,310,997,1240,1158,66,3.6
-1,0,0,-1.0,-0.0,0.9313130378723145,30.63961030678928,50,-63,-9,310,997,1240,1158,66,3.57
-2,0,0,-2.0,-0.0,0.9392800331115723,28.660360037871982,50,-61,-9,310,997,1240,1158,66,3.64
-4,-1,0,-4.0,-1.0,0.9472510814666748,24.55866572463264,50,-57,-8,310,997,1240,1158,66,4.26
-5,-1,0,-5.0,-1.0,0.9552340507507324,19.46903848937962,50,-52,-7,310,997,1240,1158,66,4.88
-7,-1,0,-7.0,-1.0,0.9632389545440674,12.398237851264668,50,-45,-6,310,997,1240,1158,66,6.87
-8,-1,0,-8.0,-1.0,0.9712438583374023,4.336309405188942,50,-37,-5,310,997,1240,1158,66,6.59
-5,-1,0,-5.0,-1.0,0.9792530536651611,-0.7509690068058035,50,-32,-4,310,997,1240,1158,66,4.0
-3,0,0,-3.0,-0.0,0.9872500896453857,-3.725437663391105,50,-29,-4,310,997,1240,1158,66,3.1
-1,0,0,-1.0,-0.0,0.9952490329742432,-4.715728752538098,50,-28,-4,310,997,1240,1158,66,3.24
-1,0,0,-1.0,-0.0,1.0032498836517334,-5.705311872087638,50,-27,-4,310,997,1240,1158,66,3.17
0,0,1,-0.0,-0.0,1.0062620639801025,-5.705311872087638,50,-27,-4,310,997,1240,1158,66,25.3
0,0,0,-0.0,-0.0,0.10196423530578613,431.5534340975266,51,248,-394,585,607,337,1001,68,123.12
1,-1,0,1.0,-1.0,0.18002629280090332,430.1745361391553,51,247,-393,585,607,337,1001,68,5.13
3,-3,0,3.0,-3.0,0.1879873275756836,426.0391287705862,51,244,-390,585,607,337,1001,68,9.35
7,-5,0,7.0,-5.0,0.19599223136901855,418.0995465602681,51,237,-385,585,607,337,1001,68,13.77
10,-7,0,10.0,-7.0,0.20396018028259277,406.9228957538948,51,227,-378,585,607,337,1001,68,17.5
12,-9,0,12.0,-9.0,0.2119591236114502,393.06673951503177,51,215,-369,585,607,337,1001,68,20.19
13,-10,0,13.0,-10.0,0.22001123428344727,377.92839183528,51,202,-359,585,607,337,1001,68,21.0
17,-15,0,17.0,-15.0,0.22795915603637695,356.59057848340376,51,185,-344,585,607,337,1001,68,26.05
15,-17,0,15.0,-17.0,0.2360982894897461,334.5498609415014,51,170,-327,585,607,337,1001,68,26.04
16,-19,0,16.0,-19.0,0.24398422241210938,310.3544685349676,51,154,-308,585,607,337,1001,68,26.4
17,-18,0,17.0,-18.0,0.2520313262939453,286.73197533142843,51,137,-290,585,607,337,1001,68,24.22
14,-19,0,14.0,-19.0,0.25995421409606934,263.6071235706565,51,123,-271,585,607,337,1001,68,23.11
13,-18,0,13.0,-18.0,0.2679572105407715,241.87859648765794,51,110,-253,585,607,337,1001,68,20.9
11,-18,0,11.0,-18.0,0.2765493392944336,221.0019607767752,51,99,-235,585,607,337,1001,68,19.65
8,-19,0,8.0,-19.0,0.2840311527252197,200.38643305447522,51,91,-216,585,607,337,1001,68,22.24
8,-22,0,8.0,-22.0,0.29195117950439453,177.00947846009194,51,83,-194,585,607,337,1001,68,19.5
7,-24,0,7.0,-24.0,0.29994821548461914,152.2149295840696,51,76,-170,585,607,337,1001,68,17.18
6,-24,0,6.0,-24.0,0.3079543113708496,127.91355718407277,51,70,-146,585,607,337,1001,68,14.61
6,-22,0,6.0,-22.0,0.3159971237182617,105.54210834009928,51,64,-124,585,607,337,1001,68,12.19
5,-18,0,5.0,-18.0,0.324019193649292,87.31364309095659,51,59,-106,585,607,337,1001,68,9.44
3,-13,0,3.0,-13.0,0.3320012092590332,74.55873986004075,51,56,-93,585,607,337,1001,68,6.63
3,-11,0,3.0,-11.0,0.33995819091796875,63.63708311906906,51,53,-82,585,607,337,1001,68,5.6
2,-9,0,2.0,-9.0,0.34830617904663086,55.05054744357274,51,51,-73,585,607,337,1001,68,4.28
2,-7,0,2.0,-7.0,0.35634326934814453,48.20097323024831,51,49,-66,585,607,337,1001,68,3.73
2,-5,0,2.0,-5.0,0.36395931243896484,43.00649323271382,51,47,-61,585,607,337,1001,68,3.6
1,-4,0,1.0,-4.0,0.37196922302246094,39.246160308919954,51,46,-57,585,607,337,1001,68,2.58
2,-3,0,2.0,-3.0,0.38000917434692383,35.65629906907199,51,44,-54,585,607,337,1001,68,4.54
1,-4,0,1.0,-4.0,0.3881072998046875,31.94694837519019,51,43,-50,585,607,337,1001,68,2.3
1,-4,0,1.0,-4.0,0.39595723152160645,28.289646009589745,51,42,-46,585,607,337,1001,68,2.12
2,-3,0,2.0,-3.0,0.4039621353149414,24.728187440104094,51,40,-43,585,607,337,1001,68,3.61
1,-3,0,1.0,-3.0,0.41197824478149414,21.865910893853687,51,39,-40,585,607,337,1001,68,2.04
2,-5,0,2.0,-5.0,0.41996216773986816,16.931326312987373,51,37,-35,585,607,337,1001,68,2.14
2,-4,0,2.0,-4.0,0.42797017097473145,12.75467891024384,51,35,-31,585,607,337,1001,68,2.14
4,-5,0,4.0,-5.0,0.4359612464904785,6.459856648287818,51,31,-26,585,607,337,1001,68,2.96
5,-6,0,5.0,-6.0,0.4439733028411865,-1.1975610662865463,51,26,-20,585,607,337,1001,68,2.5
4,-5,0,4.0,-5.0,0.4519622325897217,-7.372946088611304,51,22,-15,585,607,337,1001,68,1.75
4,-3,0,4.0,-3.0,0.4600093364715576,-12.366692347216063,51,18,-12,585,607,337,1001,68,3.85
3,-3,0,3.0,-3.0,0.4679732322692871,-16.5071443154641,51,15,-9,585,607,337,1001,68,1.67
3,-2,0,3.0,-2.0,0.47595834732055664,-20.107556010550198,51,12,-7,585,607,337,1001,68,3.45
1,-1,0,1.0,-1.0,0.4841041564941406,-21.470035913858332,51,11,-6,585,607,337,1001,68,1.72
1,0,0,1.0,-0.0,0.5002672672271729,-22.3380962103094,51,10,-6,585,607,337,1001,68,0.97
0,0,1,-0.0,-0.0,0.5149602890014648,-22.3380962103094,51,10,-6,585,607,337,1001,68,20.92
0,0,0,-0.0,-0.0,0.0883629322052002,305.62354769325856,52,187,243,762,856,575,613,3,98.07
1,0,0,1.0,-0.0,0.16145110130310059,305.01470552899906,52,186,243,762,856,575,613,3,16.27
1,1,0,1.0,1.0,0.1695089340209961,303.6128690649822,52,185,242,762,856,575,613,3,32.47
2,2,0,2.0,2.0,0.17735910415649414,300.8095425926755,52,183,240,762,856,575,613,3,47.09
2,2,0,2.0,2.0,0.18542790412902832,298.0066888883926,52,181,238,762,856,575,613,3,46.78
4,2,0,4.0,2.0,0.19342803955078125,294.0,52,177,236,762,856,575,613,3,52.53
5,2,0,5.0,2.0,0.2013719081878662,289.4134983088768,52,172,234,762,856,575,613,3,54.55
7,4,0,7.0,4.0,0.2094249725341797,282.0635970943632,52,165,230,762,856,575,613,3,62.94
9,5,0,9.0,5.0,0.21737003326416016,272.79006556118867,52,156,225,762,856,575,613,3,65.14
13,7,0,13.0,7.0,0.22535395622253418,259.71632093139084,52,143,218,762,856,575,613,3,67.33
14,11,0,14.0,11.0,0.23338103294372559,242.90571949013415,52,129,207,762,856,575,613,3,67.28
15,12,0,15.0,12.0,0.2413620948791504,224.8782858089728,52,114,195,762,856,575,613,3,64.15
16,12,0,16.0,12.0,0.24936890602111816,206.5885353289049,52,98,183,762,856,575,613,3,60.16
13,12,0,13.0,12.0,0.2573659420013428,189.9607289470796,52,85,171,762,856,575,613,3,56.11
13,12,0,13.0,12.0,0.26536107063293457,173.54225849346628,52,72,159,762,856,575,613,3,52.28
10,12,0,10.0,12.0,0.27333807945251465,158.5399636454766,52,62,147,762,856,575,613,3,48.72
9,13,0,9.0,13.0,0.2813599109649658,143.10065926289164,52,53,134,762,856,575,613,3,45.77
9,14,0,9.0,14.0,0.2893660068511963,126.81236246936366,52,44,120,762,856,575,613,3,42.33
7,14,0,7.0,14.0,0.29737091064453125,111.27199116431488,52,37,106,762,856,575,613,3,39.08
5,14,0,5.0,14.0,0.305419921875,96.40636529508737,52,32,92,762,856,575,613,3,38.27
4,14,0,4.0,14.0,0.3135099411010742,81.87339742040264,52,28,78,762,856,575,613,3,32.35
2,14,0,2.0,14.0,0.32135796546936035,68.07966415668217,52,26,64,762,856,575,613,3,26.84
2,12,0,2.0,12.0,0.3293569087982178,56.271284253105414,52,24,52,762,856,575,613,3,23.11
1,12,0,1.0,12.0,0.33736205101013184,45.14108798023731,52,23,40,762,856,575,613,3,19.33
2,9,0,2.0,9.0,0.34540700912475586,36.44329045369811,52,21,31,762,856,575,613,3,16.55
1,6,0,1.0,6.0,0.3533599376678467,31.015621187164243,52,20,25,762,856,575,613,3,13.13
1,7,0,1.0,7.0,0.3613579273223877,25.1725046566048,52,19,18,762,856,575,613,3,11.64
1,6,0,1.0,6.0,0.3695199489593506,20.633307652783937,52,18,12,762,856,575,613,3,9.46
0,5,0,-0.0,5.0,0.37735509872436523,18.313207915827967,52,18,7,762,856,575,613,3,6.0
0,5,0,-0.0,5.0,0.3853740692138672,17.110770276274835,52,18,2,762,856,575,613,3,3.27
1,3,0,1.0,3.0,0.3933980464935303,16.029386365926403,52,17,-1,762,856,575,613,3,3.28
1,4,0,1.0,4.0,0.40136098861694336,15.763054614240211,52,16,-5,762,856,575,613,3,0.08
1,3,0,1.0,3.0,0.41011691093444824,16.0,52,15,-8,762,856,575,613,3,7.81
1,2,0,1.0,2.0,0.4173460006713867,16.204650534085253,52,14,-10,762,856,575,613,3,8.64
2,2,0,2.0,2.0,0.42536211013793945,15.970562748477139,52,12,-12,762,856,575,613,3,0.27
2,3,0,2.0,3.0,0.4333980083465576,17.027756377319946,52,10,-15,762,856,575,613,3,2.73
2,1,0,2.0,1.0,0.44136691093444824,16.88854381999832,52,8,-16,762,856,575,613,3,0.05
1,1,0,1.0,1.0,0.4493980407714844,17.384776310850235,52,7,-17,762,856,575,613,3,6.02
0,1,0,-0.0,1.0,0.45739102363586426,18.313207915827967,52,7,-18,762,856,575,613,3,5.69
1,0,0,1.0,-0.0,0.5293679237365723,17.973665961010276,52,6,-18,762,856,575,613,3,1.62
1,0,0,1.0,-0.0,0.5533890724182129,17.681541692269406,52,5,-18,762,856,575,613,3,1.36
0,-1,0,-0.0,-1.0,0.561439037322998,16.72004514666935,52,5,-17,762,856,575,613,3,5.69
0,-1,0,-0.0,-1.0,0.5693809986114502,15.763054614240211,52,5,-16,762,856,575,613,3,5.51
0,-2,0,-0.0,-2.0,0.5773510932922363,13.866068747318506,52,5,-14,762,856,575,613,3,6.85
0,-1,0,-0.0,-1.0,0.585374116897583,12.92838827718412,52,5,-13,762,856,575,613,3,4.9
1,-1,0,1.0,-1.0,0.593390941619873,11.649110640673518,52,4,-12,762,856,575,613,3,5.08
0,-1,0,-0.0,-1.0,0.6013870239257812,10.704699910719626,52,4,-11,762,856,575,613,3,4.74
0,-1,0,-0.0,-1.0,0.6093559265136719,9.770329614269007,52,4,-10,762,856,575,613,3,4.48
1,-1,0,1.0,-1.0,0.6173710823059082,8.486832980505138,52,3,-9,762,856,575,613,3,4.62
0,-1,0,-0.0,-1.0,0.6333661079406738,7.54400374531753,52,3,-8,762,856,575,613,3,4.29
0,-1,0,-0.0,-1.0,0.6414101123809814,6.615773105863909,52,3,-7,762,856,575,613,3,3.95
0,-1,0,-0.0,-1.0,0.6493511199951172,5.708203932499369,52,3,-6,762,856,575,613,3,3.57
0,-1,0,-0.0,-1.0,0.6574139595031738,4.830951894845301,52,3,-5,762,856,575,613,3,3.13
0,-1,0,-0.0,-1.0,0.6735589504241943,4.0,52,3,-4,762,856,575,613,3,2.62
0,-1,0,-0.0,-1.0,0.6896641254425049,3.2426406871192848,52,3,-3,762,856,575,613,3,2.01
0,-1,0,-0.0,-1.0,0.6973531246185303,2.605551275463989,52,3,-2,762,856,575,613,3,1.27
1,-1,0,1.0,-1.0,0.7053980827331543,1.2360679774997898,52,2,-1,762,856,575,613,3,3.6
0,-1,0,-0.0,-1.0,0.7213759422302246,1.0,52,2,0,762,856,575,613,3,-0.95
1,0,0,1.0,-0.0,0.7293510437011719,0.0,52,1,0,762,856,575,613,3,9.22
0,0,1,-0.0,-0.0,0.7913599014282227,0.0,52,1,0,762,856,575,613,3,26.93
0,0,0,-0.0,-0.0,0.12050867080688477,702.0720073471073,53,-689,259,72,1115,761,856,68,167.09
-1,-1,0,-1.0,-1.0,0.22649359703063965,701.4889530101727,53,-688,260,72,1115,761,856,68,1.93
-1,0,0,-1.0,-0.0,0.23462462425231934,700.5536059403697,53,-687,260,72,1115,761,856,68,4.36
-2,0,0,-2.0,-0.0,0.24252963066101074,698.6834241335066,53,-685,260,72,1115,761,856,68,6.45
-1,0,0,-1.0,-0.0,0.2505686283111572,697.7485907058516,53,-684,260,72,1115,761,856,68,4.35
-2,0,0,-2.0,-0.0,0.25849366188049316,695.879442099858,53,-682,260,72,1115,761,856,68,6.43
-4,2,0,-4.0,2.0,0.2666466236114502,691.429527935002,53,-678,258,72,1115,761,856,68,13.59
-6,5,0,-6.0,5.0,0.2746007442474365,684.0480485315728,53,-672,253,72,1115,761,856,68,17.64
-7,5,0,-7.0,5.0,0.2825736999511719,675.7386843057099,53,-665,248,72,1115,761,856,68,19.55
-9,6,0,-9.0,6.0,0.290482759475708,665.2138442565335,53,-656,242,72,1115,761,856,68,23.4
-12,9,0,-12.0,9.0,0.29850053787231445,650.8539990392113,53,-644,233,72,1115,761,856,68,28.9
-18,10,0,-18.0,10.0,0.3066437244415283,630.5336710807061,53,-626,223,72,1115,761,856,68,37.42
-23,11,0,-23.0,11.0,0.3144955635070801,605.1815078676792,53,-603,212,72,1115,761,856,68,43.05
-24,12,0,-24.0,12.0,0.3227057456970215,578.5691797666611,53,-579,200,72,1115,761,856,68,43.0
-27,13,0,-27.0,13.0,0.3305387496948242,548.8147218456309,53,-552,187,72,1115,761,856,68,44.85
-26,11,0,-26.0,11.0,0.33852267265319824,520.6638621723972,53,-526,176,72,1115,761,856,68,42.47
-25,9,0,-25.0,9.0,0.34648966789245605,494.10036924811936,53,-501,167,72,1115,761,856,68,40.95
-25,8,0,-25.0,8.0,0.354494571685791,467.85356429938804,53,-476,159,72,1115,761,856,68,39.88
-24,8,0,-24.0,8.0,0.3625006675720215,442.5553483069936,53,-452,151,72,1115,761,856,68,38.7
-23,7,0,-23.0,7.0,0.37048864364624023,418.5229275959396,53,-429,144,72,1115,761,856,68,34.68
-23,7,0,-23.0,7.0,0.37848854064941406,394.49154017319876,53,-406,137,72,1115,761,856,68,33.41
-22,7,0,-22.0,7.0,0.38649559020996094,371.4084360247083,53,-384,130,72,1115,761,856,68,31.89
-21,6,0,-21.0,6.0,0.3945286273956299,349.59483833857826,53,-363,124,72,1115,761,856,68,28.67
-21,9,0,-21.0,9.0,0.40250253677368164,326.8171281965422,53,-342,115,72,1115,761,856,68,27.7
-21,8,0,-21.0,8.0,0.41048574447631836,304.3637096380166,53,-321,107,72,1115,761,856,68,27.02
-18,7,0,-18.0,7.0,0.4185056686401367,285.07522623983203,53,-303,100,72,1115,761,856,68,23.4
-16,6,0,-16.0,6.0,0.42655062675476074,268.00165562460086,53,-287,94,72,1115,761,856,68,21.13
-13,6,0,-13.0,6.0,0.4345085620880127,253.78464170278443,53,-274,88,72,1115,761,856,68,17.01
-12,5,0,-12.0,5.0,0.44248366355895996,240.83267636873165,53,-262,83,72,1115,761,856,68,15.93
-13,5,0,-13.0,5.0,0.45050859451293945,226.93102536877444,53,-249,78,72,1115,761,856,68,16.48
-13,5,0,-13.0,5.0,0.4585857391357422,213.0323865407125,53,-236,73,72,1115,761,856,68,15.83
-12,5,0,-12.0,5.0,0.4665796756744385,200.0939982143925,53,-224,68,72,1115,761,856,68,14.13
-14,4,0,-14.0,4.0,0.47449159622192383,185.5358740616212,53,-210,64,72,1115,761,856,68,16.47
-15,5,0,-15.0,5.0,0.48249268531799316,169.73021376320204,53,-195,59,72,1115,761,856,68,15.98
-14,5,0,-14.0,5.0,0.4905216693878174,154.88356201639147,53,-181,54,72,1115,761,856,68,13.99
-13,4,0,-13.0,4.0,0.49863362312316895,141.2826289168439,53,-168,50,72,1115,761,856,68,14.38
-11,3,0,-11.0,3.0,0.5065417289733887,129.88410539158457,53,-157,47,72,1115,761,856,68,11.94
-10,2,0,-10.0,2.0,0.5144946575164795,119.73353570382747,53,-147,45,72,1115,761,856,68,9.3
-10,2,0,-10.0,2.0,0.5224967002868652,109.58969322343438,53,-137,43,72,1115,761,856,68,8.8
-9,2,0,-9.0,2.0,0.5305056571960449,100.40610105199838,53,-128,41,72,1115,761,856,68,8.24
-10,2,0,-10.0,2.0,0.5385217666625977,90.27791436936813,53,-118,39,72,1115,761,856,68,7.83
-9,2,0,-9.0,2.0,0.5464897155761719,81.10864433221339,53,-109,37,72,1115,761,856,68,7.27
-10,3,0,-10.0,3.0,0.554492712020874,70.67568963231147,53,-99,34,72,1115,761,856,68,8.51
-10,2,0,-10.0,2.0,0.5625367164611816,60.57801012920498,53,-89,32,72,1115,761,856,68,6.27
-8,1,0,-8.0,1.0,0.5705556869506836,52.729464428186105,53,-81,31,72,1115,761,856,68,4.7
-10,2,0,-10.0,2.0,0.5785646438598633,42.694197955256044,53,-71,29,72,1115,761,856,68,5.08
-9,2,0,-9.0,2.0,0.5865426063537598,33.62396025078685,53,-62,27,72,1115,761,856,68,4.47
-8,2,0,-8.0,2.0,0.5944976806640625,25.506302187247357,53,-54,25,72,1115,761,856,68,4.0
-7,0,0,-7.0,-0.0,0.6025867462158203,19.235326616824658,53,-47,25,72,1115,761,856,68,2.15
-4,1,0,-4.0,1.0,0.6104977130889893,15.244289008980523,53,-43,24,72,1115,761,856,68,2.73
-3,1,0,-3.0,1.0,0.6187577247619629,12.141087980237309,53,-40,23,72,1115,761,856,68,3.0
-2,0,0,-2.0,-0.0,0.626497745513916,10.418464629025621,53,-38,23,72,1115,761,856,68,1.52
-2,0,0,-2.0,-0.0,0.6345245838165283,8.720018726587654,53,-36,23,72,1115,761,856,68,1.43
-1,1,0,-1.0,1.0,0.642561674118042,7.340053217188775,53,-35,22,72,1115,761,856,68,2.75
-1,0,0,-1.0,-0.0,0.6505506038665771,6.496913462633174,53,-34,22,72,1115,761,856,68,1.45
-1,0,0,-1.0,-0.0,0.6585016250610352,5.66106403010388,53,-33,22,72,1115,761,856,68,1.41
0,0,1,-0.0,-0.0,0.70450758934021,5.66106403010388,53,-33,22,72,1115,761,856,68,28.59
0,0,0,-0.0,-0.0,0.10259127616882324,1272.2337040715322,54,1261,-190,1366,903,105,1093,6,235.08
3,-2,0,3.0,-2.0,0.13252544403076172,1268.9701254353422,54,1258,-188,1366,903,105,1093,6,82.26
6,-4,0,6.0,-4.0,0.1411113739013672,1262.448537080825,54,1252,-184,1366,903,105,1093,6,120.32
11,-7,0,11.0,-7.0,0.14850735664367676,1250.5589335966617,54,1241,-177,1366,903,105,1093,6,152.23
13,-8,0,13.0,-8.0,0.15651226043701172,1236.5745237782196,54,1228,-169,1366,903,105,1093,6,159.2
16,-9,0,16.0,-9.0,0.16451740264892578,1219.5154395753045,54,1212,-160,1366,903,105,1093,6,166.99
17,-8,0,17.0,-8.0,0.1728653907775879,1201.6281583957766,54,1195,-152,1366,903,105,1093,6,167.88
18,-9,0,18.0,-9.0,0.18051433563232422,1182.6550931868846,54,1177,-143,1366,903,105,1093,6,168.64
20,-7,0,20.0,-7.0,0.1885373592376709,1161.9656647300812,54,1157,-136,1366,903,105,1093,6,170.93
25,-9,0,25.0,-9.0,0.19653725624084473,1136.1018391697908,54,1132,-127,1366,903,105,1093,6,176.47
25,-7,0,25.0,-7.0,0.2045273780822754,1110.4850695002606,54,1107,-120,1366,903,105,1093,6,174.36
30,-8,0,30.0,-8.0,0.21252131462097168,1079.8079238720043,54,1077,-112,1366,903,105,1093,6,177.08
34,-7,0,34.0,-7.0,0.2205674648284912,1045.2719112901957,54,1043,-105,1366,903,105,1093,6,177.52
35,-8,0,35.0,-8.0,0.22851133346557617,1009.6564076724148,54,1008,-97,1366,903,105,1093,6,174.49
36,-9,0,36.0,-9.0,0.2365262508392334,972.9754095262851,54,972,-88,1366,903,105,1093,6,171.24
37,-9,0,37.0,-9.0,0.24460744857788086,935.3314979259728,54,935,-79,1366,903,105,1093,6,167.92
33,-7,0,33.0,-7.0,0.2526063919067383,901.8690512996894,54,902,-72,1366,903,105,1093,6,161.9
31,-6,0,31.0,-6.0,0.2606503963470459,870.4969948431419,54,871,-66,1366,903,105,1093,6,157.16
31,-5,0,31.0,-5.0,0.26853442192077637,839.2119685684834,54,840,-61,1366,903,105,1093,6,154.06
27,-4,0,27.0,-4.0,0.27652430534362793,811.9957055101579,54,813,-57,1366,903,105,1093,6,147.79
27,-3,0,27.0,-3.0,0.2845163345336914,784.8527781254567,54,786,-54,1366,903,105,1093,6,145.44
28,-2,0,28.0,-2.0,0.2925293445587158,756.781547551663,54,758,-52,1366,903,105,1093,6,144.9
28,-1,0,28.0,-1.0,0.30052828788757324,728.7793383254271,54,730,-51,1366,903,105,1093,6,140.06
28,0,0,28.0,-0.0,0.3085603713989258,700.8501260921959,54,702,-51,1366,903,105,1093,6,135.85
28,2,0,28.0,2.0,0.31651926040649414,673.0806164948083,54,674,-53,1366,903,105,1093,6,131.45
29,2,0,29.0,2.0,0.32453131675720215,644.3407139984322,54,645,-55,1366,903,105,1093,6,128.61
25,2,0,25.0,2.0,0.33261728286743164,619.6146480769626,54,620,-57,1366,903,105,1093,6,122.05
23,2,0,23.0,2.0,0.34053730964660645,596.9083263299485,54,597,-59,1366,903,105,1093,6,117.13
23,2,0,23.0,2.0,0.3488502502441406,574.2321889846407,54,574,-61,1366,903,105,1093,6,114.18
22,3,0,22.0,3.0,0.35651636123657227,552.6977595779922,54,552,-64,1366,903,105,1093,6,109.87
20,3,0,20.0,3.0,0.36472225189208984,533.2023871636529,54,532,-67,1366,903,105,1093,6,104.91
22,4,0,22.0,4.0,0.3725564479827881,511.9184401436795,54,510,-71,1366,903,105,1093,6,103.93
22,4,0,22.0,4.0,0.38054347038269043,490.7296831263034,54,488,-75,1366,903,105,1093,6,100.91
23,3,0,23.0,3.0,0.38852643966674805,468.49655353989596,54,465,-78,1366,903,105,1093,6,99.0
23,4,0,23.0,4.0,0.39653539657592773,446.541989140058,54,442,-82,1366,903,105,1093,6,95.36
22,3,0,22.0,3.0,0.4046783447265625,425.51487722131657,54,420,-85,1366,903,105,1093,6,91.56
20,2,0,20.0,2.0,0.41253232955932617,406.35192683069175,54,400,-87,1366,903,105,1093,6,87.03
22,2,0,22.0,2.0,0.4205183982849121,385.33619455312174,54,378,-89,1366,903,105,1093,6,85.61
20,1,0,20.0,1.0,0.42853832244873047,366.139540011633,54,358,-90,1366,903,105,1093,6,81.14
20,1,0,20.0,1.0,0.43654847145080566,347.03571246374275,54,338,-91,1366,903,105,1093,6,78.02
20,0,0,20.0,-0.0,0.4445192813873291,327.76426651015373,54,318,-91,1366,903,105,1093,6,75.29
21,0,0,21.0,-0.0,0.4525632858276367,307.6283953536766,54,297,-91,1366,903,105,1093,6,72.63
20,-1,0,20.0,-1.0,0.4605123996734619,288.2541845192958,54,277,-90,1366,903,105,1093,6,68.94
21,-2,0,21.0,-2.0,0.46860241889953613,267.7027890510181,54,256,-88,1366,903,105,1093,6,66.41
20,0,0,20.0,-0.0,0.47654247283935547,248.87298386289865,54,236,-88,1366,903,105,1093,6,61.27
18,-1,0,18.0,-1.0,0.4845442771911621,231.71898091121648,54,218,-87,1366,903,105,1093,6,57.06
16,-1,0,16.0,-1.0,0.49251532554626465,216.5449840010015,54,202,-86,1366,903,105,1093,6,52.61
15,-1,0,15.0,-1.0,0.5007264614105225,202.41178155110774,54,187,-85,1366,903,105,1093,6,49.05
12,-2,0,12.0,-2.0,0.5085973739624023,190.68531178176625,54,175,-83,1366,903,105,1093,6,44.81
13,-1,0,13.0,-1.0,0.5165224075317383,178.57092278225608,54,162,-82,1366,903,105,1093,6,42.68
10,-2,0,10.0,-2.0,0.5245273113250732,168.7672844286711,54,152,-80,1366,903,105,1093,6,38.65
8,-2,0,8.0,-2.0,0.5325243473052979,160.76812876747417,54,144,-78,1366,903,105,1093,6,34.81
6,-2,0,6.0,-2.0,0.540534257888794,154.54364474646383,54,138,-76,1366,903,105,1093,6,30.94
5,-2,0,5.0,-2.0,0.5486164093017578,149.2005256232711,54,133,-74,1366,903,105,1093,6,28.67
4,-3,0,4.0,-3.0,0.5565173625946045,144.24808997063425,54,129,-71,1366,903,105,1093,6,26.93
4,-3,0,4.0,-3.0,0.5646004676818848,139.29898102235308,54,125,-68,1366,903,105,1093,6,26.26
3,-3,0,3.0,-3.0,0.5725324153900146,135.23530663329106,54,122,-65,1366,903,105,1093,6,22.42
4,-4,0,4.0,-4.0,0.5806403160095215,129.83448347473634,54,118,-61,1366,903,105,1093,6,25.07
3,-4,0,3.0,-4.0,0.5885233879089355,125.35108102388543,54,115,-57,1366,903,105,1093,6,21.75
2,-2,0,2.0,-2.0,0.5965263843536377,122.67418191498204,54,113,-55,1366,903,105,1093,6,16.49
1,-2,0,1.0,-2.0,0.604527473449707,120.90722335683259,54,112,-53,1366,903,105,1093,6,11.67
2,-2,0,2.0,-2.0,0.6127064228057861,118.24768039018313,54,110,-51,1366,903,105,1093,6,15.96
2,-3,0,2.0,-3.0,0.6205244064331055,115.18629362155326,54,108,-48,1366,903,105,1093,6,16.34
3,-2,0,3.0,-2.0,0.6285414695739746,111.63420083029322,54,105,-46,1366,903,105,1093,6,19.08
2,-2,0,2.0,-2.0,0.6365454196929932,109.0044641967453,54,103,-44,1366,903,105,1093,6,14.92
2,-1,0,2.0,-1.0,0.6445584297180176,106.77249200050075,54,101,-43,1366,903,105,1093,6,15.73
2,-2,0,2.0,-2.0,0.6525232791900635,104.15409464878138,54,99,-41,1366,903,105,1093,6,14.41
2,-3,0,2.0,-3.0,0.660529375076294,101.17773274553444,54,97,-38,1366,903,105,1093,6,14.6
3,-2,0,3.0,-2.0,0.668635368347168,97.65783625729296,54,94,-36,1366,903,105,1093,6,17.15
4,-4,0,4.0,-4.0,0.6765472888946533,92.51963149007642,54,90,-32,1366,903,105,1093,6,18.95
4,-3,0,4.0,-3.0,0.6846733093261719,87.75791976461338,54,86,-29,1366,903,105,1093,6,18.11
3,-4,0,3.0,-4.0,0.6925914287567139,83.68333173107735,54,83,-25,1366,903,105,1093,6,15.25
4,-3,0,4.0,-3.0,0.7005214691162109,79.00609733428362,54,79,-22,1366,903,105,1093,6,16.56
4,-4,0,4.0,-4.0,0.70857834815979,74.12976079309465,54,75,-18,1366,903,105,1093,6,15.63
3,-2,0,3.0,-2.0,0.7165224552154541,70.7563556583431,54,72,-16,1366,903,105,1093,6,13.1
2,-1,0,2.0,-1.0,0.724515438079834,68.58910531638176,54,70,-15,1366,903,105,1093,6,10.61
3,-2,0,3.0,-2.0,0.7325193881988525,65.24954212300622,54,67,-13,1366,903,105,1093,6,12.31
3,-1,0,3.0,-1.0,0.7405743598937988,62.115282384398824,54,64,-12,1366,903,105,1093,6,13.04
3,-2,0,3.0,-2.0,0.7485172748565674,58.814237842102365,54,61,-10,1366,903,105,1093,6,11.4
3,-1,0,3.0,-1.0,0.7565693855285645,55.69412236331676,54,58,-9,1366,903,105,1093,6,12.03
3,-1,0,3.0,-1.0,0.7645683288574219,52.57877292636101,54,55,-8,1366,903,105,1093,6,11.6
3,-1,0,3.0,-1.0,0.7731993198394775,49.46903848937962,54,52,-7,1366,903,105,1093,6,11.16
2,-1,0,2.0,-1.0,0.780813455581665,47.35871324805669,54,50,-6,1366,903,105,1093,6,8.24
2,-1,0,2.0,-1.0,0.7885143756866455,45.25971404805462,54,48,-5,1366,903,105,1093,6,7.97
2,-2,0,2.0,-2.0,0.7965133190155029,43.09772228646444,54,46,-3,1366,903,105,1093,6,6.86
1,0,0,1.0,-0.0,0.8045704364776611,42.09988913511872,54,45,-3,1366,903,105,1093,6,7.45
1,0,0,1.0,-0.0,0.8125264644622803,41.10215414239989,54,44,-3,1366,903,105,1093,6,7.38
1,-1,0,1.0,-1.0,0.8205804824829102,40.04648650006177,54,43,-2,1366,903,105,1093,6,4.23
2,0,0,2.0,-0.0,0.8285443782806396,38.048751503547585,54,41,-2,1366,903,105,1093,6,9.77
2,-1,0,2.0,-1.0,0.836653470993042,36.01281840626232,54,39,-1,1366,903,105,1093,6,6.75
2,-1,0,2.0,-1.0,0.8445844650268555,34.0,54,37,0,1366,903,105,1093,6,6.45
2,0,0,2.0,-0.0,0.852548360824585,32.0,54,35,0,1366,903,105,1093,6,11.62
1,-1,0,1.0,-1.0,0.860532283782959,31.0147027033899,54,34,1,1366,903,105,1093,6,3.44
1,0,0,1.0,-0.0,0.8685104846954346,30.015148038438355,54,33,1,1366,903,105,1093,6,7.73
3,0,0,3.0,-0.0,0.8765304088592529,27.01666203960727,54,30,1,1366,903,105,1093,6,10.61
2,0,0,2.0,-0.0,0.8845152854919434,25.0178514522438,54,28,1,1366,903,105,1093,6,8.99
1,0,0,1.0,-0.0,0.8925154209136963,24.018512172212592,54,27,1,1366,903,105,1093,6,7.21
1,0,0,1.0,-0.0,0.9005212783813477,23.019223662515376,54,26,1,1366,903,105,1093,6,7.12
1,0,0,1.0,-0.0,0.9165194034576416,22.019992006393608,54,25,1,1366,903,105,1093,6,7.02
2,0,0,2.0,-0.0,0.9245333671569824,20.021728866442675,54,23,1,1366,903,105,1093,6,8.31
1,0,0,1.0,-0.0,0.9325423240661621,19.02271554554524,54,22,1,1366,903,105,1093,6,6.71
1,0,0,1.0,-0.0,0.940516471862793,18.02379604162864,54,21,1,1366,903,105,1093,6,6.6
1,0,0,1.0,-0.0,0.9485154151916504,17.024984394500787,54,20,1,1366,903,105,1093,6,6.49
1,0,0,1.0,-0.0,0.9565572738647461,16.026297590440446,54,19,1,1366,903,105,1093,6,6.37
1,0,0,1.0,-0.0,0.9646303653717041,15.027756377319946,54,18,1,1366,903,105,1093,6,6.24
1,0,0,1.0,-0.0,0.972515344619751,14.029386365926403,54,17,1,1366,903,105,1093,6,6.11
1,0,0,1.0,-0.0,0.9885263442993164,13.031219541881399,54,16,1,1366,903,105,1093,6,5.97
1,0,0,1.0,-0.0,0.9965324401855469,12.033296378372908,54,15,1,1366,903,105,1093,6,5.82
1,0,0,1.0,-0.0,1.0205342769622803,11.035668847618199,54,14,1,1366,903,105,1093,6,5.66
1,1,0,1.0,1.0,1.0286602973937988,10.0,54,13,0,1366,903,105,1093,6,2.22
1,0,0,1.0,-0.0,1.0365893840789795,9.0,54,12,0,1366,903,105,1093,6,8.49
1,1,0,1.0,1.0,1.044649362564087,8.045361017187261,54,11,-1,1366,903,105,1093,6,1.77
1,0,0,1.0,-0.0,1.0605382919311523,7.04987562112089,54,10,-1,1366,903,105,1093,6,4.9
1,0,0,1.0,-0.0,1.116525411605835,6.055385138137417,54,9,-1,1366,903,105,1093,6,4.66
1,0,0,1.0,-0.0,1.132547378540039,5.062257748298549,54,8,-1,1366,903,105,1093,6,4.39
1,0,0,1.0,-0.0,1.1565303802490234,4.0710678118654755,54,7,-1,1366,903,105,1093,6,4.09
0,0,1,-0.0,-0.0,1.1605174541473389,4.0710678118654755,54,7,-1,1366,903,105,1093,6,28.12
1,0,1,1.0,-0.0,1.1725642681121826,3.0827625302982193,54,6,-1,1366,903,105,1093,6,13.74
0,0,0,-0.0,-0.0,1.2345194816589355,3.0827625302982193,54,6,-1,1366,903,105,1093,6,17.83
1,0,0,1.0,-0.0,1.2845144271850586,2.0990195135927845,54,5,-1,1366,903,105,1093,6,3.32
1,0,0,1.0,-0.0,1.3166372776031494,1.1231056256176606,54,4,-1,1366,903,105,1093,6,2.82
1,0,0,1.0,-0.0,1.3407044410705566,0.16227766016837952,54,3,-1,1366,903,105,1093,6,2.19
0,0,1,-0.0,-0.0,1.368523359298706,0.16227766016837952,54,3,-1,1366,903,105,1093,6,26.98
1,0,1,1.0,-0.0,0.010199546813964844,1124.2696754982842,55,-1109,213,255,1117,1363,904,11,21.11
1,0,1,1.0,-0.0,0.026256561279296875,1125.2517418699251,55,-1110,213,255,1117,1363,904,11,21.12
0,0,0,-0.0,-0.0,0.13219571113586426,1125.2517418699251,55,-1110,213,255,1117,1363,904,11,219.74
-1,0,0,-1.0,-0.0,0.24227356910705566,1124.2696754982842,55,-1109,213,255,1117,1363,904,11,20.52
-2,1,0,-2.0,1.0,0.2502007484436035,1122.1171190253478,55,-1107,212,255,1117,1363,904,11,37.38
-4,1,0,-4.0,1.0,0.258225679397583,1118.000445235887,55,-1103,211,255,1117,1363,904,11,62.35
-7,3,0,-7.0,3.0,0.26621365547180176,1110.5626383130623,55,-1096,208,255,1117,1363,904,11,88.13
-9,3,0,-9.0,3.0,0.2741847038269043,1101.1618326447538,55,-1087,205,255,1117,1363,904,11,100.4
-12,4,0,-12.0,4.0,0.2821846008300781,1088.6297362453163,55,-1075,201,255,1117,1363,904,11,114.72
-14,3,0,-14.0,3.0,0.2901897430419922,1074.3169136078616,55,-1061,198,255,1117,1363,904,11,122.52
-14,4,0,-14.0,4.0,0.2981996536254883,1059.8215812989517,55,-1047,194,255,1117,1363,904,11,120.85
-17,6,0,-17.0,6.0,0.306194543838501,1042.0167142887453,55,-1030,188,255,1117,1363,904,11,129.12
-19,7,0,-19.0,7.0,0.3141756057739258,1022.0744861011785,55,-1011,181,255,1117,1363,904,11,132.86
-24,7,0,-24.0,7.0,0.32218360900878906,997.2200357206995,55,-987,174,255,1117,1363,904,11,141.24
-34,7,0,-34.0,7.0,0.3303506374359131,962.5215759868097,55,-953,167,255,1117,1363,904,11,152.68
-39,8,0,-39.0,8.0,0.33818769454956055,922.7267916795332,55,-914,159,255,1117,1363,904,11,153.53
-40,6,0,-40.0,6.0,0.34618663787841797,882.2908204191002,55,-874,153,255,1117,1363,904,11,150.28
-42,6,0,-42.0,6.0,0.35418272018432617,839.8863828941735,55,-832,147,255,1117,1363,904,11,147.1
-42,5,0,-42.0,5.0,0.36217761039733887,797.6605758351409,55,-790,142,255,1117,1363,904,11,141.88
-45,5,0,-45.0,5.0,0.3702526092529297,752.4919141482634,55,-745,137,255,1117,1363,904,11,138.55
-43,3,0,-43.0,3.0,0.37851452827453613,709.6747511980537,55,-702,134,255,1117,1363,904,11,131.66
-41,4,0,-41.0,4.0,0.3863027095794678,668.6623783468987,55,-661,130,255,1117,1363,904,11,126.07
-41,4,0,-41.0,4.0,0.3941776752471924,627.6736915661975,55,-620,126,255,1117,1363,904,11,121.09
-40,6,0,-40.0,6.0,0.40224456787109375,587.2837157984338,55,-580,120,255,1117,1363,904,11,116.54
-34,6,0,-34.0,6.0,0.41023969650268555,552.7741478412207,55,-546,114,255,1117,1363,904,11,109.05
-32,7,0,-32.0,7.0,0.41817665100097656,520.0190472735251,55,-514,107,255,1117,1363,904,11,104.62
-30,7,0,-30.0,7.0,0.42618560791015625,489.2226219023164,55,-484,100,255,1117,1363,904,11,98.4
-25,6,0,-25.0,6.0,0.43417859077453613,463.52641334294054,55,-459,94,255,1117,1363,904,11,90.34
-22,6,0,-22.0,6.0,0.44217467308044434,440.7723634322792,55,-437,88,255,1117,1363,904,11,83.59
-20,6,0,-20.0,6.0,0.45027852058410645,419.98588211845345,55,-417,82,255,1117,1363,904,11,78.25
-19,5,0,-19.0,5.0,0.4582366943359375,400.3800685776251,55,-398,77,255,1117,1363,904,11,74.83
-18,6,0,-18.0,6.0,0.4661695957183838,381.5759951160962,55,-380,71,255,1117,1363,904,11,70.54
-20,7,0,-20.0,7.0,0.47443652153015137,360.64463622484607,55,-360,64,255,1117,1363,904,11,70.17
-18,6,0,-18.0,6.0,0.48220157623291016,341.88326566728466,55,-342,58,255,1117,1363,904,11,65.27
-16,6,0,-16.0,6.0,0.4901895523071289,325.1211898682058,55,-326,52,255,1117,1363,904,11,60.21
-17,6,0,-17.0,6.0,0.49823474884033203,307.40518561637225,55,-309,46,255,1117,1363,904,11,59.17
-13,4,0,-13.0,4.0,0.5061855316162109,293.9648808806814,55,-296,42,255,1117,1363,904,11,51.78
-13,4,0,-13.0,4.0,0.5144505500793457,280.53983960211224,55,-283,38,255,1117,1363,904,11,50.05
-12,3,0,-12.0,3.0,0.5222265720367432,268.25080054777516,55,-271,35,255,1117,1363,904,11,47.19
-11,2,0,-11.0,2.0,0.5302367210388184,257.08586379276545,55,-260,33,255,1117,1363,904,11,44.9
-9,2,0,-9.0,2.0,0.538172721862793,247.90709756746645,55,-251,31,255,1117,1363,904,11,39.34
-9,2,0,-9.0,2.0,0.5462055206298828,238.73140954747709,55,-242,29,255,1117,1363,904,11,38.3
-8,1,0,-8.0,1.0,0.5545897483825684,230.6692597688549,55,-234,28,255,1117,1363,904,11,37.68
-7,1,0,-7.0,1.0,0.562187671661377,223.60008748904713,55,-227,27,255,1117,1363,904,11,33.7
-8,2,0,-8.0,2.0,0.5702126026153564,215.42232191862965,55,-219,25,255,1117,1363,904,11,33.4
-10,2,0,-10.0,2.0,0.5782036781311035,205.261741645978,55,-209,23,255,1117,1363,904,11,36.45
-9,2,0,-9.0,2.0,0.586181640625,196.0994778710278,55,-200,21,255,1117,1363,904,11,33.34
-8,1,0,-8.0,1.0,0.5942025184631348,188.03885619221847,55,-192,20,255,1117,1363,904,11,32.36
-7,1,0,-7.0,1.0,0.602205753326416,180.9731163367437,55,-185,19,255,1117,1363,904,11,29.0
-7,1,0,-7.0,1.0,0.6102006435394287,173.90779748239035,55,-178,18,255,1117,1363,904,11,28.23
-6,1,0,-6.0,1.0,0.6181986331939697,167.8380745090618,55,-172,17,255,1117,1363,904,11,25.0
-6,1,0,-6.0,1.0,0.6264095306396484,161.76930173146374,55,-166,16,255,1117,1363,904,11,24.38
-5,0,0,-5.0,-0.0,0.634211540222168,156.7930777258409,55,-161,16,255,1117,1363,904,11,21.05
-5,1,0,-5.0,1.0,0.64219069480896,151.71949463930773,55,-156,15,255,1117,1363,904,11,20.81
-6,1,0,-6.0,1.0,0.650174617767334,145.65191668213185,55,-150,14,255,1117,1363,904,11,22.77
-7,2,0,-7.0,2.0,0.6583585739135742,138.50261321662404,55,-143,12,255,1117,1363,904,11,22.68
-6,2,0,-6.0,2.0,0.6661806106567383,132.3644786689776,55,-137,10,255,1117,1363,904,11,19.95
-7,2,0,-7.0,2.0,0.6741995811462402,125.24592124131948,55,-130,8,255,1117,1363,904,11,21.01
-8,2,0,-8.0,2.0,0.6823015213012695,117.14745187681976,55,-122,6,255,1117,1363,904,11,21.58
-8,2,0,-8.0,2.0,0.6901817321777344,109.0701538527936,55,-114,4,255,1117,1363,904,11,20.46
-8,1,0,-8.0,1.0,0.6982486248016357,101.04244433244644,55,-106,3,255,1117,1363,904,11,20.45
-8,2,0,-8.0,2.0,0.706230640411377,93.00510190801293,55,-98,1,255,1117,1363,904,11,18.23
-6,2,0,-6.0,2.0,0.7141826152801514,87.00543462209176,55,-92,-1,255,1117,1363,904,11,14.58
-6,1,0,-6.0,1.0,0.7221846580505371,81.02325267042627,55,-86,-2,255,1117,1363,904,11,14.7
-5,1,0,-5.0,1.0,0.7301757335662842,76.05553651663777,55,-81,-3,255,1117,1363,904,11,12.57
-3,1,0,-3.0,1.0,0.738196611404419,73.10249675906654,55,-78,-4,255,1117,1363,904,11,8.61
-4,0,0,-4.0,-0.0,0.7462375164031982,69.10802925459562,55,-74,-4,255,1117,1363,904,11,12.49
-4,0,0,-4.0,-0.0,0.7541797161102295,65.11419257183242,55,-70,-4,255,1117,1363,904,11,12.09
-3,1,0,-3.0,1.0,0.7622005939483643,62.186308128963304,55,-67,-5,255,1117,1363,904,11,7.74
-4,1,0,-4.0,1.0,0.7702505588531494,58.28506932918696,55,-63,-6,255,1117,1363,904,11,9.0
-3,0,0,-3.0,-0.0,0.7782347202301025,55.29925372672534,55,-60,-6,255,1117,1363,904,11,9.22
-2,0,0,-2.0,-0.0,0.7861895561218262,53.309518948453004,55,-58,-6,255,1117,1363,904,11,7.58
-4,0,0,-4.0,-0.0,0.7941696643829346,49.3323108288245,55,-54,-6,255,1117,1363,904,11,9.85
-1,0,0,-1.0,-0.0,0.8021986484527588,48.33854141237835,55,-53,-6,255,1117,1363,904,11,5.62
-2,0,0,-2.0,-0.0,0.8102207183837891,46.35172830587107,55,-51,-6,255,1117,1363,904,11,7.05
-1,-1,0,-1.0,-1.0,0.8183965682983398,45.24937810560445,55,-50,-5,255,1117,1363,904,11,3.2
-1,0,0,-1.0,-0.0,0.8263137340545654,44.25444142409901,55,-49,-5,255,1117,1363,904,11,5.63
-2,0,0,-2.0,-0.0,0.8341727256774902,42.265209192385896,55,-47,-5,255,1117,1363,904,11,6.96
-1,0,0,-1.0,-0.0,0.8430967330932617,41.2709412050371,55,-46,-5,255,1117,1363,904,11,5.46
-1,0,0,-1.0,-0.0,0.8501765727996826,40.27692569068709,55,-45,-5,255,1117,1363,904,11,5.41
-1,0,0,-1.0,-0.0,0.8581786155700684,39.28317965096906,55,-44,-5,255,1117,1363,904,11,5.35
-1,0,0,-1.0,-0.0,0.8661725521087646,38.289721643826724,55,-43,-5,255,1117,1363,904,11,5.29
-2,0,0,-2.0,-0.0,0.8741796016693115,36.30375285612676,55,-41,-5,255,1117,1363,904,11,6.45
-1,0,0,-1.0,-0.0,0.8821816444396973,35.311288741492746,55,-40,-5,255,1117,1363,904,11,5.1
-3,0,0,-3.0,-0.0,0.8902316093444824,32.33630940518894,55,-37,-5,255,1117,1363,904,11,7.12
-3,0,0,-3.0,-0.0,0.8981757164001465,29.365680554879162,55,-34,-5,255,1117,1363,904,11,6.76
-2,0,0,-2.0,-0.0,0.9062097072601318,27.38826948140329,55,-32,-5,255,1117,1363,904,11,5.6
-3,0,0,-3.0,-0.0,0.9141945838928223,24.427877939124322,55,-29,-5,255,1117,1363,904,11,6.14
-3,0,0,-3.0,-0.0,0.9222226142883301,21.476404589747453,55,-26,-5,255,1117,1363,904,11,5.73
-3,0,0,-3.0,-0.0,0.9301886558532715,18.53720459187964,55,-23,-5,255,1117,1363,904,11,5.3
-4,0,0,-4.0,-0.0,0.9382805824279785,14.6468827043885,55,-19,-5,255,1117,1363,904,11,5.22
-4,-1,0,-4.0,-1.0,0.9461746215820312,10.524174696260024,55,-15,-4,255,1117,1363,904,11,8.45
-2,0,0,-2.0,-0.0,0.9543745517730713,8.601470508735444,55,-13,-4,255,1117,1363,904,11,3.32
-1,0,0,-1.0,-0.0,0.9621737003326416,7.649110640673518,55,-12,-4,255,1117,1363,904,11,2.67
-1,0,0,-1.0,-0.0,0.9701917171478271,6.704699910719626,55,-11,-4,255,1117,1363,904,11,2.49
-2,0,0,-2.0,-0.0,0.9781806468963623,4.848857801796104,55,-9,-4,255,1117,1363,904,11,2.41
0,-1,0,-0.0,-1.0,0.986182689666748,4.486832980505138,55,-9,-3,255,1117,1363,904,11,0.08
-2,0,0,-2.0,-0.0,0.9942116737365723,2.6157731058639087,55,-7,-3,255,1117,1363,904,11,2.18
-1,-1,0,-1.0,-1.0,1.0021755695343018,1.324555320336759,55,-6,-2,255,1117,1363,904,11,1.63
-1,0,0,-1.0,-0.0,1.01017165184021,0.38516480713450374,55,-5,-2,255,1117,1363,904,11,1.73
-1,0,0,-1.0,-0.0,1.018169641494751,-0.5278640450004204,55,-4,-2,255,1117,1363,904,11,1.28
-1,0,0,-1.0,-0.0,1.0262045860290527,-1.3944487245360109,55,-3,-2,255,1117,1363,904,11,0.74
-1,0,0,-1.0,-0.0,1.0344336032867432,-2.1715728752538097,55,-2,-2,255,1117,1363,904,11,0.07
-1,-1,0,-1.0,-1.0,1.0581927299499512,-3.585786437626905,55,-1,-1,255,1117,1363,904,11,7.7
0,0,1,-0.0,-0.0,1.104210615158081,-3.585786437626905,55,-1,-1,255,1117,1363,904,11,25.9
0,0,0,-0.0,-0.0,0.10804367065429688,264.3519637254306,56,-113,-250,143,868,256,1118,20,88.97
1,-1,0,1.0,-1.0,0.1440746784210205,263.85580147223465,56,-114,-249,143,868,256,1118,20,2.44
3,-2,0,3.0,-2.0,0.15201163291931152,263.3093485411723,56,-117,-247,143,868,256,1118,20,2.35
4,-3,0,4.0,-3.0,0.1600356101989746,262.35454833727306,56,-121,-244,143,868,256,1118,20,3.89
6,-4,0,6.0,-4.0,0.1681206226348877,261.53084539329967,56,-127,-240,143,868,256,1118,20,3.25
5,-6,0,5.0,-6.0,0.1763005256652832,258.66335812685736,56,-132,-234,143,868,256,1118,20,10.41
7,-5,0,7.0,-5.0,0.18401861190795898,257.88430338487547,56,-139,-229,143,868,256,1118,20,2.99
9,-7,0,9.0,-7.0,0.1920006275177002,256.8107943843352,56,-148,-222,143,868,256,1118,20,3.99
11,-12,0,11.0,-12.0,0.20000457763671875,253.40273347101015,56,-159,-210,143,868,256,1118,20,11.46
12,-13,0,12.0,-13.0,0.20801758766174316,250.86394921491166,56,-171,-197,143,868,256,1118,20,8.67
11,-13,0,11.0,-13.0,0.2160205841064453,248.80494585691366,56,-182,-184,143,868,256,1118,20,7.1
12,-18,0,12.0,-18.0,0.2241346836090088,245.32724100651697,56,-194,-166,143,868,256,1118,20,11.2
9,-22,0,9.0,-22.0,0.2320384979248047,238.8875247978492,56,-203,-144,143,868,256,1118,20,18.3
5,-23,0,5.0,-23.0,0.24001169204711914,230.63457773146402,56,-208,-121,143,868,256,1118,20,21.51
2,-16,0,2.0,-16.0,0.24802255630493164,224.7871376374779,56,-210,-105,143,868,256,1118,20,16.48
0,-8,0,-0.0,-8.0,0.2560296058654785,221.32012450281968,56,-210,-97,143,868,256,1118,20,10.96
0,-4,0,-0.0,-4.0,0.26401758193969727,219.67150454507848,56,-210,-93,143,868,256,1118,20,5.88
-1,-3,0,-1.0,-3.0,0.27200865745544434,217.55438910291315,56,-209,-90,143,868,256,1118,20,7.71
-2,-2,0,-2.0,-2.0,0.28002071380615234,214.92887764802455,56,-207,-88,143,868,256,1118,20,10.19
-2,-3,0,-2.0,-3.0,0.2881505489349365,211.92341021172146,56,-205,-85,143,868,256,1118,20,10.49
-5,-3,0,-5.0,-3.0,0.29618263244628906,206.15735009478627,56,-200,-82,143,868,256,1118,20,18.44
-3,-3,0,-3.0,-3.0,0.3040037155151367,202.24985276791125,56,-197,-79,143,868,256,1118,20,12.88
-5,-3,0,-5.0,-3.0,0.312206506729126,196.49455198624491,56,-192,-76,143,868,256,1118,20,17.77
-5,-1,0,-5.0,-1.0,0.3200366497039795,191.47952749597167,56,-187,-75,143,868,256,1118,20,15.87
-5,-2,0,-5.0,-2.0,0.3280296325683594,186.0943650388761,56,-182,-73,143,868,256,1118,20,20.04
-4,0,0,-4.0,-0.0,0.33601951599121094,182.38762953994728,56,-178,-73,143,868,256,1118,20,11.67
-6,-1,0,-6.0,-1.0,0.3440816402435303,176.46179233290664,56,-172,-72,143,868,256,1118,20,16.45
-8,-1,0,-8.0,-1.0,0.35204553604125977,168.70926109186397,56,-164,-71,143,868,256,1118,20,18.6
-8,0,0,-8.0,-0.0,0.3600037097930908,161.39719951037708,56,-156,-71,143,868,256,1118,20,16.83
-10,-1,0,-10.0,-1.0,0.3680415153503418,151.91355718407277,56,-146,-70,143,868,256,1118,20,19.27
-11,-1,0,-11.0,-1.0,0.3761715888977051,141.61134522191932,56,-135,-69,143,868,256,1118,20,19.13
-12,0,0,-12.0,-0.0,0.38401365280151367,131.0319112825179,56,-123,-69,143,868,256,1118,20,17.96
-13,-2,0,-13.0,-2.0,0.39205169677734375,118.79829191413992,56,-110,-67,143,868,256,1118,20,18.57
-14,-3,0,-14.0,-3.0,0.4000225067138672,105.37764081484765,56,-96,-64,143,868,256,1118,20,17.99
-13,-2,0,-13.0,-2.0,0.40799856185913086,93.60019305001319,56,-83,-62,143,868,256,1118,20,15.07
-12,-2,0,-12.0,-2.0,0.4160184860229492,82.9569792968769,56,-71,-60,143,868,256,1118,20,12.94
-9,-2,0,-9.0,-2.0,0.42406153678894043,74.8999411071645,56,-62,-58,143,868,256,1118,20,10.25
-6,-2,0,-6.0,-2.0,0.43205761909484863,69.19595949289332,56,-56,-56,143,868,256,1118,20,8.09
-5,-1,0,-5.0,-1.0,0.4401376247406006,65.0066663703967,56,-51,-55,143,868,256,1118,20,6.02
-3,-2,0,-3.0,-2.0,0.44812870025634766,61.50524456289902,56,-48,-53,143,868,256,1118,20,6.55
-4,-2,0,-4.0,-2.0,0.4560086727142334,57.357256476195644,56,-44,-51,143,868,256,1118,20,6.22
-4,-2,0,-4.0,-2.0,0.4640085697174072,53.25345840347388,56,-40,-49,143,868,256,1118,20,5.85
-5,-2,0,-5.0,-2.0,0.4720594882965088,48.60034129593445,56,-35,-47,143,868,256,1118,20,5.57
-5,-2,0,-5.0,-2.0,0.4800145626068115,44.08326913195984,56,-30,-45,143,868,256,1118,20,5.03
-3,-3,0,-3.0,-3.0,0.48801350593566895,39.92995093127971,56,-27,-42,143,868,256,1118,20,6.04
-3,-1,0,-3.0,-1.0,0.4960336685180664,37.50789408087881,56,-24,-41,143,868,256,1118,20,2.98
-3,-2,0,-3.0,-2.0,0.5040555000305176,34.294469180700204,56,-21,-39,143,868,256,1118,20,3.93
-1,-1,0,-1.0,-1.0,0.5120885372161865,32.941821107167776,56,-20,-38,143,868,256,1118,20,3.39
-2,-2,0,-2.0,-2.0,0.5200545787811279,30.249223594996216,56,-18,-36,143,868,256,1118,20,4.03
-2,-2,0,-2.0,-2.0,0.5280165672302246,27.57658845611187,56,-16,-34,143,868,256,1118,20,3.78
-2,-1,0,-2.0,-1.0,0.5361745357513428,25.84689665786984,56,-14,-33,143,868,256,1118,20,2.14
0,-1,0,-0.0,-1.0,0.5520164966583252,24.928498393145958,56,-14,-32,143,868,256,1118,20,2.5
0,-2,0,-0.0,-2.0,0.5600295066833496,23.105890714493697,56,-14,-30,143,868,256,1118,20,2.81
-1,-2,0,-1.0,-2.0,0.5680205821990967,20.870698080866262,56,-13,-28,143,868,256,1118,20,6.43
0,-2,0,-0.0,-2.0,0.5762555599212646,19.068883707497267,56,-13,-26,143,868,256,1118,20,2.55
-1,-2,0,-1.0,-2.0,0.5840635299682617,16.832815729997478,56,-12,-24,143,868,256,1118,20,8.18
0,-4,0,-0.0,-4.0,0.5920145511627197,13.323807579381203,56,-12,-20,143,868,256,1118,20,2.61
-1,-3,0,-1.0,-3.0,0.6000165939331055,10.248456731316587,56,-11,-17,143,868,256,1118,20,3.38
-1,-2,0,-1.0,-2.0,0.6080176830291748,8.027756377319946,56,-10,-15,143,868,256,1118,20,3.98
0,-3,0,-0.0,-3.0,0.616053581237793,5.620499351813308,56,-10,-12,143,868,256,1118,20,1.34
-1,-2,0,-1.0,-2.0,0.6240205764770508,3.45362404707371,56,-9,-10,143,868,256,1118,20,2.58
-1,-2,0,-1.0,-2.0,0.6320245265960693,1.3137084989847612,56,-8,-8,143,868,256,1118,20,2.13
-2,-2,0,-2.0,-2.0,0.6400907039642334,-1.5147186257614305,56,-6,-6,143,868,256,1118,20,7.86
-1,-3,0,-1.0,-3.0,0.6480317115783691,-4.169048105154699,56,-5,-3,143,868,256,1118,20,0.32
-1,-1,0,-1.0,-1.0,0.6560397148132324,-5.52786404500042,56,-4,-2,143,868,256,1118,20,1.31
-1,-1,0,-1.0,-1.0,0.6640515327453613,-6.83772233983162,56,-3,-1,143,868,256,1118,20,0.5
-1,-1,0,-1.0,-1.0,0.6720366477966309,-8.0,56,-2,0,143,868,256,1118,20,-0.64
0,-1,0,-0.0,-1.0,0.6801426410675049,-7.76393202250021,56,-2,1,143,868,256,1118,20,-0.42
0,0,1,-0.0,-0.0,0.7340335845947266,-7.76393202250021,56,-2,1,143,868,256,1118,20,24.73
0,0,0,-0.0,-0.0,0.09145522117614746,779.0676150299056,57,796,127,941,994,145,867,54,177.84
1,0,0,1.0,-0.0,0.1194460391998291,778.0801202364893,57,795,127,941,994,145,867,54,6.37
2,0,0,2.0,-0.0,0.12744712829589844,776.1052234919158,57,793,127,941,994,145,867,54,9.31
3,0,0,3.0,-0.0,0.13552021980285645,773.1431121993115,57,790,127,941,994,145,867,54,12.12
3,0,0,3.0,-0.0,0.14356517791748047,770.1812842760422,57,787,127,941,994,145,867,54,12.09
3,0,0,3.0,-0.0,0.15144610404968262,767.219742892356,57,784,127,941,994,145,867,54,12.07
5,-1,0,5.0,-1.0,0.1594400405883789,762.4460082868238,57,779,128,941,994,145,867,54,15.85
7,-1,0,7.0,-1.0,0.16746807098388672,755.7036476214992,57,772,129,941,994,145,867,54,20.97
11,-2,0,11.0,-2.0,0.17548322677612305,745.1929810610817,57,761,131,941,994,145,867,54,29.22
14,-3,0,14.0,-3.0,0.18345904350280762,731.9235798155174,57,747,134,941,994,145,867,54,34.38
17,-2,0,17.0,-2.0,0.19145822525024414,715.5604352508959,57,730,136,941,994,145,867,54,39.96
23,-3,0,23.0,-3.0,0.19945812225341797,693.5345238085404,57,707,139,941,994,145,867,54,48.14
27,-1,0,27.0,-1.0,0.20746517181396484,667.2621983083912,57,680,140,941,994,145,867,54,53.22
28,-1,0,28.0,-1.0,0.2156660556793213,640.0719601362359,57,652,141,941,994,145,867,54,52.96
28,0,0,28.0,-0.0,0.22345900535583496,612.731975127084,57,624,141,941,994,145,867,54,51.88
28,2,0,28.0,2.0,0.23148202896118164,584.9942810190304,57,596,139,941,994,145,867,54,51.32
29,4,0,29.0,4.0,0.23945021629333496,555.8498949129183,57,567,135,941,994,145,867,54,51.88
28,4,0,28.0,4.0,0.2475121021270752,527.690904919127,57,539,131,941,994,145,867,54,49.2
28,6,0,28.0,6.0,0.25545716285705566,499.06653571577806,57,511,125,941,994,145,867,54,49.4
25,7,0,25.0,7.0,0.2634601593017578,473.11998560345495,57,486,118,941,994,145,867,54,44.93
24,9,0,24.0,9.0,0.2714521884918213,447.68410548490033,57,462,109,941,994,145,867,54,41.35
23,8,0,23.0,8.0,0.2795681953430176,423.46864485777473,57,439,101,941,994,145,867,54,38.91
21,10,0,21.0,10.0,0.28757309913635254,400.79083674150854,57,418,91,941,994,145,867,54,35.04
21,9,0,21.0,9.0,0.2954580783843994,378.3800685776251,57,397,82,941,994,145,867,54,33.66
19,9,0,19.0,9.0,0.30345821380615234,357.98441526898205,57,378,73,941,994,145,867,54,30.23
19,8,0,19.0,8.0,0.3117341995239258,337.83694988309503,57,359,65,941,994,145,867,54,29.04
20,8,0,20.0,8.0,0.31943821907043457,316.7586362551492,57,339,57,941,994,145,867,54,28.68
17,6,0,17.0,6.0,0.3274550437927246,299.01380338875225,57,322,51,941,994,145,867,54,24.87
16,6,0,16.0,6.0,0.33545804023742676,282.2911249939125,57,306,45,941,994,145,867,54,22.82
15,5,0,15.0,5.0,0.3435330390930176,266.73627627516487,57,291,40,941,994,145,867,54,21.13
15,4,0,15.0,4.0,0.3514981269836426,251.33792411383683,57,276,36,941,994,145,867,54,20.66
16,4,0,16.0,4.0,0.35944318771362305,234.96182928052707,57,260,32,941,994,145,867,54,20.66
15,3,0,15.0,3.0,0.36745500564575195,219.71035649116962,57,245,29,941,994,145,867,54,19.49
15,5,0,15.0,5.0,0.37560606002807617,204.24878378058554,57,230,24,941,994,145,867,54,17.44
15,4,0,15.0,4.0,0.3837771415710449,188.92822881689185,57,215,20,941,994,145,867,54,16.82
16,4,0,16.0,4.0,0.3914530277252197,172.64217991196148,57,199,16,941,994,145,867,54,16.5
16,5,0,16.0,5.0,0.3994581699371338,156.3303030052588,57,183,11,941,994,145,867,54,14.94
14,4,0,14.0,4.0,0.4074530601501465,142.14490828872147,57,169,7,941,994,145,867,54,12.88
14,4,0,14.0,4.0,0.4155890941619873,128.0290295396317,57,155,3,941,994,145,867,54,11.87
11,2,0,11.0,2.0,0.4235341548919678,117.00347218036097,57,144,1,941,994,145,867,54,10.18
10,3,0,10.0,3.0,0.43146705627441406,107.01492454200763,57,134,-2,941,994,145,867,54,8.35
9,2,0,9.0,2.0,0.4394500255584717,98.06398362438324,57,125,-4,941,994,145,867,54,7.7
10,1,0,10.0,1.0,0.4474680423736572,88.10864433221339,57,115,-5,941,994,145,867,54,8.46
8,1,0,8.0,1.0,0.4554622173309326,80.16809226630845,57,107,-6,941,994,145,867,54,6.91
7,0,0,7.0,-0.0,0.4634439945220947,73.17983829094555,57,100,-6,941,994,145,867,54,7.67
7,0,0,7.0,-0.0,0.4714322090148926,66.1933474020544,57,93,-6,941,994,145,867,54,7.31
5,0,0,5.0,-0.0,0.4794590473175049,61.20430828479978,57,88,-6,941,994,145,867,54,6.32
3,0,0,3.0,-0.0,0.4874451160430908,58.211501571090736,57,85,-6,941,994,145,867,54,5.46
2,0,0,2.0,-0.0,0.4954671859741211,56.21658488546619,57,83,-6,941,994,145,867,54,5.03
2,0,0,2.0,-0.0,0.5034530162811279,54.2219182240853,57,81,-6,941,994,145,867,54,4.97
1,0,0,1.0,-0.0,0.511437177658081,53.22468448052632,57,80,-6,941,994,145,867,54,4.6
1,0,0,1.0,-0.0,0.519456148147583,52.22752047110903,57,79,-6,941,994,145,867,54,4.57
1,0,0,1.0,-0.0,0.5274760723114014,51.23042886243178,57,78,-6,941,994,145,867,54,4.55
2,-1,0,2.0,-1.0,0.5354580879211426,49.164296097318456,57,76,-5,941,994,145,867,54,2.69
2,-1,0,2.0,-1.0,0.5434541702270508,47.10802925459562,57,74,-4,941,994,145,867,54,2.61
5,-2,0,5.0,-2.0,0.5514371395111084,42.02897942168927,57,69,-2,941,994,145,867,54,3.53
7,-1,0,7.0,-1.0,0.5594520568847656,35.00806399170998,57,62,-1,941,994,145,867,54,5.15
10,-3,0,10.0,-3.0,0.5674731731414795,25.038447325030752,57,52,2,941,994,145,867,54,3.83
10,-3,0,10.0,-3.0,0.575444221496582,15.296571965113202,57,42,5,941,994,145,867,54,2.87
11,-2,0,11.0,-2.0,0.5834541320800781,4.7804971641414085,57,31,7,941,994,145,867,54,2.27
9,-2,0,9.0,-2.0,0.5914440155029297,-3.2302713519905737,57,22,9,941,994,145,867,54,0.93
9,-1,0,9.0,-1.0,0.5994701385498047,-10.598780533143273,57,13,10,941,994,145,867,54,0.01
7,-1,0,7.0,-1.0,0.6074810028076172,-14.470035913858332,57,6,11,941,994,145,867,54,-1.09
6,0,0,6.0,-0.0,0.6154501438140869,-16.0,57,0,11,941,994,145,867,54,-1.64
5,0,0,5.0,-0.0,0.6234521865844727,-14.916954026405428,57,-5,11,941,994,145,867,54,-1.64
5,-1,0,5.0,-1.0,0.6314361095428467,-11.379500648186692,57,-10,12,941,994,145,867,54,-1.03
6,0,0,6.0,-0.0,0.6394450664520264,-7.0,57,-16,12,941,994,145,867,54,-0.85
5,0,0,5.0,-0.0,0.6475110054016113,-2.8132267551043526,57,-21,12,941,994,145,867,54,-0.08
3,0,0,3.0,-0.0,0.6554641723632812,-0.16718427000252234,57,-24,12,941,994,145,867,54,0.75
3,0,0,3.0,-0.0,0.6634511947631836,2.5465734053883153,57,-27,12,941,994,145,867,54,0.97
0,0,1,-0.0,-0.0,0.7104880809783936,2.5465734053883153,57,-27,12,941,994,145,867,54,27.67
0,0,0,-0.0,-0.0,0.07840418815612793,325.39647127324776,58,-314,-115,654,867,968,982,19,102.26
1,0,0,1.0,-0.0,0.10339021682739258,326.3356527421443,58,-315,-115,654,867,968,982,19,7.29
1,0,0,1.0,-0.0,0.11139130592346191,327.2751849304376,58,-316,-115,654,867,968,982,19,7.3
1,-1,0,1.0,-1.0,0.1193993091583252,327.8753478662397,58,-317,-114,654,867,968,982,19,8.3
3,0,0,3.0,-0.0,0.12738537788391113,330.69986753014786,58,-320,-114,654,867,968,982,19,3.92
4,-1,0,4.0,-1.0,0.13540029525756836,334.13991315496946,58,-324,-113,654,867,968,982,19,2.85
4,-2,0,4.0,-2.0,0.14339232444763184,337.27301367562563,58,-328,-111,654,867,968,982,19,2.56
4,-2,0,4.0,-2.0,0.15149235725402832,340.4352586674676,58,-332,-109,654,867,968,982,19,2.57
4,-3,0,4.0,-3.0,0.15939831733703613,343.32371478513903,58,-336,-106,654,867,968,982,19,2.45
2,-3,0,2.0,-3.0,0.1674044132232666,344.34544004415847,58,-338,-103,654,867,968,982,19,5.19
1,-3,0,1.0,-3.0,0.1753983497619629,344.4416500640523,58,-339,-100,654,867,968,982,19,35.28
-1,-3,0,-1.0,-3.0,0.18339824676513672,342.64328516267733,58,-338,-97,654,867,968,982,19,9.3
-3,-4,0,-3.0,-4.0,0.19140028953552246,338.66938317890464,58,-335,-93,654,867,968,982,19,18.23
-6,-4,0,-6.0,-4.0,0.1994173526763916,331.82546853191593,58,-329,-89,654,867,968,982,19,27.8
-7,-3,0,-7.0,-3.0,0.207383394241333,324.2866633995426,58,-322,-86,654,867,968,982,19,30.29
-8,-6,0,-8.0,-6.0,0.2154223918914795,315.0308627276112,58,-314,-80,654,867,968,982,19,32.37
-10,-7,0,-10.0,-7.0,0.2234811782836914,303.64196775225173,58,-304,-73,654,867,968,982,19,35.86
-14,-9,0,-14.0,-9.0,0.23139333724975586,287.97811367169805,58,-290,-64,654,867,968,982,19,41.28
-17,-12,0,-17.0,-12.0,0.23943829536437988,268.90825824361536,58,-273,-52,654,867,968,982,19,43.06
-18,-11,0,-18.0,-11.0,0.24740123748779297,249.2750471880704,58,-255,-41,654,867,968,982,19,41.47
-18,-12,0,-18.0,-12.0,0.2554023265838623,229.76766950322232,58,-237,-29,654,867,968,982,19,38.73
-17,-8,0,-17.0,-8.0,0.26340532302856445,212.0,58,-220,-21,654,867,968,982,19,35.37
-18,-7,0,-18.0,-7.0,0.2714102268218994,193.48456731316588,58,-202,-14,654,867,968,982,19,33.96
-17,-4,0,-17.0,-4.0,0.2795534133911133,176.27007313648906,58,-185,-10,654,867,968,982,19,31.43
-17,-3,0,-17.0,-3.0,0.28738927841186523,159.14577009250038,58,-168,-7,654,867,968,982,19,29.57
-15,-3,0,-15.0,-3.0,0.2953932285308838,144.05227865013967,58,-153,-4,654,867,968,982,19,25.69
-14,-3,0,-14.0,-3.0,0.30339622497558594,130.00359707575916,58,-139,-1,654,867,968,982,19,22.88
-10,-2,0,-10.0,-2.0,0.31139540672302246,120.00387591076478,58,-129,1,654,867,968,982,19,18.14
-8,-2,0,-8.0,-2.0,0.31942033767700195,112.03718436910205,58,-121,3,654,867,968,982,19,14.9
-6,-1,0,-6.0,-1.0,0.32738232612609863,106.06954418958998,58,-115,4,654,867,968,982,19,12.55
-5,-1,0,-5.0,-1.0,0.335402250289917,101.11357772772621,58,-110,5,654,867,968,982,19,10.69
-5,-1,0,-5.0,-1.0,0.34339022636413574,96.17128885774862,58,-105,6,654,867,968,982,19,10.3
-5,-1,0,-5.0,-1.0,0.3515021800994873,91.24470060806208,58,-100,7,654,867,968,982,19,9.9
-4,-1,0,-4.0,-1.0,0.3594632148742676,87.33275663033837,58,-96,8,654,867,968,982,19,8.16
-3,-1,0,-3.0,-1.0,0.36739635467529297,84.43446901438462,58,-93,9,654,867,968,982,19,6.38
-4,0,0,-4.0,-0.0,0.37539029121398926,80.45389874119518,58,-89,9,654,867,968,982,19,9.46
-5,-1,0,-5.0,-1.0,0.3834052085876465,75.5931439302264,58,-84,10,654,867,968,982,19,8.58
-6,0,0,-6.0,-0.0,0.39141225814819336,69.63841300535,58,-78,10,654,867,968,982,19,10.43
-5,-1,0,-5.0,-1.0,0.3993992805480957,64.824115301167,58,-73,11,654,867,968,982,19,7.68
-6,0,0,-6.0,-0.0,0.40740323066711426,58.896980787071826,58,-67,11,654,867,968,982,19,9.24
-5,-2,0,-5.0,-2.0,0.4154372215270996,54.34824385884742,58,-62,13,654,867,968,982,19,5.97
-6,-1,0,-6.0,-1.0,0.42343926429748535,48.723478758647246,58,-56,14,654,867,968,982,19,6.9
-6,-1,0,-6.0,-1.0,0.4314103126525879,43.20153254455275,58,-50,15,654,867,968,982,19,6.23
-7,0,0,-7.0,-0.0,0.4394361972808838,36.5411901469428,58,-43,15,654,867,968,982,19,6.75
-8,0,0,-8.0,-0.0,0.4474012851715088,29.078865529319543,58,-35,15,654,867,968,982,19,6.1
-6,-1,0,-6.0,-1.0,0.45539236068725586,24.12099032335839,58,-29,16,654,867,968,982,19,3.77
-6,0,0,-6.0,-0.0,0.4637782573699951,19.0178514522438,58,-23,16,654,867,968,982,19,3.54
-5,0,0,-5.0,-0.0,0.4713923931121826,15.083189157584592,58,-18,16,654,867,968,982,19,2.48
-6,1,0,-6.0,1.0,0.47939133644104004,10.209372712298546,58,-12,15,654,867,968,982,19,2.33
-2,0,0,-2.0,-0.0,0.4875833988189697,9.027756377319946,58,-10,15,654,867,968,982,19,0.73
-1,0,0,-1.0,-0.0,0.49541330337524414,8.4928556845359,58,-9,15,654,867,968,982,19,0.59
-1,1,0,-1.0,1.0,0.5354273319244385,7.124515496597098,58,-8,14,654,867,968,982,19,2.71
-1,1,0,-1.0,1.0,0.5434083938598633,5.7648230602334,58,-7,13,654,867,968,982,19,2.5
0,1,0,-0.0,1.0,0.5515062808990479,4.892443989449804,58,-7,12,654,867,968,982,19,1.55
-2,2,0,-2.0,2.0,0.5594391822814941,2.180339887498949,58,-5,10,654,867,968,982,19,2.29
-1,2,0,-1.0,2.0,0.5674324035644531,-0.05572809000084078,58,-4,8,654,867,968,982,19,7.73
0,1,0,-0.0,1.0,0.5754573345184326,-0.9377422517014509,58,-4,7,654,867,968,982,19,1.2
0,1,0,-0.0,1.0,0.5833942890167236,-1.7888974490720218,58,-4,6,654,867,968,982,19,0.93
-1,0,0,-1.0,-0.0,0.5914313793182373,-2.2917960675006306,58,-3,6,654,867,968,982,19,-0.11
0,1,0,-0.0,1.0,0.5994963645935059,-3.1690481051546993,58,-3,5,654,867,968,982,19,0.9
0,1,0,-0.0,1.0,0.631467342376709,-4.0,58,-3,4,654,867,968,982,19,0.52
-1,0,0,-1.0,-0.0,0.6394202709197998,-4.52786404500042,58,-2,4,654,867,968,982,19,-0.41
0,1,0,-0.0,1.0,0.6473953723907471,-5.39444872453601,58,-2,3,654,867,968,982,19,0.4
0,0,1,-0.0,-0.0,0.660407304763794,-5.39444872453601,58,-2,3,654,867,968,982,19,25.39
0,0,0,-0.0,-0.0,0.0971837043762207,789.3219473898605,59,221,-764,877,100,656,864,12,179.23
1,0,0,1.0,-0.0,0.1321866512298584,789.0446528340406,59,220,-764,877,100,656,864,12,4.3
2,0,0,2.0,-0.0,0.14021968841552734,788.4935493759531,59,218,-764,877,100,656,864,12,7.96
2,-2,0,2.0,-2.0,0.14820575714111328,786.0227269466451,59,216,-762,877,100,656,864,12,31.08
3,-1,0,3.0,-1.0,0.15617966651916504,784.2467968932237,59,213,-761,877,100,656,864,12,22.93
3,-3,0,3.0,-3.0,0.16418170928955078,780.5519690395544,59,210,-758,877,100,656,864,12,42.0
3,-2,0,3.0,-2.0,0.17229771614074707,777.8271493129081,59,207,-756,877,100,656,864,12,32.85
4,-4,0,4.0,-4.0,0.1801767349243164,772.9178390562126,59,203,-752,877,100,656,864,12,51.07
4,-3,0,4.0,-3.0,0.1881706714630127,768.9851611482635,59,199,-749,877,100,656,864,12,43.19
6,-6,0,6.0,-6.0,0.19618773460388184,761.6574757012401,59,193,-743,877,100,656,864,12,65.55
7,-7,0,7.0,-7.0,0.20416665077209473,753.138985957117,59,186,-736,877,100,656,864,12,71.11
10,-11,0,10.0,-11.0,0.21217966079711914,740.0569683341882,59,176,-725,877,100,656,864,12,88.03
12,-11,0,12.0,-11.0,0.22017574310302734,726.5926562558486,59,164,-714,877,100,656,864,12,87.94
12,-13,0,12.0,-13.0,0.22816777229309082,711.2900389661075,59,152,-701,877,100,656,864,12,92.07
12,-13,0,12.0,-13.0,0.23618674278259277,696.09970801874,59,140,-688,877,100,656,864,12,90.52
11,-13,0,11.0,-13.0,0.24417972564697266,681.2161232101587,59,129,-675,877,100,656,864,12,88.6
10,-16,0,10.0,-16.0,0.2522127628326416,663.6581217307829,59,119,-659,877,100,656,864,12,93.81
9,-19,0,9.0,-19.0,0.2603118419647217,643.3843238021688,59,110,-640,877,100,656,864,12,97.61
9,-23,0,9.0,-23.0,0.2682197093963623,619.2119640569908,59,101,-617,877,100,656,864,12,101.51
10,-26,0,10.0,-26.0,0.2761697769165039,591.9648819119732,59,91,-591,877,100,656,864,12,102.33
8,-27,0,8.0,-27.0,0.2845008373260498,564.0745565274774,59,83,-564,877,100,656,864,12,100.45
8,-26,0,8.0,-26.0,0.292177677154541,537.2025404947956,59,75,-538,877,100,656,864,12,96.14
9,-26,0,9.0,-26.0,0.30023670196533203,510.2363799656123,59,66,-512,877,100,656,864,12,92.74
8,-25,0,8.0,-25.0,0.3081958293914795,484.4416377103396,59,58,-487,877,100,656,864,12,88.55
7,-27,0,7.0,-27.0,0.3161888122558594,456.8185389545237,59,51,-460,877,100,656,864,12,87.32
6,-26,0,6.0,-26.0,0.32433176040649414,430.3267124529508,59,45,-434,877,100,656,864,12,83.1
4,-25,0,4.0,-25.0,0.3321967124938965,405.0498753192853,59,41,-409,877,100,656,864,12,79.64
2,-22,0,2.0,-22.0,0.34017086029052734,382.96015220071064,59,39,-387,877,100,656,864,12,75.27
3,-21,0,3.0,-21.0,0.34827566146850586,361.7662300973269,59,36,-366,877,100,656,864,12,70.2
2,-22,0,2.0,-22.0,0.3561687469482422,339.6761490181236,59,34,-344,877,100,656,864,12,69.76
1,-18,0,1.0,-18.0,0.36418867111206055,321.6659884699662,59,33,-326,877,100,656,864,12,61.29
1,-13,0,1.0,-13.0,0.3722257614135742,308.63153052419904,59,32,-313,877,100,656,864,12,53.02
0,-10,0,-0.0,-10.0,0.3801877498626709,298.6850833237492,59,32,-303,877,100,656,864,12,44.27
0,-8,0,-0.0,-8.0,0.3881876468658447,290.73051747334654,59,32,-295,877,100,656,864,12,38.69
-1,-6,0,-1.0,-6.0,0.39619970321655273,284.8779812911249,59,33,-289,877,100,656,864,12,30.82
-2,-5,0,-2.0,-5.0,0.4041788578033447,280.1485628130954,59,35,-284,877,100,656,864,12,25.81
-2,-5,0,-2.0,-5.0,0.4122047424316406,275.44271175498574,59,37,-279,877,100,656,864,12,25.4
-2,-3,0,-2.0,-3.0,0.4202547073364258,272.7418160233588,59,39,-276,877,100,656,864,12,16.56
-1,-3,0,-1.0,-3.0,0.4281797409057617,269.9148419349709,59,40,-273,877,100,656,864,12,17.65
-1,-3,0,-1.0,-3.0,0.436328649520874,267.09522148876937,59,41,-270,877,100,656,864,12,17.48
-1,-2,0,-1.0,-2.0,0.44421982765197754,265.27108213003464,59,42,-268,877,100,656,864,12,12.25
-2,-3,0,-2.0,-3.0,0.45217466354370117,262.6279955626368,59,44,-265,877,100,656,864,12,15.82
-1,-4,0,-1.0,-4.0,0.4601767063140869,258.85090145211893,59,45,-261,877,100,656,864,12,21.25
-2,-5,0,-2.0,-5.0,0.4682886600494385,254.2786967848118,59,47,-256,877,100,656,864,12,23.45
-1,-7,0,-1.0,-7.0,0.47620081901550293,247.58430550804994,59,48,-249,877,100,656,864,12,30.13
0,-10,0,-0.0,-10.0,0.4841878414154053,237.77243486497812,59,48,-239,877,100,656,864,12,36.89
-2,-13,0,-2.0,-13.0,0.4921698570251465,225.46490014686893,59,50,-226,877,100,656,864,12,38.73
-2,-16,0,-2.0,-16.0,0.5001857280731201,210.34232133357543,59,52,-210,877,100,656,864,12,40.33
-2,-17,0,-2.0,-17.0,0.508185863494873,194.4120754844877,59,54,-193,877,100,656,864,12,38.82
-3,-19,0,-3.0,-19.0,0.5161917209625244,177.09833423600554,59,57,-174,877,100,656,864,12,37.18
-4,-16,0,-4.0,-16.0,0.5241827964782715,163.36646657470303,59,61,-158,877,100,656,864,12,31.47
-2,-14,0,-2.0,-14.0,0.5321817398071289,151.17824276915684,59,63,-144,877,100,656,864,12,28.31
-3,-11,0,-3.0,-11.0,0.5401737689971924,142.47558721890948,59,66,-133,877,100,656,864,12,22.49
-2,-7,0,-2.0,-7.0,0.5482568740844727,137.17821063276352,59,68,-126,877,100,656,864,12,16.2
0,-3,0,-0.0,-3.0,0.5562217235565186,134.54536634126364,59,68,-123,877,100,656,864,12,10.5
2,-4,0,2.0,-4.0,0.5642197132110596,130.07718398026907,59,66,-119,877,100,656,864,12,17.82
6,-4,0,6.0,-4.0,0.5721888542175293,123.71121771072848,59,60,-115,877,100,656,864,12,17.51
7,-3,0,7.0,-3.0,0.580542802810669,117.90722335683259,59,53,-112,877,100,656,864,12,15.47
7,-3,0,7.0,-3.0,0.5883877277374268,112.30891766895681,59,46,-109,877,100,656,864,12,14.51
5,-3,0,5.0,-3.0,0.5961687564849854,107.65298060323803,59,41,-106,877,100,656,864,12,12.75
4,-3,0,4.0,-3.0,0.6041786670684814,103.4440496326776,59,37,-103,877,100,656,864,12,11.81
2,-3,0,2.0,-3.0,0.6122226715087891,99.94810050208545,59,35,-100,877,100,656,864,12,11.44
4,-5,0,4.0,-5.0,0.6202356815338135,93.92997548283498,59,31,-95,877,100,656,864,12,14.49
4,-5,0,4.0,-5.0,0.6282248497009277,87.96275858019496,59,27,-90,877,100,656,864,12,13.72
5,-5,0,5.0,-5.0,0.6361887454986572,81.80091115700337,59,22,-85,877,100,656,864,12,12.83
3,-4,0,3.0,-4.0,0.644169807434082,77.19855767980596,59,19,-81,877,100,656,864,12,10.77
3,-3,0,3.0,-3.0,0.6521856784820557,73.62411694957753,59,16,-78,877,100,656,864,12,8.5
3,-4,0,3.0,-4.0,0.6602146625518799,69.13321502504735,59,13,-74,877,100,656,864,12,9.73
2,-2,0,2.0,-2.0,0.6682217121124268,66.83543093852057,59,11,-72,877,100,656,864,12,5.94
1,-2,0,1.0,-2.0,0.6762046813964844,64.71067811865476,59,10,-70,877,100,656,864,12,6.53
1,-2,0,1.0,-2.0,0.6842978000640869,62.59300255857006,59,9,-68,877,100,656,864,12,6.37
2,-2,0,2.0,-2.0,0.6921837329864502,60.37017402418047,59,7,-66,877,100,656,864,12,5.37
1,-2,0,1.0,-2.0,0.700244665145874,58.280634719952786,59,6,-64,877,100,656,864,12,5.96
1,-2,0,1.0,-2.0,0.7082028388977051,56.20128616033595,59,5,-62,877,100,656,864,12,5.79
2,-1,0,2.0,-1.0,0.716195821762085,55.07372593840988,59,3,-61,877,100,656,864,12,2.68
1,-1,0,1.0,-1.0,0.7243506908416748,54.03332407921454,59,2,-60,877,100,656,864,12,3.06
2,-2,0,2.0,-2.0,0.7321887016296387,52.0,59,0,-58,877,100,656,864,12,4.43
2,-1,0,2.0,-1.0,0.7402408123016357,51.0350769263968,59,-2,-57,877,100,656,864,12,2.16
2,0,0,2.0,-0.0,0.7481896877288818,51.14017850864661,59,-4,-57,877,100,656,864,12,11.27
1,-1,0,1.0,-1.0,0.7561688423156738,50.22277118748239,59,-5,-56,877,100,656,864,12,2.53
1,-1,0,1.0,-1.0,0.7641706466674805,49.326304774492215,59,-6,-55,877,100,656,864,12,2.43
2,0,0,2.0,-0.0,0.772202730178833,49.57877292636101,59,-8,-55,877,100,656,864,12,6.2
1,-1,0,1.0,-1.0,0.7803306579589844,48.74486277268398,59,-9,-54,877,100,656,864,12,2.22
1,-1,0,1.0,-1.0,0.788226842880249,47.9351462406472,59,-10,-53,877,100,656,864,12,2.13
1,-2,0,1.0,-2.0,0.7961857318878174,46.172789842982326,59,-11,-51,877,100,656,864,12,4.02
2,-2,0,2.0,-2.0,0.8041696548461914,44.695167422546305,59,-13,-49,877,100,656,864,12,2.84
2,-2,0,2.0,-2.0,0.8122236728668213,43.33558553417604,59,-15,-47,877,100,656,864,12,2.54
1,-2,0,1.0,-2.0,0.8201847076416016,41.75981574503821,59,-16,-45,877,100,656,864,12,3.3
1,-2,0,1.0,-2.0,0.8281776905059814,40.238512086787566,59,-17,-43,877,100,656,864,12,3.1
2,-3,0,2.0,-3.0,0.83620285987854,38.28317965096906,59,-19,-40,877,100,656,864,12,3.14
0,-3,0,-0.0,-3.0,0.8441758155822754,35.593268686170845,59,-19,-37,877,100,656,864,12,5.03
0,-2,0,-0.0,-2.0,0.8522098064422607,33.824615503479755,59,-19,-35,877,100,656,864,12,3.91
0,-2,0,-0.0,-2.0,0.8601768016815186,32.07886552931954,59,-19,-33,877,100,656,864,12,3.72
0,-2,0,-0.0,-2.0,0.8681807518005371,30.359317925395686,59,-19,-31,877,100,656,864,12,3.53
0,-3,0,-0.0,-3.0,0.8762876987457275,27.837848631377263,59,-19,-28,877,100,656,864,12,4.0
0,-2,0,-0.0,-2.0,0.8843986988067627,26.202484376209235,59,-19,-26,877,100,656,864,12,3.04
0,-2,0,-0.0,-2.0,0.8921937942504883,24.610455730027933,59,-19,-24,877,100,656,864,12,2.82
0,-2,0,-0.0,-2.0,0.9001908302307129,23.068883707497267,59,-19,-22,877,100,656,864,12,2.6
0,-1,0,-0.0,-1.0,0.9081728458404541,22.319604517012593,59,-19,-21,877,100,656,864,12,1.86
0,-2,0,-0.0,-2.0,0.916489839553833,20.870057685088806,59,-19,-19,877,100,656,864,12,2.26
0,-2,0,-0.0,-2.0,0.9242017269134521,19.495097567963924,59,-19,-17,877,100,656,864,12,2.02
0,-2,0,-0.0,-2.0,0.9321987628936768,18.20743687382041,59,-19,-15,877,100,656,864,12,1.77
0,-2,0,-0.0,-2.0,0.9403657913208008,17.021728866442675,59,-19,-13,877,100,656,864,12,1.5
0,-2,0,-0.0,-2.0,0.9481797218322754,15.95449840010015,59,-19,-11,877,100,656,864,12,1.23
-1,-1,0,-1.0,-1.0,0.9562246799468994,14.591260281974002,59,-18,-10,877,100,656,864,12,3.43
0,-1,0,-0.0,-1.0,0.9641847610473633,14.124611797498108,59,-18,-9,877,100,656,864,12,0.75
0,-1,0,-0.0,-1.0,0.9721837043762207,13.697715603592208,59,-18,-8,877,100,656,864,12,0.64
0,-2,0,-0.0,-2.0,0.98018479347229,12.973665961010276,59,-18,-6,877,100,656,864,12,0.51
-1,-1,0,-1.0,-1.0,0.9882237911224365,11.72004514666935,59,-17,-5,877,100,656,864,12,2.36
0,-1,0,-0.0,-1.0,0.9961998462677002,11.464249196572979,59,-17,-4,877,100,656,864,12,0.2
0,-1,0,-0.0,-1.0,1.0041706562042236,11.262676501632068,59,-17,-3,877,100,656,864,12,0.09
0,-1,0,-0.0,-1.0,1.0121686458587646,11.11724276862369,59,-17,-2,877,100,656,864,12,-0.03
-1,-2,0,-1.0,-2.0,1.0202326774597168,10.0,59,-16,0,877,100,656,864,12,0.81
0,-1,0,-0.0,-1.0,1.0282766819000244,10.031219541881399,59,-16,1,877,100,656,864,12,9.29
-1,-1,0,-1.0,-1.0,1.0362026691436768,9.132745950421556,59,-15,2,877,100,656,864,12,1.06
-1,-1,0,-1.0,-1.0,1.0441818237304688,8.317821063276353,59,-14,3,877,100,656,864,12,0.83
-1,0,0,-1.0,-0.0,1.0605506896972656,7.341664064126334,59,-13,3,877,100,656,864,12,3.11
0,-1,0,-0.0,-1.0,1.0681726932525635,7.601470508735444,59,-13,4,877,100,656,864,12,2.79
-1,0,0,-1.0,-0.0,1.0923287868499756,6.649110640673518,59,-12,4,877,100,656,864,12,2.57
0,0,1,-0.0,-0.0,1.1182186603546143,6.649110640673518,59,-12,4,877,100,656,864,12,28.88
-1,0,1,-1.0,-0.0,1.1321897506713867,5.704699910719626,59,-11,4,877,100,656,864,12,12.39
-1,0,1,-1.0,-0.0,1.140171766281128,4.7703296142690075,59,-10,4,877,100,656,864,12,12.2
-1,0,1,-1.0,-0.0,1.1561777591705322,3.848857801796104,59,-9,4,877,100,656,864,12,11.98
-1,0,1,-1.0,-0.0,1.164691686630249,2.944271909999159,59,-8,4,877,100,656,864,12,11.75
-1,0,1,-1.0,-0.0,1.1723246574401855,2.062257748298549,59,-7,4,877,100,656,864,12,11.5
-2,1,1,-2.0,1.0,1.1801738739013672,-0.16904810515469926,59,-5,3,877,100,656,864,12,14.219999999999999
-2,0,1,-2.0,-0.0,1.1881928443908691,-1.7573593128807152,59,-3,3,877,100,656,864,12,10.36
-1,0,1,-1.0,-0.0,1.1961798667907715,-2.394448724536011,59,-2,3,877,100,656,864,12,9.81
-1,0,1,-1.0,-0.0,1.204178810119629,-2.8377223398316205,59,-1,3,877,100,656,864,12,9.27
0,0,0,-0.0,-0.0,1.2302048206329346,-2.8377223398316205,59,-1,3,877,100,656,864,12,16.12
0,0,1,-0.0,-0.0,1.3461947441101074,-2.8377223398316205,59,-1,3,877,100,656,864,12,26.12
0,0,0,-0.0,-0.0,0.10627365112304688,813.4840229730582,60,420,706,1298,803,878,97,17,182.45
0,1,0,-0.0,1.0,0.12839579582214355,812.6247619953958,60,420,705,1298,803,878,97,17,10.09
0,1,0,-0.0,1.0,0.1522996425628662,811.7658202194087,60,420,704,1298,803,878,97,17,10.08
0,1,0,-0.0,1.0,0.16041183471679688,810.9071986495173,60,420,703,1298,803,878,97,17,10.07
0,2,0,-0.0,2.0,0.16879582405090332,809.190920164927,60,420,701,1298,803,878,97,17,17.69
0,4,0,-0.0,4.0,0.1763906478881836,805.7622502918159,60,420,697,1298,803,878,97,17,30.92
0,4,0,-0.0,4.0,0.18427681922912598,802.3388180261389,60,420,693,1298,803,878,97,17,30.8
0,8,0,-0.0,8.0,0.1922757625579834,795.5079339994098,60,420,685,1298,803,878,97,17,51.22
0,9,0,-0.0,9.0,0.2002878189086914,787.849231952887,60,420,676,1298,803,878,97,17,55.02
1,11,0,1.0,11.0,0.20833778381347656,777.9936386511025,60,419,665,1298,803,878,97,17,64.45
3,12,0,3.0,12.0,0.21641778945922852,766.2512512098382,60,416,653,1298,803,878,97,17,71.41
3,11,0,3.0,11.0,0.22427582740783691,755.3695042376268,60,413,642,1298,803,878,97,17,67.82
4,11,0,4.0,11.0,0.2324206829071045,743.9587754657831,60,409,631,1298,803,878,97,17,69.49
6,11,0,6.0,11.0,0.24030470848083496,731.4653473963469,60,403,620,1298,803,878,97,17,73.78
7,11,0,7.0,11.0,0.2483196258544922,718.4275600498648,60,396,609,1298,803,878,97,17,76.57
10,11,0,10.0,11.0,0.25626182556152344,703.7583859709698,60,386,598,1298,803,878,97,17,77.47
9,12,0,9.0,12.0,0.26428675651550293,688.7962399439308,60,377,586,1298,803,878,97,17,78.29
11,13,0,11.0,13.0,0.27227282524108887,671.9154359183207,60,366,573,1298,803,878,97,17,81.02
12,13,0,12.0,13.0,0.2802727222442627,654.5073584497005,60,354,560,1298,803,878,97,17,80.5
11,13,0,11.0,13.0,0.2882707118988037,637.6454135204555,60,343,547,1298,803,878,97,17,78.34
11,15,0,11.0,15.0,0.29650163650512695,619.0948891515542,60,332,532,1298,803,878,97,17,81.24
10,15,0,10.0,15.0,0.3043076992034912,601.0755289781391,60,322,517,1298,803,878,97,17,79.71
11,17,0,11.0,17.0,0.31226277351379395,580.8301962365721,60,311,500,1298,803,878,97,17,82.66
12,16,0,12.0,16.0,0.3203916549682617,560.9086042590673,60,299,484,1298,803,878,97,17,78.63
12,20,0,12.0,20.0,0.3283267021179199,537.5868400172424,60,287,464,1298,803,878,97,17,83.71
14,18,0,14.0,18.0,0.3362727165222168,514.9196879062788,60,273,446,1298,803,878,97,17,78.35
13,18,0,13.0,18.0,0.34427571296691895,492.78338630589576,60,260,428,1298,803,878,97,17,75.86
14,16,0,14.0,16.0,0.3523097038269043,471.8541445064323,60,246,412,1298,803,878,97,17,71.01
11,14,0,11.0,14.0,0.360271692276001,454.2001730852121,60,235,398,1298,803,878,97,17,64.61
12,13,0,12.0,13.0,0.36852383613586426,436.9202175671499,60,223,385,1298,803,878,97,17,61.69
8,10,0,8.0,10.0,0.376267671585083,424.26149493101974,60,215,375,1298,803,878,97,17,52.18
7,9,0,7.0,9.0,0.38445472717285156,412.97505864362086,60,208,366,1298,803,878,97,17,48.25
7,9,0,7.0,9.0,0.39227867126464844,401.69500851242987,60,201,357,1298,803,878,97,17,47.33
5,9,0,5.0,9.0,0.4002666473388672,391.3995493237317,60,196,348,1298,803,878,97,17,47.22
5,10,0,5.0,10.0,0.40827274322509766,380.2331773560833,60,191,338,1298,803,878,97,17,46.74
5,9,0,5.0,9.0,0.41626763343811035,369.9378255745249,60,186,329,1298,803,878,97,17,45.52
5,10,0,5.0,10.0,0.4243037700653076,358.77240899500606,60,181,319,1298,803,878,97,17,45.0
5,10,0,5.0,10.0,0.43227171897888184,347.607930170293,60,176,309,1298,803,878,97,17,44.06
5,9,0,5.0,9.0,0.44062066078186035,337.3129015834769,60,171,300,1298,803,878,97,17,42.8
6,9,0,6.0,9.0,0.4482598304748535,326.5235417724738,60,165,291,1298,803,878,97,17,41.2
6,8,0,6.0,8.0,0.45625877380371094,316.6074552440224,60,159,283,1298,803,878,97,17,37.79
6,9,0,6.0,9.0,0.4642658233642578,305.82319863260585,60,153,274,1298,803,878,97,17,39.37
5,8,0,5.0,8.0,0.4725046157836914,296.4010512465422,60,148,266,1298,803,878,97,17,36.3
5,8,0,5.0,8.0,0.48026275634765625,286.97966031575805,60,143,258,1298,803,878,97,17,35.52
5,8,0,5.0,8.0,0.48827075958251953,277.5591007129697,60,138,250,1298,803,878,97,17,34.73
4,7,0,4.0,7.0,0.49626684188842773,269.49774773860776,60,134,243,1298,803,878,97,17,32.43
4,8,0,4.0,8.0,0.5042598247528076,260.5609800399157,60,130,235,1298,803,878,97,17,32.69
5,9,0,5.0,9.0,0.5122897624969482,250.26536740337446,60,125,226,1298,803,878,97,17,36.29
6,10,0,6.0,10.0,0.5203917026519775,238.61102976144437,60,119,216,1298,803,878,97,17,35.72
6,11,0,6.0,11.0,0.5282528400421143,226.081182498722,60,113,205,1298,803,878,97,17,37.34
5,8,0,5.0,8.0,0.536665678024292,216.66196829904254,60,108,197,1298,803,878,97,17,29.56
5,8,0,5.0,8.0,0.5442967414855957,207.24404753674375,60,103,189,1298,803,878,97,17,28.68
5,8,0,5.0,8.0,0.5522778034210205,197.8275977608445,60,98,181,1298,803,878,97,17,27.78
5,9,0,5.0,9.0,0.560269832611084,187.5326059765992,60,93,172,1298,803,878,97,17,29.8
5,7,0,5.0,7.0,0.568260669708252,179.0,60,88,165,1298,803,878,97,17,23.78
5,9,0,5.0,9.0,0.5764167308807373,168.70597047072292,60,83,156,1298,803,878,97,17,27.59
5,10,0,5.0,10.0,0.5842857360839844,157.5294535724685,60,78,146,1298,803,878,97,17,27.15
4,8,0,4.0,8.0,0.5922558307647705,148.58863304850706,60,74,138,1298,803,878,97,17,23.41
3,10,0,3.0,10.0,0.6002707481384277,138.37281168304446,60,71,128,1298,803,878,97,17,21.44
4,9,0,4.0,9.0,0.6082866191864014,128.56500283747664,60,67,119,1298,803,878,97,17,21.06
4,9,0,4.0,9.0,0.6163127422332764,118.763559432512,60,63,110,1298,803,878,97,17,19.92
4,7,0,4.0,7.0,0.6242697238922119,110.70130580579136,60,59,103,1298,803,878,97,17,20.46
3,7,0,3.0,7.0,0.6322567462921143,103.13955191559843,60,56,96,1298,803,878,97,17,15.73
4,7,0,4.0,7.0,0.6402606964111328,95.07764064044152,60,52,89,1298,803,878,97,17,18.21
3,5,0,3.0,5.0,0.6482686996459961,89.24710792614863,60,49,84,1298,803,878,97,17,15.09
2,6,0,2.0,6.0,0.656254768371582,83.0659101969557,60,47,78,1298,803,878,97,17,11.68
3,6,0,3.0,6.0,0.6642847061157227,76.38009243891595,60,44,72,1298,803,878,97,17,12.88
3,5,0,3.0,5.0,0.6722767353057861,70.54934754662193,60,41,67,1298,803,878,97,17,13.87
2,5,0,2.0,5.0,0.6802747249603271,65.24616030891995,60,39,62,1298,803,878,97,17,9.64
2,6,0,2.0,6.0,0.6882736682891846,59.11929677819934,60,37,56,1298,803,878,97,17,9.33
1,5,0,1.0,5.0,0.6962666511535645,54.42595614005443,60,36,51,1298,803,878,97,17,7.09
2,4,0,2.0,4.0,0.7042806148529053,50.008620049092706,60,34,47,1298,803,878,97,17,7.86
1,4,0,1.0,4.0,0.7122707366943359,46.20332093147061,60,33,43,1298,803,878,97,17,5.79
2,5,0,2.0,5.0,0.720261812210083,41.040799340956916,60,31,38,1298,803,878,97,17,6.85
3,4,0,3.0,4.0,0.7283766269683838,36.04543109109048,60,28,34,1298,803,878,97,17,8.87
2,3,0,2.0,3.0,0.7362706661224365,32.45985664828782,60,26,31,1298,803,878,97,17,6.56
2,3,0,2.0,3.0,0.7442667484283447,28.87817782917155,60,24,28,1298,803,878,97,17,6.2
2,1,0,2.0,1.0,0.7522687911987305,26.828149534535996,60,22,27,1298,803,878,97,17,3.37
1,1,0,1.0,1.0,0.7604846954345703,25.421549934136806,60,21,26,1298,803,878,97,17,4.8
0,1,0,-0.0,1.0,0.768324613571167,24.649655434629018,60,21,25,1298,803,878,97,17,1.74
1,0,0,1.0,-0.0,0.7842597961425781,24.015621187164243,60,20,25,1298,803,878,97,17,1.26
0,1,0,-0.0,1.0,0.7923498153686523,23.240998703626616,60,20,24,1298,803,878,97,17,1.72
1,1,0,1.0,1.0,0.8082737922668457,21.832867780352597,60,19,23,1298,803,878,97,17,4.82
1,2,0,1.0,2.0,0.8162927627563477,19.65863337187866,60,18,21,1298,803,878,97,17,3.87
0,1,0,-0.0,1.0,0.8242688179016113,18.90724809414742,60,18,20,1298,803,878,97,17,1.52
1,1,0,1.0,1.0,0.8322718143463135,17.495097567963924,60,17,19,1298,803,878,97,17,5.33
1,0,0,1.0,-0.0,0.8403546810150146,16.839484696748443,60,16,19,1298,803,878,97,17,1.16
0,1,0,-0.0,1.0,0.8482687473297119,16.08318915758459,60,16,18,1298,803,878,97,17,1.47
0,1,0,-0.0,1.0,0.8562698364257812,15.345235059857504,60,16,17,1298,803,878,97,17,1.38
1,0,0,1.0,-0.0,0.8644647598266602,14.671568097509269,60,15,17,1298,803,878,97,17,1.15
0,1,0,-0.0,1.0,0.8803308010101318,13.931712199461309,60,15,16,1298,803,878,97,17,1.35
0,1,0,-0.0,1.0,0.8883228302001953,13.213203435596427,60,15,15,1298,803,878,97,17,1.25
1,1,0,1.0,1.0,0.896284818649292,11.79898987322333,60,14,14,1298,803,878,97,17,7.7
0,2,0,-0.0,2.0,0.9042727947235107,10.439088914585774,60,14,12,1298,803,878,97,17,1.14
1,2,0,1.0,2.0,0.9125986099243164,8.401219466856727,60,13,10,1298,803,878,97,17,2.25
1,2,0,1.0,2.0,0.9202737808227539,6.4222051018559565,60,12,8,1298,803,878,97,17,1.88
0,1,0,-0.0,1.0,0.928250789642334,5.892443989449804,60,12,7,1298,803,878,97,17,0.49
1,1,0,1.0,1.0,0.9362757205963135,4.529964086141668,60,11,6,1298,803,878,97,17,2.5
1,1,0,1.0,1.0,0.9522826671600342,3.180339887498949,60,10,5,1298,803,878,97,17,2.23
0,1,0,-0.0,1.0,0.9602656364440918,2.7703296142690075,60,10,4,1298,803,878,97,17,0.1
1,1,0,1.0,1.0,0.96826171875,1.4868329805051381,60,9,3,1298,803,878,97,17,1.54
1,0,0,1.0,-0.0,0.9765417575836182,0.5440037453175304,60,8,3,1298,803,878,97,17,1.85
1,1,0,1.0,1.0,0.9843106269836426,-0.719890110719482,60,7,2,1298,803,878,97,17,1.18
1,1,0,1.0,1.0,0.9922707080841064,-1.9172374697017807,60,6,1,1298,803,878,97,17,0.72
1,1,0,1.0,1.0,1.0002696514129639,-3.0,60,5,0,1298,803,878,97,17,0.17
0,0,1,-0.0,-0.0,1.0112736225128174,-3.0,60,5,0,1298,803,878,97,17,26.07
0,1,1,-0.0,1.0,0.0007495880126953125,968.5374548487224,61,-967,-185,326,619,1293,803,32,28.21
0,0,0,-0.0,-0.0,0.10968661308288574,968.5374548487224,61,-967,-185,326,619,1293,803,32,201.91
-1,0,0,-1.0,-0.0,0.1766984462738037,967.5552856855581,61,-966,-185,326,619,1293,803,32,8.88
-1,0,0,-1.0,-0.0,0.18474364280700684,966.5731524929836,61,-965,-185,326,619,1293,803,32,8.87
-2,0,0,-2.0,-0.0,0.1926865577697754,964.608994451917,61,-963,-185,326,619,1293,803,32,14.32
-2,0,0,-2.0,-0.0,0.2006826400756836,962.6449815944493,61,-961,-185,326,619,1293,803,32,14.3
-4,0,0,-4.0,-0.0,0.20868158340454102,958.7173949407079,61,-957,-185,326,619,1293,803,32,24.24
-5,0,0,-5.0,-0.0,0.21670246124267578,953.8087440315229,61,-952,-185,326,619,1293,803,32,28.73
-7,-2,0,-7.0,-2.0,0.22474360466003418,946.5559723984886,61,-945,-183,326,619,1293,803,32,39.58
-8,-2,0,-8.0,-2.0,0.23284053802490234,938.321748678086,61,-937,-181,326,619,1293,803,32,43.74
-9,-4,0,-9.0,-4.0,0.24067449569702148,928.7290616891173,61,-928,-177,326,619,1293,803,32,46.63
-11,-4,0,-11.0,-4.0,0.24872660636901855,917.17629631276,61,-917,-173,326,619,1293,803,32,53.29
-12,-6,0,-12.0,-6.0,0.25668859481811523,904.2793054285204,61,-905,-167,326,619,1293,803,32,56.23
-17,-7,0,-17.0,-7.0,0.26468753814697266,886.2992851598631,61,-888,-160,326,619,1293,803,32,69.33
-27,-8,0,-27.0,-8.0,0.27268052101135254,858.3140168154689,61,-861,-152,326,619,1293,803,32,88.17
-30,-10,0,-30.0,-10.0,0.28067564964294434,827.0450759004526,61,-831,-142,326,619,1293,803,32,90.76
-34,-9,0,-34.0,-9.0,0.28877949714660645,792.0210393300412,61,-797,-133,326,619,1293,803,32,93.96
-37,-8,0,-37.0,-8.0,0.2966725826263428,754.2110100485451,61,-760,-125,326,619,1293,803,32,95.18
-37,-6,0,-37.0,-6.0,0.3046846389770508,716.727780284056,61,-723,-119,326,619,1293,803,32,94.07
-34,-5,0,-34.0,-5.0,0.3129904270172119,682.3673818270724,61,-689,-114,326,619,1293,803,32,86.94
-33,-7,0,-33.0,-7.0,0.32073044776916504,648.669090600729,61,-656,-107,326,619,1293,803,32,82.62
-31,-5,0,-31.0,-5.0,0.3286864757537842,617.2685054540451,61,-625,-102,326,619,1293,803,32,79.64
-31,-4,0,-31.0,-4.0,0.33669161796569824,586.0298995897131,61,-594,-98,326,619,1293,803,32,75.27
-32,-5,0,-32.0,-5.0,0.344679594039917,553.642870577698,61,-562,-93,326,619,1293,803,32,75.08
-30,-4,0,-30.0,-4.0,0.35268163681030273,523.3931775616003,61,-532,-89,326,619,1293,803,32,69.19
-29,-5,0,-29.0,-5.0,0.3607444763183594,493.96568512008724,61,-503,-84,326,619,1293,803,32,67.26
-29,-3,0,-29.0,-3.0,0.36873960494995117,464.8710845954454,61,-474,-81,326,619,1293,803,32,62.24
-30,-4,0,-30.0,-4.0,0.3767685890197754,434.6273404932284,61,-444,-77,326,619,1293,803,32,61.34
-28,-4,0,-28.0,-4.0,0.3848404884338379,406.35648450094857,61,-416,-73,326,619,1293,803,32,57.12
-27,-3,0,-27.0,-3.0,0.39270949363708496,379.2480233979672,61,-389,-70,326,619,1293,803,32,52.67
-25,-2,0,-25.0,-2.0,0.40067148208618164,354.29717795305976,61,-364,-68,326,619,1293,803,32,47.75
-21,-2,0,-21.0,-2.0,0.40868353843688965,333.2921413373052,61,-343,-66,326,619,1293,803,32,41.98
-18,-1,0,-18.0,-1.0,0.4166834354400635,315.436268383531,61,-325,-65,326,619,1293,803,32,36.45
-16,0,0,-16.0,-0.0,0.42467665672302246,299.7625690293262,61,-309,-65,326,619,1293,803,32,32.12
-13,-2,0,-13.0,-2.0,0.4327676296234131,286.63013729633735,61,-296,-63,326,619,1293,803,32,29.59
-13,-1,0,-13.0,-1.0,0.44069457054138184,273.71192588500736,61,-283,-62,326,619,1293,803,32,27.34
-12,-1,0,-12.0,-1.0,0.448683500289917,261.7804888756588,61,-271,-61,326,619,1293,803,32,25.28
-13,-2,0,-13.0,-2.0,0.4566786289215088,248.66015944981217,61,-258,-59,326,619,1293,803,32,26.75
-12,-3,0,-12.0,-3.0,0.4650726318359375,236.29347989989753,61,-246,-56,326,619,1293,803,32,26.34
-13,-2,0,-13.0,-2.0,0.4726865291595459,223.17566765873153,61,-233,-54,326,619,1293,803,32,24.92
-14,-3,0,-14.0,-3.0,0.480663537979126,208.8599564173221,61,-219,-51,326,619,1293,803,32,26.69
-15,-3,0,-15.0,-3.0,0.48877954483032227,193.57099035887578,61,-204,-48,326,619,1293,803,32,25.77
-15,-3,0,-15.0,-3.0,0.49669551849365234,178.28329830430613,61,-189,-45,326,619,1293,803,32,24.4
-13,-3,0,-13.0,-3.0,0.5047836303710938,164.94197965093673,61,-176,-42,326,619,1293,803,32,22.99
-11,-1,0,-11.0,-1.0,0.5126795768737793,154.01764614298128,61,-165,-41,326,619,1293,803,32,16.84
-11,-2,0,-11.0,-2.0,0.5206804275512695,142.86157496386593,61,-154,-39,326,619,1293,803,32,17.3
-9,-1,0,-9.0,-1.0,0.5286774635314941,133.8966310495336,61,-145,-38,326,619,1293,803,32,13.78
-10,-3,0,-10.0,-3.0,0.5367984771728516,123.46325680981354,61,-135,-35,326,619,1293,803,32,16.01
-8,-1,0,-8.0,-1.0,0.5446875095367432,115.47243057006287,61,-127,-34,326,619,1293,803,32,11.88
-7,-2,0,-7.0,-2.0,0.5526914596557617,108.1933975700802,61,-120,-32,326,619,1293,803,32,13.21
-6,-2,0,-6.0,-2.0,0.5607035160064697,101.881296226331,61,-114,-30,326,619,1293,803,32,10.7
-7,-3,0,-7.0,-3.0,0.5687165260314941,94.35397591387454,61,-107,-27,326,619,1293,803,32,10.07
-6,-1,0,-6.0,-1.0,0.5768435001373291,88.29285689825551,61,-101,-26,326,619,1293,803,32,9.44
-6,-2,0,-6.0,-2.0,0.5847594738006592,81.98469268207153,61,-95,-24,326,619,1293,803,32,9.49
-5,-2,0,-5.0,-2.0,0.5926685333251953,76.64987857520376,61,-90,-22,326,619,1293,803,32,7.72
-5,-2,0,-5.0,-2.0,0.6006956100463867,71.32124598286491,61,-85,-20,326,619,1293,803,32,7.38
-4,-3,0,-4.0,-3.0,0.6086935997009277,66.76472678623425,61,-81,-17,326,619,1293,803,32,5.18
-6,-3,0,-6.0,-3.0,0.616673469543457,60.2954782408499,61,-75,-14,326,619,1293,803,32,6.61
-6,-4,0,-6.0,-4.0,0.6246864795684814,53.72087205421343,61,-69,-10,326,619,1293,803,32,5.6
-6,-3,0,-6.0,-3.0,0.6327505111694336,47.387695966961914,61,-63,-7,326,619,1293,803,32,5.45
-6,-2,0,-6.0,-2.0,0.6407394409179688,41.21887800367987,61,-57,-5,326,619,1293,803,32,5.6
-4,-2,0,-4.0,-2.0,0.6486704349517822,37.08483775994799,61,-53,-3,326,619,1293,803,32,3.77
-4,-1,0,-4.0,-1.0,0.6566746234893799,33.040799340956916,61,-49,-2,326,619,1293,803,32,4.53
-3,-1,0,-3.0,-1.0,0.6646885871887207,30.010868281309364,61,-46,-1,326,619,1293,803,32,3.51
-1,-1,0,-1.0,-1.0,0.6728775501251221,29.0,61,-45,0,326,619,1293,803,32,1.39
-1,-1,0,-1.0,-1.0,0.6807105541229248,28.011362169330773,61,-44,1,326,619,1293,803,32,1.32
-2,0,0,-2.0,-0.0,0.6886875629425049,26.01190307520001,61,-42,1,326,619,1293,803,32,6.16
-1,-1,0,-1.0,-1.0,0.704688549041748,25.048751503547585,61,-41,2,326,619,1293,803,32,1.22
-1,0,0,-1.0,-0.0,0.7126774787902832,24.049968789001575,61,-40,2,326,619,1293,803,32,5.01
-2,-1,0,-2.0,-1.0,0.7207565307617188,22.118237105091836,61,-38,3,326,619,1293,803,32,2.05
-1,0,0,-1.0,-0.0,0.7287886142730713,21.12142238654117,61,-37,3,326,619,1293,803,32,4.39
-2,-1,0,-2.0,-1.0,0.7366735935211182,19.22782990761707,61,-35,4,326,619,1293,803,32,1.87
-1,0,0,-1.0,-0.0,0.7447404861450195,18.23448553724738,61,-34,4,326,619,1293,803,32,3.88
-2,0,0,-2.0,-0.0,0.7527456283569336,16.249030993194197,61,-32,4,326,619,1293,803,32,3.96
-2,-1,0,-2.0,-1.0,0.7606804370880127,14.4138126514911,61,-30,5,326,619,1293,803,32,1.57
-1,0,0,-1.0,-0.0,0.768695592880249,13.427877939124322,61,-29,5,326,619,1293,803,32,3.3
0,0,1,-0.0,-0.0,0.7966794967651367,13.427877939124322,61,-29,5,326,619,1293,803,32,30.91
-1,0,1,-1.0,-0.0,0.01502847671508789,161.1016657177453,62,138,111,492,725,355,614,32,3.46
-1,0,1,-1.0,-0.0,0.023093461990356445,161.88198334851114,62,139,111,492,725,355,614,32,3.47
-1,0,1,-1.0,-0.0,0.03099846839904785,162.6644900364927,62,140,111,492,725,355,614,32,3.47
-2,0,1,-2.0,-0.0,0.03892946243286133,164.23595645708434,62,142,111,492,725,355,614,32,2.34
-2,0,1,-2.0,-0.0,0.04697251319885254,165.8158408940211,62,144,111,492,725,355,614,32,2.35
-1,0,1,-1.0,-0.0,0.05502748489379883,166.60887163552596,62,145,111,492,725,355,614,32,3.52
-1,0,1,-1.0,-0.0,0.06295251846313477,167.40392580312997,62,146,111,492,725,355,614,32,3.53
-1,0,1,-1.0,-0.0,0.07892346382141113,168.20097719610501,62,147,111,492,725,355,614,32,3.54
-1,0,1,-1.0,-0.0,0.09499549865722656,169.0,62,148,111,492,725,355,614,32,3.55
0,0,0,-0.0,-0.0,0.11692333221435547,169.0,62,148,111,492,725,355,614,32,65.84
1,1,0,1.0,1.0,0.21492743492126465,167.60010893242955,62,147,110,492,725,355,614,32,5.82
5,1,0,5.0,1.0,0.22292852401733398,163.0111728356641,62,142,109,492,725,355,614,32,8.8
8,2,0,8.0,2.0,0.23091840744018555,155.4788616710526,62,134,107,492,725,355,614,32,12.1
10,2,0,10.0,2.0,0.23891949653625488,146.48384535085327,62,124,105,492,725,355,614,32,12.84
11,3,0,11.0,3.0,0.24698352813720703,136.22680447279973,62,113,102,492,725,355,614,32,13.43
15,5,0,15.0,5.0,0.25493836402893066,121.88763541376724,62,98,97,492,725,355,614,32,15.36
15,7,0,15.0,7.0,0.2631034851074219,106.42957159118053,62,83,90,492,725,355,614,32,14.82
14,8,0,14.0,8.0,0.27092432975769043,91.16809226630845,62,69,82,492,725,355,614,32,13.35
14,9,0,14.0,9.0,0.27898740768432617,75.40021881811882,62,55,73,492,725,355,614,32,11.95
11,9,0,11.0,9.0,0.28691840171813965,61.6659513557904,62,44,64,492,725,355,614,32,10.04
10,8,0,10.0,8.0,0.2949254512786865,49.513357416636794,62,34,56,492,725,355,614,32,7.95
9,8,0,9.0,8.0,0.30296850204467773,38.120236510939236,62,25,48,492,725,355,614,32,6.57
8,8,0,8.0,8.0,0.31104040145874023,27.46262762420146,62,17,40,492,725,355,614,32,5.29
7,7,0,7.0,7.0,0.3189244270324707,18.481879299133332,62,10,33,492,725,355,614,32,3.7
5,5,0,5.0,5.0,0.3269314765930176,12.442925306655784,62,5,28,492,725,355,614,32,2.27
4,5,0,4.0,5.0,0.3349313735961914,7.021728866442675,62,1,23,492,725,355,614,32,1.71
3,3,0,3.0,3.0,0.34293556213378906,4.09975124224178,62,-2,20,492,725,355,614,32,0.63
2,2,0,2.0,2.0,0.35094738006591797,2.439088914585774,62,-4,18,492,725,355,614,32,0.28
0,1,0,-0.0,1.0,0.36692047119140625,1.464249196572979,62,-4,17,492,725,355,614,32,2.59
1,0,0,1.0,-0.0,0.3750424385070801,1.7200451466693494,62,-5,17,492,725,355,614,32,1.05
0,1,0,-0.0,1.0,0.38297343254089355,0.763054614240211,62,-5,16,492,725,355,614,32,2.19
1,3,0,1.0,3.0,0.3909473419189453,-1.6821789367236466,62,-6,13,492,725,355,614,32,0.55
0,1,0,-0.0,1.0,0.398923397064209,-2.583592135001261,62,-6,12,492,725,355,614,32,1.46
0,2,0,-0.0,2.0,0.40692853927612305,-4.3380962103093985,62,-6,10,492,725,355,614,32,0.95
1,2,0,1.0,2.0,0.4149653911590576,-5.36985418726535,62,-7,8,492,725,355,614,32,-0.41
0,2,0,-0.0,2.0,0.4230184555053711,-6.780455542707113,62,-7,6,492,725,355,614,32,0.04
0,1,0,-0.0,1.0,0.4309265613555908,-7.397674732957373,62,-7,5,492,725,355,614,32,0.14
1,1,0,1.0,1.0,0.4390585422515869,-7.055728090000841,62,-8,4,492,725,355,614,32,-0.08
0,1,0,-0.0,1.0,0.45493555068969727,-7.45599625468247,62,-8,3,492,725,355,614,32,-0.22
0,0,1,-0.0,-0.0,0.4629404544830322,-7.45599625468247,62,-8,3,492,725,355,614,32,24.810000000000002
0,1,1,-0.0,1.0,0.010374069213867188,221.8297255459794,63,-208,109,292,832,500,722,27,1.84
0,1,1,-0.0,1.0,0.018177032470703125,221.36723320464404,63,-208,108,292,832,500,722,27,1.83
0,1,1,-0.0,1.0,0.02632904052734375,220.90810161257775,63,-208,107,292,832,500,722,27,1.81
0,1,1,-0.0,1.0,0.03418111801147461,220.45235059857504,63,-208,106,292,832,500,722,27,1.8
0,1,1,-0.0,1.0,0.042179107666015625,220.0,63,-208,105,292,832,500,722,27,1.78
0,1,1,-0.0,1.0,0.050907135009765625,219.55106965997814,63,-208,104,292,832,500,722,27,1.77
1,0,1,1.0,-0.0,0.06617403030395508,220.44592521609795,63,-209,104,292,832,500,722,27,4.67
0,0,0,-0.0,-0.0,0.1061849594116211,220.44592521609795,63,-209,104,292,832,500,722,27,78.71
1,0,0,1.0,-0.0,0.14619207382202148,221.34163095788165,63,-210,104,292,832,500,722,27,4.68
3,0,0,3.0,-0.0,0.15423893928527832,224.03375287076733,63,-213,104,292,832,500,722,27,2.7
2,-1,0,2.0,-1.0,0.1621859073638916,226.26972228010797,63,-215,105,292,832,500,722,27,7.17
3,0,0,3.0,-0.0,0.17026305198669434,228.96900627972997,63,-218,105,292,832,500,722,27,2.73
3,-1,0,3.0,-1.0,0.17827892303466797,232.10609947530887,63,-221,106,292,832,500,722,27,4.31
1,0,0,1.0,-0.0,0.18618202209472656,233.0081299469593,63,-222,106,292,832,500,722,27,4.82
1,0,0,1.0,-0.0,0.1943950653076172,233.9109151090733,63,-223,106,292,832,500,722,27,4.83
-1,2,0,-1.0,2.0,0.24219012260437012,232.15301344262525,63,-222,104,292,832,500,722,27,5.82
-4,3,0,-4.0,3.0,0.2501718997955322,227.26027553467927,63,-218,101,292,832,500,722,27,14.02
-5,4,0,-5.0,4.0,0.25817012786865234,221.04700382615454,63,-213,97,292,832,500,722,27,15.94
-6,5,0,-6.0,5.0,0.26621413230895996,213.52372944131042,63,-207,92,292,832,500,722,27,17.55
-6,5,0,-6.0,5.0,0.2742280960083008,206.02054698132775,63,-201,87,292,832,500,722,27,17.07
-7,6,0,-7.0,6.0,0.282167911529541,197.23082552280482,63,-194,81,292,832,500,722,27,18.27
-7,5,0,-7.0,5.0,0.2901749610900879,188.8539075668341,63,-187,76,292,832,500,722,27,17.59
-8,6,0,-8.0,6.0,0.2981860637664795,179.20041623263984,63,-179,70,292,832,500,722,27,18.38
-10,6,0,-10.0,6.0,0.30619096755981445,167.71247881648904,63,-169,64,292,832,500,722,27,20.14
-10,6,0,-10.0,6.0,0.3141920566558838,156.24833824885843,63,-159,58,292,832,500,722,27,19.1
-10,6,0,-10.0,6.0,0.3221700191497803,144.8131806916013,63,-149,52,292,832,500,722,27,18.03
-10,4,0,-10.0,4.0,0.3301689624786377,134.05441169852742,63,-139,48,292,832,500,722,27,18.41
-8,4,0,-8.0,4.0,0.33817195892333984,125.19189556555045,63,-131,44,292,832,500,722,27,14.62
-8,4,0,-8.0,4.0,0.3464059829711914,116.34063553268942,63,-123,40,292,832,500,722,27,13.88
-9,3,0,-9.0,3.0,0.3541860580444336,106.85407794480753,63,-114,37,292,832,500,722,27,16.82
-8,4,0,-8.0,4.0,0.3622009754180908,98.01801655587259,63,-106,33,292,832,500,722,27,12.39
-8,4,0,-8.0,4.0,0.3701789379119873,89.20078277586722,63,-98,29,292,832,500,722,27,11.59
-8,3,0,-8.0,3.0,0.37828612327575684,80.68030742904295,63,-90,26,292,832,500,722,27,11.82
-6,2,0,-6.0,2.0,0.3862149715423584,74.36131867136622,63,-84,24,292,832,500,722,27,10.54
-4,2,0,-4.0,2.0,0.39427804946899414,69.96987405076617,63,-80,22,292,832,500,722,27,6.93
-3,1,0,-3.0,1.0,0.4021949768066406,66.81227975693966,63,-77,21,292,832,500,722,27,7.44
-1,1,0,-1.0,1.0,0.4103889465332031,65.587530817554,63,-76,20,292,832,500,722,27,2.79
-2,1,0,-2.0,1.0,0.41852712631225586,63.40026177965623,63,-74,19,292,832,500,722,27,4.83
-2,1,0,-2.0,1.0,0.42617201805114746,61.21590126111789,63,-72,18,292,832,500,722,27,4.73
-3,1,0,-3.0,1.0,0.43418192863464355,58.06335201775947,63,-69,17,292,832,500,722,27,6.68
-2,1,0,-2.0,1.0,0.4421730041503906,55.8839603971781,63,-67,16,292,832,500,722,27,4.52
-2,1,0,-2.0,1.0,0.45020103454589844,53.70832032063167,63,-65,15,292,832,500,722,27,4.41
-2,1,0,-2.0,1.0,0.45816802978515625,51.53681120105021,63,-63,14,292,832,500,722,27,4.31
-2,1,0,-2.0,1.0,0.4662759304046631,49.369864518050704,63,-61,13,292,832,500,722,27,4.2
-3,0,0,-3.0,-0.0,0.47417497634887695,46.43904440685432,63,-58,13,292,832,500,722,27,4.77
-2,1,0,-2.0,1.0,0.4821910858154297,44.271284253105414,63,-56,12,292,832,500,722,27,4.06
-2,0,0,-2.0,-0.0,0.49019813537597656,42.31726674375732,63,-54,12,292,832,500,722,27,4.08
-2,1,0,-2.0,1.0,0.4981729984283447,40.150729063673246,63,-52,11,292,832,500,722,27,3.92
-2,1,0,-2.0,1.0,0.5062339305877686,37.99019513592785,63,-50,10,292,832,500,722,27,3.8
-2,1,0,-2.0,1.0,0.5141770839691162,35.83646178829912,63,-48,9,292,832,500,722,27,3.67
-2,1,0,-2.0,1.0,0.5221691131591797,33.69047011971501,63,-46,8,292,832,500,722,27,3.53
-2,0,0,-2.0,-0.0,0.5301880836486816,31.721359549995796,63,-44,8,292,832,500,722,27,4.06
-1,1,0,-1.0,1.0,0.5382270812988281,30.56604182158393,63,-43,7,292,832,500,722,27,1.91
-2,0,0,-2.0,-0.0,0.5461831092834473,28.593268686170845,63,-41,7,292,832,500,722,27,4.05
-2,0,0,-2.0,-0.0,0.5541739463806152,26.6232255123179,63,-39,7,292,832,500,722,27,3.93
-2,1,0,-2.0,1.0,0.562222957611084,24.483329627982627,63,-37,6,292,832,500,722,27,3.18
-1,0,0,-1.0,-0.0,0.5701749324798584,23.496575181789318,63,-36,6,292,832,500,722,27,3.59
-2,1,0,-2.0,1.0,0.5783369541168213,21.365680554879162,63,-34,5,292,832,500,722,27,3.0
-3,0,0,-3.0,-0.0,0.5862760543823242,18.400636936215164,63,-31,5,292,832,500,722,27,4.09
-3,1,0,-3.0,1.0,0.5942420959472656,15.284271247461902,63,-28,4,292,832,500,722,27,3.81
-3,0,0,-3.0,-0.0,0.602186918258667,12.317977802344327,63,-25,4,292,832,500,722,27,3.8
-4,1,0,-4.0,1.0,0.6101670265197754,8.213203435596427,63,-21,3,292,832,500,722,27,4.36
-2,0,0,-2.0,-0.0,0.6181859970092773,6.235384061671343,63,-19,3,292,832,500,722,27,3.34
-1,0,0,-1.0,-0.0,0.6261770725250244,5.248287590894659,63,-18,3,292,832,500,722,27,3.17
0,1,0,-0.0,1.0,0.6421709060668945,5.110770276274835,63,-18,2,292,832,500,722,27,-0.11
0,0,1,-0.0,-0.0,0.6652069091796875,5.110770276274835,63,-18,2,292,832,500,722,27,28.43
0,0,0,-0.0,-0.0,0.09770703315734863,1285.0485353021281,64,1287,-169,1597,661,310,830,26,236.36
2,0,0,2.0,-0.0,0.1357271671295166,1283.0655847602775,64,1285,-169,1597,661,310,830,26,19.8
4,0,0,4.0,-0.0,0.14390206336975098,1279.0998413435395,64,1281,-169,1597,661,310,830,26,33.84
5,0,0,5.0,-0.0,0.15170001983642578,1274.142960202945,64,1276,-169,1597,661,310,830,26,40.11
4,-1,0,4.0,-1.0,0.15971803665161133,1270.0463748438713,64,1272,-168,1597,661,310,830,26,34.76
4,-2,0,4.0,-2.0,0.16800212860107422,1265.8197683802046,64,1268,-166,1597,661,310,830,26,34.12
4,-2,0,4.0,-2.0,0.17573308944702148,1261.5948375856542,64,1264,-164,1597,661,310,830,26,34.05
6,-4,0,6.0,-4.0,0.18370699882507324,1255.1340623136025,64,1258,-160,1597,661,310,830,26,46.92
7,-3,0,7.0,-3.0,0.1917109489440918,1247.813229626022,64,1251,-157,1597,661,310,830,26,52.13
9,-4,0,9.0,-4.0,0.19970011711120605,1238.388428906069,64,1242,-153,1597,661,310,830,26,62.25
10,-5,0,10.0,-5.0,0.20778512954711914,1227.857767836427,64,1232,-148,1597,661,310,830,26,66.72
11,-4,0,11.0,-4.0,0.21576404571533203,1216.4620774956827,64,1221,-144,1597,661,310,830,26,70.58
12,-5,0,12.0,-5.0,0.22370100021362305,1203.9642558432026,64,1209,-139,1597,661,310,830,26,74.32
14,-5,0,14.0,-5.0,0.23174810409545898,1189.4895009936677,64,1195,-134,1597,661,310,830,26,81.33
14,-4,0,14.0,-4.0,0.2397761344909668,1175.1334100175789,64,1181,-130,1597,661,310,830,26,80.8
20,-5,0,20.0,-5.0,0.24772095680236816,1154.709724203751,64,1161,-125,1597,661,310,830,26,98.45
22,-5,0,22.0,-5.0,0.2556910514831543,1132.3038898039244,64,1139,-120,1597,661,310,830,26,102.47
26,-5,0,26.0,-5.0,0.263700008392334,1105.9253773152166,64,1113,-115,1597,661,310,830,26,110.08
27,-5,0,27.0,-5.0,0.27170705795288086,1078.5566865719802,64,1086,-110,1597,661,310,830,26,110.53
30,-4,0,30.0,-4.0,0.2797060012817383,1048.3067417104255,64,1056,-106,1597,661,310,830,26,114.91
32,-5,0,32.0,-5.0,0.2878689765930176,1015.9689013765187,64,1024,-101,1597,661,310,830,26,115.61
32,-4,0,32.0,-4.0,0.2957191467285156,983.7311573338119,64,992,-97,1597,661,310,830,26,114.16
35,-2,0,35.0,-2.0,0.30368804931640625,948.7036965718703,64,957,-95,1597,661,310,830,26,115.3
32,-3,0,32.0,-3.0,0.31170105934143066,916.5638762344414,64,925,-92,1597,661,310,830,26,110.6
31,-1,0,31.0,-1.0,0.31989502906799316,885.6194967838168,64,894,-91,1597,661,310,830,26,104.62
29,-2,0,29.0,-2.0,0.32770705223083496,856.5665586946177,64,865,-89,1597,661,310,830,26,100.58
24,-2,0,24.0,-2.0,0.33570098876953125,832.4880247525685,64,841,-87,1597,661,310,830,26,91.1
23,-2,0,23.0,-2.0,0.3437070846557617,809.4044017391931,64,818,-85,1597,661,310,830,26,87.93
20,-2,0,20.0,-2.0,0.3518190383911133,789.3048049214214,64,798,-83,1597,661,310,830,26,81.54
21,-4,0,21.0,-4.0,0.35982203483581543,768.0057618225361,64,777,-79,1597,661,310,830,26,80.21
20,-3,0,20.0,-3.0,0.3676900863647461,747.8054941967756,64,757,-76,1597,661,310,830,26,77.47
20,-4,0,20.0,-4.0,0.3757951259613037,727.5086089978968,64,737,-72,1597,661,310,830,26,75.55
21,-5,0,21.0,-5.0,0.3838491439819336,706.1279441100867,64,716,-67,1597,661,310,830,26,75.83
22,-4,0,22.0,-4.0,0.3920769691467285,683.8536431705011,64,694,-63,1597,661,310,830,26,76.54
23,-4,0,23.0,-4.0,0.3997030258178711,660.5888953954036,64,671,-59,1597,661,310,830,26,76.68
25,-4,0,25.0,-4.0,0.40769410133361816,635.3371036736985,64,646,-55,1597,661,310,830,26,78.1
27,-3,0,27.0,-3.0,0.4156980514526367,608.1803280851705,64,619,-52,1597,661,310,830,26,79.79
27,-2,0,27.0,-2.0,0.42399096488952637,581.1077343378051,64,592,-50,1597,661,310,830,26,78.28
28,-2,0,28.0,-2.0,0.4317290782928467,553.0388679233962,64,564,-48,1597,661,310,830,26,77.0
28,-1,0,28.0,-1.0,0.4397621154785156,525.0566884632138,64,536,-47,1597,661,310,830,26,73.16
28,0,0,28.0,-0.0,0.4477059841156006,497.16957964974745,64,508,-47,1597,661,310,830,26,69.86
29,-1,0,29.0,-1.0,0.455996036529541,468.20369907140156,64,479,-46,1597,661,310,830,26,68.87
28,0,0,28.0,-0.0,0.4636991024017334,440.3398283848442,64,451,-46,1597,661,310,830,26,64.43
27,0,0,27.0,-0.0,0.4717221260070801,413.487983418056,64,424,-46,1597,661,310,830,26,60.72
24,0,0,24.0,-0.0,0.4797201156616211,389.6363123216782,64,400,-46,1597,661,310,830,26,55.14
23,-1,0,23.0,-1.0,0.4876899719238281,366.67617781472677,64,377,-45,1597,661,310,830,26,52.52
21,0,0,21.0,-0.0,0.4957010746002197,345.8328301591146,64,356,-45,1597,661,310,830,26,47.51
20,-1,0,20.0,-1.0,0.5036971569061279,325.86870613852795,64,336,-44,1597,661,310,830,26,45.23
19,0,0,19.0,-0.0,0.5116889476776123,307.0390601161052,64,317,-44,1597,661,310,830,26,41.49
17,-1,0,17.0,-1.0,0.519711971282959,290.0659994126692,64,300,-43,1597,661,310,830,26,38.41
16,0,0,16.0,-0.0,0.5277020931243896,274.2368360778262,64,284,-43,1597,661,310,830,26,34.87
14,0,0,14.0,-0.0,0.5357310771942139,260.40263349134,64,270,-43,1597,661,310,830,26,31.12
12,0,0,12.0,-0.0,0.5436880588531494,248.55878880282347,64,258,-43,1597,661,310,830,26,27.45
11,0,0,11.0,-0.0,0.5517370700836182,237.7149776140229,64,247,-43,1597,661,310,830,26,25.2
10,0,0,10.0,-0.0,0.5597269535064697,227.8692591427972,64,237,-43,1597,661,310,830,26,23.03
9,0,0,9.0,-0.0,0.5677850246429443,219.01939574095957,64,228,-43,1597,661,310,830,26,20.93
9,0,0,9.0,-0.0,0.5756850242614746,210.1815404552984,64,219,-43,1597,661,310,830,26,20.3
8,1,0,8.0,1.0,0.5837039947509766,202.5388596054085,64,211,-44,1597,661,310,830,26,17.33
8,0,0,8.0,-0.0,0.5917601585388184,194.7137453323684,64,203,-44,1597,661,310,830,26,17.74
9,0,0,9.0,-0.0,0.5997381210327148,185.92712233378333,64,194,-44,1597,661,310,830,26,18.47
11,0,0,11.0,-0.0,0.6077101230621338,175.2153022471871,64,183,-44,1597,661,310,830,26,19.98
11,0,0,11.0,-0.0,0.6156861782073975,164.53872816937718,64,172,-44,1597,661,310,830,26,19.02
12,0,0,12.0,-0.0,0.6237270832061768,152.93974810153233,64,160,-44,1597,661,310,830,26,18.92
13,0,0,13.0,-0.0,0.6317591667175293,140.44380078712857,64,147,-44,1597,661,310,830,26,18.52
14,-1,0,14.0,-1.0,0.6397011280059814,126.77839604173457,64,133,-43,1597,661,310,830,26,18.43
13,0,0,13.0,-0.0,0.6476950645446777,114.47156545677157,64,120,-43,1597,661,310,830,26,15.71
13,-2,0,13.0,-2.0,0.6558680534362793,101.58621208504974,64,107,-41,1597,661,310,830,26,15.53
14,0,0,14.0,-0.0,0.6637370586395264,88.6366075781753,64,93,-41,1597,661,310,830,26,13.29
14,-2,0,14.0,-2.0,0.6717209815979004,75.10221336606703,64,79,-39,1597,661,310,830,26,12.56
14,-1,0,14.0,-1.0,0.6796870231628418,62.29276193632427,64,65,-38,1597,661,310,830,26,10.28
10,0,0,10.0,-0.0,0.6877040863037109,53.85057965343307,64,55,-38,1597,661,310,830,26,6.94
7,0,0,7.0,-0.0,0.6958270072937012,48.220911460055866,64,48,-38,1597,661,310,830,26,4.88
4,-1,0,4.0,-1.0,0.7037169933319092,44.48912940721924,64,44,-37,1597,661,310,830,26,4.22
1,0,0,1.0,-0.0,0.7117149829864502,43.72741841473134,64,43,-37,1597,661,310,830,26,1.74
1,-1,0,1.0,-1.0,0.7197000980377197,42.31726674375732,64,42,-36,1597,661,310,830,26,5.16
1,-1,0,1.0,-1.0,0.727694034576416,40.907327887774215,64,41,-35,1597,661,310,830,26,5.1
1,-1,0,1.0,-1.0,0.7357981204986572,39.49761899362675,64,40,-34,1597,661,310,830,26,5.04
1,-2,0,1.0,-2.0,0.7436909675598145,37.44799302251776,64,39,-32,1597,661,310,830,26,3.13
1,-1,0,1.0,-1.0,0.7516980171203613,36.040799340956916,64,38,-31,1597,661,310,830,26,4.69
0,-1,0,-0.0,-1.0,0.7597119808197021,35.41487374764082,64,38,-30,1597,661,310,830,26,1.21
0,-1,0,-0.0,-1.0,0.7677030563354492,34.80167361086848,64,38,-29,1597,661,310,830,26,1.17
0,-2,0,-0.0,-2.0,0.77577805519104,33.61544808322666,64,38,-27,1597,661,310,830,26,1.34
0,-1,0,-0.0,-1.0,0.7917230129241943,33.04345773288535,64,38,-26,1597,661,310,830,26,1.04
0,-2,0,-0.0,-2.0,0.7996900081634521,31.944410108488462,64,38,-24,1597,661,310,830,26,1.17
-1,-1,0,-1.0,-1.0,0.8081569671630859,32.27692569068709,64,39,-23,1597,661,310,830,26,2.14
0,-1,0,-0.0,-1.0,0.8158650398254395,31.77722635447622,64,39,-22,1597,661,310,830,26,0.86
0,-1,0,-0.0,-1.0,0.8236961364746094,31.294469180700204,64,39,-21,1597,661,310,830,26,0.82
1,-2,0,1.0,-2.0,0.8317101001739502,29.485291572496003,64,38,-19,1597,661,310,830,26,2.15
0,-1,0,-0.0,-1.0,0.8397071361541748,29.04759208325728,64,38,-18,1597,661,310,830,26,0.7
1,-1,0,1.0,-1.0,0.8476951122283936,27.718546143004666,64,37,-17,1597,661,310,830,26,2.78
1,-1,0,1.0,-1.0,0.8556890487670898,26.395431207184416,64,36,-16,1597,661,310,830,26,2.69
1,-1,0,1.0,-1.0,0.8637161254882812,25.078865529319543,64,35,-15,1597,661,310,830,26,2.61
2,-2,0,2.0,-2.0,0.8717000484466553,22.4682957019364,64,33,-13,1597,661,310,830,26,2.88
3,-2,0,3.0,-2.0,0.8800649642944336,18.953090617340916,64,30,-11,1597,661,310,830,26,3.8
3,-3,0,3.0,-3.0,0.8876919746398926,15.160255680657446,64,27,-8,1597,661,310,830,26,2.57
4,-2,0,4.0,-2.0,0.8957440853118896,10.769728648009426,64,23,-6,1597,661,310,830,26,3.69
2,-1,0,2.0,-1.0,0.9037079811096191,8.587033144922902,64,21,-5,1597,661,310,830,26,2.98
3,-1,0,3.0,-1.0,0.9116990566253662,5.439088914585774,64,18,-4,1597,661,310,830,26,4.05
3,0,0,3.0,-0.0,0.919741153717041,2.524174696260024,64,15,-4,1597,661,310,830,26,2.52
4,-1,0,4.0,-1.0,0.9276909828186035,-1.5982457490086208,64,11,-3,1597,661,310,830,26,5.63
3,-1,0,3.0,-1.0,0.9357421398162842,-4.753788748764679,64,8,-2,1597,661,310,830,26,3.58
3,0,0,3.0,-0.0,0.9437060356140137,-7.614835192865496,64,5,-2,1597,661,310,830,26,0.91
2,0,0,2.0,-0.0,0.9517409801483154,-9.39444872453601,64,3,-2,1597,661,310,830,26,-0.01
1,0,0,1.0,-0.0,0.959726095199585,-10.17157287525381,64,2,-2,1597,661,310,830,26,-0.35
1,0,0,1.0,-0.0,0.9836931228637695,-10.76393202250021,64,1,-2,1597,661,310,830,26,-1.04
0,0,1,-0.0,-0.0,0.9907269477844238,-10.76393202250021,64,1,-2,1597,661,310,830,26,23.9
-1,1,1,-1.0,1.0,0.07981300354003906,1370.168214127968,65,-1305,-482,290,182,1596,663,43,3.82
-2,2,1,-2.0,2.0,0.0877830982208252,1368.9874100149252,65,-1303,-484,290,182,1596,663,43,6.93
-2,2,1,-2.0,2.0,0.0958700180053711,1367.8113622807095,65,-1301,-486,290,182,1596,663,43,6.9
0,0,0,-0.0,-0.0,0.10380697250366211,1367.8113622807095,65,-1301,-486,290,182,1596,663,43,244.45
-5,3,0,-5.0,3.0,0.11178994178771973,1364.1848252128666,65,-1296,-489,290,182,1596,663,43,19.35
-7,4,0,-7.0,4.0,0.11980795860290527,1359.061592828378,65,-1289,-493,290,182,1596,663,43,26.12
-8,3,0,-8.0,3.0,0.12779903411865234,1352.672814028144,65,-1281,-496,290,182,1596,663,43,31.73
-9,3,0,-9.0,3.0,0.13578104972839355,1345.3765952328076,65,-1272,-499,290,182,1596,663,43,35.4
-13,2,0,-13.0,2.0,0.14377999305725098,1334.0210330470888,65,-1259,-501,290,182,1596,663,43,50.56
-14,4,0,-14.0,4.0,0.15177488327026367,1322.5214921987665,65,-1245,-505,290,182,1596,663,43,50.49
-17,2,0,-17.0,2.0,0.15977692604064941,1307.545445214427,65,-1228,-507,290,182,1596,663,43,61.5
-16,2,0,-16.0,2.0,0.1679821014404297,1293.5436470501845,65,-1212,-509,290,182,1596,663,43,58.19
-14,1,0,-14.0,1.0,0.1757810115814209,1281.0384018914342,65,-1198,-510,290,182,1596,663,43,53.37
-13,0,0,-13.0,-0.0,0.18378806114196777,1269.0872063546713,65,-1185,-510,290,182,1596,663,43,51.54
-11,0,0,-11.0,-0.0,0.19178104400634766,1258.9906249656674,65,-1174,-510,290,182,1596,663,43,45.12
-9,-2,0,-9.0,-2.0,0.19977807998657227,1249.9402031567024,65,-1165,-508,290,182,1596,663,43,42.3
-11,-3,0,-11.0,-3.0,0.20785808563232422,1238.6590808627548,65,-1154,-505,290,182,1596,663,43,50.08
-11,-4,0,-11.0,-4.0,0.21577787399291992,1226.9783651970895,65,-1143,-501,290,182,1596,663,43,52.14
-13,-5,0,-13.0,-5.0,0.22379589080810547,1213.0648281188473,65,-1130,-496,290,182,1596,663,43,59.04
-14,-6,0,-14.0,-6.0,0.2317790985107422,1197.8338689091306,65,-1116,-490,290,182,1596,663,43,63.76
-16,-8,0,-16.0,-8.0,0.23981404304504395,1179.9679429526834,65,-1100,-482,290,182,1596,663,43,68.81
-20,-10,0,-20.0,-10.0,0.24777007102966309,1157.636500368116,65,-1080,-472,290,182,1596,663,43,78.52
-23,-11,0,-23.0,-11.0,0.2557981014251709,1132.1565375091102,65,-1057,-461,290,182,1596,663,43,84.45
-25,-14,0,-25.0,-14.0,0.26380109786987305,1103.6479449143185,65,-1032,-447,290,182,1596,663,43,87.63
-28,-16,0,-28.0,-16.0,0.27180910110473633,1071.6010250773152,65,-1004,-431,290,182,1596,663,43,91.91
-31,-18,0,-31.0,-18.0,0.2798888683319092,1036.02317855381,65,-973,-413,290,182,1596,663,43,95.27
-33,-17,0,-33.0,-17.0,0.28777289390563965,999.0078431071008,65,-940,-396,290,182,1596,663,43,95.87
-33,-17,0,-33.0,-17.0,0.2957949638366699,962.0005086468674,65,-907,-379,290,182,1596,663,43,93.78
-35,-17,0,-35.0,-17.0,0.304271936416626,923.154648349517,65,-872,-362,290,182,1596,663,43,94.24
-33,-17,0,-33.0,-17.0,0.31185197830200195,886.1637117962777,65,-839,-345,290,182,1596,663,43,89.35
-33,-17,0,-33.0,-17.0,0.31978893280029297,849.1838886120565,65,-806,-328,290,182,1596,663,43,87.09
-32,-14,0,-32.0,-14.0,0.32779502868652344,814.2676217835814,65,-774,-314,290,182,1596,663,43,83.84
-31,-14,0,-31.0,-14.0,0.33583688735961914,780.2796016372812,65,-743,-300,290,182,1596,663,43,80.24
-29,-15,0,-29.0,-15.0,0.34380507469177246,747.7789018957271,65,-714,-285,290,182,1596,663,43,75.38
-29,-15,0,-29.0,-15.0,0.35201501846313477,715.2913825381905,65,-685,-270,290,182,1596,663,43,73.33
-27,-14,0,-27.0,-14.0,0.3597750663757324,685.0453243241541,65,-658,-256,290,182,1596,663,43,68.64
-26,-13,0,-26.0,-13.0,0.3678169250488281,656.1063431987623,65,-632,-243,290,182,1596,663,43,65.37
-26,-13,0,-26.0,-13.0,0.375885009765625,627.1789876261032,65,-606,-230,290,182,1596,663,43,63.53
-27,-12,0,-27.0,-12.0,0.383807897567749,597.6800465507191,65,-579,-218,290,182,1596,663,43,63.03
-25,-11,0,-25.0,-11.0,0.39177393913269043,570.4093337105866,65,-554,-207,290,182,1596,663,43,58.66
-25,-9,0,-25.0,-9.0,0.39984703063964844,543.8406855034435,65,-529,-198,290,182,1596,663,43,57.61
-23,-10,0,-23.0,-10.0,0.40784287452697754,518.7962578603153,65,-506,-188,290,182,1596,663,43,52.77
-21,-8,0,-21.0,-8.0,0.41577792167663574,496.3248495867949,65,-485,-180,290,182,1596,663,43,49.85
-18,-8,0,-18.0,-8.0,0.4239521026611328,476.6675597223512,65,-467,-172,290,182,1596,663,43,43.15
-17,-8,0,-17.0,-8.0,0.4317939281463623,457.95302483646554,65,-450,-164,290,182,1596,663,43,40.44
-15,-7,0,-15.0,-7.0,0.4398000240325928,441.4651338209184,65,-435,-157,290,182,1596,663,43,36.47
-12,-7,0,-12.0,-7.0,0.44787096977233887,427.808422380864,65,-423,-150,290,182,1596,663,43,30.68
-11,-6,0,-11.0,-6.0,0.4558439254760742,415.4401448079679,65,-412,-144,290,182,1596,663,43,28.33
-11,-6,0,-11.0,-6.0,0.4637889862060547,403.08136011855083,65,-401,-138,290,182,1596,663,43,27.74
-12,-6,0,-12.0,-6.0,0.4717888832092285,389.78583227759935,65,-389,-132,290,182,1596,663,43,28.82
-16,-6,0,-16.0,-6.0,0.47988104820251465,372.70674365573166,65,-373,-126,290,182,1596,663,43,34.71
-16,-6,0,-16.0,-6.0,0.4877800941467285,355.6284641393956,65,-357,-120,290,182,1596,663,43,33.68
-19,-7,0,-19.0,-7.0,0.49610209465026855,335.38883259720694,65,-338,-113,290,182,1596,663,43,36.07
-17,-5,0,-17.0,-5.0,0.5037949085235596,317.6812660895196,65,-321,-108,290,182,1596,663,43,31.99
-16,-5,0,-16.0,-5.0,0.5117979049682617,300.9223508860483,65,-305,-103,290,182,1596,663,43,30.47
-14,-5,0,-14.0,-5.0,0.5197999477386475,286.05862632402955,65,-291,-98,290,182,1596,663,43,27.73
-12,-4,0,-12.0,-4.0,0.528156042098999,273.4095786485216,65,-279,-94,290,182,1596,663,43,25.5
-12,-5,0,-12.0,-5.0,0.5357840061187744,260.44271175498574,65,-267,-89,290,182,1596,663,43,22.74
-9,-4,0,-9.0,-4.0,0.5437929630279541,250.64130760986995,65,-258,-85,290,182,1596,663,43,18.25
-6,-3,0,-6.0,-3.0,0.5517899990081787,244.0056603169072,65,-252,-82,290,182,1596,663,43,13.51
-5,-2,0,-5.0,-2.0,0.5597829818725586,238.63243248870123,65,-247,-80,290,182,1596,663,43,12.65
-4,-2,0,-4.0,-2.0,0.5677740573883057,234.2116768488464,65,-243,-78,290,182,1596,663,43,10.19
-4,-1,0,-4.0,-1.0,0.5758330821990967,230.09759058979438,65,-239,-77,290,182,1596,663,43,10.71
-6,-2,0,-6.0,-2.0,0.5837750434875488,223.77336456403913,65,-233,-75,290,182,1596,663,43,15.2
-8,-2,0,-8.0,-2.0,0.591789960861206,215.54597861726586,65,-225,-73,290,182,1596,663,43,15.41
-10,-3,0,-10.0,-3.0,0.6009540557861328,205.10838109190027,65,-215,-70,290,182,1596,663,43,18.47
-10,-2,0,-10.0,-2.0,0.6077909469604492,194.9837956884729,65,-205,-68,290,182,1596,663,43,15.74
-10,-2,0,-10.0,-2.0,0.6157898902893066,184.86646157157313,65,-195,-66,290,182,1596,663,43,15.17
-10,-3,0,-10.0,-3.0,0.6238548755645752,174.4328529188478,65,-185,-63,290,182,1596,663,43,16.45
-7,-2,0,-7.0,-2.0,0.6317799091339111,167.16216410320115,65,-178,-61,290,182,1596,663,43,12.82
-8,-3,0,-8.0,-3.0,0.6398050785064697,158.62182495454164,65,-170,-58,290,182,1596,663,43,14.23
-8,-2,0,-8.0,-2.0,0.647860050201416,150.40595088852663,65,-162,-56,290,182,1596,663,43,12.33
-8,-3,0,-8.0,-3.0,0.6559290885925293,141.8649747490233,65,-154,-53,290,182,1596,663,43,13.55
-8,-2,0,-8.0,-2.0,0.6637880802154541,133.65122049308243,65,-146,-51,290,182,1596,663,43,11.52
-6,-2,0,-6.0,-2.0,0.6718409061431885,127.32734070291963,65,-140,-49,290,182,1596,663,43,11.68
-5,-1,0,-5.0,-1.0,0.6797950267791748,122.27944723511465,65,-135,-48,290,182,1596,663,43,7.98
-6,-1,0,-6.0,-1.0,0.6878008842468262,116.2953021774598,65,-129,-47,290,182,1596,663,43,8.17
-7,-2,0,-7.0,-2.0,0.6958870887756348,109.034610777285,65,-122,-45,290,182,1596,663,43,9.96
-8,-1,0,-8.0,-1.0,0.7038459777832031,101.19656296312102,65,-114,-44,290,182,1596,663,43,8.4
-6,-2,0,-6.0,-2.0,0.711824893951416,94.8792474949678,65,-108,-42,290,182,1596,663,43,9.26
-6,-1,0,-6.0,-1.0,0.7197999954223633,88.9317970379817,65,-102,-41,290,182,1596,663,43,6.88
-5,-1,0,-5.0,-1.0,0.7277989387512207,83.92378186092989,65,-97,-40,290,182,1596,663,43,6.3
-5,-2,0,-5.0,-2.0,0.7360799312591553,78.53893710503444,65,-92,-38,290,182,1596,663,43,9.48
-3,-1,0,-3.0,-1.0,0.7437930107116699,75.38464608017192,65,-89,-37,290,182,1596,663,43,6.24
-4,-1,0,-4.0,-1.0,0.7517929077148438,71.30926280715278,65,-85,-36,290,182,1596,663,43,5.66
-3,-2,0,-3.0,-2.0,0.7597930431365967,67.76936408468859,65,-82,-34,290,182,1596,663,43,4.98
-5,-3,0,-5.0,-3.0,0.7678940296173096,62.006023877788536,65,-77,-31,290,182,1596,663,43,6.14
-4,-3,0,-4.0,-3.0,0.7758119106292725,57.18567643756751,65,-73,-28,290,182,1596,663,43,4.76
-5,-3,0,-5.0,-3.0,0.7839078903198242,51.449982746719826,65,-68,-25,290,182,1596,663,43,5.44
-5,-3,0,-5.0,-3.0,0.7917819023132324,45.730802482811484,65,-63,-22,290,182,1596,663,43,5.07
-4,-3,0,-4.0,-3.0,0.7999711036682129,40.98386886924694,65,-59,-19,290,182,1596,663,43,3.87
-4,-3,0,-4.0,-3.0,0.8078229427337646,36.28001396647874,65,-55,-16,290,182,1596,663,43,3.55
-4,-2,0,-4.0,-2.0,0.8157839775085449,31.886671288709408,65,-51,-14,290,182,1596,663,43,4.16
-5,-3,0,-5.0,-3.0,0.8237779140472412,26.296934361541872,65,-46,-11,290,182,1596,663,43,3.58
-5,-3,0,-5.0,-3.0,0.8318960666656494,20.773197148410844,65,-41,-8,290,182,1596,663,43,3.11
-3,-2,0,-3.0,-2.0,0.8399279117584229,17.470768123342687,65,-38,-6,290,182,1596,663,43,2.28
-4,-1,0,-4.0,-1.0,0.8478009700775146,13.365680554879162,65,-34,-5,290,182,1596,663,43,4.28
-3,-1,0,-3.0,-1.0,0.8557829856872559,10.256999216175569,65,-31,-4,290,182,1596,663,43,3.14
-3,0,0,-3.0,-0.0,0.8637809753417969,7.284271247461902,65,-28,-4,290,182,1596,663,43,3.44
-3,-1,0,-3.0,-1.0,0.8717949390411377,4.179356624028344,65,-25,-3,290,182,1596,663,43,2.82
-5,-2,0,-5.0,-2.0,0.8798511028289795,-0.9750156054992125,65,-20,-1,290,182,1596,663,43,1.91
-3,0,0,-3.0,-0.0,0.8877918720245361,-3.9706136340735974,65,-17,-1,290,182,1596,663,43,4.09
-2,0,0,-2.0,-0.0,0.8957850933074951,-5.966703621627092,65,-15,-1,290,182,1596,663,43,3.88
-4,-1,0,-4.0,-1.0,0.9038000106811523,-10.0,65,-11,0,290,182,1596,663,43,1.66
-2,0,0,-2.0,-0.0,0.9118130207061768,-12.0,65,-9,0,290,182,1596,663,43,6.95
-1,0,0,-1.0,-0.0,0.9198288917541504,-13.0,65,-8,0,290,182,1596,663,43,6.8
-1,-1,0,-1.0,-1.0,0.9277908802032471,-13.928932188134524,65,-7,1,290,182,1596,663,43,-0.21
0,0,1,-0.0,-0.0,0.934777021408081,-13.928932188134524,65,-7,1,290,182,1596,663,43,23.05
0,0,0,-0.0,-0.0,0.07978653907775879,968.3012496258282,66,414,915,711,1096,297,181,73,201.88
1,0,0,1.0,-0.0,0.1098625659942627,967.8894361432439,66,413,915,711,1096,297,181,73,1.67
4,1,0,4.0,1.0,0.11784839630126953,965.3376054058891,66,409,914,711,1096,297,181,73,7.46
4,2,0,4.0,2.0,0.12579560279846191,961.8822575835287,66,405,912,711,1096,297,181,73,10.04
6,3,0,6.0,3.0,0.13382840156555176,956.7144604567821,66,399,909,711,1096,297,181,73,14.04
8,2,0,8.0,2.0,0.14181160926818848,951.6892223771605,66,391,907,711,1096,297,181,73,13.26
9,4,0,9.0,4.0,0.14979338645935059,944.4759048543723,66,382,903,711,1096,297,181,73,18.37
9,3,0,9.0,3.0,0.15784144401550293,938.2325184472134,66,373,900,711,1096,297,181,73,15.99
10,5,0,10.0,5.0,0.16585159301757812,929.8126112243514,66,363,895,711,1096,297,181,73,20.82
12,6,0,12.0,6.0,0.17379355430603027,919.7834482768574,66,351,889,711,1096,297,181,73,23.94
13,9,0,13.0,9.0,0.1820225715637207,906.6791606904228,66,338,880,711,1096,297,181,73,29.89
14,11,0,14.0,11.0,0.18980956077575684,891.4357120577146,66,324,869,711,1096,297,181,73,33.52
15,14,0,15.0,14.0,0.1978604793548584,873.1237539521228,66,309,855,711,1096,297,181,73,38.39
16,17,0,16.0,17.0,0.2057933807373047,851.7460222383427,66,293,838,711,1096,297,181,73,42.67
18,18,0,18.0,18.0,0.21378755569458008,828.8843853371386,66,275,820,711,1096,297,181,73,43.97
18,20,0,18.0,20.0,0.2218475341796875,804.2672194010665,66,257,800,711,1096,297,181,73,45.68
17,23,0,17.0,23.0,0.22978448867797852,777.2213720752794,66,240,777,711,1096,297,181,73,48.15
15,25,0,15.0,25.0,0.23783349990844727,748.938851121538,66,225,752,711,1096,297,181,73,48.98
14,23,0,14.0,23.0,0.24578857421875,722.9216033293558,66,211,729,711,1096,297,181,73,45.2
10,25,0,10.0,25.0,0.25389552116394043,696.1318187321187,66,201,704,711,1096,297,181,73,46.36
9,24,0,9.0,24.0,0.2617795467376709,670.5861589360494,66,192,680,711,1096,297,181,73,44.18
7,24,0,7.0,24.0,0.2698085308074951,645.5871184228763,66,185,656,711,1096,297,181,73,44.71
7,22,0,7.0,22.0,0.27786755561828613,622.5134774626864,66,178,634,711,1096,297,181,73,40.5
6,22,0,6.0,22.0,0.2857825756072998,599.710625992676,66,172,612,711,1096,297,181,73,40.51
6,23,0,6.0,23.0,0.29387950897216797,575.9452589897237,66,166,589,711,1096,297,181,73,40.03
6,21,0,6.0,21.0,0.3018505573272705,554.1050753891209,66,160,568,711,1096,297,181,73,38.01
7,23,0,7.0,23.0,0.3097994327545166,530.0689003999424,66,153,545,711,1096,297,181,73,38.35
6,22,0,6.0,22.0,0.3177914619445801,507.2660490036167,66,147,523,711,1096,297,181,73,36.89
6,22,0,6.0,22.0,0.325791597366333,484.4632551871457,66,141,501,711,1096,297,181,73,35.92
7,22,0,7.0,22.0,0.333890438079834,461.390188885949,66,134,479,711,1096,297,181,73,33.99
6,21,0,6.0,21.0,0.3418314456939697,439.5502076542497,66,128,458,711,1096,297,181,73,33.26
5,21,0,5.0,21.0,0.34978556632995605,417.98017577863465,66,123,437,711,1096,297,181,73,30.54
5,21,0,5.0,21.0,0.3577876091003418,396.41184072594496,66,118,416,711,1096,297,181,73,29.53
5,21,0,5.0,21.0,0.36585545539855957,374.8454697328425,66,113,395,711,1096,297,181,73,28.5
6,20,0,6.0,20.0,0.37383556365966797,353.96666524204346,66,107,375,711,1096,297,181,73,28.13
6,22,0,6.0,22.0,0.38182759284973145,331.16481312892716,66,101,353,711,1096,297,181,73,28.63
7,21,0,7.0,21.0,0.38981056213378906,309.05072090925995,66,94,332,711,1096,297,181,73,25.73
7,19,0,7.0,19.0,0.39778852462768555,288.8661262735775,66,87,313,711,1096,297,181,73,22.63
6,18,0,6.0,18.0,0.4059255123138428,269.91828974417336,66,81,295,711,1096,297,181,73,21.36
5,18,0,5.0,18.0,0.413832426071167,251.23683607782618,66,76,277,711,1096,297,181,73,22.45
4,15,0,4.0,15.0,0.421844482421875,235.7130839691015,66,72,262,711,1096,297,181,73,19.2
4,12,0,4.0,12.0,0.4302854537963867,223.0829982843336,66,68,250,711,1096,297,181,73,14.89
2,10,0,2.0,10.0,0.43782949447631836,212.90962215229848,66,66,240,711,1096,297,181,73,12.53
3,10,0,3.0,10.0,0.44579648971557617,202.47222060441337,66,63,230,711,1096,297,181,73,13.57
2,8,0,2.0,8.0,0.45377659797668457,194.2281477143922,66,61,222,711,1096,297,181,73,11.85
3,9,0,3.0,9.0,0.4620935916900635,184.75552088226468,66,58,213,711,1096,297,181,73,11.48
4,9,0,4.0,9.0,0.46978259086608887,175.02606474082768,66,54,204,711,1096,297,181,73,10.0
4,9,0,4.0,9.0,0.47785449028015137,165.30822139197394,66,50,195,711,1096,297,181,73,9.62
4,8,0,4.0,8.0,0.4857785701751709,156.57466084612483,66,46,187,711,1096,297,181,73,8.39
4,8,0,4.0,8.0,0.493788480758667,147.86136081297778,66,42,179,711,1096,297,181,73,8.05
2,7,0,2.0,7.0,0.5023884773254395,140.58992043715293,66,40,172,711,1096,297,181,73,9.04
1,6,0,1.0,6.0,0.5100805759429932,134.51979357247652,66,39,166,711,1096,297,181,73,7.92
2,6,0,2.0,6.0,0.5177834033966064,128.2224101637776,66,37,160,711,1096,297,181,73,7.44
1,6,0,1.0,6.0,0.5257925987243652,122.15182578775372,66,36,154,711,1096,297,181,73,7.65
1,6,0,1.0,6.0,0.5338644981384277,116.08221460775746,66,35,148,711,1096,297,181,73,7.46
2,6,0,2.0,6.0,0.5418045520782471,109.78408692309321,66,33,142,711,1096,297,181,73,7.0
1,6,0,1.0,6.0,0.5500013828277588,103.71399357258383,66,32,136,711,1096,297,181,73,7.19
1,6,0,1.0,6.0,0.5577735900878906,97.64505228402584,66,31,130,711,1096,297,181,73,6.98
1,6,0,1.0,6.0,0.5662875175476074,91.57742747053649,66,30,124,711,1096,297,181,73,6.78
1,6,0,1.0,6.0,0.5738205909729004,85.51131634543344,66,29,118,711,1096,297,181,73,6.56
0,6,0,-0.0,6.0,0.5817904472351074,79.69356075426151,66,29,112,711,1096,297,181,73,4.73
0,6,0,-0.0,6.0,0.5897924900054932,73.89540481748998,66,29,106,711,1096,297,181,73,4.5
0,7,0,-0.0,7.0,0.5977914333343506,67.16006979447037,66,29,99,711,1096,297,181,73,4.5
0,5,0,-0.0,5.0,0.6059935092926025,62.37174391053561,66,29,94,711,1096,297,181,73,3.77
0,5,0,-0.0,5.0,0.6137974262237549,57.60555539069249,66,29,89,711,1096,297,181,73,3.58
0,5,0,-0.0,5.0,0.6217904090881348,52.86506625215557,66,29,84,711,1096,297,181,73,3.39
0,4,0,-0.0,4.0,0.6297934055328369,49.09406559801923,66,29,80,711,1096,297,181,73,3.03
0,3,0,-0.0,3.0,0.6378655433654785,46.28000972289685,66,29,77,711,1096,297,181,73,2.74
0,4,0,-0.0,4.0,0.6457815170288086,42.54934754662193,66,29,73,711,1096,297,181,73,2.77
0,3,0,-0.0,3.0,0.6537835597991943,39.76938695805846,66,29,70,711,1096,297,181,73,2.51
0,1,0,-0.0,1.0,0.6617934703826904,38.846509604656916,66,29,69,711,1096,297,181,73,2.19
0,2,0,-0.0,2.0,0.6697773933410645,37.00684899377592,66,29,67,711,1096,297,181,73,2.27
0,1,0,-0.0,1.0,0.6779325008392334,36.09022125087424,66,29,66,711,1096,297,181,73,2.12
0,2,0,-0.0,2.0,0.6858716011047363,34.26378868236469,66,29,64,711,1096,297,181,73,2.18
-1,1,0,-1.0,1.0,0.6937954425811768,33.778220097678044,66,30,63,711,1096,297,181,73,0.43
0,2,0,-0.0,2.0,0.701784610748291,31.97793759742936,66,30,61,711,1096,297,181,73,2.05
0,2,0,-0.0,2.0,0.709864616394043,30.18912297349165,66,30,59,711,1096,297,181,73,1.98
0,2,0,-0.0,2.0,0.7178425788879395,28.41273166075166,66,30,57,711,1096,297,181,73,1.92
0,3,0,-0.0,3.0,0.7257964611053467,25.773780845922005,66,30,54,711,1096,297,181,73,1.89
0,2,0,-0.0,2.0,0.7337915897369385,24.033324079214538,66,30,52,711,1096,297,181,73,1.75
-1,2,0,-1.0,2.0,0.7417905330657959,22.83026432033091,66,31,50,711,1096,297,181,73,0.68
0,2,0,-0.0,2.0,0.7497754096984863,21.140178508646613,66,31,48,711,1096,297,181,73,1.58
0,2,0,-0.0,2.0,0.7577924728393555,19.470712993434653,66,31,46,711,1096,297,181,73,1.51
0,1,0,-0.0,1.0,0.765777587890625,18.644304369257,66,31,45,711,1096,297,181,73,1.47
-1,2,0,-1.0,2.0,0.7739624977111816,17.600373133029585,66,32,43,711,1096,297,181,73,0.49
0,1,0,-0.0,1.0,0.7817864418029785,16.80151512977634,66,32,42,711,1096,297,181,73,1.35
0,2,0,-0.0,2.0,0.7898194789886475,15.224993899462788,66,32,40,711,1096,297,181,73,1.26
-1,2,0,-1.0,2.0,0.7977855205535889,14.328918128646478,66,33,38,711,1096,297,181,73,0.34
0,1,0,-0.0,1.0,0.8057944774627686,13.578221024962161,66,33,37,711,1096,297,181,73,1.16
-1,2,0,-1.0,2.0,0.8138694763183594,12.795491595023407,66,34,35,711,1096,297,181,73,0.24
-2,1,0,-2.0,1.0,0.8217785358428955,13.51767361255979,66,36,34,711,1096,297,181,73,0.29
0,1,0,-0.0,1.0,0.8299295902252197,12.836461788299118,66,36,33,711,1096,297,181,73,0.96
-2,1,0,-2.0,1.0,0.8378665447235107,13.678969393496885,66,38,32,711,1096,297,181,73,0.32
0,0,1,-0.0,-0.0,0.844780445098877,13.678969393496885,66,38,32,711,1096,297,181,73,30.99
0,1,1,-0.0,1.0,0.845888614654541,13.040799340956916,66,38,31,711,1096,297,181,73,10.86
-1,1,1,-1.0,1.0,0.853818416595459,13.203658400570177,66,39,30,711,1096,297,181,73,11.08
-1,0,1,-1.0,-0.0,0.8697915077209473,14.0,66,40,30,711,1096,297,181,73,11.379999999999999
0,1,1,-0.0,1.0,0.8777904510498047,13.406477308142499,66,40,29,711,1096,297,181,73,10.77
-2,0,1,-2.0,-0.0,0.8859283924102783,15.039200620699383,66,42,29,711,1096,297,181,73,11.120000000000001
-1,0,1,-1.0,-0.0,0.893789529800415,15.86520991955976,66,43,29,711,1096,297,181,73,11.5
-1,0,1,-1.0,-0.0,0.9098994731903076,16.69724850502159,66,44,29,711,1096,297,181,73,11.53
0,1,1,-0.0,1.0,0.9177744388580322,16.153619241621193,66,44,28,711,1096,297,181,73,10.69
-1,0,1,-1.0,-0.0,0.9340744018554688,17.0,66,45,28,711,1096,297,181,73,11.59
0,0,0,-0.0,-0.0,0.9407744407653809,17.0,66,45,28,711,1096,297,181,73,21.99
0,-1,0,-0.0,-1.0,0.9817914962768555,17.53503525729669,66,45,29,711,1096,297,181,73,0.94
1,0,0,1.0,-0.0,0.989823579788208,16.69724850502159,66,44,29,711,1096,297,181,73,1.51
1,-2,0,1.0,-2.0,0.9978303909301758,17.009433122794285,66,43,31,711,1096,297,181,73,0.53
1,0,0,1.0,-0.0,1.0061275959014893,16.201532544552748,66,42,31,711,1096,297,181,73,1.38
0,-1,0,-0.0,-1.0,1.0137884616851807,16.80151512977634,66,42,32,711,1096,297,181,73,1.0
0,0,1,-0.0,-0.0,1.0957953929901123,16.80151512977634,66,42,32,711,1096,297,181,73,31.93
0,0,0,-0.0,-0.0,0.07591390609741211,366.4932777910524,67,-257,-294,412,770,669,1064,48,110.65
0,-2,0,-0.0,-2.0,0.1939547061920166,364.98971708774,67,-257,-292,412,770,669,1064,48,4.33
0,-2,0,-0.0,-2.0,0.20189690589904785,363.4906450483676,67,-257,-290,412,770,669,1064,48,4.31
0,-4,0,-0.0,-4.0,0.20993781089782715,360.50617680344226,67,-257,-286,412,770,669,1064,48,7.12
1,-5,0,1.0,-5.0,0.21796083450317383,357.4773912042495,67,-258,-281,412,770,669,1064,48,6.79
0,-6,0,-0.0,-6.0,0.22596287727355957,353.07956720034565,67,-258,-275,412,770,669,1064,48,9.51
1,-8,0,1.0,-8.0,0.2339317798614502,347.9811823197512,67,-259,-267,412,770,669,1064,48,10.34
0,-11,0,-0.0,-11.0,0.241912841796875,340.16617086159994,67,-259,-256,412,770,669,1064,48,14.62
-2,-12,0,-2.0,-12.0,0.24990081787109375,330.37973982720854,67,-257,-244,412,770,669,1064,48,17.42
-5,-14,0,-5.0,-14.0,0.25790977478027344,317.18030423809637,67,-252,-230,412,770,669,1064,48,21.6
-8,-17,0,-8.0,-17.0,0.265927791595459,299.8904135660702,67,-244,-213,412,770,669,1064,48,25.36
-10,-18,0,-10.0,-18.0,0.2739217281341553,280.59973736035954,67,-234,-195,412,770,669,1064,48,26.2
-12,-22,0,-12.0,-22.0,0.28191590309143066,257.4480413859723,67,-222,-173,412,770,669,1064,48,27.55
-14,-23,0,-14.0,-23.0,0.2899188995361328,232.44492586128507,67,-208,-150,412,770,669,1064,48,26.88
-11,-17,0,-11.0,-17.0,0.2979607582092285,213.6930794112441,67,-197,-133,412,770,669,1064,48,21.11
-11,-14,0,-11.0,-14.0,0.3059258460998535,196.80987296767324,67,-186,-119,412,770,669,1064,48,18.85
-9,-10,0,-9.0,-10.0,0.3139057159423828,183.87015177749788,67,-177,-109,412,770,669,1064,48,15.31
-9,-9,0,-9.0,-9.0,0.321915864944458,171.50959055759898,67,-168,-100,412,770,669,1064,48,14.37
-11,-8,0,-11.0,-8.0,0.32990384101867676,157.96977771047588,67,-157,-92,412,770,669,1064,48,15.68
-10,-8,0,-10.0,-8.0,0.33815979957580566,145.30741271426953,67,-147,-84,412,770,669,1064,48,13.73
-12,-7,0,-12.0,-7.0,0.34589481353759766,131.4155719353759,67,-135,-77,412,770,669,1064,48,16.7
-14,-8,0,-14.0,-8.0,0.3539109230041504,115.29106216839614,67,-121,-69,412,770,669,1064,48,17.73
-14,-7,0,-14.0,-7.0,0.3619248867034912,99.664869708418,67,-107,-62,412,770,669,1064,48,13.5
-15,-6,0,-15.0,-6.0,0.36995887756347656,83.70329614269008,67,-92,-56,412,770,669,1064,48,11.07
-14,-6,0,-14.0,-6.0,0.377896785736084,68.64987857520376,67,-78,-50,412,770,669,1064,48,9.57
-15,-6,0,-15.0,-6.0,0.38591575622558594,52.84399781375251,67,-63,-44,412,770,669,1064,48,8.05
-14,-4,0,-14.0,-4.0,0.3939197063446045,39.25345840347388,67,-49,-40,412,770,669,1064,48,5.55
-11,-3,0,-11.0,-3.0,0.4019358158111572,29.037722424704477,67,-38,-37,412,770,669,1064,48,3.75
-7,-1,0,-7.0,-1.0,0.4101889133453369,23.507894080878813,67,-31,-36,412,770,669,1064,48,1.98
-4,-1,0,-4.0,-1.0,0.4179108142852783,20.204072210600685,67,-27,-35,412,770,669,1064,48,1.63
-1,0,0,-1.0,-0.0,0.4259169101715088,19.60045871318328,67,-26,-35,412,770,669,1064,48,0.85
-1,0,0,-1.0,-0.0,0.4339158535003662,19.011626335213137,67,-25,-35,412,770,669,1064,48,0.81
-1,0,0,-1.0,-0.0,0.4419078826904297,18.43819034784589,67,-24,-35,412,770,669,1064,48,0.78
-1,0,0,-1.0,-0.0,0.44989871978759766,17.880783182743848,67,-23,-35,412,770,669,1064,48,0.74
-2,-1,0,-2.0,-1.0,0.45798492431640625,15.962482405376171,67,-21,-34,412,770,669,1064,48,1.66
-2,0,0,-2.0,-0.0,0.46590185165405273,14.948684188300895,67,-19,-34,412,770,669,1064,48,0.55
-2,-1,0,-2.0,-1.0,0.4739067554473877,13.12142238654117,67,-17,-33,412,770,669,1064,48,1.39
-2,0,0,-2.0,-0.0,0.4819157123565674,12.249137920783717,67,-15,-33,412,770,669,1064,48,0.37
0,-1,0,-0.0,-1.0,0.4899628162384033,11.341194094144583,67,-15,-32,412,770,669,1064,48,1.89
-1,0,0,-1.0,-0.0,0.5379137992858887,10.928498393145958,67,-14,-32,412,770,669,1064,48,0.42
0,0,1,-0.0,-0.0,0.5699267387390137,10.928498393145958,67,-14,-32,412,770,669,1064,48,30.16
0,0,0,-0.0,-0.0,0.05629920959472656,1285.766822720801,68,1320,45,1746,847,426,802,71,236.43
1,0,0,1.0,-0.0,0.13828516006469727,1284.7674037496154,68,1319,45,1746,847,426,802,71,8.26
3,1,0,3.0,1.0,0.14627623558044434,1281.7353568580133,68,1316,44,1746,847,426,802,71,11.88
4,1,0,4.0,1.0,0.15466928482055664,1277.7044602651429,68,1312,43,1746,847,426,802,71,15.19
7,1,0,7.0,1.0,0.16241025924682617,1270.6756871443995,68,1305,42,1746,847,426,802,71,24.28
11,1,0,11.0,1.0,0.17032217979431152,1259.649373382616,68,1294,41,1746,847,426,802,71,34.97
13,2,0,13.0,2.0,0.17829108238220215,1246.593539309558,68,1281,39,1746,847,426,802,71,38.61
15,3,0,15.0,3.0,0.18629026412963867,1231.5117449119846,68,1266,36,1746,847,426,802,71,42.39
18,3,0,18.0,3.0,0.19436025619506836,1213.4362218391454,68,1248,33,1746,847,426,802,71,48.46
18,2,0,18.0,2.0,0.20229530334472656,1195.3905883905322,68,1230,31,1746,847,426,802,71,48.63
22,2,0,22.0,2.0,0.21029114723205566,1173.3480458874421,68,1208,29,1746,847,426,802,71,55.91
27,1,0,27.0,1.0,0.2182941436767578,1146.331875469379,68,1181,28,1746,847,426,802,71,65.07
30,0,0,30.0,-0.0,0.2263021469116211,1116.3405230425967,68,1151,28,1746,847,426,802,71,68.2
33,-2,0,33.0,-2.0,0.23433208465576172,1083.4024320431354,68,1118,30,1746,847,426,802,71,69.85
38,-1,0,38.0,-1.0,0.24228930473327637,1045.4448158050461,68,1080,31,1746,847,426,802,71,75.43
37,-2,0,37.0,-2.0,0.2503070831298828,1008.5219211880506,68,1043,33,1746,847,426,802,71,72.17
38,0,0,38.0,-0.0,0.2583041191101074,970.5416450848767,68,1005,33,1746,847,426,802,71,72.97
38,0,0,38.0,-0.0,0.2663092613220215,932.5629178508239,68,967,33,1746,847,426,802,71,71.33
40,0,0,40.0,-0.0,0.27432727813720703,892.587192667083,68,927,33,1746,847,426,802,71,71.72
38,2,0,38.0,2.0,0.2822742462158203,854.5403307326768,68,889,31,1746,847,426,802,71,68.59
37,2,0,37.0,2.0,0.29028820991516113,817.4934017339958,68,852,29,1746,847,426,802,71,65.74
38,2,0,38.0,2.0,0.29833316802978516,779.4476655992084,68,814,27,1746,847,426,802,71,65.04
37,2,0,37.0,2.0,0.30687713623046875,742.402083866515,68,777,25,1746,847,426,802,71,62.15
36,2,0,36.0,2.0,0.3142890930175781,706.3568641349455,68,741,23,1746,847,426,802,71,59.3
37,3,0,37.0,3.0,0.32233214378356934,669.28403361144,68,704,20,1746,847,426,802,71,57.62
34,2,0,34.0,2.0,0.3302891254425049,635.2417474314772,68,670,18,1746,847,426,802,71,53.58
34,1,0,34.0,1.0,0.33846521377563477,601.227160690268,68,636,17,1746,847,426,802,71,53.42
35,1,0,35.0,1.0,0.346332311630249,566.2129406458248,68,601,16,1746,847,426,802,71,52.57
32,1,0,32.0,1.0,0.35428428649902344,534.1976809510031,68,569,15,1746,847,426,802,71,47.94
30,0,0,30.0,-0.0,0.3622891902923584,504.20867945536634,68,539,15,1746,847,426,802,71,43.33
30,-1,0,30.0,-1.0,0.3702962398529053,474.25141138734216,68,509,16,1746,847,426,802,71,40.78
26,-1,0,26.0,-1.0,0.37832021713256836,448.2990792459675,68,483,17,1746,847,426,802,71,35.81
25,-1,0,25.0,-1.0,0.3863832950592041,423.35357531058924,68,458,18,1746,847,426,802,71,33.6
23,-1,0,23.0,-1.0,0.3942732810974121,400.41474481234553,68,435,19,1746,847,426,802,71,30.61
19,-2,0,19.0,-2.0,0.4023561477661133,381.52971082505024,68,416,21,1746,847,426,802,71,25.37
17,-1,0,17.0,-1.0,0.41057419776916504,364.60605601016607,68,399,22,1746,847,426,802,71,23.28
16,-1,0,16.0,-1.0,0.41829919815063477,348.6899790195204,68,383,23,1746,847,426,802,71,21.64
13,-1,0,13.0,-1.0,0.42629027366638184,335.7775613491194,68,370,24,1746,847,426,802,71,18.16
13,-1,0,13.0,-1.0,0.43429112434387207,322.8742796010912,68,357,25,1746,847,426,802,71,17.68
11,-1,0,11.0,-1.0,0.4423072338104248,311.9755034580972,68,346,26,1746,847,426,802,71,15.28
13,-1,0,13.0,-1.0,0.4503812789916992,299.0928014788705,68,333,27,1746,847,426,802,71,16.76
12,-2,0,12.0,-2.0,0.4582841396331787,287.3073067741406,68,321,29,1746,847,426,802,71,14.75
10,-1,0,10.0,-1.0,0.4662802219390869,277.44359490954525,68,311,30,1746,847,426,802,71,13.1
11,-1,0,11.0,-1.0,0.47431516647338867,266.59741378201505,68,300,31,1746,847,426,802,71,13.66
10,0,0,10.0,-0.0,0.48259711265563965,256.65219011692676,68,290,31,1746,847,426,802,71,13.39
9,0,0,9.0,-0.0,0.49029016494750977,247.70479302622374,68,281,31,1746,847,426,802,71,12.25
8,0,0,8.0,-0.0,0.4982922077178955,239.75443581496552,68,273,31,1746,847,426,802,71,11.17
10,0,0,10.0,-0.0,0.5062851905822754,229.82069405543064,68,263,31,1746,847,426,802,71,12.45
10,0,0,10.0,-0.0,0.5142900943756104,219.8921340488953,68,253,31,1746,847,426,802,71,12.1
12,1,0,12.0,1.0,0.5223851203918457,207.86004199950224,68,241,30,1746,847,426,802,71,14.53
13,1,0,13.0,1.0,0.5302863121032715,194.83689869122406,68,228,29,1746,847,426,802,71,14.45
13,0,0,13.0,-0.0,0.5383942127227783,181.9469981354893,68,215,29,1746,847,426,802,71,12.6
12,0,0,12.0,-0.0,0.5465691089630127,170.0609665440988,68,203,29,1746,847,426,802,71,11.45
10,0,0,10.0,-0.0,0.5542902946472168,160.1665955024066,68,193,29,1746,847,426,802,71,9.87
10,0,0,10.0,-0.0,0.5623161792755127,150.28356645962967,68,183,29,1746,847,426,802,71,9.45
9,0,0,9.0,-0.0,0.5702941417694092,141.40011337864837,68,174,29,1746,847,426,802,71,8.55
7,0,0,7.0,-0.0,0.5782821178436279,134.49926253526885,68,167,29,1746,847,426,802,71,7.23
6,0,0,6.0,-0.0,0.5863451957702637,128.59095329510126,68,161,29,1746,847,426,802,71,6.51
6,1,0,6.0,1.0,0.5943231582641602,122.50872991678906,68,155,28,1746,847,426,802,71,9.3
5,0,0,5.0,-0.0,0.6022791862487793,117.5909564816998,68,150,28,1746,847,426,802,71,5.71
3,0,0,3.0,-0.0,0.6102862358093262,114.64290828502365,68,147,28,1746,847,426,802,71,4.64
3,0,0,3.0,-0.0,0.6182982921600342,111.69696656713799,68,144,28,1746,847,426,802,71,4.58
1,0,0,1.0,-0.0,0.6262822151184082,110.71547618561317,68,143,28,1746,847,426,802,71,3.56
2,0,0,2.0,-0.0,0.634345293045044,108.75326083258076,68,141,28,1746,847,426,802,71,4.03
2,1,0,2.0,1.0,0.6423172950744629,106.59802258506295,68,139,27,1746,847,426,802,71,3.66
4,0,0,4.0,-0.0,0.6502912044525146,102.6735268670052,68,135,27,1746,847,426,802,71,4.87
4,0,0,4.0,-0.0,0.6582832336425781,98.75350462698165,68,131,27,1746,847,426,802,71,4.76
4,0,0,4.0,-0.0,0.6662952899932861,94.83836104942176,68,127,27,1746,847,426,802,71,4.65
4,1,0,4.0,1.0,0.674328088760376,90.7179382586272,68,123,26,1746,847,426,802,71,6.82
6,0,0,6.0,-0.0,0.6822841167449951,84.85407794480753,68,117,26,1746,847,426,802,71,5.14
5,0,0,5.0,-0.0,0.6903042793273926,79.97825881443848,68,112,26,1746,847,426,802,71,4.61
6,0,0,6.0,-0.0,0.6983160972595215,74.14210919713803,68,106,26,1746,847,426,802,71,4.72
5,0,0,5.0,-0.0,0.7063302993774414,69.29285689825551,68,101,26,1746,847,426,802,71,4.23
7,0,0,7.0,-0.0,0.714285135269165,62.529482721892876,68,94,26,1746,847,426,802,71,4.5
6,0,0,6.0,-0.0,0.722283124923706,56.76055797563569,68,88,26,1746,847,426,802,71,3.98
5,-1,0,5.0,-1.0,0.7302792072296143,52.28115489611719,68,83,27,1746,847,426,802,71,2.72
5,0,0,5.0,-0.0,0.7382831573486328,47.54089895318563,68,78,27,1746,847,426,802,71,3.29
3,-1,0,3.0,-1.0,0.7462971210479736,45.05623023850174,68,75,28,1746,847,426,802,71,1.74
2,0,0,2.0,-0.0,0.7542881965637207,43.18567643756751,68,73,28,1746,847,426,802,71,2.51
2,0,0,2.0,-0.0,0.76228928565979,41.321687612368734,68,71,28,1746,847,426,802,71,2.45
1,0,0,1.0,-0.0,0.7703173160552979,40.39230729988306,68,70,28,1746,847,426,802,71,2.27
1,0,0,1.0,-0.0,0.7782812118530273,39.46475676452586,68,69,28,1746,847,426,802,71,2.25
1,-1,0,1.0,-1.0,0.7862911224365234,38.92563831310488,68,68,29,1746,847,426,802,71,0.52
1,0,0,1.0,-0.0,0.7942702770233154,38.00684899377592,68,67,29,1746,847,426,802,71,2.16
1,0,0,1.0,-0.0,0.8023602962493896,37.09022125087424,68,66,29,1746,847,426,802,71,2.13
0,0,1,-0.0,-0.0,0.8056972026824951,37.09022125087424,68,66,29,1746,847,426,802,71,38.120000000000005
1,0,1,1.0,-0.0,0.8103542327880859,36.175838597096984,68,65,29,1746,847,426,802,71,12.11
1,0,1,1.0,-0.0,0.8182811737060547,35.26378868236469,68,64,29,1746,847,426,802,71,12.08
1,0,1,1.0,-0.0,0.8267312049865723,34.35416353759881,68,63,29,1746,847,426,802,71,12.06
1,0,1,1.0,-0.0,0.8346631526947021,33.447059834590405,68,62,29,1746,847,426,802,71,12.03
1,0,1,1.0,-0.0,0.8423612117767334,32.54257916307313,68,61,29,1746,847,426,802,71,12.01
2,0,1,2.0,-0.0,0.8502931594848633,30.741919655574407,68,59,29,1746,847,426,802,71,12.04
4,0,1,4.0,-0.0,0.8582942485809326,27.177166226839255,68,55,29,1746,847,426,802,71,12.08
3,0,1,3.0,-0.0,0.8662762641906738,24.539902586416787,68,52,29,1746,847,426,802,71,11.870000000000001
3,0,1,3.0,-0.0,0.8742733001708984,21.938563381947034,68,49,29,1746,847,426,802,71,11.75
2,0,1,2.0,-0.0,0.882310152053833,20.226805085936306,68,47,29,1746,847,426,802,71,11.629999999999999
2,0,1,2.0,-0.0,0.890343189239502,18.53503525729669,68,45,29,1746,847,426,802,71,11.56
2,1,1,2.0,1.0,0.8982782363891602,16.312766442669997,68,43,28,1746,847,426,802,71,13.79
0,0,0,-0.0,-0.0,0.9032630920410156,16.312766442669997,68,43,28,1746,847,426,802,71,21.78
1,0,0,1.0,-0.0,0.906365156173706,15.47771785649585,68,42,28,1746,847,426,802,71,1.49
1,0,0,1.0,-0.0,0.9143002033233643,14.648766349225639,68,41,28,1746,847,426,802,71,1.45
0,0,1,-0.0,-0.0,1.0093281269073486,14.648766349225639,68,41,28,1746,847,426,802,71,31.28
0,0,0,-0.0,-0.0,0.11123132705688477,505.6486844522975,69,-125,-526,1580,293,1705,819,70,136.31
-4,0,0,-4.0,-0.0,0.20826220512390137,504.73789935486275,69,-121,-526,1580,293,1705,819,70,1.95
-5,0,0,-5.0,-0.0,0.21625232696533203,503.6390256934601,69,-116,-526,1580,293,1705,819,70,2.26
-6,-2,0,-6.0,-2.0,0.22429418563842773,500.42132942197964,69,-110,-524,1580,293,1705,819,70,6.26
-6,-5,0,-6.0,-5.0,0.23222923278808594,494.31748506921633,69,-104,-519,1580,293,1705,819,70,11.41
-6,-10,0,-6.0,-10.0,0.24024629592895508,483.3483384751995,69,-98,-509,1580,293,1705,819,70,19.04
-7,-16,0,-7.0,-16.0,0.24822616577148438,466.32823578968697,69,-91,-493,1580,293,1705,819,70,26.48
-7,-21,0,-7.0,-21.0,0.25626635551452637,444.4163117792301,69,-84,-472,1580,293,1705,819,70,31.32
-6,-23,0,-6.0,-23.0,0.26423120498657227,420.7246975971348,69,-78,-449,1580,293,1705,819,70,32.61
-4,-23,0,-4.0,-23.0,0.2722792625427246,397.3794629720519,69,-74,-426,1580,293,1705,819,70,34.14
-4,-21,0,-4.0,-21.0,0.280245304107666,376.0048661512416,69,-70,-405,1580,293,1705,819,70,30.14
-3,-22,0,-3.0,-22.0,0.28832125663757324,353.8161519278745,69,-67,-383,1580,293,1705,819,70,28.99
-2,-21,0,-2.0,-21.0,0.29635024070739746,332.78934187928826,69,-65,-362,1580,293,1705,819,70,26.08
-2,-24,0,-2.0,-24.0,0.30422329902648926,308.8211744497421,69,-63,-338,1580,293,1705,819,70,26.79
-1,-25,0,-1.0,-25.0,0.312225341796875,284.0814942926023,69,-62,-313,1580,293,1705,819,70,25.32
-2,-25,0,-2.0,-25.0,0.3202223777770996,259.1836161311503,69,-60,-288,1580,293,1705,819,70,24.21
0,-23,0,-0.0,-23.0,0.32828521728515625,236.70756338387048,69,-60,-265,1580,293,1705,819,70,20.6
0,-21,0,-0.0,-21.0,0.3362092971801758,216.26878039263056,69,-60,-244,1580,293,1705,819,70,18.1
1,-18,0,1.0,-18.0,0.3442251682281494,199.08759044426085,69,-61,-226,1580,293,1705,819,70,14.87
1,-16,0,1.0,-16.0,0.3522152900695801,183.96118377465902,69,-62,-210,1580,293,1705,819,70,12.8
0,-17,0,-0.0,-17.0,0.36035919189453125,167.71408436514716,69,-62,-193,1580,293,1705,819,70,12.77
0,-16,0,-0.0,-16.0,0.3683602809906006,152.5446613476374,69,-62,-177,1580,293,1705,819,70,11.34
0,-15,0,-0.0,-15.0,0.37623119354248047,138.4589288563722,69,-62,-162,1580,293,1705,819,70,10.0
0,-14,0,-0.0,-14.0,0.3843703269958496,125.46183346827368,69,-62,-148,1580,293,1705,819,70,8.77
0,-13,0,-0.0,-13.0,0.3922722339630127,113.55638660118251,69,-62,-135,1580,293,1705,819,70,7.63
0,-10,0,-0.0,-10.0,0.4002552032470703,104.53135848260061,69,-62,-125,1580,293,1705,819,70,5.97
0,-10,0,-0.0,-10.0,0.40822935104370117,95.64838307457157,69,-62,-115,1580,293,1705,819,70,5.49
1,-9,0,1.0,-9.0,0.4162273406982422,88.30855606972291,69,-63,-106,1580,293,1705,819,70,4.25
1,-7,0,1.0,-7.0,0.42421722412109375,82.88553770501282,69,-64,-99,1580,293,1705,819,70,3.24
0,-7,0,-0.0,-7.0,0.43222618103027344,77.0714058089752,69,-64,-92,1580,293,1705,819,70,3.48
0,-6,0,-0.0,-6.0,0.440258264541626,72.20074626605917,69,-64,-86,1580,293,1705,819,70,2.98
-1,-6,0,-1.0,-6.0,0.4482433795928955,66.82828683622247,69,-63,-80,1580,293,1705,819,70,3.37
-2,-6,0,-2.0,-6.0,0.45623016357421875,60.90099061010788,69,-61,-74,1580,293,1705,819,70,3.82
-4,-6,0,-4.0,-6.0,0.46425437927246094,53.72992730753249,69,-57,-68,1580,293,1705,819,70,5.59
-4,-4,0,-4.0,-4.0,0.4726133346557617,48.09632964216891,69,-53,-64,1580,293,1705,819,70,5.25
-2,-4,0,-2.0,-4.0,0.4802262783050537,43.746428490440124,69,-51,-60,1580,293,1705,819,70,3.6
-3,-4,0,-3.0,-4.0,0.4882333278656006,38.7563556583431,69,-48,-56,1580,293,1705,819,70,5.33
-3,-4,0,-3.0,-4.0,0.4962751865386963,33.76772498781678,69,-45,-52,1580,293,1705,819,70,5.11
-3,-3,0,-3.0,-3.0,0.5042293071746826,29.536811201050213,69,-42,-49,1580,293,1705,819,70,4.77
-4,-4,0,-4.0,-4.0,0.512263298034668,23.89821729050889,69,-38,-45,1580,293,1705,819,70,4.68
-4,-5,0,-4.0,-5.0,0.5202553272247314,17.49761899362675,69,-34,-40,1580,293,1705,819,70,5.81
-4,-5,0,-4.0,-5.0,0.5282151699066162,11.097722286464439,69,-30,-35,1580,293,1705,819,70,5.44
-5,-5,0,-5.0,-5.0,0.5362582206726074,4.05124837953327,69,-25,-30,1580,293,1705,819,70,3.95
-4,-5,0,-4.0,-5.0,0.5442671775817871,-2.350344565370982,69,-21,-25,1580,293,1705,819,70,5.31
-4,-5,0,-4.0,-5.0,0.5522332191467285,-8.751190503186624,69,-17,-20,1580,293,1705,819,70,4.78
-3,-4,0,-3.0,-4.0,0.5602161884307861,-13.7397083745307,69,-14,-16,1580,293,1705,819,70,3.41
-2,-3,0,-2.0,-3.0,0.5682423114776611,-17.30819398704587,69,-12,-13,1580,293,1705,819,70,2.34
-2,-2,0,-2.0,-2.0,0.5762972831726074,-20.133931252681492,69,-10,-11,1580,293,1705,819,70,3.9
0,0,1,-0.0,-0.0,0.597231388092041,-20.133931252681492,69,-10,-11,1580,293,1705,819,70,21.45
-1,0,1,-1.0,-0.0,0.05413675308227539,1629.7351302557631,70,-1451,785,138,1089,1590,304,40,7.38
-1,0,1,-1.0,-0.0,0.06998777389526367,1628.8556637862514,70,-1450,785,138,1089,1590,304,40,7.38
-1,0,1,-1.0,-0.0,0.0861656665802002,1627.9763347815406,70,-1449,785,138,1089,1590,304,40,7.38
0,0,0,-0.0,-0.0,0.08696389198303223,1627.9763347815406,70,-1449,785,138,1089,1590,304,40,267.95
-2,0,0,-2.0,-0.0,0.09399771690368652,1626.2180900476096,70,-1447,785,138,1089,1590,304,40,12.74
-2,0,0,-2.0,-0.0,0.10199379920959473,1624.460397820513,70,-1445,785,138,1089,1590,304,40,12.73
-2,0,0,-2.0,-0.0,0.10999178886413574,1622.7032598737972,70,-1443,785,138,1089,1590,304,40,12.72
-2,1,0,-2.0,1.0,0.11798977851867676,1620.4685306338552,70,-1441,784,138,1089,1590,304,40,18.85
-3,2,0,-3.0,2.0,0.1260976791381836,1616.8775152710725,70,-1438,782,138,1089,1590,304,40,25.45
-1,0,0,-1.0,-0.0,0.1340017318725586,1615.9990831293273,70,-1437,782,138,1089,1590,304,40,7.34
-1,0,0,-1.0,-0.0,0.17404866218566895,1615.1207906451436,70,-1436,782,138,1089,1590,304,40,7.34
-2,1,0,-2.0,1.0,0.18199968338012695,1612.886095231385,70,-1434,781,138,1089,1590,304,40,18.8
-5,2,0,-5.0,2.0,0.18999671936035156,1607.5386324139897,70,-1429,779,138,1089,1590,304,40,34.25
-10,6,0,-10.0,6.0,0.19798970222473145,1595.8867534576796,70,-1419,773,138,1089,1590,304,40,63.15
-14,12,0,-14.0,12.0,0.20598769187927246,1577.856689443706,70,-1405,761,138,1089,1590,304,40,82.64
-21,17,0,-21.0,17.0,0.214005708694458,1551.3026443050364,70,-1384,744,138,1089,1590,304,40,104.51
-24,21,0,-24.0,21.0,0.22199273109436035,1520.236670125731,70,-1360,723,138,1089,1590,304,40,112.71
-29,25,0,-29.0,25.0,0.23004674911499023,1482.9188268166715,70,-1331,698,138,1089,1590,304,40,122.52
-31,25,0,-31.0,25.0,0.2380537986755371,1443.8746531038782,70,-1300,673,138,1089,1590,304,40,123.72
-36,25,0,-36.0,25.0,0.2460007667541504,1400.4224723651762,70,-1264,648,138,1089,1590,304,40,128.66
-40,25,0,-40.0,25.0,0.2540106773376465,1353.428192516813,70,-1224,623,138,1089,1590,304,40,131.45
-40,24,0,-40.0,24.0,0.2619938850402832,1306.8975092297069,70,-1184,599,138,1089,1590,304,40,128.66
-39,22,0,-39.0,22.0,0.270000696182251,1262.1676957403038,70,-1145,577,138,1089,1590,304,40,124.53
-38,22,0,-38.0,22.0,0.27798986434936523,1218.3351727218283,70,-1107,555,138,1089,1590,304,40,120.75
-35,22,0,-35.0,22.0,0.2860066890716553,1177.1938021891026,70,-1072,533,138,1089,1590,304,40,114.43
-32,23,0,-32.0,23.0,0.2940046787261963,1138.3177456984763,70,-1040,510,138,1089,1590,304,40,108.62
-34,24,0,-34.0,24.0,0.30223965644836426,1097.2430353329573,70,-1006,486,138,1089,1590,304,40,109.3
-34,25,0,-34.0,25.0,0.31006479263305664,1055.7811115649874,70,-972,461,138,1089,1590,304,40,107.22
-38,25,0,-38.0,25.0,0.31800365447998047,1010.7531227214399,70,-934,436,138,1089,1590,304,40,109.04
-38,24,0,-38.0,24.0,0.3260316848754883,966.1845669041876,70,-896,412,138,1089,1590,304,40,105.87
-39,22,0,-39.0,22.0,0.3339958190917969,921.567310392624,70,-857,390,138,1089,1590,304,40,103.61
-38,22,0,-38.0,22.0,0.34214067459106445,877.8780540808423,70,-819,368,138,1089,1590,304,40,99.55
-39,21,0,-39.0,21.0,0.3500666618347168,833.7031099861356,70,-780,347,138,1089,1590,304,40,97.45
-37,18,0,-37.0,18.0,0.3582417964935303,792.5823035237723,70,-743,329,138,1089,1590,304,40,92.37
-35,17,0,-35.0,17.0,0.3660008907318115,753.6976153511138,70,-708,312,138,1089,1590,304,40,87.31
-35,16,0,-35.0,16.0,0.3739898204803467,715.2176548478689,70,-673,296,138,1089,1590,304,40,85.1
-31,14,0,-31.0,14.0,0.3820497989654541,681.204677679777,70,-642,282,138,1089,1590,304,40,78.11
-27,13,0,-27.0,13.0,0.3899977207183838,651.2570297583483,70,-615,269,138,1089,1590,304,40,70.18
-23,11,0,-23.0,11.0,0.39800381660461426,625.7770513110543,70,-592,258,138,1089,1590,304,40,62.78
-20,9,0,-20.0,9.0,0.4059908390045166,603.8469363553852,70,-572,249,138,1089,1590,304,40,57.3
-16,7,0,-16.0,7.0,0.41399168968200684,586.3827174318212,70,-556,242,138,1089,1590,304,40,49.91
-16,5,0,-16.0,5.0,0.42206478118896484,569.7194248114946,70,-540,237,138,1089,1590,304,40,44.75
-16,5,0,-16.0,5.0,0.42998576164245605,553.0619512757761,70,-524,232,138,1089,1590,304,40,43.9
-16,4,0,-16.0,4.0,0.437990665435791,536.8195398870266,70,-508,228,138,1089,1590,304,40,41.83
-15,4,0,-15.0,4.0,0.44599366188049316,521.5025392368904,70,-493,224,138,1089,1590,304,40,39.61
-15,4,0,-15.0,4.0,0.4543497562408447,506.1976814848199,70,-478,220,138,1089,1590,304,40,38.82
-13,3,0,-13.0,3.0,0.46198487281799316,493.14130607465233,70,-465,217,138,1089,1590,304,40,34.04
-11,2,0,-11.0,2.0,0.46999669075012207,482.33554522848567,70,-454,215,138,1089,1590,304,40,29.12
-9,3,0,-9.0,3.0,0.47799181938171387,472.9188574197583,70,-445,212,138,1089,1590,304,40,27.06
-9,3,0,-9.0,3.0,0.4860367774963379,463.50491207432424,70,-436,209,138,1089,1590,304,40,26.71
-7,3,0,-7.0,3.0,0.4942338466644287,455.8959970413704,70,-429,206,138,1089,1590,304,40,24.04
-10,3,0,-10.0,3.0,0.5020158290863037,445.5856526999087,70,-419,203,138,1089,1590,304,40,27.46
-10,2,0,-10.0,2.0,0.5099806785583496,435.72140612439966,70,-409,201,138,1089,1590,304,40,25.61
-11,3,0,-11.0,3.0,0.5180346965789795,424.53121375219536,70,-398,198,138,1089,1590,304,40,27.94
-15,3,0,-15.0,3.0,0.5262718200683594,409.7836665114206,70,-383,195,138,1089,1590,304,40,32.5
-14,4,0,-14.0,4.0,0.5339937210083008,395.5021058911735,70,-369,191,138,1089,1590,304,40,31.51
-15,4,0,-15.0,4.0,0.5419838428497314,380.3560914985558,70,-354,187,138,1089,1590,304,40,31.77
-14,5,0,-14.0,5.0,0.5500998497009277,365.6475074468912,70,-340,182,138,1089,1590,304,40,30.93
-14,4,0,-14.0,4.0,0.5580928325653076,351.4296703280447,70,-326,178,138,1089,1590,304,40,28.96
-12,5,0,-12.0,5.0,0.5659997463226318,338.50383540486706,70,-314,173,138,1089,1590,304,40,27.46
-11,5,0,-11.0,5.0,0.574042797088623,326.45778963677526,70,-303,168,138,1089,1590,304,40,26.03
-10,5,0,-10.0,5.0,0.5820016860961914,315.2879359595272,70,-293,163,138,1089,1590,304,40,24.96
-10,5,0,-10.0,5.0,0.5900578498840332,304.11880537852164,70,-283,158,138,1089,1590,304,40,24.39
-11,6,0,-11.0,6.0,0.5979938507080078,291.58947350640716,70,-272,152,138,1089,1590,304,40,26.89
-9,6,0,-9.0,6.0,0.6059837341308594,280.8072472531205,70,-263,146,138,1089,1590,304,40,22.08
-10,5,0,-10.0,5.0,0.6140007972717285,269.6377047278203,70,-253,141,138,1089,1590,304,40,22.73
-9,5,0,-9.0,5.0,0.6220707893371582,259.3420841906926,70,-244,136,138,1089,1590,304,40,23.12
-10,7,0,-10.0,7.0,0.6300747394561768,247.20217064986576,70,-234,129,138,1089,1590,304,40,21.64
-11,7,0,-11.0,7.0,0.6379938125610352,234.19087316424248,70,-223,122,138,1089,1590,304,40,22.45
-11,7,0,-11.0,7.0,0.6459858417510986,221.18250351134512,70,-212,115,138,1089,1590,304,40,21.6
-11,7,0,-11.0,7.0,0.6539907455444336,208.17756243767704,70,-201,108,138,1089,1590,304,40,20.73
-10,7,0,-10.0,7.0,0.6621718406677246,196.06017680266763,70,-191,101,138,1089,1590,304,40,18.48
-9,6,0,-9.0,6.0,0.6699926853179932,185.30221625691235,70,-182,95,138,1089,1590,304,40,16.77
-8,5,0,-8.0,5.0,0.678001880645752,175.8979326077741,70,-174,90,138,1089,1590,304,40,15.33
-7,5,0,-7.0,5.0,0.6860036849975586,167.38729946290383,70,-167,85,138,1089,1590,304,40,13.26
-7,6,0,-7.0,6.0,0.6939878463745117,158.44046626256053,70,-160,79,138,1089,1590,304,40,12.52
-6,5,0,-6.0,5.0,0.7019877433776855,150.85666507338834,70,-154,74,138,1089,1590,304,40,10.95
-6,5,0,-6.0,5.0,0.7100868225097656,143.29421300217592,70,-148,69,138,1089,1590,304,40,10.52
-6,6,0,-6.0,6.0,0.7179927825927734,135.3479964466874,70,-142,63,138,1089,1590,304,40,9.98
-4,5,0,-4.0,5.0,0.7259907722473145,129.69301920931383,70,-138,58,138,1089,1590,304,40,7.36
-6,6,0,-6.0,6.0,0.7339956760406494,121.8731828077456,70,-132,52,138,1089,1590,304,40,9.07
-5,6,0,-5.0,6.0,0.7420308589935303,115.07405376311175,70,-127,46,138,1089,1590,304,40,7.61
-5,5,0,-5.0,5.0,0.7500128746032715,108.70508925446578,70,-122,41,138,1089,1590,304,40,7.22
-4,4,0,-4.0,4.0,0.7579898834228516,103.664869708418,70,-118,37,138,1089,1590,304,40,5.98
-5,4,0,-5.0,4.0,0.7660088539123535,97.72000679578642,70,-113,33,138,1089,1590,304,40,6.7
-5,3,0,-5.0,3.0,0.7740187644958496,92.08925015361643,70,-108,30,138,1089,1590,304,40,6.79
-5,3,0,-5.0,3.0,0.7820537090301514,86.48004507887852,70,-103,27,138,1089,1590,304,40,6.48
-5,2,0,-5.0,2.0,0.7899937629699707,81.13851887386922,70,-98,25,138,1089,1590,304,40,7.17
-5,3,0,-5.0,3.0,0.7980928421020508,75.56673061269805,70,-93,22,138,1089,1590,304,40,5.9
-5,3,0,-5.0,3.0,0.8063008785247803,70.02777349240623,70,-88,19,138,1089,1590,304,40,5.57
-4,2,0,-4.0,2.0,0.8140146732330322,65.70297544426332,70,-84,17,138,1089,1590,304,40,5.08
-3,1,0,-3.0,1.0,0.8219966888427734,62.56512580987206,70,-81,16,138,1089,1590,304,40,5.36
-4,1,0,-4.0,1.0,0.8300008773803711,58.44743462982075,70,-77,15,138,1089,1590,304,40,6.83
-3,2,0,-3.0,2.0,0.8379888534545898,55.13321502504735,70,-74,13,138,1089,1590,304,40,3.61
-3,1,0,-3.0,1.0,0.8460307121276855,52.00694410957877,70,-71,12,138,1089,1590,304,40,4.81
-4,2,0,-4.0,2.0,0.8540518283843994,47.742158217759794,70,-67,10,138,1089,1590,304,40,4.17
-6,3,0,-6.0,3.0,0.8619956970214844,41.40032573203501,70,-61,7,138,1089,1590,304,40,4.5
-7,2,0,-7.0,2.0,0.869985818862915,34.230987451824994,70,-54,5,138,1089,1590,304,40,5.25
-6,2,0,-6.0,2.0,0.8781306743621826,28.093658625644196,70,-48,3,138,1089,1590,304,40,4.17
-6,1,0,-6.0,1.0,0.8859977722167969,22.04759208325728,70,-42,2,138,1089,1590,304,40,4.92
-5,2,0,-5.0,2.0,0.8939988613128662,17.0,70,-37,0,138,1089,1590,304,40,2.8
-6,1,0,-6.0,1.0,0.9019877910614014,11.016124838541646,70,-31,-1,138,1089,1590,304,40,3.55
-6,2,0,-6.0,2.0,0.9099957942962646,5.179356624028344,70,-25,-3,138,1089,1590,304,40,1.99
-7,2,0,-7.0,2.0,0.9179897308349609,-1.3184583077305945,70,-18,-5,138,1089,1590,304,40,1.24
-7,2,0,-7.0,2.0,0.9260127544403076,-6.961595189594702,70,-11,-7,138,1089,1590,304,40,0.01
-7,2,0,-7.0,2.0,0.9341297149658203,-10.151142198203896,70,-4,-9,138,1089,1590,304,40,-1.4
-6,2,0,-6.0,2.0,0.94203782081604,-8.819660112501051,70,2,-11,138,1089,1590,304,40,-1.95
-3,1,0,-3.0,1.0,0.9500727653503418,-7.0,70,5,-12,138,1089,1590,304,40,-0.78
-3,1,0,-3.0,1.0,0.9580128192901611,-4.735662477526253,70,8,-13,138,1089,1590,304,40,-0.39
-1,0,0,-1.0,-0.0,0.9740188121795654,-4.188611699158104,70,9,-13,138,1089,1590,304,40,0.54
0,0,1,-0.0,-0.0,1.017000675201416,-4.188611699158104,70,9,-13,138,1089,1590,304,40,25.73
0,0,0,-0.0,-0.0,0.05706524848937988,1364.372435808753,71,995,-974,1124,128,129,1102,57,244.12
2,0,0,2.0,-0.0,0.09206724166870117,1362.9439241033408,71,993,-974,1124,128,129,1102,57,6.92
4,-2,0,4.0,-2.0,0.10007619857788086,1358.6885014306565,71,989,-972,1124,128,129,1102,57,18.82
5,-3,0,5.0,-3.0,0.10805630683898926,1353.0202750140927,71,984,-969,1124,128,129,1102,57,24.11
7,-3,0,7.0,-3.0,0.11608028411865234,1345.9304931473062,71,977,-966,1124,128,129,1102,57,28.16
8,-4,0,8.0,-4.0,0.12406134605407715,1337.4321660192425,71,969,-962,1124,128,129,1102,57,32.78
11,-4,0,11.0,-4.0,0.13205337524414062,1326.816592753425,71,958,-958,1124,128,129,1102,57,38.56
14,-5,0,14.0,-5.0,0.14005637168884277,1313.3966602015976,71,944,-953,1124,128,129,1102,57,46.1
15,-5,0,15.0,-5.0,0.14822030067443848,1299.3074248266676,71,929,-948,1124,128,129,1102,57,47.5
15,-5,0,15.0,-5.0,0.1560673713684082,1285.257400512177,71,914,-943,1124,128,129,1102,57,47.11
15,-5,0,15.0,-5.0,0.1640632152557373,1271.2478593401645,71,899,-938,1124,128,129,1102,57,46.71
16,-6,0,16.0,-6.0,0.17206835746765137,1255.86642607399,71,883,-932,1124,128,129,1102,57,49.93
19,-8,0,19.0,-8.0,0.1802372932434082,1237.0185769386947,71,864,-924,1124,128,129,1102,57,57.69
22,-11,0,22.0,-11.0,0.18844223022460938,1213.9875200661236,71,842,-913,1124,128,129,1102,57,66.01
27,-15,0,27.0,-15.0,0.19604825973510742,1184.694932784004,71,815,-898,1124,128,129,1102,57,76.56
27,-17,0,27.0,-17.0,0.2040543556213379,1153.9919627476322,71,788,-881,1124,128,129,1102,57,77.95
31,-21,0,31.0,-21.0,0.21205520629882812,1117.708950824772,71,757,-860,1124,128,129,1102,57,84.91
36,-23,0,36.0,-23.0,0.22011637687683105,1076.7216844074349,71,721,-837,1124,128,129,1102,57,89.01
33,-24,0,33.0,-24.0,0.22805428504943848,1037.0413137526639,71,688,-813,1124,128,129,1102,57,85.8
31,-27,0,31.0,-27.0,0.23606228828430176,996.4242285303487,71,657,-786,1124,128,129,1102,57,85.54
31,-29,0,31.0,-29.0,0.24405527114868164,954.3059604827815,71,626,-757,1124,128,129,1102,57,85.43
27,-30,0,27.0,-30.0,0.25205230712890625,913.981953117999,71,599,-727,1124,128,129,1102,57,82.66
25,-30,0,25.0,-30.0,0.2601642608642578,874.9313373673549,71,574,-697,1124,128,129,1102,57,80.81
24,-30,0,24.0,-30.0,0.26813220977783203,836.5166279488209,71,550,-667,1124,128,129,1102,57,77.52
23,-31,0,23.0,-31.0,0.27605724334716797,797.9691277523634,71,527,-636,1124,128,129,1102,57,74.33
21,-28,0,21.0,-28.0,0.2842881679534912,763.0120100226039,71,506,-608,1124,128,129,1102,57,68.57
21,-30,0,21.0,-30.0,0.2920541763305664,726.5256788208072,71,485,-578,1124,128,129,1102,57,67.61
21,-31,0,21.0,-31.0,0.30004334449768066,689.2900389661075,71,464,-547,1124,128,129,1102,57,65.99
24,-33,0,24.0,-33.0,0.3080592155456543,648.6062370389442,71,440,-514,1124,128,129,1102,57,67.22
25,-33,0,25.0,-33.0,0.3160572052001953,607.2841883755647,71,415,-481,1124,128,129,1102,57,65.38
25,-29,0,25.0,-29.0,0.3240532875061035,568.995812380623,71,390,-452,1124,128,129,1102,57,62.92
25,-25,0,25.0,-25.0,0.3320443630218506,533.7419336314497,71,365,-427,1124,128,129,1102,57,55.03
25,-22,0,25.0,-22.0,0.340057373046875,500.7958017987662,71,340,-405,1124,128,129,1102,57,50.0
24,-22,0,24.0,-22.0,0.34806036949157715,468.5329797707298,71,316,-383,1124,128,129,1102,57,47.43
23,-20,0,23.0,-20.0,0.3560633659362793,438.4954447794748,71,293,-363,1124,128,129,1102,57,43.23
20,-17,0,20.0,-17.0,0.364058256149292,412.732345080322,71,273,-346,1124,128,129,1102,57,37.63
20,-16,0,20.0,-16.0,0.3721022605895996,387.8232797715876,71,253,-330,1124,128,129,1102,57,35.08
17,-14,0,17.0,-14.0,0.3800482749938965,366.4008113581918,71,236,-316,1124,128,129,1102,57,30.64
15,-12,0,15.0,-12.0,0.38806629180908203,347.84172200542076,71,221,-304,1124,128,129,1102,57,26.75
15,-12,0,15.0,-12.0,0.39607715606689453,329.35136770411276,71,206,-292,1124,128,129,1102,57,25.65
15,-13,0,15.0,-13.0,0.40406036376953125,310.11536492741646,71,191,-279,1124,128,129,1102,57,25.43
14,-12,0,14.0,-12.0,0.41234827041625977,292.3404439030451,71,177,-267,1124,128,129,1102,57,23.08
13,-13,0,13.0,-13.0,0.42010927200317383,274.34417474130373,71,164,-254,1124,128,129,1102,57,22.66
14,-13,0,14.0,-13.0,0.4281141757965088,255.86792703650053,71,150,-241,1124,128,129,1102,57,21.69
11,-11,0,11.0,-11.0,0.43607616424560547,240.73965096353015,71,139,-230,1124,128,129,1102,57,18.34
9,-10,0,9.0,-10.0,0.44405627250671387,227.53864678361276,71,130,-220,1124,128,129,1102,57,16.39
8,-9,0,8.0,-9.0,0.4520552158355713,215.73140954747709,71,122,-211,1124,128,129,1102,57,14.69
8,-8,0,8.0,-8.0,0.4600541591644287,204.81967270830015,71,114,-203,1124,128,129,1102,57,13.08
9,-10,0,9.0,-10.0,0.4680662155151367,191.71344974762013,71,105,-193,1124,128,129,1102,57,14.38
11,-8,0,11.0,-8.0,0.4760463237762451,179.51144546747295,71,94,-185,1124,128,129,1102,57,12.15
10,-8,0,10.0,-8.0,0.48406219482421875,167.92090240706835,71,84,-177,1124,128,129,1102,57,11.25
9,-7,0,9.0,-7.0,0.49207019805908203,157.80904176062046,71,75,-170,1124,128,129,1102,57,9.68
8,-6,0,8.0,-6.0,0.5000753402709961,149.15812146215595,71,67,-164,1124,128,129,1102,57,8.22
6,-5,0,6.0,-5.0,0.5080661773681641,142.29973576021777,71,61,-159,1124,128,129,1102,57,6.87
5,-5,0,5.0,-5.0,0.5163931846618652,135.86579875007476,71,56,-154,1124,128,129,1102,57,6.62
4,-4,0,4.0,-4.0,0.524125337600708,130.75767697972907,71,52,-150,1124,128,129,1102,57,5.56
3,-5,0,3.0,-5.0,0.532050371170044,125.05554547287727,71,49,-145,1124,128,129,1102,57,6.84
3,-5,0,3.0,-5.0,0.540067195892334,119.36349615830918,71,46,-140,1124,128,129,1102,57,6.62
3,-5,0,3.0,-5.0,0.5480551719665527,113.6827441857335,71,43,-135,1124,128,129,1102,57,6.4
3,-5,0,3.0,-5.0,0.5562412738800049,108.01470508735443,71,40,-130,1124,128,129,1102,57,6.18
2,-4,0,2.0,-4.0,0.5640652179718018,103.60547101089682,71,38,-126,1124,128,129,1102,57,5.84
2,-5,0,2.0,-5.0,0.5722713470458984,98.24183141890805,71,36,-121,1124,128,129,1102,57,7.04
2,-5,0,2.0,-5.0,0.5800883769989014,92.88010589009261,71,34,-116,1124,128,129,1102,57,6.83
2,-4,0,2.0,-4.0,0.5880622863769531,88.48175822848829,71,32,-112,1124,128,129,1102,57,5.37
2,-4,0,2.0,-4.0,0.5961782932281494,84.08925015361643,71,30,-108,1124,128,129,1102,57,5.21
2,-5,0,2.0,-5.0,0.604128360748291,78.7379969832674,71,28,-103,1124,128,129,1102,57,6.18
3,-5,0,3.0,-5.0,0.6120631694793701,73.13851887386922,71,25,-98,1124,128,129,1102,57,4.86
2,-5,0,2.0,-5.0,0.6201033592224121,67.80187889597991,71,23,-93,1124,128,129,1102,57,5.62
3,-5,0,3.0,-5.0,0.628075361251831,62.24411338142782,71,20,-88,1124,128,129,1102,57,4.38
3,-5,0,3.0,-5.0,0.6360671520233154,56.72307831990054,71,17,-83,1124,128,129,1102,57,4.09
2,-5,0,2.0,-5.0,0.6440882682800293,51.42921376924235,71,15,-78,1124,128,129,1102,57,4.66
2,-5,0,2.0,-5.0,0.6521763801574707,46.14849964766651,71,13,-73,1124,128,129,1102,57,4.39
2,-5,0,2.0,-5.0,0.6600532531738281,40.8839603971781,71,11,-68,1124,128,129,1102,57,4.11
3,-6,0,3.0,-6.0,0.6682033538818359,34.51399843235114,71,8,-62,1124,128,129,1102,57,3.52
3,-6,0,3.0,-6.0,0.6760773658752441,28.222771187482387,71,5,-56,1124,128,129,1102,57,3.09
3,-7,0,3.0,-7.0,0.6840581893920898,21.040799340956916,71,2,-49,1124,128,129,1102,57,2.95
2,-5,0,2.0,-5.0,0.6920711994171143,16.0,71,0,-44,1124,128,129,1102,57,2.41
2,-5,0,2.0,-5.0,0.7000842094421387,11.05124837953327,71,-2,-39,1124,128,129,1102,57,2.02
1,-4,0,1.0,-4.0,0.7080502510070801,7.128336140500593,71,-3,-35,1124,128,129,1102,57,2.21
1,-5,0,1.0,-5.0,0.7161743640899658,2.265491900843113,71,-4,-30,1124,128,129,1102,57,2.04
1,-4,0,1.0,-4.0,0.7240493297576904,-1.5235954102525469,71,-5,-26,1124,128,129,1102,57,1.46
0,-4,0,-0.0,-4.0,0.7322711944580078,-5.438971654643044,71,-5,-22,1124,128,129,1102,57,2.25
0,-2,0,-0.0,-2.0,0.7400522232055664,-7.384471871911696,71,-5,-20,1124,128,129,1102,57,2.21
0,-1,0,-0.0,-1.0,0.7480533123016357,-8.3531172956115,71,-5,-19,1124,128,129,1102,57,2.31
0,-1,0,-0.0,-1.0,0.7560641765594482,-9.318458307730594,71,-5,-18,1124,128,129,1102,57,2.21
0,0,1,-0.0,-0.0,0.77506422996521,-9.318458307730594,71,-5,-18,1124,128,129,1102,57,24.29
0,0,0,-0.0,-0.0,0.10479855537414551,798.1780711693137,72,546,608,1675,754,1129,146,38,180.42
0,1,0,-0.0,1.0,0.33579254150390625,797.4343206896682,72,546,607,1675,754,1129,146,38,4.54
3,4,0,3.0,4.0,0.34376955032348633,792.4542500967013,72,543,603,1675,754,1129,146,38,24.01
5,8,0,5.0,8.0,0.3518836498260498,783.1651949567496,72,538,595,1675,754,1129,146,38,36.78
7,8,0,7.0,8.0,0.3599426746368408,772.5364805237974,72,531,587,1675,754,1129,146,38,42.83
10,11,0,10.0,11.0,0.3677675724029541,757.6704577876,72,521,576,1675,754,1129,146,38,53.74
11,11,0,11.0,11.0,0.37590861320495605,742.1340223639986,72,510,565,1675,754,1129,146,38,52.7
10,12,0,10.0,12.0,0.38382649421691895,726.52598881595,72,500,553,1675,754,1129,146,38,52.47
13,14,0,13.0,14.0,0.3918485641479492,707.4227419347498,72,487,539,1675,754,1129,146,38,59.6
13,15,0,13.0,15.0,0.39978456497192383,687.57766735158,72,474,524,1675,754,1129,146,38,59.64
13,17,0,13.0,17.0,0.40778160095214844,666.2517785456671,72,461,507,1675,754,1129,146,38,59.59
16,18,0,16.0,18.0,0.41579461097717285,642.1701747659221,72,445,489,1675,754,1129,146,38,64.54
18,18,0,18.0,18.0,0.4239485263824463,616.7436590324751,72,427,471,1675,754,1129,146,38,63.61
18,18,0,18.0,18.0,0.4321916103363037,591.3195884124972,72,409,453,1675,754,1129,146,38,61.95
18,17,0,18.0,17.0,0.4397716522216797,566.6423823460867,72,391,436,1675,754,1129,146,38,58.78
17,15,0,17.0,15.0,0.4477674961090088,544.1314233817893,72,374,421,1675,754,1129,146,38,53.91
15,13,0,15.0,13.0,0.4559645652770996,524.4565300003304,72,359,408,1675,754,1129,146,38,48.48
14,13,0,14.0,13.0,0.4640805721282959,505.4520950477746,72,345,395,1675,754,1129,146,38,46.71
12,10,0,12.0,10.0,0.4717826843261719,490.0324154707635,72,333,385,1675,754,1129,146,38,39.61
9,10,0,9.0,10.0,0.4797666072845459,476.58147665141803,72,324,375,1675,754,1129,146,38,37.94
8,8,0,8.0,8.0,0.48778247833251953,465.298461694852,72,316,367,1675,754,1129,146,38,32.09
7,9,0,7.0,9.0,0.495774507522583,453.91119673782305,72,309,358,1675,754,1129,146,38,32.26
6,9,0,6.0,9.0,0.5039684772491455,443.17961876309516,72,303,349,1675,754,1129,146,38,29.48
7,11,0,7.0,11.0,0.511784553527832,430.2883261336755,72,296,338,1675,754,1129,146,38,32.51
7,11,0,7.0,11.0,0.5197834968566895,417.4057744805859,72,289,327,1675,754,1129,146,38,31.84
6,9,0,6.0,9.0,0.5277905464172363,406.69120263402203,72,283,318,1675,754,1129,146,38,27.81
7,11,0,7.0,11.0,0.5357956886291504,393.82562904936026,72,276,307,1675,754,1129,146,38,30.59
7,9,0,7.0,9.0,0.5437874794006348,382.4536087769046,72,269,298,1675,754,1129,146,38,28.68
6,9,0,6.0,9.0,0.5517804622650146,371.7556781417258,72,263,289,1675,754,1129,146,38,26.17
7,9,0,7.0,9.0,0.5597715377807617,360.38898244414,72,256,280,1675,754,1129,146,38,27.55
6,9,0,6.0,9.0,0.5678606033325195,349.70177650778953,72,250,271,1675,754,1129,146,38,25.11
7,11,0,7.0,11.0,0.5758776664733887,336.87778801155883,72,243,260,1675,754,1129,146,38,27.47
7,10,0,7.0,10.0,0.583763599395752,324.7964514069335,72,236,250,1675,754,1129,146,38,26.1
7,12,0,7.0,12.0,0.5918686389923096,311.28018408617856,72,229,238,1675,754,1129,146,38,26.66
8,12,0,8.0,12.0,0.5998215675354004,297.09650425147066,72,221,226,1675,754,1129,146,38,27.01
8,14,0,8.0,14.0,0.6077806949615479,281.5212138934621,72,213,212,1675,754,1129,146,38,27.15
8,13,0,8.0,13.0,0.6157855987548828,266.70264261990997,72,205,199,1675,754,1129,146,38,25.45
9,17,0,9.0,17.0,0.6239056587219238,248.46962444359923,72,196,182,1675,754,1129,146,38,27.17
9,14,0,9.0,14.0,0.631819486618042,232.38217916153087,72,187,168,1675,754,1129,146,38,24.3
8,12,0,8.0,12.0,0.6399095058441162,218.43841306747314,72,179,156,1675,754,1129,146,38,21.27
7,10,0,7.0,10.0,0.6478686332702637,206.61028345356956,72,172,146,1675,754,1129,146,38,18.47
7,10,0,7.0,10.0,0.6558434963226318,194.82469455140114,72,165,136,1675,754,1129,146,38,17.63
7,11,0,7.0,11.0,0.66377854347229,182.4671189052943,72,158,125,1675,754,1129,146,38,17.09
8,10,0,8.0,10.0,0.6718294620513916,170.01058171435798,72,150,115,1675,754,1129,146,38,16.82
7,10,0,7.0,10.0,0.6799495220184326,158.40913167027227,72,143,105,1675,754,1129,146,38,14.91
7,11,0,7.0,11.0,0.6878094673156738,146.32392446346051,72,136,94,1675,754,1129,146,38,14.21
6,11,0,6.0,11.0,0.6957685947418213,135.23683088030563,72,130,83,1675,754,1129,146,38,12.37
8,11,0,8.0,11.0,0.7038166522979736,122.66156853571826,72,122,72,1675,754,1129,146,38,12.85
6,10,0,6.0,10.0,0.7121706008911133,112.52946437965906,72,116,62,1675,754,1129,146,38,10.13
6,8,0,6.0,8.0,0.7197694778442383,103.53978945632312,72,110,54,1675,754,1129,146,38,9.03
5,9,0,5.0,9.0,0.7278046607971191,95.23659658795863,72,105,45,1675,754,1129,146,38,7.59
4,7,0,4.0,7.0,0.7358675003051758,88.91200118615167,72,101,38,1675,754,1129,146,38,5.94
3,7,0,3.0,7.0,0.7438375949859619,83.7861858422619,72,98,31,1675,754,1129,146,38,4.59
5,9,0,5.0,9.0,0.7517814636230469,76.56673061269805,72,93,22,1675,754,1129,146,38,5.54
5,9,0,5.0,9.0,0.7597835063934326,69.95504482602435,72,88,13,1675,754,1129,146,38,4.7
5,9,0,5.0,9.0,0.7677755355834961,64.09632964216891,72,83,4,1675,754,1129,146,38,3.83
7,8,0,7.0,8.0,0.7759876251220703,57.105190361761785,72,76,-4,1675,754,1129,146,38,4.22
8,8,0,8.0,8.0,0.7837836742401123,50.05070600652827,72,68,-12,1675,754,1129,146,38,3.73
8,8,0,8.0,8.0,0.7917776107788086,44.245553203367585,72,60,-20,1675,754,1129,146,38,2.65
7,7,0,7.0,7.0,0.7999634742736816,40.481089431852205,72,53,-27,1675,754,1129,146,38,1.44
8,6,0,8.0,6.0,0.8077876567840576,36.80322571321482,72,45,-33,1675,754,1129,146,38,1.23
6,6,0,6.0,6.0,0.8158066272735596,36.154328932550705,72,39,-39,1675,754,1129,146,38,-0.41
7,5,0,7.0,5.0,0.8237745761871338,35.405882034941776,72,32,-44,1675,754,1129,146,38,-0.37
6,4,0,6.0,4.0,0.8318774700164795,35.589376255824725,72,26,-48,1675,754,1129,146,38,1.92
7,4,0,7.0,4.0,0.8397805690765381,36.362442142665635,72,19,-52,1675,754,1129,146,38,-0.09
6,4,0,6.0,4.0,0.8477716445922852,38.48912940721924,72,13,-56,1675,754,1129,146,38,-0.29
5,3,0,5.0,3.0,0.8558135032653809,40.53990258641679,72,8,-59,1675,754,1129,146,38,-0.05
3,2,0,3.0,2.0,0.8637955188751221,42.204574992397426,72,5,-61,1675,754,1129,146,38,0.43
2,0,0,2.0,-0.0,0.8717916011810303,42.07372593840988,72,3,-61,1675,754,1129,146,38,0.01
2,0,0,2.0,-0.0,0.8797965049743652,42.00819617067857,72,1,-61,1675,754,1129,146,38,-0.06
1,0,0,1.0,-0.0,0.8877894878387451,42.0,72,0,-61,1675,754,1129,146,38,0.01
1,-1,0,1.0,-1.0,0.8957815170288086,41.00833275470999,72,-1,-60,1675,754,1129,146,38,1.42
1,-3,0,1.0,-3.0,0.903780460357666,38.0350769263968,72,-2,-57,1675,754,1129,146,38,3.27
0,-4,0,-0.0,-4.0,0.9117815494537354,34.03772242470448,72,-2,-53,1675,754,1129,146,38,6.42
0,-6,0,-0.0,-6.0,0.9198014736175537,28.042533945356304,72,-2,-47,1675,754,1129,146,38,6.63
1,-5,0,1.0,-5.0,0.9278125762939453,23.1070065428546,72,-3,-42,1675,754,1129,146,38,3.66
1,-4,0,1.0,-4.0,0.9357695579528809,19.209946349085598,72,-4,-38,1675,754,1129,146,38,2.87
1,-5,0,1.0,-5.0,0.9437894821166992,14.376638536557273,72,-5,-33,1675,754,1129,146,38,2.81
2,-4,0,2.0,-4.0,0.9517745971679688,10.832867780352597,72,-7,-29,1675,754,1129,146,38,1.37
2,-4,0,2.0,-4.0,0.9600956439971924,7.570660511172846,72,-9,-25,1675,754,1129,146,38,0.94
2,-4,0,2.0,-4.0,0.9677786827087402,4.7065391822593945,72,-11,-21,1675,754,1129,146,38,0.49
0,-4,0,-0.0,-4.0,0.9757685661315918,1.2484567313165869,72,-11,-17,1675,754,1129,146,38,1.19
1,-2,0,1.0,-2.0,0.9838144779205322,0.2093727122985456,72,-12,-15,1675,754,1129,146,38,0.04
1,-1,0,1.0,-1.0,0.9918785095214844,0.10497317454279909,72,-13,-14,1675,754,1129,146,38,-0.31
0,-2,0,-0.0,-2.0,0.9998276233673096,-1.3081939870458683,72,-13,-12,1675,754,1129,146,38,0.54
1,-1,0,1.0,-1.0,1.0077714920043945,-1.1955061852351427,72,-14,-11,1675,754,1129,146,38,1.46
2,-1,0,2.0,-1.0,1.0157794952392578,-0.13203773588679368,72,-16,-10,1675,754,1129,146,38,-0.1
1,-1,0,1.0,-1.0,1.0237905979156494,0.2353840616713434,72,-17,-9,1675,754,1129,146,38,0.44
1,-1,0,1.0,-1.0,1.0317754745483398,0.6977156035922079,72,-18,-8,1675,754,1129,146,38,0.39
0,0,1,-0.0,-0.0,1.0647766590118408,0.6977156035922079,72,-18,-8,1675,754,1129,146,38,27.14
0,0,0,-0.0,-0.0,0.07496929168701172,417.6918448740441,73,-389,-194,1304,568,1693,762,34,120.54
-2,1,0,-2.0,1.0,0.10396218299865723,416.35205087780537,73,-387,-195,1304,568,1693,762,34,5.13
-3,3,0,-3.0,3.0,0.11197018623352051,415.0416646574726,73,-384,-198,1304,568,1693,762,34,4.57
-7,2,0,-7.0,2.0,0.11996316909790039,409.76574370490425,73,-377,-200,1304,568,1693,762,34,16.07
-7,1,0,-7.0,1.0,0.12810134887695312,404.07125287770475,73,-370,-201,1304,568,1693,762,34,17.2
-10,0,0,-10.0,-0.0,0.13598418235778809,395.3117752381079,73,-360,-201,1304,568,1693,762,34,23.93
-14,0,0,-14.0,-0.0,0.14395618438720703,383.1462232734429,73,-346,-201,1304,568,1693,762,34,29.6
-15,-1,0,-15.0,-1.0,0.15197229385375977,369.73117278026604,73,-331,-200,1304,568,1693,762,34,31.03
-14,-2,0,-14.0,-2.0,0.1599583625793457,356.755267521409,73,-317,-198,1304,568,1693,762,34,29.81
-15,-3,0,-15.0,-3.0,0.16801118850708008,342.48435292791254,73,-302,-195,1304,568,1693,762,34,31.04
-15,-4,0,-15.0,-4.0,0.17597031593322754,327.74628351876396,73,-287,-191,1304,568,1693,762,34,30.96
-17,-6,0,-17.0,-6.0,0.18396830558776855,310.29955698106284,73,-270,-185,1304,568,1693,762,34,33.47
-21,-7,0,-21.0,-7.0,0.1919562816619873,289.08005488760614,73,-249,-178,1304,568,1693,762,34,35.57
-22,-8,0,-22.0,-8.0,0.19995832443237305,266.600070521853,73,-227,-170,1304,568,1693,762,34,34.74
-26,-11,0,-26.0,-11.0,0.20798921585083008,239.28499761008254,73,-201,-159,1304,568,1693,762,34,35.84
-27,-12,0,-27.0,-12.0,0.21596717834472656,210.7827912727386,73,-174,-147,1304,568,1693,762,34,33.36
-26,-13,0,-26.0,-13.0,0.22396039962768555,182.64969321288726,73,-148,-134,1304,568,1693,762,34,29.94
-20,-11,0,-20.0,-11.0,0.23224925994873047,160.51901306620653,73,-128,-123,1304,568,1693,762,34,24.14
-16,-8,0,-16.0,-8.0,0.2399892807006836,143.52725625263767,73,-112,-115,1304,568,1693,762,34,18.9
-10,-8,0,-10.0,-8.0,0.2480151653289795,130.82760229402356,73,-102,-107,1304,568,1693,762,34,16.13
-6,-6,0,-6.0,-6.0,0.2559523582458496,122.34489585198304,73,-96,-101,1304,568,1693,762,34,14.27
-6,-7,0,-6.0,-7.0,0.2640073299407959,113.13838787997952,73,-90,-94,1304,568,1693,762,34,13.44
-5,-8,0,-5.0,-8.0,0.27196335792541504,103.91732712891069,73,-85,-86,1304,568,1693,762,34,11.03
-5,-7,0,-5.0,-7.0,0.2799832820892334,95.43220179290273,73,-80,-79,1304,568,1693,762,34,10.33
-5,-7,0,-5.0,-7.0,0.2879643440246582,86.96634070698074,73,-75,-72,1304,568,1693,762,34,9.68
-5,-9,0,-5.0,-9.0,0.2959582805633545,77.17536832951598,73,-70,-63,1304,568,1693,762,34,8.97
-6,-9,0,-6.0,-9.0,0.30397820472717285,66.73768566183328,73,-64,-54,1304,568,1693,762,34,8.73
-6,-9,0,-6.0,-9.0,0.3120272159576416,56.40980860893181,73,-58,-45,1304,568,1693,762,34,7.68
-5,-7,0,-5.0,-7.0,0.31995224952697754,48.215028942721474,73,-53,-38,1304,568,1693,762,34,6.18
-4,-8,0,-4.0,-8.0,0.32794928550720215,40.4543296888929,73,-49,-30,1304,568,1693,762,34,4.69
-6,-9,0,-6.0,-9.0,0.3359963893890381,30.853944456021594,73,-43,-21,1304,568,1693,762,34,4.63
-7,-10,0,-7.0,-10.0,0.3440883159637451,20.64306044943742,73,-36,-11,1304,568,1693,762,34,3.53
-7,-8,0,-7.0,-8.0,0.3519623279571533,12.154759474226502,73,-29,-3,1304,568,1693,762,34,2.25
-5,-6,0,-5.0,-6.0,0.35997533798217773,7.186773244895647,73,-24,3,1304,568,1693,762,34,0.77
-5,-5,0,-5.0,-5.0,0.3680293560028076,3.615528128088304,73,-19,8,1304,568,1693,762,34,0.01
-4,-4,0,-4.0,-4.0,0.3760082721710205,2.2093727122985456,73,-15,12,1304,568,1693,762,34,-0.75
-5,-4,0,-5.0,-4.0,0.38400721549987793,1.8679622641132063,73,-10,16,1304,568,1693,762,34,-1.33
-5,-3,0,-5.0,-3.0,0.39197635650634766,2.6468827043884993,73,-5,19,1304,568,1693,762,34,-0.99
-3,-3,0,-3.0,-3.0,0.39995837211608887,5.090722034374522,73,-2,22,1304,568,1693,762,34,-0.5
-2,-1,0,-2.0,-1.0,0.4079551696777344,6.0,73,0,23,1304,568,1693,762,34,0.1
0,1,0,-0.0,1.0,0.47196531295776367,5.0,73,0,22,1304,568,1693,762,34,6.98
0,1,0,-0.0,1.0,0.48006129264831543,4.0,73,0,21,1304,568,1693,762,34,6.97
0,2,0,-0.0,2.0,0.4880082607269287,2.0,73,0,19,1304,568,1693,762,34,7.25
0,2,0,-0.0,2.0,0.49610328674316406,0.0,73,0,17,1304,568,1693,762,34,7.22
0,1,0,-0.0,1.0,0.5040192604064941,-1.0,73,0,16,1304,568,1693,762,34,6.93
0,0,1,-0.0,-0.0,0.5086603164672852,-1.0,73,0,16,1304,568,1693,762,34,26.64
0,0,0,-0.0,-0.0,0.5809793472290039,-1.0,73,0,16,1304,568,1693,762,34,16.64
-1,2,0,-1.0,2.0,0.6959831714630127,-2.964331152381801,73,1,14,1304,568,1693,762,34,1.06
-3,4,0,-3.0,4.0,0.7039673328399658,-6.2296703857309925,73,4,10,1304,568,1693,762,34,-0.39
-1,4,0,-1.0,4.0,0.7119531631469727,-9.189750324093346,73,5,6,1304,568,1693,762,34,-0.5
0,4,0,-0.0,4.0,0.7200243473052979,-11.614835192865495,73,5,2,1304,568,1693,762,34,-1.23
0,4,0,-0.0,4.0,0.7284033298492432,-11.614835192865495,73,5,-2,1304,568,1693,762,34,4.69
0,2,0,-0.0,2.0,0.7362792491912842,-10.596875762567151,73,5,-4,1304,568,1693,762,34,-1.04
0,2,0,-0.0,2.0,0.743962287902832,-9.189750324093346,73,5,-6,1304,568,1693,762,34,-0.59
0,1,0,-0.0,1.0,0.7520973682403564,-8.397674732957373,73,5,-7,1304,568,1693,762,34,0.54
0,1,0,-0.0,1.0,0.759965181350708,-7.566018867943397,73,5,-8,1304,568,1693,762,34,0.75
0,1,0,-0.0,1.0,0.7759613990783691,-6.704369859012999,73,5,-9,1304,568,1693,762,34,0.95
0,1,0,-0.0,1.0,0.7839772701263428,-5.819660112501051,73,5,-10,1304,568,1693,762,34,1.14
0,0,1,-0.0,-0.0,0.7867121696472168,-5.819660112501051,73,5,-10,1304,568,1693,762,34,25.27
0,0,0,-0.0,-0.0,0.8739871978759766,-5.819660112501051,73,5,-10,1304,568,1693,762,34,15.27
-2,0,0,-2.0,-0.0,0.9839832782745361,-4.793444384266298,73,7,-10,1304,568,1693,762,34,-0.32
-4,0,0,-4.0,-0.0,0.9919731616973877,-2.133931252681494,73,11,-10,1304,568,1693,762,34,-0.77
-5,0,0,-5.0,-0.0,0.9999592304229736,1.8679622641132063,73,16,-10,1304,568,1693,762,34,-0.47
-6,-1,0,-6.0,-1.0,1.008028268814087,6.769728648009426,73,22,-9,1304,568,1693,762,34,-0.41
-2,-1,0,-2.0,-1.0,1.015977382659912,8.298221281347036,73,24,-8,1304,568,1693,762,34,0.43
-1,0,0,-1.0,-0.0,1.0239653587341309,9.248809496813376,73,25,-8,1304,568,1693,762,34,2.32
0,-1,0,-0.0,-1.0,1.0399672985076904,8.96150997149434,73,25,-7,1304,568,1693,762,34,0.19
1,0,0,1.0,-0.0,1.119962215423584,8.0,73,24,-7,1304,568,1693,762,34,2.48
0,-1,0,-0.0,-1.0,1.1359553337097168,7.738633753705962,73,24,-6,1304,568,1693,762,34,0.14
0,0,1,-0.0,-0.0,1.1489722728729248,7.738633753705962,73,24,-6,1304,568,1693,762,34,29.21
0,0,0,-0.0,-0.0,0.06061434745788574,445.1535610078664,74,387,-222,1667,352,1280,574,3,125.62
1,-3,0,1.0,-3.0,0.23167037963867188,442.79837764462366,74,386,-219,1667,352,1280,574,3,53.27
2,-4,0,2.0,-4.0,0.2397143840789795,439.0920358288707,74,384,-215,1667,352,1280,574,3,66.53
3,-5,0,3.0,-5.0,0.2476353645324707,434.04137734243164,74,381,-210,1667,352,1280,574,3,74.89
5,-6,0,5.0,-6.0,0.25561952590942383,426.7756421303111,74,376,-204,1667,352,1280,574,3,83.75
7,-7,0,7.0,-7.0,0.2636094093322754,417.2941548719035,74,369,-197,1667,352,1280,574,3,88.69
6,-7,0,6.0,-7.0,0.271639347076416,408.71819583709,74,363,-190,1667,352,1280,574,3,85.02
7,-6,0,7.0,-6.0,0.2796053886413574,399.7393167634042,74,356,-184,1667,352,1280,574,3,85.38
9,-8,0,9.0,-8.0,0.2876284122467041,388.08225351460067,74,347,-176,1667,352,1280,574,3,88.44
12,-9,0,12.0,-9.0,0.2957875728607178,373.31804658605495,74,335,-167,1667,352,1280,574,3,90.3
12,-9,0,12.0,-9.0,0.3036184310913086,358.57335830119564,74,323,-158,1667,352,1280,574,3,87.78
14,-9,0,14.0,-9.0,0.3122243881225586,342.04810158343685,74,309,-149,1667,352,1280,574,3,87.04
17,-10,0,17.0,-10.0,0.3196704387664795,322.39604202896487,74,292,-139,1667,352,1280,574,3,85.95
17,-10,0,17.0,-10.0,0.3276073932647705,302.75318928366823,74,275,-129,1667,352,1280,574,3,82.21
17,-9,0,17.0,-9.0,0.335613489151001,283.541736833105,74,258,-120,1667,352,1280,574,3,79.07
18,-10,0,18.0,-10.0,0.3436884880065918,263.0075756488817,74,240,-110,1667,352,1280,574,3,75.16
17,-10,0,17.0,-10.0,0.35160040855407715,243.3951718017359,74,223,-100,1667,352,1280,574,3,70.34
18,-11,0,18.0,-11.0,0.35965442657470703,222.48601745970598,74,205,-89,1667,352,1280,574,3,66.18
18,-11,0,18.0,-11.0,0.36760449409484863,201.6153992173349,74,187,-78,1667,352,1280,574,3,61.53
16,-11,0,16.0,-11.0,0.3756093978881836,182.65728953678914,74,171,-67,1667,352,1280,574,3,56.12
15,-10,0,15.0,-10.0,0.3836073875427246,165.0873264279969,74,156,-57,1667,352,1280,574,3,51.6
13,-8,0,13.0,-8.0,0.39162254333496094,150.16216457830973,74,143,-49,1667,352,1280,574,3,47.2
11,-6,0,11.0,-6.0,0.39960336685180664,137.82723075823418,74,132,-43,1667,352,1280,574,3,43.3
8,-5,0,8.0,-5.0,0.4075953960418701,128.6919426949878,74,124,-38,1667,352,1280,574,3,38.42
7,-3,0,7.0,-3.0,0.41561245918273926,121.12288892750614,74,117,-35,1667,352,1280,574,3,36.33
5,-2,0,5.0,-2.0,0.4237174987792969,115.76043850551436,74,112,-33,1667,352,1280,574,3,32.27
4,-1,0,4.0,-1.0,0.43161439895629883,111.64102272262978,74,108,-32,1667,352,1280,574,3,29.79
2,-1,0,2.0,-1.0,0.43959736824035645,109.44002897500525,74,106,-31,1667,352,1280,574,3,21.13
3,-1,0,3.0,-1.0,0.44759654998779297,106.28000745712129,74,103,-30,1667,352,1280,574,3,26.32
3,0,0,3.0,-0.0,0.4556105136871338,103.4030650891055,74,100,-30,1667,352,1280,574,3,22.4
4,-1,0,4.0,-1.0,0.46387553215026855,99.2845950283492,74,96,-29,1667,352,1280,574,3,27.58
4,-1,0,4.0,-1.0,0.4716494083404541,95.16652224137046,74,92,-28,1667,352,1280,574,3,26.83
4,0,0,4.0,-0.0,0.4796113967895508,91.34717104492157,74,88,-28,1667,352,1280,574,3,23.15
2,-1,0,2.0,-1.0,0.4876124858856201,89.13878188659973,74,86,-27,1667,352,1280,574,3,18.79
3,-1,0,3.0,-1.0,0.4956395626068115,85.97700845625813,74,83,-26,1667,352,1280,574,3,23.98
2,-1,0,2.0,-1.0,0.5036613941192627,83.77027781009096,74,81,-25,1667,352,1280,574,3,18.06
2,-1,0,2.0,-1.0,0.5116164684295654,81.56512580987206,74,79,-24,1667,352,1280,574,3,17.74
3,0,0,3.0,-0.0,0.5196404457092285,78.6994353806851,74,76,-24,1667,352,1280,574,3,18.69
2,-1,0,2.0,-1.0,0.5281414985656738,76.4919350642375,74,74,-23,1667,352,1280,574,3,17.15
1,0,0,1.0,-0.0,0.5356285572052002,75.53757247260981,74,73,-23,1667,352,1280,574,3,10.28
2,0,0,2.0,-0.0,0.5436124801635742,73.63243262818116,74,71,-23,1667,352,1280,574,3,14.76
1,0,0,1.0,-0.0,0.5516023635864258,72.68174807915459,74,70,-23,1667,352,1280,574,3,9.99
2,-1,0,2.0,-1.0,0.559598445892334,70.47027354082255,74,68,-22,1667,352,1280,574,3,16.47
2,-1,0,2.0,-1.0,0.5676133632659912,68.26037828369117,74,66,-21,1667,352,1280,574,3,16.14
2,0,0,2.0,-0.0,0.5757474899291992,66.35725647619564,74,64,-21,1667,352,1280,574,3,13.86
2,-1,0,2.0,-1.0,0.5836834907531738,64.14598989960932,74,62,-20,1667,352,1280,574,3,15.63
1,0,0,1.0,-0.0,0.5915954113006592,63.19501538281614,74,61,-20,1667,352,1280,574,3,9.29
1,0,0,1.0,-0.0,0.6076195240020752,62.245553203367585,74,60,-20,1667,352,1280,574,3,9.19
1,0,0,1.0,-0.0,0.623591423034668,61.297672508690084,74,59,-20,1667,352,1280,574,3,9.09
1,0,0,1.0,-0.0,0.6316375732421875,60.35144660071187,74,58,-20,1667,352,1280,574,3,8.99
2,0,0,2.0,-0.0,0.6395964622497559,58.464274989274024,74,56,-20,1667,352,1280,574,3,12.74
2,-1,0,2.0,-1.0,0.6476545333862305,56.245087125446844,74,54,-19,1667,352,1280,574,3,14.86
2,0,0,2.0,-0.0,0.6556134223937988,54.362442142665635,74,52,-19,1667,352,1280,574,3,12.19
4,-1,0,4.0,-1.0,0.6635973453521729,50.264022471905186,74,48,-18,1667,352,1280,574,3,17.8
2,-1,0,2.0,-1.0,0.6718544960021973,48.040799340956916,74,46,-17,1667,352,1280,574,3,13.93
2,-1,0,2.0,-1.0,0.6797614097595215,45.8187996428785,74,44,-16,1667,352,1280,574,3,13.56
2,-1,0,2.0,-1.0,0.6876134872436523,43.598206241955516,74,42,-15,1667,352,1280,574,3,13.18
3,-1,0,3.0,-1.0,0.6956114768981934,40.43669871020132,74,39,-14,1667,352,1280,574,3,16.54
3,-2,0,3.0,-2.0,0.7036044597625732,36.94733192202055,74,36,-12,1667,352,1280,574,3,13.36
4,-1,0,4.0,-1.0,0.7116024494171143,32.83784863137726,74,32,-11,1667,352,1280,574,3,14.88
4,-2,0,4.0,-2.0,0.7197244167327881,28.410882339705484,74,28,-9,1667,352,1280,574,3,13.53
4,-1,0,4.0,-1.0,0.727635383605957,24.298221281347036,74,24,-8,1667,352,1280,574,3,13.35
4,-1,0,4.0,-1.0,0.7355964183807373,20.18962010041709,74,20,-7,1667,352,1280,574,3,12.27
3,-1,0,3.0,-1.0,0.7437734603881836,17.027756377319946,74,17,-6,1667,352,1280,574,3,12.78
3,-2,0,3.0,-2.0,0.751645565032959,13.560219778561036,74,14,-4,1667,352,1280,574,3,8.66
3,-1,0,3.0,-1.0,0.7596044540405273,10.40175425099138,74,11,-3,1667,352,1280,574,3,10.12
2,-2,0,2.0,-2.0,0.7676784992218018,8.055385138137417,74,9,-1,1667,352,1280,574,3,5.29
2,-1,0,2.0,-1.0,0.7756145000457764,6.0,74,7,0,1667,352,1280,574,3,5.14
2,-1,0,2.0,-1.0,0.7836494445800781,4.0990195135927845,74,5,1,1667,352,1280,574,3,3.96
2,-1,0,2.0,-1.0,0.7916085720062256,2.605551275463989,74,3,2,1667,352,1280,574,3,2.28
0,-1,0,-0.0,-1.0,0.7996053695678711,3.2426406871192848,74,3,3,1667,352,1280,574,3,3.09
1,0,0,1.0,-0.0,0.8076224327087402,2.605551275463989,74,2,3,1667,352,1280,574,3,1.27
1,0,0,1.0,-0.0,0.8156013488769531,2.1622776601683795,74,1,3,1667,352,1280,574,3,0.34
1,-1,0,1.0,-1.0,0.823615550994873,3.0,74,0,4,1667,352,1280,574,3,1.86
1,0,0,1.0,-0.0,0.8315935134887695,3.1231056256176606,74,-1,4,1667,352,1280,574,3,6.97
2,0,0,2.0,-0.0,0.8396074771881104,4.0,74,-3,4,1667,352,1280,574,3,1.55
1,-1,0,1.0,-1.0,0.8476123809814453,5.4031242374328485,74,-4,5,1667,352,1280,574,3,4.17
1,0,0,1.0,-0.0,0.8555994033813477,6.0710678118654755,74,-5,5,1667,352,1280,574,3,3.81
1,0,0,1.0,-0.0,0.8637564182281494,6.810249675906654,74,-6,5,1667,352,1280,574,3,3.85
1,-1,0,1.0,-1.0,0.8716113567352295,8.219544457292887,74,-7,6,1667,352,1280,574,3,5.25
1,0,0,1.0,-0.0,0.9036643505096436,9.0,74,-8,6,1667,352,1280,574,3,4.21
0,0,1,-0.0,-0.0,0.981642484664917,9.0,74,-8,6,1667,352,1280,574,3,19.58
-1,1,1,-1.0,1.0,0.9996185302734375,7.602325267042627,74,-7,5,1667,352,1280,574,3,6.14
-1,1,1,-1.0,1.0,1.0076124668121338,6.211102550927978,74,-6,4,1667,352,1280,574,3,5.63
-1,1,1,-1.0,1.0,1.0156733989715576,4.830951894845301,74,-5,3,1667,352,1280,574,3,5.02
-1,2,1,-1.0,2.0,1.0236365795135498,3.1231056256176606,74,-4,1,1667,352,1280,574,3,3.04
-2,2,1,-2.0,2.0,1.0316593647003174,1.2360679774997898,74,-2,-1,1667,352,1280,574,3,11.98
-1,3,1,-1.0,3.0,1.0397963523864746,3.1231056256176606,74,-1,-4,1667,352,1280,574,3,-0.85
-2,3,1,-2.0,3.0,1.0476393699645996,6.0710678118654755,74,1,-7,1667,352,1280,574,3,-0.21
0,0,0,-0.0,-0.0,1.0485854148864746,6.0710678118654755,74,1,-7,1667,352,1280,574,3,18.71
-3,4,0,-3.0,4.0,1.055612564086914,10.704699910719626,74,4,-11,1667,352,1280,574,3,0.33
-1,4,0,-1.0,4.0,1.0636084079742432,14.811388300841896,74,5,-15,1667,352,1280,574,3,3.26
-2,2,0,-2.0,2.0,1.071683406829834,17.384776310850235,74,7,-17,1667,352,1280,574,3,2.35
0,1,0,-0.0,1.0,1.0797085762023926,18.313207915827967,74,7,-18,1667,352,1280,574,3,5.69
0,-1,0,-0.0,-1.0,1.1836085319519043,17.384776310850235,74,7,-17,1667,352,1280,574,3,5.23
0,-1,0,-0.0,-1.0,1.1916234493255615,16.46424919657298,74,7,-16,1667,352,1280,574,3,5.04
0,0,1,-0.0,-0.0,1.2156105041503906,16.46424919657298,74,7,-16,1667,352,1280,574,3,21.83
0,-1,1,-0.0,-1.0,1.2236464023590088,15.552945357246848,74,7,-15,1667,352,1280,574,3,4.85
0,-1,1,-0.0,-1.0,1.231663465499878,14.652475842498529,74,7,-14,1667,352,1280,574,3,4.65
0,-1,1,-0.0,-1.0,1.239736557006836,13.7648230602334,74,7,-13,1667,352,1280,574,3,4.44
0,-1,1,-0.0,-1.0,1.2476093769073486,12.892443989449804,74,7,-12,1667,352,1280,574,3,4.21
1,-1,1,1.0,-1.0,1.2556514739990234,11.529964086141668,74,6,-11,1667,352,1280,574,3,5.91
0,0,0,-0.0,-0.0,1.259603500366211,11.529964086141668,74,6,-11,1667,352,1280,574,3,20.34
0,-1,0,-0.0,-1.0,1.2638685703277588,10.661903789690601,74,6,-10,1667,352,1280,574,3,3.93
0,-1,0,-0.0,-1.0,1.2716064453125,9.816653826391969,74,6,-9,1667,352,1280,574,3,3.65
1,-1,0,1.0,-1.0,1.2796053886413574,8.433981132056603,74,5,-8,1667,352,1280,574,3,5.81
0,-1,0,-0.0,-1.0,1.3036835193634033,7.602325267042627,74,5,-7,1667,352,1280,574,3,3.27
0,-1,0,-0.0,-1.0,1.3436024188995361,6.810249675906654,74,5,-6,1667,352,1280,574,3,2.9
1,0,0,1.0,-0.0,1.3516385555267334,6.211102550927978,74,4,-6,1667,352,1280,574,3,1.85
0,-1,0,-0.0,-1.0,1.3679554462432861,5.4031242374328485,74,4,-5,1667,352,1280,574,3,2.76
0,0,1,-0.0,-0.0,1.408616542816162,5.4031242374328485,74,4,-5,1667,352,1280,574,3,18.51
0,0,0,-0.0,-0.0,1.5246384143829346,5.4031242374328485,74,4,-5,1667,352,1280,574,3,18.51
1,-1,0,1.0,-1.0,1.543609380722046,4.0,74,3,-4,1667,352,1280,574,3,5.64
1,0,0,1.0,-0.0,1.559598445892334,3.4721359549995796,74,2,-4,1667,352,1280,574,3,1.04
0,-1,0,-0.0,-1.0,1.5676095485687256,2.605551275463989,74,2,-3,1667,352,1280,574,3,2.49
0,0,1,-0.0,-0.0,1.634615421295166,2.605551275463989,74,2,-3,1667,352,1280,574,3,27.69
1,0,1,1.0,-0.0,1.6958155632019043,2.1622776601683795,74,1,-3,1667,352,1280,574,3,10.34
1,0,1,1.0,-0.0,1.711592435836792,2.0,74,0,-3,1667,352,1280,574,3,9.2
0,0,0,-0.0,-0.0,1.714592456817627,2.0,74,0,-3,1667,352,1280,574,3,17.51
0,0,1,-0.0,-0.0,1.931624412536621,2.0,74,0,-3,1667,352,1280,574,3,27.51
0,0,0,-0.0,-0.0,0.07779431343078613,702.1549421438926,75,-705,-174,962,181,1667,355,49,167.1
-2,0,0,-2.0,-0.0,0.2349073886871338,700.2133663500005,75,-703,-174,962,181,1667,355,49,8.82
-4,2,0,-4.0,2.0,0.24276447296142578,696.8168976931659,75,-699,-176,962,181,1667,355,49,11.54
-7,3,0,-7.0,3.0,0.25077247619628906,690.776188747219,75,-692,-179,962,181,1667,355,49,18.68
-10,4,0,-10.0,4.0,0.2588174343109131,682.1253429809753,75,-682,-183,962,181,1667,355,49,24.88
-11,3,0,-11.0,3.0,0.26682043075561523,672.3023768450026,75,-671,-186,962,181,1667,355,49,27.54
-12,3,0,-12.0,3.0,0.2747783660888672,661.5669186884677,75,-659,-189,962,181,1667,355,49,29.26
-15,3,0,-15.0,3.0,0.282759428024292,648.0119046564577,75,-644,-192,962,181,1667,355,49,34.59
-16,1,0,-16.0,1.0,0.29077649116516113,632.9878233270385,75,-628,-193,962,181,1667,355,49,37.19
-16,1,0,-16.0,1.0,0.29879331588745117,618.0124609382593,75,-612,-194,962,181,1667,355,49,36.53
-16,0,0,-16.0,-0.0,0.30731844902038574,602.7790679338294,75,-596,-194,962,181,1667,355,49,36.64
-19,-2,0,-19.0,-2.0,0.31490349769592285,584.1060762728819,75,-577,-192,962,181,1667,355,49,41.93
-21,-4,0,-21.0,-4.0,0.32276344299316406,562.9241859047896,75,-556,-188,962,181,1667,355,49,45.15
-29,-7,0,-29.0,-7.0,0.3307664394378662,533.2162955262526,75,-527,-181,962,181,1667,355,49,54.2
-33,-8,0,-33.0,-8.0,0.33876943588256836,499.41666003290345,75,-494,-173,962,181,1667,355,49,55.85
-31,-8,0,-31.0,-8.0,0.34680747985839844,467.5221256464453,75,-463,-165,962,181,1667,355,49,51.98
-26,-9,0,-26.0,-9.0,0.3547794818878174,440.00969817451016,75,-437,-156,962,181,1667,355,49,48.22
-22,-8,0,-22.0,-8.0,0.3627784252166748,416.6007262817437,75,-415,-148,962,181,1667,355,49,42.8
-19,-9,0,-19.0,-9.0,0.37082338333129883,395.68678797407955,75,-396,-139,962,181,1667,355,49,36.2
-16,-7,0,-16.0,-7.0,0.3788163661956787,378.27353877678803,75,-380,-132,962,181,1667,355,49,31.69
-15,-7,0,-15.0,-7.0,0.3869173526763916,361.8108344772085,75,-365,-125,962,181,1667,355,49,29.34
-12,-6,0,-12.0,-6.0,0.39478230476379395,348.5184559186296,75,-353,-119,962,181,1667,355,49,24.55
-11,-6,0,-11.0,-6.0,0.4028313159942627,336.1846748544419,75,-342,-113,962,181,1667,355,49,22.47
-9,-4,0,-9.0,-4.0,0.41082143783569336,326.3855019831728,75,-333,-109,962,181,1667,355,49,19.57
-8,-4,0,-8.0,-4.0,0.41877245903015137,317.5406271587613,75,-325,-105,962,181,1667,355,49,17.47
-6,-4,0,-6.0,-4.0,0.42678141593933105,310.6072324382723,75,-319,-101,962,181,1667,355,49,13.78
-6,-4,0,-6.0,-4.0,0.43476152420043945,303.6858251435359,75,-313,-97,962,181,1667,355,49,13.54
-7,-3,0,-7.0,-3.0,0.4428584575653076,296.1124802315586,75,-306,-94,962,181,1667,355,49,15.54
-9,-5,0,-9.0,-5.0,0.4508063793182373,286.0483833210552,75,-297,-89,962,181,1667,355,49,17.42
-10,-4,0,-10.0,-4.0,0.45885348320007324,275.322568477554,75,-287,-85,962,181,1667,355,49,18.88
-10,-4,0,-10.0,-4.0,0.4669945240020752,264.60006930006097,75,-277,-81,962,181,1667,355,49,18.39
-11,-4,0,-11.0,-4.0,0.47477030754089355,252.92056622793478,75,-266,-77,962,181,1667,355,49,19.35
-13,-4,0,-13.0,-4.0,0.4827854633331299,239.32109676210905,75,-253,-73,962,181,1667,355,49,21.98
-13,-5,0,-13.0,-5.0,0.49082446098327637,225.44738924270183,75,-240,-68,962,181,1667,355,49,19.69
-13,-3,0,-13.0,-3.0,0.49877142906188965,212.1228493814184,75,-227,-65,962,181,1667,355,49,19.18
-12,-3,0,-12.0,-3.0,0.5067644119262695,199.76103324752503,75,-215,-62,962,181,1667,355,49,18.14
-13,-3,0,-13.0,-3.0,0.5147793292999268,186.440015206234,75,-202,-59,962,181,1667,355,49,17.66
-13,-3,0,-13.0,-3.0,0.5227704048156738,173.12178976460214,75,-189,-56,962,181,1667,355,49,16.82
-12,-3,0,-12.0,-3.0,0.5307815074920654,160.76471524617463,75,-177,-53,962,181,1667,355,49,15.78
-14,-4,0,-14.0,-4.0,0.5387635231018066,146.20575783445165,75,-163,-49,962,181,1667,355,49,17.59
-15,-3,0,-15.0,-3.0,0.5467863082885742,130.983870128475,75,-148,-46,962,181,1667,355,49,14.71
-15,-3,0,-15.0,-3.0,0.5548114776611328,115.77839604173457,75,-133,-43,962,181,1667,355,49,13.5
-13,-3,0,-13.0,-3.0,0.5628354549407959,102.49110640673517,75,-120,-40,962,181,1667,355,49,11.92
-12,-2,0,-12.0,-2.0,0.5707783699035645,90.49017425089369,75,-108,-38,962,181,1667,355,49,9.74
-8,-2,0,-8.0,-2.0,0.5787534713745117,82.28264204469139,75,-100,-36,962,181,1667,355,49,8.29
-7,-1,0,-7.0,-1.0,0.5867824554443359,75.36800289831733,75,-93,-35,962,181,1667,355,49,6.35
-4,-1,0,-4.0,-1.0,0.5947813987731934,71.2732911156112,75,-89,-34,962,181,1667,355,49,5.72
-4,-1,0,-4.0,-1.0,0.6028323173522949,67.18113840043894,75,-85,-33,962,181,1667,355,49,5.55
-4,-2,0,-4.0,-2.0,0.6107673645019531,62.729464428186105,75,-81,-31,962,181,1667,355,49,5.9
-6,-2,0,-6.0,-2.0,0.6187703609466553,56.4114419718985,75,-75,-29,962,181,1667,355,49,7.32
-7,-2,0,-7.0,-2.0,0.6267693042755127,49.16419889536138,75,-68,-27,962,181,1667,355,49,6.38
-6,-2,0,-6.0,-2.0,0.634803295135498,42.85057965343307,75,-62,-25,962,181,1667,355,49,6.44
-6,-2,0,-6.0,-2.0,0.6427774429321289,36.53924347066124,75,-56,-23,962,181,1667,355,49,6.04
-6,-2,0,-6.0,-2.0,0.6507594585418701,30.230987451824994,75,-50,-21,962,181,1667,355,49,5.62
-6,-2,0,-6.0,-2.0,0.6588244438171387,23.927027865287037,75,-44,-19,962,181,1667,355,49,5.16
-5,-2,0,-5.0,-2.0,0.6668493747711182,18.5440947723653,75,-39,-17,962,181,1667,355,49,6.03
-4,-2,0,-4.0,-2.0,0.6747593879699707,14.078865529319543,75,-35,-15,962,181,1667,355,49,4.94
-2,0,0,-2.0,-0.0,0.6827864646911621,12.249137920783717,75,-33,-15,962,181,1667,355,49,1.95
-2,-1,0,-2.0,-1.0,0.6907823085784912,10.0147027033899,75,-31,-14,962,181,1667,355,49,5.05
-1,-1,0,-1.0,-1.0,0.7068674564361572,8.695565448543633,75,-30,-13,962,181,1667,355,49,2.05
-1,0,0,-1.0,-0.0,0.7227654457092285,7.7804971641414085,75,-29,-13,962,181,1667,355,49,1.89
-1,0,0,-1.0,-0.0,0.7308483123779297,6.870698080866262,75,-28,-13,962,181,1667,355,49,1.84
0,-1,0,-0.0,-1.0,0.7388772964477539,6.463092423455635,75,-28,-12,962,181,1667,355,49,0.37
0,0,1,-0.0,-0.0,0.7487683296203613,6.463092423455635,75,-28,-12,962,181,1667,355,49,28.83
0,0,0,-0.0,-0.0,0.1043241024017334,949.0556706411658,76,-833,461,157,654,990,193,6,199.58
-1,0,0,-1.0,-0.0,0.11733007431030273,948.1808450552397,76,-832,461,157,654,990,193,6,26.26
-1,0,0,-1.0,-0.0,0.1333620548248291,947.3062664215153,76,-831,461,157,654,990,193,6,26.24
-1,0,0,-1.0,-0.0,0.15733599662780762,946.4319354224399,76,-830,461,157,654,990,193,6,26.22
-1,0,0,-1.0,-0.0,0.18135714530944824,945.5578527427834,76,-829,461,157,654,990,193,6,26.2
-2,0,0,-2.0,-0.0,0.18932795524597168,943.810435092474,76,-827,461,157,654,990,193,6,45.08
-6,2,0,-6.0,2.0,0.19732308387756348,937.5966191731713,76,-821,459,157,654,990,193,6,100.46
-8,3,0,-8.0,3.0,0.20533108711242676,929.1507388829341,76,-813,456,157,654,990,193,6,114.64
-12,7,0,-12.0,7.0,0.21332812309265137,915.2603116763786,76,-801,449,157,654,990,193,6,137.42
-15,6,0,-15.0,6.0,0.22133493423461914,899.2444236458323,76,-786,443,157,654,990,193,6,139.26
-20,9,0,-20.0,9.0,0.22933197021484375,877.4044525103221,76,-766,434,157,654,990,193,6,148.15
-26,10,0,-26.0,10.0,0.23732900619506836,849.8634122765498,76,-740,424,157,654,990,193,6,151.29
-33,11,0,-33.0,11.0,0.24542593955993652,815.7905715138639,76,-707,413,157,654,990,193,6,152.29
-33,12,0,-33.0,12.0,0.2533259391784668,781.2684489382447,76,-674,401,157,654,990,193,6,148.76
-31,13,0,-31.0,13.0,0.2613680362701416,747.9946737494215,76,-643,388,157,654,990,193,6,144.42
-24,11,0,-24.0,11.0,0.269334077835083,721.7689286938286,76,-619,377,157,654,990,193,6,136.2
-24,12,0,-24.0,12.0,0.277346134185791,695.0329505116503,76,-595,365,157,654,990,193,6,133.92
-24,14,0,-24.0,14.0,0.2853240966796875,667.2551752877407,76,-571,351,157,654,990,193,6,132.92
-24,14,0,-24.0,14.0,0.2934529781341553,639.4780151880685,76,-547,337,157,654,990,193,6,129.45
-24,17,0,-24.0,17.0,0.301332950592041,610.1304918204606,76,-523,320,157,654,990,193,6,125.75
-24,16,0,-24.0,16.0,0.3093569278717041,581.3089935984214,76,-499,304,157,654,990,193,6,122.2
-23,18,0,-23.0,18.0,0.317965030670166,552.3125246201457,76,-476,286,157,654,990,193,6,117.06
-22,17,0,-22.0,17.0,0.325329065322876,524.7092002230016,76,-454,269,157,654,990,193,6,112.32
-20,18,0,-20.0,18.0,0.3334951400756836,498.3551635318021,76,-434,251,157,654,990,193,6,107.04
-21,17,0,-21.0,17.0,0.34151792526245117,471.68410548490033,76,-413,234,157,654,990,193,6,103.75
-22,17,0,-22.0,17.0,0.3493211269378662,444.1800532224129,76,-391,217,157,654,990,193,6,100.34
-24,17,0,-24.0,17.0,0.35733914375305176,414.95813187447374,76,-367,200,157,654,990,193,6,97.17
-25,16,0,-25.0,16.0,0.36534810066223145,385.35550723531657,76,-342,184,157,654,990,193,6,93.19
-25,15,0,-25.0,15.0,0.3733839988708496,356.23529893372114,76,-317,169,157,654,990,193,6,88.62
-24,14,0,-24.0,14.0,0.3813290596008301,328.4724724618924,76,-293,155,157,654,990,193,6,83.47
-22,12,0,-22.0,12.0,0.38936400413513184,303.41475160311717,76,-271,143,157,654,990,193,6,78.81
-18,9,0,-18.0,9.0,0.39739203453063965,283.29530209208815,76,-253,134,157,654,990,193,6,71.68
-14,7,0,-14.0,7.0,0.4053459167480469,267.64737205448716,76,-239,127,157,654,990,193,6,65.05
-12,5,0,-12.0,5.0,0.41339707374572754,254.7071981920567,76,-227,122,157,654,990,193,6,58.21
-10,3,0,-10.0,3.0,0.4213390350341797,244.48737341529164,76,-217,119,157,654,990,193,6,51.52
-8,4,0,-8.0,4.0,0.4293379783630371,235.549785160247,76,-209,115,157,654,990,193,6,49.92
-5,3,0,-5.0,3.0,0.43766093254089355,229.7230113246217,76,-204,112,157,654,990,193,6,41.37
-3,1,0,-3.0,1.0,0.4454379081726074,226.61271741782946,76,-201,111,157,654,990,193,6,28.08
-2,2,0,-2.0,2.0,0.453326940536499,223.89645215384044,76,-199,109,157,654,990,193,6,25.11
-2,1,0,-2.0,1.0,0.4614219665527344,221.66196829904254,76,-197,108,157,654,990,193,6,24.53
-1,1,0,-1.0,1.0,0.46945810317993164,220.3047245357787,76,-196,107,157,654,990,193,6,15.74
-1,0,0,-1.0,-0.0,0.4773831367492676,219.4275162833951,76,-195,107,157,654,990,193,6,10.86
-2,1,0,-2.0,1.0,0.48533105850219727,217.19309707617992,76,-193,106,157,654,990,193,6,24.22
-3,1,0,-3.0,1.0,0.4934380054473877,214.0829334609241,76,-190,105,157,654,990,193,6,27.04
-2,2,0,-2.0,2.0,0.5013301372528076,211.36650857818253,76,-188,103,157,654,990,193,6,24.16
-5,1,0,-5.0,1.0,0.5093920230865479,206.50656314301946,76,-183,102,157,654,990,193,6,32.88
-5,3,0,-5.0,3.0,0.5173189640045166,200.67866849525504,76,-178,99,157,654,990,193,6,38.03
-7,3,0,-7.0,3.0,0.525331974029541,193.1045639448506,76,-171,96,157,654,990,193,6,39.91
-7,4,0,-7.0,4.0,0.5333240032196045,185.04254837669055,76,-164,92,157,654,990,193,6,42.25
-8,3,0,-8.0,3.0,0.5413200855255127,176.60233851484227,76,-156,89,157,654,990,193,6,38.6
-6,4,0,-6.0,4.0,0.549346923828125,169.40939649566667,76,-150,85,157,654,990,193,6,36.24
-6,3,0,-6.0,3.0,0.5573301315307617,162.71059109181888,76,-144,82,157,654,990,193,6,34.63
-7,4,0,-7.0,4.0,0.5653209686279297,154.64834283937145,76,-137,78,157,654,990,193,6,38.24
-5,3,0,-5.0,3.0,0.5735149383544922,148.81897114655993,76,-132,75,157,654,990,193,6,31.7
-6,3,0,-6.0,3.0,0.5814149379730225,142.12063946937388,76,-126,72,157,654,990,193,6,31.66
-6,2,0,-6.0,2.0,0.5893280506134033,135.92443989449805,76,-120,70,157,654,990,193,6,28.11
-5,3,0,-5.0,3.0,0.5974149703979492,130.09395177843356,76,-115,67,157,654,990,193,6,29.67
-4,3,0,-4.0,3.0,0.6053309440612793,125.1288414058287,76,-111,64,157,654,990,193,6,24.75
-5,2,0,-5.0,2.0,0.6133289337158203,119.80065146407001,76,-106,62,157,654,990,193,6,24.57
-3,2,0,-3.0,2.0,0.6213319301605225,116.20151005754919,76,-103,60,157,654,990,193,6,21.05
-4,3,0,-4.0,3.0,0.6294410228729248,111.23659658795863,76,-99,57,157,654,990,193,6,22.94
-4,3,0,-4.0,3.0,0.6373341083526611,106.27488274987991,76,-95,54,157,654,990,193,6,22.22
-5,4,0,-5.0,4.0,0.645362138748169,99.95630140987001,76,-90,50,157,654,990,193,6,23.33
-7,4,0,-7.0,4.0,0.6533761024475098,91.89467845985885,76,-83,46,157,654,990,193,6,27.21
-5,4,0,-5.0,4.0,0.6613359451293945,85.58893836140041,76,-78,42,157,654,990,193,6,21.0
-6,4,0,-6.0,4.0,0.6693429946899414,78.41252974819048,76,-72,38,157,654,990,193,6,21.67
-6,5,0,-6.0,5.0,0.6773800849914551,70.79024325749306,76,-66,33,157,654,990,193,6,19.71
-5,3,0,-5.0,3.0,0.6853289604187012,64.97793759742936,76,-61,30,157,654,990,193,6,18.19
-5,4,0,-5.0,4.0,0.693371057510376,58.741396161732524,76,-56,26,157,654,990,193,6,16.24
-4,2,0,-4.0,2.0,0.7013320922851562,54.271284253105414,76,-52,24,157,654,990,193,6,16.07
-4,3,0,-4.0,3.0,0.7093350887298584,49.392747589718944,76,-48,21,157,654,990,193,6,13.35
-4,3,0,-4.0,3.0,0.7173280715942383,44.53945729601885,76,-44,18,157,654,990,193,6,12.46
-5,1,0,-5.0,1.0,0.725398063659668,39.5440947723653,76,-39,17,157,654,990,193,6,12.1
-4,2,0,-4.0,2.0,0.7333130836486816,35.07886552931954,76,-35,15,157,654,990,193,6,12.63
-3,1,0,-3.0,1.0,0.7413110733032227,31.928498393145958,76,-32,14,157,654,990,193,6,10.16
-2,1,0,-2.0,1.0,0.749359130859375,29.695565448543633,76,-30,13,157,654,990,193,6,9.28
-3,1,0,-3.0,1.0,0.7573249340057373,26.546573405388315,76,-27,12,157,654,990,193,6,9.42
-3,1,0,-3.0,1.0,0.7653510570526123,23.40075756488817,76,-24,11,157,654,990,193,6,8.88
-2,1,0,-2.0,1.0,0.7733421325683594,21.166091947189145,76,-22,10,157,654,990,193,6,8.91
-3,0,0,-3.0,-0.0,0.7813141345977783,18.470910553583888,76,-19,10,157,654,990,193,6,5.67
-2,1,0,-2.0,1.0,0.7897930145263672,16.235384061671343,76,-17,9,157,654,990,193,6,8.91
-2,1,0,-2.0,1.0,0.7973759174346924,14.0,76,-15,8,157,654,990,193,6,8.53
-1,0,0,-1.0,-0.0,0.805333137512207,13.124515496597098,76,-14,8,157,654,990,193,6,2.93
-1,1,0,-1.0,1.0,0.8133819103240967,11.7648230602334,76,-13,7,157,654,990,193,6,4.25
-1,0,0,-1.0,-0.0,0.8773751258850098,10.892443989449804,76,-12,7,157,654,990,193,6,2.75
-1,0,0,-1.0,-0.0,0.8933939933776855,10.038404810405298,76,-11,7,157,654,990,193,6,2.56
0,1,0,-0.0,1.0,0.9013869762420654,9.529964086141668,76,-11,6,157,654,990,193,6,1.07
-1,0,0,-1.0,-0.0,0.9097421169281006,8.661903789690601,76,-10,6,157,654,990,193,6,2.53
-1,1,0,-1.0,1.0,0.9653840065002441,7.295630140987001,76,-9,5,157,654,990,193,6,3.86
-1,0,0,-1.0,-0.0,0.9733550548553467,6.433981132056603,76,-8,5,157,654,990,193,6,2.28
-1,1,0,-1.0,1.0,0.9893429279327393,5.062257748298549,76,-7,4,157,654,990,193,6,3.64
-1,0,0,-1.0,-0.0,1.005514144897461,4.211102550927978,76,-6,4,157,654,990,193,6,1.94
0,1,0,-0.0,1.0,1.021317958831787,3.7082039324993694,76,-6,3,157,654,990,193,6,0.52
-1,0,0,-1.0,-0.0,1.0293750762939453,2.8309518948453007,76,-5,3,157,654,990,193,6,1.9
-1,1,0,-1.0,1.0,1.0374219417572021,1.4721359549995796,76,-4,2,157,654,990,193,6,2.74
-1,1,0,-1.0,1.0,1.0453169345855713,0.16227766016837952,76,-3,1,157,654,990,193,6,1.84
-2,0,0,-2.0,-0.0,1.0533421039581299,-1.5857864376269049,76,-1,1,157,654,990,193,6,0.71
-1,1,0,-1.0,1.0,1.0613489151000977,-3.0,76,0,0,157,654,990,193,6,8.44
0,0,1,-0.0,-0.0,1.1093361377716064,-3.0,76,0,0,157,654,990,193,6,26.07
-1,1,1,-1.0,1.0,0.016653060913085938,356.83114882639325,77,382,-67,538,588,157,654,62,2.82
-1,0,1,-1.0,-0.0,0.03270411491394043,357.8161519278745,77,383,-67,538,588,157,654,62,4.81
-1,0,1,-1.0,-0.0,0.048651933670043945,358.80123139877327,77,384,-67,538,588,157,654,62,4.81
0,1,1,-0.0,1.0,0.0567169189453125,358.9743581314033,77,384,-68,538,588,157,654,62,9.01
0,0,0,-0.0,-0.0,0.12067604064941406,358.9743581314033,77,384,-68,538,588,157,654,62,109.14
3,0,0,3.0,-0.0,0.17675209045410156,356.02067128255567,77,381,-68,538,588,157,654,62,7.72
3,0,0,3.0,-0.0,0.18477797508239746,353.06770236509084,77,378,-68,538,588,157,654,62,7.68
3,0,0,3.0,-0.0,0.1930680274963379,350.1154680670938,77,375,-68,538,588,157,654,62,7.64
4,0,0,4.0,-0.0,0.200714111328125,346.18032822510776,77,371,-68,538,588,157,654,62,8.98
6,-1,0,6.0,-1.0,0.20864391326904297,340.098369708087,77,365,-67,538,588,157,654,62,14.4
7,-2,0,7.0,-2.0,0.21665191650390625,332.8529922922168,77,358,-65,538,588,157,654,62,13.88
9,-3,0,9.0,-3.0,0.22464299201965332,323.4643846707311,77,349,-62,538,588,157,654,62,15.67
14,-4,0,14.0,-4.0,0.23265600204467773,308.98382314457257,77,335,-58,538,588,157,654,62,20.86
19,-5,0,19.0,-5.0,0.24075794219970703,289.41379495895615,77,316,-53,538,588,157,654,62,24.58
22,-7,0,22.0,-7.0,0.24864912033081055,266.57688082241873,77,294,-46,538,588,157,654,62,24.99
22,-5,0,22.0,-5.0,0.2566549777984619,244.0727176584403,77,272,-41,538,588,157,654,62,24.31
22,-4,0,22.0,-4.0,0.26467204093933105,221.7231687044146,77,250,-37,538,588,157,654,62,23.73
21,-3,0,21.0,-3.0,0.27263903617858887,200.51025895195227,77,229,-34,538,588,157,654,62,23.14
18,-2,0,18.0,-2.0,0.28064894676208496,182.41274563624359,77,211,-32,538,588,157,654,62,18.51
18,-2,0,18.0,-2.0,0.2886490821838379,164.3176899310454,77,193,-30,538,588,157,654,62,17.31
16,-1,0,16.0,-1.0,0.29674506187438965,148.3599732381782,77,177,-29,538,588,157,654,62,14.19
13,0,0,13.0,-0.0,0.3048410415649414,135.54428840401582,77,164,-29,538,588,157,654,62,11.12
12,0,0,12.0,-0.0,0.31264710426330566,123.74172029546526,77,152,-29,538,588,157,654,62,9.93
9,0,0,9.0,-0.0,0.3206460475921631,114.91093173576817,77,143,-29,538,588,157,654,62,7.99
8,0,0,8.0,-0.0,0.3286590576171875,107.07968713753664,77,135,-29,538,588,157,654,62,7.14
7,0,0,7.0,-0.0,0.33666300773620605,100.24404748406687,77,128,-29,538,588,157,654,62,6.36
6,0,0,6.0,-0.0,0.3447139263153076,94.39936203984452,77,122,-29,538,588,157,654,62,5.67
7,0,0,7.0,-0.0,0.3526620864868164,87.6001686339442,77,115,-29,538,588,157,654,62,5.8
8,0,0,8.0,-0.0,0.36064696311950684,79.86027241532469,77,107,-29,538,588,157,654,62,5.8
7,0,0,7.0,-0.0,0.36876702308654785,73.12012293500234,77,100,-29,538,588,157,654,62,5.11
7,1,0,7.0,1.0,0.37666797637939453,66.71898484941399,77,93,-30,538,588,157,654,62,4.09
8,0,0,8.0,-0.0,0.3847239017486572,59.13878188659973,77,85,-30,538,588,157,654,62,4.61
8,1,0,8.0,1.0,0.3926570415496826,52.006023877788536,77,77,-31,538,588,157,654,62,3.62
8,0,0,8.0,-0.0,0.4008181095123291,44.64390259630977,77,69,-31,538,588,157,654,62,3.66
7,0,0,7.0,-0.0,0.409013032913208,38.31810730249349,77,62,-31,538,588,157,654,62,3.06
5,0,0,5.0,-0.0,0.4166450500488281,33.88451279003334,77,57,-31,538,588,157,654,62,2.45
4,0,0,4.0,-0.0,0.42462992668151855,30.400325732035007,77,53,-31,538,588,157,654,62,2.11
3,0,0,3.0,-0.0,0.43268394470214844,27.83026432033091,77,50,-31,538,588,157,654,62,1.86
3,0,0,3.0,-0.0,0.4407670497894287,25.302753041036986,77,47,-31,538,588,157,654,62,1.73
3,0,0,3.0,-0.0,0.4486660957336426,22.823786563191554,77,44,-31,538,588,157,654,62,1.6
5,-2,0,5.0,-2.0,0.45664000511169434,17.60041152089147,77,39,-29,538,588,157,654,62,2.99
4,-2,0,4.0,-2.0,0.46463608741760254,13.204072210600685,77,35,-27,538,588,157,654,62,3.18
5,-2,0,5.0,-2.0,0.47266507148742676,8.05124837953327,77,30,-25,538,588,157,654,62,2.35
3,-1,0,3.0,-1.0,0.48065900802612305,5.124783736376884,77,27,-24,538,588,157,654,62,1.83
2,-1,0,2.0,-1.0,0.4886479377746582,2.97057550292606,77,25,-23,538,588,157,654,62,2.33
2,0,0,2.0,-0.0,0.4966440200805664,1.526911934581186,77,23,-23,538,588,157,654,62,0.81
2,-1,0,2.0,-1.0,0.5046501159667969,-0.5861873485089006,77,21,-22,538,588,157,654,62,1.94
2,0,0,2.0,-0.0,0.5126409530639648,-1.9311162925027325,77,19,-22,538,588,157,654,62,0.61
3,-1,0,3.0,-1.0,0.5208299160003662,-4.5992424351118295,77,16,-21,538,588,157,654,62,0.95
3,-1,0,3.0,-1.0,0.5289299488067627,-7.146279116246873,77,13,-20,538,588,157,654,62,0.68
2,0,0,2.0,-0.0,0.537024974822998,-8.174575578973347,77,11,-20,538,588,157,654,62,0.13
2,0,0,2.0,-0.0,0.5446839332580566,-9.068287800538691,77,9,-20,538,588,157,654,62,0.0
0,0,1,-0.0,-0.0,0.5466489791870117,-9.068287800538691,77,9,-20,538,588,157,654,62,24.36
1,0,1,1.0,-0.0,0.004123687744140625,455.97374103989824,78,149,432,679,1040,529,608,2,17.45
1,0,1,1.0,-0.0,0.01211857795715332,455.6486614455363,78,148,432,679,1040,529,608,2,17.35
1,0,1,1.0,-0.0,0.02055954933166504,455.32554169145516,78,147,432,679,1040,529,608,2,17.25
0,0,0,-0.0,-0.0,0.11411666870117188,455.32554169145516,78,147,432,679,1040,529,608,2,127.46
1,0,0,1.0,-0.0,0.13228654861450195,455.0043859438196,78,146,432,679,1040,529,608,2,17.15
1,1,0,1.0,1.0,0.14019155502319336,453.7372867931549,78,145,431,679,1040,529,608,2,48.58
1,0,0,1.0,-0.0,0.14811062812805176,453.41940979672074,78,144,431,679,1040,529,608,2,16.96
2,0,0,2.0,-0.0,0.15611863136291504,452.7895988230669,78,142,431,679,1040,529,608,2,29.24
2,0,0,2.0,-0.0,0.16411972045898438,452.167739363693,78,140,431,679,1040,529,608,2,28.93
2,0,0,2.0,-0.0,0.1721177101135254,451.55386419740137,78,138,431,679,1040,529,608,2,28.62
3,0,0,3.0,-0.0,0.18025851249694824,450.648093099041,78,135,431,679,1040,529,608,2,37.78
3,0,0,3.0,-0.0,0.18814969062805176,449.7604685417744,78,132,431,679,1040,529,608,2,37.2
4,1,0,4.0,1.0,0.19620966911315918,447.64685444121864,78,128,430,679,1040,529,608,2,62.0
5,1,0,5.0,1.0,0.20412564277648926,445.28466251933867,78,123,429,679,1040,529,608,2,64.98
7,4,0,7.0,4.0,0.21215271949768066,439.5462518283409,78,116,425,679,1040,529,608,2,88.39
11,6,0,11.0,6.0,0.22012567520141602,430.9560162794356,78,105,419,679,1040,529,608,2,95.15
11,6,0,11.0,6.0,0.2281186580657959,422.56227405188014,78,94,413,679,1040,529,608,2,93.44
12,7,0,12.0,7.0,0.2361135482788086,413.19802027532677,78,82,406,679,1040,529,608,2,93.85
12,9,0,12.0,9.0,0.24417567253112793,402.1240503864784,78,70,397,679,1040,529,608,2,94.79
12,9,0,12.0,9.0,0.252105712890625,391.3111010409978,78,58,388,679,1040,529,608,2,92.64
10,9,0,10.0,9.0,0.26021265983581543,381.0274859221519,78,48,379,679,1040,529,608,2,90.38
9,10,0,9.0,10.0,0.2682206630706787,370.0552519504339,78,39,369,679,1040,529,608,2,89.64
8,13,0,8.0,13.0,0.27611351013183594,356.3471701301131,78,31,356,679,1040,529,608,2,90.42
7,12,0,7.0,12.0,0.28420352935791016,343.8361929960369,78,24,344,679,1040,529,608,2,87.2
7,12,0,7.0,12.0,0.29216766357421875,331.4349560440358,78,17,332,679,1040,529,608,2,84.82
6,11,0,6.0,11.0,0.30010557174682617,320.18841822207725,78,11,321,679,1040,529,608,2,81.71
5,11,0,5.0,11.0,0.30809473991394043,309.0580590792634,78,6,310,679,1040,529,608,2,79.77
5,9,0,5.0,9.0,0.316098690032959,300.0016611249845,78,1,301,679,1040,529,608,2,75.29
4,8,0,4.0,8.0,0.32422852516174316,292.01535795927146,78,-3,293,679,1040,529,608,2,72.27
3,9,0,3.0,9.0,0.33213257789611816,283.0633732109791,78,-6,284,679,1040,529,608,2,72.65
3,10,0,3.0,10.0,0.3401665687561035,273.14777037211155,78,-9,274,679,1040,529,608,2,72.12
3,10,0,3.0,10.0,0.34811854362487793,263.27258654654287,78,-12,264,679,1040,529,608,2,70.16
3,11,0,3.0,11.0,0.356487512588501,252.4442739538615,78,-15,253,679,1040,529,608,2,69.1
2,11,0,2.0,11.0,0.36416053771972656,241.5963726027246,78,-17,242,679,1040,529,608,2,67.34
2,11,0,2.0,11.0,0.3721175193786621,230.78006816808042,78,-19,231,679,1040,529,608,2,65.08
1,13,0,1.0,13.0,0.38010263442993164,217.91550881561588,78,-20,218,679,1040,529,608,2,64.53
1,14,0,1.0,14.0,0.3881206512451172,204.0780339285512,78,-21,204,679,1040,529,608,2,62.06
1,13,0,1.0,13.0,0.39656758308410645,191.26284092356485,78,-22,191,679,1040,529,608,2,58.58
0,14,0,-0.0,14.0,0.404099702835083,177.36199146679206,78,-22,177,679,1040,529,608,2,56.61
1,12,0,1.0,12.0,0.41210365295410156,165.59531806146293,78,-23,165,679,1040,529,608,2,52.06
1,10,0,1.0,10.0,0.4201047420501709,155.84705926475002,78,-24,155,679,1040,529,608,2,48.35
0,7,0,-0.0,7.0,0.42812561988830566,148.9333185119305,78,-24,148,679,1040,529,608,2,44.65
1,6,0,1.0,6.0,0.436145544052124,143.183910336764,78,-25,142,679,1040,529,608,2,40.7
0,5,0,-0.0,5.0,0.4441547393798828,138.26234236145822,78,-25,137,679,1040,529,608,2,39.05
0,5,0,-0.0,5.0,0.4521167278289795,133.34656675925888,78,-25,132,679,1040,529,608,2,38.03
0,5,0,-0.0,5.0,0.4601156711578369,128.43724348115578,78,-25,127,679,1040,529,608,2,36.99
-1,5,0,-1.0,5.0,0.46817970275878906,123.33824833895642,78,-24,122,679,1040,529,608,2,40.02
0,4,0,-0.0,4.0,0.4761495590209961,119.41594578792295,78,-24,118,679,1040,529,608,2,33.0
-1,5,0,-1.0,5.0,0.4841465950012207,114.31695452100702,78,-23,113,679,1040,529,608,2,38.17
0,5,0,-0.0,5.0,0.49220871925354004,109.42191811411355,78,-23,108,679,1040,529,608,2,33.02
-1,5,0,-1.0,5.0,0.5001876354217529,104.32331175955302,78,-22,103,679,1040,529,608,2,35.43
-1,5,0,-1.0,5.0,0.5081067085266113,99.22474744293447,78,-21,98,679,1040,529,608,2,34.33
-1,5,0,-1.0,5.0,0.5161936283111572,94.12623192369179,78,-20,93,679,1040,529,608,2,33.22
-2,5,0,-2.0,5.0,0.5241396427154541,88.82204629154248,78,-18,88,679,1040,529,608,2,29.51
-2,5,0,-2.0,5.0,0.5321767330169678,83.52810183601665,78,-16,83,679,1040,529,608,2,28.25
-2,3,0,-2.0,3.0,0.5401077270507812,80.21576201698781,78,-14,80,679,1040,529,608,2,23.09
-2,3,0,-2.0,3.0,0.548102617263794,76.92945527847606,78,-12,77,679,1040,529,608,2,22.34
-2,4,0,-2.0,4.0,0.5563886165618896,72.68174807915459,78,-10,73,679,1040,529,608,2,23.71
-2,4,0,-2.0,4.0,0.5641167163848877,68.46221994724903,78,-8,69,679,1040,529,608,2,22.7
-3,4,0,-3.0,4.0,0.5721116065979004,64.19202405202648,78,-5,65,679,1040,529,608,2,21.15
-2,4,0,-2.0,4.0,0.58046555519104,60.07372593840988,78,-3,61,679,1040,529,608,2,20.53
-2,2,0,-2.0,2.0,0.5881175994873047,58.00847396772772,78,-1,59,679,1040,529,608,2,14.85
-1,3,0,-1.0,3.0,0.5960946083068848,55.0,78,0,56,679,1040,529,608,2,18.01
-3,3,0,-3.0,3.0,0.6041257381439209,52.08483775994799,78,3,53,679,1040,529,608,2,15.81
-1,3,0,-1.0,3.0,0.6120965480804443,49.15974481593781,78,4,50,679,1040,529,608,2,16.42
-2,2,0,-2.0,2.0,0.620248556137085,47.373546489791295,78,6,48,679,1040,529,608,2,12.01
-1,3,0,-1.0,3.0,0.6281247138977051,44.5411901469428,78,7,45,679,1040,529,608,2,15.12
-1,2,0,-1.0,2.0,0.6361105442047119,42.73785545725808,78,8,43,679,1040,529,608,2,11.91
-1,2,0,-1.0,2.0,0.6441125869750977,40.97618372363071,78,9,41,679,1040,529,608,2,11.44
-1,1,0,-1.0,1.0,0.652174711227417,40.23105625617661,78,10,40,679,1040,529,608,2,6.51
-1,2,0,-1.0,2.0,0.6602835655212402,38.56008088970496,78,11,38,679,1040,529,608,2,10.66
0,2,0,-0.0,2.0,0.6681187152862549,36.64306044943742,78,11,36,679,1040,529,608,2,12.41
-1,2,0,-1.0,2.0,0.6761126518249512,35.05551275463989,78,12,34,679,1040,529,608,2,9.76
-1,3,0,-1.0,3.0,0.6841986179351807,32.61547262794322,78,13,31,679,1040,529,608,2,11.53
-1,2,0,-1.0,2.0,0.6921656131744385,31.202484376209235,78,14,29,679,1040,529,608,2,8.46
-1,3,0,-1.0,3.0,0.7002346515655518,29.01666203960727,78,15,26,679,1040,529,608,2,10.12
0,1,0,-0.0,1.0,0.7082116603851318,28.154759474226502,78,15,25,679,1040,529,608,2,6.94
-1,3,0,-1.0,3.0,0.7161035537719727,26.202941017470888,78,16,22,679,1040,529,608,2,8.95
0,2,0,-0.0,2.0,0.7241456508636475,24.612496949731394,78,16,20,679,1040,529,608,2,8.48
0,2,0,-0.0,2.0,0.7321715354919434,23.08318915758459,78,16,18,679,1040,529,608,2,7.98
0,2,0,-0.0,2.0,0.7401225566864014,21.627416997969522,78,16,16,679,1040,529,608,2,7.45
0,1,0,-0.0,1.0,0.7481017112731934,20.93171219946131,78,16,15,679,1040,529,608,2,4.9
1,2,0,1.0,2.0,0.7561147212982178,18.849433241279208,78,15,13,679,1040,529,608,2,9.31
1,2,0,1.0,2.0,0.7641055583953857,16.804493814764857,78,14,11,679,1040,529,608,2,8.7
1,1,0,1.0,1.0,0.7721407413482666,15.401219466856727,78,13,10,679,1040,529,608,2,8.99
1,1,0,1.0,1.0,0.7801425457000732,14.0,78,12,9,679,1040,529,608,2,8.65
1,1,0,1.0,1.0,0.788109540939331,12.601470508735444,78,11,8,679,1040,529,608,2,8.28
1,1,0,1.0,1.0,0.7963755130767822,11.206555615733702,78,10,7,679,1040,529,608,2,7.89
1,0,0,1.0,-0.0,0.8041427135467529,10.40175425099138,78,9,7,679,1040,529,608,2,4.46
2,2,0,2.0,2.0,0.8121585845947266,7.602325267042627,78,7,5,679,1040,529,608,2,8.97
1,1,0,1.0,1.0,0.8200995922088623,6.211102550927978,78,6,4,679,1040,529,608,2,6.76
1,2,0,1.0,2.0,0.8280975818634033,4.385164807134504,78,5,2,679,1040,529,608,2,4.94
1,1,0,1.0,1.0,0.8362336158752441,3.1231056256176606,78,4,1,679,1040,529,608,2,4.31
0,1,0,-0.0,1.0,0.8441107273101807,3.0,78,4,0,679,1040,529,608,2,-0.47
1,1,0,1.0,1.0,0.8601245880126953,2.1622776601683795,78,3,-1,679,1040,529,608,2,2.02
1,0,0,1.0,-0.0,0.932274580001831,1.2360679774997898,78,2,-1,679,1040,529,608,2,3.36
1,0,0,1.0,-0.0,0.948164701461792,0.41421356237309515,78,1,-1,679,1040,529,608,2,1.95
0,0,1,-0.0,-0.0,1.0791435241699219,0.41421356237309515,78,1,-1,679,1040,529,608,2,27.05
1,0,1,1.0,-0.0,0.011725425720214844,522.6180994151113,79,198,-517,877,524,678,1041,63,1.25
0,-1,1,-0.0,-1.0,0.01972651481628418,521.6843583818887,79,198,-516,877,524,678,1041,63,4.1
1,0,1,1.0,-0.0,0.027707338333129883,521.326895959268,79,197,-516,877,524,678,1041,63,1.24
1,-1,1,1.0,-1.0,0.035715341567993164,520.0362964451616,79,196,-515,877,524,678,1041,63,4.61
0,-1,1,-0.0,-1.0,0.051720380783081055,519.1018087590696,79,196,-514,877,524,678,1041,63,4.1
1,0,1,1.0,-0.0,0.0598604679107666,518.7463051262828,79,195,-514,877,524,678,1041,63,1.23
0,0,0,-0.0,-0.0,0.1197195053100586,518.7463051262828,79,195,-514,877,524,678,1041,63,138.53
-1,0,0,-1.0,-0.0,0.12371635437011719,519.1018087590696,79,196,-514,877,524,678,1041,63,6.13
0,-1,0,-0.0,-1.0,0.2357335090637207,518.1675518455182,79,196,-513,877,524,678,1041,63,4.09
0,-2,0,-0.0,-2.0,0.2437453269958496,516.2997350629726,79,196,-511,877,524,678,1041,63,5.93
2,-4,0,2.0,-4.0,0.2517063617706299,511.8489661038326,79,194,-507,877,524,678,1041,63,12.45
4,-6,0,4.0,-6.0,0.25974535942077637,504.8180661381249,79,190,-501,877,524,678,1041,63,15.7
5,-8,0,5.0,-8.0,0.26792240142822266,495.5681342428537,79,185,-493,877,524,678,1041,63,19.19
6,-9,0,6.0,-9.0,0.2757413387298584,485.0397271528617,79,179,-484,877,524,678,1041,63,20.62
5,-8,0,5.0,-8.0,0.2837224006652832,475.80568268321537,79,174,-476,877,524,678,1041,63,18.66
4,-10,0,4.0,-10.0,0.2917053699493408,465.0403209417557,79,170,-466,877,524,678,1041,63,22.9
4,-12,0,4.0,-12.0,0.2997264862060547,452.3963177352513,79,166,-454,877,524,678,1041,63,25.15
5,-17,0,5.0,-17.0,0.307828426361084,434.7145048202815,79,161,-437,877,524,678,1041,63,29.69
9,-26,0,9.0,-26.0,0.3157813549041748,407.20657229210974,79,152,-411,877,524,678,1041,63,39.15
12,-30,0,12.0,-30.0,0.3237583637237549,374.90762495917716,79,140,-381,877,524,678,1041,63,40.57
11,-32,0,11.0,-32.0,0.3317294120788574,341.0779488225552,79,129,-349,877,524,678,1041,63,39.46
10,-32,0,10.0,-32.0,0.3397243022918701,307.60005906674024,79,119,-317,877,524,678,1041,63,35.74
7,-33,0,7.0,-33.0,0.34771251678466797,274.28675044947494,79,112,-284,877,524,678,1041,63,31.64
6,-28,0,6.0,-28.0,0.3557124137878418,246.07760645710795,79,106,-256,877,524,678,1041,63,26.48
7,-26,0,7.0,-26.0,0.3637053966522217,219.40167731067618,79,99,-230,877,524,678,1041,63,23.97
9,-22,0,9.0,-22.0,0.3717043399810791,195.6362724719942,79,90,-208,877,524,678,1041,63,23.07
8,-17,0,8.0,-17.0,0.37978148460388184,176.85812469085735,79,82,-191,877,524,678,1041,63,18.55
8,-13,0,8.0,-13.0,0.387737512588501,161.76929216034384,79,74,-178,877,524,678,1041,63,13.72
9,-12,0,9.0,-12.0,0.3963744640350342,147.27226368675525,79,65,-166,877,524,678,1041,63,11.88
7,-12,0,7.0,-12.0,0.403733491897583,133.5600194457937,79,58,-154,877,524,678,1041,63,11.42
6,-10,0,6.0,-10.0,0.4118483066558838,122.10127367203711,79,52,-144,877,524,678,1041,63,9.55
5,-9,0,5.0,-9.0,0.4197103977203369,111.94754282603111,79,47,-135,877,524,678,1041,63,8.64
4,-7,0,4.0,-7.0,0.42775845527648926,104.02962637880623,79,43,-128,877,524,678,1041,63,7.12
1,-6,0,1.0,-6.0,0.43570542335510254,98.02712893031449,79,42,-122,877,524,678,1041,63,6.25
2,-5,0,2.0,-5.0,0.44370436668395996,92.64869590901475,79,40,-117,877,524,678,1041,63,7.32
2,-6,0,2.0,-6.0,0.45180249214172363,86.32433677630571,79,38,-111,877,524,678,1041,63,9.21
2,-5,0,2.0,-5.0,0.45973634719848633,80.94641575325224,79,36,-106,877,524,678,1041,63,6.97
2,-3,0,2.0,-3.0,0.4677414894104004,77.4665847162157,79,34,-103,877,524,678,1041,63,4.03
1,-2,0,1.0,-2.0,0.47578930854797363,75.25441167311595,79,33,-101,877,524,678,1041,63,4.3
2,-2,0,2.0,-2.0,0.483776330947876,72.74005976477939,79,31,-99,877,524,678,1041,63,2.75
2,-4,0,2.0,-4.0,0.4918043613433838,68.32774033471213,79,29,-95,877,524,678,1041,63,4.83
2,-2,0,2.0,-2.0,0.499725341796875,65.84007434941384,79,27,-93,877,524,678,1041,63,2.59
3,-3,0,3.0,-3.0,0.5077154636383057,62.14504817756014,79,24,-90,877,524,678,1041,63,2.85
3,-3,0,3.0,-3.0,0.5157012939453125,58.49860334105779,79,21,-87,877,524,678,1041,63,2.69
3,-3,0,3.0,-3.0,0.5237963199615479,54.90692637965812,79,18,-84,877,524,678,1041,63,2.54
3,-3,0,3.0,-3.0,0.5317704677581787,51.37718130647589,79,15,-81,877,524,678,1041,63,2.37
2,-4,0,2.0,-4.0,0.5397253036499023,47.08969202141856,79,13,-77,877,524,678,1041,63,3.5
3,-5,0,3.0,-5.0,0.5477705001831055,41.69112738154499,79,10,-72,877,524,678,1041,63,3.16
4,-5,0,4.0,-5.0,0.5557074546813965,36.268120235368556,79,6,-67,877,524,678,1041,63,2.43
3,-4,0,3.0,-4.0,0.5637123584747314,32.071388124885914,79,3,-63,877,524,678,1041,63,2.07
2,-4,0,2.0,-4.0,0.5717353820800781,28.008473967727717,79,1,-59,877,524,678,1041,63,2.37
2,-1,0,2.0,-1.0,0.5797173976898193,27.008620049092706,79,-1,-58,877,524,678,1041,63,0.56
1,-2,0,1.0,-2.0,0.5877153873443604,25.0357029044876,79,-2,-56,877,524,678,1041,63,1.89
1,0,0,1.0,-0.0,0.5957214832305908,25.080299571239813,79,-3,-56,877,524,678,1041,63,4.69
0,-1,0,-0.0,-1.0,0.6038854122161865,24.081757415681643,79,-3,-55,877,524,678,1041,63,4.71
0,0,1,-0.0,-0.0,0.6497282981872559,24.081757415681643,79,-3,-55,877,524,678,1041,63,34.14
0,0,0,-0.0,-0.0,0.1462700366973877,304.5088324454499,80,-166,280,714,859,880,579,43,97.83
-1,0,0,-1.0,-0.0,0.1794140338897705,304.0,80,-165,280,714,859,880,579,43,1.76
-1,0,0,-1.0,-0.0,0.18726801872253418,303.4934513977131,80,-164,280,714,859,880,579,43,1.75
-2,1,0,-2.0,1.0,0.19526004791259766,301.62206992082855,80,-162,279,714,859,880,579,43,5.24
-2,3,0,-2.0,3.0,0.20375418663024902,298.02351010544663,80,-160,276,714,859,880,579,43,11.27
-3,5,0,-3.0,5.0,0.21128106117248535,292.1932310890515,80,-157,271,714,859,880,579,43,16.2
-5,7,0,-5.0,7.0,0.2192540168762207,283.63092423455635,80,-152,264,714,859,880,579,43,18.03
-5,9,0,-5.0,9.0,0.22726106643676758,273.33654207386485,80,-147,255,714,859,880,579,43,21.81
-6,10,0,-6.0,10.0,0.23532605171203613,261.6764935398768,80,-141,245,714,859,880,579,43,22.8
-7,11,0,-7.0,11.0,0.24326014518737793,248.65162710430656,80,-134,234,714,859,880,579,43,22.69
-6,11,0,-6.0,11.0,0.25133204460144043,236.12448347055556,80,-128,223,714,859,880,579,43,22.28
-5,11,0,-5.0,11.0,0.25927019119262695,224.0979396078229,80,-123,212,714,859,880,579,43,19.41
-5,11,0,-5.0,11.0,0.26726198196411133,212.0772404161333,80,-118,201,714,859,880,579,43,18.68
-5,10,0,-5.0,10.0,0.27525901794433594,200.92341021172146,80,-113,191,714,859,880,579,43,17.74
-4,8,0,-4.0,8.0,0.2832632064819336,192.00234740490538,80,-109,183,714,859,880,579,43,15.07
-4,8,0,-4.0,8.0,0.29126811027526855,183.08331631958552,80,-105,175,714,859,880,579,43,14.62
-5,9,0,-5.0,9.0,0.29938316345214844,172.7937047481161,80,-100,166,714,859,880,579,43,16.29
-5,12,0,-5.0,12.0,0.30736207962036133,159.9447429465692,80,-95,154,714,859,880,579,43,15.76
-6,11,0,-6.0,11.0,0.3155181407928467,147.4339633209407,80,-89,143,714,859,880,579,43,16.04
-7,11,0,-7.0,11.0,0.32326197624206543,134.3962676514465,80,-82,132,714,859,880,579,43,17.23
-5,9,0,-5.0,9.0,0.3312520980834961,124.11374848717816,80,-77,123,714,859,880,579,43,13.21
-6,9,0,-6.0,9.0,0.3392751216888428,113.30189872075525,80,-71,114,714,859,880,579,43,13.51
-6,8,0,-6.0,8.0,0.34748411178588867,103.34226956268733,80,-65,106,714,859,880,579,43,11.09
-5,7,0,-5.0,7.0,0.3552701473236084,94.76268828944843,80,-60,99,714,859,880,579,43,10.09
-4,7,0,-4.0,7.0,0.3632771968841553,86.70329614269008,80,-56,92,714,859,880,579,43,10.55
-4,8,0,-4.0,8.0,0.37126898765563965,77.79271228182775,80,-52,84,714,859,880,579,43,9.11
-3,7,0,-3.0,7.0,0.37929415702819824,70.26883367283708,80,-49,77,714,859,880,579,43,7.28
-2,4,0,-2.0,4.0,0.38727402687072754,65.82165628459296,80,-47,73,714,859,880,579,43,6.16
-2,5,0,-2.0,5.0,0.39525413513183594,60.541400527584756,80,-45,68,714,859,880,579,43,5.51
-2,4,0,-2.0,4.0,0.40326714515686035,56.10382610480494,80,-43,64,714,859,880,579,43,5.62
-2,5,0,-2.0,5.0,0.4113171100616455,50.847059786744225,80,-41,59,714,859,880,579,43,4.98
-2,4,0,-2.0,4.0,0.4192640781402588,46.42403132415029,80,-39,55,714,859,880,579,43,5.04
-2,4,0,-2.0,4.0,0.427962064743042,42.00793600809346,80,-37,51,714,859,880,579,43,4.79
-3,4,0,-3.0,4.0,0.43599820137023926,37.008620049092706,80,-34,47,714,859,880,579,43,7.45
-4,3,0,-4.0,3.0,0.44327306747436523,32.25410782277739,80,-30,44,714,859,880,579,43,3.54
-4,4,0,-4.0,4.0,0.4512600898742676,26.707441767506253,80,-26,40,714,859,880,579,43,4.13
-4,5,0,-4.0,5.0,0.4593031406402588,20.340053217188775,80,-22,35,714,859,880,579,43,4.81
-3,5,0,-3.0,5.0,0.4672861099243164,14.510561809129406,80,-19,30,714,859,880,579,43,6.34
-4,4,0,-4.0,4.0,0.4753110408782959,9.016662039607269,80,-15,26,714,859,880,579,43,2.89
-2,3,0,-2.0,3.0,0.48327112197875977,5.419689627245813,80,-13,23,714,859,880,579,43,4.27
-2,3,0,-2.0,3.0,0.4913361072540283,1.8254244210266535,80,-11,20,714,859,880,579,43,3.91
-2,3,0,-2.0,3.0,0.49926114082336426,-1.7646159383286566,80,-9,17,714,859,880,579,43,3.49
-3,4,0,-3.0,4.0,0.5072681903839111,-6.682178936723647,80,-6,13,714,859,880,579,43,2.14
-3,3,0,-3.0,3.0,0.5153930187225342,-10.55969349108945,80,-3,10,714,859,880,579,43,0.58
-2,3,0,-2.0,3.0,0.523252010345459,-13.928932188134524,80,-1,7,714,859,880,579,43,0.41
-2,3,0,-2.0,3.0,0.5312690734863281,-16.87689437438234,80,1,4,714,859,880,579,43,-0.95
-2,2,0,-2.0,2.0,0.5393140316009521,-17.394448724536012,80,3,2,714,859,880,579,43,-2.21
-1,2,0,-1.0,2.0,0.5472910404205322,-17.0,80,4,0,714,859,880,579,43,-1.76
-1,2,0,-1.0,2.0,0.5553750991821289,-15.614835192865495,80,5,-2,714,859,880,579,43,-1.4
-1,1,0,-1.0,1.0,0.5632879734039307,-14.29179606750063,80,6,-3,714,859,880,579,43,0.59
-1,1,0,-1.0,1.0,0.5712490081787109,-12.93774225170145,80,7,-4,714,859,880,579,43,1.08
0,1,0,-0.0,1.0,0.5792660713195801,-12.397674732957373,80,7,-5,714,859,880,579,43,0.03
0,0,1,-0.0,-0.0,0.5874021053314209,-12.397674732957373,80,7,-5,714,859,880,579,43,23.46
0,1,1,-0.0,1.0,0.003324270248413086,406.7242529398076,81,243,-341,950,524,707,864,25,6.66
1,-2,1,1.0,-2.0,0.09943246841430664,404.51530584121394,81,242,-339,950,524,707,864,25,12.31
0,0,0,-0.0,-0.0,0.10633444786071777,404.51530584121394,81,242,-339,950,524,707,864,25,118.05
1,-1,0,1.0,-1.0,0.10735535621643066,403.12046444375636,81,241,-338,950,524,707,864,25,9.08
1,-2,0,1.0,-2.0,0.11538934707641602,400.9116128180461,81,240,-336,950,524,707,864,25,12.25
2,-2,0,2.0,-2.0,0.12333130836486816,398.1219330881976,81,238,-334,950,524,707,864,25,14.23
2,-2,0,2.0,-2.0,0.13176345825195312,395.33278777923096,81,236,-332,950,524,707,864,25,14.17
4,-4,0,4.0,-4.0,0.1393604278564453,389.756144943671,81,232,-328,950,524,707,864,25,22.87
3,-4,0,3.0,-4.0,0.14734148979187012,384.7581127084864,81,229,-324,950,524,707,864,25,23.09
2,-4,0,2.0,-4.0,0.15532946586608887,380.3378646014172,81,227,-320,950,524,707,864,25,19.26
2,-3,0,2.0,-3.0,0.1635124683380127,376.7338421079389,81,225,-317,950,524,707,864,25,18.51
4,-7,0,4.0,-7.0,0.17137527465820312,368.71117661555456,81,221,-310,950,524,707,864,25,29.05
5,-8,0,5.0,-8.0,0.17933249473571777,359.29503093900945,81,216,-302,950,524,707,864,25,32.28
6,-9,0,6.0,-9.0,0.18734145164489746,348.4843963336,81,210,-293,950,524,707,864,25,35.16
6,-10,0,6.0,-10.0,0.19534826278686523,336.8624370722649,81,204,-283,950,524,707,864,25,34.89
5,-10,0,5.0,-10.0,0.20342731475830078,325.8313188560232,81,199,-273,950,524,707,864,25,32.22
6,-11,0,6.0,-11.0,0.21137237548828125,313.41204648875555,81,193,-262,950,524,707,864,25,34.04
6,-13,0,6.0,-13.0,0.219374418258667,299.40006422606916,81,187,-249,950,524,707,864,25,34.84
9,-14,0,9.0,-14.0,0.22734642028808594,282.8033242689098,81,178,-235,950,524,707,864,25,38.23
9,-12,0,9.0,-12.0,0.2353513240814209,267.8035024798653,81,169,-223,950,524,707,864,25,37.31
9,-12,0,9.0,-12.0,0.2433304786682129,252.80370088048238,81,160,-211,950,524,707,864,25,35.99
9,-11,0,9.0,-11.0,0.2515294551849365,238.60127693210185,81,151,-200,950,524,707,864,25,32.21
10,-12,0,10.0,-12.0,0.2593803405761719,223.0,81,141,-188,950,524,707,864,25,32.09
9,-13,0,9.0,-13.0,0.26733946800231934,207.2008211663451,81,132,-175,950,524,707,864,25,31.06
10,-14,0,10.0,-14.0,0.2753443717956543,190.00247523235947,81,122,-161,950,524,707,864,25,31.05
10,-12,0,10.0,-12.0,0.28337836265563965,174.40010729610646,81,112,-149,950,524,707,864,25,27.37
8,-11,0,8.0,-11.0,0.29134535789489746,160.80046296234278,81,104,-138,950,524,707,864,25,25.36
9,-12,0,9.0,-12.0,0.2994053363800049,145.8005069700348,81,95,-126,950,524,707,864,25,26.21
8,-11,0,8.0,-11.0,0.3073844909667969,132.20124826089406,81,87,-115,950,524,707,864,25,22.49
7,-11,0,7.0,-11.0,0.3153533935546875,119.20975573485381,81,80,-104,950,524,707,864,25,18.93
9,-11,0,9.0,-11.0,0.32357239723205566,105.00427342623003,81,71,-93,950,524,707,864,25,19.5
8,-10,0,8.0,-10.0,0.33133625984191895,92.20172743289815,81,63,-83,950,524,707,864,25,17.56
7,-8,0,7.0,-8.0,0.3395044803619385,81.60021367496978,81,56,-75,950,524,707,864,25,13.79
7,-8,0,7.0,-8.0,0.34741926193237305,71.00602387778854,81,49,-67,950,524,707,864,25,12.63
6,-6,0,6.0,-6.0,0.3553614616394043,62.632432628181164,81,43,-61,950,524,707,864,25,9.68
5,-6,0,5.0,-6.0,0.36334729194641113,54.85057965343307,81,38,-55,950,524,707,864,25,9.57
5,-6,0,5.0,-6.0,0.37134647369384766,47.07622195096772,81,33,-49,950,524,707,864,25,8.76
5,-4,0,5.0,-4.0,0.3793764114379883,41.0,81,28,-45,950,524,707,864,25,5.79
4,-6,0,4.0,-6.0,0.38738441467285156,33.79301256742124,81,24,-39,950,524,707,864,25,8.73
5,-5,0,5.0,-5.0,0.3953824043273926,26.948684188300895,81,19,-34,950,524,707,864,25,5.33
4,-6,0,4.0,-6.0,0.4033374786376953,19.76476034853718,81,15,-28,950,524,707,864,25,6.29
3,-4,0,3.0,-4.0,0.4113292694091797,14.832815729997478,81,12,-24,950,524,707,864,25,4.37
2,-3,0,2.0,-3.0,0.41969728469848633,11.259406699226016,81,10,-21,950,524,707,864,25,4.09
1,-1,0,1.0,-1.0,0.4273712635040283,9.931712199461309,81,9,-20,950,524,707,864,25,2.27
0,-1,0,-0.0,-1.0,0.4353513717651367,9.02379604162864,81,9,-19,950,524,707,864,25,1.91
1,-1,0,1.0,-1.0,0.4433474540710449,7.697715603592208,81,8,-18,950,524,707,864,25,2.17
0,-1,0,-0.0,-1.0,0.45134449005126953,6.7882942280559355,81,8,-17,950,524,707,864,25,1.85
1,-1,0,1.0,-1.0,0.4593362808227539,5.464249196572979,81,7,-16,950,524,707,864,25,2.05
1,-1,0,1.0,-1.0,0.4673473834991455,4.15549442140351,81,6,-15,950,524,707,864,25,1.87
1,-2,0,1.0,-2.0,0.4753293991088867,1.9283882771841192,81,5,-13,950,524,707,864,25,3.79
2,-2,0,2.0,-2.0,0.48433828353881836,-0.5982457490086208,81,3,-11,950,524,707,864,25,1.2
1,-1,0,1.0,-1.0,0.4913814067840576,-1.801960972814431,81,2,-10,950,524,707,864,25,0.96
1,-1,0,1.0,-1.0,0.499340295791626,-2.9446148618625827,81,1,-9,950,524,707,864,25,0.66
1,-1,0,1.0,-1.0,0.5073294639587402,-4.0,81,0,-8,950,524,707,864,25,0.33
0,0,1,-0.0,-0.0,0.5873513221740723,-4.0,81,0,-8,950,524,707,864,25,25.78
0,0,0,-0.0,-0.0,0.09223079681396484,739.4888637030232,82,-732,253,218,785,950,532,71,172.39
-1,1,0,-1.0,1.0,0.11224675178527832,738.2173045140673,82,-731,252,218,785,950,532,71,4.78
-2,2,0,-2.0,2.0,0.12026476860046387,735.6756775713114,82,-729,250,218,785,950,532,71,7.55
-2,3,0,-2.0,3.0,0.1282186508178711,732.8137795064634,82,-727,247,218,785,950,532,71,7.71
-4,5,0,-4.0,5.0,0.1363077163696289,727.4257340882455,82,-723,242,218,785,950,532,71,13.04
-4,6,0,-4.0,6.0,0.14421987533569336,721.7410389294346,82,-719,236,218,785,950,532,71,13.35
-5,7,0,-5.0,7.0,0.15233874320983887,714.8246461673556,82,-714,229,218,785,950,532,71,15.68
-4,8,0,-4.0,8.0,0.1602647304534912,708.6000268961802,82,-710,221,218,785,950,532,71,13.96
-4,8,0,-4.0,8.0,0.16823482513427734,702.4313527373243,82,-706,213,218,785,950,532,71,13.77
-4,8,0,-4.0,8.0,0.17623186111450195,696.3200393808445,82,-702,205,218,785,950,532,71,13.57
-5,6,0,-5.0,6.0,0.18451285362243652,689.8517089722559,82,-697,199,218,785,950,532,71,14.63
-5,7,0,-5.0,7.0,0.19223475456237793,683.1420472302119,82,-692,192,218,785,950,532,71,14.81
-6,6,0,-6.0,6.0,0.20021677017211914,675.7685980683165,82,-686,186,218,785,950,532,71,16.3
-6,5,0,-6.0,5.0,0.20822787284851074,668.6767723891418,82,-680,181,218,785,950,532,71,15.95
-7,6,0,-7.0,6.0,0.2162187099456787,660.3804713967743,82,-673,175,218,785,950,532,71,17.89
-9,5,0,-9.0,5.0,0.22422385215759277,650.4166616008105,82,-664,170,218,785,950,532,71,21.31
-11,5,0,-11.0,5.0,0.2323298454284668,638.5235704858443,82,-653,165,218,785,950,532,71,24.63
-12,5,0,-12.0,5.0,0.24022269248962402,625.6670871172561,82,-641,160,218,785,950,532,71,26.03
-14,5,0,-14.0,5.0,0.24823474884033203,610.874600832081,82,-627,155,218,785,950,532,71,28.97
-14,3,0,-14.0,3.0,0.2564668655395508,596.5639318390498,82,-613,152,218,785,950,532,71,29.22
-13,2,0,-13.0,2.0,0.26422882080078125,583.4658438426491,82,-600,150,218,785,950,532,71,25.97
-14,2,0,-14.0,2.0,0.27223873138427734,569.400529450463,82,-586,148,218,785,950,532,71,26.78
-14,2,0,-14.0,2.0,0.28040075302124023,555.3388857258177,82,-572,146,218,785,950,532,71,26.37
-14,2,0,-14.0,2.0,0.28838086128234863,541.2811813689564,82,-558,144,218,785,950,532,71,25.94
-16,3,0,-16.0,3.0,0.29625368118286133,525.040177130177,82,-542,141,218,785,950,532,71,28.82
-18,2,0,-18.0,2.0,0.30428481101989746,507.1226798428562,82,-524,139,218,785,950,532,71,29.24
-19,3,0,-19.0,3.0,0.31221985816955566,487.9923517605205,82,-505,136,218,785,950,532,71,30.34
-18,3,0,-18.0,3.0,0.32045984268188477,469.83462638769146,82,-487,133,218,785,950,532,71,28.67
-19,3,0,-19.0,3.0,0.32828474044799805,450.7200839990045,82,-468,130,218,785,950,532,71,28.8
-19,4,0,-19.0,4.0,0.33623576164245605,431.3442934142113,82,-449,126,218,785,950,532,71,28.99
-20,5,0,-20.0,5.0,0.3442246913909912,410.7375909658058,82,-429,121,218,785,950,532,71,30.21
-21,6,0,-21.0,6.0,0.35222768783569336,388.89739324511066,82,-408,115,218,785,950,532,71,31.77
-22,6,0,-22.0,6.0,0.3605327606201172,366.0947518978527,82,-386,109,218,785,950,532,71,31.09
-21,5,0,-21.0,5.0,0.36821985244750977,344.5273376187808,82,-365,104,218,785,950,532,71,27.6
-19,6,0,-19.0,6.0,0.3762238025665283,324.6109008358896,82,-346,98,218,785,950,532,71,25.74
-20,4,0,-20.0,4.0,0.38537168502807617,304.28159395994356,82,-326,94,218,785,950,532,71,23.89
-19,5,0,-19.0,5.0,0.3925466537475586,284.64042297556796,82,-307,89,218,785,950,532,71,23.8
-17,4,0,-17.0,4.0,0.40024876594543457,267.2002647252315,82,-290,85,218,785,950,532,71,20.52
-17,4,0,-17.0,4.0,0.4082458019256592,249.76305940202286,82,-273,81,218,785,950,532,71,19.63
-13,4,0,-13.0,4.0,0.41631269454956055,236.1623130156549,82,-260,77,218,785,950,532,71,17.93
-11,3,0,-11.0,3.0,0.42426085472106934,224.76335384345498,82,-249,74,218,785,950,532,71,15.28
-10,3,0,-10.0,3.0,0.4325296878814697,214.32308356828895,82,-239,71,218,785,950,532,71,15.42
-10,3,0,-10.0,3.0,0.4402308464050293,203.88281646028875,82,-229,68,218,785,950,532,71,15.08
-11,3,0,-11.0,3.0,0.44841670989990234,192.48406537601704,82,-218,65,218,785,950,532,71,14.11
-12,4,0,-12.0,4.0,0.4563448429107666,179.84180226389836,82,-206,61,218,785,950,532,71,14.05
-11,3,0,-11.0,3.0,0.4642767906188965,168.44286667268528,82,-195,58,218,785,950,532,71,13.26
-11,4,0,-11.0,4.0,0.4722177982330322,156.7602670002313,82,-184,54,218,785,950,532,71,11.85
-8,3,0,-8.0,3.0,0.48023366928100586,148.24027941476186,82,-176,51,218,785,950,532,71,9.56
-8,4,0,-8.0,4.0,0.488264799118042,139.4505660638566,82,-168,47,218,785,950,532,71,8.24
-6,2,0,-6.0,2.0,0.4962458610534668,133.13387523042465,82,-162,45,218,785,950,532,71,8.42
-6,2,0,-6.0,2.0,0.504328727722168,126.81779877380609,82,-156,43,218,785,950,532,71,8.22
-4,1,0,-4.0,1.0,0.5122287273406982,122.69590990257166,82,-152,42,218,785,950,532,71,7.76
-5,2,0,-5.0,2.0,0.5202338695526123,117.34500319997372,82,-147,40,218,785,950,532,71,6.55
-4,1,0,-4.0,1.0,0.5283458232879639,113.22280526288793,82,-143,39,218,785,950,532,71,7.73
-4,2,0,-4.0,2.0,0.5362427234649658,108.84018909887459,82,-139,37,218,785,950,532,71,5.15
-4,1,0,-4.0,1.0,0.5442287921905518,104.71757226634023,82,-135,36,218,785,950,532,71,7.84
-4,1,0,-4.0,1.0,0.5522336959838867,100.5949851580065,82,-131,35,218,785,950,532,71,7.75
-3,1,0,-3.0,1.0,0.5602278709411621,97.43866504914644,82,-128,34,218,785,950,532,71,5.92
-3,1,0,-3.0,1.0,0.5682647228240967,94.28263611173776,82,-125,33,218,785,950,532,71,5.85
-3,1,0,-3.0,1.0,0.5762207508087158,91.1269202034205,82,-122,32,218,785,950,532,71,5.77
-3,1,0,-3.0,1.0,0.584223747253418,87.97154142320898,82,-119,31,218,785,950,532,71,5.7
-5,1,0,-5.0,1.0,0.5922427177429199,82.881296226331,82,-114,30,218,785,950,532,71,6.49
-4,2,0,-4.0,2.0,0.6002357006072998,78.50770898930169,82,-110,28,218,785,950,532,71,4.49
-6,2,0,-6.0,2.0,0.6082358360290527,72.20074626605917,82,-104,26,218,785,950,532,71,6.34
-7,2,0,-7.0,2.0,0.6162106990814209,64.92497185388645,82,-97,24,218,785,950,532,71,7.32
-7,3,0,-7.0,3.0,0.6242208480834961,57.41753080449618,82,-90,21,218,785,950,532,71,5.13
-8,2,0,-8.0,2.0,0.6323437690734863,49.17244204607586,82,-82,19,218,785,950,532,71,7.78
-8,3,0,-8.0,3.0,0.6402478218078613,40.7099729229908,82,-74,16,218,785,950,532,71,4.97
-8,2,0,-8.0,2.0,0.6483817100524902,32.468511173732,82,-66,14,218,785,950,532,71,6.39
-8,2,0,-8.0,2.0,0.6566438674926758,24.22837157984339,82,-58,12,218,785,950,532,71,5.9
-9,2,0,-9.0,2.0,0.6642856597900391,15.009999000199947,82,-49,10,218,785,950,532,71,6.58
-8,2,0,-8.0,2.0,0.6722366809844971,6.773197148410844,82,-41,8,218,785,950,532,71,4.84
-8,1,0,-8.0,1.0,0.6802346706390381,-1.2657444131340014,82,-33,7,218,785,950,532,71,3.82
-5,2,0,-5.0,2.0,0.6882388591766357,-6.557074693344216,82,-28,5,218,785,950,532,71,2.35
-4,1,0,-4.0,1.0,0.6962287425994873,-10.668949878807123,82,-24,4,218,785,950,532,71,3.51
-2,1,0,-2.0,1.0,0.7042436599731445,-12.796396688825482,82,-22,3,218,785,950,532,71,1.71
-1,0,0,-1.0,-0.0,0.7123007774353027,-13.786796564403573,82,-21,3,218,785,950,532,71,3.1
0,0,1,-0.0,-0.0,0.73223876953125,-13.786796564403573,82,-21,3,218,785,950,532,71,23.09
0,0,0,-0.0,-0.0,0.07546734809875488,425.11411627986377,83,147,-436,386,346,239,782,70,121.93
2,0,0,2.0,-0.0,0.07659339904785156,424.4790528413673,83,145,-436,386,346,239,782,70,1.46
2,0,0,2.0,-0.0,0.08445930480957031,423.85182793577275,83,143,-436,386,346,239,782,70,1.44
2,0,0,2.0,-0.0,0.09264230728149414,423.2324737510427,83,141,-436,386,346,239,782,70,1.42
4,-2,0,4.0,-2.0,0.10046935081481934,420.1098768429444,83,137,-434,386,346,239,782,70,5.87
4,-2,0,4.0,-2.0,0.1086883544921875,417.0099556425721,83,133,-432,386,346,239,782,70,5.8
5,-3,0,5.0,-3.0,0.11705851554870605,412.6885077819175,83,128,-429,386,346,239,782,70,7.63
6,-3,0,6.0,-3.0,0.12447333335876465,408.12526445690276,83,122,-426,386,346,239,782,70,7.75
7,-3,0,7.0,-3.0,0.13246631622314453,403.353738435068,83,115,-423,386,346,239,782,70,7.84
7,-4,0,7.0,-4.0,0.14046549797058105,397.6950427263987,83,108,-419,386,346,239,782,70,9.13
8,-3,0,8.0,-3.0,0.1484663486480713,392.85044115905737,83,100,-416,386,346,239,782,70,7.68
8,-4,0,8.0,-4.0,0.1564652919769287,387.14689386515687,83,92,-412,386,346,239,782,70,8.87
10,-5,0,10.0,-5.0,0.16459345817565918,380.1782749614917,83,82,-407,386,346,239,782,70,10.31
13,-5,0,13.0,-5.0,0.17245936393737793,372.87865842674336,83,69,-402,386,346,239,782,70,10.35
16,-8,0,16.0,-8.0,0.180511474609375,362.54873915030845,83,53,-394,386,346,239,782,70,13.68
18,-10,0,18.0,-10.0,0.188462495803833,350.59175302384256,83,35,-384,386,346,239,782,70,15.05
18,-11,0,18.0,-11.0,0.1964564323425293,338.3871984950743,83,17,-373,386,346,239,782,70,14.91
19,-11,0,19.0,-11.0,0.20445632934570312,327.00552481971874,83,-2,-362,386,346,239,782,70,13.61
18,-13,0,18.0,-13.0,0.2124624252319336,314.57259617996374,83,-20,-349,386,346,239,782,70,14.31
17,-13,0,17.0,-13.0,0.22048139572143555,303.031063661315,83,-37,-336,386,346,239,782,70,13.06
14,-15,0,14.0,-15.0,0.2284684181213379,290.0261527938944,83,-51,-321,386,346,239,782,70,14.16
12,-14,0,12.0,-14.0,0.2364654541015625,278.39751115795417,83,-63,-307,386,346,239,782,70,12.57
10,-16,0,10.0,-16.0,0.2444744110107422,265.0166662037294,83,-73,-291,386,346,239,782,70,13.76
8,-15,0,8.0,-15.0,0.25244736671447754,252.64040050034697,83,-81,-276,386,346,239,782,70,12.57
6,-16,0,6.0,-16.0,0.26046228408813477,239.16965550549173,83,-87,-260,386,346,239,782,70,13.1
3,-17,0,3.0,-17.0,0.26885151863098145,224.13124087998347,83,-90,-243,386,346,239,782,70,13.97
2,-17,0,2.0,-17.0,0.27651047706604004,209.00819658363937,83,-92,-226,386,346,239,782,70,13.42
0,-16,0,-0.0,-16.0,0.28450441360473633,194.26840166058645,83,-92,-210,386,346,239,782,70,12.8
0,-14,0,-0.0,-14.0,0.2925083637237549,181.51789764358972,83,-92,-196,386,346,239,782,70,10.96
-3,-14,0,-3.0,-14.0,0.30046629905700684,167.5956564193813,83,-89,-182,386,346,239,782,70,11.87
-3,-13,0,-3.0,-13.0,0.3084583282470703,154.62331080328704,83,-86,-169,386,346,239,782,70,10.77
-4,-13,0,-4.0,-13.0,0.31645750999450684,141.23847480048164,83,-82,-156,386,346,239,782,70,10.76
-4,-12,0,-4.0,-12.0,0.32457828521728516,128.76812876747417,83,-78,-144,386,346,239,782,70,9.84
-4,-11,0,-4.0,-11.0,0.33268046379089355,117.20052562327109,83,-74,-133,386,346,239,782,70,9.06
-4,-8,0,-4.0,-8.0,0.3405594825744629,108.26548781894402,83,-70,-125,386,346,239,782,70,9.12
-3,-7,0,-3.0,-7.0,0.3486063480377197,100.69450983735487,83,-67,-118,386,346,239,782,70,7.21
-3,-6,0,-3.0,-6.0,0.3565022945404053,93.99612397277679,83,-64,-112,386,346,239,782,70,7.53
-3,-6,0,-3.0,-6.0,0.36446642875671387,87.29881438509533,83,-61,-106,386,346,239,782,70,7.27
-4,-5,0,-4.0,-5.0,0.37245750427246094,80.97413504743201,83,-57,-101,386,346,239,782,70,5.66
-2,-3,0,-2.0,-3.0,0.3804643154144287,77.37882362794157,83,-55,-98,386,346,239,782,70,5.56
-1,-3,0,-1.0,-3.0,0.38851332664489746,74.27488274987991,83,-54,-95,386,346,239,782,70,4.13
-1,-3,0,-1.0,-3.0,0.39656639099121094,71.17438485811914,83,-53,-92,386,346,239,782,70,4.04
-1,-2,0,-1.0,-2.0,0.40444445610046387,68.94229168149026,83,-52,-90,386,346,239,782,70,5.25
-2,-3,0,-2.0,-3.0,0.41245341300964355,65.34440691936945,83,-50,-87,386,346,239,782,70,5.53
-1,-2,0,-1.0,-2.0,0.4205443859100342,63.11218069128827,83,-49,-85,386,346,239,782,70,5.21
-2,-3,0,-2.0,-3.0,0.42846035957336426,59.51454914456292,83,-47,-82,386,346,239,782,70,5.41
-1,-2,0,-1.0,-2.0,0.43653345108032227,57.28217596047462,83,-46,-80,386,346,239,782,70,5.16
-2,-2,0,-2.0,-2.0,0.4444613456726074,54.55445270895244,83,-44,-78,386,346,239,782,70,3.27
-3,-3,0,-3.0,-3.0,0.4524714946746826,50.47514258543241,83,-41,-75,386,346,239,782,70,3.45
-3,-2,0,-3.0,-2.0,0.46047329902648926,47.29823813423954,83,-38,-73,386,346,239,782,70,2.38
-3,-3,0,-3.0,-3.0,0.4684615135192871,43.26237921249263,83,-35,-70,386,346,239,782,70,3.12
-3,-3,0,-3.0,-3.0,0.4765934944152832,39.24957912338628,83,-32,-67,386,346,239,782,70,2.95
-2,-3,0,-2.0,-3.0,0.4844553470611572,35.68238818828917,83,-30,-64,386,346,239,782,70,3.93
-3,-2,0,-3.0,-2.0,0.49245643615722656,32.62396025078685,83,-27,-62,386,346,239,782,70,1.9
-3,-3,0,-3.0,-3.0,0.5011353492736816,28.694583757176716,83,-24,-59,386,346,239,782,70,2.46
-3,-3,0,-3.0,-3.0,0.5084803104400635,24.808026217222718,83,-21,-56,386,346,239,782,70,2.27
-2,-3,0,-2.0,-3.0,0.5164644718170166,21.302753041036986,83,-19,-53,386,346,239,782,70,2.95
-2,-3,0,-2.0,-3.0,0.5244674682617188,17.810983706043572,83,-17,-50,386,346,239,782,70,2.78
-1,-2,0,-1.0,-2.0,0.5324695110321045,15.596442562694072,83,-16,-48,386,346,239,782,70,3.49
0,0,1,-0.0,-0.0,0.5384523868560791,15.596442562694072,83,-16,-48,386,346,239,782,70,31.57
0,-1,1,-0.0,-1.0,0.0010135173797607422,1254.0774570102292,84,1284,135,1686,528,402,394,74,26.24
-1,0,1,-1.0,-0.0,0.008922576904296875,1255.0719794191034,84,1285,135,1686,528,402,394,74,6.87
0,-1,1,-0.0,-1.0,0.024892568588256836,1255.1768454820726,84,1285,136,1686,528,402,394,74,26.11
0,0,0,-0.0,-0.0,0.11392641067504883,1255.1768454820726,84,1285,136,1686,528,402,394,74,233.36
1,0,0,1.0,-0.0,0.16091561317443848,1254.1824038454056,84,1284,136,1686,528,402,394,74,6.82
3,1,0,3.0,1.0,0.1691756248474121,1251.0939406735831,84,1281,135,1686,528,402,394,74,11.94
8,2,0,8.0,2.0,0.17726755142211914,1242.928904275546,84,1273,133,1686,528,402,394,74,25.8
12,5,0,12.0,5.0,0.18494248390197754,1230.4797828762398,84,1261,128,1686,528,402,394,74,34.66
18,7,0,18.0,7.0,0.19291257858276367,1211.8754941946775,84,1243,121,1686,528,402,394,74,47.07
22,7,0,22.0,7.0,0.20089149475097656,1189.3103196173472,84,1221,114,1686,528,402,394,74,54.1
28,7,0,28.0,7.0,0.20889759063720703,1160.7887960738321,84,1193,107,1686,528,402,394,74,63.43
32,6,0,32.0,6.0,0.21702146530151367,1128.3849149529954,84,1161,101,1686,528,402,394,74,68.64
35,3,0,35.0,3.0,0.22500061988830566,1093.2566080319991,84,1126,98,1686,528,402,394,74,73.98
37,2,0,37.0,2.0,0.23295044898986816,1056.2232159993675,84,1089,96,1686,528,402,394,74,73.35
39,1,0,39.0,1.0,0.24094057083129883,1017.2888598481918,84,1050,95,1686,528,402,394,74,73.38
38,2,0,38.0,2.0,0.2492666244506836,979.2642372926442,84,1012,93,1686,528,402,394,74,71.37
39,1,0,39.0,1.0,0.25695157051086426,940.3397566864862,84,973,92,1686,528,402,394,74,70.13
38,1,0,38.0,1.0,0.26490354537963867,902.4179048751413,84,935,91,1686,528,402,394,74,67.38
36,3,0,36.0,3.0,0.27289843559265137,866.2967397262098,84,899,88,1686,528,402,394,74,65.48
33,3,0,33.0,3.0,0.28089141845703125,833.1614792669232,84,866,85,1686,528,402,394,74,61.19
33,5,0,33.0,5.0,0.28890347480773926,799.8327192456088,84,833,80,1686,528,402,394,74,58.29
32,5,0,32.0,5.0,0.296891450881958,767.5035736402915,84,801,75,1686,528,402,394,74,55.69
33,5,0,33.0,5.0,0.3050065040588379,734.1835060476851,84,768,70,1686,528,402,394,74,55.37
31,5,0,31.0,5.0,0.3129434585571289,702.8607977180573,84,737,65,1686,528,402,394,74,51.66
34,4,0,34.0,4.0,0.32091856002807617,668.6415520645025,84,703,61,1686,528,402,394,74,54.04
32,3,0,32.0,3.0,0.32894158363342285,636.5020415707736,84,671,58,1686,528,402,394,74,51.63
33,4,0,33.0,4.0,0.3369014263153076,603.2811882290467,84,638,54,1686,528,402,394,74,49.77
30,2,0,30.0,2.0,0.34488558769226074,573.2196325914138,84,608,52,1686,528,402,394,74,46.0
27,3,0,27.0,3.0,0.35289955139160156,546.0626038428463,84,581,49,1686,528,402,394,74,41.63
25,3,0,25.0,3.0,0.3609194755554199,520.8996325505153,84,556,46,1686,528,402,394,74,38.23
22,3,0,22.0,3.0,0.3689444065093994,498.72847600253624,84,534,43,1686,528,402,394,74,33.86
21,4,0,21.0,4.0,0.3769044876098633,477.4803203233337,84,513,39,1686,528,402,394,74,31.19
19,4,0,19.0,4.0,0.3849015235900879,458.2383264651475,84,494,35,1686,528,402,394,74,28.16
20,4,0,20.0,4.0,0.39290642738342285,438.0126314109973,84,474,31,1686,528,402,394,74,28.4
20,2,0,20.0,2.0,0.4009544849395752,417.92526858814955,84,454,29,1686,528,402,394,74,29.03
18,1,0,18.0,1.0,0.4088926315307617,399.89815746922073,84,436,28,1686,528,402,394,74,27.55
19,1,0,19.0,1.0,0.4169015884399414,380.8731865051884,84,417,27,1686,528,402,394,74,27.52
20,1,0,20.0,1.0,0.4250354766845703,360.85047442475167,84,397,26,1686,528,402,394,74,27.37
19,0,0,19.0,-0.0,0.43292856216430664,341.89312477267254,84,378,26,1686,528,402,394,74,24.11
18,1,0,18.0,1.0,0.44089555740356445,323.86701151532264,84,360,25,1686,528,402,394,74,24.22
16,0,0,16.0,-0.0,0.4489095211029053,307.90723390500233,84,344,25,1686,528,402,394,74,20.18
14,0,0,14.0,-0.0,0.45691442489624023,293.94561486745823,84,330,25,1686,528,402,394,74,17.97
9,0,0,9.0,-0.0,0.46490049362182617,284.97204847626136,84,321,25,1686,528,402,394,74,13.34
8,0,0,8.0,-0.0,0.47289443016052246,276.99681527047375,84,313,25,1686,528,402,394,74,12.21
7,1,0,7.0,1.0,0.48089051246643066,269.9397334982879,84,306,24,1686,528,402,394,74,11.49
6,1,0,6.0,1.0,0.48896360397338867,263.8803749000589,84,300,23,1686,528,402,394,74,10.06
5,1,0,5.0,1.0,0.4969344139099121,258.81920154040034,84,295,22,1686,528,402,394,74,8.65
7,1,0,7.0,1.0,0.5050294399261475,251.76461001999536,84,288,21,1686,528,402,394,74,11.02
9,2,0,9.0,2.0,0.5128955841064453,242.6462050520264,84,279,19,1686,528,402,394,74,11.53
9,1,0,9.0,1.0,0.5210654735565186,233.59933481071232,84,270,18,1686,528,402,394,74,12.75
11,0,0,11.0,-0.0,0.5289645195007324,222.6247291765559,84,259,18,1686,528,402,394,74,13.33
10,0,0,10.0,-0.0,0.5369024276733398,212.64975465639858,84,249,18,1686,528,402,394,74,12.27
10,0,0,10.0,-0.0,0.5449004173278809,202.67686580060246,84,239,18,1686,528,402,394,74,11.91
9,0,0,9.0,-0.0,0.5529494285583496,193.70327262524907,84,230,18,1686,528,402,394,74,10.92
8,0,0,8.0,-0.0,0.5609424114227295,185.72853431924702,84,222,18,1686,528,402,394,74,10.0
9,0,0,9.0,-0.0,0.5689184665679932,176.75921032788273,84,213,18,1686,528,402,394,74,10.34
8,0,0,8.0,-0.0,0.5769035816192627,168.7887266105702,84,205,18,1686,528,402,394,74,9.45
10,0,0,10.0,-0.0,0.5851624011993408,158.82900704441107,84,195,18,1686,528,402,394,74,10.25
10,0,0,10.0,-0.0,0.5929434299468994,148.87361297397757,84,185,18,1686,528,402,394,74,9.85
9,0,0,9.0,-0.0,0.6009025573730469,139.91806012954132,84,176,18,1686,528,402,394,74,8.97
9,0,0,9.0,-0.0,0.6089174747467041,130.96725871431016,84,167,18,1686,528,402,394,74,8.62
8,1,0,8.0,1.0,0.6169524192810059,122.90622251807463,84,159,17,1686,528,402,394,74,9.94
8,1,0,8.0,1.0,0.6248965263366699,114.84531602917491,84,151,16,1686,528,402,394,74,9.66
6,1,0,6.0,1.0,0.6328945159912109,108.7737973711325,84,145,15,1686,528,402,394,74,7.34
4,1,0,4.0,1.0,0.6409025192260742,104.69333082400175,84,141,14,1686,528,402,394,74,5.3
3,0,0,3.0,-0.0,0.6488955020904541,101.70832707519762,84,138,14,1686,528,402,394,74,5.24
4,0,0,4.0,-0.0,0.6569004058837891,97.72935834479432,84,134,14,1686,528,402,394,74,5.58
4,0,0,4.0,-0.0,0.6648914813995361,93.75167302944922,84,130,14,1686,528,402,394,74,5.47
5,0,0,5.0,-0.0,0.6732754707336426,88.78155667664477,84,125,14,1686,528,402,394,74,5.71
6,0,0,6.0,-0.0,0.6809005737304688,82.82069938036582,84,119,14,1686,528,402,394,74,5.87
6,0,0,6.0,-0.0,0.688929557800293,76.86395390991831,84,113,14,1686,528,402,394,74,5.65
7,0,0,7.0,-0.0,0.6969225406646729,69.92053123698928,84,106,14,1686,528,402,394,74,5.68
7,0,0,7.0,-0.0,0.704958438873291,62.98499887483122,84,99,14,1686,528,402,394,74,5.38
6,0,0,6.0,-0.0,0.7129275798797607,57.04786015641186,84,93,14,1686,528,402,394,74,4.87
5,-1,0,5.0,-1.0,0.7209055423736572,52.26925562588724,84,88,15,1686,528,402,394,74,3.23
6,0,0,6.0,-0.0,0.728893518447876,46.36066218546971,84,82,15,1686,528,402,394,74,4.3
7,0,0,7.0,-0.0,0.736891508102417,39.48529270389177,84,75,15,1686,528,402,394,74,4.15
8,0,0,8.0,-0.0,0.7451095581054688,31.658575575087482,84,67,15,1686,528,402,394,74,3.87
7,0,0,7.0,-0.0,0.7528965473175049,24.846584384264908,84,60,15,1686,528,402,394,74,3.34
6,0,0,6.0,-0.0,0.7609095573425293,19.044625076808217,84,54,15,1686,528,402,394,74,2.9
4,1,0,4.0,1.0,0.7688875198364258,14.923019942988681,84,50,14,1686,528,402,394,74,5.54
4,0,0,4.0,-0.0,0.7769246101379395,11.08326112068523,84,46,14,1686,528,402,394,74,2.43
3,0,0,3.0,-0.0,0.7849385738372803,8.221676218380054,84,43,14,1686,528,402,394,74,2.26
1,0,0,1.0,-0.0,0.7928996086120605,7.271887242357309,84,42,14,1686,528,402,394,74,2.28
0,0,1,-0.0,-0.0,0.8059065341949463,7.271887242357309,84,42,14,1686,528,402,394,74,29.07
1,0,1,1.0,-0.0,0.8095214366912842,6.324358044868937,84,41,14,1686,528,402,394,74,12.24
0,1,1,-0.0,1.0,0.004876375198364258,1293.113353874389,85,-1309,-54,336,461,1645,514,35,95.06
0,0,0,-0.0,-0.0,0.08588218688964844,1293.113353874389,85,-1309,-54,336,461,1645,514,35,237.17
-1,1,0,-1.0,1.0,0.11687517166137695,1292.1558348798665,85,-1308,-55,336,461,1645,514,35,7.17
-1,2,0,-1.0,2.0,0.1248621940612793,1291.2423322916898,85,-1307,-57,336,461,1645,514,35,6.42
-2,2,0,-2.0,2.0,0.1328582763671875,1289.3330356383092,85,-1305,-59,336,461,1645,514,35,12.92
-1,3,0,-1.0,3.0,0.14109420776367188,1288.4730943225143,85,-1304,-62,336,461,1645,514,35,5.9
-2,1,0,-2.0,1.0,0.14886832237243652,1286.5233024384336,85,-1302,-63,336,461,1645,514,35,13.83
-1,1,0,-1.0,1.0,0.15687131881713867,1285.573222509967,85,-1301,-64,336,461,1645,514,35,7.09
-2,2,0,-2.0,2.0,0.16485118865966797,1283.6755936819911,85,-1299,-66,336,461,1645,514,35,12.81
-3,1,0,-3.0,1.0,0.17300724983215332,1280.7307116655597,85,-1296,-67,336,461,1645,514,35,19.92
-7,2,0,-7.0,2.0,0.18087339401245117,1273.8454593792396,85,-1289,-69,336,461,1645,514,35,39.83
-13,3,0,-13.0,3.0,0.18892335891723633,1261.0297336134242,85,-1276,-72,336,461,1645,514,35,63.34
-20,3,0,-20.0,3.0,0.19686222076416016,1241.2372590254988,85,-1256,-75,336,461,1645,514,35,84.16
-26,3,0,-26.0,3.0,0.20486235618591309,1215.4706893066464,85,-1230,-78,336,461,1645,514,35,97.34
-32,2,0,-32.0,2.0,0.21288537979125977,1183.668147324647,85,-1198,-80,336,461,1645,514,35,107.72
-36,1,0,-36.0,1.0,0.22088122367858887,1147.8197285417173,85,-1162,-81,336,461,1645,514,35,112.68
-38,0,0,-38.0,-0.0,0.22887229919433594,1109.9148148817637,85,-1124,-81,336,461,1645,514,35,113.9
-36,-1,0,-36.0,-1.0,0.23685216903686523,1073.9372117587702,85,-1088,-80,336,461,1645,514,35,109.66
-36,-3,0,-36.0,-3.0,0.2448592185974121,1037.8142016488023,85,-1052,-77,336,461,1645,514,35,109.12
-32,-3,0,-32.0,-3.0,0.2528862953186035,1005.6807908629163,85,-1020,-74,336,461,1645,514,35,100.86
-29,-4,0,-29.0,-4.0,0.2612001895904541,976.4691741569036,85,-991,-70,336,461,1645,514,35,93.37
-31,-5,0,-31.0,-5.0,0.26888322830200195,945.1980045707847,85,-960,-65,336,461,1645,514,35,94.5
-31,-5,0,-31.0,-5.0,0.2769472599029541,913.9355509378723,85,-929,-60,336,461,1645,514,35,92.63
-30,-5,0,-30.0,-5.0,0.28498029708862305,883.6808535768927,85,-899,-55,336,461,1645,514,35,89.23
-30,-6,0,-30.0,-6.0,0.29286623001098633,853.3803766170283,85,-869,-49,336,461,1645,514,35,87.11
-28,-5,0,-28.0,-5.0,0.3009183406829834,825.1502241286884,85,-841,-44,336,461,1645,514,35,82.47
-29,-5,0,-29.0,-5.0,0.30884838104248047,795.9360368442279,85,-812,-39,336,461,1645,514,35,82.21
-27,-4,0,-27.0,-4.0,0.31687235832214355,768.7798673928978,85,-785,-35,336,461,1645,514,35,77.72
-27,-4,0,-27.0,-4.0,0.3250162601470947,741.6336401715917,85,-758,-31,336,461,1645,514,35,76.01
-26,-3,0,-26.0,-3.0,0.33286023139953613,715.5353233803814,85,-732,-28,336,461,1645,514,35,73.24
-24,-2,0,-24.0,-2.0,0.3409242630004883,691.4772402836946,85,-708,-26,336,461,1645,514,35,69.23
-21,-1,0,-21.0,-1.0,0.3488633632659912,670.4547257819964,85,-687,-25,336,461,1645,514,35,64.26
-21,-2,0,-21.0,-2.0,0.35703039169311523,649.397028804901,85,-666,-23,336,461,1645,514,35,61.57
-21,-2,0,-21.0,-2.0,0.3649153709411621,628.3417699173051,85,-645,-21,336,461,1645,514,35,60.32
-20,-2,0,-20.0,-2.0,0.37285828590393066,608.2887333064622,85,-625,-19,336,461,1645,514,35,57.37
-19,-3,0,-19.0,-3.0,0.38086938858032227,589.2111843244069,85,-606,-16,336,461,1645,514,35,53.84
-18,-3,0,-18.0,-3.0,0.3888523578643799,571.1436899261948,85,-588,-13,336,461,1645,514,35,50.98
-16,-3,0,-16.0,-3.0,0.3968641757965088,555.0874059092719,85,-572,-10,336,461,1645,514,35,46.32
-15,-3,0,-15.0,-3.0,0.4049832820892334,540.0439839007329,85,-557,-7,336,461,1645,514,35,43.54
-15,-3,0,-15.0,-3.0,0.4131183624267578,525.0147599466272,85,-542,-4,336,461,1645,514,35,42.72
-13,-3,0,-13.0,-3.0,0.42086124420166016,512.0009451787397,85,-529,-1,336,461,1645,514,35,38.02
-16,-2,0,-16.0,-2.0,0.4288642406463623,496.0009746579435,85,-513,1,336,461,1645,514,35,43.45
-16,-2,0,-16.0,-2.0,0.4370431900024414,480.00905424348156,85,-497,3,336,461,1645,514,35,42.51
-16,-2,0,-16.0,-2.0,0.44518136978149414,464.02598682399685,85,-481,5,336,461,1645,514,35,41.56
-15,-1,0,-15.0,-1.0,0.4528632164001465,449.0386250087003,85,-466,6,336,461,1645,514,35,39.76
-14,-1,0,-14.0,-1.0,0.4608883857727051,435.05420029018643,85,-452,7,336,461,1645,514,35,37.21
-13,0,0,-13.0,-0.0,0.4688682556152344,422.0558051091,85,-439,7,336,461,1645,514,35,36.61
-14,-1,0,-14.0,-1.0,0.4768683910369873,408.07528744917647,85,-425,8,336,461,1645,514,35,35.7
-15,-1,0,-15.0,-1.0,0.48490238189697266,393.0987685911773,85,-410,9,336,461,1645,514,35,36.43
-17,0,0,-17.0,-0.0,0.49285030364990234,376.10303992719264,85,-393,9,336,461,1645,514,35,39.77
-17,0,0,-17.0,-0.0,0.5008552074432373,359.10769734213096,85,-376,9,336,461,1645,514,35,38.62
-18,0,0,-18.0,-0.0,0.50887131690979,341.11311062288684,85,-358,9,336,461,1645,514,35,38.6
-17,1,0,-17.0,1.0,0.517059326171875,324.09382873338535,85,-341,8,336,461,1645,514,35,35.88
-18,2,0,-18.0,2.0,0.5248632431030273,306.05572274763995,85,-323,6,336,461,1645,514,35,34.63
-15,2,0,-15.0,2.0,0.5328652858734131,291.0259729308553,85,-308,4,336,461,1645,514,35,29.74
-16,2,0,-16.0,2.0,0.5408852100372314,275.0068492347397,85,-292,2,336,461,1645,514,35,29.8
-13,1,0,-13.0,1.0,0.5488853454589844,262.0017921089397,85,-279,1,336,461,1645,514,35,26.02
-12,1,0,-12.0,1.0,0.556882381439209,250.0,85,-267,0,336,461,1645,514,35,23.9
-10,0,0,-10.0,-0.0,0.5648572444915771,240.0,85,-257,0,336,461,1645,514,35,23.69
-9,0,0,-9.0,-0.0,0.5728552341461182,231.0,85,-248,0,336,461,1645,514,35,21.9
-10,1,0,-10.0,1.0,0.580909252166748,221.0021008310641,85,-238,-1,336,461,1645,514,35,19.5
-10,1,0,-10.0,1.0,0.5888633728027344,211.00877176108818,85,-228,-2,336,461,1645,514,35,18.88
-12,0,0,-12.0,-0.0,0.5968601703643799,199.0092590608097,85,-216,-2,336,461,1645,514,35,22.87
-12,1,0,-12.0,1.0,0.6048562526702881,187.02205763103166,85,-204,-3,336,461,1645,514,35,19.69
-12,0,0,-12.0,-0.0,0.6128673553466797,175.02343606966312,85,-192,-3,336,461,1645,514,35,20.91
-9,0,0,-9.0,-0.0,0.6209871768951416,166.02458851203573,85,-183,-3,336,461,1645,514,35,17.37
-9,0,0,-9.0,-0.0,0.6289842128753662,157.0258601472781,85,-174,-3,336,461,1645,514,35,16.83
-9,0,0,-9.0,-0.0,0.6368553638458252,148.0272704737008,85,-165,-3,336,461,1645,514,35,16.28
-9,0,0,-9.0,-0.0,0.6448612213134766,139.02884348735012,85,-156,-3,336,461,1645,514,35,15.72
-8,0,0,-8.0,-0.0,0.6530041694641113,131.03040228277433,85,-148,-3,336,461,1645,514,35,14.33
-7,0,0,-7.0,-0.0,0.660961389541626,124.03191128251791,85,-141,-3,336,461,1645,514,35,13.04
-6,0,0,-6.0,-0.0,0.668877363204956,118.03332921912278,85,-135,-3,336,461,1645,514,35,11.82
-7,0,0,-7.0,-0.0,0.6768972873687744,111.03515142334936,85,-128,-3,336,461,1645,514,35,12.31
-7,0,0,-7.0,-0.0,0.6848952770233154,104.03718436910205,85,-121,-3,336,461,1645,514,35,11.91
-6,0,0,-6.0,-0.0,0.6928772926330566,98.03912377969506,85,-115,-3,336,461,1645,514,35,10.79
-6,0,0,-6.0,-0.0,0.7010324001312256,92.04127658827184,85,-109,-3,336,461,1645,514,35,10.47
-5,0,0,-5.0,-0.0,0.7088642120361328,87.04326023342406,85,-104,-3,336,461,1645,514,35,9.47
-6,0,0,-6.0,-0.0,0.7172152996063232,81.04590761474952,85,-98,-3,336,461,1645,514,35,9.86
-8,0,0,-8.0,-0.0,0.7248632907867432,73.0499861188218,85,-90,-3,336,461,1645,514,35,10.56
-9,0,0,-9.0,-0.0,0.7329022884368896,64.05553651663777,85,-81,-3,336,461,1645,514,35,10.38
-8,0,0,-8.0,-0.0,0.7408633232116699,56.06161783043132,85,-73,-3,336,461,1645,514,35,9.27
-7,1,0,-7.0,1.0,0.7488713264465332,49.12110101926616,85,-66,-4,336,461,1645,514,35,6.31
-6,0,0,-6.0,-0.0,0.7568633556365967,43.13318551349163,85,-60,-4,336,461,1645,514,35,7.07
-6,0,0,-6.0,-0.0,0.764918327331543,37.147945482723536,85,-54,-4,336,461,1645,514,35,6.61
-3,0,0,-3.0,-0.0,0.7729382514953613,34.15662224971465,85,-51,-4,336,461,1645,514,35,5.32
-3,0,0,-3.0,-0.0,0.7808563709259033,31.166378315169183,85,-48,-4,336,461,1645,514,35,5.14
-1,0,0,-1.0,-0.0,0.7888572216033936,30.16990566028302,85,-47,-4,336,461,1645,514,35,4.42
-3,0,0,-3.0,-0.0,0.7968692779541016,27.181444068749045,85,-44,-4,336,461,1645,514,35,4.9
-3,0,0,-3.0,-0.0,0.8048763275146484,24.19465984809196,85,-41,-4,336,461,1645,514,35,4.7
-3,-1,0,-3.0,-1.0,0.8128683567047119,21.118237105091836,85,-38,-3,336,461,1645,514,35,3.37
-5,0,0,-5.0,-0.0,0.8208491802215576,16.136083051561783,85,-33,-3,336,461,1645,514,35,4.9
-6,-1,0,-6.0,-1.0,0.8288583755493164,10.073972741361768,85,-27,-2,336,461,1645,514,35,4.71
-5,0,0,-5.0,-0.0,0.8370082378387451,5.090722034374522,85,-22,-2,336,461,1645,514,35,4.22
-7,0,0,-7.0,-0.0,0.8448853492736816,-1.8672540495784435,85,-15,-2,336,461,1645,514,35,3.34
-8,-1,0,-8.0,-1.0,0.8528633117675781,-9.928932188134524,85,-7,-1,336,461,1645,514,35,5.27
-9,0,0,-9.0,-0.0,0.8608613014221191,-14.76393202250021,85,2,-1,336,461,1645,514,35,-1.08
-10,0,0,-10.0,-0.0,0.8688693046569824,-4.958405421207704,85,12,-1,336,461,1645,514,35,-1.27
-9,0,0,-9.0,-0.0,0.8769493103027344,4.023796041628639,85,21,-1,336,461,1645,514,35,1.97
-7,-1,0,-7.0,-1.0,0.8848693370819092,11.0,85,28,0,336,461,1645,514,35,1.41
-6,-1,0,-6.0,-1.0,0.8928482532501221,17.0147027033899,85,34,1,336,461,1645,514,35,1.95
-9,-2,0,-9.0,-2.0,0.9008631706237793,26.104524124504614,85,43,3,336,461,1645,514,35,1.58
-8,-1,0,-8.0,-1.0,0.9089193344116211,34.15662224971465,85,51,4,336,461,1645,514,35,3.54
-6,-1,0,-6.0,-1.0,0.9168872833251953,40.21887800367987,85,57,5,336,461,1645,514,35,3.26
-2,0,0,-2.0,-0.0,0.9248583316802979,42.21148537234985,85,59,5,336,461,1645,514,35,4.02
-1,0,0,-1.0,-0.0,0.9328513145446777,43.207972893961475,85,60,5,336,461,1645,514,35,4.56
0,0,1,-0.0,-0.0,0.9408671855926514,43.207972893961475,85,60,5,336,461,1645,514,35,30.0
0,0,0,-0.0,-0.0,1.036867380142212,43.207972893961475,85,60,5,336,461,1645,514,35,30.0
2,0,0,2.0,-0.0,1.068974256515503,41.215118311311535,85,58,5,336,461,1645,514,35,4.98
2,0,0,2.0,-0.0,1.0768601894378662,39.22277118748239,85,56,5,336,461,1645,514,35,4.9
3,0,0,3.0,-0.0,1.084869384765625,36.23532661682466,85,53,5,336,461,1645,514,35,5.15
1,0,0,1.0,-0.0,1.0928583145141602,35.23983154643591,85,52,5,336,461,1645,514,35,4.33
2,0,0,2.0,-0.0,1.1009232997894287,33.24937810560445,85,50,5,336,461,1645,514,35,4.62
2,0,0,2.0,-0.0,1.108870267868042,31.25971404805462,85,48,5,336,461,1645,514,35,4.52
2,0,0,2.0,-0.0,1.1168763637542725,29.270941205037097,85,46,5,336,461,1645,514,35,4.42
2,0,0,2.0,-0.0,1.1248633861541748,27.28317965096906,85,44,5,336,461,1645,514,35,4.31
2,1,0,2.0,1.0,1.1328833103179932,25.190046219457976,85,42,4,336,461,1645,514,35,2.67
2,0,0,2.0,-0.0,1.1411523818969727,23.19950248448356,85,40,4,336,461,1645,514,35,4.38
4,0,0,4.0,-0.0,1.148869276046753,19.22154055254967,85,36,4,336,461,1645,514,35,4.58
4,0,0,4.0,-0.0,1.1568691730499268,15.249030993194197,85,32,4,336,461,1645,514,35,4.23
4,0,0,4.0,-0.0,1.1648612022399902,11.284271247461902,85,28,4,336,461,1645,514,35,3.85
5,0,0,5.0,-0.0,1.1728932857513428,6.3452350598575045,85,23,4,336,461,1645,514,35,3.42
4,1,0,4.0,1.0,1.1808552742004395,2.2353840616713434,85,19,3,336,461,1645,514,35,3.98
4,0,0,4.0,-0.0,1.1888713836669922,-1.7029414592216447,85,15,3,336,461,1645,514,35,2.58
2,0,0,2.0,-0.0,1.1968603134155273,-3.658335935873666,85,13,3,336,461,1645,514,35,2.27
1,1,0,1.0,1.0,1.204984188079834,-4.834474939403561,85,12,2,336,461,1645,514,35,0.84
0,0,1,-0.0,-0.0,1.2129004001617432,-4.834474939403561,85,12,2,336,461,1645,514,35,25.55
0,0,0,-0.0,-0.0,0.06563138961791992,319.40219244091537,86,-298,138,26,597,324,459,18,101.0
-4,5,0,-4.0,5.0,0.2947065830230713,313.6840560052511,86,-294,133,26,597,324,459,18,24.08
-7,9,0,-7.0,9.0,0.30263447761535645,303.64196775225173,86,-287,124,26,597,324,459,18,33.96
-9,10,0,-9.0,10.0,0.3107454776763916,291.4663042672173,86,-278,114,26,597,324,459,18,37.11
-9,11,0,-9.0,11.0,0.318805456161499,279.0451353520833,86,-269,103,26,597,324,459,18,36.18
-11,10,0,-11.0,10.0,0.3266634941101074,265.2498860528478,86,-258,93,26,597,324,459,18,37.38
-11,9,0,-11.0,9.0,0.33478856086730957,251.89269824968272,86,-247,84,26,597,324,459,18,35.55
-14,8,0,-14.0,8.0,0.3426194190979004,236.08161905781512,86,-233,76,26,597,324,459,18,37.83
-15,9,0,-15.0,9.0,0.3506793975830078,219.06358762415363,86,-218,67,26,597,324,459,18,36.94
-17,8,0,-17.0,8.0,0.3586454391479492,200.4803093371785,86,-201,59,26,597,324,459,18,36.74
-18,8,0,-18.0,8.0,0.36668848991394043,180.97368238785077,86,-183,51,26,597,324,459,18,34.99
-18,9,0,-18.0,9.0,0.37462449073791504,161.26156348395253,86,-165,42,26,597,324,459,18,31.89
-17,8,0,-17.0,8.0,0.38271641731262207,142.85519418182574,86,-148,34,26,597,324,459,18,28.4
-16,6,0,-16.0,6.0,0.3908054828643799,125.937022347464,86,-132,28,26,597,324,459,18,25.53
-14,7,0,-14.0,7.0,0.3986234664916992,110.85407794480753,86,-118,21,26,597,324,459,18,21.32
-12,5,0,-12.0,5.0,0.40665340423583984,98.20074626605917,86,-106,16,26,597,324,459,18,18.22
-11,5,0,-11.0,5.0,0.41461658477783203,86.63472172804185,86,-95,11,26,597,324,459,18,15.69
-11,5,0,-11.0,5.0,0.422621488571167,75.2140130857092,86,-84,6,26,597,324,459,18,14.0
-11,5,0,-11.0,5.0,0.4306185245513916,64.00684899377592,86,-73,1,26,597,324,459,18,12.26
-13,5,0,-13.0,5.0,0.4387664794921875,51.13318551349163,86,-60,-4,26,597,324,459,18,11.32
-14,6,0,-14.0,6.0,0.44663357734680176,38.07440918375928,86,-46,-10,26,597,324,459,18,8.99
-15,5,0,-15.0,5.0,0.4546234607696533,25.438350715445125,86,-31,-15,26,597,324,459,18,6.65
-15,5,0,-15.0,5.0,0.4627504348754883,16.612496949731394,86,-16,-20,26,597,324,459,18,3.42
-12,5,0,-12.0,5.0,0.470672607421875,16.317977802344327,86,-4,-25,26,597,324,459,18,-1.65
-10,2,0,-10.0,2.0,0.47862958908081055,18.65863337187866,86,6,-27,26,597,324,459,18,-1.24
-6,0,0,-6.0,-0.0,0.4866325855255127,20.546573405388315,86,12,-27,26,597,324,459,18,-0.48
-2,0,0,-2.0,-0.0,0.49463844299316406,21.4138126514911,86,14,-27,26,597,324,459,18,0.98
-1,-1,0,-1.0,-1.0,0.5026974678039551,21.01666203960727,86,15,-26,26,597,324,459,18,0.37
-2,0,0,-2.0,-0.0,0.5106954574584961,22.064449134018133,86,17,-26,26,597,324,459,18,0.96
-1,0,0,-1.0,-0.0,0.5186126232147217,22.622776601683793,86,18,-26,26,597,324,459,18,2.0
0,-1,0,-0.0,-1.0,0.5906195640563965,21.805843601498726,86,18,-25,26,597,324,459,18,1.84
0,-2,0,-0.0,-2.0,0.599353551864624,20.206163733020468,86,18,-23,26,597,324,459,18,2.08
2,-3,0,2.0,-3.0,0.6066794395446777,16.612496949731394,86,16,-20,26,597,324,459,18,5.66
1,-3,0,1.0,-3.0,0.6146314144134521,13.671568097509269,86,15,-17,26,597,324,459,18,3.05
1,-2,0,1.0,-2.0,0.6226334571838379,11.518284528683193,86,14,-15,26,597,324,459,18,3.11
0,-2,0,-0.0,-2.0,0.6306324005126953,10.104973174542799,86,14,-13,26,597,324,459,18,1.2
0,-1,0,-0.0,-1.0,0.6386206150054932,9.439088914585774,86,14,-12,26,597,324,459,18,0.96
0,-1,0,-0.0,-1.0,0.6466495990753174,8.804493814764857,86,14,-11,26,597,324,459,18,0.86
0,-1,0,-0.0,-1.0,0.6626265048980713,8.204650534085253,86,14,-10,26,597,324,459,18,0.75
0,-1,0,-0.0,-1.0,0.6787095069885254,7.643316977093239,86,14,-9,26,597,324,459,18,0.64
2,-1,0,2.0,-1.0,0.6866824626922607,5.4222051018559565,86,12,-8,26,597,324,459,18,3.89
3,-2,0,3.0,-2.0,0.6946134567260742,1.8166538263919687,86,9,-6,26,597,324,459,18,8.45
3,-1,0,3.0,-1.0,0.702629566192627,-1.189750324093346,86,6,-5,26,597,324,459,18,1.79
2,-1,0,2.0,-1.0,0.7106614112854004,-3.3431457505076194,86,4,-4,26,597,324,459,18,1.59
1,0,0,1.0,-0.0,0.7186505794525146,-4.0,86,3,-4,26,597,324,459,18,-0.03
2,0,0,2.0,-0.0,0.7266736030578613,-4.876894374382339,86,1,-4,26,597,324,459,18,-1.09
1,0,0,1.0,-0.0,0.7346205711364746,-5.0,86,0,-4,26,597,324,459,18,-1.06
2,0,0,2.0,-0.0,0.7426755428314209,-4.52786404500042,86,-2,-4,26,597,324,459,18,-0.89
1,0,0,1.0,-0.0,0.7506704330444336,-4.0,86,-3,-4,26,597,324,459,18,0.13
1,0,0,1.0,-0.0,0.7586305141448975,-3.3431457505076194,86,-4,-4,26,597,324,459,18,0.29
2,0,0,2.0,-0.0,0.7666316032409668,-1.7888974490720218,86,-6,-4,26,597,324,459,18,-0.33
2,0,0,2.0,-0.0,0.7746355533599854,-0.05572809000084078,86,-8,-4,26,597,324,459,18,0.24
2,0,0,2.0,-0.0,0.7826404571533203,1.7703296142690075,86,-10,-4,26,597,324,459,18,0.73
0,0,1,-0.0,-0.0,0.7867035865783691,1.7703296142690075,86,-10,-4,26,597,324,459,18,27.45
1,0,1,1.0,-0.0,0.7908365726470947,2.7046999107196257,86,-11,-4,26,597,324,459,18,11.91
1,0,1,1.0,-0.0,0.023212432861328125,1053.5623546678435,87,978,478,1016,1079,37,601,71,4.44
0,0,0,-0.0,-0.0,0.10922026634216309,1053.5623546678435,87,978,478,1016,1079,37,601,71,211.79
2,1,0,2.0,1.0,0.17525839805603027,1051.3263782123677,87,976,477,1016,1079,37,601,71,12.29
3,0,0,3.0,-0.0,0.18322348594665527,1048.6318563054522,87,973,477,1016,1079,37,601,71,9.33
3,1,0,3.0,1.0,0.19134235382080078,1045.4980333161186,87,970,476,1016,1079,37,601,71,12.12
6,1,0,6.0,1.0,0.19935250282287598,1039.672508255422,87,964,475,1016,1079,37,601,71,17.86
7,3,0,7.0,3.0,0.2072153091430664,1032.0674767792334,87,957,472,1016,1079,37,601,71,24.17
11,4,0,11.0,4.0,0.21544742584228516,1020.4335602016831,87,946,468,1016,1079,37,601,71,32.0
16,6,0,16.0,6.0,0.22324037551879883,1003.4334355171736,87,930,462,1016,1079,37,601,71,42.21
20,7,0,20.0,7.0,0.23120331764221191,982.4109297624043,87,910,455,1016,1079,37,601,71,48.36
26,8,0,26.0,8.0,0.23947834968566895,955.5882090959896,87,884,447,1016,1079,37,601,71,56.05
30,10,0,30.0,10.0,0.2472374439239502,924.3148596785104,87,854,437,1016,1079,37,601,71,61.12
34,11,0,34.0,11.0,0.25519847869873047,889.0541109696986,87,820,426,1016,1079,37,601,71,64.44
34,11,0,34.0,11.0,0.2632153034210205,853.8312550760128,87,786,415,1016,1079,37,601,71,62.84
33,11,0,33.0,11.0,0.2712094783782959,819.5320356780078,87,753,404,1016,1079,37,601,71,60.34
31,13,0,31.0,13.0,0.2792043685913086,786.075514188555,87,722,391,1016,1079,37,601,71,58.66
27,12,0,27.0,12.0,0.2871983051300049,756.6223847264553,87,695,379,1016,1079,37,601,71,53.1
26,14,0,26.0,14.0,0.29520130157470703,727.0931701570353,87,669,365,1016,1079,37,601,71,54.31
25,14,0,25.0,14.0,0.303281307220459,698.4418859050797,87,644,351,1016,1079,37,601,71,51.71
23,13,0,23.0,13.0,0.3112363815307617,672.0254592304296,87,621,338,1016,1079,37,601,71,47.82
21,14,0,21.0,14.0,0.31925034523010254,646.8914869684179,87,600,324,1016,1079,37,601,71,43.46
22,19,0,22.0,19.0,0.3272123336791992,618.5357679576535,87,578,305,1016,1079,37,601,71,44.64
20,17,0,20.0,17.0,0.3352174758911133,592.9394875304466,87,558,288,1016,1079,37,601,71,40.57
20,17,0,20.0,17.0,0.3432323932647705,567.3993691895768,87,538,271,1016,1079,37,601,71,39.36
19,17,0,19.0,17.0,0.35120439529418945,542.820906509967,87,519,254,1016,1079,37,601,71,37.09
18,16,0,18.0,16.0,0.3592243194580078,519.6575520084442,87,501,238,1016,1079,37,601,71,34.59
19,16,0,19.0,16.0,0.3672144412994385,495.6675041869438,87,482,222,1016,1079,37,601,71,34.47
19,14,0,19.0,14.0,0.3751983642578125,472.57561013114093,87,463,208,1016,1079,37,601,71,32.88
19,15,0,19.0,15.0,0.3832263946533203,449.1332461213545,87,444,193,1016,1079,37,601,71,31.89
21,14,0,21.0,14.0,0.3912312984466553,424.31470692761405,87,423,179,1016,1079,37,601,71,32.4
19,12,0,19.0,12.0,0.399247407913208,402.1555787131167,87,404,167,1016,1079,37,601,71,29.12
20,11,0,20.0,11.0,0.4072103500366211,379.47798494009305,87,384,156,1016,1079,37,601,71,29.0
19,11,0,19.0,11.0,0.4153604507446289,357.7467377331096,87,365,145,1016,1079,37,601,71,26.86
19,12,0,19.0,12.0,0.42335033416748047,335.6818042472546,87,346,133,1016,1079,37,601,71,25.65
19,10,0,19.0,10.0,0.4312252998352051,314.3680008243457,87,327,123,1016,1079,37,601,71,24.62
20,9,0,20.0,9.0,0.4393153190612793,292.48282397707516,87,307,114,1016,1079,37,601,71,24.7
21,9,0,21.0,9.0,0.44719648361206055,269.6653902234384,87,286,105,1016,1079,37,601,71,24.39
19,8,0,19.0,8.0,0.4556005001068115,249.07393403830628,87,267,97,1016,1079,37,601,71,21.88
20,8,0,20.0,8.0,0.4634582996368408,227.54523419784255,87,247,89,1016,1079,37,601,71,21.69
20,6,0,20.0,6.0,0.47126150131225586,206.69815886762564,87,227,83,1016,1079,37,601,71,19.48
17,6,0,17.0,6.0,0.47921133041381836,188.6716343213864,87,210,77,1016,1079,37,601,71,18.54
16,5,0,16.0,5.0,0.4872143268585205,171.92993983471797,87,194,72,1016,1079,37,601,71,15.49
14,5,0,14.0,5.0,0.4955284595489502,157.06509313251067,87,180,67,1016,1079,37,601,71,15.18
11,3,0,11.0,3.0,0.5032613277435303,145.71247881648904,87,169,64,1016,1079,37,601,71,10.72
9,2,0,9.0,2.0,0.5112724304199219,136.5925406304132,87,160,62,1016,1079,37,601,71,8.63
7,3,0,7.0,3.0,0.519235372543335,128.98170629676957,87,153,59,1016,1079,37,601,71,9.35
7,3,0,7.0,3.0,0.5272173881530762,121.37135287513502,87,146,56,1016,1079,37,601,71,9.08
8,2,0,8.0,2.0,0.5352084636688232,113.18906842274163,87,138,54,1016,1079,37,601,71,7.63
10,3,0,10.0,3.0,0.5432643890380859,102.78606605894515,87,128,51,1016,1079,37,601,71,8.69
9,2,0,9.0,2.0,0.5511994361877441,93.69343417595164,87,119,49,1016,1079,37,601,71,6.94
10,1,0,10.0,1.0,0.5592074394226074,84.10079764636339,87,109,48,1016,1079,37,601,71,5.91
9,1,0,9.0,1.0,0.5672464370727539,75.4943437466371,87,100,47,1016,1079,37,601,71,5.2
8,0,0,8.0,-0.0,0.5752823352813721,68.31021246711285,87,92,47,1016,1079,37,601,71,4.0
7,0,0,7.0,-0.0,0.5834503173828125,62.128780492704635,87,85,47,1016,1079,37,601,71,3.42
6,0,0,6.0,-0.0,0.5912103652954102,56.92388155425118,87,79,47,1016,1079,37,601,71,2.94
4,0,0,4.0,-0.0,0.5992114543914795,53.50988645343524,87,75,47,1016,1079,37,601,71,2.37
5,0,0,5.0,-0.0,0.6072454452514648,49.314885992925355,87,70,47,1016,1079,37,601,71,2.37
5,0,0,5.0,-0.0,0.6152703762054443,45.2122185206219,87,65,47,1016,1079,37,601,71,2.18
5,0,0,5.0,-0.0,0.6232314109802246,41.21679604916491,87,60,47,1016,1079,37,601,71,1.98
4,0,0,4.0,-0.0,0.6312112808227539,38.109506905736964,87,56,47,1016,1079,37,601,71,1.69
4,0,0,4.0,-0.0,0.6392624378204346,35.092795635500224,87,52,47,1016,1079,37,601,71,1.54
2,0,0,2.0,-0.0,0.6472363471984863,33.62215385719105,87,50,47,1016,1079,37,601,71,1.3
1,0,0,1.0,-0.0,0.6552143096923828,32.896980787071826,87,49,47,1016,1079,37,601,71,1.2
1,0,0,1.0,-0.0,0.6634852886199951,32.178865724273734,87,48,47,1016,1079,37,601,71,1.18
2,0,0,2.0,-0.0,0.6715033054351807,30.76473218982953,87,46,47,1016,1079,37,601,71,1.18
1,1,0,1.0,1.0,0.6794643402099609,29.350602172784676,87,45,46,1016,1079,37,601,71,6.21
1,0,0,1.0,-0.0,0.6872353553771973,28.655321851358195,87,44,46,1016,1079,37,601,71,1.1
1,1,0,1.0,1.0,0.6952164173126221,27.24146527838174,87,43,45,1016,1079,37,601,71,5.65
2,0,0,2.0,-0.0,0.7032172679901123,25.876925020897694,87,41,45,1016,1079,37,601,71,1.06
2,1,0,2.0,1.0,0.7112033367156982,23.7962583843564,87,39,44,1016,1079,37,601,71,2.24
4,1,0,4.0,1.0,0.7192773818969727,20.443665102516448,87,35,43,1016,1079,37,601,71,1.49
4,2,0,4.0,2.0,0.7273654937744141,16.40038910358559,87,31,41,1016,1079,37,601,71,1.94
2,2,0,2.0,2.0,0.7352023124694824,13.60041152089147,87,29,39,1016,1079,37,601,71,3.43
3,1,0,3.0,1.0,0.7432472705841064,11.04345773288535,87,26,38,1016,1079,37,601,71,1.25
0,0,1,-0.0,-0.0,0.7441854476928711,11.04345773288535,87,26,38,1016,1079,37,601,71,30.19
2,1,1,2.0,1.0,0.005402088165283203,476.2534017698446,88,145,-484,1137,558,990,1041,58,5.67
1,0,1,1.0,-0.0,0.013413190841674805,475.9673256756322,88,144,-484,1137,558,990,1041,58,1.02
1,0,1,1.0,-0.0,0.021395206451416016,475.68306886599635,88,143,-484,1137,558,990,1041,58,1.01
1,0,1,1.0,-0.0,0.02939915657043457,475.40063441673027,88,142,-484,1137,558,990,1041,58,1.01
0,0,0,-0.0,-0.0,0.14640021324157715,475.40063441673027,88,142,-484,1137,558,990,1041,58,131.05
1,0,0,1.0,-0.0,0.2056102752685547,475.12002539077935,88,141,-484,1137,558,990,1041,58,1.0
5,-6,0,5.0,-6.0,0.2133800983428955,467.9708240933264,88,136,-478,1137,558,990,1041,58,15.34
7,-10,0,7.0,-10.0,0.22139930725097656,456.45339632141827,88,129,-468,1137,558,990,1041,58,22.06
8,-12,0,8.0,-12.0,0.22939109802246094,442.7806693793208,88,121,-456,1137,558,990,1041,58,24.63
9,-14,0,9.0,-14.0,0.23746728897094727,426.96929721199433,88,112,-442,1137,558,990,1041,58,26.75
6,-13,0,6.0,-13.0,0.24539518356323242,412.901572751218,88,106,-429,1137,558,990,1041,58,24.8
4,-16,0,4.0,-16.0,0.2533841133117676,396.4092147568033,88,102,-413,1137,558,990,1041,58,30.68
3,-19,0,3.0,-19.0,0.26152729988098145,377.2474615305307,88,99,-394,1137,558,990,1041,58,29.96
0,-23,0,-0.0,-23.0,0.26938915252685547,354.9817704006272,88,99,-371,1137,558,990,1041,58,30.3
0,-28,0,-0.0,-28.0,0.27756524085998535,328.0014005574768,88,99,-343,1137,558,990,1041,58,32.39
0,-28,0,-0.0,-28.0,0.2854881286621094,301.19085390119454,88,99,-315,1137,558,990,1041,58,30.31
2,-23,0,2.0,-23.0,0.29357028007507324,278.6897788357618,88,97,-292,1137,558,990,1041,58,26.05
4,-18,0,4.0,-18.0,0.3013932704925537,260.35272592460575,88,93,-274,1137,558,990,1041,58,22.8
5,-17,0,5.0,-17.0,0.30943727493286133,242.64867016055865,88,88,-257,1137,558,990,1041,58,22.44
5,-14,0,5.0,-14.0,0.31745028495788574,227.78395588509807,88,83,-243,1137,558,990,1041,58,20.58
6,-14,0,6.0,-14.0,0.3253931999206543,212.59884105682295,88,77,-229,1137,558,990,1041,58,18.19
5,-12,0,5.0,-12.0,0.3333733081817627,199.63289352147035,88,72,-217,1137,558,990,1041,58,16.01
4,-11,0,4.0,-11.0,0.3414781093597412,187.9331694324314,88,68,-206,1137,558,990,1041,58,15.59
4,-12,0,4.0,-12.0,0.3494751453399658,175.2841158778626,88,64,-194,1137,558,990,1041,58,17.19
5,-13,0,5.0,-13.0,0.35742926597595215,161.37331745809337,88,59,-181,1137,558,990,1041,58,15.17
4,-12,0,4.0,-12.0,0.36541008949279785,148.72450590731714,88,55,-169,1137,558,990,1041,58,15.56
3,-12,0,3.0,-12.0,0.3734152317047119,136.38742394752995,88,52,-157,1137,558,990,1041,58,12.51
4,-13,0,4.0,-13.0,0.3814432621002197,122.78932768808221,88,48,-144,1137,558,990,1041,58,13.79
5,-15,0,5.0,-15.0,0.3894352912902832,106.9779393872403,88,43,-129,1137,558,990,1041,58,15.7
5,-11,0,5.0,-11.0,0.39739322662353516,94.96773773849388,88,38,-118,1137,558,990,1041,58,9.62
4,-10,0,4.0,-10.0,0.4053921699523926,84.22543883774529,88,34,-108,1137,558,990,1041,58,9.1
5,-10,0,5.0,-10.0,0.41355109214782715,73.20078277586722,88,29,-98,1137,558,990,1041,58,7.5
4,-10,0,4.0,-10.0,0.4213862419128418,62.48223871331527,88,25,-88,1137,558,990,1041,58,7.55
3,-8,0,3.0,-8.0,0.4293861389160156,53.969874050766165,88,22,-80,1137,558,990,1041,58,6.66
2,-6,0,2.0,-6.0,0.4373931884765625,47.6550715869472,88,20,-74,1137,558,990,1041,58,6.35
2,-6,0,2.0,-6.0,0.44539308547973633,41.3420215802759,88,18,-68,1137,558,990,1041,58,6.01
1,-5,0,1.0,-5.0,0.45424509048461914,36.25335240430181,88,17,-63,1137,558,990,1041,58,5.5
0,-5,0,-0.0,-5.0,0.46141719818115234,31.440052945046304,88,17,-58,1137,558,990,1041,58,3.33
1,-8,0,1.0,-8.0,0.4693892002105713,23.49761899362675,88,16,-50,1137,558,990,1041,58,4.13
2,-7,0,2.0,-7.0,0.47739315032958984,16.221676218380054,88,14,-43,1137,558,990,1041,58,5.82
1,-7,0,1.0,-7.0,0.48538827896118164,9.275318418009277,88,13,-36,1137,558,990,1041,58,3.17
2,-5,0,2.0,-5.0,0.49339723587036133,3.893768406797051,88,11,-31,1137,558,990,1041,58,5.0
1,-4,0,1.0,-4.0,0.5014011859893799,-0.20763990222406292,88,10,-27,1137,558,990,1041,58,3.47
1,-4,0,1.0,-4.0,0.5093941688537598,-4.301821929543063,88,9,-23,1137,558,990,1041,58,3.09
1,-2,0,1.0,-2.0,0.5173852443695068,-6.527794945755769,88,8,-21,1137,558,990,1041,58,3.45
0,-2,0,-0.0,-2.0,0.5254592895507812,-8.384471871911696,88,8,-19,1137,558,990,1041,58,1.51
0,0,1,-0.0,-0.0,0.5793862342834473,-8.384471871911696,88,8,-19,1137,558,990,1041,58,24.55
0,0,0,-0.0,-0.0,0.09095335006713867,1203.8120185323519,89,-1116,-454,13,123,1129,577,3,228.09
-1,1,0,-1.0,1.0,0.1509413719177246,1203.2632602549993,89,-1115,-455,13,123,1129,577,3,34.77
-4,4,0,-4.0,4.0,0.15894436836242676,1201.0823599071737,89,-1111,-459,13,123,1129,577,3,93.6
-4,5,0,-4.0,5.0,0.16693949699401855,1199.3103765276712,89,-1107,-464,13,123,1129,577,3,82.42
-3,6,0,-3.0,6.0,0.1749415397644043,1198.8816608316006,89,-1104,-470,13,123,1129,577,3,27.77
-2,5,0,-2.0,5.0,0.18292951583862305,1199.0120832724976,89,-1102,-475,13,123,1129,577,3,158.92
-1,4,0,-1.0,4.0,0.19093847274780273,1199.6839717427729,89,-1101,-479,13,123,1129,577,3,73.55
-1,2,0,-1.0,2.0,0.1989424228668213,1199.5669494034892,89,-1100,-481,13,123,1129,577,3,8.46
-1,1,0,-1.0,1.0,0.214949369430542,1199.0520822031017,89,-1099,-482,13,123,1129,577,3,32.87
-1,1,0,-1.0,1.0,0.2311534881591797,1198.5386613194257,89,-1098,-483,13,123,1129,577,3,32.79
-2,1,0,-2.0,1.0,0.23899340629577637,1197.1118478673015,89,-1096,-484,13,123,1129,577,3,72.09
-4,2,0,-4.0,2.0,0.24695253372192383,1194.2656608469936,89,-1092,-486,13,123,1129,577,3,108.24
-7,2,0,-7.0,2.0,0.2549424171447754,1188.6928174953398,89,-1085,-488,13,123,1129,577,3,144.13
-11,4,0,-11.0,4.0,0.2629413604736328,1180.32975921205,89,-1074,-492,13,123,1129,577,3,162.19
-15,3,0,-15.0,3.0,0.2709343433380127,1167.976475383487,89,-1059,-495,13,123,1129,577,3,176.42
-20,2,0,-20.0,2.0,0.27895045280456543,1150.7508411110452,89,-1039,-497,13,123,1129,577,3,185.27
-23,0,0,-23.0,-0.0,0.28698134422302246,1130.0459760770116,89,-1016,-497,13,123,1129,577,3,188.24
-26,0,0,-26.0,-0.0,0.2949495315551758,1106.7495204241795,89,-990,-497,13,123,1129,577,3,188.59
-28,-4,0,-28.0,-4.0,0.30293750762939453,1079.9685471834969,89,-962,-493,13,123,1129,577,3,189.19
-27,-7,0,-27.0,-7.0,0.3109934329986572,1052.7651541021842,89,-935,-486,13,123,1129,577,3,187.25
-29,-10,0,-29.0,-10.0,0.3189425468444824,1022.4314828067387,89,-906,-476,13,123,1129,577,3,186.51
-32,-12,0,-32.0,-12.0,0.32695937156677246,988.5312021356376,89,-874,-464,13,123,1129,577,3,184.8
-32,-13,0,-32.0,-13.0,0.3349423408508301,954.1779938838624,89,-842,-451,13,123,1129,577,3,181.48
-32,-13,0,-32.0,-13.0,0.34314846992492676,919.8387480987103,89,-810,-438,13,123,1129,577,3,177.58
-35,-15,0,-35.0,-15.0,0.3509664535522461,881.9235527496138,89,-775,-423,13,123,1129,577,3,174.68
-37,-16,0,-37.0,-16.0,0.3589503765106201,841.7888228969342,89,-738,-407,13,123,1129,577,3,170.55
-38,-17,0,-38.0,-17.0,0.3669455051422119,800.3114251026251,89,-700,-390,13,123,1129,577,3,165.92
-39,-18,0,-39.0,-18.0,0.37495851516723633,757.4886287875382,89,-661,-372,13,123,1129,577,3,160.91
-36,-16,0,-36.0,-16.0,0.3832235336303711,718.2781103300725,89,-625,-356,13,123,1129,577,3,154.61
-34,-16,0,-34.0,-16.0,0.3909413814544678,680.821824232695,89,-591,-340,13,123,1129,577,3,149.35
-32,-17,0,-32.0,-17.0,0.3989384174346924,644.6082403439411,89,-559,-323,13,123,1129,577,3,144.99
-29,-14,0,-29.0,-14.0,0.4069705009460449,612.4989812542478,89,-530,-309,13,123,1129,577,3,138.24
-25,-15,0,-25.0,-15.0,0.4149463176727295,583.3466436970439,89,-505,-294,13,123,1129,577,3,134.78
-21,-13,0,-21.0,-13.0,0.4231894016265869,558.657931240146,89,-484,-281,13,123,1129,577,3,128.45
-19,-13,0,-19.0,-13.0,0.43099045753479004,535.7019657128153,89,-465,-268,13,123,1129,577,3,122.99
-15,-10,0,-15.0,-10.0,0.438948392868042,517.7137939172237,89,-450,-258,13,123,1129,577,3,116.94
-13,-11,0,-13.0,-11.0,0.44707536697387695,500.97410291767045,89,-437,-247,13,123,1129,577,3,112.02
-12,-10,0,-12.0,-10.0,0.45508742332458496,485.6148374227814,89,-425,-237,13,123,1129,577,3,108.35
-12,-11,0,-12.0,-11.0,0.46296048164367676,469.791886081313,89,-413,-226,13,123,1129,577,3,106.14
-11,-10,0,-11.0,-10.0,0.47097134590148926,455.3551248753541,89,-402,-216,13,123,1129,577,3,102.44
-11,-9,0,-11.0,-9.0,0.4789543151855469,441.4138334184409,89,-391,-207,13,123,1129,577,3,100.03
-11,-10,0,-11.0,-10.0,0.48694634437561035,427.02920461108727,89,-380,-197,13,123,1129,577,3,97.99
-11,-9,0,-11.0,-9.0,0.4949965476989746,413.13162158907886,89,-369,-188,13,123,1129,577,3,95.53
-10,-9,0,-10.0,-9.0,0.5030105113983154,400.15084444632544,89,-359,-179,13,123,1129,577,3,92.07
-13,-11,0,-13.0,-11.0,0.511028528213501,383.6296920415791,89,-346,-168,13,123,1129,577,3,93.15
-12,-10,0,-12.0,-10.0,0.5192835330963135,368.4861296449435,89,-334,-158,13,123,1129,577,3,89.41
-13,-11,0,-13.0,-11.0,0.5269834995269775,352.0580688781946,89,-321,-147,13,123,1129,577,3,87.61
-13,-10,0,-13.0,-10.0,0.5350165367126465,336.0949421157191,89,-308,-137,13,123,1129,577,3,84.67
-14,-9,0,-14.0,-9.0,0.5429575443267822,319.6555784638714,89,-294,-128,13,123,1129,577,3,82.65
-16,-8,0,-16.0,-8.0,0.5509405136108398,301.7936591145858,89,-278,-120,13,123,1129,577,3,81.67
-16,-7,0,-16.0,-7.0,0.5589413642883301,284.3296339324046,89,-262,-113,13,123,1129,577,3,80.17
-16,-7,0,-16.0,-7.0,0.566941499710083,266.8656379605268,89,-246,-106,13,123,1129,577,3,76.81
-14,-7,0,-14.0,-7.0,0.575202465057373,251.23996511258878,89,-232,-99,13,123,1129,577,3,70.55
-12,-7,0,-12.0,-7.0,0.5829644203186035,237.46173697262208,89,-220,-92,13,123,1129,577,3,65.53
-13,-8,0,-13.0,-8.0,0.5909814834594727,222.3942702935776,89,-207,-84,13,123,1129,577,3,63.14
-12,-8,0,-12.0,-8.0,0.5989375114440918,208.2868844433401,89,-195,-76,13,123,1129,577,3,59.28
-11,-7,0,-11.0,-7.0,0.6069505214691162,195.51208614230322,89,-184,-69,13,123,1129,577,3,55.76
-11,-6,0,-11.0,-6.0,0.6149353981018066,183.1140950606444,89,-173,-63,13,123,1129,577,3,53.37
-7,-5,0,-7.0,-5.0,0.6229524612426758,174.84083712266613,89,-166,-58,13,123,1129,577,3,46.61
-7,-3,0,-7.0,-3.0,0.630934476852417,167.24387061643583,89,-159,-55,13,123,1129,577,3,46.0
-7,-3,0,-7.0,-3.0,0.638986349105835,159.64868502418562,89,-152,-52,13,123,1129,577,3,44.5
-7,-3,0,-7.0,-3.0,0.6473095417022705,152.05554547287727,89,-145,-49,13,123,1129,577,3,42.98
-9,-3,0,-9.0,-3.0,0.654963493347168,142.5687988387449,89,-136,-46,13,123,1129,577,3,45.81
-9,-3,0,-9.0,-3.0,0.6629593372344971,133.08206442324789,89,-127,-43,13,123,1129,577,3,43.81
-11,-4,0,-11.0,-4.0,0.6710164546966553,121.38055401083949,89,-116,-39,13,123,1129,577,3,41.73
-11,-4,0,-11.0,-4.0,0.6789934635162354,109.67971810589327,89,-105,-35,13,123,1129,577,3,38.96
-9,-3,0,-9.0,-3.0,0.6869523525238037,100.19288512538814,89,-96,-32,13,123,1129,577,3,37.3
-6,-3,0,-6.0,-3.0,0.6949403285980225,93.5568612000208,89,-90,-29,13,123,1129,577,3,29.21
-7,-2,0,-7.0,-2.0,0.7029874324798584,86.28115489611719,89,-83,-27,13,123,1129,577,3,30.17
-4,-1,0,-4.0,-1.0,0.7109324932098389,82.16850365372699,89,-79,-26,13,123,1129,577,3,24.13
-4,-1,0,-4.0,-1.0,0.7191543579101562,78.05694150420949,89,-75,-25,13,123,1129,577,3,23.35
-3,-1,0,-3.0,-1.0,0.7269434928894043,74.8946638440411,89,-72,-24,13,123,1129,577,3,23.54
-3,0,0,-3.0,-0.0,0.7351334095001221,72.05477397131553,89,-69,-24,13,123,1129,577,3,17.5
-4,-1,0,-4.0,-1.0,0.742964506149292,67.9492567037528,89,-65,-23,13,123,1129,577,3,21.27
-5,0,0,-5.0,-0.0,0.7509415149688721,63.25729530566937,89,-60,-23,13,123,1129,577,3,19.46
-2,-1,0,-2.0,-1.0,0.7589564323425293,61.03224967708329,89,-58,-22,13,123,1129,577,3,15.79
-3,0,0,-3.0,-0.0,0.7669525146484375,58.23681287847955,89,-55,-22,13,123,1129,577,3,15.11
-2,-1,0,-2.0,-1.0,0.7749414443969727,56.0087712549569,89,-53,-21,13,123,1129,577,3,15.33
-2,0,0,-2.0,-0.0,0.7829623222351074,54.154328932550705,89,-51,-21,13,123,1129,577,3,11.92
-1,-1,0,-1.0,-1.0,0.7911224365234375,52.85164807134504,89,-50,-20,13,123,1129,577,3,9.73
-1,0,0,-1.0,-0.0,0.7989413738250732,51.92447448959697,89,-49,-20,13,123,1129,577,3,8.04
-1,0,0,-1.0,-0.0,0.8069443702697754,51.0,89,-48,-20,13,123,1129,577,3,7.93
-1,0,0,-1.0,-0.0,0.8149595260620117,50.07837115648854,89,-47,-20,13,123,1129,577,3,7.82
-2,0,0,-2.0,-0.0,0.8229854106903076,48.24428900898052,89,-45,-20,13,123,1129,577,3,11.04
-2,-1,0,-2.0,-1.0,0.8309423923492432,46.01063709417264,89,-43,-19,13,123,1129,577,3,14.7
-3,0,0,-3.0,-0.0,0.8389394283294678,43.28317965096906,89,-40,-19,13,123,1129,577,3,12.43
-2,-1,0,-2.0,-1.0,0.8469593524932861,41.04759208325728,89,-38,-18,13,123,1129,577,3,14.86
-3,0,0,-3.0,-0.0,0.8551723957061768,38.35733730830886,89,-35,-18,13,123,1129,577,3,11.49
-3,-1,0,-3.0,-1.0,0.8629453182220459,35.235341863986875,89,-32,-17,13,123,1129,577,3,13.19
-2,0,0,-2.0,-0.0,0.8709404468536377,33.48187929913333,89,-30,-17,13,123,1129,577,3,8.68
-3,0,0,-3.0,-0.0,0.8793854713439941,30.906112267087632,89,-27,-17,13,123,1129,577,3,9.86
-2,-1,0,-2.0,-1.0,0.886946439743042,28.68164415931166,89,-25,-16,13,123,1129,577,3,11.25
-2,0,0,-2.0,-0.0,0.8949873447418213,27.0178514522438,89,-23,-16,13,123,1129,577,3,7.41
-2,0,0,-2.0,-0.0,0.902949333190918,25.40075756488817,89,-21,-16,13,123,1129,577,3,6.99
-2,-1,0,-2.0,-1.0,0.9109494686126709,23.20743687382041,89,-19,-15,13,123,1129,577,3,9.49
-1,0,0,-1.0,-0.0,0.9190664291381836,22.430749027719962,89,-18,-15,13,123,1129,577,3,4.37
-1,0,0,-1.0,-0.0,0.9270403385162354,21.67156809750927,89,-17,-15,13,123,1129,577,3,4.2
-1,0,0,-1.0,-0.0,0.9349625110626221,20.93171219946131,89,-16,-15,13,123,1129,577,3,4.02
-1,0,0,-1.0,-0.0,0.9509563446044922,20.213203435596427,89,-15,-15,13,123,1129,577,3,3.83
-1,0,0,-1.0,-0.0,0.9669363498687744,19.518284528683193,89,-14,-15,13,123,1129,577,3,3.63
-1,-1,0,-1.0,-1.0,0.9829504489898682,18.1049731745428,89,-13,-14,13,123,1129,577,3,9.52
-2,0,0,-2.0,-0.0,0.9910604953765869,16.804493814764857,89,-11,-14,13,123,1129,577,3,4.69
-1,-1,0,-1.0,-1.0,0.9989414215087891,15.401219466856727,89,-10,-13,13,123,1129,577,3,7.6
-1,0,0,-1.0,-0.0,1.006948471069336,14.811388300841896,89,-9,-13,13,123,1129,577,3,2.7
-2,0,0,-2.0,-0.0,1.014953374862671,13.7648230602334,89,-7,-13,13,123,1129,577,3,3.45
-2,-1,0,-2.0,-1.0,1.0230004787445068,12.0,89,-5,-12,13,123,1129,577,3,5.23
-3,0,0,-3.0,-0.0,1.0309455394744873,11.165525060596439,89,-2,-12,13,123,1129,577,3,1.96
-2,-1,0,-2.0,-1.0,1.0389513969421387,10.0,89,0,-11,13,123,1129,577,3,3.12
-2,0,0,-2.0,-0.0,1.0469424724578857,10.180339887498949,89,2,-11,13,123,1129,577,3,7.67
-2,-1,0,-2.0,-1.0,1.0550663471221924,9.770329614269007,89,4,-10,13,123,1129,577,3,0.66
-1,0,0,-1.0,-0.0,1.0629584789276123,10.180339887498949,89,5,-10,13,123,1129,577,3,5.74
0,-1,0,-0.0,-1.0,1.0950334072113037,9.295630140987,89,5,-9,13,123,1129,577,3,3.9
0,-1,0,-0.0,-1.0,1.1109414100646973,8.433981132056603,89,5,-8,13,123,1129,577,3,3.6
-1,0,0,-1.0,-0.0,1.1190104484558105,9.0,89,6,-8,13,123,1129,577,3,4.69
0,-1,0,-0.0,-1.0,1.1269395351409912,8.219544457292887,89,6,-7,13,123,1129,577,3,3.03
0,-1,0,-0.0,-1.0,1.143026351928711,7.4852813742385695,89,6,-6,13,123,1129,577,3,2.68
-1,0,0,-1.0,-0.0,1.1509435176849365,8.219544457292887,89,7,-6,13,123,1129,577,3,4.12
0,-1,0,-0.0,-1.0,1.166940450668335,7.602325267042627,89,7,-5,13,123,1129,577,3,2.12
3,0,0,3.0,-0.0,1.2549984455108643,5.4031242374328485,89,4,-5,13,123,1129,577,3,4.06
4,0,0,4.0,-0.0,1.2629845142364502,4.0,89,0,-5,13,123,1129,577,3,1.52
2,0,0,2.0,-0.0,1.2710695266723633,4.385164807134504,89,-2,-5,13,123,1129,577,3,3.74
1,0,0,1.0,-0.0,1.2869443893432617,4.830951894845301,89,-3,-5,13,123,1129,577,3,4.32
0,-1,0,-0.0,-1.0,1.2949473857879639,4.0,89,-3,-4,13,123,1129,577,3,2.62
0,0,1,-0.0,-0.0,1.4139623641967773,4.0,89,-3,-4,13,123,1129,577,3,18.1
0,0,0,-0.0,-0.0,1.5309514999389648,4.0,89,-3,-4,13,123,1129,577,3,18.1
-1,0,0,-1.0,-0.0,1.5749595165252686,3.4721359549995796,89,-2,-4,13,123,1129,577,3,1.04
-1,0,0,-1.0,-0.0,1.590991497039795,3.1231056256176606,89,-1,-4,13,123,1129,577,3,0.24
0,-1,0,-0.0,-1.0,1.6871073246002197,2.1622776601683795,89,-1,-3,13,123,1129,577,3,3.41
0,0,1,-0.0,-0.0,1.803950548171997,2.1622776601683795,89,-1,-3,13,123,1129,577,3,27.56
0,0,0,-0.0,-0.0,2.023951530456543,2.1622776601683795,89,-1,-3,13,123,1129,577,3,17.56
-1,0,0,-1.0,-0.0,2.0551843643188477,2.0,89,0,-3,13,123,1129,577,3,-0.8
0,0,1,-0.0,-0.0,2.1919734477996826,2.0,89,0,-3,13,123,1129,577,3,27.51
0,0,0,-0.0,-0.0,0.12373208999633789,1479.2908016848662,90,1387,556,1400,682,13,126,30,254.86
3,2,0,3.0,2.0,0.2817370891571045,1475.7622211472894,90,1384,554,1400,682,13,126,30,29.02
6,5,0,6.0,5.0,0.2897322177886963,1468.3357677882645,90,1378,549,1400,682,13,126,30,51.38
8,8,0,8.0,8.0,0.2977170944213867,1457.9497615329587,90,1370,541,1400,682,13,126,30,65.27
9,9,0,9.0,9.0,0.3057842254638672,1446.2819714209847,90,1361,532,1400,682,13,126,30,70.58
10,11,0,10.0,11.0,0.31373023986816406,1432.9785910019527,90,1351,521,1400,682,13,126,30,76.68
13,13,0,13.0,13.0,0.3217141628265381,1416.1911123256739,90,1338,508,1400,682,13,126,30,88.81
21,18,0,21.0,18.0,0.32991623878479004,1390.2006974094484,90,1317,490,1400,682,13,126,30,113.4
25,19,0,25.0,19.0,0.3378641605377197,1360.1745343773641,90,1292,471,1400,682,13,126,30,120.8
31,20,0,31.0,20.0,0.34572720527648926,1324.224402406109,90,1261,451,1400,682,13,126,30,129.86
37,23,0,37.0,23.0,0.3537251949310303,1281.6726649389968,90,1224,428,1400,682,13,126,30,137.07
40,21,0,40.0,21.0,0.36171913146972656,1237.0003993609587,90,1184,407,1400,682,13,126,30,137.53
44,21,0,44.0,21.0,0.36973118782043457,1188.5763374211044,90,1140,386,1400,682,13,126,30,139.05
47,20,0,47.0,20.0,0.37778210639953613,1137.6512915882236,90,1093,366,1400,682,13,126,30,138.72
45,17,0,45.0,17.0,0.38582515716552734,1089.583631962741,90,1048,349,1400,682,13,126,30,133.39
43,14,0,43.0,14.0,0.3937201499938965,1044.3630161564072,90,1005,335,1400,682,13,126,30,128.71
39,12,0,39.0,12.0,0.40172719955444336,1003.5700761361488,90,966,323,1400,682,13,126,30,120.02
35,9,0,35.0,9.0,0.4097721576690674,967.5258266325624,90,931,314,1400,682,13,126,30,110.43
29,8,0,29.0,8.0,0.4177432060241699,937.4914697780763,90,902,306,1400,682,13,126,30,100.08
25,6,0,25.0,6.0,0.42572808265686035,911.8921188574213,90,877,300,1400,682,13,126,30,90.44
22,6,0,22.0,6.0,0.43384313583374023,889.1354986947476,90,855,294,1400,682,13,126,30,84.21
19,5,0,19.0,5.0,0.44173526763916016,869.543385029813,90,836,289,1400,682,13,126,30,76.35
17,4,0,17.0,4.0,0.44974708557128906,852.1712633615116,90,819,285,1400,682,13,126,30,69.97
17,4,0,17.0,4.0,0.457719087600708,834.8029183287147,90,802,281,1400,682,13,126,30,69.1
17,3,0,17.0,3.0,0.46578121185302734,817.7718775270932,90,785,278,1400,682,13,126,30,66.9
18,3,0,18.0,3.0,0.4739673137664795,799.8091801151973,90,767,275,1400,682,13,126,30,68.08
19,3,0,19.0,3.0,0.4820432662963867,780.9195939289345,90,748,272,1400,682,13,126,30,69.05
21,4,0,21.0,4.0,0.48975610733032227,759.8244962570557,90,727,268,1400,682,13,126,30,72.57
24,3,0,24.0,3.0,0.49773621559143066,736.2882269808306,90,703,265,1400,682,13,126,30,75.12
24,4,0,24.0,4.0,0.505730152130127,712.4352204835836,90,679,261,1400,682,13,126,30,74.37
24,5,0,24.0,5.0,0.5138041973114014,688.2503110557435,90,655,256,1400,682,13,126,30,73.61
25,5,0,25.0,5.0,0.5217432975769043,663.1600106169635,90,630,251,1400,682,13,126,30,73.24
23,6,0,23.0,6.0,0.5298862457275391,639.5792541778268,90,607,245,1400,682,13,126,30,69.78
23,6,0,23.0,6.0,0.5377111434936523,616.0126781610652,90,584,239,1400,682,13,126,30,68.11
26,6,0,26.0,6.0,0.5457162857055664,589.6924838295909,90,558,233,1400,682,13,126,30,69.86
25,8,0,25.0,8.0,0.5537271499633789,563.5447260151975,90,533,225,1400,682,13,126,30,68.49
26,7,0,26.0,7.0,0.5617291927337646,536.881327823292,90,507,218,1400,682,13,126,30,66.48
26,8,0,26.0,8.0,0.569716215133667,509.8437862831187,90,481,210,1400,682,13,126,30,65.08
23,7,0,23.0,7.0,0.5777242183685303,485.97205510886533,90,458,203,1400,682,13,126,30,59.15
22,8,0,22.0,8.0,0.5857632160186768,462.6201419538334,90,436,195,1400,682,13,126,30,57.33
20,7,0,20.0,7.0,0.5938472747802734,441.50848842053307,90,416,188,1400,682,13,126,30,52.51
16,7,0,16.0,7.0,0.6017911434173584,424.04555572286574,90,400,181,1400,682,13,126,30,48.01
14,6,0,14.0,6.0,0.6097393035888672,408.8171775659878,90,386,175,1400,682,13,126,30,43.07
13,7,0,13.0,7.0,0.6177232265472412,394.0880100907383,90,373,168,1400,682,13,126,30,40.01
12,6,0,12.0,6.0,0.6257290840148926,380.6829538911172,90,361,162,1400,682,13,126,30,37.59
10,6,0,10.0,6.0,0.634000301361084,369.1054542700481,90,351,156,1400,682,13,126,30,32.45
11,7,0,11.0,7.0,0.6417281627655029,356.21557079411417,90,340,149,1400,682,13,126,30,33.64
11,8,0,11.0,8.0,0.6497132778167725,342.9413359756037,90,329,141,1400,682,13,126,30,32.92
13,7,0,13.0,7.0,0.657731294631958,328.237527085836,90,316,134,1400,682,13,126,30,35.24
13,7,0,13.0,7.0,0.6657171249389648,313.5391909650963,90,303,127,1400,682,13,126,30,34.14
15,9,0,15.0,9.0,0.6737642288208008,296.2362446759696,90,288,118,1400,682,13,126,30,35.56
15,7,0,15.0,7.0,0.6817193031311035,279.7032405658275,90,273,111,1400,682,13,126,30,34.72
15,7,0,15.0,7.0,0.6897273063659668,263.1726082848561,90,258,104,1400,682,13,126,30,33.31
17,7,0,17.0,7.0,0.6978332996368408,244.78837541352772,90,241,97,1400,682,13,126,30,35.43
17,7,0,17.0,7.0,0.7057693004608154,226.40422531513403,90,224,90,1400,682,13,126,30,33.72
14,6,0,14.0,6.0,0.7137062549591064,211.17692189964916,90,210,84,1400,682,13,126,30,28.48
16,6,0,16.0,6.0,0.7217261791229248,194.093280618962,90,194,78,1400,682,13,126,30,28.74
13,5,0,13.0,5.0,0.7297301292419434,180.1665955024066,90,181,73,1400,682,13,126,30,25.01
10,4,0,10.0,4.0,0.7378592491149902,169.39631232755173,90,171,69,1400,682,13,126,30,21.98
8,5,0,8.0,5.0,0.7457733154296875,160.1142484208524,90,163,64,1400,682,13,126,30,16.04
7,4,0,7.0,4.0,0.7537331581115723,152.14065932620943,90,156,60,1400,682,13,126,30,14.41
5,3,0,5.0,3.0,0.7617201805114746,146.40012391568973,90,151,57,1400,682,13,126,30,11.33
5,3,0,5.0,3.0,0.7698132991790771,140.66630977832037,90,146,54,1400,682,13,126,30,11.02
4,3,0,4.0,3.0,0.7778151035308838,135.88074761214565,90,142,51,1400,682,13,126,30,9.05
6,2,0,6.0,2.0,0.785743236541748,129.55794685869054,90,136,49,1400,682,13,126,30,13.57
7,3,0,7.0,3.0,0.7937071323394775,121.95619737711763,90,129,46,1400,682,13,126,30,13.4
7,3,0,7.0,3.0,0.801734209060669,114.3560976529518,90,122,43,1400,682,13,126,30,12.88
7,2,0,7.0,2.0,0.8097562789916992,107.09013064126027,90,115,41,1400,682,13,126,30,12.19
5,2,0,5.0,2.0,0.8180522918701172,101.70903992407786,90,110,39,1400,682,13,126,30,10.78
5,1,0,5.0,1.0,0.8258981704711914,96.66467659918243,90,105,38,1400,682,13,126,30,8.61
5,1,0,5.0,1.0,0.8338842391967773,91.6255128944288,90,100,37,1400,682,13,126,30,8.32
4,2,0,4.0,2.0,0.8419671058654785,87.18121158021175,90,96,35,1400,682,13,126,30,8.04
4,1,0,4.0,1.0,0.8497591018676758,83.08159868191383,90,92,34,1400,682,13,126,30,7.65
2,1,0,2.0,1.0,0.8577122688293457,80.85927185202274,90,90,33,1400,682,13,126,30,5.91
3,1,0,3.0,1.0,0.8657381534576416,77.69843580125827,90,87,32,1400,682,13,126,30,8.15
2,2,0,2.0,2.0,0.8737461566925049,75.13878188659973,90,85,30,1400,682,13,126,30,4.18
1,0,0,1.0,-0.0,0.8819732666015625,74.19641248391103,90,84,30,1400,682,13,126,30,3.14
2,1,0,2.0,1.0,0.8898341655731201,71.97700845625813,90,82,29,1400,682,13,126,30,5.58
1,1,0,1.0,1.0,0.8977291584014893,70.70297544426332,90,81,28,1400,682,13,126,30,3.0
2,0,0,2.0,-0.0,0.9057331085205078,68.81527307120105,90,79,28,1400,682,13,126,30,3.87
2,0,0,2.0,-0.0,0.9217891693115234,66.93289937503738,90,77,28,1400,682,13,126,30,3.79
0,1,0,-0.0,1.0,0.9297151565551758,66.59656855530139,90,77,27,1400,682,13,126,30,0.7
1,0,0,1.0,-0.0,0.9377312660217285,65.65358020571685,90,76,27,1400,682,13,126,30,3.06
2,0,0,2.0,-0.0,0.9457612037658691,63.77182237323191,90,74,27,1400,682,13,126,30,3.72
1,1,0,1.0,1.0,0.9537351131439209,62.491935064237495,90,73,26,1400,682,13,126,30,2.91
2,0,0,2.0,-0.0,0.9617602825164795,60.61084578286372,90,71,26,1400,682,13,126,30,3.65
2,1,0,2.0,1.0,0.9698452949523926,58.38937252763509,90,69,25,1400,682,13,126,30,5.34
2,1,0,2.0,1.0,0.9777212142944336,56.16881339463234,90,67,24,1400,682,13,126,30,5.24
2,0,0,2.0,-0.0,0.9861712455749512,54.289248805280025,90,65,24,1400,682,13,126,30,3.5
2,1,0,2.0,1.0,0.9937222003936768,52.067130548428864,90,63,23,1400,682,13,126,30,5.21
2,1,0,2.0,1.0,1.0017282962799072,49.8459713474939,90,61,22,1400,682,13,126,30,5.11
3,2,0,3.0,2.0,1.0097222328186035,46.35144660071187,90,58,20,1400,682,13,126,30,4.66
3,1,0,3.0,1.0,1.0177252292633057,43.18934610390462,90,55,19,1400,682,13,126,30,7.94
3,2,0,3.0,2.0,1.0258193016052246,39.70831746635972,90,52,17,1400,682,13,126,30,4.31
3,2,0,3.0,2.0,1.0340023040771484,36.24451190127583,90,49,15,1400,682,13,126,30,4.06
4,2,0,4.0,2.0,1.0417242050170898,31.840153714521477,90,45,13,1400,682,13,126,30,4.89
4,2,0,4.0,2.0,1.0497701168060303,27.449970553582247,90,41,11,1400,682,13,126,30,4.52
3,3,0,3.0,3.0,1.057725191116333,23.8329756778952,90,38,8,1400,682,13,126,30,2.56
3,2,0,3.0,2.0,1.065796136856079,20.510561809129406,90,35,6,1400,682,13,126,30,2.81
3,3,0,3.0,3.0,1.0737032890319824,17.140317359976393,90,32,3,1400,682,13,126,30,1.88
3,2,0,3.0,2.0,1.081714153289795,14.017236257093817,90,29,1,1400,682,13,126,30,2.03
1,1,0,1.0,1.0,1.0897412300109863,13.0,90,28,0,1400,682,13,126,30,1.11
3,1,0,3.0,1.0,1.0977222919464111,10.019992006393608,90,25,-1,1400,682,13,126,30,2.44
1,1,0,1.0,1.0,1.1057500839233398,9.083189157584592,90,24,-2,1400,682,13,126,30,0.85
2,1,0,2.0,1.0,1.1137182712554932,7.203603311174518,90,22,-3,1400,682,13,126,30,1.41
1,0,0,1.0,-0.0,1.121847152709961,6.2132034355964265,90,21,-3,1400,682,13,126,30,3.4
1,1,0,1.0,1.0,1.1297292709350586,5.396078054371138,90,20,-4,1400,682,13,126,30,0.53
1,1,0,1.0,1.0,1.137742280960083,4.646882704388499,90,19,-5,1400,682,13,126,30,0.41
1,0,0,1.0,-0.0,1.1457343101501465,3.6815416922694055,90,18,-5,1400,682,13,126,30,2.44
1,0,0,1.0,-0.0,1.1537272930145264,2.7200451466693494,90,17,-5,1400,682,13,126,30,2.33
0,0,1,-0.0,-0.0,1.1657302379608154,2.7200451466693494,90,17,-5,1400,682,13,126,30,27.73
1,1,1,1.0,1.0,0.0007371902465820312,597.8427924848319,91,-593,-221,791,467,1383,687,70,3.53
0,0,0,-0.0,-0.0,0.10779500007629395,597.8427924848319,91,-593,-221,791,467,1383,687,70,151.42
-2,0,0,-2.0,-0.0,0.15275216102600098,595.9690959151644,91,-591,-221,791,467,1383,687,70,5.95
-1,0,0,-1.0,-0.0,0.1607811450958252,595.032538842241,91,-590,-221,791,467,1383,687,70,4.1
-1,1,0,-1.0,1.0,0.16881299018859863,594.4481710196638,91,-589,-222,791,467,1383,687,70,1.76
-1,0,0,-1.0,-0.0,0.18476605415344238,593.5125297080401,91,-588,-222,791,467,1383,687,70,4.09
-1,0,0,-1.0,-0.0,0.19280505180358887,592.5770868984941,91,-587,-222,791,467,1383,687,70,4.08
-3,0,0,-3.0,-0.0,0.20073699951171875,589.771958397622,91,-584,-222,791,467,1383,687,70,7.67
-6,0,0,-6.0,-0.0,0.20875811576843262,584.1671825928761,91,-578,-222,791,467,1383,687,70,12.64
-6,-1,0,-6.0,-1.0,0.2168130874633789,578.2087735836792,91,-572,-221,791,467,1383,687,70,13.98
-8,-3,0,-8.0,-3.0,0.2248401641845703,569.6651966171031,91,-564,-218,791,467,1383,687,70,21.18
-10,-5,0,-10.0,-5.0,0.23290014266967773,558.5360140715978,91,-554,-213,791,467,1383,687,70,22.74
-11,-5,0,-11.0,-5.0,0.24076509475708008,546.4748489831696,91,-543,-208,791,467,1383,687,70,24.35
-11,-8,0,-11.0,-8.0,0.24875617027282715,533.3520036034007,91,-532,-200,791,467,1383,687,70,23.56
-13,-8,0,-13.0,-8.0,0.2568471431732178,518.3760023709015,91,-519,-192,791,467,1383,687,70,25.97
-16,-10,0,-16.0,-10.0,0.2647590637207031,499.914011781333,91,-503,-182,791,467,1383,687,70,29.43
-24,-14,0,-24.0,-14.0,0.2727351188659668,472.6071315495873,91,-479,-168,791,467,1383,687,70,37.33
-32,-15,0,-32.0,-15.0,0.2807769775390625,437.4595220757012,91,-447,-153,791,467,1383,687,70,42.47
-34,-15,0,-34.0,-15.0,0.28876805305480957,400.44574863006756,91,-413,-138,791,467,1383,687,70,41.57
-36,-14,0,-36.0,-14.0,0.29676198959350586,361.86899601757756,91,-377,-124,791,467,1383,687,70,40.57
-39,-14,0,-39.0,-14.0,0.30498814582824707,320.4490118146343,91,-338,-110,791,467,1383,687,70,39.69
-37,-11,0,-37.0,-11.0,0.31293606758117676,281.8627463113958,91,-301,-99,791,467,1383,687,70,35.2
-36,-10,0,-36.0,-10.0,0.32078003883361816,244.54606060540362,91,-265,-89,791,467,1383,687,70,30.83
-33,-9,0,-33.0,-9.0,0.32874512672424316,210.40578640284747,91,-232,-80,791,467,1383,687,70,26.31
-31,-9,0,-31.0,-9.0,0.33675217628479004,178.17129262637593,91,-201,-71,791,467,1383,687,70,23.03
-28,-9,0,-28.0,-9.0,0.34479498863220215,148.77431811871864,91,-173,-62,791,467,1383,687,70,20.18
-24,-8,0,-24.0,-8.0,0.35274720191955566,123.48343762046557,91,-149,-54,791,467,1383,687,70,16.99
-23,-8,0,-23.0,-8.0,0.3608400821685791,99.13426109685773,91,-126,-46,791,467,1383,687,70,15.35
-20,-9,0,-20.0,-9.0,0.3687450885772705,77.27199116431488,91,-106,-37,791,467,1383,687,70,10.91
-17,-8,0,-17.0,-8.0,0.376737117767334,58.60555539069249,91,-89,-29,791,467,1383,687,70,8.31
-13,-5,0,-13.0,-5.0,0.3849811553955078,44.6994353806851,91,-76,-24,791,467,1383,687,70,7.39
-9,-5,0,-9.0,-5.0,0.39280104637145996,34.6419413859206,91,-67,-19,791,467,1383,687,70,4.37
-4,-2,0,-4.0,-2.0,0.4007570743560791,30.253352404301808,91,-63,-17,791,467,1383,687,70,3.54
-1,-2,0,-1.0,-2.0,0.4088730812072754,28.788713735268246,91,-62,-15,791,467,1383,687,70,1.02
-1,-1,0,-1.0,-1.0,0.41675305366516113,27.5859409132754,91,-61,-14,791,467,1383,687,70,1.67
0,0,1,-0.0,-0.0,0.5187561511993408,27.5859409132754,91,-61,-14,791,467,1383,687,70,35.21
-1,0,1,-1.0,-0.0,0.05278944969177246,586.213306837062,92,472,-382,1323,99,852,481,43,5.45
-1,0,1,-1.0,-0.0,0.0688173770904541,586.9909538800721,92,473,-382,1323,99,852,481,43,5.46
-1,0,1,-1.0,-0.0,0.08473849296569824,587.7692502089769,92,474,-382,1323,99,852,481,43,5.46
-2,0,1,-2.0,-0.0,0.09271550178527832,589.3277807866851,92,476,-382,1323,99,852,481,43,3.39
-2,0,1,-2.0,-0.0,0.10103535652160645,590.8888788007182,92,478,-382,1323,99,852,481,43,3.4
-1,0,1,-1.0,-0.0,0.10885739326477051,591.6703844645994,92,479,-382,1323,99,852,481,43,5.47
0,0,0,-0.0,-0.0,0.11471438407897949,591.6703844645994,92,479,-382,1323,99,852,481,43,150.45
1,0,0,1.0,-0.0,0.2207784652709961,590.8888788007182,92,478,-382,1323,99,852,481,43,3.88
5,-2,0,5.0,-2.0,0.2287273406982422,585.7363513091992,92,473,-380,1323,99,852,481,43,17.66
8,-6,0,8.0,-6.0,0.2367253303527832,575.7419877970713,92,465,-374,1323,99,852,481,43,31.6
13,-9,0,13.0,-9.0,0.24474334716796875,559.9724606209833,92,452,-365,1323,99,852,481,43,41.23
16,-10,0,16.0,-10.0,0.252887487411499,541.2463872716303,92,436,-355,1323,99,852,481,43,44.44
21,-12,0,21.0,-12.0,0.2607283592224121,517.3994799403134,92,415,-343,1323,99,852,481,43,49.74
24,-15,0,24.0,-15.0,0.2687253952026367,489.35771768437087,92,391,-328,1323,99,852,481,43,53.04
24,-14,0,24.0,-14.0,0.2767302989959717,461.99585919550077,92,367,-314,1323,99,852,481,43,50.07
25,-13,0,25.0,-13.0,0.2847583293914795,434.5930201396856,92,342,-301,1323,99,852,481,43,47.73
26,-13,0,26.0,-13.0,0.2927403450012207,406.551166528639,92,316,-288,1323,99,852,481,43,46.09
23,-12,0,23.0,-12.0,0.30071234703063965,381.5232912515747,92,293,-276,1323,99,852,481,43,41.34
23,-11,0,23.0,-11.0,0.3087153434753418,357.3186487605389,92,270,-265,1323,99,852,481,43,38.51
23,-13,0,23.0,-13.0,0.3167703151702881,331.8639964632266,92,247,-252,1323,99,852,481,43,37.94
24,-15,0,24.0,-15.0,0.32473230361938477,304.41972896553153,92,223,-237,1323,99,852,481,43,37.45
22,-16,0,22.0,-16.0,0.3328273296356201,277.7339953872006,92,201,-221,1323,99,852,481,43,34.9
22,-18,0,22.0,-18.0,0.3407573699951172,249.64737205448716,92,179,-203,1323,99,852,481,43,33.65
18,-18,0,18.0,-18.0,0.34922337532043457,224.246814454337,92,161,-185,1323,99,852,481,43,30.69
16,-18,0,16.0,-18.0,0.35678839683532715,200.16509670379727,92,145,-167,1323,99,852,481,43,29.56
11,-15,0,11.0,-15.0,0.3649134635925293,181.63267258761604,92,134,-152,1323,99,852,481,43,22.12
9,-14,0,9.0,-14.0,0.3727273941040039,165.19613314996636,92,125,-138,1323,99,852,481,43,18.62
6,-11,0,6.0,-11.0,0.3807244300842285,153.04022523543227,92,119,-127,1323,99,852,481,43,14.17
6,-10,0,6.0,-10.0,0.38872432708740234,141.65915283192643,92,113,-117,1323,99,852,481,43,13.06
5,-10,0,5.0,-10.0,0.39673948287963867,131.029602380589,92,108,-107,1323,99,852,481,43,11.4
5,-10,0,5.0,-10.0,0.40474438667297363,120.48498153514387,92,103,-97,1323,99,852,481,43,10.63
5,-8,0,5.0,-8.0,0.41276049613952637,111.38202294873727,92,98,-89,1323,99,852,481,43,9.55
4,-6,0,4.0,-6.0,0.4207584857940674,104.39936203984452,92,94,-83,1323,99,852,481,43,7.92
3,-4,0,3.0,-4.0,0.4287264347076416,99.50726119201282,92,91,-79,1323,99,852,481,43,6.62
2,-3,0,2.0,-3.0,0.43686532974243164,96.0341830406826,92,89,-76,1323,99,852,481,43,5.18
2,-3,0,2.0,-3.0,0.44472742080688477,92.56936206565572,92,87,-73,1323,99,852,481,43,5.04
1,-2,0,1.0,-2.0,0.4527323246002197,90.5212984142491,92,86,-71,1323,99,852,481,43,3.49
1,-2,0,1.0,-2.0,0.46071934700012207,88.48059188732951,92,85,-69,1323,99,852,481,43,3.43
2,-2,0,2.0,-2.0,0.46883630752563477,85.66770832824712,92,83,-67,1323,99,852,481,43,5.77
1,-3,0,1.0,-3.0,0.47672343254089355,83.01922899156675,92,82,-64,1323,99,852,481,43,3.27
2,-3,0,2.0,-3.0,0.48472142219543457,79.60318086422517,92,80,-61,1323,99,852,481,43,4.48
2,-3,0,2.0,-3.0,0.4927194118499756,76.20082304178294,92,78,-58,1323,99,852,481,43,4.34
2,-4,0,2.0,-4.0,0.5007514953613281,72.23089616645332,92,76,-54,1323,99,852,481,43,4.03
2,-3,0,2.0,-3.0,0.5088963508605957,68.87213138676528,92,74,-51,1323,99,852,481,43,3.99
2,-3,0,2.0,-3.0,0.5167264938354492,65.53323061113575,92,72,-48,1323,99,852,481,43,3.83
2,-3,0,2.0,-3.0,0.524733304977417,62.21658488546619,92,70,-45,1323,99,852,481,43,3.68
3,-3,0,3.0,-3.0,0.5327463150024414,58.07591289387686,92,67,-42,1323,99,852,481,43,4.79
4,-4,0,4.0,-4.0,0.5408284664154053,52.57309290766564,92,63,-38,1323,99,852,481,43,5.05
4,-3,0,4.0,-3.0,0.5487263202667236,47.600291544569984,92,59,-35,1323,99,852,481,43,5.75
5,-3,0,5.0,-3.0,0.5567305088043213,41.76941930590086,92,54,-32,1323,99,852,481,43,8.75
4,-4,0,4.0,-4.0,0.564725399017334,36.30619512757761,92,50,-28,1323,99,852,481,43,4.16
4,-3,0,4.0,-3.0,0.5727343559265137,31.354560450833695,92,46,-25,1323,99,852,481,43,4.69
4,-2,0,4.0,-2.0,0.5807332992553711,26.885279575251516,92,42,-23,1323,99,852,481,43,6.11
3,-4,0,3.0,-4.0,0.5887343883514404,22.382023926967726,92,39,-19,1323,99,852,481,43,2.53
4,-3,0,4.0,-3.0,0.5967123508453369,17.483762809787713,92,35,-16,1323,99,852,481,43,3.53
5,-3,0,5.0,-3.0,0.604736328125,11.695565448543633,92,30,-13,1323,99,852,481,43,4.04
3,-3,0,3.0,-3.0,0.6127223968505859,7.792360097775937,92,27,-10,1323,99,852,481,43,1.95
3,-2,0,3.0,-2.0,0.6207373142242432,4.298221281347036,92,24,-8,1323,99,852,481,43,2.46
3,-2,0,3.0,-2.0,0.6287713050842285,0.840329667841555,92,21,-6,1323,99,852,481,43,2.06
3,-1,0,3.0,-1.0,0.636716365814209,-2.3184583077305945,92,18,-5,1323,99,852,481,43,4.36
2,-2,0,2.0,-2.0,0.6448814868927002,-4.721179403900294,92,16,-3,1323,99,852,481,43,0.8
2,-1,0,2.0,-1.0,0.6527523994445801,-6.857864376269049,92,14,-2,1323,99,852,481,43,1.65
2,-1,0,2.0,-1.0,0.6607494354248047,-8.958405421207704,92,12,-1,1323,99,852,481,43,1.27
2,-2,0,2.0,-2.0,0.6687314510345459,-10.95012437887911,92,10,1,1323,99,852,481,43,-0.23
2,-1,0,2.0,-1.0,0.6767394542694092,-12.753788748764679,92,8,2,1323,99,852,481,43,0.05
1,-1,0,1.0,-1.0,0.6848104000091553,-13.384226894136091,92,7,3,1323,99,852,481,43,-0.51
0,0,1,-0.0,-0.0,0.7117283344268799,-13.384226894136091,92,7,3,1323,99,852,481,43,23.189999999999998
0,0,0,-0.0,-0.0,0.08234000205993652,1032.317917741592,93,-1038,173,278,269,1316,96,40,209.37
-2,2,0,-2.0,2.0,0.09332489967346191,1030.0176188997973,93,-1036,171,278,269,1316,96,40,12.43
-3,3,0,-3.0,3.0,0.10132288932800293,1026.5720233218544,93,-1033,168,278,269,1316,96,40,17.42
-5,5,0,-5.0,5.0,0.10937380790710449,1020.8424472512638,93,-1028,163,278,269,1316,96,40,26.59
-5,6,0,-5.0,6.0,0.11733078956604004,1014.9772944369358,93,-1023,157,278,269,1316,96,40,26.82
-5,6,0,-5.0,6.0,0.12546491622924805,1009.1379888042225,93,-1018,151,278,269,1316,96,40,26.62
-7,7,0,-7.0,7.0,0.13332891464233398,1001.2037015209062,93,-1011,144,278,269,1316,96,40,34.25
-7,6,0,-7.0,6.0,0.1413099765777588,993.439687401278,93,-1004,138,278,269,1316,96,40,33.68
-6,6,0,-6.0,6.0,0.14944100379943848,986.691611169975,93,-998,132,278,269,1316,96,40,29.78
-5,5,0,-5.0,5.0,0.1573479175567627,981.0884076843563,93,-993,127,278,269,1316,96,40,25.46
-6,5,0,-6.0,5.0,0.16532087326049805,974.5114378427229,93,-987,122,278,269,1316,96,40,29.15
-4,4,0,-4.0,4.0,0.1733388900756836,970.0570690621829,93,-983,118,278,269,1316,96,40,20.87
-7,5,0,-7.0,5.0,0.1813209056854248,962.5197199038806,93,-976,113,278,269,1316,96,40,32.49
-8,6,0,-8.0,6.0,0.1893908977508545,953.8957849790705,93,-968,107,278,269,1316,96,40,35.87
-11,7,0,-11.0,7.0,0.19733500480651855,942.2104759354888,93,-957,100,278,269,1316,96,40,45.14
-12,7,0,-12.0,7.0,0.20533394813537598,929.5651636407056,93,-945,93,278,269,1316,96,40,47.57
-16,9,0,-16.0,9.0,0.2133188247680664,912.7899013175474,93,-929,84,278,269,1316,96,40,57.47
-23,8,0,-23.0,8.0,0.22136688232421875,889.182049976791,93,-906,76,278,269,1316,96,40,71.29
-25,7,0,-25.0,7.0,0.2294478416442871,863.6979121849276,93,-881,69,278,269,1316,96,40,73.69
-29,7,0,-29.0,7.0,0.23732590675354004,834.2528899570665,93,-852,62,278,269,1316,96,40,78.62
-27,5,0,-27.0,5.0,0.2453148365020752,806.9667466107691,93,-825,57,278,269,1316,96,40,74.35
-28,3,0,-28.0,3.0,0.25333380699157715,778.8272654335228,93,-797,54,278,269,1316,96,40,75.36
-28,2,0,-28.0,2.0,0.26148390769958496,750.7561222591748,93,-769,52,278,269,1316,96,40,75.28
-29,1,0,-29.0,1.0,0.26934099197387695,721.7553505031157,93,-740,51,278,269,1316,96,40,73.4
-29,0,0,-29.0,-0.0,0.27742791175842285,692.8267671741852,93,-711,51,278,269,1316,96,40,70.71
-29,1,0,-29.0,1.0,0.285322904586792,663.830388327398,93,-682,50,278,269,1316,96,40,69.71
-30,0,0,-30.0,-0.0,0.29332590103149414,633.9143674824709,93,-652,50,278,269,1316,96,40,68.15
-31,-2,0,-31.0,-2.0,0.3014979362487793,603.1733306231903,93,-621,52,278,269,1316,96,40,66.21
-31,0,0,-31.0,-0.0,0.3093268871307373,572.2870925488753,93,-590,52,278,269,1316,96,40,64.91
-30,-1,0,-30.0,-1.0,0.3173189163208008,542.5024444391331,93,-560,53,278,269,1316,96,40,61.09
-30,-2,0,-30.0,-2.0,0.3253469467163086,512.8461316365166,93,-530,55,278,269,1316,96,40,58.43
-32,-2,0,-32.0,-2.0,0.3334498405456543,481.251433913161,93,-498,57,278,269,1316,96,40,57.95
-31,-2,0,-31.0,-2.0,0.3415210247039795,450.7122263124254,93,-467,59,278,269,1316,96,40,54.43
-34,-1,0,-34.0,-1.0,0.34932994842529297,417.13727820903125,93,-433,60,278,269,1316,96,40,54.5
-32,-2,0,-32.0,-2.0,0.35732579231262207,385.7647101461634,93,-401,62,278,269,1316,96,40,49.6
-32,-1,0,-32.0,-1.0,0.3656468391418457,354.33941817553756,93,-369,63,278,269,1316,96,40,46.97
-29,-1,0,-29.0,-1.0,0.37337279319763184,325.9710970586994,93,-340,64,278,269,1316,96,40,41.88
-27,0,0,-27.0,-0.0,0.38130688667297363,299.4761336938958,93,-313,64,278,269,1316,96,40,38.18
-25,-1,0,-25.0,-1.0,0.3893308639526367,275.24396691549856,93,-288,65,278,269,1316,96,40,33.9
-22,0,0,-22.0,-0.0,0.39732980728149414,253.82658746002005,93,-266,65,278,269,1316,96,40,29.94
-20,0,0,-20.0,-0.0,0.4053208827972412,234.4425278918601,93,-246,65,278,269,1316,96,40,26.59
-17,0,0,-17.0,-0.0,0.4133419990539551,218.04621400055913,93,-229,65,278,269,1316,96,40,22.71
-15,0,0,-15.0,-0.0,0.42131495475769043,203.6537502480117,93,-214,65,278,269,1316,96,40,19.86
-12,1,0,-12.0,1.0,0.42934298515319824,191.8962010041709,93,-202,64,278,269,1316,96,40,17.1
-10,1,0,-10.0,1.0,0.437518835067749,182.07176942858692,93,-192,63,278,269,1316,96,40,14.75
-7,1,0,-7.0,1.0,0.445375919342041,175.1127878945919,93,-185,62,278,269,1316,96,40,11.78
-6,1,0,-6.0,1.0,0.45333099365234375,169.10843450253614,93,-179,61,278,269,1316,96,40,10.68
-5,1,0,-5.0,1.0,0.46132493019104004,164.05433980213562,93,-174,60,278,269,1316,96,40,9.74
-6,0,0,-6.0,-0.0,0.46933579444885254,158.39282496782207,93,-168,60,278,269,1316,96,40,8.92
-5,1,0,-5.0,1.0,0.47733497619628906,153.34935823359717,93,-163,59,278,269,1316,96,40,9.25
-5,1,0,-5.0,1.0,0.48537588119506836,148.30923919975396,93,-158,58,278,269,1316,96,40,9.05
-4,1,0,-4.0,1.0,0.49338793754577637,144.21023110634732,93,-154,57,278,269,1316,96,40,8.42
-6,1,0,-6.0,1.0,0.5013368129730225,138.24032355881985,93,-148,56,278,269,1316,96,40,9.27
-8,0,0,-8.0,-0.0,0.509354829788208,130.78461459976612,93,-140,56,278,269,1316,96,40,9.31
-9,1,0,-9.0,1.0,0.5174548625946045,122.07744367069671,93,-131,55,278,269,1316,96,40,10.25
-8,0,0,-8.0,-0.0,0.5253069400787354,114.73678042761748,93,-123,55,278,269,1316,96,40,8.34
-10,1,0,-10.0,1.0,0.5333328247070312,105.23977004130916,93,-113,54,278,269,1316,96,40,9.58
-8,0,0,-8.0,-0.0,0.5413308143615723,98.07201192492656,93,-105,54,278,269,1316,96,40,7.25
-6,1,0,-6.0,1.0,0.549414873123169,92.29425630903836,93,-99,53,278,269,1316,96,40,6.63
-4,0,0,-4.0,-0.0,0.5573418140411377,88.78419002777932,93,-95,53,278,269,1316,96,40,4.34
-4,1,0,-4.0,1.0,0.5653958320617676,84.80935072788114,93,-91,52,278,269,1316,96,40,5.43
-3,1,0,-3.0,1.0,0.5733540058135986,81.71037311896953,93,-88,51,278,269,1316,96,40,5.17
-4,1,0,-4.0,1.0,0.581326961517334,77.75479527879949,93,-84,50,278,269,1316,96,40,5.11
-4,1,0,-4.0,1.0,0.5893638134002686,73.81364506296512,93,-80,49,278,269,1316,96,40,4.93
-3,2,0,-3.0,2.0,0.5973789691925049,70.21086409075129,93,-77,47,278,269,1316,96,40,7.22
-3,1,0,-3.0,1.0,0.6053328514099121,67.13208364316786,93,-74,46,278,269,1316,96,40,4.61
-4,3,0,-4.0,3.0,0.6133198738098145,62.152297594163485,93,-70,43,278,269,1316,96,40,6.69
-6,3,0,-6.0,3.0,0.6213397979736328,55.471849056452825,93,-64,40,278,269,1316,96,40,7.14
-6,3,0,-6.0,3.0,0.6293449401855469,48.796802251267465,93,-58,37,278,269,1316,96,40,6.67
-7,4,0,-7.0,4.0,0.6374239921569824,40.74537019394976,93,-51,33,278,269,1316,96,40,7.53
-6,4,0,-6.0,4.0,0.6453268527984619,33.53503525729669,93,-45,29,278,269,1316,96,40,8.25
-5,5,0,-5.0,5.0,0.6533708572387695,26.647615158762406,93,-40,24,278,269,1316,96,40,4.35
-6,4,0,-6.0,4.0,0.6613099575042725,19.44616584663204,93,-34,20,278,269,1316,96,40,5.98
-5,4,0,-5.0,4.0,0.6693379878997803,13.120990323358392,93,-29,16,278,269,1316,96,40,3.94
-6,4,0,-6.0,4.0,0.6773359775543213,5.942243542145693,93,-23,12,278,269,1316,96,40,4.22
-5,4,0,-5.0,4.0,0.6853218078613281,-0.30228439640779214,93,-18,8,278,269,1316,96,40,2.44
-4,4,0,-4.0,4.0,0.6933410167694092,-5.439780221438964,93,-14,4,278,269,1316,96,40,0.96
-5,3,0,-5.0,3.0,0.7013709545135498,-10.944614861862583,93,-9,1,278,269,1316,96,40,0.71
-4,3,0,-4.0,3.0,0.7093288898468018,-14.614835192865495,93,-5,-2,278,269,1316,96,40,-1.12
-2,2,0,-2.0,2.0,0.7173328399658203,-15.0,93,-3,-4,278,269,1316,96,40,-1.87
-1,1,0,-1.0,1.0,0.7253258228302002,-14.614835192865495,93,-2,-5,278,269,1316,96,40,-0.84
-1,0,0,-1.0,-0.0,0.7333438396453857,-14.900980486407216,93,-1,-5,278,269,1316,96,40,-0.76
0,1,0,-0.0,1.0,0.7413158416748047,-13.917237469701782,93,-1,-6,278,269,1316,96,40,1.86
0,0,1,-0.0,-0.0,0.7623379230499268,-13.917237469701782,93,-1,-6,278,269,1316,96,40,23.05
-1,0,1,-1.0,-0.0,0.01598358154296875,1148.741335532251,94,1006,573,1284,848,279,275,19,14.01
0,0,0,-0.0,-0.0,0.07798051834106445,1148.741335532251,94,1006,573,1284,848,279,275,19,222.27
1,1,0,1.0,1.0,0.12805438041687012,1147.3775335071155,94,1005,572,1284,848,279,275,19,17.03
2,0,0,2.0,-0.0,0.13612842559814453,1145.6397706644268,94,1003,572,1284,848,279,275,19,19.72
3,0,0,3.0,-0.0,0.14427447319030762,1143.0347216989599,94,1000,572,1284,848,279,275,19,27.6
3,1,0,3.0,1.0,0.15197253227233887,1139.9342888085462,94,997,571,1284,848,279,275,19,33.1
5,1,0,5.0,1.0,0.16001057624816895,1135.0996460099093,94,992,570,1284,848,279,275,19,45.74
7,1,0,7.0,1.0,0.1680145263671875,1128.5350544049181,94,985,569,1284,848,279,275,19,56.86
11,1,0,11.0,1.0,0.17599248886108398,1118.5194011634567,94,974,568,1284,848,279,275,19,75.13
15,3,0,15.0,3.0,0.1840505599975586,1104.061543671328,94,959,565,1284,848,279,275,19,93.23
18,3,0,18.0,3.0,0.1920604705810547,1087.0497251493657,94,941,562,1284,848,279,275,19,100.66
23,6,0,23.0,6.0,0.20001554489135742,1064.2474085689655,94,918,556,1284,848,279,275,19,114.83
26,9,0,26.0,9.0,0.20827651023864746,1037.361792115901,94,892,547,1284,848,279,275,19,121.74
30,10,0,30.0,10.0,0.21597957611083984,1006.58505306055,94,862,537,1284,848,279,275,19,125.97
33,12,0,33.0,12.0,0.22397637367248535,972.2573566603207,94,829,525,1284,848,279,275,19,128.52
34,12,0,34.0,12.0,0.23226046562194824,937.1469230515945,94,795,513,1284,848,279,275,19,126.66
35,13,0,35.0,13.0,0.23999357223510742,900.7252332435327,94,760,500,1284,848,279,275,19,125.33
32,14,0,32.0,14.0,0.24822139739990234,866.3170854039123,94,728,486,1284,848,279,275,19,120.46
31,13,0,31.0,13.0,0.25597643852233887,833.3407861429957,94,697,473,1284,848,279,275,19,115.81
27,15,0,27.0,15.0,0.26398634910583496,802.5811727732477,94,670,458,1284,848,279,275,19,111.42
26,14,0,26.0,14.0,0.27202439308166504,773.222474747434,94,644,444,1284,848,279,275,19,106.87
24,15,0,24.0,15.0,0.2799713611602783,744.9502636115992,94,620,429,1284,848,279,275,19,104.04
26,14,0,26.0,14.0,0.2879924774169922,715.6109300859324,94,594,415,1284,848,279,275,19,101.88
24,15,0,24.0,15.0,0.29596638679504395,687.3476143421474,94,570,400,1284,848,279,275,19,98.96
25,15,0,25.0,15.0,0.3039684295654297,658.2705598181295,94,545,385,1284,848,279,275,19,97.02
25,14,0,25.0,14.0,0.31197643280029297,629.7808700955281,94,520,371,1284,848,279,275,19,93.19
23,14,0,23.0,14.0,0.32027244567871094,602.9297345284016,94,497,357,1284,848,279,275,19,89.08
22,12,0,22.0,12.0,0.32796335220336914,578.0689908349784,94,475,345,1284,848,279,275,19,83.46
22,12,0,22.0,12.0,0.3359694480895996,553.225933233251,94,453,333,1284,848,279,275,19,81.08
21,12,0,21.0,12.0,0.34407854080200195,529.2053511439663,94,432,321,1284,848,279,275,19,77.87
21,13,0,21.0,13.0,0.35216450691223145,504.60003894080853,94,411,308,1284,848,279,275,19,76.67
20,11,0,20.0,11.0,0.36005353927612305,482.0091648839154,94,391,297,1284,848,279,275,19,71.17
18,11,0,18.0,11.0,0.36799049377441406,461.02659499224086,94,373,286,1284,848,279,275,19,67.36
16,12,0,16.0,12.0,0.3759725093841553,441.0277769204919,94,357,274,1284,848,279,275,19,66.36
17,10,0,17.0,10.0,0.3840913772583008,421.46021883560854,94,340,264,1284,848,279,275,19,61.3
17,12,0,17.0,12.0,0.3919694423675537,400.67426084634604,94,323,252,1284,848,279,275,19,62.16
17,11,0,17.0,11.0,0.3999814987182617,380.5086648586909,94,306,241,1284,848,279,275,19,58.5
19,12,0,19.0,12.0,0.407961368560791,358.16481312892716,94,287,229,1284,848,279,275,19,58.55
19,12,0,19.0,12.0,0.415973424911499,335.8376429567979,94,268,217,1284,848,279,275,19,55.96
18,11,0,18.0,11.0,0.42397236824035645,314.93826572357887,94,250,206,1284,848,279,275,19,51.82
18,11,0,18.0,11.0,0.43198347091674805,294.0659994126692,94,232,195,1284,848,279,275,19,49.32
18,11,0,18.0,11.0,0.4399874210357666,273.2268591045154,94,214,184,1284,848,279,275,19,46.75
16,10,0,16.0,10.0,0.44796037673950195,254.59059163786554,94,198,174,1284,848,279,275,19,42.32
15,8,0,15.0,8.0,0.4562103748321533,238.07286374670934,94,183,166,1284,848,279,275,19,37.57
13,7,0,13.0,7.0,0.46399641036987305,223.76812496559748,94,170,159,1284,848,279,275,19,33.38
13,9,0,13.0,9.0,0.47196340560913086,208.13820483738002,94,157,150,1284,848,279,275,19,33.87
11,8,0,11.0,8.0,0.47995758056640625,194.66639388961548,94,146,142,1284,848,279,275,19,30.13
12,9,0,12.0,9.0,0.4879744052886963,179.79883474216678,94,134,133,1284,848,279,275,19,30.03
13,9,0,13.0,9.0,0.49597954750061035,164.25414857947845,94,121,124,1284,848,279,275,19,28.38
12,9,0,12.0,9.0,0.504150390625,149.44872987815333,94,109,115,1284,848,279,275,19,26.13
13,9,0,13.0,9.0,0.5119915008544922,134.01048912579805,94,96,106,1284,848,279,275,19,24.3
13,8,0,13.0,8.0,0.5200324058532715,119.42507543311004,94,83,98,1284,848,279,275,19,21.36
12,7,0,12.0,7.0,0.5280864238739014,106.42096863222038,94,71,91,1284,848,279,275,19,18.32
11,7,0,11.0,7.0,0.5360114574432373,94.22790320451152,94,60,84,1284,848,279,275,19,16.25
11,5,0,11.0,5.0,0.5439605712890625,83.9623579735368,94,49,79,1284,848,279,275,19,13.04
8,4,0,8.0,4.0,0.551971435546875,76.47514258543241,94,41,75,1284,848,279,275,19,10.08
5,4,0,5.0,4.0,0.559969425201416,70.60527620704548,94,36,71,1284,848,279,275,19,8.74
4,2,0,4.0,2.0,0.5679745674133301,67.05918747922567,94,32,69,1284,848,279,275,19,5.61
2,2,0,2.0,2.0,0.5760514736175537,64.40980860893181,94,30,67,1284,848,279,275,19,5.45
2,2,0,2.0,2.0,0.5840463638305664,61.77428911688199,94,28,65,1284,848,279,275,19,5.27
1,1,0,1.0,1.0,0.5920205116271973,60.462219947249025,94,27,64,1284,848,279,275,19,3.74
1,1,0,1.0,1.0,0.6000933647155762,59.15423684555495,94,26,63,1284,848,279,275,19,3.67
1,2,0,1.0,2.0,0.6080324649810791,56.924198895398035,94,25,61,1284,848,279,275,19,6.83
1,1,0,1.0,1.0,0.615971565246582,55.62197768561404,94,24,60,1284,848,279,275,19,3.55
0,1,0,-0.0,1.0,0.6239774227142334,54.694583757176716,94,24,59,1284,848,279,275,19,3.19
1,1,0,1.0,1.0,0.6400885581970215,53.39390995922599,94,23,58,1284,848,279,275,19,3.49
0,1,0,-0.0,1.0,0.6479804515838623,52.465437442517235,94,23,57,1284,848,279,275,19,3.16
0,2,0,-0.0,2.0,0.6559903621673584,50.61543424315552,94,23,55,1284,848,279,275,19,4.0
0,2,0,-0.0,2.0,0.6639645099639893,48.77542730261716,94,23,53,1284,848,279,275,19,3.89
1,3,0,1.0,3.0,0.6720085144042969,45.62600113499065,94,22,50,1284,848,279,275,19,6.91
1,3,0,1.0,3.0,0.6801834106445312,42.478150704935004,94,21,47,1284,848,279,275,19,6.67
1,3,0,1.0,3.0,0.6879615783691406,39.33218389437829,94,20,44,1284,848,279,275,19,6.42
2,3,0,2.0,3.0,0.6959743499755859,35.77722635447622,94,18,41,1284,848,279,275,19,5.82
1,2,0,1.0,2.0,0.7039713859558105,33.5440947723653,94,17,39,1284,848,279,275,19,6.36
1,3,0,1.0,3.0,0.7120535373687744,30.395431207184416,94,16,36,1284,848,279,275,19,6.05
1,2,0,1.0,2.0,0.7199604511260986,28.16180835212409,94,15,34,1284,848,279,275,19,6.25
1,3,0,1.0,3.0,0.7279574871063232,25.0147027033899,94,14,31,1284,848,279,275,19,5.67
1,3,0,1.0,3.0,0.7362575531005859,21.870698080866262,94,13,28,1284,848,279,275,19,5.35
0,2,0,-0.0,2.0,0.7439725399017334,20.068883707497267,94,13,26,1284,848,279,275,19,2.64
0,3,0,-0.0,3.0,0.7520143985748291,17.419689627245813,94,13,23,1284,848,279,275,19,2.71
1,3,0,1.0,3.0,0.7599754333496094,14.323807579381203,94,12,20,1284,848,279,275,19,3.93
1,3,0,1.0,3.0,0.7679734230041504,11.248456731316587,94,11,17,1284,848,279,275,19,3.5
0,3,0,-0.0,3.0,0.7761704921722412,8.804493814764857,94,11,14,1284,848,279,275,19,1.68
2,3,0,2.0,3.0,0.7840814590454102,5.212670403551895,94,9,11,1284,848,279,275,19,4.45
2,2,0,2.0,2.0,0.7919983863830566,2.401754250991379,94,7,9,1284,848,279,275,19,3.68
2,2,0,2.0,2.0,0.7999775409698486,-0.3976747329573733,94,5,7,1284,848,279,275,19,2.97
2,2,0,2.0,2.0,0.8079695701599121,-3.1690481051546993,94,3,5,1284,848,279,275,19,2.02
2,2,0,2.0,2.0,0.8159704208374023,-5.83772233983162,94,1,3,1284,848,279,275,19,0.57
2,1,0,2.0,1.0,0.8240044116973877,-6.76393202250021,94,-1,2,1284,848,279,275,19,-1.92
1,2,0,1.0,2.0,0.8320324420928955,-7.0,94,-2,0,1284,848,279,275,19,-2.68
2,1,0,2.0,1.0,0.8399803638458252,-4.876894374382339,94,-4,-1,1284,848,279,275,19,-0.53
1,1,0,1.0,1.0,0.8479595184326172,-3.6148351928654963,94,-5,-2,1284,848,279,275,19,0.24
1,1,0,1.0,1.0,0.8559784889221191,-2.2917960675006306,94,-6,-3,1284,848,279,275,19,0.85
1,1,0,1.0,1.0,0.8640563488006592,-0.9377422517014509,94,-7,-4,1284,848,279,275,19,1.34
1,1,0,1.0,1.0,0.8800125122070312,0.43398113205660316,94,-8,-5,1284,848,279,275,19,1.75
0,0,1,-0.0,-0.0,0.9119815826416016,0.43398113205660316,94,-8,-5,1284,848,279,275,19,27.06
0,0,0,-0.0,-0.0,0.09630608558654785,247.06125740618614,95,-242,-74,1050,779,1292,853,13,85.01
-2,0,0,-2.0,-0.0,0.14629721641540527,245.14935795259362,95,-240,-74,1050,779,1292,853,13,12.36
-2,1,0,-2.0,1.0,0.1542961597442627,243.5375723212839,95,-238,-75,1050,779,1292,853,13,9.61
-4,0,0,-4.0,-0.0,0.162337064743042,239.72545655670274,95,-234,-75,1050,779,1292,853,13,19.61
-2,1,0,-2.0,1.0,0.1703181266784668,238.13111231467406,95,-232,-76,1050,779,1292,853,13,9.36
-3,2,0,-3.0,2.0,0.17830705642700195,235.91940806805889,95,-229,-78,1050,779,1292,853,13,11.76
-2,0,0,-2.0,-0.0,0.1862940788269043,234.0270818053663,95,-227,-78,1050,779,1292,853,13,11.8
0,1,0,-0.0,1.0,0.19430303573608398,234.35390573069537,95,-227,-79,1050,779,1292,853,13,14.79
-1,0,0,-1.0,-0.0,0.20235705375671387,233.40969069776602,95,-226,-79,1050,779,1292,853,13,7.34
-1,0,0,-1.0,-0.0,0.21829915046691895,232.4659304806454,95,-225,-79,1050,779,1292,853,13,7.32
-1,0,0,-1.0,-0.0,0.2262880802154541,231.52263050075882,95,-224,-79,1050,779,1292,853,13,7.3
-4,0,0,-4.0,-0.0,0.23429512977600098,227.75414434828744,95,-220,-79,1050,779,1292,853,13,18.67
-5,0,0,-5.0,-0.0,0.24236321449279785,223.05457864884517,95,-215,-79,1050,779,1292,853,13,21.3
-7,0,0,-7.0,-0.0,0.2503042221069336,216.49719099350446,95,-208,-79,1050,779,1292,853,13,25.71
-8,-2,0,-8.0,-2.0,0.2584850788116455,208.3105223734943,95,-200,-77,1050,779,1292,853,13,29.98
-13,-2,0,-13.0,-2.0,0.2663102149963379,195.47952749597167,95,-187,-75,1050,779,1292,853,13,34.99
-18,-3,0,-18.0,-3.0,0.27430009841918945,177.69812192834198,95,-169,-72,1050,779,1292,853,13,37.46
-19,-3,0,-19.0,-3.0,0.28229808807373047,159.10905486980417,95,-150,-69,1050,779,1292,853,13,34.98
-17,-3,0,-17.0,-3.0,0.29030609130859375,142.47558721890948,95,-133,-66,1050,779,1292,853,13,30.89
-16,-3,0,-16.0,-3.0,0.2982971668243408,126.8834075421006,95,-117,-63,1050,779,1292,853,13,27.59
-14,-3,0,-14.0,-3.0,0.3063390254974365,113.20151005754919,95,-103,-60,1050,779,1292,853,13,24.05
-11,-3,0,-11.0,-3.0,0.3143742084503174,102.2266141020775,95,-92,-57,1050,779,1292,853,13,20.4
-9,-3,0,-9.0,-3.0,0.3224220275878906,93.02019995940222,95,-83,-54,1050,779,1292,853,13,17.75
-8,-2,0,-8.0,-2.0,0.33056211471557617,85.2633551870629,95,-75,-52,1050,779,1292,853,13,14.89
-5,-2,0,-5.0,-2.0,0.3383920192718506,80.02325267042627,95,-70,-50,1050,779,1292,853,13,12.09
-4,-3,0,-4.0,-3.0,0.34630703926086426,75.02468759581859,95,-66,-47,1050,779,1292,853,13,14.14
-4,-2,0,-4.0,-2.0,0.35430908203125,70.60939890117922,95,-62,-45,1050,779,1292,853,13,10.76
-4,-3,0,-4.0,-3.0,0.36230921745300293,65.61005515987263,95,-58,-42,1050,779,1292,853,13,13.68
-3,-2,0,-3.0,-2.0,0.37035608291625977,62.007352543677214,95,-55,-40,1050,779,1292,853,13,10.82
-3,-3,0,-3.0,-3.0,0.3783111572265625,57.8200595424354,95,-52,-37,1050,779,1292,853,13,9.43
-2,-2,0,-2.0,-2.0,0.3863651752471924,55.032778078668514,95,-50,-35,1050,779,1292,853,13,7.5
-2,-2,0,-2.0,-2.0,0.394334077835083,52.249463516842795,95,-48,-33,1050,779,1292,853,13,7.26
-2,-2,0,-2.0,-2.0,0.4023141860961914,49.47071299343465,95,-46,-31,1050,779,1292,853,13,7.02
-2,-2,0,-2.0,-2.0,0.4103431701660156,46.69724850502159,95,-44,-29,1050,779,1292,853,13,6.78
-2,-1,0,-2.0,-1.0,0.41834521293640137,44.47771785649585,95,-42,-28,1050,779,1292,853,13,6.67
-1,-1,0,-1.0,-1.0,0.4263010025024414,43.09175083453431,95,-41,-27,1050,779,1292,853,13,4.93
-2,-1,0,-2.0,-1.0,0.43430399894714355,40.87216658103186,95,-39,-26,1050,779,1292,853,13,6.48
-1,-2,0,-1.0,-2.0,0.4423670768737793,38.94441010848846,95,-38,-24,1050,779,1292,853,13,4.0
-2,-2,0,-2.0,-2.0,0.450336217880249,36.190046219457976,95,-36,-22,1050,779,1292,853,13,5.88
-3,-2,0,-3.0,-2.0,0.45832204818725586,32.58756276314948,95,-33,-20,1050,779,1292,853,13,8.58
-3,-2,0,-3.0,-2.0,0.4662940502166748,28.9857113690718,95,-30,-18,1050,779,1292,853,13,8.18
-2,-2,0,-2.0,-2.0,0.4743962287902832,26.249030993194197,95,-28,-16,1050,779,1292,853,13,5.04
-2,-2,0,-2.0,-2.0,0.4823770523071289,23.5296461204668,95,-26,-14,1050,779,1292,853,13,4.7
-1,-1,0,-1.0,-1.0,0.49034714698791504,22.178005607210743,95,-25,-13,1050,779,1292,853,13,3.54
-1,0,0,-1.0,-0.0,0.49829816818237305,21.294688127912362,95,-24,-13,1050,779,1292,853,13,2.45
-2,-1,0,-2.0,-1.0,0.5063061714172363,19.059928172283335,95,-22,-12,1050,779,1292,853,13,6.8
-2,0,0,-2.0,-0.0,0.5142951011657715,17.323807579381203,95,-20,-12,1050,779,1292,853,13,2.73
-3,-1,0,-3.0,-1.0,0.5223321914672852,14.248456731316587,95,-17,-11,1050,779,1292,853,13,4.38
-2,-1,0,-2.0,-1.0,0.5303590297698975,12.027756377319946,95,-15,-10,1050,779,1292,853,13,4.74
-2,0,0,-2.0,-0.0,0.5383012294769287,10.401219466856727,95,-13,-10,1050,779,1292,853,13,1.93
-1,0,0,-1.0,-0.0,0.5462870597839355,9.620499351813308,95,-12,-10,1050,779,1292,853,13,1.46
-2,0,0,-2.0,-0.0,0.5543661117553711,8.142135623730951,95,-10,-10,1050,779,1292,853,13,1.4
-2,-1,0,-2.0,-1.0,0.5623350143432617,6.041594578792296,95,-8,-9,1050,779,1292,853,13,2.59
-2,-1,0,-2.0,-1.0,0.5702950954437256,4.0,95,-6,-8,1050,779,1292,853,13,2.06
-2,0,0,-2.0,-0.0,0.5782840251922607,2.944271909999159,95,-4,-8,1050,779,1292,853,13,0.18
-2,-1,0,-2.0,-1.0,0.5862941741943359,1.280109889280518,95,-2,-7,1050,779,1292,853,13,0.68
-2,-1,0,-2.0,-1.0,0.5943012237548828,0.0,95,0,-6,1050,779,1292,853,13,-0.13
-3,0,0,-3.0,-0.0,0.6023061275482178,0.7082039324993694,95,3,-6,1050,779,1292,853,13,-0.81
-2,-1,0,-2.0,-1.0,0.6104090213775635,1.0710678118654755,95,5,-5,1050,779,1292,853,13,0.39
-3,-1,0,-3.0,-1.0,0.6182971000671387,2.944271909999159,95,8,-4,1050,779,1292,853,13,-0.88
-3,0,0,-3.0,-0.0,0.626305103302002,5.704699910719626,95,11,-4,1050,779,1292,853,13,0.42
-1,0,0,-1.0,-0.0,0.6344590187072754,6.649110640673518,95,12,-4,1050,779,1292,853,13,2.38
0,0,1,-0.0,-0.0,0.6912961006164551,6.649110640673518,95,12,-4,1050,779,1292,853,13,28.88
0,0,0,-0.0,-0.0,0.1188662052154541,739.6315937679467,96,-428,-613,610,170,1038,783,16,172.41
0,-1,0,-0.0,-1.0,0.18098807334899902,738.8118906391354,96,-428,-612,610,170,1038,783,16,9.53
0,-1,0,-0.0,-1.0,0.18900513648986816,737.9926273094125,96,-428,-611,610,170,1038,783,16,9.52
1,-4,0,1.0,-4.0,0.19682621955871582,735.2967106075473,96,-429,-607,610,170,1038,783,16,24.75
2,-6,0,2.0,-6.0,0.20483613014221191,731.568793284303,96,-431,-601,610,170,1038,783,16,31.88
2,-8,0,2.0,-8.0,0.21291518211364746,726.2601718737031,96,-433,-593,610,170,1038,783,16,41.68
1,-10,0,1.0,-10.0,0.22122812271118164,718.8046505079615,96,-434,-583,610,170,1038,783,16,52.81
1,-12,0,1.0,-12.0,0.22884821891784668,709.8203117772581,96,-435,-571,610,170,1038,783,16,59.13
0,-12,0,-0.0,-12.0,0.23682212829589844,700.3120781124659,96,-435,-559,610,170,1038,783,16,60.89
-4,-13,0,-4.0,-13.0,0.24496006965637207,687.6126795854141,96,-431,-546,610,170,1038,783,16,72.03
-5,-12,0,-5.0,-12.0,0.2528252601623535,675.1046771908387,96,-426,-534,610,170,1038,783,16,71.02
-5,-12,0,-5.0,-12.0,0.2608530521392822,662.6153890271233,96,-421,-522,610,170,1038,783,16,70.13
-8,-13,0,-8.0,-13.0,0.26884007453918457,647.4769256045555,96,-413,-509,610,170,1038,783,16,77.42
-9,-13,0,-9.0,-13.0,0.2768261432647705,631.71243539578,96,-404,-496,610,170,1038,783,16,78.41
-11,-13,0,-11.0,-13.0,0.28487420082092285,614.6861167554646,96,-393,-483,610,170,1038,783,16,81.39
-12,-15,0,-12.0,-15.0,0.2931652069091797,595.4774229414055,96,-381,-468,610,170,1038,783,16,84.73
-15,-16,0,-15.0,-16.0,0.30084228515625,573.6012379629191,96,-366,-452,610,170,1038,783,16,85.34
-16,-16,0,-16.0,-16.0,0.3088252544403076,551.1028527918634,96,-350,-436,610,170,1038,783,16,83.63
-18,-15,0,-18.0,-15.0,0.31692028045654297,528.1576260765112,96,-332,-421,610,170,1038,783,16,81.16
-18,-17,0,-18.0,-17.0,0.32503414154052734,503.6756785308444,96,-314,-404,610,170,1038,783,16,81.11
-18,-17,0,-18.0,-17.0,0.33290624618530273,479.2217154438008,96,-296,-387,610,170,1038,783,16,78.42
-17,-16,0,-17.0,-16.0,0.3409731388092041,456.2003877637329,96,-279,-371,610,170,1038,783,16,74.11
-16,-16,0,-16.0,-16.0,0.34892725944519043,433.80765045435777,96,-263,-355,610,170,1038,783,16,71.11
-16,-18,0,-16.0,-18.0,0.35683226585388184,409.8253223537319,96,-247,-337,610,170,1038,783,16,70.9
-16,-17,0,-16.0,-17.0,0.3649411201477051,386.66568130507625,96,-231,-320,610,170,1038,783,16,66.89
-15,-17,0,-15.0,-17.0,0.3728320598602295,364.1088550411022,96,-216,-303,610,170,1038,783,16,63.89
-15,-17,0,-15.0,-17.0,0.3808302879333496,341.56687486087696,96,-201,-286,610,170,1038,783,16,61.1
-15,-17,0,-15.0,-17.0,0.3888370990753174,319.04281065328433,96,-186,-269,610,170,1038,783,16,58.22
-16,-16,0,-16.0,-16.0,0.39682626724243164,296.809776746088,96,-170,-253,610,170,1038,783,16,54.46
-14,-14,0,-14.0,-14.0,0.404893159866333,277.40672732085346,96,-156,-239,610,170,1038,783,16,49.07
-11,-12,0,-11.0,-12.0,0.4128432273864746,261.3584971743049,96,-145,-227,610,170,1038,783,16,43.53
-9,-13,0,-9.0,-13.0,0.4208390712738037,245.55867171130237,96,-136,-214,610,170,1038,783,16,43.25
-8,-13,0,-8.0,-13.0,0.4288361072540283,230.29603437741048,96,-128,-201,610,170,1038,783,16,41.74
-5,-13,0,-5.0,-13.0,0.43683409690856934,216.66196829904254,96,-123,-188,610,170,1038,783,16,35.1
-4,-11,0,-4.0,-11.0,0.4448881149291992,205.283848427395,96,-119,-177,610,170,1038,783,16,30.64
-3,-9,0,-3.0,-9.0,0.45284128189086914,196.15680248279753,96,-116,-168,610,170,1038,783,16,26.1
-1,-7,0,-1.0,-7.0,0.46083712577819824,189.8534811419804,96,-115,-161,610,170,1038,783,16,19.69
-1,-3,0,-1.0,-3.0,0.468853235244751,186.83326204732086,96,-114,-158,610,170,1038,783,16,12.39
0,-3,0,-0.0,-3.0,0.47685718536376953,184.40841977418765,96,-114,-155,610,170,1038,783,16,9.56
0,-4,0,-0.0,-4.0,0.48482608795166016,181.20095137181525,96,-114,-151,610,170,1038,783,16,11.58
0,-3,0,-0.0,-3.0,0.4928262233734131,178.81541692269406,96,-114,-148,610,170,1038,783,16,9.21
-1,-4,0,-1.0,-4.0,0.5008730888366699,175.04371062672436,96,-113,-144,610,170,1038,783,16,13.34
0,-4,0,-0.0,-4.0,0.5088822841644287,171.91386828146406,96,-113,-140,610,170,1038,783,16,10.9
-1,-3,0,-1.0,-3.0,0.5168871879577637,168.9547964876906,96,-112,-137,610,170,1038,783,16,11.23
0,-3,0,-0.0,-3.0,0.5248310565948486,166.64249196572982,96,-112,-134,610,170,1038,783,16,8.5
-1,-4,0,-1.0,-4.0,0.5328221321105957,162.94151046483705,96,-111,-130,610,170,1038,783,16,12.43
-2,-5,0,-2.0,-5.0,0.5408291816711426,157.8493292117879,96,-109,-125,610,170,1038,783,16,15.55
-2,-5,0,-2.0,-5.0,0.5488362312316895,152.77624202599088,96,-107,-120,610,170,1038,783,16,15.13
-2,-6,0,-2.0,-6.0,0.5569062232971191,146.98709623707387,96,-105,-114,610,170,1038,783,16,15.76
-3,-5,0,-3.0,-5.0,0.5649430751800537,141.2816130673835,96,-102,-109,610,170,1038,783,16,16.16
-3,-5,0,-3.0,-5.0,0.5728480815887451,135.58621103713267,96,-99,-104,610,170,1038,783,16,15.67
-3,-4,0,-3.0,-4.0,0.5808372497558594,130.62178760930766,96,-96,-100,610,170,1038,783,16,14.89
-2,-4,0,-2.0,-4.0,0.5891022682189941,126.35773144854747,96,-94,-96,610,170,1038,783,16,12.11
-1,-2,0,-1.0,-2.0,0.5968410968780518,124.23085872821065,96,-93,-94,610,170,1038,783,16,7.73
-2,-3,0,-2.0,-3.0,0.6048140525817871,120.69343417595164,96,-91,-91,610,170,1038,783,16,11.09
-1,-3,0,-1.0,-3.0,0.6129682064056396,117.8729518204765,96,-90,-88,610,170,1038,783,16,8.36
-2,-3,0,-2.0,-3.0,0.6208701133728027,114.34786471369249,96,-88,-85,610,170,1038,783,16,10.62
-2,-3,0,-2.0,-3.0,0.6288542747497559,110.82760622010359,96,-86,-82,610,170,1038,783,16,10.38
-4,-4,0,-4.0,-4.0,0.6369080543518066,105.17243480636087,96,-82,-78,610,170,1038,783,16,15.95
-3,-4,0,-3.0,-4.0,0.6448471546173096,100.2450922675019,96,-79,-74,610,170,1038,783,16,12.24
-3,-3,0,-3.0,-3.0,0.6530451774597168,96.00480758118829,96,-76,-71,610,170,1038,783,16,12.98
-2,-3,0,-2.0,-3.0,0.6608340740203857,92.4987562112089,96,-74,-68,610,170,1038,783,16,9.25
-4,-4,0,-4.0,-4.0,0.6688370704650879,86.847245611035,96,-70,-64,610,170,1038,783,16,13.88
-3,-3,0,-3.0,-3.0,0.6768372058868408,82.60905032059435,96,-67,-61,610,170,1038,783,16,11.77
-5,-4,0,-5.0,-4.0,0.6848201751708984,76.21995013059554,96,-62,-57,610,170,1038,783,16,13.26
-4,-4,0,-4.0,-4.0,0.69283127784729,70.56844150166147,96,-58,-53,610,170,1038,783,16,12.54
-4,-4,0,-4.0,-4.0,0.7008800506591797,64.91776189653656,96,-54,-49,610,170,1038,783,16,11.98
-5,-3,0,-5.0,-3.0,0.7088582515716553,59.208630398186216,96,-49,-46,610,170,1038,783,16,9.61
-3,-3,0,-3.0,-3.0,0.7168231010437012,54.96824596572466,96,-46,-43,610,170,1038,783,16,10.28
-4,-3,0,-4.0,-3.0,0.7250580787658691,50.0,96,-42,-40,610,170,1038,783,16,9.02
-5,-4,0,-5.0,-4.0,0.7330772876739502,43.62363799656123,96,-37,-36,610,170,1038,783,16,9.74
-4,-4,0,-4.0,-4.0,0.7408502101898193,37.967379738244816,96,-33,-32,610,170,1038,783,16,10.86
-4,-3,0,-4.0,-3.0,0.7488322257995605,33.012193308819754,96,-29,-29,610,170,1038,783,16,7.34
-4,-3,0,-4.0,-3.0,0.7568371295928955,28.069377593742864,96,-25,-26,610,170,1038,783,16,6.71
-4,-3,0,-4.0,-3.0,0.7648410797119141,23.144823004794873,96,-21,-23,610,170,1038,783,16,6.05
-4,-4,0,-4.0,-4.0,0.7729592323303223,17.495097567963924,96,-17,-19,610,170,1038,783,16,7.46
-4,-2,0,-4.0,-2.0,0.7808670997619629,13.400934559032695,96,-13,-17,610,170,1038,783,16,3.49
-3,-3,0,-3.0,-3.0,0.7888422012329102,9.204650534085253,96,-10,-14,610,170,1038,783,16,4.58
-2,-1,0,-2.0,-1.0,0.79683518409729,7.264337522473747,96,-8,-13,610,170,1038,783,16,1.9
-3,-1,0,-3.0,-1.0,0.8048772811889648,5.0,96,-5,-12,610,170,1038,783,16,1.07
-2,-1,0,-2.0,-1.0,0.8128480911254883,3.401754250991379,96,-3,-11,610,170,1038,783,16,0.82
-1,-1,0,-1.0,-1.0,0.8208372592926025,2.198039027185569,96,-2,-10,610,170,1038,783,16,1.28
-2,0,0,-2.0,-0.0,0.8288390636444092,2.0,96,0,-10,610,170,1038,783,16,-0.81
-1,-1,0,-1.0,-1.0,0.8368871212005615,1.0553851381374173,96,1,-9,610,170,1038,783,16,0.46
-1,0,0,-1.0,-0.0,0.8448481559753418,1.219544457292887,96,2,-9,610,170,1038,783,16,2.38
0,-1,0,-0.0,-1.0,0.8528232574462891,0.24621125123532117,96,2,-8,610,170,1038,783,16,2.4
-1,0,0,-1.0,-0.0,0.8693780899047852,0.5440037453175304,96,3,-8,610,170,1038,783,16,1.3
0,-1,0,-0.0,-1.0,0.8768482208251953,-0.38422689413609135,96,3,-7,610,170,1038,783,16,1.62
0,0,1,-0.0,-0.0,0.9638321399688721,-0.38422689413609135,96,3,-7,610,170,1038,783,16,26.82
0,-1,1,-0.0,-1.0,0.001317739486694336,899.3926970845904,97,867,332,1474,508,607,177,59,8.97
0,0,0,-0.0,-0.0,0.13035368919372559,899.3926970845904,97,867,332,1474,508,607,177,59,193.48
0,1,0,-0.0,1.0,0.20147371292114258,899.0355596635293,97,867,331,1474,508,607,177,59,1.63
4,6,0,4.0,6.0,0.20935273170471191,893.1680974746415,97,863,325,1474,508,607,177,59,18.19
9,9,0,9.0,9.0,0.21738481521606445,881.5888204892481,97,854,316,1474,508,607,177,59,32.09
12,9,0,12.0,9.0,0.2254016399383545,867.2215127969201,97,842,307,1474,508,607,177,59,38.09
15,11,0,15.0,11.0,0.23336076736450195,849.3763430329849,97,827,296,1474,508,607,177,59,44.19
19,9,0,19.0,9.0,0.24136781692504883,828.4572875659755,97,808,287,1474,508,607,177,59,50.17
22,8,0,22.0,8.0,0.2494356632232666,805.0485597373812,97,786,279,1474,508,607,177,59,55.63
23,6,0,23.0,6.0,0.2573966979980469,781.3690517289021,97,763,273,1474,508,607,177,59,52.88
28,7,0,28.0,7.0,0.26539158821105957,752.652736194277,97,735,266,1474,508,607,177,59,58.38
28,6,0,28.0,6.0,0.27353477478027344,724.2921080165384,97,707,260,1474,508,607,177,59,56.2
28,7,0,28.0,7.0,0.28145480155944824,695.6033397659716,97,679,253,1474,508,607,177,59,55.57
31,9,0,31.0,9.0,0.28946566581726074,663.4160598946272,97,648,244,1474,508,607,177,59,58.43
31,11,0,31.0,11.0,0.2973966598510742,630.5286195458086,97,617,233,1474,508,607,177,59,58.87
34,10,0,34.0,10.0,0.3053467273712158,595.1938801366127,97,583,223,1474,508,607,177,59,57.77
36,10,0,36.0,10.0,0.31342172622680664,558.0076660487493,97,547,213,1474,508,607,177,59,56.85
35,11,0,35.0,11.0,0.32147765159606934,521.4071220469444,97,512,202,1474,508,607,177,59,54.43
34,11,0,34.0,11.0,0.32935571670532227,485.7475109216168,97,478,191,1474,508,607,177,59,51.36
33,8,0,33.0,8.0,0.3374316692352295,452.1590173736745,97,445,183,1474,508,607,177,59,46.37
29,8,0,29.0,8.0,0.3456687927246094,422.3103145287065,97,416,175,1474,508,607,177,59,41.55
27,7,0,27.0,7.0,0.35350966453552246,394.72750677764594,97,389,168,1474,508,607,177,59,37.66
23,7,0,23.0,7.0,0.3615226745605469,370.8462204398086,97,366,161,1474,508,607,177,59,33.36
23,6,0,23.0,6.0,0.36941981315612793,347.3960679922148,97,343,155,1474,508,607,177,59,31.14
20,4,0,20.0,4.0,0.37734460830688477,327.5529413705628,97,323,151,1474,508,607,177,59,26.4
19,5,0,19.0,5.0,0.38544273376464844,308.24175304964837,97,304,146,1474,508,607,177,59,25.22
19,4,0,19.0,4.0,0.39334964752197266,289.4163940503064,97,285,142,1474,508,607,177,59,23.38
18,4,0,18.0,4.0,0.401519775390625,271.5544875725531,97,267,138,1474,508,607,177,59,21.6
17,3,0,17.0,3.0,0.4093196392059326,255.12145290350747,97,250,135,1474,508,607,177,59,19.28
16,4,0,16.0,4.0,0.4174017906188965,239.17345133327422,97,234,131,1474,508,607,177,59,18.34
14,4,0,14.0,4.0,0.4254136085510254,225.02558926218438,97,220,127,1474,508,607,177,59,16.35
11,3,0,11.0,3.0,0.4333317279815674,214.0164603478538,97,209,124,1474,508,607,177,59,13.24
9,2,0,9.0,2.0,0.44138169288635254,205.27334462119245,97,200,122,1474,508,607,177,59,10.76
6,3,0,6.0,3.0,0.4495368003845215,198.58954281776656,97,194,119,1474,508,607,177,59,10.58
4,2,0,4.0,2.0,0.4573957920074463,194.13448859376265,97,190,117,1474,508,607,177,59,8.45
3,3,0,3.0,3.0,0.46541476249694824,190.0091322296858,97,187,114,1474,508,607,177,59,6.78
4,4,0,4.0,4.0,0.4735586643218994,184.5158073773462,97,183,110,1474,508,607,177,59,7.84
3,4,0,3.0,4.0,0.48148465156555176,179.89231675674432,97,180,106,1474,508,607,177,59,6.33
4,4,0,4.0,4.0,0.48952579498291016,174.42074623793906,97,176,102,1474,508,607,177,59,7.5
2,4,0,2.0,4.0,0.4979057312011719,170.69977466186586,97,174,98,1474,508,607,177,59,4.81
2,3,0,2.0,3.0,0.5056717395782471,167.49173010587495,97,172,95,1474,508,607,177,59,4.65
2,3,0,2.0,3.0,0.5134286880493164,164.29769786523585,97,170,92,1474,508,607,177,59,4.56
2,4,0,2.0,4.0,0.5213947296142578,160.65231345807516,97,168,88,1474,508,607,177,59,4.51
3,4,0,3.0,4.0,0.5294187068939209,156.15128949051368,97,165,84,1474,508,607,177,59,5.55
2,4,0,2.0,4.0,0.5375256538391113,152.5736765062601,97,163,80,1474,508,607,177,59,4.26
2,4,0,2.0,4.0,0.5454986095428467,149.03651310896873,97,161,76,1474,508,607,177,59,4.14
3,5,0,3.0,5.0,0.5533947944641113,144.21951391226105,97,158,71,1474,508,607,177,59,5.11
3,5,0,3.0,5.0,0.561511754989624,139.46661390317072,97,155,66,1474,508,607,177,59,4.91
4,5,0,4.0,5.0,0.5694537162780762,133.85576440519384,97,151,61,1474,508,607,177,59,5.65
4,6,0,4.0,6.0,0.5775096416473389,127.95222202950808,97,147,55,1474,508,607,177,59,5.38
4,6,0,4.0,6.0,0.5854606628417969,122.16216457830973,97,143,49,1474,508,607,177,59,5.08
4,6,0,4.0,6.0,0.5933997631072998,116.49914089093448,97,139,43,1474,508,607,177,59,4.79
6,7,0,6.0,7.0,0.6013877391815186,108.78606605894515,97,133,36,1474,508,607,177,59,5.85
5,7,0,5.0,7.0,0.6093606948852539,102.24404748406687,97,128,29,1474,508,607,177,59,4.73
6,5,0,6.0,5.0,0.6173796653747559,95.33824833895642,97,122,24,1474,508,607,177,59,5.25
6,5,0,6.0,5.0,0.6253376007080078,88.5457357797381,97,116,19,1474,508,607,177,59,4.88
6,5,0,6.0,5.0,0.6334497928619385,81.8873302050329,97,110,14,1474,508,607,177,59,4.49
7,5,0,7.0,5.0,0.6490588188171387,74.39245620450265,97,103,9,1474,508,607,177,59,4.64
8,5,0,8.0,5.0,0.6493916511535645,66.08417323613851,97,95,4,1474,508,607,177,59,4.63
6,3,0,6.0,3.0,0.6575086116790771,60.00561780022652,97,89,1,1474,508,607,177,59,3.88
6,3,0,6.0,3.0,0.6653966903686523,54.02409288875127,97,83,-2,1474,508,607,177,59,3.54
6,3,0,6.0,3.0,0.673433780670166,48.1621668954417,97,77,-5,1474,508,607,177,59,3.18
6,2,0,6.0,2.0,0.6814577579498291,42.344235926947874,97,71,-7,1474,508,607,177,59,3.31
7,2,0,7.0,2.0,0.6894698143005371,35.6297145282261,97,64,-9,1474,508,607,177,59,3.26
6,2,0,6.0,2.0,0.6974287033081055,30.033888572581766,97,58,-11,1474,508,607,177,59,2.54
6,2,0,6.0,2.0,0.7054486274719238,24.600373133029585,97,52,-13,1474,508,607,177,59,2.15
5,2,0,5.0,2.0,0.7135066986083984,20.33558553417604,97,47,-15,1474,508,607,177,59,1.55
5,2,0,5.0,2.0,0.7213497161865234,16.310043036836767,97,42,-17,1474,508,607,177,59,1.22
6,2,0,6.0,2.0,0.7294278144836426,11.70626487409524,97,36,-19,1474,508,607,177,59,1.0
6,2,0,6.0,2.0,0.7376327514648438,7.61966684720111,97,30,-21,1474,508,607,177,59,0.56
4,2,0,4.0,2.0,0.7454407215118408,5.713109915419565,97,26,-23,1474,508,607,177,59,0.02
4,1,0,4.0,1.0,0.7535586357116699,3.557641192199412,97,22,-24,1474,508,607,177,59,0.18
3,1,0,3.0,1.0,0.7614696025848389,2.4006369362151645,97,19,-25,1474,508,607,177,59,-0.05
2,0,0,2.0,-0.0,0.7695705890655518,1.2324329156619491,97,17,-25,1474,508,607,177,59,0.46
1,0,0,1.0,-0.0,0.7773516178131104,0.6816441593116593,97,16,-25,1474,508,607,177,59,0.56
1,1,0,1.0,1.0,0.7855067253112793,1.0166620396072688,97,15,-26,1474,508,607,177,59,0.44
1,0,0,1.0,-0.0,0.7935097217559814,0.5296461204668006,97,14,-26,1474,508,607,177,59,0.45
0,0,1,-0.0,-0.0,0.8053896427154541,0.5296461204668006,97,14,-26,1474,508,607,177,59,27.09
0,0,0,-0.0,-0.0,0.08078551292419434,1287.5647500217804,98,-1303,202,157,736,1460,534,62,236.61
-1,0,0,-1.0,-0.0,0.1427924633026123,1286.5765632402545,98,-1302,202,157,736,1460,534,62,6.95
-2,1,0,-2.0,1.0,0.15087056159973145,1284.447072291394,98,-1300,201,157,736,1460,534,62,10.02
-3,1,0,-3.0,1.0,0.158935546875,1281.3296079872616,98,-1297,200,157,736,1460,534,62,14.18
-4,1,0,-4.0,1.0,0.16670846939086914,1277.2239869380167,98,-1293,199,157,736,1460,534,62,18.18
-5,1,0,-5.0,1.0,0.17484140396118164,1272.1300779277562,98,-1288,198,157,736,1460,534,62,22.11
-8,2,0,-8.0,2.0,0.1826953887939453,1263.9193025049863,98,-1280,196,157,736,1460,534,62,30.53
-10,2,0,-10.0,2.0,0.1907954216003418,1253.7318786423882,98,-1270,194,157,736,1460,534,62,36.69
-15,2,0,-15.0,2.0,0.19881343841552734,1238.6019061107304,98,-1255,192,157,736,1460,534,62,49.64
-19,4,0,-19.0,4.0,0.2069404125213623,1219.215981340824,98,-1236,188,157,736,1460,534,62,57.54
-22,5,0,-22.0,5.0,0.21494650840759277,1196.7153578904192,98,-1214,183,157,736,1460,534,62,62.85
-22,6,0,-22.0,6.0,0.22283434867858887,1174.069707527328,98,-1192,177,157,736,1460,534,62,61.89
-24,6,0,-24.0,6.0,0.230851411819458,1149.4511849288813,98,-1168,171,157,736,1460,534,62,64.99
-24,7,0,-24.0,7.0,0.23911833763122559,1124.695461616078,98,-1144,164,157,736,1460,534,62,64.02
-25,6,0,-25.0,6.0,0.24686741828918457,1099.0995531368021,98,-1119,158,157,736,1460,534,62,65.16
-25,7,0,-25.0,7.0,0.2548503875732422,1073.3717671146796,98,-1094,151,157,736,1460,534,62,64.08
-29,7,0,-29.0,7.0,0.2627873420715332,1043.6911184149612,98,-1065,144,157,736,1460,534,62,69.64
-31,7,0,-31.0,7.0,0.2708854675292969,1012.0364327289819,98,-1034,137,157,736,1460,534,62,71.46
-34,8,0,-34.0,8.0,0.2788975238800049,977.2861696958855,98,-1000,129,157,736,1460,534,62,74.04
-38,7,0,-38.0,7.0,0.28682756423950195,938.7051098143188,98,-962,122,157,736,1460,534,62,77.76
-39,8,0,-39.0,8.0,0.2948615550994873,899.0134407630892,98,-923,114,157,736,1460,534,62,76.7
-38,9,0,-38.0,9.0,0.30272841453552246,860.2070466507769,98,-885,105,157,736,1460,534,62,73.34
-37,8,0,-37.0,8.0,0.31086039543151855,822.5297300035893,98,-848,97,157,736,1460,534,62,70.41
-35,9,0,-35.0,9.0,0.3187594413757324,786.7487389167898,98,-813,88,157,736,1460,534,62,66.04
-31,6,0,-31.0,6.0,0.326871395111084,755.2874792338995,98,-782,82,157,736,1460,534,62,60.23
-31,6,0,-31.0,6.0,0.33479738235473633,723.8357437217716,98,-751,76,157,736,1460,534,62,58.68
-29,6,0,-29.0,6.0,0.34290337562561035,694.3854147968513,98,-722,70,157,736,1460,534,62,54.73
-28,3,0,-28.0,3.0,0.35091257095336914,666.2266489456639,98,-694,67,157,736,1460,534,62,54.26
-28,4,0,-28.0,4.0,0.3588094711303711,637.9730936293328,98,-666,63,157,736,1460,534,62,51.67
-27,3,0,-27.0,3.0,0.36679553985595703,610.8107197608965,98,-639,60,157,736,1460,534,62,50.14
-29,2,0,-29.0,2.0,0.37496137619018555,581.7511729894934,98,-610,58,157,736,1460,534,62,50.41
-30,2,0,-30.0,2.0,0.38293933868408203,551.6971769281193,98,-580,56,157,736,1460,534,62,49.71
-32,3,0,-32.0,3.0,0.3914153575897217,519.5569906921535,98,-548,53,157,736,1460,534,62,51.39
-33,3,0,-33.0,3.0,0.3989083766937256,486.42149162940655,98,-515,50,157,736,1460,534,62,50.02
-31,3,0,-31.0,3.0,0.40715837478637695,455.2766702197423,98,-484,47,157,736,1460,534,62,47.0
-29,3,0,-29.0,3.0,0.4147794246673584,426.1225218691374,98,-455,44,157,736,1460,534,62,42.91
-28,4,0,-28.0,4.0,0.4228813648223877,397.86944400365013,98,-427,40,157,736,1460,534,62,38.71
-24,3,0,-24.0,3.0,0.4308595657348633,373.6949468426805,98,-403,37,157,736,1460,534,62,34.28
-23,3,0,-23.0,3.0,0.43889451026916504,350.5180205442464,98,-380,34,157,736,1460,534,62,31.9
-21,1,0,-21.0,1.0,0.44687938690185547,329.51352263126,98,-359,33,157,736,1460,534,62,28.8
-18,1,0,-18.0,1.0,0.4547715187072754,311.49817517762045,98,-341,32,157,736,1460,534,62,25.45
-18,1,0,-18.0,1.0,0.46292543411254883,293.48420608713764,98,-323,31,157,736,1460,534,62,24.5
-20,1,0,-20.0,1.0,0.47088146209716797,273.48152653322006,98,-303,30,157,736,1460,534,62,24.81
-18,1,0,-18.0,1.0,0.4789724349975586,255.47163908491882,98,-285,29,157,736,1460,534,62,22.39
-21,0,0,-21.0,-0.0,0.4869093894958496,234.5880268385606,98,-264,29,157,736,1460,534,62,22.14
-21,0,0,-21.0,-0.0,0.49478936195373535,213.72433471152803,98,-243,29,157,736,1460,534,62,20.72
-22,0,0,-22.0,-0.0,0.5028164386749268,191.89459392277777,98,-221,29,157,736,1460,534,62,19.72
-21,0,0,-21.0,-0.0,0.5108983516693115,171.09156340629363,98,-200,29,157,736,1460,534,62,17.63
-20,0,0,-20.0,-0.0,0.5188775062561035,151.3211452355431,98,-180,29,157,736,1460,534,62,15.64
-17,0,0,-17.0,-0.0,0.5268163681030273,134.55965692160635,98,-163,29,157,736,1460,534,62,13.0
-15,-1,0,-15.0,-1.0,0.5348074436187744,120.00993344810135,98,-148,30,157,736,1460,534,62,10.54
-13,0,0,-13.0,-0.0,0.5428144931793213,107.2931668593933,98,-135,30,157,736,1460,534,62,9.32
-12,0,0,-12.0,-0.0,0.5509054660797119,95.60568707605516,98,-123,30,157,736,1460,534,62,8.17
-8,0,0,-8.0,-0.0,0.5593554973602295,87.84864324004712,98,-115,30,157,736,1460,534,62,6.16
-5,0,0,-5.0,-0.0,0.5668325424194336,83.0175425099138,98,-110,30,157,736,1460,534,62,4.74
-3,0,0,-3.0,-0.0,0.5748064517974854,80.12605455067681,98,-107,30,157,736,1460,534,62,3.84
-1,0,0,-1.0,-0.0,0.5988883972167969,79.16351483136329,98,-106,30,157,736,1460,534,62,2.99
-1,0,0,-1.0,-0.0,0.6069583892822266,78.20164833920778,98,-105,30,157,736,1460,534,62,2.97
-2,-1,0,-2.0,-1.0,0.6229064464569092,76.56393447619885,98,-103,31,157,736,1460,534,62,1.82
-4,0,0,-4.0,-0.0,0.6308004856109619,72.74005976477939,98,-99,31,157,736,1460,534,62,3.93
-3,0,0,-3.0,-0.0,0.6387465000152588,69.88111815399351,98,-96,31,157,736,1460,534,62,3.48
-4,0,0,-4.0,-0.0,0.6468675136566162,66.082439194738,98,-92,31,157,736,1460,534,62,3.68
-6,0,0,-6.0,-0.0,0.6549365520477295,60.4166286842826,98,-86,31,157,736,1460,534,62,4.05
-6,0,0,-6.0,-0.0,0.662745475769043,54.7962703152066,98,-80,31,157,736,1460,534,62,3.77
-5,0,0,-5.0,-0.0,0.6708345413208008,50.15417426109393,98,-75,31,157,736,1460,534,62,3.29
-6,0,0,-6.0,-0.0,0.6788265705108643,44.64390259630977,98,-69,31,157,736,1460,534,62,3.23
-6,0,0,-6.0,-0.0,0.6869335174560547,39.21395872616783,98,-63,31,157,736,1460,534,62,2.93
-6,0,0,-6.0,-0.0,0.6949114799499512,33.88451279003334,98,-57,31,157,736,1460,534,62,2.61
-6,0,0,-6.0,-0.0,0.7026975154876709,28.682493245507096,98,-51,31,157,736,1460,534,62,2.27
-5,0,0,-5.0,-0.0,0.710944414138794,24.470712993434653,98,-46,31,157,736,1460,534,62,1.88
-4,1,0,-4.0,1.0,0.7188193798065186,20.61395160225576,98,-42,30,157,736,1460,534,62,2.41
-5,1,0,-5.0,1.0,0.7269034385681152,16.010637094172637,98,-37,29,157,736,1460,534,62,2.02
-3,1,0,-3.0,1.0,0.7349305152893066,13.045431091090478,98,-34,28,157,736,1460,534,62,2.18
-3,0,0,-3.0,-0.0,0.7428584098815918,10.773197148410844,98,-31,28,157,736,1460,534,62,1.06
-3,1,0,-3.0,1.0,0.7508933544158936,7.897300677553446,98,-28,27,157,736,1460,534,62,1.77
-5,1,0,-5.0,1.0,0.7588503360748291,3.7131099154195653,98,-23,26,157,736,1460,534,62,1.06
-5,1,0,-5.0,1.0,0.7667803764343262,-0.1941563985012742,98,-18,25,157,736,1460,534,62,0.67
-5,1,0,-5.0,1.0,0.7748353481292725,-3.7053118720876377,98,-13,24,157,736,1460,534,62,0.27
-5,0,0,-5.0,-0.0,0.7829043865203857,-5.701778718652964,98,-8,24,157,736,1460,534,62,-0.43
-3,0,0,-3.0,-0.0,0.7908935546875,-6.484698655737475,98,-5,24,157,736,1460,534,62,-0.37
-1,1,0,-1.0,1.0,0.7988324165344238,-7.6547649401424955,98,-4,23,157,736,1460,534,62,1.06
0,0,1,-0.0,-0.0,-0.001016855239868164,1465.7074930959407,99,1485,105,1646,818,161,713,47,253.62
-1,0,1,-1.0,-0.0,0.004897356033325195,1466.705004354889,99,1486,105,1646,818,161,713,47,9.46
-1,0,1,-1.0,-0.0,0.009908199310302734,1467.7025189487003,99,1487,105,1646,818,161,713,47,9.46
0,0,0,-0.0,-0.0,0.10287022590637207,1467.7025189487003,99,1487,105,1646,818,161,713,47,253.8
2,0,0,2.0,-0.0,0.1300961971282959,1465.7074930959407,99,1485,105,1646,818,161,713,47,14.35
4,0,0,4.0,-0.0,0.1379091739654541,1461.7174815432058,99,1481,105,1646,818,161,713,47,23.58
5,-1,0,5.0,-1.0,0.14590835571289062,1456.8013380180462,99,1476,106,1646,818,161,713,47,25.88
4,-1,0,4.0,-1.0,0.15398526191711426,1452.8838030143158,99,1472,107,1646,818,161,713,47,21.26
5,-2,0,5.0,-2.0,0.16194820404052734,1448.0438470691483,99,1467,109,1646,818,161,713,47,24.75
5,-2,0,5.0,-2.0,0.1699681282043457,1443.2076933367932,99,1462,111,1646,818,161,713,47,24.69
9,-2,0,9.0,-2.0,0.17795419692993164,1434.3873884455018,99,1453,113,1646,818,161,713,47,40.97
11,-2,0,11.0,-2.0,0.18604326248168945,1423.5783767221187,99,1442,115,1646,818,161,713,47,48.02
15,-2,0,15.0,-2.0,0.19451212882995605,1408.788392186499,99,1427,117,1646,818,161,713,47,60.65
18,0,0,18.0,-0.0,0.20198416709899902,1390.849355483108,99,1409,117,1646,818,161,713,47,70.29
23,0,0,23.0,-0.0,0.2098853588104248,1367.9295453041466,99,1386,117,1646,818,161,713,47,81.89
27,0,0,27.0,-0.0,0.21802616119384766,1341.0271258299815,99,1359,117,1646,818,161,713,47,89.51
32,1,0,32.0,1.0,0.22587919235229492,1309.0604340644609,99,1327,116,1646,818,161,713,47,98.31
34,1,0,34.0,1.0,0.23408818244934082,1275.1040019967584,99,1293,115,1646,818,161,713,47,100.21
37,1,0,37.0,1.0,0.2420961856842041,1238.1629553709545,99,1256,114,1646,818,161,713,47,103.18
39,3,0,39.0,3.0,0.2499241828918457,1199.051553740676,99,1217,111,1646,818,161,713,47,105.97
39,1,0,39.0,1.0,0.25799131393432617,1160.1246764394698,99,1178,110,1646,818,161,713,47,102.3
38,2,0,38.0,2.0,0.2666141986846924,1122.1043620561402,99,1140,108,1646,818,161,713,47,99.75
37,1,0,37.0,1.0,0.2739582061767578,1085.1777835708492,99,1103,107,1646,818,161,713,47,95.84
35,1,0,35.0,1.0,0.2820162773132324,1050.2474085689655,99,1068,106,1646,818,161,713,47,91.32
33,0,0,33.0,-0.0,0.2899012565612793,1017.413859961506,99,1035,106,1646,818,161,713,47,86.23
33,0,0,33.0,-0.0,0.2979552745819092,984.5911869404179,99,1002,106,1646,818,161,713,47,84.59
35,0,0,35.0,-0.0,0.3059842586517334,949.7923725029921,99,967,106,1646,818,161,713,47,85.56
33,0,0,33.0,-0.0,0.31392621994018555,916.9957446712192,99,934,106,1646,818,161,713,47,81.09
36,0,0,36.0,-0.0,0.32199835777282715,881.2344828638201,99,898,106,1646,818,161,713,47,83.06
36,1,0,36.0,1.0,0.3299872875213623,845.3714642939391,99,862,105,1646,818,161,713,47,81.49
38,2,0,38.0,2.0,0.33809733390808105,807.4125480747506,99,824,103,1646,818,161,713,47,82.08
37,1,0,37.0,1.0,0.3459141254425049,770.5823838770616,99,787,102,1646,818,161,713,47,78.15
35,2,0,35.0,2.0,0.3539621829986572,735.6197993725184,99,752,100,1646,818,161,713,47,74.31
34,3,0,34.0,3.0,0.3618903160095215,701.5226014418046,99,718,97,1646,818,161,713,47,71.83
30,4,0,30.0,4.0,0.3700902462005615,671.2571569670708,99,688,93,1646,818,161,713,47,67.54
28,5,0,28.0,5.0,0.3780081272125244,642.8408218185484,99,660,88,1646,818,161,713,47,61.65
28,8,0,28.0,8.0,0.38596415519714355,614.0431696517905,99,632,80,1646,818,161,713,47,58.89
26,6,0,26.0,6.0,0.3940403461456299,587.5014332497509,99,606,74,1646,818,161,713,47,55.09
25,6,0,25.0,6.0,0.40184926986694336,561.9658109667607,99,581,68,1646,818,161,713,47,52.22
24,4,0,24.0,4.0,0.4099862575531006,537.6647839841557,99,557,64,1646,818,161,713,47,50.35
23,5,0,23.0,5.0,0.41805315017700195,514.2494765004429,99,534,59,1646,818,161,713,47,47.05
24,3,0,24.0,3.0,0.42594218254089355,490.06529798847237,99,510,56,1646,818,161,713,47,48.64
25,3,0,25.0,3.0,0.43402624130249023,464.88728206420797,99,485,53,1646,818,161,713,47,48.48
24,3,0,24.0,3.0,0.4419882297515869,440.7035691042285,99,461,50,1646,818,161,713,47,45.55
23,2,0,23.0,2.0,0.4499671459197998,417.62228722569176,99,438,48,1646,818,161,713,47,42.64
23,2,0,23.0,2.0,0.4579322338104248,394.5416146924759,99,415,46,1646,818,161,713,47,41.12
23,2,0,23.0,2.0,0.46597814559936523,371.4616584663204,99,392,44,1646,818,161,713,47,39.57
20,3,0,20.0,3.0,0.4739091396331787,351.25258850140233,99,372,41,1646,818,161,713,47,34.9
20,3,0,20.0,3.0,0.48189616203308105,331.04519485512014,99,352,38,1646,818,161,713,47,33.57
17,3,0,17.0,3.0,0.4901301860809326,313.82339586198583,99,335,35,1646,818,161,713,47,28.86
17,4,0,17.0,4.0,0.49785614013671875,296.50743340335606,99,318,31,1646,818,161,713,47,27.12
15,3,0,15.0,3.0,0.5059792995452881,281.2909791630373,99,303,28,1646,818,161,713,47,24.44
14,2,0,14.0,2.0,0.513911247253418,267.1671931835162,99,289,26,1646,818,161,713,47,23.43
13,2,0,13.0,2.0,0.5218312740325928,254.04151313476467,99,276,24,1646,818,161,713,47,21.44
13,2,0,13.0,2.0,0.5299322605133057,240.91854804086807,99,263,22,1646,818,161,713,47,20.7
12,1,0,12.0,1.0,0.5379703044891357,228.87695408671274,99,251,21,1646,818,161,713,47,21.72
11,0,0,11.0,-0.0,0.5459733009338379,217.91699815496622,99,240,21,1646,818,161,713,47,17.16
10,0,0,10.0,-0.0,0.5540482997894287,207.95670589961227,99,230,21,1646,818,161,713,47,15.69
9,0,0,9.0,-0.0,0.5619933605194092,198.9954954497951,99,221,21,1646,818,161,713,47,14.29
8,0,0,8.0,-0.0,0.5697872638702393,191.03270778084362,99,213,21,1646,818,161,713,47,12.96
7,0,0,7.0,-0.0,0.5778331756591797,184.06762180505189,99,206,21,1646,818,161,713,47,11.69
8,0,0,8.0,-0.0,0.58585524559021,176.11052207254141,99,198,21,1646,818,161,713,47,12.29
6,0,0,6.0,-0.0,0.5938332080841064,170.14502323383846,99,192,21,1646,818,161,713,47,10.19
7,0,0,7.0,-0.0,0.6019902229309082,163.18807695446023,99,185,21,1646,818,161,713,47,10.82
6,0,0,6.0,-0.0,0.6098003387451172,157.22763384120648,99,179,21,1646,818,161,713,47,9.69
8,0,0,8.0,-0.0,0.61794114112854,149.28464818433474,99,171,21,1646,818,161,713,47,11.02
8,1,0,8.0,1.0,0.6259453296661377,141.2224101637776,99,163,20,1646,818,161,713,47,13.99
9,1,0,9.0,1.0,0.6338412761688232,132.16765126791086,99,154,19,1646,818,161,713,47,13.59
11,0,0,11.0,-0.0,0.6418333053588867,121.25671561490648,99,143,19,1646,818,161,713,47,11.63
11,1,0,11.0,1.0,0.64984130859375,110.22161986704711,99,132,18,1646,818,161,713,47,12.44
10,0,0,10.0,-0.0,0.657839298248291,100.32072007574396,99,122,18,1646,818,161,713,47,9.76
9,1,0,9.0,1.0,0.6658291816711426,91.27160627207444,99,113,17,1646,818,161,713,47,10.51
9,0,0,9.0,-0.0,0.6739871501922607,82.38026380684383,99,104,17,1646,818,161,713,47,8.16
8,0,0,8.0,-0.0,0.6819851398468018,74.49358953285082,99,96,17,1646,818,161,713,47,7.2
5,0,0,5.0,-0.0,0.6899683475494385,69.57429448826494,99,91,17,1646,818,161,713,47,5.57
5,0,0,5.0,-0.0,0.6978001594543457,64.66413177577246,99,86,17,1646,818,161,713,47,5.33
3,0,0,3.0,-0.0,0.7059552669525146,61.72307831990054,99,83,17,1646,818,161,713,47,4.34
1,0,0,1.0,-0.0,0.7139363288879395,60.74365647617735,99,82,17,1646,818,161,713,47,3.43
2,0,0,2.0,-0.0,0.7217903137207031,58.78630692236935,99,80,17,1646,818,161,713,47,3.81
3,0,0,3.0,-0.0,0.7298531532287598,55.854296014865284,99,77,17,1646,818,161,713,47,4.11
3,0,0,3.0,-0.0,0.7379062175750732,52.92759709091287,99,74,17,1646,818,161,713,47,3.99
3,0,0,3.0,-0.0,0.745779275894165,50.00684899377592,99,71,17,1646,818,161,713,47,3.87
3,0,0,3.0,-0.0,0.7538981437683105,47.092795635500224,99,68,17,1646,818,161,713,47,3.74
4,1,0,4.0,1.0,0.7618331909179688,42.96969000988257,99,64,16,1646,818,161,713,47,8.52
4,0,0,4.0,-0.0,0.7698922157287598,39.0966987850401,99,60,16,1646,818,161,713,47,3.74
