dx,dy,button,rx,ry,time,distance,targetID,directionX,directionY,targetX,targetY,initMouseX,initMouseY,targetSize,score
1,0,0,1.0,-0.0,0.22835397720336914,477.0461193637361,1,473,62,1434,662,960,600,20,131.34
4,2,0,4.0,2.0,0.23624300956726074,472.8223767970378,1,469,60,1434,662,960,600,20,23.8
6,2,0,6.0,2.0,0.24426603317260742,466.61868800981387,1,463,58,1434,662,960,600,20,31.96
7,3,0,7.0,3.0,0.253587007522583,459.3049096188718,1,456,55,1434,662,960,600,20,34.89
10,3,0,10.0,3.0,0.2602880001068115,449.02115763068446,1,446,52,1434,662,960,600,20,43.57
15,4,0,15.0,4.0,0.268373966217041,433.66461695646785,1,431,48,1434,662,960,600,20,53.79
17,5,0,17.0,5.0,0.27631187438964844,416.22710147226115,1,414,43,1434,662,960,600,20,55.63
20,7,0,20.0,7.0,0.284229040145874,395.64125164092786,1,394,36,1434,662,960,600,20,57.87
24,6,0,24.0,6.0,0.29224085807800293,371.2142238654117,1,370,30,1434,662,960,600,20,60.37
28,7,0,28.0,7.0,0.3002359867095947,342.7725193185708,1,342,23,1434,662,960,600,20,60.7
33,6,0,33.0,6.0,0.30831098556518555,309.46728421595714,1,309,17,1434,662,960,600,20,60.43
30,5,0,30.0,5.0,0.31627488136291504,279.2579452764057,1,279,12,1434,662,960,600,20,54.36
29,4,0,29.0,4.0,0.32425594329833984,250.12796724876648,1,250,8,1434,662,960,600,20,49.86
25,2,0,25.0,2.0,0.3323359489440918,225.07998578283232,1,225,6,1434,662,960,600,20,44.57
24,2,0,24.0,2.0,0.3409569263458252,201.03979705520993,1,201,4,1434,662,960,600,20,40.38
22,0,0,22.0,-0.0,0.3487050533294678,179.0446871593793,1,179,4,1434,662,960,600,20,37.18
20,1,0,20.0,1.0,0.35790491104125977,159.02829936838285,1,159,3,1434,662,960,600,20,32.75
18,0,0,18.0,-0.0,0.36440587043762207,141.0319112825179,1,141,3,1434,662,960,600,20,29.37
16,0,0,16.0,-0.0,0.37239885330200195,125.03599481749245,1,125,3,1434,662,960,600,20,25.78
14,-1,0,14.0,-1.0,0.38023900985717773,111.07204868912791,1,111,4,1434,662,960,600,20,20.77
11,-1,0,11.0,-1.0,0.38823795318603516,100.12492197250393,1,100,5,1434,662,960,600,20,16.89
10,-1,0,10.0,-1.0,0.3962368965148926,90.19977827023745,1,90,6,1434,662,960,600,20,14.81
7,-1,0,7.0,-1.0,0.4042658805847168,83.2946576918352,1,83,7,1434,662,960,600,20,11.21
6,-1,0,6.0,-1.0,0.4126160144805908,77.41446893184762,1,77,8,1434,662,960,600,20,9.57
5,-2,0,5.0,-2.0,0.4202399253845215,72.69112738154499,1,72,10,1434,662,960,600,20,7.21
3,-1,0,3.0,-1.0,0.4282338619232178,69.87131027825369,1,69,11,1434,662,960,600,20,5.25
2,-1,0,2.0,-1.0,0.43665099143981934,68.06614430096654,1,67,12,1434,662,960,600,20,3.63
2,-1,0,2.0,-1.0,0.44429898262023926,66.2872536767062,1,65,13,1434,662,960,600,20,3.5
1,-1,0,1.0,-1.0,0.4543769359588623,65.5133574166368,1,64,14,1434,662,960,600,20,1.69
1,0,0,1.0,-0.0,0.46089696884155273,64.53681120105021,1,63,14,1434,662,960,600,20,4.1
1,-1,0,1.0,-1.0,0.4682478904724121,63.788713735268246,1,62,15,1434,662,960,600,20,1.6
1,0,0,1.0,-0.0,0.49230384826660156,62.81719509815764,1,61,15,1434,662,960,600,20,3.94
1,0,0,1.0,-0.0,0.5002648830413818,61.84658438426491,1,60,15,1434,662,960,600,20,3.9
2,0,0,2.0,-0.0,0.5253069400787354,59.90826320300064,1,58,15,1434,662,960,600,20,4.86
1,0,0,1.0,-0.0,0.5322680473327637,58.9406481131655,1,57,15,1434,662,960,600,20,3.78
2,0,0,2.0,-0.0,0.5402610301971436,57.0087712549569,1,55,15,1434,662,960,600,20,4.69
2,1,0,2.0,1.0,0.5484869480133057,54.817880294662984,1,53,14,1434,662,960,600,20,5.22
3,0,0,3.0,-0.0,0.5563008785247803,51.92301994298868,1,50,14,1434,662,960,600,20,5.33
3,1,0,3.0,1.0,0.5642518997192383,48.76474136094644,1,47,13,1434,662,960,600,20,7.57
3,0,0,3.0,-0.0,0.5723199844360352,45.880278987817846,1,44,13,1434,662,960,600,20,4.97
2,0,0,2.0,-0.0,0.580406904220581,43.965895873961216,1,42,13,1434,662,960,600,20,4.07
3,1,0,3.0,1.0,0.5884449481964111,40.80441152620633,1,39,12,1434,662,960,600,20,8.06
3,0,0,3.0,-0.0,0.5966629981994629,37.94733192202055,1,36,12,1434,662,960,600,20,4.39
2,1,0,2.0,1.0,0.6042690277099609,35.73513677041127,1,34,11,1434,662,960,600,20,4.91
2,0,0,2.0,-0.0,0.6133480072021484,33.83784863137726,1,32,11,1434,662,960,600,20,3.54
3,1,0,3.0,1.0,0.6202728748321533,30.675723300355934,1,29,10,1434,662,960,600,20,8.25
2,1,0,2.0,1.0,0.6285760402679443,28.460498941515414,1,27,9,1434,662,960,600,20,4.67
2,0,0,2.0,-0.0,0.6365079879760742,26.570660511172846,1,25,9,1434,662,960,600,20,3.17
2,1,0,2.0,1.0,0.644258975982666,24.351591323771842,1,23,8,1434,662,960,600,20,4.6
2,1,0,2.0,1.0,0.652756929397583,22.135943621178654,1,21,7,1434,662,960,600,20,4.35
2,0,0,2.0,-0.0,0.660254955291748,20.248456731316587,1,19,7,1434,662,960,600,20,2.83
1,1,0,1.0,1.0,0.6682419776916504,18.973665961010276,1,18,6,1434,662,960,600,20,2.15
3,0,0,3.0,-0.0,0.6762619018554688,16.15549442140351,1,15,6,1434,662,960,600,20,2.78
2,1,0,2.0,1.0,0.6857829093933105,13.92838827718412,1,13,5,1434,662,960,600,20,4.34
3,1,0,3.0,1.0,0.6922519207000732,10.770329614269007,1,10,4,1434,662,960,600,20,4.99
2,0,0,2.0,-0.0,0.7002420425415039,8.94427190999916,1,8,4,1434,662,960,600,20,1.59
2,0,0,2.0,-0.0,0.7082579135894775,7.211102550927978,1,6,4,1434,662,960,600,20,1.01
2,1,0,2.0,1.0,0.7177050113677979,5.0,1,4,3,1434,662,960,600,20,2.49
1,0,0,1.0,-0.0,0.7245039939880371,4.242640687119285,1,3,3,1434,662,960,600,20,0.17
1,0,0,1.0,-0.0,0.732374906539917,3.605551275463989,1,2,3,1434,662,960,600,20,-0.32
1,0,0,1.0,-0.0,0.740433931350708,3.1622776601683795,1,1,3,1434,662,960,600,20,-0.83
0,0,1,-0.0,-0.0,0.8062698841094971,3.1622776601683795,1,1,3,1434,662,960,600,20,27.86
0,0,0,-0.0,-0.0,0.06344866752624512,767.4144903505537,2,-757,-126,676,533,1433,659,71,176.25
0,1,0,-0.0,1.0,0.06777763366699219,767.5793118629501,2,-757,-127,676,533,1433,659,71,13.64
-1,0,0,-1.0,-0.0,0.13144159317016602,766.5931124136193,2,-756,-127,676,533,1433,659,71,5.55
-1,0,0,-1.0,-0.0,0.13941454887390137,765.6069487667938,2,-755,-127,676,533,1433,659,71,5.55
-1,0,0,-1.0,-0.0,0.1554265022277832,764.6208210610015,2,-754,-127,676,533,1433,659,71,5.55
-1,0,0,-1.0,-0.0,0.16339564323425293,763.6347294354808,2,-753,-127,676,533,1433,659,71,5.54
-2,0,0,-2.0,-0.0,0.17142868041992188,761.6626549857883,2,-751,-127,676,533,1433,659,71,7.77
-1,0,0,-1.0,-0.0,0.18000149726867676,760.6766724436868,2,-750,-127,676,533,1433,659,71,5.53
-4,0,0,-4.0,-0.0,0.18740463256835938,756.7331101517892,2,-746,-127,676,533,1433,659,71,12.02
-7,0,0,-7.0,-0.0,0.19556164741516113,749.8333148106984,2,-739,-127,676,533,1433,659,71,17.92
-10,1,0,-10.0,1.0,0.20355558395385742,740.1520114138716,2,-729,-128,676,533,1433,659,71,22.33
-14,0,0,-14.0,-0.0,0.21142053604125977,726.366987135291,2,-715,-128,676,533,1433,659,71,29.61
-17,0,0,-17.0,-0.0,0.21940159797668457,709.6393450197079,2,-698,-128,676,533,1433,659,71,33.68
-20,2,0,-20.0,2.0,0.22783946990966797,690.3506355468936,2,-678,-130,676,533,1433,659,71,36.12
-30,0,0,-30.0,-0.0,0.2354755401611328,660.9114918050676,2,-648,-130,676,533,1433,659,71,47.84
-36,-2,0,-36.0,-2.0,0.24358057975769043,625.2423530120141,2,-612,-128,676,533,1433,659,71,52.69
-39,-3,0,-39.0,-3.0,0.2514524459838867,586.4759159590443,2,-573,-125,676,533,1433,659,71,53.4
-35,-4,0,-35.0,-4.0,0.25940465927124023,551.4390265478133,2,-538,-121,676,533,1433,659,71,48.63
-37,-5,0,-37.0,-5.0,0.2674076557159424,514.2538283766102,2,-501,-116,676,533,1433,659,71,48.45
-36,-6,0,-36.0,-6.0,0.27551746368408203,477.83365306349026,2,-465,-110,676,533,1433,659,71,46.1
-35,-6,0,-35.0,-6.0,0.2834146022796631,442.3980108454377,2,-430,-104,676,533,1433,659,71,43.19
-33,-6,0,-33.0,-6.0,0.29175662994384766,408.91686196585243,2,-397,-98,676,533,1433,659,71,39.81
-34,-9,0,-34.0,-9.0,0.3003394603729248,373.75125417849773,2,-363,-89,676,533,1433,659,71,40.05
-31,-8,0,-31.0,-8.0,0.3074214458465576,341.73820389298004,2,-332,-81,676,533,1433,659,71,36.18
-28,-7,0,-28.0,-7.0,0.3153996467590332,312.87697262662203,2,-304,-74,676,533,1433,659,71,32.81
-24,-6,0,-24.0,-6.0,0.32342052459716797,288.13885541523206,2,-280,-68,676,533,1433,659,71,28.56
-20,-5,0,-20.0,-5.0,0.3314356803894043,267.52383071420013,2,-260,-63,676,533,1433,659,71,24.58
-16,-6,0,-16.0,-6.0,0.33940649032592773,250.56935167733502,2,-244,-57,676,533,1433,659,71,18.24
-12,-5,0,-12.0,-5.0,0.3474135398864746,237.7561776274173,2,-232,-52,676,533,1433,659,71,14.33
-8,-5,0,-8.0,-5.0,0.3562955856323242,228.87769659798658,2,-224,-47,676,533,1433,659,71,10.06
-3,-3,0,-3.0,-3.0,0.36342549324035645,225.33752461585266,2,-221,-44,676,533,1433,659,71,4.8
-1,-2,0,-1.0,-2.0,0.37143564224243164,223.9732126840172,2,-220,-42,676,533,1433,659,71,2.17
-1,0,0,-1.0,-0.0,0.37946248054504395,222.9910312097776,2,-219,-42,676,533,1433,659,71,4.02
0,-1,0,-0.0,-1.0,0.387439489364624,222.80484734403782,2,-219,-41,676,533,1433,659,71,0.46
0,-2,0,-0.0,-2.0,0.39708757400512695,222.4454989429995,2,-219,-39,676,533,1433,659,71,0.59
0,-1,0,-0.0,-1.0,0.40371060371398926,222.27235545609355,2,-219,-38,676,533,1433,659,71,0.44
0,-1,0,-0.0,-1.0,0.4114224910736084,222.10357943986403,2,-219,-37,676,533,1433,659,71,0.43
0,-1,0,-0.0,-1.0,0.4196956157684326,221.93918085818015,2,-219,-36,676,533,1433,659,71,0.42
-1,-2,0,-1.0,-2.0,0.43944358825683594,220.6354459283458,2,-218,-34,676,533,1433,659,71,2.04
-1,-1,0,-1.0,-1.0,0.4438955783843994,219.49487465542333,2,-217,-33,676,533,1433,659,71,2.48
-2,-2,0,-2.0,-2.0,0.4513986110687256,217.2233873228203,2,-215,-31,676,533,1433,659,71,3.47
-2,-1,0,-2.0,-1.0,0.4594905376434326,215.10230124292022,2,-213,-30,676,533,1433,659,71,4.29
-2,-2,0,-2.0,-2.0,0.4674546718597412,212.8497122384712,2,-211,-28,676,533,1433,659,71,3.39
-2,-2,0,-2.0,-2.0,0.47562456130981445,210.61101585624624,2,-209,-26,676,533,1433,659,71,3.34
-4,-1,0,-4.0,-1.0,0.4834785461425781,206.51876428063383,2,-205,-25,676,533,1433,659,71,7.17
-4,-2,0,-4.0,-2.0,0.49455761909484863,202.3116407921205,2,-201,-23,676,533,1433,659,71,5.79
-5,-1,0,-5.0,-1.0,0.49944162368774414,197.2308292331602,2,-196,-22,676,533,1433,659,71,8.27
-6,-1,0,-6.0,-1.0,0.5075094699859619,191.15700353374447,2,-190,-21,676,533,1433,659,71,9.42
-6,-2,0,-6.0,-2.0,0.515845537185669,184.97837711473198,2,-184,-19,676,533,1433,659,71,7.6
-8,-1,0,-8.0,-1.0,0.5234756469726562,176.91806012954132,2,-176,-18,676,533,1433,659,71,11.41
-9,-1,0,-9.0,-1.0,0.5318465232849121,167.86303941010956,2,-167,-17,676,533,1433,659,71,12.48
-10,-1,0,-10.0,-1.0,0.5395045280456543,157.8131806916013,2,-157,-16,676,533,1433,659,71,13.4
-11,-1,0,-11.0,-1.0,0.5474085807800293,146.76852523616907,2,-146,-15,676,533,1433,659,71,12.75
-11,0,0,-11.0,-0.0,0.555504560470581,135.83077707206124,2,-135,-15,676,533,1433,659,71,9.83
-11,-1,0,-11.0,-1.0,0.5642256736755371,124.78781991845197,2,-124,-14,676,533,1433,659,71,11.35
-10,-1,0,-10.0,-1.0,0.5714194774627686,114.73883387938018,2,-114,-13,676,533,1433,659,71,10.91
-12,-1,0,-12.0,-1.0,0.5794556140899658,102.70345661174214,2,-102,-12,676,533,1433,659,71,10.34
-11,-2,0,-11.0,-2.0,0.5874166488647461,91.54780172128658,2,-91,-10,676,533,1433,659,71,8.61
-11,-2,0,-11.0,-2.0,0.5954296588897705,80.39900496896712,2,-80,-8,676,533,1433,659,71,7.92
-11,-1,0,-11.0,-1.0,0.6034426689147949,69.35416353759881,2,-69,-7,676,533,1433,659,71,9.63
-11,-2,0,-11.0,-2.0,0.611506462097168,58.215118311311535,2,-58,-5,676,533,1433,659,71,6.61
-9,-1,0,-9.0,-1.0,0.6197366714477539,49.16299421312742,2,-49,-4,676,533,1433,659,71,7.16
-7,-1,0,-7.0,-1.0,0.6285595893859863,42.1070065428546,2,-42,-3,676,533,1433,659,71,5.36
-5,-1,0,-5.0,-1.0,0.6354045867919922,37.05401462729781,2,-37,-2,676,533,1433,659,71,3.89
-4,-1,0,-4.0,-1.0,0.6435074806213379,33.015148038438355,2,-33,-1,676,533,1433,659,71,3.06
-5,0,0,-5.0,-0.0,0.6515336036682129,28.0178514522438,2,-28,-1,676,533,1433,659,71,5.33
-3,-1,0,-3.0,-1.0,0.6596055030822754,25.0,2,-25,0,676,533,1433,659,71,2.13
-3,0,0,-3.0,-0.0,0.6674215793609619,22.0,2,-22,0,676,533,1433,659,71,7.33
-3,0,0,-3.0,-0.0,0.6754364967346191,19.0,2,-19,0,676,533,1433,659,71,7.29
-1,0,0,-1.0,-0.0,0.6915426254272461,18.0,2,-18,0,676,533,1433,659,71,6.86
0,0,1,-0.0,-0.0,0.7144715785980225,18.0,2,-18,0,676,533,1433,659,71,32.29
0,0,0,-0.0,-0.0,0.08345794677734375,1178.0819156578204,3,1169,-146,1863,387,694,533,31,225.39
2,1,0,2.0,1.0,0.1682291030883789,1176.221917836936,3,1167,-147,1863,387,694,533,31,13.87
7,3,0,7.0,3.0,0.1759929656982422,1169.6580696938743,3,1160,-150,1863,387,694,533,31,39.66
9,2,0,9.0,2.0,0.18499302864074707,1160.99310936801,3,1151,-152,1863,387,694,533,31,49.55
15,2,0,15.0,2.0,0.19143891334533691,1146.3908583026994,3,1136,-154,1863,387,694,533,31,71.43
22,3,0,22.0,3.0,0.20222711563110352,1125.0088888537725,3,1114,-157,1863,387,694,533,31,89.33
33,2,0,33.0,2.0,0.20743608474731445,1092.6307702055622,3,1081,-159,1863,387,694,533,31,109.68
37,1,0,37.0,1.0,0.21684002876281738,1056.1893769585074,3,1044,-160,1863,387,694,533,31,113.81
42,1,0,42.0,1.0,0.2234189510345459,1014.8522059886355,3,1002,-161,1863,387,694,533,31,117.41
45,0,0,45.0,-0.0,0.2314319610595703,970.4483499908689,3,957,-161,1863,387,694,533,31,117.93
46,0,0,46.0,-0.0,0.23945093154907227,925.1172898611289,3,911,-161,1863,387,694,533,31,115.56
44,-1,0,44.0,-1.0,0.24748492240905762,881.6399491856072,3,867,-160,1863,387,694,533,31,110.6
41,0,0,41.0,-0.0,0.25562095642089844,841.353671175208,3,826,-160,1863,387,694,533,31,104.02
39,-1,0,39.0,-1.0,0.26535701751708984,802.9009901600571,3,787,-159,1863,387,694,533,31,99.29
40,0,0,40.0,-0.0,0.27208399772644043,763.7342469733827,3,747,-159,1863,387,694,533,31,96.84
40,-2,0,40.0,-2.0,0.2799711227416992,724.2223415498862,3,707,-157,1863,387,694,533,31,94.39
43,-3,0,43.0,-3.0,0.28966403007507324,681.624530075026,3,664,-154,1863,387,694,533,31,93.89
41,-4,0,41.0,-4.0,0.29635000228881836,640.8034019884726,3,623,-150,1863,387,694,533,31,88.96
36,-5,0,36.0,-5.0,0.30396509170532227,604.6436967338699,3,587,-145,1863,387,694,533,31,81.84
33,-4,0,33.0,-4.0,0.3114180564880371,571.6616131943791,3,554,-141,1863,387,694,533,31,75.54
29,-3,0,29.0,-3.0,0.32050514221191406,542.8342288397075,3,525,-138,1863,387,694,533,31,68.34
27,-4,0,27.0,-4.0,0.3277459144592285,515.7130985344468,3,498,-134,1863,387,694,533,31,64.54
26,-4,0,26.0,-4.0,0.33541297912597656,489.575326175656,3,472,-130,1863,387,694,533,31,61.27
26,-5,0,26.0,-5.0,0.3434290885925293,463.18570789695144,3,446,-125,1863,387,694,533,31,59.83
25,-4,0,25.0,-4.0,0.3514540195465088,438.0433768475446,3,421,-121,1863,387,694,533,31,55.84
24,-4,0,24.0,-4.0,0.3594489097595215,413.8816255887666,3,397,-117,1863,387,694,533,31,52.7
22,-4,0,22.0,-4.0,0.3674650192260742,391.6554608326048,3,375,-113,1863,387,694,533,31,48.73
23,-2,0,23.0,-2.0,0.37840700149536133,369.08671067921154,3,352,-111,1863,387,694,533,31,46.35
23,-3,0,23.0,-3.0,0.38345813751220703,346.27301367562563,3,329,-108,1863,387,694,533,31,44.86
24,-4,0,24.0,-4.0,0.3914470672607422,322.2436966024316,3,305,-104,1863,387,694,533,31,44.08
23,-2,0,23.0,-2.0,0.4001610279083252,299.8799759903952,3,282,-102,1863,387,694,533,31,39.77
23,-2,0,23.0,-2.0,0.4074549674987793,277.6346520159182,3,259,-100,1863,387,694,533,31,37.47
22,-3,0,22.0,-3.0,0.41549110412597656,256.08201811138554,3,237,-97,1863,387,694,533,31,34.94
22,-2,0,22.0,-2.0,0.42352890968322754,235.05318547086316,3,215,-95,1863,387,694,533,31,32.1
21,-2,0,21.0,-2.0,0.4314539432525635,215.13948963405113,3,194,-93,1863,387,694,533,31,29.12
16,-2,0,16.0,-2.0,0.4410860538482666,199.9124808509964,3,178,-91,1863,387,694,533,31,23.64
15,-3,0,15.0,-3.0,0.4480631351470947,185.23768515072737,3,163,-88,1863,387,694,533,31,22.11
12,-3,0,12.0,-3.0,0.45557498931884766,173.28012003689287,3,151,-85,1863,387,694,533,31,18.76
11,-3,0,11.0,-3.0,0.4634420871734619,162.24672569885655,3,140,-82,1863,387,694,533,31,17.08
10,-3,0,10.0,-3.0,0.4714229106903076,152.12166183683374,3,130,-79,1863,387,694,533,31,15.54
11,-2,0,11.0,-2.0,0.4794631004333496,141.7391971192161,3,119,-77,1863,387,694,533,31,14.43
10,-2,0,10.0,-2.0,0.48744797706604004,132.31024147812596,3,109,-75,1863,387,694,533,31,12.88
10,-2,0,10.0,-2.0,0.4954531192779541,123.00406497347964,3,99,-73,1863,387,694,533,31,12.03
10,-3,0,10.0,-3.0,0.5034420490264893,113.22985472038724,3,89,-70,1863,387,694,533,31,11.94
9,-2,0,9.0,-2.0,0.5115640163421631,104.9952379872535,3,80,-68,1863,387,694,533,31,9.8
7,-3,0,7.0,-3.0,0.5213820934295654,97.74456506629922,3,73,-65,1863,387,694,533,31,9.19
6,-2,0,6.0,-2.0,0.5274569988250732,91.96738552334735,3,67,-63,1863,387,694,533,31,7.29
5,-2,0,5.0,-2.0,0.5354161262512207,86.97700845625813,3,62,-61,1863,387,694,533,31,6.56
3,-2,0,3.0,-2.0,0.5436849594116211,83.43860018001261,3,59,-59,1863,387,694,533,31,6.23
2,-2,0,2.0,-2.0,0.5514669418334961,80.61017305526642,3,57,-57,1863,387,694,533,31,9.54
2,-2,0,2.0,-2.0,0.559561014175415,77.78174593052023,3,55,-55,1863,387,694,533,31,9.47
3,-3,0,3.0,-3.0,0.5677371025085449,73.53910524340094,3,52,-52,1863,387,694,533,31,10.56
3,-2,0,3.0,-2.0,0.5755610466003418,70.00714249274856,3,49,-50,1863,387,694,533,31,5.69
2,-2,0,2.0,-2.0,0.5834460258483887,67.17886572427373,3,47,-48,1863,387,694,533,31,8.34
1,-2,0,1.0,-2.0,0.5914919376373291,65.05382386916237,3,46,-46,1863,387,694,533,31,3.93
1,-1,0,1.0,-1.0,0.5994510650634766,63.63961030678928,3,45,-45,1863,387,694,533,31,7.93
1,-2,0,1.0,-2.0,0.6074569225311279,61.5223536610881,3,44,-43,1863,387,694,533,31,3.79
1,-3,0,1.0,-3.0,0.6154689788818359,58.728187440104094,3,43,-40,1863,387,694,533,31,3.56
2,-3,0,2.0,-3.0,0.6246860027313232,55.226805085936306,3,41,-37,1863,387,694,533,31,4.86
2,-3,0,2.0,-3.0,0.6327419281005859,51.73973328110612,3,39,-34,1863,387,694,533,31,4.62
3,-3,0,3.0,-3.0,0.6394181251525879,47.50789408087881,3,36,-31,1863,387,694,533,31,6.53
3,-4,0,3.0,-4.0,0.6475369930267334,42.638011210655684,3,33,-27,1863,387,694,533,31,4.99
3,-3,0,3.0,-3.0,0.6554760932922363,38.41874542459709,3,30,-24,1863,387,694,533,31,5.56
4,-3,0,4.0,-3.0,0.6643290519714355,33.421549934136806,3,26,-21,1863,387,694,533,31,7.02
4,-3,0,4.0,-3.0,0.6720399856567383,28.42534080710379,3,22,-18,1863,387,694,533,31,6.52
3,-3,0,3.0,-3.0,0.6794979572296143,24.20743687382041,3,19,-15,1863,387,694,533,31,4.68
4,-3,0,4.0,-3.0,0.6883869171142578,19.209372712298546,3,15,-12,1863,387,694,533,31,6.25
4,-3,0,4.0,-3.0,0.6970000267028809,14.212670403551895,3,11,-9,1863,387,694,533,31,5.47
3,-2,0,3.0,-2.0,0.7034730911254883,10.63014581273465,3,8,-7,1863,387,694,533,31,3.36
4,-3,0,4.0,-3.0,0.7154200077056885,5.656854249492381,3,4,-4,1863,387,694,533,31,2.85
3,-2,0,3.0,-2.0,0.7195451259613037,2.23606797749979,3,1,-2,1863,387,694,533,31,0.11
3,-2,0,3.0,-2.0,0.7274110317230225,2.0,3,-2,0,1863,387,694,533,31,-2.65
3,-2,0,3.0,-2.0,0.7354490756988525,5.385164807134504,3,-5,2,1863,387,694,533,31,-1.23
2,-1,0,2.0,-1.0,0.743462085723877,7.615773105863909,3,-7,3,1863,387,694,533,31,2.52
1,-1,0,1.0,-1.0,0.7528901100158691,8.94427190999916,3,-8,4,1863,387,694,533,31,1.13
1,0,0,1.0,-0.0,0.759925127029419,9.848857801796104,3,-9,4,1863,387,694,533,31,1.35
0,-1,0,-0.0,-1.0,0.7760651111602783,10.295630140987,3,-9,5,1863,387,694,533,31,0.66
0,0,1,-0.0,-0.0,0.8124661445617676,10.295630140987,3,-9,5,1863,387,694,533,31,29.97
1,0,1,1.0,-0.0,0.033701181411743164,1462.2722044817783,4,-1432,-296,441,86,1872,382,72,6.42
0,0,0,-0.0,-0.0,0.06464529037475586,1462.2722044817783,4,-1432,-296,441,86,1872,382,72,253.3
-1,0,0,-1.0,-0.0,0.0896451473236084,1461.2929206699114,4,-1431,-296,441,86,1872,382,72,6.28
-2,0,0,-2.0,-0.0,0.09908628463745117,1459.3344373377886,4,-1429,-296,441,86,1872,382,72,9.49
-4,1,0,-4.0,1.0,0.10654425621032715,1455.6215167412167,4,-1425,-297,441,86,1872,382,72,13.93
-3,1,0,-3.0,1.0,0.1136171817779541,1452.8895346859651,4,-1422,-298,441,86,1872,382,72,10.64
-6,2,0,-6.0,2.0,0.12198710441589355,1447.4308273627448,4,-1416,-300,441,86,1872,382,72,18.91
-7,2,0,-7.0,2.0,0.13132023811340332,1441.0013879243836,4,-1409,-302,441,86,1872,382,72,21.78
-7,3,0,-7.0,3.0,0.1388552188873291,1434.7923194664795,4,-1402,-305,441,86,1872,382,72,20.78
-7,3,0,-7.0,3.0,0.14564013481140137,1428.5968640592769,4,-1395,-308,441,86,1872,382,72,20.68
-8,3,0,-8.0,3.0,0.1536850929260254,1421.4394113010937,4,-1387,-311,441,86,1872,382,72,23.44
-9,3,0,-9.0,3.0,0.1616661548614502,1413.3223270011692,4,-1378,-314,441,86,1872,382,72,26.08
-10,3,0,-10.0,3.0,0.1696453094482422,1404.248197435197,4,-1368,-317,441,86,1872,382,72,28.62
-12,3,0,-12.0,3.0,0.17764616012573242,1393.2465682713882,4,-1356,-320,441,86,1872,382,72,33.56
-19,2,0,-19.0,2.0,0.18561124801635742,1375.2283446758943,4,-1337,-322,441,86,1872,382,72,49.87
-26,2,0,-26.0,2.0,0.19414830207824707,1350.4432605629902,4,-1311,-324,441,86,1872,382,72,62.63
-32,0,0,-32.0,-0.0,0.20164728164672852,1319.4002425344631,4,-1279,-324,441,86,1872,382,72,72.69
-34,0,0,-34.0,-0.0,0.2097151279449463,1286.4684216878393,4,-1245,-324,441,86,1872,382,72,74.54
-35,-1,0,-35.0,-1.0,0.2189192771911621,1252.36935446377,4,-1210,-323,441,86,1872,382,72,75.28
-34,-1,0,-34.0,-1.0,0.22786521911621094,1219.2866767089681,4,-1176,-322,441,86,1872,382,72,72.7
-33,-2,0,-33.0,-2.0,0.2339153289794922,1186.9494513246973,4,-1143,-320,441,86,1872,382,72,70.72
-31,-3,0,-31.0,-3.0,0.2433791160583496,1156.3014312885718,4,-1112,-317,441,86,1872,382,72,67.48
-28,-3,0,-28.0,-3.0,0.24961209297180176,1128.5619167772763,4,-1084,-314,441,86,1872,382,72,62.28
-30,-4,0,-30.0,-4.0,0.257702112197876,1098.6427990934997,4,-1054,-310,441,86,1872,382,72,64.77
-26,-5,0,-26.0,-5.0,0.2656242847442627,1072.291471569181,4,-1028,-305,441,86,1872,382,72,59.2
-28,-6,0,-28.0,-6.0,0.27364420890808105,1043.7437424962125,4,-1000,-299,441,86,1872,382,72,61.84
-29,-8,0,-29.0,-8.0,0.2816472053527832,1013.6675983772984,4,-971,-291,441,86,1872,382,72,64.37
-30,-8,0,-30.0,-8.0,0.2897031307220459,982.6342147513488,4,-941,-283,441,86,1872,382,72,64.24
-32,-9,0,-32.0,-9.0,0.29761314392089844,949.3982304596949,4,-909,-274,441,86,1872,382,72,66.33
-34,-10,0,-34.0,-10.0,0.3062632083892822,913.9589706327084,4,-875,-264,441,86,1872,382,72,68.25
-34,-11,0,-34.0,-11.0,0.3149101734161377,878.2311768549326,4,-841,-253,441,86,1872,382,72,66.35
-35,-13,0,-35.0,-13.0,0.32161927223205566,840.9732457099929,4,-806,-240,441,86,1872,382,72,65.18
-36,-13,0,-36.0,-13.0,0.3296482563018799,802.7633524271023,4,-770,-227,441,86,1872,382,72,64.56
-36,-13,0,-36.0,-13.0,0.33833813667297363,764.5600041854138,4,-734,-214,441,86,1872,382,72,62.69
-34,-11,0,-34.0,-11.0,0.3456993103027344,728.8408605450164,4,-700,-203,441,86,1872,382,72,59.3
-32,-11,0,-32.0,-11.0,0.35366225242614746,695.045322263232,4,-668,-192,441,86,1872,382,72,55.2
-29,-10,0,-29.0,-10.0,0.3621342182159424,664.4132750028404,4,-639,-182,441,86,1872,382,72,50.46
-25,-10,0,-25.0,-10.0,0.3696401119232178,637.6362599476288,4,-614,-172,441,86,1872,382,72,44.33
-23,-9,0,-23.0,-9.0,0.37831926345825195,613.0660649554826,4,-591,-163,441,86,1872,382,72,40.91
-23,-9,0,-23.0,-9.0,0.38577723503112793,588.5065845001227,4,-568,-154,441,86,1872,382,72,39.85
-21,-9,0,-21.0,-9.0,0.3936042785644531,565.8922158856756,4,-547,-145,441,86,1872,382,72,36.42
-22,-9,0,-22.0,-9.0,0.4017212390899658,542.3292357968543,4,-525,-136,441,86,1872,382,72,36.6
-22,-8,0,-22.0,-8.0,0.4096252918243408,519.0308276008276,4,-503,-128,441,86,1872,382,72,35.74
-22,-9,0,-22.0,-9.0,0.4177401065826416,495.50176588989063,4,-481,-119,441,86,1872,382,72,34.47
-23,-7,0,-23.0,-7.0,0.42563915252685547,471.49549308556493,4,-458,-112,441,86,1872,382,72,35.1
-23,-8,0,-23.0,-8.0,0.43360114097595215,447.25943254446855,4,-435,-104,441,86,1872,382,72,33.47
-23,-6,0,-23.0,-6.0,0.4416351318359375,423.4949822607111,4,-412,-98,441,86,1872,382,72,33.67
-22,-6,0,-22.0,-6.0,0.44962024688720703,400.7043798113517,4,-390,-92,441,86,1872,382,72,31.28
-21,-5,0,-21.0,-5.0,0.45766711235046387,379.11739606617897,4,-369,-87,441,86,1872,382,72,30.96
-21,-5,0,-21.0,-5.0,0.46568727493286133,357.5304182863327,4,-348,-82,441,86,1872,382,72,29.95
-18,-4,0,-18.0,-4.0,0.47400426864624023,339.092907622675,4,-330,-78,441,86,1872,382,72,25.63
-17,-5,0,-17.0,-5.0,0.4821441173553467,321.4000622277475,4,-313,-73,441,86,1872,382,72,22.81
-16,-4,0,-16.0,-4.0,0.48963332176208496,304.9098227345259,4,-297,-69,441,86,1872,382,72,22.39
-16,-4,0,-16.0,-4.0,0.49787020683288574,288.41983288255335,4,-281,-65,441,86,1872,382,72,21.66
-17,-5,0,-17.0,-5.0,0.5057783126831055,270.73234014428346,4,-264,-60,441,86,1872,382,72,20.45
-17,-4,0,-17.0,-4.0,0.5140471458435059,253.26863208853953,4,-247,-56,441,86,1872,382,72,21.42
-17,-5,0,-17.0,-5.0,0.5219261646270752,235.58650216003463,4,-230,-51,441,86,1872,382,72,18.69
-17,-4,0,-17.0,-4.0,0.5321252346038818,218.1238180483736,4,-213,-47,441,86,1872,382,72,19.38
-17,-4,0,-17.0,-4.0,0.5401782989501953,200.66140635408692,4,-196,-43,441,86,1872,382,72,18.45
-17,-4,0,-17.0,-4.0,0.5472702980041504,183.19934497699495,4,-179,-39,441,86,1872,382,72,17.48
-15,-3,0,-15.0,-3.0,0.5536742210388184,167.90473489452285,4,-164,-36,441,86,1872,382,72,15.44
-14,-4,0,-14.0,-4.0,0.5618512630462646,153.37535656030275,4,-150,-32,441,86,1872,382,72,12.9
-14,-2,0,-14.0,-2.0,0.5696511268615723,139.26952286842948,4,-136,-30,441,86,1872,382,72,11.89
-11,-3,0,-11.0,-3.0,0.5788161754608154,127.88275880665071,4,-125,-27,441,86,1872,382,72,10.56
-10,-3,0,-10.0,-3.0,0.5861871242523193,117.47765745025733,4,-115,-24,441,86,1872,382,72,9.11
-10,-2,0,-10.0,-2.0,0.5936391353607178,107.28000745712129,4,-105,-22,441,86,1872,382,72,10.95
-8,-3,0,-8.0,-3.0,0.6025002002716064,98.84331034521254,4,-97,-19,441,86,1872,382,72,6.73
-8,-2,0,-8.0,-2.0,0.6099891662597656,90.60905032059435,4,-89,-17,441,86,1872,382,72,7.77
-6,-1,0,-6.0,-1.0,0.617652177810669,84.52810183601665,4,-83,-16,441,86,1872,382,72,7.7
-4,-2,0,-4.0,-2.0,0.625765323638916,80.23091673413684,4,-79,-14,441,86,1872,382,72,3.93
-3,0,0,-3.0,-0.0,0.6336092948913574,77.27871634544663,4,-76,-14,441,86,1872,382,72,4.07
-3,-2,0,-3.0,-2.0,0.642815113067627,73.97972695272672,4,-73,-12,441,86,1872,382,72,2.93
-3,-1,0,-3.0,-1.0,0.6496851444244385,70.8590149522275,4,-70,-11,441,86,1872,382,72,4.14
-3,-1,0,-3.0,-1.0,0.6576721668243408,67.7421582177598,4,-67,-10,441,86,1872,382,72,4.02
-2,0,0,-2.0,-0.0,0.665715217590332,65.76473218982953,4,-65,-10,441,86,1872,382,72,3.86
-1,-1,0,-1.0,-1.0,0.6750292778015137,64.6297145282261,4,-64,-9,441,86,1872,382,72,1.63
-1,0,0,-1.0,-0.0,0.681638240814209,63.63961030678928,4,-63,-9,441,86,1872,382,72,3.69
-1,0,0,-1.0,-0.0,0.68992018699646,62.64982043070834,4,-62,-9,441,86,1872,382,72,3.66
-1,0,0,-1.0,-0.0,0.7057220935821533,61.66036003787198,4,-61,-9,441,86,1872,382,72,3.63
-1,0,0,-1.0,-0.0,0.7144951820373535,60.67124524847005,4,-60,-9,441,86,1872,382,72,3.6
0,-1,0,-0.0,-1.0,0.7312653064727783,60.530983801686226,4,-60,-8,441,86,1872,382,72,0.18
0,0,1,-0.0,-0.0,0.7626702785491943,60.530983801686226,4,-60,-8,441,86,1872,382,72,45.27
0,0,0,-0.0,-0.0,0.06318950653076172,826.8119495991818,5,803,197,1304,291,501,94,38,184.21
0,4,0,-0.0,4.0,0.14119553565979004,825.8680281982104,5,803,193,1304,291,501,94,38,4.62
0,6,0,-0.0,6.0,0.1492326259613037,824.4865068635144,5,803,187,1304,291,501,94,38,6.51
0,6,0,-0.0,6.0,0.1571974754333496,823.1464025311658,5,803,181,1304,291,501,94,38,6.32
0,6,0,-0.0,6.0,0.16519951820373535,821.8479178047481,5,803,175,1304,291,501,94,38,6.13
2,7,0,2.0,7.0,0.17323541641235352,818.4283719422244,5,801,168,1304,291,501,94,38,15.14
4,7,0,4.0,7.0,0.18129658699035645,813.0990099612716,5,797,161,1304,291,501,94,38,22.52
6,9,0,6.0,9.0,0.18973755836486816,805.47191136625,5,791,152,1304,291,501,94,38,30.17
9,11,0,9.0,11.0,0.19747447967529297,794.6099672166213,5,782,141,1304,291,501,94,38,39.6
13,12,0,13.0,12.0,0.20522260665893555,779.7448300566026,5,769,129,1304,291,501,94,38,49.47
19,13,0,19.0,13.0,0.21340346336364746,758.91765034159,5,750,116,1304,291,501,94,38,61.23
24,14,0,24.0,14.0,0.22117948532104492,733.1302749170845,5,726,102,1304,291,501,94,38,68.36
29,15,0,29.0,15.0,0.2301945686340332,702.4087129300149,5,697,87,1304,291,501,94,38,73.52
31,12,0,31.0,12.0,0.23716354370117188,670.2096686858524,5,666,75,1304,291,501,94,38,73.65
31,10,0,31.0,10.0,0.24545049667358398,638.3181025162925,5,635,65,1304,291,501,94,38,71.37
31,8,0,31.0,8.0,0.25322651863098145,606.6836078220673,5,604,57,1304,291,501,94,38,69.22
30,7,0,30.0,7.0,0.2611815929412842,576.1735849550897,5,574,50,1304,291,501,94,38,65.9
29,6,0,29.0,6.0,0.2692735195159912,546.7732619651404,5,545,44,1304,291,501,94,38,62.71
28,5,0,28.0,5.0,0.27796459197998047,518.4688997423085,5,517,39,1304,291,501,94,38,59.67
28,5,0,28.0,5.0,0.2864515781402588,490.1805789706483,5,489,34,1304,291,501,94,38,57.49
29,5,0,29.0,5.0,0.29322242736816406,460.91322393700096,5,460,29,1304,291,501,94,38,56.26
28,3,0,28.0,3.0,0.3012235164642334,432.781700167648,5,432,26,1304,291,501,94,38,53.93
24,3,0,24.0,3.0,0.3092024326324463,408.6477700905757,5,408,23,1304,291,501,94,38,47.44
23,2,0,23.0,2.0,0.3172595500946045,385.5723019097715,5,385,21,1304,291,501,94,38,45.44
20,0,0,20.0,-0.0,0.32521653175354004,365.60361048545457,5,365,21,1304,291,501,94,38,39.87
18,0,0,18.0,-0.0,0.33396458625793457,347.6348659153739,5,347,21,1304,291,501,94,38,36.23
16,0,0,16.0,-0.0,0.34123659133911133,331.6654941352808,5,331,21,1304,291,501,94,38,32.71
16,0,0,16.0,-0.0,0.34921741485595703,315.6992239458311,5,315,21,1304,291,501,94,38,31.64
15,0,0,15.0,-0.0,0.35716748237609863,300.7341018241862,5,300,21,1304,291,501,94,38,29.43
16,0,0,16.0,-0.0,0.36519551277160645,284.77535005684746,5,284,21,1304,291,501,94,38,29.48
17,0,0,17.0,-0.0,0.37320542335510254,267.8245694479877,5,267,21,1304,291,501,94,38,29.3
14,0,0,14.0,-0.0,0.38119959831237793,253.87004549572208,5,253,21,1304,291,501,94,38,25.12
15,1,0,15.0,1.0,0.39217662811279297,238.83885781003056,5,238,20,1304,291,501,94,38,26.98
13,0,0,13.0,-0.0,0.39719557762145996,225.88713996153035,5,225,20,1304,291,501,94,38,22.2
14,1,0,14.0,1.0,0.40527844429016113,211.85372312045877,5,211,19,1304,291,501,94,38,24.11
12,1,0,12.0,1.0,0.41317248344421387,199.81241202688085,5,199,18,1304,291,501,94,38,22.08
11,1,0,11.0,1.0,0.42173242568969727,188.76705220985997,5,188,17,1304,291,501,94,38,21.06
9,2,0,9.0,2.0,0.4293825626373291,179.62739212046696,5,179,15,1304,291,501,94,38,15.05
10,2,0,10.0,2.0,0.43723058700561523,169.49926253526885,5,169,13,1304,291,501,94,38,15.61
9,1,0,9.0,1.0,0.4451866149902344,160.44936896105264,5,160,12,1304,291,501,94,38,15.59
9,2,0,9.0,2.0,0.4538605213165283,151.33076356114773,5,151,10,1304,291,501,94,38,13.37
9,2,0,9.0,2.0,0.4621875286102295,142.22517358048822,5,142,8,1304,291,501,94,38,12.77
8,2,0,8.0,2.0,0.4702334403991699,134.13426109685773,5,134,6,1304,291,501,94,38,11.2
8,2,0,8.0,2.0,0.47739362716674805,126.0634760745554,5,126,4,1304,291,501,94,38,10.68
6,2,0,6.0,2.0,0.4855384826660156,120.01666550941998,5,120,2,1304,291,501,94,38,8.24
7,2,0,7.0,2.0,0.4931986331939697,113.0,5,113,0,1304,291,501,94,38,8.83
6,0,0,6.0,-0.0,0.5032825469970703,107.0,5,107,0,1304,291,501,94,38,12.41
7,3,0,7.0,3.0,0.5137796401977539,100.04498987955368,5,100,-3,1304,291,501,94,38,7.51
7,1,0,7.0,1.0,0.5172364711761475,93.08598175880189,5,93,-4,1304,291,501,94,38,8.38
5,2,0,5.0,2.0,0.5251564979553223,88.20430828479978,5,88,-6,1304,291,501,94,38,5.53
5,1,0,5.0,1.0,0.5338666439056396,83.2946576918352,5,83,-7,1304,291,501,94,38,6.03
6,2,0,6.0,2.0,0.5412755012512207,77.52418977325722,5,77,-9,1304,291,501,94,38,5.67
6,2,0,6.0,2.0,0.5491664409637451,71.84705978674423,5,71,-11,1304,291,501,94,38,5.24
5,2,0,5.0,2.0,0.559375524520874,67.26812023536856,5,66,-13,1304,291,501,94,38,4.16
4,2,0,4.0,2.0,0.5666534900665283,63.788713735268246,5,62,-15,1304,291,501,94,38,3.14
4,1,0,4.0,1.0,0.5732336044311523,60.166435825965294,5,58,-16,1304,291,501,94,38,3.58
4,1,0,4.0,1.0,0.58115553855896,56.61271941887264,5,54,-17,1304,291,501,94,38,3.32
3,1,0,3.0,1.0,0.5914535522460938,54.08326913195984,5,51,-18,1304,291,501,94,38,2.49
4,2,0,4.0,2.0,0.5976715087890625,51.07837115648854,5,47,-20,1304,291,501,94,38,2.15
4,1,0,4.0,1.0,0.6056976318359375,47.853944456021594,5,43,-21,1304,291,501,94,38,2.5
5,1,0,5.0,1.0,0.6135275363922119,43.9089968002003,5,38,-22,1304,291,501,94,38,2.56
4,1,0,4.0,1.0,0.6216094493865967,41.048751503547585,5,34,-23,1304,291,501,94,38,1.82
4,1,0,4.0,1.0,0.6292076110839844,38.41874542459709,5,30,-24,1304,291,501,94,38,1.49
3,0,0,3.0,-0.0,0.6372356414794922,36.124783736376884,5,27,-24,1304,291,501,94,38,1.73
2,1,0,2.0,1.0,0.645209550857544,35.35533905932738,5,25,-25,1304,291,501,94,38,0.38
3,0,0,3.0,-0.0,0.6532895565032959,33.301651610693426,5,22,-25,1304,291,501,94,38,1.32
2,0,0,2.0,-0.0,0.6615095138549805,32.01562118716424,5,20,-25,1304,291,501,94,38,1.04
2,1,0,2.0,1.0,0.6705646514892578,31.622776601683793,5,18,-26,1304,291,501,94,38,-0.04
2,0,0,2.0,-0.0,0.678755521774292,30.528675044947494,5,16,-26,1304,291,501,94,38,0.74
1,0,0,1.0,-0.0,0.6867685317993164,30.01666203960727,5,15,-26,1304,291,501,94,38,0.66
1,0,0,1.0,-0.0,0.6932435035705566,29.5296461204668,5,14,-26,1304,291,501,94,38,0.6
1,0,0,1.0,-0.0,0.7013964653015137,29.068883707497267,5,13,-26,1304,291,501,94,38,0.55
1,0,0,1.0,-0.0,0.7114474773406982,28.635642126552707,5,12,-26,1304,291,501,94,38,0.49
1,0,0,1.0,-0.0,0.7182145118713379,28.231188426986208,5,11,-26,1304,291,501,94,38,0.44
0,0,1,-0.0,-0.0,0.7562205791473389,28.231188426986208,5,11,-26,1304,291,501,94,38,35.41
1,0,1,1.0,-0.0,0.03564643859863281,863.2873218112264,6,-748,431,546,748,1293,317,70,4.63
0,0,0,-0.0,-0.0,0.06452631950378418,863.2873218112264,6,-748,431,546,748,1293,317,70,188.93
0,2,0,-0.0,2.0,0.13154125213623047,862.2905542797045,6,-748,429,546,748,1293,317,70,3.24
-1,2,0,-1.0,2.0,0.13964343070983887,860.4289627854237,6,-747,427,546,748,1293,317,70,6.21
-1,2,0,-1.0,2.0,0.147491455078125,858.5691585422808,6,-746,425,546,748,1293,317,70,6.2
-2,3,0,-2.0,3.0,0.1560993194580078,855.3478824431612,6,-744,422,546,748,1293,317,70,9.77
-2,4,0,-2.0,4.0,0.1636662483215332,851.6384209275672,6,-742,418,546,748,1293,317,70,10.55
-3,4,0,-3.0,4.0,0.17168545722961426,847.0637520281457,6,-739,414,546,748,1293,317,70,12.99
-4,5,0,-4.0,5.0,0.17948031425476074,841.1337586852641,6,-735,409,546,748,1293,317,70,16.03
-5,6,0,-5.0,6.0,0.18760228157043457,833.8519053165256,6,-730,403,546,748,1293,317,70,18.87
-6,7,0,-6.0,7.0,0.19571733474731445,825.2223942671454,6,-724,396,546,748,1293,317,70,21.54
-9,7,0,-9.0,7.0,0.20348143577575684,813.9692868898678,6,-715,389,546,748,1293,317,70,27.48
-9,9,0,-9.0,9.0,0.21155238151550293,801.7705407409279,6,-706,380,546,748,1293,317,70,28.18
-11,9,0,-11.0,9.0,0.21998143196105957,787.823584313138,6,-695,371,546,748,1293,317,70,31.48
-11,10,0,-11.0,10.0,0.2278592586517334,773.4190326078095,6,-684,361,546,748,1293,317,70,31.57
-13,10,0,-13.0,10.0,0.26882123947143555,757.2595327891224,6,-671,351,546,748,1293,317,70,34.51
-17,13,0,-17.0,13.0,0.2689633369445801,736.1793259797506,6,-654,338,546,748,1293,317,70,41.13
-18,14,0,-18.0,14.0,0.26908135414123535,713.7730731822264,6,-636,324,546,748,1293,317,70,42.06
-19,13,0,-19.0,13.0,0.2691953182220459,690.9486232709347,6,-617,311,546,748,1293,317,70,42.26
-19,13,0,-19.0,13.0,0.2698183059692383,668.137710356181,6,-598,298,546,748,1293,317,70,41.37
-19,13,0,-19.0,13.0,0.275787353515625,645.3417699173051,6,-579,285,546,748,1293,317,70,40.46
-21,12,0,-21.0,12.0,0.28527140617370605,621.2028654151557,6,-558,273,546,748,1293,317,70,42.13
-22,13,0,-22.0,13.0,0.29152941703796387,595.7314831364882,6,-536,260,546,748,1293,317,70,42.29
-23,13,0,-23.0,13.0,0.29953527450561523,569.3663144233245,6,-513,247,546,748,1293,317,70,42.37
-22,13,0,-22.0,13.0,0.3078343868255615,543.9089997416847,6,-491,234,546,748,1293,317,70,39.91
-21,13,0,-21.0,13.0,0.31574344635009766,519.3659596084441,6,-470,221,546,748,1293,317,70,37.55
-21,13,0,-21.0,13.0,0.32349729537963867,494.83835744614623,6,-449,208,546,748,1293,317,70,36.37
-20,12,0,-20.0,12.0,0.33197832107543945,471.65347449160174,6,-429,196,546,748,1293,317,70,34.09
-19,12,0,-19.0,12.0,0.33954524993896484,449.39514906149134,6,-410,184,546,748,1293,317,70,31.88
-19,12,0,-19.0,12.0,0.3477792739868164,427.15922090012293,6,-391,172,546,748,1293,317,70,30.79
-19,11,0,-19.0,11.0,0.3554704189300537,405.34553161469535,6,-372,161,546,748,1293,317,70,29.72
-18,11,0,-18.0,11.0,0.36403441429138184,384.46846424641905,6,-354,150,546,748,1293,317,70,27.6
-17,10,0,-17.0,10.0,0.3719632625579834,364.9232796081938,6,-337,140,546,748,1293,317,70,25.63
-17,9,0,-17.0,9.0,0.37987828254699707,345.77593901253454,6,-320,131,546,748,1293,317,70,24.87
-15,9,0,-15.0,9.0,0.3916902542114258,328.49505323520475,6,-305,122,546,748,1293,317,70,21.86
-16,8,0,-16.0,8.0,0.3955104351043701,310.67185260335384,6,-289,114,546,748,1293,317,70,22.33
-17,8,0,-17.0,8.0,0.40406131744384766,291.92464781172555,6,-272,106,546,748,1293,317,70,22.52
-16,8,0,-16.0,8.0,0.41225624084472656,274.11676344215067,6,-256,98,546,748,1293,317,70,20.51
-15,7,0,-15.0,7.0,0.4195222854614258,257.6082296822056,6,-241,91,546,748,1293,317,70,19.12
-15,7,0,-15.0,7.0,0.4284234046936035,241.1057859114957,6,-226,84,546,748,1293,317,70,18.28
-14,6,0,-14.0,6.0,0.4354863166809082,225.89378034819816,6,-212,78,546,748,1293,317,70,17.23
-13,6,0,-13.0,6.0,0.44350743293762207,211.62466774929618,6,-199,72,546,748,1293,317,70,15.37
-12,5,0,-12.0,5.0,0.4515113830566406,198.64037857394453,6,-187,67,546,748,1293,317,70,14.62
-10,4,0,-10.0,4.0,0.45992326736450195,187.8776197422141,6,-177,63,546,748,1293,317,70,13.08
-9,4,0,-9.0,4.0,0.46757030487060547,178.05897899291685,6,-168,59,546,748,1293,317,70,11.25
-7,3,0,-7.0,3.0,0.47574424743652344,170.46113926640288,6,-161,56,546,748,1293,317,70,9.76
-4,1,0,-4.0,1.0,0.4864063262939453,166.35504200354134,6,-157,55,546,748,1293,317,70,6.99
-3,2,0,-3.0,2.0,0.49201130867004395,162.8649747490233,6,-154,53,546,748,1293,317,70,5.17
-3,0,0,-3.0,-0.0,0.4998133182525635,160.0312469488381,6,-151,53,546,748,1293,317,70,4.3
-3,2,0,-3.0,2.0,0.5074822902679443,156.54072952429985,6,-148,51,546,748,1293,317,70,5.08
-2,0,0,-2.0,-0.0,0.5155794620513916,154.65122049308243,6,-146,51,546,748,1293,317,70,3.61
-3,1,0,-3.0,1.0,0.5237302780151367,151.48927354766738,6,-143,50,546,748,1293,317,70,8.01
-2,1,0,-2.0,1.0,0.5318143367767334,149.27156460625713,6,-141,49,546,748,1293,317,70,5.07
-3,2,0,-3.0,2.0,0.5413212776184082,145.7840869230932,6,-138,47,546,748,1293,317,70,4.91
-3,1,0,-3.0,1.0,0.5474963188171387,142.6218777046495,6,-135,46,546,748,1293,317,70,8.36
-3,0,0,-3.0,-0.0,0.5568764209747314,139.7855500400524,6,-132,46,546,748,1293,317,70,4.07
-5,1,0,-5.0,1.0,0.5639264583587646,134.73678042761748,6,-127,45,546,748,1293,317,70,6.44
-6,2,0,-6.0,2.0,0.5714802742004395,128.41339493993607,6,-121,43,546,748,1293,317,70,9.26
-6,2,0,-6.0,2.0,0.5794882774353027,122.09013064126027,6,-115,41,546,748,1293,317,70,9.06
-7,2,0,-7.0,2.0,0.5884623527526855,114.82595525402782,6,-108,39,546,748,1293,317,70,8.02
-8,2,0,-8.0,2.0,0.5956873893737793,106.6255128944288,6,-100,37,546,748,1293,317,70,7.57
-8,2,0,-8.0,2.0,0.6035873889923096,98.43271813782245,6,-92,35,546,748,1293,317,70,7.17
-7,2,0,-7.0,2.0,0.6115894317626953,91.18113840043894,6,-85,33,546,748,1293,317,70,6.9
-7,1,0,-7.0,1.0,0.6195123195648193,84.30895563343196,6,-78,32,546,748,1293,317,70,5.19
-6,2,0,-6.0,2.0,0.6277883052825928,78.0,6,-72,30,546,748,1293,317,70,6.44
-7,1,0,-7.0,1.0,0.6410534381866455,71.17583859709698,6,-65,29,546,748,1293,317,70,4.58
-6,1,0,-6.0,1.0,0.6469483375549316,65.30696746902278,6,-59,28,546,748,1293,317,70,4.11
-6,1,0,-6.0,1.0,0.6515822410583496,59.481089431852205,6,-53,27,546,748,1293,317,70,3.77
-5,1,0,-5.0,1.0,0.6595382690429688,54.589376255824725,6,-48,26,546,748,1293,317,70,3.43
-4,1,0,-4.0,1.0,0.6675353050231934,50.60632371551998,6,-44,25,546,748,1293,317,70,3.27
-3,1,0,-3.0,1.0,0.6754753589630127,47.50789408087881,6,-41,24,546,748,1293,317,70,3.4
-3,1,0,-3.0,1.0,0.6838202476501465,44.41846462902562,6,-38,23,546,748,1293,317,70,3.23
-3,1,0,-3.0,1.0,0.691880464553833,41.340053217188775,6,-35,22,546,748,1293,317,70,3.05
-2,1,0,-2.0,1.0,0.6994912624359131,39.11521443121589,6,-33,21,546,748,1293,317,70,4.04
-2,1,0,-2.0,1.0,0.711125373840332,36.89173349139343,6,-31,20,546,748,1293,317,70,3.91
0,0,1,-0.0,-0.0,0.7115182876586914,36.89173349139343,6,-31,20,546,748,1293,317,70,38.06
-1,1,1,-1.0,1.0,0.004597902297973633,571.6861026822324,7,-517,244,59,973,577,728,53,5.69
-2,1,1,-2.0,1.0,0.010560750961303711,569.45061243272,7,-515,243,59,973,577,728,53,11.09
-3,1,1,-3.0,1.0,0.017665863037109375,566.3108686931587,7,-512,242,59,973,577,728,53,11.42
-2,1,1,-2.0,1.0,0.02537369728088379,564.0753495766323,7,-510,241,59,973,577,728,53,11.07
-1,0,1,-1.0,-0.0,0.03342175483703613,563.1713771135745,7,-509,241,59,973,577,728,53,4.24
0,1,1,-0.0,1.0,0.041539907455444336,562.7441692279006,7,-509,240,59,973,577,728,53,1.7
0,0,0,-0.0,-0.0,0.10143685340881348,562.7441692279006,7,-509,240,59,973,577,728,53,145.82
1,-1,0,1.0,-1.0,0.1694629192352295,564.0753495766323,7,-510,241,59,973,577,728,53,4.18
2,-1,0,2.0,-1.0,0.1774299144744873,566.3108686931587,7,-512,242,59,973,577,728,53,6.6
2,-1,0,2.0,-1.0,0.18549489974975586,568.5463921264474,7,-514,243,59,973,577,728,53,6.6
1,-1,0,1.0,-1.0,0.19348478317260742,569.8780571315235,7,-515,244,59,973,577,728,53,4.2
0,-1,0,-0.0,-1.0,0.20938968658447266,570.3069349043548,7,-515,245,59,973,577,728,53,6.5
-3,2,0,-3.0,2.0,0.2494347095489502,566.7389169626522,7,-512,243,59,973,577,728,53,12.17
-4,3,0,-4.0,3.0,0.25761985778808594,561.8398348283966,7,-508,240,59,973,577,728,53,14.65
-8,5,0,-8.0,5.0,0.26541876792907715,552.4717187331855,7,-500,235,59,973,577,728,53,24.15
-10,6,0,-10.0,6.0,0.27513980865478516,540.8705945048224,7,-490,229,59,973,577,728,53,27.99
-12,7,0,-12.0,7.0,0.282437801361084,527.0370005986297,7,-478,222,59,973,577,728,53,31.31
-15,8,0,-15.0,8.0,0.28939390182495117,510.0637215093816,7,-463,214,59,973,577,728,53,35.9
-18,9,0,-18.0,9.0,0.2974097728729248,489.9489769353539,7,-445,205,59,973,577,728,53,39.77
-18,9,0,-18.0,9.0,0.30545783042907715,469.83507744739535,7,-427,196,59,973,577,728,53,38.74
-19,9,0,-19.0,9.0,0.3158848285675049,448.8128786030989,7,-408,187,59,973,577,728,53,39.61
-19,10,0,-19.0,10.0,0.32160282135009766,427.375712927162,7,-389,177,59,973,577,728,53,37.45
-17,9,0,-17.0,9.0,0.3293747901916504,408.17643244067875,7,-372,168,59,973,577,728,53,33.86
-19,9,0,-19.0,9.0,0.33768486976623535,387.15629918677547,7,-353,159,59,973,577,728,53,35.95
-17,8,0,-17.0,8.0,0.3454399108886719,368.3707371656983,7,-336,151,59,973,577,728,53,32.67
-17,8,0,-17.0,8.0,0.35378384590148926,349.5854688055555,7,-319,143,59,973,577,728,53,31.63
-16,7,0,-16.0,7.0,0.36182379722595215,332.12196554880256,7,-303,136,59,973,577,728,53,29.85
-15,7,0,-15.0,7.0,0.3694148063659668,315.5709112069742,7,-288,129,59,973,577,728,53,27.71
-14,6,0,-14.0,6.0,0.37757277488708496,300.341472327749,7,-274,123,59,973,577,728,53,25.53
-11,7,0,-11.0,7.0,0.38561582565307617,287.4456470360962,7,-263,116,59,973,577,728,53,20.06
-13,5,0,-13.0,5.0,0.39345288276672363,273.53427573157995,7,-250,111,59,973,577,728,53,21.82
-11,6,0,-11.0,6.0,0.40249085426330566,261.04788832702707,7,-239,105,59,973,577,728,53,19.22
-11,6,0,-11.0,6.0,0.4118688106536865,248.5658866377283,7,-228,99,59,973,577,728,53,18.58
-9,5,0,-9.0,5.0,0.4174199104309082,238.32121181296472,7,-219,94,59,973,577,728,53,15.84
-9,5,0,-9.0,5.0,0.425372838973999,228.08112591795052,7,-210,89,59,973,577,728,53,15.37
-8,5,0,-8.0,5.0,0.4335339069366455,218.76928486421488,7,-202,84,59,973,577,728,53,13.55
-7,5,0,-7.0,5.0,0.4414079189300537,210.39486685753528,7,-195,79,59,973,577,728,53,11.88
-6,5,0,-6.0,5.0,0.4495258331298828,202.97044119772713,7,-189,74,59,973,577,728,53,10.3
-5,4,0,-5.0,4.0,0.4577028751373291,196.8654362756449,7,-184,70,59,973,577,728,53,8.92
-4,4,0,-4.0,4.0,0.4666457176208496,191.7185437040455,7,-180,66,59,973,577,728,53,7.39
-5,2,0,-5.0,2.0,0.47758984565734863,186.33571852975479,7,-175,64,59,973,577,728,53,10.86
-4,3,0,-4.0,3.0,0.4817018508911133,181.5543995611233,7,-171,61,59,973,577,728,53,7.33
-5,3,0,-5.0,3.0,0.4897308349609375,175.84083712266613,7,-166,58,59,973,577,728,53,8.57
-4,3,0,-4.0,3.0,0.49756669998168945,171.0818517552344,7,-162,55,59,973,577,728,53,7.0
-5,2,0,-5.0,2.0,0.5054159164428711,165.7045563646335,7,-157,53,59,973,577,728,53,9.68
-5,2,0,-5.0,2.0,0.5133888721466064,160.3277892319357,7,-152,51,59,973,577,728,53,9.51
-6,3,0,-6.0,3.0,0.5217037200927734,153.68799562750502,7,-146,48,59,973,577,728,53,9.14
-9,3,0,-9.0,3.0,0.5297558307647705,144.20124826089406,7,-137,45,59,973,577,728,53,14.16
-8,4,0,-8.0,4.0,0.5375487804412842,135.35878250043476,7,-129,41,59,973,577,728,53,9.93
-8,3,0,-8.0,3.0,0.5454127788543701,126.82665335015349,7,-121,38,59,973,577,728,53,10.72
-9,3,0,-9.0,3.0,0.5534138679504395,117.34138229968147,7,-112,35,59,973,577,728,53,12.02
-6,3,0,-6.0,3.0,0.5614447593688965,110.72488428533127,7,-106,32,59,973,577,728,53,7.48
-6,1,0,-6.0,1.0,0.5698738098144531,104.69479452198185,7,-100,31,59,973,577,728,53,7.24
-5,3,0,-5.0,3.0,0.5775117874145508,99.04039579888602,7,-95,28,59,973,577,728,53,5.99
-4,2,0,-4.0,2.0,0.5860977172851562,94.64142856064674,7,-91,26,59,973,577,728,53,5.62
-3,2,0,-3.0,2.0,0.5937879085540771,91.21403400793103,7,-88,24,59,973,577,728,53,4.26
-2,2,0,-2.0,2.0,0.6013698577880859,88.76936408468859,7,-86,22,59,973,577,728,53,2.96
-2,1,0,-2.0,1.0,0.6094326972961426,86.58521813797087,7,-84,21,59,973,577,728,53,4.05
-2,2,0,-2.0,2.0,0.6179606914520264,84.17244204607586,7,-82,19,59,973,577,728,53,2.81
-4,1,0,-4.0,1.0,0.6256299018859863,80.049984384758,7,-78,18,59,973,577,728,53,7.81
-5,2,0,-5.0,2.0,0.6333746910095215,74.73285756613352,7,-73,16,59,973,577,728,53,5.63
-5,1,0,-5.0,1.0,0.6414127349853516,69.63476143421474,7,-68,15,59,973,577,728,53,7.9
-7,2,0,-7.0,2.0,0.6497337818145752,62.369864518050704,7,-61,13,59,973,577,728,53,7.06
-8,1,0,-8.0,1.0,0.6581718921661377,54.3415126767741,7,-53,12,59,973,577,728,53,6.44
-8,1,0,-8.0,1.0,0.6654248237609863,46.32493928760188,7,-45,11,59,973,577,728,53,5.8
-6,1,0,-6.0,1.0,0.6757097244262695,40.26164427839479,7,-39,10,59,973,577,728,53,5.4
-7,1,0,-7.0,1.0,0.6813867092132568,33.24154027718932,7,-32,9,59,973,577,728,53,4.66
-4,0,0,-4.0,-0.0,0.6896617412567139,29.410882339705484,7,-28,9,59,973,577,728,53,2.69
-4,0,0,-4.0,-0.0,0.7008087635040283,25.632011235952593,7,-24,9,59,973,577,728,53,2.31
-3,1,0,-3.0,1.0,0.705413818359375,22.47220505424423,7,-21,8,59,973,577,728,53,4.99
-4,0,0,-4.0,-0.0,0.7138059139251709,18.788294228055936,7,-17,8,59,973,577,728,53,1.65
-2,1,0,-2.0,1.0,0.7213819026947021,16.55294535724685,7,-15,7,59,973,577,728,53,5.19
-2,0,0,-2.0,-0.0,0.7295017242431641,14.7648230602334,7,-13,7,59,973,577,728,53,1.24
-1,1,0,-1.0,1.0,0.7373979091644287,13.416407864998739,7,-12,6,59,973,577,728,53,1.87
0,0,1,-0.0,-0.0,0.7714316844940186,13.416407864998739,7,-12,6,59,973,577,728,53,30.91
0,0,0,-0.0,-0.0,0.07595205307006836,528.4278569492717,8,94,-520,165,447,71,967,21,140.16
2,-1,0,2.0,-1.0,0.12115001678466797,527.0910737244561,8,92,-519,165,447,71,967,21,8.81
4,-1,0,4.0,-1.0,0.1289501190185547,525.4217353707401,8,88,-518,165,447,71,967,21,10.29
4,-2,0,4.0,-2.0,0.13693904876708984,522.7925018590072,8,84,-516,165,447,71,967,21,15.52
6,-3,0,6.0,-3.0,0.14493203163146973,518.8959433258271,8,78,-513,165,447,71,967,21,21.35
6,-3,0,6.0,-3.0,0.1529700756072998,515.0572783681442,8,72,-510,165,447,71,967,21,20.98
6,-2,0,6.0,-2.0,0.16108012199401855,512.2694603428941,8,66,-508,165,447,71,967,21,15.83
7,-4,0,7.0,-4.0,0.16899800300598145,507.4416222581668,8,59,-504,165,447,71,967,21,25.0
6,-3,0,6.0,-3.0,0.17778611183166504,503.7955934702089,8,53,-501,165,447,71,967,21,19.78
7,-5,0,7.0,-5.0,0.18593811988830566,498.1284974783113,8,46,-496,165,447,71,967,21,28.1
8,-5,0,8.0,-5.0,0.1929490566253662,492.4682730897494,8,38,-491,165,447,71,967,21,27.73
8,-6,0,8.0,-6.0,0.20464110374450684,485.92694924237327,8,30,-485,165,447,71,967,21,30.76
10,-8,0,10.0,-8.0,0.21036601066589355,477.41910309496416,8,20,-477,165,447,71,967,21,36.7
11,-10,0,11.0,-10.0,0.21697402000427246,467.0867157177562,8,9,-467,165,447,71,967,21,41.29
11,-15,0,11.0,-15.0,0.22556519508361816,452.00442475710344,8,-2,-452,165,447,71,967,21,51.26
11,-17,0,11.0,-17.0,0.23298215866088867,435.1942095203014,8,-13,-435,165,447,71,967,21,53.12
11,-19,0,11.0,-19.0,0.2409970760345459,416.69173257937337,8,-24,-416,165,447,71,967,21,54.3
9,-22,0,9.0,-22.0,0.24897503852844238,395.37956446938426,8,-33,-394,165,447,71,967,21,56.5
8,-19,0,8.0,-19.0,0.2569441795349121,377.2346749703691,8,-41,-375,165,447,71,967,21,50.41
6,-18,0,6.0,-18.0,0.2649531364440918,360.0805465447974,8,-47,-357,165,447,71,967,21,47.57
4,-17,0,4.0,-17.0,0.27293920516967773,343.80372307466365,8,-51,-340,165,447,71,967,21,45.06
2,-18,0,2.0,-18.0,0.28185009956359863,326.3326523656497,8,-53,-322,165,447,71,967,21,45.57
1,-18,0,1.0,-18.0,0.2889280319213867,308.7588055424493,8,-54,-304,165,447,71,967,21,44.23
0,-18,0,-0.0,-18.0,0.2969322204589844,291.05325973092965,8,-54,-286,165,447,71,967,21,42.91
-1,-16,0,-1.0,-16.0,0.30495715141296387,275.1526848860465,8,-53,-270,165,447,71,967,21,39.55
-2,-18,0,-2.0,-18.0,0.31313300132751465,257.1089263327899,8,-51,-252,165,447,71,967,21,40.74
-3,-18,0,-3.0,-18.0,0.32157111167907715,238.8723508487326,8,-48,-234,165,447,71,967,21,40.01
-4,-16,0,-4.0,-16.0,0.32998108863830566,222.39604313026794,8,-44,-218,165,447,71,967,21,36.14
-3,-14,0,-3.0,-14.0,0.3369481563568115,208.07931180201456,8,-41,-204,165,447,71,967,21,33.53
-2,-11,0,-2.0,-11.0,0.3449442386627197,196.9009903479411,8,-39,-193,165,447,71,967,21,28.26
0,-10,0,-0.0,-10.0,0.35469913482666016,187.1095935541521,8,-39,-183,165,447,71,967,21,22.74
-1,-10,0,-1.0,-10.0,0.3609640598297119,177.12425017484196,8,-38,-173,165,447,71,967,21,22.95
-2,-12,0,-2.0,-12.0,0.36890721321105957,164.97575579460153,8,-36,-161,165,447,71,967,21,25.35
0,-10,0,-0.0,-10.0,0.37700605392456055,155.23208431248997,8,-36,-151,165,447,71,967,21,19.82
-1,-7,0,-1.0,-7.0,0.38494420051574707,148.1924424523734,8,-35,-144,165,447,71,967,21,16.99
0,-6,0,-0.0,-6.0,0.39293622970581055,142.36923825040296,8,-35,-138,165,447,71,967,21,13.61
-1,-7,0,-1.0,-7.0,0.40096616744995117,135.34031180694095,8,-34,-131,165,447,71,967,21,15.87
-1,-7,0,-1.0,-7.0,0.40923404693603516,128.3160161476345,8,-33,-124,165,447,71,967,21,15.29
-1,-8,0,-1.0,-8.0,0.4169580936431885,120.33287165193059,8,-32,-116,165,447,71,967,21,15.53
-1,-8,0,-1.0,-8.0,0.42493200302124023,112.36102527122117,8,-31,-108,165,447,71,967,21,14.77
0,-8,0,-0.0,-8.0,0.43296003341674805,104.69479452198185,8,-31,-100,165,447,71,967,21,12.92
0,-6,0,-0.0,-6.0,0.44098520278930664,98.97979591815695,8,-31,-94,165,447,71,967,21,10.37
0,-6,0,-0.0,-6.0,0.4489710330963135,93.30058949438637,8,-31,-88,165,447,71,967,21,9.86
0,-4,0,-0.0,-4.0,0.45709705352783203,89.5377015563835,8,-31,-84,165,447,71,967,21,7.45
0,-6,0,-0.0,-6.0,0.4649631977081299,83.93449827097318,8,-31,-78,165,447,71,967,21,9.0
-1,-7,0,-1.0,-7.0,0.4729480743408203,77.07788269017254,8,-30,-71,165,447,71,967,21,10.16
-1,-7,0,-1.0,-7.0,0.4810490608215332,70.26378868236469,8,-29,-64,165,447,71,967,21,9.44
-1,-6,0,-1.0,-6.0,0.4892120361328125,64.40496875241847,8,-28,-58,165,447,71,967,21,8.24
0,-5,0,-0.0,-5.0,0.4977571964263916,59.941638282582836,8,-28,-53,165,447,71,967,21,6.06
-1,-5,0,-1.0,-5.0,0.5074441432952881,55.072679252057455,8,-27,-48,165,447,71,967,21,6.69
0,-4,0,-0.0,-4.0,0.5129921436309814,51.62363799656123,8,-27,-44,165,447,71,967,21,4.6
0,-3,0,-0.0,-3.0,0.5210521221160889,49.09175083453431,8,-27,-41,165,447,71,967,21,3.68
0,-3,0,-0.0,-3.0,0.5291440486907959,46.61544808322666,8,-27,-38,165,447,71,967,21,3.44
-1,-2,0,-1.0,-2.0,0.5387241840362549,44.40720662234904,8,-26,-36,165,447,71,967,21,5.07
-1,-2,0,-1.0,-2.0,0.5449440479278564,42.20189569201838,8,-25,-34,165,447,71,967,21,4.91
0,-2,0,-0.0,-2.0,0.5529520511627197,40.607881008493905,8,-25,-32,165,447,71,967,21,2.48
-1,-2,0,-1.0,-2.0,0.5609450340270996,38.41874542459709,8,-24,-30,165,447,71,967,21,4.46
-1,-1,0,-1.0,-1.0,0.5697400569915771,37.013511046643494,8,-23,-29,165,447,71,967,21,4.7
0,-2,0,-0.0,-2.0,0.5769391059875488,35.4682957019364,8,-23,-27,165,447,71,967,21,2.19
-1,-2,0,-1.0,-2.0,0.5850422382354736,33.301651610693426,8,-22,-25,165,447,71,967,21,3.95
-1,-1,0,-1.0,-1.0,0.5929322242736816,31.89043743820395,8,-21,-24,165,447,71,967,21,5.25
-1,-2,0,-1.0,-2.0,0.6009340286254883,29.732137494637012,8,-20,-22,165,447,71,967,21,3.71
-2,-1,0,-2.0,-1.0,0.6102321147918701,27.65863337187866,8,-18,-21,165,447,71,967,21,3.03
-1,-2,0,-1.0,-2.0,0.6169450283050537,25.495097567963924,8,-17,-19,165,447,71,967,21,3.55
-3,-2,0,-3.0,-2.0,0.6249630451202393,22.02271554554524,8,-14,-17,165,447,71,967,21,3.75
-2,-2,0,-2.0,-2.0,0.632965087890625,19.209372712298546,8,-12,-15,165,447,71,967,21,4.66
-2,-2,0,-2.0,-2.0,0.6409502029418945,16.401219466856727,8,-10,-13,165,447,71,967,21,4.24
-2,-1,0,-2.0,-1.0,0.6489951610565186,14.422205101855956,8,-8,-12,165,447,71,967,21,1.86
-3,-2,0,-3.0,-2.0,0.6569311618804932,11.180339887498949,8,-5,-10,165,447,71,967,21,1.89
-1,-2,0,-1.0,-2.0,0.6649501323699951,8.94427190999916,8,-4,-8,165,447,71,967,21,7.89
-2,-1,0,-2.0,-1.0,0.6729350090026855,7.280109889280518,8,-2,-7,165,447,71,967,21,0.39
-2,-2,0,-2.0,-2.0,0.6811201572418213,5.0,8,0,-5,165,447,71,967,21,0.23
-1,-2,0,-1.0,-2.0,0.6889481544494629,3.1622776601683795,8,1,-3,165,447,71,967,21,-0.18
-1,-2,0,-1.0,-2.0,0.6970090866088867,2.23606797749979,8,2,-1,165,447,71,967,21,-1.85
0,-2,0,-0.0,-2.0,0.7049651145935059,2.23606797749979,8,2,1,165,447,71,967,21,8.37
-1,-1,0,-1.0,-1.0,0.7129390239715576,3.605551275463989,8,3,2,165,447,71,967,21,0.52
0,-1,0,-0.0,-1.0,0.720933198928833,4.242640687119285,8,3,3,165,447,71,967,21,0.03
0,0,1,-0.0,-0.0,0.7559800148010254,4.242640687119285,8,3,3,165,447,71,967,21,28.17
0,0,0,-0.0,-0.0,0.07500600814819336,690.7807177389942,9,427,543,589,987,162,444,46,165.45
2,0,0,2.0,-0.0,0.11801600456237793,689.5462276018918,9,425,543,589,987,162,444,46,5.03
2,0,0,2.0,-0.0,0.12714290618896484,688.3153347122233,9,423,543,589,987,162,444,46,5.01
4,1,0,4.0,1.0,0.1339879035949707,685.0729888121411,9,419,542,589,987,162,444,46,11.68
6,1,0,6.0,1.0,0.14218997955322266,680.6247130394253,9,413,541,589,987,162,444,46,14.95
6,1,0,6.0,1.0,0.14995884895324707,676.201892928436,9,407,540,589,987,162,444,46,14.81
6,0,0,6.0,-0.0,0.1581418514251709,672.6076122078905,9,401,540,589,987,162,444,46,12.1
8,1,0,8.0,1.0,0.16705679893493652,667.0607168766574,9,393,539,589,987,162,444,46,17.65
8,1,0,8.0,1.0,0.17401790618896484,661.5655674232147,9,385,538,589,987,162,444,46,17.41
9,2,0,9.0,2.0,0.18473386764526367,654.730478899524,9,376,536,589,987,162,444,46,20.91
9,3,0,9.0,3.0,0.19010591506958008,647.1305896030568,9,367,533,589,987,162,444,46,22.84
9,3,0,9.0,3.0,0.19818401336669922,639.5811129168841,9,358,530,589,987,162,444,46,22.53
9,5,0,9.0,5.0,0.2059948444366455,630.4173220970375,9,349,525,589,987,162,444,46,26.53
10,6,0,10.0,6.0,0.21401500701904297,619.9048314055957,9,339,519,589,987,162,444,46,29.26
10,6,0,10.0,6.0,0.22200489044189453,609.4341637945809,9,329,513,589,987,162,444,46,28.84
11,8,0,11.0,8.0,0.23088788986206055,596.7822048285287,9,318,505,589,987,162,444,46,33.08
11,10,0,11.0,10.0,0.23801589012145996,582.4723169387538,9,307,495,589,987,162,444,46,36.07
11,10,0,11.0,10.0,0.24633383750915527,568.1909890168973,9,296,485,589,987,162,444,46,35.43
9,12,0,9.0,12.0,0.2545959949493408,553.2612402834668,9,287,473,589,987,162,444,46,37.38
10,14,0,10.0,14.0,0.2620058059692383,536.1063327363332,9,277,459,589,987,162,444,46,40.52
10,16,0,10.0,16.0,0.27220797538757324,517.2407563214639,9,267,443,589,987,162,444,46,43.78
11,16,0,11.0,16.0,0.27799391746520996,497.86042220686716,9,256,427,589,987,162,444,46,42.15
11,17,0,11.0,17.0,0.28609681129455566,477.62432936357,9,245,410,589,987,162,444,46,42.85
13,20,0,13.0,20.0,0.2940409183502197,453.7884969895116,9,232,390,589,987,162,444,46,45.68
12,22,0,12.0,22.0,0.3019888401031494,428.74701165139334,9,220,368,589,987,162,444,46,45.39
15,23,0,15.0,23.0,0.3099789619445801,401.3103537164223,9,205,345,589,987,162,444,46,45.78
13,29,0,13.0,29.0,0.3179969787597656,369.7566767483719,9,192,316,589,987,162,444,46,45.5
15,29,0,15.0,29.0,0.3260159492492676,337.19134033957636,9,177,287,589,987,162,444,46,44.17
13,23,0,13.0,23.0,0.3344290256500244,310.792535302893,9,164,264,589,987,162,444,46,38.05
11,22,0,11.0,22.0,0.3444390296936035,286.3092733391638,9,153,242,589,987,162,444,46,33.51
11,20,0,11.0,20.0,0.35004186630249023,263.52988445335757,9,142,222,589,987,162,444,46,30.94
9,18,0,9.0,18.0,0.35797595977783203,243.52617929085162,9,133,204,589,987,162,444,46,26.56
9,15,0,9.0,15.0,0.3660140037536621,226.04645540242387,9,124,189,589,987,162,444,46,24.6
7,13,0,7.0,13.0,0.37396693229675293,211.3409567499873,9,117,176,589,987,162,444,46,20.33
4,10,0,4.0,10.0,0.38196492195129395,200.81085628023203,9,113,166,589,987,162,444,46,14.92
3,9,0,3.0,9.0,0.3900628089904785,191.70028690641024,9,110,157,589,987,162,444,46,12.77
4,8,0,4.0,8.0,0.39798688888549805,182.8578683021324,9,106,149,589,987,162,444,46,13.0
2,6,0,2.0,6.0,0.40607190132141113,176.81911661356077,9,104,143,589,987,162,444,46,9.16
2,4,0,2.0,4.0,0.4140019416809082,172.40939649566667,9,102,139,589,987,162,444,46,8.21
2,5,0,2.0,5.0,0.4220468997955322,167.20047846821492,9,100,134,589,987,162,444,46,8.29
1,3,0,1.0,3.0,0.43185901641845703,164.20109622045769,9,99,131,589,987,162,444,46,5.68
1,4,0,1.0,4.0,0.4385390281677246,160.41508657230466,9,98,127,589,987,162,444,46,6.08
1,3,0,1.0,3.0,0.4459660053253174,157.4325252290644,9,97,124,589,987,162,444,46,5.48
1,3,0,1.0,3.0,0.4539828300476074,154.45711378890906,9,96,121,589,987,162,444,46,5.39
1,3,0,1.0,3.0,0.46202588081359863,151.48927354766738,9,95,118,589,987,162,444,46,5.3
1,3,0,1.0,3.0,0.4718480110168457,148.52945835759317,9,94,115,589,987,162,444,46,5.21
1,2,0,1.0,2.0,0.4780869483947754,146.3488981851247,9,93,113,589,987,162,444,46,5.09
1,1,0,1.0,1.0,0.4860048294067383,144.9413674559475,9,92,112,589,987,162,444,46,5.39
0,2,0,-0.0,2.0,0.49453091621398926,143.4015341619468,9,92,110,589,987,162,444,46,2.83
0,1,0,-0.0,1.0,0.5049178600311279,142.63590010933433,9,92,109,589,987,162,444,46,2.06
1,1,0,1.0,1.0,0.5099668502807617,141.2267680009707,9,91,108,589,987,162,444,46,5.52
1,0,0,1.0,-0.0,0.5180649757385254,140.5844941663198,9,90,108,589,987,162,444,46,1.6
0,2,0,-0.0,2.0,0.5260248184204102,139.05394636614957,9,90,106,589,987,162,444,46,2.77
1,2,0,1.0,2.0,0.5339658260345459,136.88316185711082,9,89,104,589,987,162,444,46,4.84
1,1,0,1.0,1.0,0.5419638156890869,135.47324459095236,9,88,103,589,987,162,444,46,5.58
2,2,0,2.0,2.0,0.5500278472900391,132.6536844569347,9,86,101,589,987,162,444,46,6.81
1,2,0,1.0,2.0,0.5580430030822754,130.4837154590564,9,85,99,589,987,162,444,46,4.74
1,2,0,1.0,2.0,0.5659868717193604,128.3160161476345,9,84,97,589,987,162,444,46,4.69
3,3,0,3.0,3.0,0.5765688419342041,124.08464852672147,9,81,94,589,987,162,444,46,7.91
4,3,0,4.0,3.0,0.5843160152435303,119.20570456148481,9,77,91,589,987,162,444,46,6.82
6,5,0,6.0,5.0,0.589979887008667,111.5212984142491,9,71,86,589,987,162,444,46,8.72
8,5,0,8.0,5.0,0.5979669094085693,102.61578825892242,9,63,81,589,987,162,444,46,8.13
8,4,0,8.0,4.0,0.605963945388794,94.62557793746889,9,55,77,589,987,162,444,46,6.73
8,5,0,8.0,5.0,0.6139910221099854,85.98255637046388,9,47,72,589,987,162,444,46,6.8
7,5,0,7.0,5.0,0.6220028400421143,78.03204469959762,9,40,67,589,987,162,444,46,6.13
7,5,0,7.0,5.0,0.6320459842681885,70.2353187506115,9,33,62,589,987,162,444,46,5.49
8,4,0,8.0,4.0,0.6393330097198486,63.15853069855251,9,25,58,589,987,162,444,46,4.18
7,6,0,7.0,6.0,0.6484649181365967,55.02726596879042,9,18,52,589,987,162,444,46,4.58
7,5,0,7.0,5.0,0.6563339233398438,48.27007354458868,9,11,47,589,987,162,444,46,3.25
7,5,0,7.0,5.0,0.6619830131530762,42.190046219457976,9,4,42,589,987,162,444,46,2.43
5,5,0,5.0,5.0,0.6706359386444092,37.013511046643494,9,-1,37,589,987,162,444,46,2.03
6,5,0,6.0,5.0,0.6807119846343994,32.7566787083184,9,-7,32,589,987,162,444,46,1.02
4,4,0,4.0,4.0,0.6859819889068604,30.083217912982647,9,-11,28,589,987,162,444,46,0.48
4,4,0,4.0,4.0,0.6958479881286621,28.30194339616981,9,-15,24,589,987,162,444,46,-0.09
2,2,0,2.0,2.0,0.7021598815917969,27.80287754891569,9,-17,22,589,987,162,444,46,-0.23
2,4,0,2.0,4.0,0.7099628448486328,26.1725046566048,9,-19,18,589,987,162,444,46,0.0
1,3,0,1.0,3.0,0.7184348106384277,25.0,9,-20,15,589,987,162,444,46,0.04
2,3,0,2.0,3.0,0.725970983505249,25.059928172283335,9,-22,12,589,987,162,444,46,3.97
1,3,0,1.0,3.0,0.7339680194854736,24.698178070456937,9,-23,9,589,987,162,444,46,-0.48
2,3,0,2.0,3.0,0.7419898509979248,25.709920264364882,9,-25,6,589,987,162,444,46,-0.28
1,3,0,1.0,3.0,0.7531089782714844,26.1725046566048,9,-26,3,589,987,162,444,46,0.18
1,2,0,1.0,2.0,0.758004903793335,27.018512172212592,9,-27,1,589,987,162,444,46,0.25
1,2,0,1.0,2.0,0.7659919261932373,28.0178514522438,9,-28,-1,589,987,162,444,46,0.28
0,1,0,-0.0,1.0,0.7739818096160889,28.071337695236398,9,-28,-2,589,987,162,444,46,5.28
0,1,0,-0.0,1.0,0.7819898128509521,28.160255680657446,9,-28,-3,589,987,162,444,46,3.58
1,1,0,1.0,1.0,0.7901170253753662,29.274562336608895,9,-29,-4,589,987,162,444,46,1.17
0,0,1,-0.0,-0.0,0.813978910446167,29.274562336608895,9,-29,-4,589,987,162,444,46,35.730000000000004
0,0,0,-0.0,-0.0,0.09665989875793457,669.6058542157468,10,-404,-534,214,457,618,991,57,162.35
0,-1,0,-0.0,-1.0,0.17711901664733887,668.8086422886594,10,-404,-533,214,457,618,991,57,3.52
0,-1,0,-0.0,-1.0,0.18522000312805176,668.0119759405516,10,-404,-532,214,457,618,991,57,3.51
0,-3,0,-0.0,-3.0,0.192673921585083,665.6252699529969,10,-404,-529,214,457,618,991,57,7.56
-1,-5,0,-1.0,-5.0,0.20198392868041992,661.0484097250367,10,-403,-524,214,457,618,991,57,13.26
-3,-5,0,-3.0,-5.0,0.2091538906097412,655.2564383506659,10,-400,-519,214,457,618,991,57,17.78
-4,-8,0,-4.0,-8.0,0.21729588508605957,646.4804714761306,10,-396,-511,214,457,618,991,57,23.2
-6,-9,0,-6.0,-9.0,0.2246558666229248,635.6917491992483,10,-390,-502,214,457,618,991,57,28.09
-9,-11,0,-9.0,-11.0,0.23264384269714355,621.4837085555823,10,-381,-491,214,457,618,991,57,34.79
-12,-13,0,-12.0,-13.0,0.24412107467651367,603.8584271168202,10,-369,-478,214,457,618,991,57,38.19
-13,-16,0,-13.0,-16.0,0.24974298477172852,583.2495177880561,10,-356,-462,214,457,618,991,57,42.93
-11,-13,0,-11.0,-13.0,0.25661706924438477,566.2384656661891,10,-345,-449,214,457,618,991,57,36.62
-11,-15,0,-11.0,-15.0,0.26506686210632324,547.6422189714741,10,-334,-434,214,457,618,991,57,38.83
-14,-18,0,-14.0,-18.0,0.2726118564605713,524.8390229394153,10,-320,-416,214,457,618,991,57,44.12
-16,-20,0,-16.0,-20.0,0.2807588577270508,499.2314092682871,10,-304,-396,214,457,618,991,57,45.09
-17,-20,0,-17.0,-20.0,0.28866004943847656,473.0169130168603,10,-287,-376,214,457,618,991,57,43.26
-19,-21,0,-19.0,-21.0,0.296644926071167,444.8022032319534,10,-268,-355,214,457,618,991,57,42.87
-21,-19,0,-21.0,-19.0,0.3046538829803467,417.0191842109905,10,-247,-336,214,457,618,991,57,39.67
-20,-19,0,-20.0,-19.0,0.31305503845214844,389.89485762189787,10,-227,-317,214,457,618,991,57,37.47
-19,-19,0,-19.0,-19.0,0.32062506675720215,363.4116123626211,10,-208,-298,214,457,618,991,57,35.33
-19,-18,0,-19.0,-18.0,0.32868003845214844,337.8179983363823,10,-189,-280,214,457,618,991,57,32.64
-18,-18,0,-18.0,-18.0,0.33701300621032715,312.86578592105593,10,-171,-262,214,457,618,991,57,30.57
-18,-18,0,-18.0,-18.0,0.34463000297546387,288.00173610587836,10,-153,-244,214,457,618,991,57,28.71
-17,-17,0,-17.0,-17.0,0.3534379005432129,264.62237244798484,10,-136,-227,214,457,618,991,57,25.93
-14,-16,0,-14.0,-16.0,0.36063385009765625,243.73140954747709,10,-122,-211,214,457,618,991,57,23.12
-12,-15,0,-12.0,-15.0,0.3687460422515869,224.75764725588314,10,-110,-196,214,457,618,991,57,20.82
-9,-12,0,-9.0,-12.0,0.3766779899597168,209.89759407863636,10,-101,-184,214,457,618,991,57,17.21
-8,-12,0,-8.0,-12.0,0.3863699436187744,195.5326059765992,10,-93,-172,214,457,618,991,57,16.66
-7,-11,0,-7.0,-11.0,0.39432287216186523,182.52944967867515,10,-86,-161,214,457,618,991,57,15.29
-7,-11,0,-7.0,-11.0,0.40163493156433105,169.53170794869024,10,-79,-150,214,457,618,991,57,14.54
-6,-12,0,-6.0,-12.0,0.4086759090423584,156.11854470241516,10,-73,-138,214,457,618,991,57,15.58
-6,-10,0,-6.0,-10.0,0.41664791107177734,144.4749113168096,10,-67,-128,214,457,618,991,57,12.87
-4,-8,0,-4.0,-8.0,0.4251890182495117,135.5322839769182,10,-63,-120,214,457,618,991,57,11.99
-4,-9,0,-4.0,-9.0,0.4327080249786377,125.70600622086441,10,-59,-111,214,457,618,991,57,10.7
-2,-8,0,-2.0,-8.0,0.4407670497894287,117.72000679578642,10,-57,-103,214,457,618,991,57,7.59
-3,-9,0,-3.0,-9.0,0.448624849319458,108.40664186294121,10,-54,-94,214,457,618,991,57,8.27
-2,-7,0,-2.0,-7.0,0.45661187171936035,101.35580891098448,10,-52,-87,214,457,618,991,57,6.49
-2,-8,0,-2.0,-8.0,0.46470093727111816,93.49331526906082,10,-50,-79,214,457,618,991,57,6.28
-2,-6,0,-2.0,-6.0,0.4728069305419922,87.36704184073076,10,-48,-73,214,457,618,991,57,5.56
-1,-7,0,-1.0,-7.0,0.48064684867858887,81.02468759581859,10,-47,-66,214,457,618,991,57,4.55
-1,-6,0,-1.0,-6.0,0.48895692825317383,75.6042326857432,10,-46,-60,214,457,618,991,57,3.96
-2,-7,0,-2.0,-7.0,0.4966440200805664,68.8839603971781,10,-44,-53,214,457,618,991,57,4.44
-2,-8,0,-2.0,-8.0,0.5053980350494385,61.554853586049575,10,-42,-45,214,457,618,991,57,4.04
-2,-7,0,-2.0,-7.0,0.5174520015716553,55.17245689653489,10,-40,-38,214,457,618,991,57,3.4
-1,-7,0,-1.0,-7.0,0.5206429958343506,49.8196748283246,10,-39,-31,214,457,618,991,57,2.33
-2,-5,0,-2.0,-5.0,0.5287349224090576,45.221676218380054,10,-37,-26,214,457,618,991,57,2.42
-2,-6,0,-2.0,-6.0,0.536625862121582,40.311288741492746,10,-35,-20,214,457,618,991,57,1.92
-2,-5,0,-2.0,-5.0,0.5453159809112549,36.24913792078372,10,-33,-15,214,457,618,991,57,1.52
-1,-4,0,-1.0,-4.0,0.553117036819458,33.83784863137726,10,-32,-11,214,457,618,991,57,0.73
-2,-4,0,-2.0,-4.0,0.5606460571289062,30.805843601498726,10,-30,-7,214,457,618,991,57,0.93
-3,-4,0,-3.0,-4.0,0.5686209201812744,27.16615541441225,10,-27,-3,214,457,618,991,57,0.98
-2,-4,0,-2.0,-4.0,0.5766968727111816,25.019992006393608,10,-25,1,214,457,618,991,57,0.12
-2,-3,0,-2.0,-3.0,0.5857639312744141,23.345235059857504,10,-23,4,214,457,618,991,57,0.06
-2,-3,0,-2.0,-3.0,0.5927739143371582,22.135943621178654,10,-21,7,214,457,618,991,57,-0.26
-1,-1,0,-1.0,-1.0,0.6020760536193848,21.540659228538015,10,-20,8,214,457,618,991,57,0.2
-2,-1,0,-2.0,-1.0,0.6095900535583496,20.12461179749811,10,-18,9,214,457,618,991,57,0.44
0,-1,0,-0.0,-1.0,0.6166708469390869,20.591260281974,10,-18,10,214,457,618,991,57,0.76
-1,0,0,-1.0,-0.0,0.6246359348297119,19.72308292331602,10,-17,10,214,457,618,991,57,1.42
0,0,1,-0.0,-0.0,0.6496570110321045,19.72308292331602,10,-17,10,214,457,618,991,57,32.82
0,-1,1,-0.0,-1.0,0.05347108840942383,507.0009861923347,11,339,377,570,823,231,447,49,4.66
0,-1,1,-0.0,-1.0,0.06152510643005371,507.74501474657535,11,339,378,570,823,231,447,49,4.66
0,0,0,-0.0,-0.0,0.06649899482727051,507.74501474657535,11,339,378,570,823,231,447,49,136.66
0,-1,0,-0.0,-1.0,0.07042193412780762,508.48992123738304,11,339,379,570,823,231,447,49,4.67
0,-1,0,-0.0,-1.0,0.0779421329498291,509.2357018120391,11,339,380,570,823,231,447,49,4.67
0,-1,0,-0.0,-1.0,0.08550000190734863,509.9823526358535,11,339,381,570,823,231,447,49,4.67
1,-1,0,1.0,-1.0,0.09349203109741211,510.06666230993767,11,338,382,570,823,231,447,49,25.58
1,0,0,1.0,-0.0,0.10286211967468262,509.40455435733986,11,337,382,570,823,231,447,49,2.73
2,-1,0,2.0,-1.0,0.11095690727233887,508.83592640457294,11,335,383,570,823,231,447,49,1.84
1,0,0,1.0,-0.0,0.12829303741455078,508.17811837976654,11,334,383,570,823,231,447,49,2.7
2,-1,0,2.0,-1.0,0.13424992561340332,507.6219065406851,11,332,384,570,823,231,447,49,1.8
2,-1,0,2.0,-1.0,0.13616394996643066,507.0749451511088,11,330,385,570,823,231,447,49,1.77
2,0,0,2.0,-0.0,0.14148592948913574,505.77564195995046,11,328,385,570,823,231,447,49,4.29
1,-1,0,1.0,-1.0,0.1497049331665039,505.8903043150758,11,327,386,570,823,231,447,49,19.78
2,0,0,2.0,-0.0,0.15842103958129883,504.59984145855617,11,325,386,570,823,231,447,49,4.25
2,0,0,2.0,-0.0,0.16545510292053223,503.3140172894055,11,323,386,570,823,231,447,49,4.23
3,0,0,3.0,-0.0,0.1833820343017578,501.39405660617876,11,320,386,570,823,231,447,49,5.76
3,0,0,3.0,-0.0,0.18371200561523438,499.484734501466,11,317,386,570,823,231,447,49,5.71
5,2,0,5.0,2.0,0.18945598602294922,494.77267507411926,11,312,384,570,823,231,447,49,12.82
9,4,0,9.0,4.0,0.1974639892578125,486.01337430157207,11,303,380,570,823,231,447,49,20.74
12,7,0,12.0,7.0,0.2054760456085205,473.0856159301401,11,291,373,570,823,231,447,49,27.71
14,8,0,14.0,8.0,0.21357107162475586,458.2073766320224,11,277,365,570,823,231,447,49,29.95
15,9,0,15.0,9.0,0.22178912162780762,442.01809917694544,11,262,356,570,823,231,447,49,31.08
18,9,0,18.0,9.0,0.22944211959838867,424.19924563817887,11,244,347,570,823,231,447,49,32.0
19,13,0,19.0,13.0,0.2374279499053955,402.7170222376998,11,225,334,570,823,231,447,49,35.45
19,14,0,19.0,14.0,0.2473909854888916,380.5732518188844,11,206,320,570,823,231,447,49,34.85
16,15,0,16.0,15.0,0.2537360191345215,359.339672176619,11,190,305,570,823,231,447,49,33.09
14,17,0,14.0,17.0,0.262037992477417,337.5203697556638,11,176,288,570,823,231,447,49,33.13
12,18,0,12.0,18.0,0.26943302154541016,315.9050490258109,11,164,270,570,823,231,447,49,33.04
11,20,0,11.0,20.0,0.279526948928833,293.10237119477557,11,153,250,570,823,231,447,49,32.39
11,19,0,11.0,19.0,0.2861359119415283,271.15493725912495,11,142,231,570,823,231,447,49,30.77
11,20,0,11.0,20.0,0.2934379577636719,248.35861168882386,11,131,211,570,823,231,447,49,28.96
12,19,0,12.0,19.0,0.3067610263824463,225.88713996153035,11,119,192,570,823,231,447,49,28.8
13,18,0,13.0,18.0,0.3097550868988037,203.74493858744074,11,106,174,570,823,231,447,49,24.57
10,12,0,10.0,12.0,0.31751298904418945,188.30825791770258,11,96,162,570,823,231,447,49,17.97
11,12,0,11.0,12.0,0.32552003860473633,172.40939649566667,11,85,150,570,823,231,447,49,16.78
10,11,0,10.0,11.0,0.333590030670166,157.94302770302968,11,75,139,570,823,231,447,49,14.8
11,11,0,11.0,11.0,0.3446218967437744,143.10835055998655,11,64,128,570,823,231,447,49,13.65
10,11,0,10.0,11.0,0.3512129783630371,128.86038956948718,11,54,117,570,823,231,447,49,12.44
9,9,0,9.0,9.0,0.3574490547180176,117.0,11,45,108,570,823,231,447,49,10.02
9,7,0,9.0,7.0,0.3668050765991211,107.2240644631605,11,36,101,570,823,231,447,49,7.77
6,7,0,6.0,7.0,0.3769969940185547,98.67117106835208,11,30,94,570,823,231,447,49,7.21
6,7,0,6.0,7.0,0.3862791061401367,90.24965373894794,11,24,87,570,823,231,447,49,6.59
6,6,0,6.0,6.0,0.3905069828033447,82.97590011563598,11,18,81,570,823,231,447,49,5.31
6,5,0,6.0,5.0,0.39922094345092773,76.94153624668537,11,12,76,570,823,231,447,49,4.11
4,4,0,4.0,4.0,0.4078850746154785,72.44308110509934,11,8,72,570,823,231,447,49,3.37
3,3,0,3.0,3.0,0.4146740436553955,69.18092222571191,11,5,69,570,823,231,447,49,2.65
2,0,0,2.0,-0.0,0.4240579605102539,69.06518659932803,11,3,69,570,823,231,447,49,0.03
0,1,0,-0.0,1.0,0.42964601516723633,68.06614430096654,11,3,68,570,823,231,447,49,5.31
0,1,0,-0.0,1.0,0.43742895126342773,67.06713054842886,11,3,67,570,823,231,447,49,5.29
-1,1,0,-1.0,1.0,0.4560670852661133,66.12110101926616,11,4,66,570,823,231,447,49,1.37
-2,1,0,-2.0,1.0,0.461712121963501,65.27633568147036,11,6,65,570,823,231,447,49,0.73
-1,2,0,-1.0,2.0,0.46944308280944824,63.387695966961914,11,7,63,570,823,231,447,49,2.3
-2,1,0,-2.0,1.0,0.4794340133666992,62.64982043070834,11,9,62,570,823,231,447,49,0.59
-1,0,0,-1.0,-0.0,0.48557209968566895,62.80127387243033,11,10,62,570,823,231,447,49,3.6
-1,1,0,-1.0,1.0,0.49651098251342773,61.98386886924694,11,11,61,570,823,231,447,49,1.08
-1,1,0,-1.0,1.0,0.501971960067749,61.18823416311342,11,12,60,570,823,231,447,49,1.04
-1,1,0,-1.0,1.0,0.5174860954284668,60.41522986797286,11,13,59,570,823,231,447,49,0.99
-1,1,0,-1.0,1.0,0.5257000923156738,59.665735560705194,11,14,58,570,823,231,447,49,0.94
-1,2,0,-1.0,2.0,0.5388901233673096,57.97413216254298,11,15,56,570,823,231,447,49,1.78
0,1,0,-0.0,1.0,0.5446228981018066,57.0087712549569,11,15,55,570,823,231,447,49,2.96
0,1,0,-0.0,1.0,0.5574779510498047,56.04462507680822,11,15,54,570,823,231,447,49,2.93
0,2,0,-0.0,2.0,0.5669279098510742,54.120236510939236,11,15,52,570,823,231,447,49,3.18
0,1,0,-0.0,1.0,0.5834629535675049,53.16013544000805,11,15,51,570,823,231,447,49,2.82
0,1,0,-0.0,1.0,0.5838069915771484,52.20153254455275,11,15,50,570,823,231,447,49,2.79
0,2,0,-0.0,2.0,0.5894880294799805,50.28916384272063,11,15,48,570,823,231,447,49,3.0
1,2,0,1.0,2.0,0.597459077835083,48.08326112068523,11,14,46,570,823,231,447,49,3.86
1,4,0,1.0,4.0,0.6054549217224121,43.965895873961216,11,13,42,570,823,231,447,49,5.75
2,4,0,2.0,4.0,0.613955020904541,39.56008088970496,11,11,38,570,823,231,447,49,4.09
1,5,0,1.0,5.0,0.6217191219329834,34.48187929913333,11,10,33,570,823,231,447,49,4.89
3,4,0,3.0,4.0,0.6300699710845947,29.832867780352597,11,7,29,570,823,231,447,49,2.56
2,5,0,2.0,5.0,0.6376299858093262,24.515301344262525,11,5,24,570,823,231,447,49,3.6
4,4,0,4.0,4.0,0.6473441123962402,20.024984394500787,11,1,20,570,823,231,447,49,1.06
3,5,0,3.0,5.0,0.6535060405731201,15.132745950421556,11,-2,15,570,823,231,447,49,0.92
4,4,0,4.0,4.0,0.6643140316009521,12.529964086141668,11,-6,11,570,823,231,447,49,-0.69
3,4,0,3.0,4.0,0.6697230339050293,11.40175425099138,11,-9,7,570,823,231,447,49,-1.29
3,4,0,3.0,4.0,0.6774389743804932,12.36931687685298,11,-12,3,570,823,231,447,49,-1.43
3,3,0,3.0,3.0,0.6864469051361084,15.0,11,-15,0,570,823,231,447,49,-0.89
3,3,0,3.0,3.0,0.6950371265411377,18.24828759089466,11,-18,-3,570,823,231,447,49,-0.39
2,2,0,2.0,2.0,0.7019391059875488,20.615528128088304,11,-20,-5,570,823,231,447,49,0.42
0,0,1,-0.0,-0.0,0.7074570655822754,20.615528128088304,11,-20,-5,570,823,231,447,49,33.09
2,2,1,2.0,2.0,0.7164900302886963,23.08679276123039,11,-22,-7,570,823,231,447,49,10.7
0,0,0,-0.0,-0.0,0.7934660911560059,23.08679276123039,11,-22,-7,570,823,231,447,49,23.84
1,0,0,1.0,-0.0,0.805495023727417,24.041630560342615,11,-23,-7,570,823,231,447,49,2.32
1,0,0,1.0,-0.0,0.8138039112091064,25.0,11,-24,-7,570,823,231,447,49,2.39
1,0,0,1.0,-0.0,0.8228940963745117,25.96150997149434,11,-25,-7,570,823,231,447,49,2.47
3,0,0,3.0,-0.0,0.8295180797576904,28.861739379323623,11,-28,-7,570,823,231,447,49,1.75
2,0,0,2.0,-0.0,0.8374829292297363,30.805843601498726,11,-30,-7,570,823,231,447,49,2.26
4,0,0,4.0,-0.0,0.8454649448394775,34.713109915419565,11,-34,-7,570,823,231,447,49,1.89
3,-1,0,3.0,-1.0,0.8534359931945801,37.48332962798263,11,-37,-6,570,823,231,447,49,1.01
5,0,0,5.0,-0.0,0.8614470958709717,42.42640687119285,11,-42,-6,570,823,231,447,49,2.35
5,-1,0,5.0,-1.0,0.8694610595703125,47.265209192385896,11,-47,-5,570,823,231,447,49,1.39
5,-1,0,5.0,-1.0,0.8814558982849121,52.15361924162119,11,-52,-4,570,823,231,447,49,1.62
6,-1,0,6.0,-1.0,0.8855171203613281,58.077534382926416,11,-58,-3,570,823,231,447,49,1.87
6,-2,0,6.0,-2.0,0.8934988975524902,64.00781202322104,11,-64,-1,570,823,231,447,49,1.32
7,-3,0,7.0,-3.0,0.9050741195678711,71.02816342831905,11,-71,2,570,823,231,447,49,1.09
6,-3,0,6.0,-3.0,0.9148499965667725,77.1621668954417,11,-77,5,570,823,231,447,49,1.2
5,-4,0,5.0,-4.0,0.9184761047363281,82.49242389456137,11,-82,9,570,823,231,447,49,0.84
3,-4,0,3.0,-4.0,0.9254770278930664,85.98837130682264,11,-85,13,570,823,231,447,49,0.68
3,-4,0,3.0,-4.0,0.9357509613037109,89.62700485902673,11,-88,17,570,823,231,447,49,0.77
1,-3,0,1.0,-3.0,0.9414589405059814,91.21951545584969,11,-89,20,570,823,231,447,49,0.82
0,-3,0,-0.0,-3.0,0.9495229721069336,91.92388155425118,11,-89,23,570,823,231,447,49,1.12
0,-3,0,-0.0,-3.0,0.9580891132354736,92.72000862812729,11,-89,26,570,823,231,447,49,1.04
0,-3,0,-0.0,-3.0,0.965925931930542,93.60555539069249,11,-89,29,570,823,231,447,49,0.98
0,-3,0,-0.0,-3.0,0.9785239696502686,94.57801012920498,11,-89,32,570,823,231,447,49,0.94
-1,-2,0,-1.0,-2.0,0.9817309379577637,94.33981132056604,11,-88,34,570,823,231,447,49,0.22
0,-1,0,-0.0,-1.0,0.9894521236419678,94.70480452437458,11,-88,35,570,823,231,447,49,2.46
0,-1,0,-0.0,-1.0,0.9982509613037109,95.0789145920377,11,-88,36,570,823,231,447,49,2.43
-1,0,0,-1.0,-0.0,1.0134921073913574,94.15412895885129,11,-87,36,570,823,231,447,49,2.68
-1,0,0,-1.0,-0.0,1.0330049991607666,93.23089616645332,11,-86,36,570,823,231,447,49,2.66
-2,0,0,-2.0,-0.0,1.0376310348510742,91.3892772703669,11,-84,36,570,823,231,447,49,3.18
-3,1,0,-3.0,1.0,1.0466210842132568,88.23831367382311,11,-81,35,570,823,231,447,49,5.97
-5,3,0,-5.0,3.0,1.053581953048706,82.46211251235322,11,-76,32,570,823,231,447,49,6.55
-6,3,0,-6.0,3.0,1.0616810321807861,75.76938695805846,11,-70,29,570,823,231,447,49,7.63
-8,3,0,-8.0,3.0,1.0694360733032227,67.23094525588644,11,-62,26,570,823,231,447,49,8.75
-7,4,0,-7.0,4.0,1.0778028964996338,59.23681287847955,11,-55,22,570,823,231,447,49,6.48
-7,3,0,-7.0,3.0,1.0855209827423096,51.62363799656123,11,-48,19,570,823,231,447,49,7.97
-6,3,0,-6.0,3.0,1.0960819721221924,44.94441010848846,11,-42,16,570,823,231,447,49,5.77
-6,2,0,-6.0,2.0,1.1014349460601807,38.62641583165593,11,-36,14,570,823,231,447,49,6.27
-6,4,0,-6.0,4.0,1.1094660758972168,31.622776601683793,11,-30,10,570,823,231,447,49,3.74
-5,2,0,-5.0,2.0,1.1174631118774414,26.248809496813376,11,-25,8,570,823,231,447,49,4.94
-5,2,0,-5.0,2.0,1.1254699230194092,20.8806130178211,11,-20,6,570,823,231,447,49,4.32
-4,1,0,-4.0,1.0,1.1369271278381348,16.76305461424021,11,-16,5,570,823,231,447,49,4.48
-4,1,0,-4.0,1.0,1.146960973739624,12.649110640673518,11,-12,4,570,823,231,447,49,3.81
-3,0,0,-3.0,-0.0,1.1502130031585693,9.848857801796104,11,-9,4,570,823,231,447,49,1.13
0,0,1,-0.0,-0.0,1.1564810276031494,9.848857801796104,11,-9,4,570,823,231,447,49,29.84
-1,1,1,-1.0,1.0,-0.0001304149627685547,1229.2863783512773,12,1152,-429,1730,391,579,819,39,6.33
-1,0,1,-1.0,-0.0,0.009003639221191406,1230.2235569196357,12,1153,-429,1730,391,579,819,39,8.18
-1,0,1,-1.0,-0.0,0.016316652297973633,1231.160834334816,12,1154,-429,1730,391,579,819,39,8.18
0,0,0,-0.0,-0.0,0.09287667274475098,1231.160834334816,12,1154,-429,1730,391,579,819,39,230.91
1,0,0,1.0,-0.0,0.12218570709228516,1230.2235569196357,12,1153,-429,1730,391,579,819,39,7.47
1,0,0,1.0,-0.0,0.12800359725952148,1229.2863783512773,12,1152,-429,1730,391,579,819,39,7.47
3,0,0,3.0,-0.0,0.13629460334777832,1226.4754379929507,12,1149,-429,1730,391,579,819,39,17.24
2,0,0,2.0,-0.0,0.14774680137634277,1224.6019761538848,12,1147,-429,1730,391,579,819,39,12.45
3,0,0,3.0,-0.0,0.15211963653564453,1221.792535580407,12,1144,-429,1730,391,579,819,39,17.19
2,-1,0,2.0,-1.0,0.16048979759216309,1219.5687762483917,12,1142,-428,1730,391,579,819,39,15.85
2,0,0,2.0,-0.0,0.17622971534729004,1217.6961854255765,12,1140,-428,1730,391,579,819,39,12.4
3,0,0,3.0,-0.0,0.18723368644714355,1214.8880606870741,12,1137,-428,1730,391,579,819,39,17.13
5,-1,0,5.0,-1.0,0.19850778579711914,1209.8566030732734,12,1132,-427,1730,391,579,819,39,28.6
9,-1,0,9.0,-1.0,0.19982671737670898,1201.0849262229544,12,1123,-426,1730,391,579,819,39,43.22
13,-2,0,13.0,-2.0,0.20798778533935547,1188.2238846278087,12,1110,-424,1730,391,579,819,39,57.31
19,-3,0,19.0,-3.0,0.21595072746276855,1169.4109628355636,12,1091,-421,1730,391,579,819,39,73.63
22,-5,0,22.0,-5.0,0.2237997055053711,1147.090667732939,12,1069,-416,1730,391,579,819,39,81.62
28,-6,0,28.0,-6.0,0.2319645881652832,1118.830192656598,12,1041,-410,1730,391,579,819,39,92.24
33,-8,0,33.0,-8.0,0.23981976509094238,1085.204128263434,12,1008,-402,1730,391,579,819,39,99.77
36,-9,0,36.0,-9.0,0.24821758270263672,1048.4431315049949,12,972,-393,1730,391,579,819,39,102.39
38,-10,0,38.0,-10.0,0.25754857063293457,1009.4775876660165,12,934,-383,1730,391,579,819,39,103.17
39,-12,0,39.0,-12.0,0.2637755870819092,968.8477692599596,12,895,-371,1730,391,579,819,39,103.23
37,-14,0,37.0,-14.0,0.27513957023620605,929.3078069186764,12,858,-357,1730,391,579,819,39,100.74
35,-14,0,35.0,-14.0,0.28249359130859375,891.615387933609,12,823,-343,1730,391,579,819,39,96.91
34,-14,0,34.0,-14.0,0.2940826416015625,854.8461849947042,12,789,-329,1730,391,579,819,39,94.14
31,-12,0,31.0,-12.0,0.29593467712402344,821.6160903974557,12,758,-317,1730,391,579,819,39,86.4
31,-14,0,31.0,-14.0,0.30379176139831543,787.615388371761,12,727,-303,1730,391,579,819,39,85.19
29,-13,0,29.0,-13.0,0.3139686584472656,755.846545272253,12,698,-290,1730,391,579,819,39,80.41
28,-14,0,28.0,-14.0,0.32108163833618164,724.6212803941104,12,670,-276,1730,391,579,819,39,76.66
30,-14,0,30.0,-14.0,0.32987260818481445,691.5518780250691,12,640,-262,1730,391,579,819,39,77.28
29,-15,0,29.0,-15.0,0.34079766273498535,659.0371764931019,12,611,-247,1730,391,579,819,39,73.62
31,-15,0,31.0,-15.0,0.3464086055755615,624.6791176276025,12,580,-232,1730,391,579,819,39,73.62
31,-15,0,31.0,-15.0,0.35454368591308594,590.330415953642,12,549,-217,1730,391,579,819,39,71.01
30,-13,0,30.0,-13.0,0.3598017692565918,557.6531179864414,12,519,-204,1730,391,579,819,39,67.73
29,-12,0,29.0,-12.0,0.36826157569885254,526.2736930533389,12,490,-192,1730,391,579,819,39,64.62
28,-10,0,28.0,-10.0,0.3758077621459961,496.5561398271096,12,462,-182,1730,391,579,819,39,60.12
27,-9,0,27.0,-9.0,0.3871126174926758,468.13886828589654,12,435,-173,1730,391,579,819,39,55.97
26,-9,0,26.0,-9.0,0.3918647766113281,440.65519400093314,12,409,-164,1730,391,579,819,39,53.11
23,-9,0,23.0,-9.0,0.4002096652984619,415.95793056509933,12,386,-155,1730,391,579,819,39,49.86
22,-8,0,22.0,-8.0,0.4077925682067871,392.56209699867867,12,364,-147,1730,391,579,819,39,45.55
20,-7,0,20.0,-7.0,0.4159657955169678,371.39736132611387,12,344,-140,1730,391,579,819,39,41.18
21,-8,0,21.0,-8.0,0.4257547855377197,348.9312253152475,12,323,-132,1730,391,579,819,39,41.72
21,-6,0,21.0,-6.0,0.4317626953125,327.2308053958246,12,302,-126,1730,391,579,819,39,37.44
20,-7,0,20.0,-7.0,0.4430546760559082,306.08005488760614,12,282,-119,1730,391,579,819,39,36.09
20,-6,0,20.0,-6.0,0.4489107131958008,285.3296339324046,12,262,-113,1730,391,579,819,39,33.32
19,-6,0,19.0,-6.0,0.45855259895324707,265.51459470243816,12,243,-107,1730,391,579,819,39,30.99
19,-6,0,19.0,-6.0,0.4707326889038086,245.7173172570464,12,224,-101,1730,391,579,819,39,29.3
16,-6,0,16.0,-6.0,0.4773087501525879,228.66788143506292,12,208,-95,1730,391,579,819,39,26.26
18,-7,0,18.0,-7.0,0.48313379287719727,209.3895890439637,12,190,-88,1730,391,579,819,39,26.72
15,-6,0,15.0,-6.0,0.4886195659637451,193.25889371514057,12,175,-82,1730,391,579,819,39,23.05
15,-6,0,15.0,-6.0,0.4960646629333496,177.13271860387624,12,160,-76,1730,391,579,819,39,21.7
14,-6,0,14.0,-6.0,0.5038397312164307,161.91355718407277,12,146,-70,1730,391,579,819,39,20.34
12,-4,0,12.0,-4.0,0.5139145851135254,149.37201879870273,12,134,-66,1730,391,579,819,39,15.95
11,-4,0,11.0,-4.0,0.5230257511138916,137.7425134081704,12,123,-62,1730,391,579,819,39,14.68
12,-4,0,12.0,-4.0,0.5283665657043457,125.23977004130916,12,111,-58,1730,391,579,819,39,14.01
11,-3,0,11.0,-3.0,0.5361917018890381,114.12712210513327,12,100,-55,1730,391,579,819,39,11.8
10,-3,0,10.0,-3.0,0.5438227653503418,103.94229168149026,12,90,-52,1730,391,579,819,39,10.57
11,-3,0,11.0,-3.0,0.5525646209716797,92.9623579735368,12,79,-49,1730,391,579,819,39,9.97
8,-3,0,8.0,-3.0,0.5599727630615234,84.59905436823747,12,71,-46,1730,391,579,819,39,8.41
7,-3,0,7.0,-3.0,0.5677986145019531,77.10382610480494,12,64,-43,1730,391,579,819,39,7.71
6,-2,0,6.0,-2.0,0.5761926174163818,71.02816342831905,12,58,-41,1730,391,579,819,39,6.02
5,-2,0,5.0,-2.0,0.5838437080383301,65.80273550544841,12,53,-39,1730,391,579,819,39,5.55
4,-1,0,4.0,-1.0,0.5918526649475098,62.00806399170998,12,49,-38,1730,391,579,819,39,3.98
4,-2,0,4.0,-2.0,0.5998036861419678,57.62811813689564,12,45,-36,1730,391,579,819,39,5.06
5,-1,0,5.0,-1.0,0.610020637512207,53.150729063673246,12,40,-35,1730,391,579,819,39,3.62
5,-1,0,5.0,-1.0,0.615816593170166,48.79549159502341,12,35,-34,1730,391,579,819,39,3.24
5,-1,0,5.0,-1.0,0.6243486404418945,44.598206241955516,12,30,-33,1730,391,579,819,39,2.84
5,-1,0,5.0,-1.0,0.6337475776672363,40.607881008493905,12,25,-32,1730,391,579,819,39,2.41
4,-2,0,4.0,-2.0,0.6407537460327148,36.61966684720111,12,21,-30,1730,391,579,819,39,2.8
4,-1,0,4.0,-1.0,0.6479086875915527,33.61547262794322,12,17,-29,1730,391,579,819,39,1.64
4,-2,0,4.0,-2.0,0.6568865776062012,29.966648127543394,12,13,-27,1730,391,579,819,39,1.96
3,-1,0,3.0,-1.0,0.663853645324707,27.85677655436824,12,10,-26,1730,391,579,819,39,1.05
2,-2,0,2.0,-2.0,0.6731147766113281,25.298221281347036,12,8,-24,1730,391,579,819,39,2.07
2,-1,0,2.0,-1.0,0.6863477230072021,23.769728648009426,12,6,-23,1730,391,579,819,39,0.91
2,-2,0,2.0,-2.0,0.6915056705474854,21.37755832643195,12,4,-21,1730,391,579,819,39,1.48
1,0,0,1.0,-0.0,0.6958305835723877,21.213203435596427,12,3,-21,1730,391,579,819,39,-0.02
0,-1,0,-0.0,-1.0,0.7084617614746094,20.223748416156685,12,3,-20,1730,391,579,819,39,3.33
1,-1,0,1.0,-1.0,0.7136847972869873,19.1049731745428,12,2,-19,1730,391,579,819,39,1.12
0,-1,0,-0.0,-1.0,0.7198686599731445,18.110770276274835,12,2,-18,1730,391,579,819,39,3.67
1,-1,0,1.0,-1.0,0.727846622467041,17.029386365926403,12,1,-17,1730,391,579,819,39,0.94
1,-1,0,1.0,-1.0,0.7392525672912598,16.0,12,0,-16,1730,391,579,819,39,0.78
1,-2,0,1.0,-2.0,0.7453517913818359,14.035668847618199,12,-1,-14,1730,391,579,819,39,1.24
1,-2,0,1.0,-2.0,0.753429651260376,12.165525060596439,12,-2,-12,1730,391,579,819,39,0.86
2,-2,0,2.0,-2.0,0.7599647045135498,10.770329614269007,12,-4,-10,1730,391,579,819,39,-0.37
1,-1,0,1.0,-1.0,0.7763617038726807,10.295630140987,12,-5,-9,1730,391,579,819,39,-0.33
0,0,1,-0.0,-0.0,0.7948207855224609,10.295630140987,12,-5,-9,1730,391,579,819,39,29.97
0,0,0,-0.0,-0.0,0.06597232818603516,337.91271062213684,13,68,-331,1803,69,1735,400,26,104.86
-1,0,0,-1.0,-0.0,0.07562923431396484,338.11536492741646,13,69,-331,1803,69,1735,400,26,15.98
-1,1,0,-1.0,1.0,0.07995438575744629,339.29927792437167,13,70,-332,1803,69,1735,400,26,4.59
-2,2,0,-2.0,2.0,0.08913922309875488,341.67235767618075,13,72,-334,1803,69,1735,400,26,3.03
-3,2,0,-3.0,2.0,0.0959322452545166,344.26879033685293,13,75,-336,1803,69,1735,400,26,2.47
-3,2,0,-3.0,2.0,0.105682373046875,346.88326566728466,13,78,-338,1803,69,1735,400,26,2.48
-3,3,0,-3.0,3.0,0.11550235748291016,350.48823090083926,13,81,-341,1803,69,1735,400,26,2.51
-5,3,0,-5.0,3.0,0.1201932430267334,354.5870838031188,13,86,-344,1803,69,1735,400,26,1.85
-5,4,0,-5.0,4.0,0.12822723388671875,359.70126494078386,13,91,-348,1803,69,1735,400,26,1.93
-6,3,0,-6.0,3.0,0.13592028617858887,364.156559737704,13,97,-351,1803,69,1735,400,26,1.68
-6,4,0,-6.0,4.0,0.1453723907470703,369.64036576110027,13,103,-355,1803,69,1735,400,26,1.75
-6,3,0,-6.0,3.0,0.152388334274292,374.22586762542215,13,109,-358,1803,69,1735,400,26,1.72
-5,3,0,-5.0,3.0,0.16713643074035645,378.5723180582542,13,114,-361,1803,69,1735,400,26,1.96
-3,2,0,-3.0,2.0,0.16805744171142578,381.3895646186455,13,117,-363,1803,69,1735,400,26,2.65
-2,1,0,-2.0,1.0,0.1759624481201172,382.95822226451804,13,119,-364,1803,69,1735,400,26,3.6
-2,0,0,-2.0,-0.0,0.1839463710784912,383.5844105278524,13,121,-364,1803,69,1735,400,26,6.61
0,-1,0,-0.0,-1.0,0.21592044830322266,382.6355968803739,13,121,-363,1803,69,1735,400,26,6.11
0,-4,0,-0.0,-4.0,0.22498631477355957,378.8429753869009,13,121,-359,1803,69,1735,400,26,15.78
0,-6,0,-0.0,-6.0,0.23297524452209473,373.1621631409058,13,121,-353,1803,69,1735,400,26,21.03
3,-7,0,3.0,-7.0,0.23995137214660645,365.5680511204446,13,118,-346,1803,69,1735,400,26,27.49
2,-8,0,2.0,-8.0,0.247955322265625,357.35136770411276,13,116,-338,1803,69,1735,400,26,28.39
3,-10,0,3.0,-10.0,0.25881528854370117,346.91929897311854,13,113,-328,1803,69,1735,400,26,33.33
5,-11,0,5.0,-11.0,0.26404237747192383,334.89252007173883,13,108,-317,1803,69,1735,400,26,34.44
5,-13,0,5.0,-13.0,0.2720303535461426,320.97507691408066,13,103,-304,1803,69,1735,400,26,37.59
6,-15,0,6.0,-15.0,0.2802584171295166,304.8442225137291,13,97,-289,1803,69,1735,400,26,39.07
7,-14,0,7.0,-14.0,0.28806543350219727,289.35272592460575,13,90,-275,1803,69,1735,400,26,35.73
8,-14,0,8.0,-14.0,0.2967872619628906,273.57814240176424,13,82,-261,1803,69,1735,400,26,34.24
8,-16,0,8.0,-16.0,0.3050343990325928,255.93163149560078,13,74,-245,1803,69,1735,400,26,35.11
8,-15,0,8.0,-15.0,0.3171422481536865,239.28226010300054,13,66,-230,1803,69,1735,400,26,32.19
8,-15,0,8.0,-15.0,0.3279154300689697,222.6858774148015,13,58,-215,1803,69,1735,400,26,30.46
7,-15,0,7.0,-15.0,0.32808637619018555,206.40009689920205,13,51,-200,1803,69,1735,400,26,28.85
6,-13,0,6.0,-13.0,0.33599042892456055,192.33824372703418,13,45,-187,1803,69,1735,400,26,25.25
6,-13,0,6.0,-13.0,0.3457753658294678,178.31713322056297,13,39,-174,1803,69,1735,400,26,23.82
4,-12,0,4.0,-12.0,0.3536243438720703,165.73774464496614,13,35,-162,1803,69,1735,400,26,22.18
4,-9,0,4.0,-9.0,0.360107421875,156.1089363233252,13,31,-153,1803,69,1735,400,26,17.39
3,-9,0,3.0,-9.0,0.3679683208465576,146.696966567138,13,28,-144,1803,69,1735,400,26,17.17
4,-9,0,4.0,-9.0,0.37642741203308105,137.11673858431726,13,24,-135,1803,69,1735,400,26,15.76
2,-8,0,2.0,-8.0,0.38451242446899414,128.89142717807107,13,22,-127,1803,69,1735,400,26,15.38
3,-8,0,3.0,-8.0,0.39277124404907227,120.50726119201282,13,19,-119,1803,69,1735,400,26,13.62
2,-7,0,2.0,-7.0,0.40153932571411133,113.28283188550682,13,17,-112,1803,69,1735,400,26,12.61
2,-6,0,2.0,-6.0,0.40808844566345215,107.05606008068857,13,15,-106,1803,69,1735,400,26,10.77
1,-6,0,1.0,-6.0,0.4164113998413086,100.9752444909147,13,14,-100,1803,69,1735,400,26,12.63
2,-5,0,2.0,-5.0,0.4239492416381836,95.75489543621255,13,12,-95,1803,69,1735,400,26,8.68
2,-6,0,2.0,-6.0,0.4320852756500244,89.56003573022959,13,10,-89,1803,69,1735,400,26,9.48
2,-4,0,2.0,-4.0,0.44048333168029785,85.37564055396598,13,8,-85,1803,69,1735,400,26,6.66
2,-5,0,2.0,-5.0,0.45108842849731445,80.22468448052632,13,6,-80,1803,69,1735,400,26,7.53
2,-4,0,2.0,-4.0,0.45623230934143066,76.10519036176179,13,4,-76,1803,69,1735,400,26,6.03
2,-5,0,2.0,-5.0,0.46392130851745605,71.02816342831905,13,2,-71,1803,69,1735,400,26,6.76
3,-5,0,3.0,-5.0,0.4719562530517578,66.007575322837,13,-1,-66,1803,69,1735,400,26,5.76
1,-4,0,1.0,-4.0,0.4799513816833496,62.03224967708329,13,-2,-62,1803,69,1735,400,26,5.82
2,-4,0,2.0,-4.0,0.48932433128356934,58.137767414994535,13,-4,-58,1803,69,1735,400,26,4.62
1,-3,0,1.0,-3.0,0.4960293769836426,55.226805085936306,13,-5,-55,1803,69,1735,400,26,4.2
1,-2,0,1.0,-2.0,0.504075288772583,53.33854141237835,13,-6,-53,1803,69,1735,400,26,2.93
1,-2,0,1.0,-2.0,0.5119524002075195,51.478150704935004,13,-7,-51,1803,69,1735,400,26,2.8
0,-2,0,-0.0,-2.0,0.5218403339385986,49.49747468305833,13,-7,-49,1803,69,1735,400,26,4.85
1,-2,0,1.0,-2.0,0.5279524326324463,47.67598976424087,13,-8,-47,1803,69,1735,400,26,2.59
1,-2,0,1.0,-2.0,0.5361192226409912,45.89117562233506,13,-9,-45,1803,69,1735,400,26,2.45
1,-2,0,1.0,-2.0,0.5444772243499756,44.14748010928823,13,-10,-43,1803,69,1735,400,26,2.3
1,-3,0,1.0,-3.0,0.5523092746734619,41.48493702538308,13,-11,-40,1803,69,1735,400,26,2.97
0,-2,0,-0.0,-2.0,0.5599923133850098,39.56008088970496,13,-11,-38,1803,69,1735,400,26,3.59
1,-2,0,1.0,-2.0,0.5679802894592285,37.94733192202055,13,-12,-36,1803,69,1735,400,26,1.86
1,-2,0,1.0,-2.0,0.5773453712463379,36.40054944640259,13,-13,-34,1803,69,1735,400,26,1.69
0,-2,0,-0.0,-2.0,0.5839402675628662,34.539832078341085,13,-13,-32,1803,69,1735,400,26,2.95
0,-3,0,-0.0,-3.0,0.5921392440795898,31.78049716414141,13,-13,-29,1803,69,1735,400,26,3.11
0,-2,0,-0.0,-2.0,0.5999343395233154,29.966648127543394,13,-13,-27,1803,69,1735,400,26,2.55
0,-3,0,-0.0,-3.0,0.6096742153167725,27.294688127912362,13,-13,-24,1803,69,1735,400,26,2.61
0,-2,0,-0.0,-2.0,0.618260383605957,25.553864678361276,13,-13,-22,1803,69,1735,400,26,2.1
-1,-2,0,-1.0,-2.0,0.6287543773651123,23.323807579381203,13,-12,-20,1803,69,1735,400,26,4.86
-1,-2,0,-1.0,-2.0,0.6334733963012695,21.095023109728988,13,-11,-18,1803,69,1735,400,26,4.62
0,-2,0,-0.0,-2.0,0.6409194469451904,19.4164878389476,13,-11,-16,1803,69,1735,400,26,1.64
0,-1,0,-0.0,-1.0,0.6501312255859375,18.601075237738275,13,-11,-15,1803,69,1735,400,26,1.4
-1,-1,0,-1.0,-1.0,0.6561603546142578,17.204650534085253,13,-10,-14,1803,69,1735,400,26,3.35
0,-1,0,-0.0,-1.0,0.663973331451416,16.401219466856727,13,-10,-13,1803,69,1735,400,26,1.27
-1,-1,0,-1.0,-1.0,0.679955244064331,15.0,13,-9,-12,1803,69,1735,400,26,3.45
-1,0,0,-1.0,-0.0,0.7040402889251709,14.422205101855956,13,-8,-12,1803,69,1735,400,26,0.54
0,0,1,-0.0,-0.0,0.7240114212036133,14.422205101855956,13,-8,-12,1803,69,1735,400,26,31.21
-1,0,1,-1.0,-0.0,0.03818678855895996,485.0494820118871,14,-88,477,1722,558,1811,81,13,2.04
0,0,0,-0.0,-0.0,0.04993295669555664,485.0494820118871,14,-88,477,1722,558,1811,81,13,132.74
-1,0,0,-1.0,-0.0,0.061186790466308594,484.86905448791015,14,-87,477,1722,558,1811,81,13,2.02
-1,0,0,-1.0,-0.0,0.07688474655151367,484.69062297510976,14,-86,477,1722,558,1811,81,13,2.0
-1,0,0,-1.0,-0.0,0.13363981246948242,484.5141896786925,14,-85,477,1722,558,1811,81,13,1.97
-1,1,0,-1.0,1.0,0.14088678359985352,483.35494204569795,14,-84,476,1722,558,1811,81,13,11.74
-2,1,0,-2.0,1.0,0.1489717960357666,482.02593291232785,14,-82,475,1722,558,1811,81,13,12.47
-2,2,0,-2.0,2.0,0.15748977661132812,479.7176252755364,14,-80,473,1722,558,1811,81,13,20.26
-2,3,0,-2.0,3.0,0.1648869514465332,476.42837866776995,14,-78,470,1722,558,1811,81,13,27.05
-5,3,0,-5.0,3.0,0.17299890518188477,472.6711330301439,14,-73,467,1722,558,1811,81,13,28.62
-3,4,0,-3.0,4.0,0.18107295036315918,468.26167897875223,14,-70,463,1722,558,1811,81,13,32.84
-5,5,0,-5.0,5.0,0.1888749599456787,462.5894508092462,14,-65,458,1722,558,1811,81,13,38.33
-6,8,0,-6.0,8.0,0.1970977783203125,453.8512972329153,14,-59,450,1722,558,1811,81,13,49.94
-7,11,0,-7.0,11.0,0.20573091506958008,442.06899913927464,14,-52,439,1722,558,1811,81,13,57.89
-10,13,0,-10.0,13.0,0.21288776397705078,428.06541556168725,14,-42,426,1722,558,1811,81,13,61.29
-10,15,0,-10.0,15.0,0.22415590286254883,412.2438598693739,14,-32,411,1722,558,1811,81,13,63.25
-9,14,0,-9.0,14.0,0.2289409637451172,397.665688738669,14,-23,397,1722,558,1811,81,13,59.5
-10,15,0,-10.0,15.0,0.23688387870788574,382.22114017934695,14,-13,382,1722,558,1811,81,13,59.31
-11,16,0,-11.0,16.0,0.25061988830566406,366.0054644400818,14,-2,366,1722,558,1811,81,13,58.67
-10,15,0,-10.0,15.0,0.26111674308776855,351.0911562543266,14,8,351,1722,558,1811,81,13,54.9
-8,14,0,-8.0,14.0,0.26129794120788574,337.37960815674677,14,16,337,1722,558,1811,81,13,51.47
-6,13,0,-6.0,13.0,0.2690298557281494,324.7460546334628,14,22,324,1722,558,1811,81,13,48.37
-3,14,0,-3.0,14.0,0.276918888092041,311.0064308016797,14,25,310,1722,558,1811,81,13,49.61
-2,11,0,-2.0,11.0,0.2851858139038086,300.2165884823822,14,27,299,1722,558,1811,81,13,43.16
0,11,0,-0.0,11.0,0.2959318161010742,289.26285623978754,14,27,288,1722,558,1811,81,13,43.81
0,12,0,-0.0,12.0,0.3025038242340088,277.31750756127894,14,27,276,1722,558,1811,81,13,44.35
0,10,0,-0.0,10.0,0.3093869686126709,267.36678926149375,14,27,266,1722,558,1811,81,13,39.52
2,10,0,2.0,10.0,0.31888890266418457,257.21780653757236,14,25,256,1722,558,1811,81,13,38.91
2,8,0,2.0,8.0,0.32970190048217773,249.06424873915566,14,23,248,1722,558,1811,81,13,33.41
2,9,0,2.0,9.0,0.33535194396972656,239.92082027202224,14,21,239,1722,558,1811,81,13,34.85
2,8,0,2.0,8.0,0.34295177459716797,231.78006816808042,14,19,231,1722,558,1811,81,13,31.72
1,7,0,1.0,7.0,0.3507418632507324,224.72205054244233,14,18,224,1722,558,1811,81,13,29.9
1,8,0,1.0,8.0,0.3569159507751465,216.6679487141557,14,17,216,1722,558,1811,81,13,31.7
1,11,0,1.0,11.0,0.3660397529602051,205.62344224333955,14,16,205,1722,558,1811,81,13,37.04
1,11,0,1.0,11.0,0.37317585945129395,194.57903278616635,14,15,194,1722,558,1811,81,13,35.73
1,11,0,1.0,11.0,0.38092494010925293,183.53473785635242,14,14,183,1722,558,1811,81,13,34.39
1,13,0,1.0,13.0,0.3889148235321045,170.49633427144408,14,13,170,1722,558,1811,81,13,36.42
0,14,0,-0.0,14.0,0.4030168056488037,156.54072952429985,14,13,156,1722,558,1811,81,13,32.38
0,14,0,-0.0,14.0,0.4049367904663086,142.59382875847047,14,13,142,1722,558,1811,81,13,30.27
1,14,0,1.0,14.0,0.41287875175476074,128.56126943990557,14,12,128,1722,558,1811,81,13,29.98
1,12,0,1.0,12.0,0.4216427803039551,116.52038448271615,14,11,116,1722,558,1811,81,13,27.14
1,11,0,1.0,11.0,0.4289717674255371,105.47511554864494,14,10,105,1722,558,1811,81,13,25.33
1,10,0,1.0,10.0,0.43790578842163086,95.42536350467836,14,9,95,1722,558,1811,81,13,23.0
2,10,0,2.0,10.0,0.44524288177490234,85.28774824088158,14,7,85,1722,558,1811,81,13,18.62
1,7,0,1.0,7.0,0.4530158042907715,78.23042886243178,14,6,78,1722,558,1811,81,13,15.67
1,7,0,1.0,7.0,0.4609498977661133,71.17583859709698,14,5,71,1722,558,1811,81,13,14.76
1,5,0,1.0,5.0,0.4689209461212158,66.12110101926616,14,4,66,1722,558,1811,81,13,11.33
1,6,0,1.0,6.0,0.4769587516784668,60.07495318350236,14,3,60,1722,558,1811,81,13,11.98
0,5,0,-0.0,5.0,0.4853689670562744,55.08175741568164,14,3,55,1722,558,1811,81,13,11.44
1,4,0,1.0,4.0,0.492891788482666,51.03920062069938,14,2,51,1722,558,1811,81,13,8.38
0,3,0,-0.0,3.0,0.5009157657623291,48.041648597857254,14,2,48,1722,558,1811,81,13,9.08
0,4,0,-0.0,4.0,0.5105197429656982,44.04543109109048,14,2,44,1722,558,1811,81,13,9.72
0,3,0,-0.0,3.0,0.5169367790222168,41.048751503547585,14,2,41,1722,558,1811,81,13,8.43
0,3,0,-0.0,3.0,0.5248899459838867,38.05259518088089,14,2,38,1722,558,1811,81,13,8.14
0,3,0,-0.0,3.0,0.5332849025726318,35.05709628591621,14,2,35,1722,558,1811,81,13,7.83
0,3,0,-0.0,3.0,0.5421037673950195,32.0624390837628,14,2,32,1722,558,1811,81,13,7.5
0,2,0,-0.0,2.0,0.5489599704742432,30.066592756745816,14,2,30,1722,558,1811,81,13,6.42
-1,3,0,-1.0,3.0,0.5569858551025391,27.16615541441225,14,3,27,1722,558,1811,81,13,4.41
-1,2,0,-1.0,2.0,0.565018892288208,25.317977802344327,14,4,25,1722,558,1811,81,13,2.93
0,4,0,-0.0,4.0,0.5732138156890869,21.37755832643195,14,4,21,1722,558,1811,81,13,5.77
-1,2,0,-1.0,2.0,0.5816137790679932,19.6468827043885,14,5,19,1722,558,1811,81,13,2.26
0,3,0,-0.0,3.0,0.5901927947998047,16.76305461424021,14,5,16,1722,558,1811,81,13,4.03
0,2,0,-0.0,2.0,0.5969138145446777,14.866068747318506,14,5,14,1722,558,1811,81,13,3.15
-1,2,0,-1.0,2.0,0.6054718494415283,13.416407864998739,14,6,12,1722,558,1811,81,13,1.21
0,2,0,-0.0,2.0,0.6129429340362549,11.661903789690601,14,6,10,1722,558,1811,81,13,2.12
0,2,0,-0.0,2.0,0.6209568977355957,10.0,14,6,8,1722,558,1811,81,13,1.64
0,1,0,-0.0,1.0,0.6300888061523438,9.219544457292887,14,6,7,1722,558,1811,81,13,1.15
0,2,0,-0.0,2.0,0.6371548175811768,7.810249675906654,14,6,5,1722,558,1811,81,13,0.77
0,1,0,-0.0,1.0,0.6624698638916016,7.211102550927978,14,6,4,1722,558,1811,81,13,0.38
0,1,0,-0.0,1.0,0.6848998069763184,6.708203932499369,14,6,3,1722,558,1811,81,13,0.09
0,1,0,-0.0,1.0,0.7120988368988037,6.324555320336759,14,6,2,1722,558,1811,81,13,-0.2
0,1,0,-0.0,1.0,0.7169599533081055,6.082762530298219,14,6,1,1722,558,1811,81,13,-0.48
0,2,0,-0.0,2.0,0.7330589294433594,6.082762530298219,14,6,-1,1722,558,1811,81,13,10.63
0,1,0,-0.0,1.0,0.7332708835601807,6.324555320336759,14,6,-2,1722,558,1811,81,13,2.15
0,2,0,-0.0,2.0,0.7456059455871582,7.211102550927978,14,6,-4,1722,558,1811,81,13,-0.18
0,2,0,-0.0,2.0,0.7489128112792969,8.48528137423857,14,6,-6,1722,558,1811,81,13,-0.04
0,1,0,-0.0,1.0,0.7569389343261719,9.219544457292887,14,6,-7,1722,558,1811,81,13,1.39
0,1,0,-0.0,1.0,0.764894962310791,10.0,14,6,-8,1722,558,1811,81,13,1.53
0,0,1,-0.0,-0.0,0.785897970199585,10.0,14,6,-8,1722,558,1811,81,13,29.88
0,0,0,-0.0,-0.0,0.09094667434692383,1391.6051882628205,15,-1337,-386,379,180,1716,566,10,246.72
-1,0,0,-1.0,-0.0,0.22527050971984863,1390.6444549200921,15,-1336,-386,379,180,1716,566,10,23.57
-3,0,0,-3.0,-0.0,0.2376716136932373,1387.7625877649245,15,-1333,-386,379,180,1716,566,10,56.15
-5,0,0,-5.0,-0.0,0.23902249336242676,1382.960592352508,15,-1328,-386,379,180,1716,566,10,80.11
-7,0,0,-7.0,-0.0,0.24692153930664062,1376.2401679939444,15,-1321,-386,379,180,1716,566,10,98.38
-9,0,0,-9.0,-0.0,0.2560756206512451,1367.603743779608,15,-1312,-386,379,180,1716,566,10,112.64
-11,0,0,-11.0,-0.0,0.26319169998168945,1357.0545309603442,15,-1301,-386,379,180,1716,566,10,123.97
-14,0,0,-14.0,-0.0,0.2716705799102783,1343.6387163222114,15,-1287,-386,379,180,1716,566,10,137.3
-19,-1,0,-19.0,-1.0,0.28085970878601074,1325.159990340789,15,-1268,-385,379,180,1716,566,10,154.22
-27,-3,0,-27.0,-3.0,0.2869396209716797,1298.4625524057287,15,-1241,-382,379,180,1716,566,10,170.95
-30,-3,0,-30.0,-3.0,0.2949206829071045,1268.921589382102,15,-1211,-379,379,180,1716,566,10,173.14
-30,-4,0,-30.0,-4.0,0.3029136657714844,1239.1069364667442,15,-1181,-375,379,180,1716,566,10,171.47
-30,-4,0,-30.0,-4.0,0.311983585357666,1209.3146819583396,15,-1151,-371,379,180,1716,566,10,169.11
-33,-5,0,-33.0,-5.0,0.3189055919647217,1176.384290952578,15,-1118,-366,379,180,1716,566,10,170.61
-38,-5,0,-38.0,-5.0,0.33039164543151855,1138.7365806015016,15,-1080,-361,379,180,1716,566,10,172.24
-40,-7,0,-40.0,-7.0,0.3367025852203369,1098.5972874534143,15,-1040,-354,379,180,1716,566,10,171.23
-41,-9,0,-41.0,-9.0,0.3429574966430664,1056.8945075077265,15,-999,-345,379,180,1716,566,10,169.1
-39,-8,0,-39.0,-8.0,0.3511655330657959,1017.4325530471295,15,-960,-337,379,180,1716,566,10,163.51
-38,-8,0,-38.0,-8.0,0.358919620513916,978.9407540806543,15,-922,-329,379,180,1716,566,10,159.11
-34,-8,0,-34.0,-8.0,0.3670666217803955,944.2377878479551,15,-888,-321,379,180,1716,566,10,152.68
-30,-7,0,-30.0,-7.0,0.374950647354126,913.6520125299347,15,-858,-314,379,180,1716,566,10,145.46
-25,-9,0,-25.0,-9.0,0.3833475112915039,887.0817324237942,15,-833,-305,379,180,1716,566,10,140.8
-23,-7,0,-23.0,-7.0,0.39184069633483887,863.078211983132,15,-810,-298,379,180,1716,566,10,132.96
-20,-8,0,-20.0,-8.0,0.39992856979370117,841.5461959987699,15,-790,-290,379,180,1716,566,10,127.62
-19,-7,0,-19.0,-7.0,0.4092435836791992,821.2977535583548,15,-771,-283,379,180,1716,566,10,124.91
-20,-8,0,-20.0,-8.0,0.41507863998413086,799.7662158406042,15,-751,-275,379,180,1716,566,10,123.82
-22,-8,0,-22.0,-8.0,0.4231576919555664,776.3568767004,15,-729,-267,379,180,1716,566,10,126.12
-24,-8,0,-24.0,-8.0,0.4309384822845459,751.0699035376134,15,-705,-259,379,180,1716,566,10,124.88
-24,-8,0,-24.0,-8.0,0.4389326572418213,725.7837143391962,15,-681,-251,379,180,1716,566,10,122.3
-26,-8,0,-26.0,-8.0,0.44704651832580566,698.6229312010879,15,-655,-243,379,180,1716,566,10,121.13
-27,-9,0,-27.0,-9.0,0.4549286365509033,670.1790805448943,15,-628,-234,379,180,1716,566,10,120.01
-29,-11,0,-29.0,-11.0,0.4629194736480713,639.1635158549024,15,-599,-223,379,180,1716,566,10,120.36
-32,-12,0,-32.0,-12.0,0.4713175296783447,604.9876031787759,15,-567,-211,379,180,1716,566,10,119.24
-32,-12,0,-32.0,-12.0,0.48155951499938965,570.8117027531933,15,-535,-199,379,180,1716,566,10,115.02
-33,-11,0,-33.0,-11.0,0.48854947090148926,536.0485052679468,15,-502,-188,379,180,1716,566,10,109.24
-31,-10,0,-31.0,-10.0,0.49579548835754395,503.51266121121523,15,-471,-178,379,180,1716,566,10,103.12
-28,-8,0,-28.0,-8.0,0.5066266059875488,474.4986828221971,15,-443,-170,379,180,1716,566,10,95.92
-24,-7,0,-24.0,-7.0,0.5114665031433105,449.5887009256349,15,-419,-163,379,180,1716,566,10,89.05
-20,-7,0,-20.0,-7.0,0.518946647644043,428.41218470066883,15,-399,-156,379,180,1716,566,10,83.39
-17,-7,0,-17.0,-7.0,0.5322005748748779,410.03048667141815,15,-382,-149,379,180,1716,566,10,78.16
-16,-6,0,-16.0,-6.0,0.5349445343017578,392.9440163687443,15,-366,-143,379,180,1716,566,10,74.46
-13,-6,0,-13.0,-6.0,0.5430946350097656,378.65287533570904,15,-353,-137,379,180,1716,566,10,66.73
-12,-5,0,-12.0,-5.0,0.5512256622314453,365.65694304908254,15,-341,-132,379,180,1716,566,10,63.79
-11,-5,0,-11.0,-5.0,0.5590624809265137,353.5944004081513,15,-330,-127,379,180,1716,566,10,59.66
-10,-4,0,-10.0,-4.0,0.5669465065002441,342.82502825785633,15,-320,-123,379,180,1716,566,10,57.1
-10,-5,0,-10.0,-5.0,0.5752956867218018,331.6986584235758,15,-310,-118,379,180,1716,566,10,54.62
-11,-4,0,-11.0,-4.0,0.5829496383666992,319.9953124656672,15,-299,-114,379,180,1716,566,10,56.48
-12,-4,0,-12.0,-4.0,0.5909476280212402,307.35809733924367,15,-287,-110,379,180,1716,566,10,55.74
-13,-4,0,-13.0,-4.0,0.5993025302886963,293.7890399589474,15,-274,-106,379,180,1716,566,10,55.07
-13,-4,0,-13.0,-4.0,0.6069486141204834,280.22312538404105,15,-261,-102,379,180,1716,566,10,53.28
-14,-4,0,-14.0,-4.0,0.6165995597839355,265.73106705840775,15,-247,-98,379,180,1716,566,10,52.32
-13,-4,0,-13.0,-4.0,0.6269416809082031,252.1745427278495,15,-234,-94,379,180,1716,566,10,49.42
-13,-4,0,-13.0,-4.0,0.6310615539550781,238.62313383240948,15,-221,-90,379,180,1716,566,10,47.51
-11,-4,0,-11.0,-4.0,0.6415045261383057,226.92730113408567,15,-210,-86,379,180,1716,566,10,44.23
-11,-3,0,-11.0,-3.0,0.6479926109313965,215.61539833694624,15,-199,-83,379,180,1716,566,10,40.73
-9,-4,0,-9.0,-4.0,0.660996675491333,205.7692882818036,15,-190,-79,379,180,1716,566,10,39.06
-8,-4,0,-8.0,-4.0,0.6695384979248047,196.84765683136794,15,-182,-75,379,180,1716,566,10,35.13
-7,-3,0,-7.0,-3.0,0.6749935150146484,189.2326610286924,15,-175,-72,379,180,1716,566,10,33.39
-6,-3,0,-6.0,-3.0,0.6789696216583252,182.54314558481784,15,-169,-69,379,180,1716,566,10,29.01
-7,-3,0,-7.0,-3.0,0.6869416236877441,174.92855684535903,15,-162,-66,379,180,1716,566,10,31.62
-6,-3,0,-6.0,-3.0,0.6949095726013184,168.24089871371942,15,-156,-63,379,180,1716,566,10,27.45
-6,-3,0,-6.0,-3.0,0.7029385566711426,161.55494421403512,15,-150,-60,379,180,1716,566,10,26.68
-6,-2,0,-6.0,-2.0,0.7124567031860352,155.24174696260025,15,-144,-58,379,180,1716,566,10,25.63
-5,-2,0,-5.0,-2.0,0.7193975448608398,149.85659811966906,15,-139,-56,379,180,1716,566,10,25.35
-5,-2,0,-5.0,-2.0,0.7275927066802979,144.4714504668656,15,-134,-54,379,180,1716,566,10,24.83
-5,-3,0,-5.0,-3.0,0.7357685565948486,138.7155362603627,15,-129,-51,379,180,1716,566,10,21.54
-6,-3,0,-6.0,-3.0,0.7429494857788086,132.03408650799233,15,-123,-48,379,180,1716,566,10,23.3
-5,-2,0,-5.0,-2.0,0.7513096332550049,126.64912159190051,15,-118,-46,379,180,1716,566,10,22.63
-4,-2,0,-4.0,-2.0,0.7589576244354248,122.19656296312102,15,-114,-44,379,180,1716,566,10,17.96
-6,-3,0,-6.0,-3.0,0.7669355869293213,115.52056094046635,15,-108,-41,379,180,1716,566,10,21.28
-6,-3,0,-6.0,-3.0,0.7758345603942871,108.84851859350222,15,-102,-38,379,180,1716,566,10,20.41
-10,-3,0,-10.0,-3.0,0.7862155437469482,98.43271813782245,15,-92,-35,379,180,1716,566,10,23.85
-10,-5,0,-10.0,-5.0,0.7909116744995117,87.31551981177229,15,-82,-30,379,180,1716,566,10,22.1
-9,-2,0,-9.0,-2.0,0.7996447086334229,78.18567643756751,15,-73,-28,379,180,1716,566,10,18.7
-9,-3,0,-9.0,-3.0,0.8069205284118652,68.70953354520753,15,-64,-25,379,180,1716,566,10,18.95
-7,-2,0,-7.0,-2.0,0.8152406215667725,61.465437442517235,15,-57,-23,379,180,1716,566,10,15.11
-6,-2,0,-6.0,-2.0,0.8229365348815918,55.154328932550705,15,-51,-21,379,180,1716,566,10,13.98
-5,-1,0,-5.0,-1.0,0.8312125205993652,50.15974481593781,15,-46,-20,379,180,1716,566,10,10.59
-4,-2,0,-4.0,-2.0,0.8402705192565918,45.69463863518345,15,-42,-18,379,180,1716,566,10,11.27
-5,-2,0,-5.0,-2.0,0.846928596496582,40.311288741492746,15,-37,-16,379,180,1716,566,10,12.41
-4,-2,0,-4.0,-2.0,0.8614506721496582,35.84689665786984,15,-33,-14,379,180,1716,566,10,10.13
-2,-1,0,-2.0,-1.0,0.8653645515441895,33.61547262794322,15,-31,-13,379,180,1716,566,10,7.57
-2,-1,0,-2.0,-1.0,0.8744635581970215,31.38470965295043,15,-29,-12,379,180,1716,566,10,7.33
-1,-1,0,-1.0,-1.0,0.8870086669921875,30.083217912982647,15,-28,-11,379,180,1716,566,10,3.79
-1,0,0,-1.0,-0.0,0.9915356636047363,29.154759474226502,15,-27,-11,379,180,1716,566,10,3.37
-1,0,0,-1.0,-0.0,0.999361515045166,28.231188426986208,15,-26,-11,379,180,1716,566,10,3.28
-1,-1,0,-1.0,-1.0,1.0069336891174316,26.92582403567252,15,-25,-10,379,180,1716,566,10,3.66
-2,0,0,-2.0,-0.0,1.0155165195465088,25.079872407968907,15,-23,-10,379,180,1716,566,10,4.1
-1,0,0,-1.0,-0.0,1.022939682006836,24.166091947189145,15,-22,-10,379,180,1716,566,10,3.03
-2,-1,0,-2.0,-1.0,1.030942678451538,21.93171219946131,15,-20,-9,379,180,1716,566,10,7.32
-2,0,0,-2.0,-0.0,1.038926601409912,20.12461179749811,15,-18,-9,379,180,1716,566,10,3.53
-2,0,0,-2.0,-0.0,1.0594086647033691,18.35755975068582,15,-16,-9,379,180,1716,566,10,3.22
-1,0,0,-1.0,-0.0,1.0744144916534424,17.4928556845359,15,-15,-9,379,180,1716,566,10,2.34
-1,-1,0,-1.0,-1.0,1.0814595222473145,16.1245154965971,15,-14,-8,379,180,1716,566,10,3.69
-1,0,0,-1.0,-0.0,1.0887014865875244,15.264337522473747,15,-13,-8,379,180,1716,566,10,2.19
-1,0,0,-1.0,-0.0,1.1050574779510498,14.422205101855956,15,-12,-8,379,180,1716,566,10,2.04
-1,0,0,-1.0,-0.0,1.1129436492919922,13.601470508735444,15,-11,-8,379,180,1716,566,10,1.87
-1,-1,0,-1.0,-1.0,1.127138614654541,12.206555615733702,15,-10,-7,379,180,1716,566,10,4.0
-1,0,0,-1.0,-0.0,1.1349475383758545,11.40175425099138,15,-9,-7,379,180,1716,566,10,1.64
-1,0,0,-1.0,-0.0,1.150925636291504,10.63014581273465,15,-8,-7,379,180,1716,566,10,1.44
-1,0,0,-1.0,-0.0,1.1589365005493164,9.899494936611665,15,-7,-7,379,180,1716,566,10,1.22
-1,0,0,-1.0,-0.0,1.16725754737854,9.219544457292887,15,-6,-7,379,180,1716,566,10,0.98
0,0,1,-0.0,-0.0,1.1722345352172852,9.219544457292887,15,-6,-7,379,180,1716,566,10,29.65
-1,0,1,-1.0,-0.0,0.002424955368041992,884.7604195487047,16,776,425,1160,612,385,187,31,8.3
0,0,0,-0.0,-0.0,0.10006189346313477,884.7604195487047,16,776,425,1160,612,385,187,31,191.65
1,0,0,1.0,-0.0,0.241163969039917,883.8834764831844,16,775,425,1160,612,385,187,31,6.82
4,1,0,4.0,1.0,0.24912476539611816,879.896016583778,16,771,424,1160,612,385,187,31,23.62
6,3,0,6.0,3.0,0.25835490226745605,873.1929912682534,16,765,421,1160,612,385,187,31,37.5
9,4,0,9.0,4.0,0.26709580421447754,863.3799858694896,16,756,417,1160,612,385,187,31,47.79
12,6,0,12.0,6.0,0.2733879089355469,849.9747055059933,16,744,411,1160,612,385,187,31,59.28
11,7,0,11.0,7.0,0.28328680992126465,836.9617673466333,16,733,404,1160,612,385,187,31,57.18
13,7,0,13.0,7.0,0.2901008129119873,822.1976647984352,16,720,397,1160,612,385,187,31,63.0
16,11,0,16.0,11.0,0.2974739074707031,802.877325623286,16,704,386,1160,612,385,187,31,70.6
22,12,0,22.0,12.0,0.30719900131225586,777.8174593052023,16,682,374,1160,612,385,187,31,82.88
26,15,0,26.0,15.0,0.31317877769470215,747.8081304719815,16,656,359,1160,612,385,187,31,87.29
31,18,0,31.0,18.0,0.32119297981262207,711.9733141066455,16,625,341,1160,612,385,187,31,91.76
37,22,0,37.0,22.0,0.33031177520751953,668.9581451780074,16,588,319,1160,612,385,187,31,94.92
39,21,0,39.0,21.0,0.33800387382507324,624.663909634613,16,549,298,1160,612,385,187,31,93.88
37,19,0,37.0,19.0,0.346193790435791,583.0823269487765,16,512,279,1160,612,385,187,31,86.55
36,18,0,36.0,18.0,0.35886096954345703,542.8600187893745,16,476,261,1160,612,385,187,31,81.23
33,16,0,33.0,16.0,0.36632394790649414,506.2351232382044,16,443,245,1160,612,385,187,31,74.35
32,15,0,32.0,15.0,0.36957693099975586,470.9787680989452,16,411,230,1160,612,385,187,31,69.48
31,14,0,31.0,14.0,0.3770298957824707,437.09953099951963,16,380,216,1160,612,385,187,31,64.72
29,13,0,29.0,13.0,0.3857278823852539,405.47503005733904,16,351,203,1160,612,385,187,31,59.57
29,13,0,29.0,13.0,0.3952629566192627,373.8769851167627,16,322,190,1160,612,385,187,31,56.31
26,12,0,26.0,12.0,0.4011728763580322,345.3983207834109,16,296,178,1160,612,385,187,31,50.88
23,11,0,23.0,11.0,0.4123997688293457,320.0281237641467,16,273,167,1160,612,385,187,31,45.74
20,10,0,20.0,10.0,0.41707396507263184,297.75493278869453,16,253,157,1160,612,385,187,31,40.9
17,8,0,17.0,8.0,0.42504096031188965,279.1003403795846,16,236,149,1160,612,385,187,31,35.22
14,7,0,14.0,7.0,0.4366929531097412,263.52988445335757,16,222,142,1160,612,385,187,31,30.77
12,7,0,12.0,7.0,0.44268083572387695,249.64975465639858,16,210,135,1160,612,385,187,31,28.85
9,5,0,9.0,5.0,0.4534749984741211,239.3762728425689,16,201,130,1160,612,385,187,31,23.06
9,5,0,9.0,5.0,0.45908188819885254,229.1047795223836,16,192,125,1160,612,385,187,31,22.38
9,5,0,9.0,5.0,0.4650888442993164,218.8355546980426,16,183,120,1160,612,385,187,31,21.69
8,5,0,8.0,5.0,0.47588396072387695,209.40391591371923,16,175,115,1160,612,385,187,31,21.34
7,5,0,7.0,5.0,0.48105597496032715,200.80836635957178,16,168,110,1160,612,385,187,31,19.18
9,5,0,9.0,5.0,0.489055871963501,190.541334098405,16,159,105,1160,612,385,187,31,19.85
9,6,0,9.0,6.0,0.49770188331604004,179.7247896090019,16,150,99,1160,612,385,187,31,22.18
12,6,0,12.0,6.0,0.5052859783172607,166.41213898030395,16,138,93,1160,612,385,187,31,20.48
10,6,0,10.0,6.0,0.5135278701782227,154.76756766196203,16,128,87,1160,612,385,187,31,19.13
11,5,0,11.0,5.0,0.5250818729400635,142.87407042567241,16,117,82,1160,612,385,187,31,16.89
9,4,0,9.0,4.0,0.5302679538726807,133.2216198670471,16,108,78,1160,612,385,187,31,14.09
8,5,0,8.0,5.0,0.537153959274292,123.81033882515628,16,100,73,1160,612,385,187,31,14.64
8,5,0,8.0,5.0,0.5452749729156494,114.40279716860073,16,92,68,1160,612,385,187,31,13.89
7,4,0,7.0,4.0,0.5555098056793213,106.40018796975878,16,85,64,1160,612,385,187,31,11.61
6,4,0,6.0,4.0,0.5613889694213867,99.20181449953424,16,79,60,1160,612,385,187,31,11.45
5,4,0,5.0,4.0,0.5747900009155273,92.80086206496145,16,74,56,1160,612,385,187,31,11.4
3,2,0,3.0,2.0,0.5785517692565918,89.20201791439474,16,71,54,1160,612,385,187,31,7.97
3,2,0,3.0,2.0,0.5850567817687988,85.60373823613078,16,68,52,1160,612,385,187,31,7.8
2,2,0,2.0,2.0,0.593052864074707,82.80096617793781,16,66,50,1160,612,385,187,31,6.09
1,2,0,1.0,2.0,0.6015379428863525,80.80222769206304,16,65,48,1160,612,385,187,31,3.64
3,2,0,3.0,2.0,0.6090848445892334,77.20103626247513,16,62,46,1160,612,385,187,31,7.81
2,2,0,2.0,2.0,0.6171629428863525,74.4043009509531,16,60,44,1160,612,385,187,31,5.7
3,2,0,3.0,2.0,0.625328779220581,70.80254232723568,16,57,42,1160,612,385,187,31,7.66
2,2,0,2.0,2.0,0.6395058631896973,68.00735254367721,16,55,40,1160,612,385,187,31,5.48
2,3,0,2.0,3.0,0.6477339267730713,64.63745044476924,16,53,37,1160,612,385,187,31,4.56
2,1,0,2.0,1.0,0.6558327674865723,62.42595614005443,16,51,36,1160,612,385,187,31,4.96
2,2,0,2.0,2.0,0.6571578979492188,59.64059020499378,16,49,34,1160,612,385,187,31,5.04
1,1,0,1.0,1.0,0.6726338863372803,58.249463516842795,16,48,33,1160,612,385,187,31,4.07
1,1,0,1.0,1.0,0.6733667850494385,56.859475903318,16,47,32,1160,612,385,187,31,4.01
1,1,0,1.0,1.0,0.683229923248291,55.47071299343465,16,46,31,1160,612,385,187,31,3.95
1,2,0,1.0,2.0,0.6897459030151367,53.53503525729669,16,45,29,1160,612,385,187,31,2.8
2,1,0,2.0,1.0,0.697056770324707,51.31276644267,16,43,28,1160,612,385,187,31,5.06
2,1,0,2.0,1.0,0.7051799297332764,49.09175083453431,16,41,27,1160,612,385,187,31,4.94
2,2,0,2.0,2.0,0.7130367755889893,46.32493928760188,16,39,25,1160,612,385,187,31,4.34
2,1,0,2.0,1.0,0.721538782119751,44.10215414239989,16,37,24,1160,612,385,187,31,4.88
2,1,0,2.0,1.0,0.7292327880859375,41.88078318274385,16,35,23,1160,612,385,187,31,4.74
3,2,0,3.0,2.0,0.7373299598693848,38.27531841800928,16,32,21,1160,612,385,187,31,8.12
3,2,0,3.0,2.0,0.7457318305969238,34.66987164671943,16,29,19,1160,612,385,187,31,7.92
2,2,0,2.0,2.0,0.7536008358001709,31.906112267087632,16,27,17,1160,612,385,187,31,3.74
3,1,0,3.0,1.0,0.7633669376373291,28.844410203711913,16,24,16,1160,612,385,187,31,3.46
2,0,0,2.0,-0.0,0.7690608501434326,27.202941017470888,16,22,16,1160,612,385,187,31,1.71
1,1,0,1.0,1.0,0.7770838737487793,25.80697580112788,16,21,15,1160,612,385,187,31,3.53
3,0,0,3.0,-0.0,0.7867698669433594,23.430749027719962,16,18,15,1160,612,385,187,31,1.57
1,1,0,1.0,1.0,0.7934868335723877,22.02271554554524,16,17,14,1160,612,385,187,31,4.13
2,0,0,2.0,-0.0,0.8026659488677979,20.518284528683193,16,15,14,1160,612,385,187,31,1.16
1,0,0,1.0,-0.0,0.8091428279876709,19.79898987322333,16,14,14,1160,612,385,187,31,1.02
2,0,0,2.0,-0.0,0.8172628879547119,18.439088914585774,16,12,14,1160,612,385,187,31,0.82
1,1,0,1.0,1.0,0.8250608444213867,17.029386365926403,16,11,13,1160,612,385,187,31,4.13
1,0,0,1.0,-0.0,0.8330569267272949,16.401219466856727,16,10,13,1160,612,385,187,31,0.67
2,1,0,2.0,1.0,0.8430848121643066,14.422205101855956,16,8,12,1160,612,385,187,31,1.48
1,0,0,1.0,-0.0,0.8507158756256104,13.892443989449804,16,7,12,1160,612,385,187,31,0.37
2,1,0,2.0,1.0,0.8572859764099121,12.083045973594572,16,5,11,1160,612,385,187,31,0.88
2,1,0,2.0,1.0,0.8684189319610596,10.44030650891055,16,3,10,1160,612,385,187,31,0.44
2,1,0,2.0,1.0,0.8763718605041504,9.055385138137417,16,1,9,1160,612,385,187,31,-0.04
3,1,0,3.0,1.0,0.8813519477844238,8.246211251235321,16,-2,8,1160,612,385,187,31,-1.11
2,1,0,2.0,1.0,0.8894999027252197,8.06225774829855,16,-4,7,1160,612,385,187,31,-1.16
2,1,0,2.0,1.0,0.8972609043121338,8.48528137423857,16,-6,6,1160,612,385,187,31,-0.36
1,1,0,1.0,1.0,0.9134519100189209,8.602325267042627,16,-7,5,1160,612,385,187,31,1.88
1,0,0,1.0,-0.0,0.9144718647003174,9.433981132056603,16,-8,5,1160,612,385,187,31,0.96
0,1,0,-0.0,1.0,0.921057939529419,8.94427190999916,16,-8,4,1160,612,385,187,31,0.02
0,0,1,-0.0,-0.0,0.9240357875823975,8.94427190999916,16,-8,4,1160,612,385,187,31,29.57
1,0,1,1.0,-0.0,0.9290988445281982,9.848857801796104,16,-9,4,1160,612,385,187,31,11.35
0,0,0,-0.0,-0.0,1.0210609436035156,9.848857801796104,16,-9,4,1160,612,385,187,31,19.84
-1,0,0,-1.0,-0.0,1.121121883392334,8.94427190999916,16,-8,4,1160,612,385,187,31,1.34
-2,1,0,-2.0,1.0,1.1290738582611084,6.708203932499369,16,-6,3,1160,612,385,187,31,7.47
-1,0,0,-1.0,-0.0,1.1376187801361084,5.830951894845301,16,-5,3,1160,612,385,187,31,0.81
-1,0,0,-1.0,-0.0,1.1457247734069824,5.0,16,-4,3,1160,612,385,187,31,0.44
-1,0,0,-1.0,-0.0,1.1549718379974365,4.242640687119285,16,-3,3,1160,612,385,187,31,0.02
0,1,0,-0.0,1.0,1.16109299659729,3.605551275463989,16,-3,2,1160,612,385,187,31,-0.44
0,0,1,-0.0,-0.0,1.2170829772949219,3.605551275463989,16,-3,2,1160,612,385,187,31,27.99
-1,0,1,-1.0,-0.0,0.01933908462524414,885.4885657082197,17,-879,-107,283,503,1163,610,63,6.51
0,2,1,-0.0,2.0,0.09934020042419434,885.732465251218,17,-879,-109,283,503,1163,610,63,11.54
0,0,0,-0.0,-0.0,0.1013031005859375,885.732465251218,17,-879,-109,283,503,1163,610,63,191.77
0,1,0,-0.0,1.0,0.11530923843383789,885.8560831196002,17,-879,-110,283,503,1163,610,63,21.31
-3,0,0,-3.0,-0.0,0.21132421493530273,882.8793802100035,17,-876,-110,283,503,1163,610,63,11.91
-7,1,0,-7.0,1.0,0.22178912162780762,876.0605001939078,17,-869,-111,283,503,1163,610,63,20.48
-9,0,0,-9.0,-0.0,0.22948026657104492,867.1337843724001,17,-860,-111,283,503,1163,610,63,26.15
-8,1,0,-8.0,1.0,0.23560214042663574,859.3299715476006,17,-852,-112,283,503,1163,610,63,22.61
-9,1,0,-9.0,1.0,0.2436692714691162,850.5398285794734,17,-843,-113,283,503,1163,610,63,24.74
-10,1,0,-10.0,1.0,0.2522552013397217,840.7645330293137,17,-833,-114,283,503,1163,610,63,26.75
-13,0,0,-13.0,-0.0,0.2593231201171875,827.8864656461054,17,-820,-114,283,503,1163,610,63,33.48
-16,0,0,-16.0,-0.0,0.26732826232910156,812.0418708416457,17,-804,-114,283,503,1163,610,63,38.55
-24,0,0,-24.0,-0.0,0.27634525299072266,788.2867498569286,17,-780,-114,283,503,1163,610,63,50.34
-30,-2,0,-30.0,-2.0,0.2834961414337158,758.3165565909793,17,-750,-112,283,503,1163,610,63,58.05
-35,-4,0,-35.0,-4.0,0.291370153427124,723.1106416033441,17,-715,-108,283,503,1163,610,63,63.26
-36,-5,0,-36.0,-5.0,0.29953527450561523,686.7677919064056,17,-679,-103,283,503,1163,610,63,63.5
-38,-6,0,-38.0,-6.0,0.30736827850341797,648.297771089798,17,-641,-97,283,503,1163,610,63,63.84
-35,-4,0,-35.0,-4.0,0.317399263381958,613.0946093385588,17,-606,-93,283,503,1163,610,63,57.3
-33,-5,0,-33.0,-5.0,0.32330822944641113,579.718034910076,17,-573,-88,283,503,1163,610,63,55.56
-31,-5,0,-31.0,-5.0,0.33132314682006836,548.3183381941552,17,-542,-83,283,503,1163,610,63,51.41
-28,-4,0,-28.0,-4.0,0.33931422233581543,520.0355757061242,17,-514,-79,283,503,1163,610,63,46.66
-27,-5,0,-27.0,-5.0,0.3473992347717285,492.590093282437,17,-487,-74,283,503,1163,610,63,43.41
-25,-4,0,-25.0,-4.0,0.3554372787475586,467.27293951180184,17,-462,-70,283,503,1163,610,63,41.13
-24,-5,0,-24.0,-5.0,0.3647301197052002,442.7967931229855,17,-438,-65,283,503,1163,610,63,37.25
-22,-4,0,-22.0,-4.0,0.3723921775817871,420.4485699821085,17,-416,-61,283,503,1163,610,63,34.66
-23,-4,0,-23.0,-4.0,0.3799111843109131,397.1120748604857,17,-393,-57,283,503,1163,610,63,34.6
-20,-4,0,-20.0,-4.0,0.3872952461242676,376.74659918836693,17,-373,-53,283,503,1163,610,63,30.03
-20,-4,0,-20.0,-4.0,0.3958241939544678,356.384623686264,17,-353,-49,283,503,1163,610,63,28.95
-20,-3,0,-20.0,-3.0,0.40337610244750977,336.1621632486321,17,-333,-46,283,503,1163,610,63,29.42
-20,-4,0,-20.0,-4.0,0.4117591381072998,315.8053197778657,17,-313,-42,283,503,1163,610,63,26.76
-21,-3,0,-21.0,-3.0,0.4193441867828369,294.5929394944828,17,-292,-39,283,503,1163,610,63,28.19
-22,-4,0,-22.0,-4.0,0.4288771152496338,272.2590678012396,17,-270,-35,283,503,1163,610,63,26.09
-20,-3,0,-20.0,-3.0,0.4355311393737793,252.03967941576184,17,-250,-32,283,503,1163,610,63,24.35
-21,-3,0,-21.0,-3.0,0.4439260959625244,230.82894099310857,17,-229,-29,283,503,1163,610,63,24.04
-19,-3,0,-19.0,-3.0,0.45406007766723633,211.60340261914504,17,-210,-26,283,503,1163,610,63,20.87
-18,-3,0,-18.0,-3.0,0.4595050811767578,193.3726971420733,17,-192,-23,283,503,1163,610,63,18.82
-16,-4,0,-16.0,-4.0,0.46735525131225586,177.02259742756007,17,-176,-19,283,503,1163,610,63,15.37
-15,-3,0,-15.0,-3.0,0.4755401611328125,161.7930777258409,17,-161,-16,283,503,1163,610,63,14.34
-12,-2,0,-12.0,-2.0,0.4864182472229004,149.6562728387955,17,-149,-14,283,503,1163,610,63,12.41
-12,-2,0,-12.0,-2.0,0.4914841651916504,137.5245432641025,17,-137,-12,283,503,1163,610,63,11.73
-10,-2,0,-10.0,-2.0,0.5049111843109131,127.39309243440164,17,-127,-10,283,503,1163,610,63,9.67
-10,-2,0,-10.0,-2.0,0.5167942047119141,117.27318534089538,17,-117,-8,283,503,1163,610,63,9.12
-8,-1,0,-8.0,-1.0,0.5169682502746582,109.22453936730518,17,-109,-7,283,503,1163,610,63,8.79
-8,-1,0,-8.0,-1.0,0.5300030708312988,101.17806086301516,17,-101,-6,283,503,1163,610,63,8.4
-6,-1,0,-6.0,-1.0,0.5312900543212891,95.13148795220224,17,-95,-5,283,503,1163,610,63,6.6
-5,-1,0,-5.0,-1.0,0.5393192768096924,90.08884503644167,17,-90,-4,283,503,1163,610,63,5.61
-4,0,0,-4.0,-0.0,0.5481212139129639,86.09297300012354,17,-86,-4,283,503,1163,610,63,6.56
-2,0,0,-2.0,-0.0,0.5555312633514404,84.09518416651456,17,-84,-4,283,503,1163,610,63,5.64
-2,-1,0,-2.0,-1.0,0.5651850700378418,82.05485969764375,17,-82,-3,283,503,1163,610,63,2.78
-3,0,0,-3.0,-0.0,0.573073148727417,79.05694150420949,17,-79,-3,283,503,1163,610,63,6.24
-5,0,0,-5.0,-0.0,0.5795552730560303,74.06078584514209,17,-74,-3,283,503,1163,610,63,6.83
-5,0,0,-5.0,-0.0,0.5877010822296143,69.06518659932803,17,-69,-3,283,503,1163,610,63,6.61
-6,0,0,-6.0,-0.0,0.5959861278533936,63.071388124885914,17,-63,-3,283,503,1163,610,63,6.65
-5,0,0,-5.0,-0.0,0.6078970432281494,58.077534382926416,17,-58,-3,283,503,1163,610,63,6.09
-6,0,0,-6.0,-0.0,0.6115372180938721,52.08646657242167,17,-52,-3,283,503,1163,610,63,6.03
-7,0,0,-7.0,-0.0,0.6198451519012451,45.09988913511872,17,-45,-3,283,503,1163,610,63,5.8
-8,0,0,-8.0,-0.0,0.6273291110992432,37.12142238654117,17,-37,-3,283,503,1163,610,63,5.36
-6,1,0,-6.0,1.0,0.6353251934051514,31.25699921617557,17,-31,-4,283,503,1163,610,63,2.92
-4,0,0,-4.0,-0.0,0.6433281898498535,27.294688127912362,17,-27,-4,283,503,1163,610,63,3.48
-3,0,0,-3.0,-0.0,0.651738166809082,24.331050121192877,17,-24,-4,283,503,1163,610,63,3.13
-3,0,0,-3.0,-0.0,0.6604931354522705,21.37755832643195,17,-21,-4,283,503,1163,610,63,2.82
-3,0,0,-3.0,-0.0,0.6674370765686035,18.439088914585774,17,-18,-4,283,503,1163,610,63,2.48
-4,0,0,-4.0,-0.0,0.6767902374267578,14.560219778561036,17,-14,-4,283,503,1163,610,63,1.92
-5,0,0,-5.0,-0.0,0.687744140625,9.848857801796104,17,-9,-4,283,503,1163,610,63,0.96
-5,0,0,-5.0,-0.0,0.6924490928649902,5.656854249492381,17,-4,-4,283,503,1163,610,63,-0.49
-3,1,0,-3.0,1.0,0.6992921829223633,5.0990195135927845,17,-1,-5,283,503,1163,610,63,-1.9
0,0,1,-0.0,-0.0,0.7073380947113037,5.0990195135927845,17,-1,-5,283,503,1163,610,63,28.43
-2,0,1,-2.0,-0.0,0.003434419631958008,730.9856359737857,18,622,-384,904,124,284,508,50,3.49
0,0,0,-0.0,-0.0,0.09724926948547363,730.9856359737857,18,622,-384,904,124,284,508,50,171.2
1,0,0,1.0,-0.0,0.1382904052734375,730.1349190389403,18,621,-384,904,124,284,508,50,4.35
2,0,0,2.0,-0.0,0.15440726280212402,728.4346230101917,18,619,-384,904,124,284,508,50,6.98
2,0,0,2.0,-0.0,0.16431331634521484,726.7358529754811,18,617,-384,904,124,284,508,50,6.96
4,0,0,4.0,-0.0,0.17059326171875,723.3429338840602,18,613,-384,904,124,284,508,50,11.92
5,0,0,5.0,-0.0,0.17898344993591309,719.1105617358154,18,608,-384,904,124,284,508,50,14.22
8,-1,0,8.0,-1.0,0.18620538711547852,711.8209044415596,18,600,-383,904,124,284,508,50,22.38
10,-1,0,10.0,-1.0,0.19466543197631836,702.8684087366568,18,590,-382,904,124,284,508,50,26.05
13,-2,0,13.0,-2.0,0.20246124267578125,690.8900057172632,18,577,-380,904,124,284,508,50,32.45
15,-1,0,15.0,-1.0,0.21021628379821777,677.8532289515186,18,562,-379,904,124,284,508,50,33.89
19,-2,0,19.0,-2.0,0.22127246856689453,661.0431150840315,18,543,-377,904,124,284,508,50,40.3
21,-4,0,21.0,-4.0,0.22695136070251465,641.5707287587238,18,522,-373,904,124,284,508,50,44.08
22,-4,0,22.0,-4.0,0.2381443977355957,621.4185385068586,18,500,-369,904,124,284,508,50,44.16
21,-5,0,21.0,-5.0,0.24831724166870117,601.6120012100822,18,479,-364,904,124,284,508,50,42.89
19,-5,0,19.0,-5.0,0.25965428352355957,583.5074978095826,18,460,-359,904,124,284,508,50,39.58
17,-7,0,17.0,-7.0,0.25982141494750977,565.8206429602935,18,443,-352,904,124,284,508,50,38.71
17,-8,0,17.0,-8.0,0.26621031761169434,547.5509108749615,18,426,-344,904,124,284,508,50,38.99
18,-9,0,18.0,-9.0,0.2767634391784668,527.9100302134825,18,408,-335,904,124,284,508,50,40.1
19,-11,0,19.0,-11.0,0.2822253704071045,506.25783944547464,18,389,-324,904,124,284,508,50,42.01
17,-11,0,17.0,-11.0,0.2935323715209961,486.16149580154945,18,372,-313,904,124,284,508,50,39.43
17,-13,0,17.0,-13.0,0.2982332706451416,464.7848964843845,18,355,-300,904,124,284,508,50,41.04
17,-17,0,17.0,-17.0,0.30652546882629395,440.83216761030496,18,338,-283,904,124,284,508,50,41.85
18,-19,0,18.0,-19.0,0.3143422603607178,414.84454919885354,18,320,-264,904,124,284,508,50,41.86
16,-17,0,16.0,-17.0,0.32222843170166016,391.69503443367773,18,304,-247,904,124,284,508,50,37.48
15,-17,0,15.0,-17.0,0.33643341064453125,369.35213550215195,18,289,-230,904,124,284,508,50,34.92
14,-14,0,14.0,-14.0,0.3405282497406006,349.6870029040256,18,275,-216,904,124,284,508,50,31.57
12,-13,0,12.0,-13.0,0.3511323928833008,332.2318467576521,18,263,-203,904,124,284,508,50,27.85
10,-11,0,10.0,-11.0,0.35491132736206055,317.60510071470827,18,253,-192,904,124,284,508,50,23.94
11,-10,0,11.0,-10.0,0.364410400390625,302.80026420067736,18,242,-182,904,124,284,508,50,24.29
10,-10,0,10.0,-10.0,0.3754153251647949,288.80443209895515,18,232,-172,904,124,284,508,50,22.14
9,-11,0,9.0,-11.0,0.3796074390411377,275.04545078950133,18,223,-161,904,124,284,508,50,20.44
9,-8,0,9.0,-8.0,0.39005231857299805,263.0684321616716,18,214,-153,904,124,284,508,50,19.26
9,-9,0,9.0,-9.0,0.39423441886901855,250.52145616693193,18,205,-144,904,124,284,508,50,18.6
8,-7,0,8.0,-7.0,0.4022634029388428,239.95416228938393,18,197,-137,904,124,284,508,50,16.73
9,-7,0,9.0,-7.0,0.4102044105529785,228.56946427727394,18,188,-130,904,124,284,508,50,17.89
10,-8,0,10.0,-8.0,0.41820430755615234,215.79620015190258,18,178,-122,904,124,284,508,50,18.2
11,-7,0,11.0,-7.0,0.4262852668762207,202.76587484091104,18,167,-115,904,124,284,508,50,18.58
10,-7,0,10.0,-7.0,0.43428540229797363,190.55970193091719,18,157,-108,904,124,284,508,50,18.56
11,-8,0,11.0,-8.0,0.4452364444732666,176.96327302578916,18,146,-100,904,124,284,508,50,17.87
11,-6,0,11.0,-6.0,0.4504542350769043,164.50227961946302,18,135,-94,904,124,284,508,50,14.73
10,-6,0,10.0,-6.0,0.458254337310791,152.86922515666782,18,125,-88,904,124,284,508,50,14.04
9,-6,0,9.0,-6.0,0.4676482677459717,142.0563268566381,18,116,-82,904,124,284,508,50,14.06
8,-5,0,8.0,-5.0,0.480452299118042,132.6386067478093,18,108,-77,904,124,284,508,50,11.77
8,-5,0,8.0,-5.0,0.4904763698577881,123.2233744059949,18,100,-72,904,124,284,508,50,11.23
7,-4,0,7.0,-4.0,0.4955923557281494,115.20850663036997,18,93,-68,904,124,284,508,50,9.32
6,-4,0,6.0,-4.0,0.4983184337615967,108.00462953040486,18,87,-64,904,124,284,508,50,9.64
7,-4,0,7.0,-4.0,0.5136463642120361,100.0,18,80,-60,904,124,284,508,50,8.51
6,-3,0,6.0,-3.0,0.514202356338501,93.40770846134703,18,74,-57,904,124,284,508,50,6.89
6,-4,0,6.0,-4.0,0.5231404304504395,86.21484790916237,18,68,-53,904,124,284,508,50,8.17
6,-2,0,6.0,-2.0,0.5304512977600098,80.2807573457052,18,62,-51,904,124,284,508,50,5.15
5,-3,0,5.0,-3.0,0.5382213592529297,74.51845409024533,18,57,-48,904,124,284,508,50,6.03
5,-2,0,5.0,-2.0,0.5466864109039307,69.42621983083913,18,52,-46,904,124,284,508,50,4.48
4,-2,0,4.0,-2.0,0.5545353889465332,65.11528238439882,18,48,-44,904,124,284,508,50,4.32
4,-1,0,4.0,-1.0,0.5622162818908691,61.5223536610881,18,44,-43,904,124,284,508,50,3.0
4,-2,0,4.0,-2.0,0.5742793083190918,57.28001396647874,18,40,-41,904,124,284,508,50,3.79
4,-2,0,4.0,-2.0,0.5786223411560059,53.075418038862395,18,36,-39,904,124,284,508,50,3.52
4,-2,0,4.0,-2.0,0.5882163047790527,48.91829923454004,18,32,-37,904,124,284,508,50,3.24
4,-1,0,4.0,-1.0,0.5951552391052246,45.60701700396552,18,28,-36,904,124,284,508,50,2.1
4,-2,0,4.0,-2.0,0.6056852340698242,41.617304093369626,18,24,-34,904,124,284,508,50,2.6
3,-1,0,3.0,-1.0,0.6119394302368164,39.11521443121589,18,21,-33,904,124,284,508,50,1.68
4,-2,0,4.0,-2.0,0.6193814277648926,35.35533905932738,18,17,-31,904,124,284,508,50,1.99
4,-1,0,4.0,-1.0,0.6264512538909912,32.69556544854363,18,13,-30,904,124,284,508,50,1.0
2,-1,0,2.0,-1.0,0.6344742774963379,31.016124838541646,18,11,-29,904,124,284,508,50,1.2
3,-2,0,3.0,-2.0,0.6422202587127686,28.160255680657446,18,8,-27,904,124,284,508,50,1.35
3,-1,0,3.0,-1.0,0.6516313552856445,26.476404589747453,18,5,-26,904,124,284,508,50,0.43
2,-1,0,2.0,-1.0,0.6582233905792236,25.179356624028344,18,3,-25,904,124,284,508,50,0.54
1,-2,0,1.0,-2.0,0.6676113605499268,23.08679276123039,18,2,-23,904,124,284,508,50,2.03
2,0,0,2.0,-0.0,0.6742243766784668,23.0,18,0,-23,904,124,284,508,50,-0.41
1,-1,0,1.0,-1.0,0.6825423240661621,22.02271554554524,18,-1,-22,904,124,284,508,50,0.8
0,0,1,-0.0,-0.0,0.7192513942718506,22.02271554554524,18,-1,-22,904,124,284,508,50,33.519999999999996
0,0,0,-0.0,-0.0,0.07717585563659668,734.1559779774323,19,731,68,1636,214,905,146,61,171.65
-1,0,0,-1.0,-0.0,0.1107177734375,735.1516850283348,19,732,68,1636,214,905,146,61,6.64
-1,1,0,-1.0,1.0,0.12549471855163574,736.0557044137353,19,733,67,1636,214,905,146,61,3.88
0,2,0,-0.0,2.0,0.13126683235168457,735.8763483086,19,733,65,1636,214,905,146,61,0.68
-1,1,0,-1.0,1.0,0.13423490524291992,736.7849075544368,19,734,64,1636,214,905,146,61,3.88
0,3,0,-0.0,3.0,0.14221882820129395,736.5303795499544,19,734,61,1636,214,905,146,61,0.87
-1,2,0,-1.0,2.0,0.15036487579345703,737.3642247898931,19,735,59,1636,214,905,146,61,3.69
-1,3,0,-1.0,3.0,0.15926790237426758,738.1273602841179,19,736,56,1636,214,905,146,61,3.81
0,3,0,-0.0,3.0,0.16620969772338867,737.905820548937,19,736,53,1636,214,905,146,61,0.77
0,3,0,-0.0,3.0,0.17418384552001953,737.6964145229391,19,736,50,1636,214,905,146,61,0.73
0,4,0,-0.0,4.0,0.18226981163024902,737.4360989265443,19,736,46,1636,214,905,146,61,0.85
2,4,0,2.0,4.0,0.1931006908416748,735.2006528832792,19,734,42,1636,214,905,146,61,6.48
3,3,0,3.0,3.0,0.19930481910705566,732.039616414303,19,731,39,1636,214,905,146,61,9.27
6,4,0,6.0,4.0,0.20623373985290527,725.8443359288547,19,725,35,1636,214,905,146,61,16.64
6,3,0,6.0,3.0,0.21677875518798828,719.7117478546533,19,719,32,1636,214,905,146,61,16.78
7,1,0,7.0,1.0,0.22441673278808594,712.6745400251085,19,712,31,1636,214,905,146,61,20.56
7,2,0,7.0,2.0,0.23021769523620605,705.5962018038363,19,705,29,1636,214,905,146,61,19.39
10,1,0,10.0,1.0,0.2383418083190918,695.5638000931331,19,695,28,1636,214,905,146,61,26.9
10,1,0,10.0,1.0,0.2461538314819336,685.5319102711412,19,685,27,1636,214,905,146,61,26.67
13,1,0,13.0,1.0,0.2550778388977051,672.5027880983097,19,672,26,1636,214,905,146,61,32.29
15,2,0,15.0,2.0,0.26231980323791504,657.4382100243338,19,657,24,1636,214,905,146,61,34.2
19,1,0,19.0,1.0,0.27022480964660645,638.4144421925306,19,638,23,1636,214,905,146,61,41.42
21,1,0,21.0,1.0,0.27815771102905273,617.3920958353775,19,617,22,1636,214,905,146,61,43.61
21,1,0,21.0,1.0,0.2861607074737549,596.3698516860154,19,596,21,1636,214,905,146,61,42.75
23,2,0,23.0,2.0,0.2942318916320801,573.3149221850065,19,573,19,1636,214,905,146,61,42.92
25,1,0,25.0,1.0,0.3029947280883789,548.2955407442231,19,548,18,1636,214,905,146,61,45.79
26,2,0,26.0,2.0,0.3101956844329834,522.2451531608504,19,522,16,1636,214,905,146,61,44.03
24,3,0,24.0,3.0,0.3188307285308838,498.169649818212,19,498,13,1636,214,905,146,61,39.81
23,2,0,23.0,2.0,0.3261747360229492,475.1273513490883,19,475,11,1636,214,905,146,61,38.12
20,1,0,20.0,1.0,0.3343677520751953,455.1098768429444,19,455,10,1636,214,905,146,61,34.8
19,2,0,19.0,2.0,0.34242868423461914,436.07338831898466,19,436,8,1636,214,905,146,61,31.58
17,2,0,17.0,2.0,0.35021281242370605,419.0429572251513,19,419,6,1636,214,905,146,61,28.39
15,1,0,15.0,1.0,0.35982680320739746,404.0309394093477,19,404,5,1636,214,905,146,61,26.28
16,1,0,16.0,1.0,0.3662557601928711,388.0206180088888,19,388,4,1636,214,905,146,61,26.81
13,1,0,13.0,1.0,0.3741598129272461,375.0119998080061,19,375,3,1636,214,905,146,61,22.61
14,1,0,14.0,1.0,0.38306283950805664,361.00554012369395,19,361,2,1636,214,905,146,61,23.27
12,0,0,12.0,-0.0,0.3958897590637207,349.0057306119772,19,349,2,1636,214,905,146,61,22.65
15,1,0,15.0,1.0,0.39815187454223633,334.0014970026332,19,334,1,1636,214,905,146,61,23.28
14,1,0,14.0,1.0,0.40638279914855957,320.0,19,320,0,1636,214,905,146,61,21.55
14,0,0,14.0,-0.0,0.41417574882507324,306.0,19,306,0,1636,214,905,146,61,23.73
14,1,0,14.0,1.0,0.42217373847961426,292.00171232374646,19,292,-1,1636,214,905,146,61,20.34
15,1,0,15.0,1.0,0.43021488189697266,277.0072201225087,19,277,-2,1636,214,905,146,61,20.6
13,0,0,13.0,-0.0,0.44002270698547363,264.0075756488817,19,264,-2,1636,214,905,146,61,20.4
11,0,0,11.0,-0.0,0.4463977813720703,253.00790501484337,19,253,-2,1636,214,905,146,61,18.13
12,1,0,12.0,1.0,0.4565887451171875,241.0186714758838,19,241,-3,1636,214,905,146,61,16.14
11,0,0,11.0,-0.0,0.4637277126312256,230.0195643852931,19,230,-3,1636,214,905,146,61,16.97
8,1,0,8.0,1.0,0.4701569080352783,222.03603311174518,19,222,-4,1636,214,905,146,61,11.48
8,0,0,8.0,-0.0,0.4782247543334961,214.03737991294884,19,214,-4,1636,214,905,146,61,13.54
8,1,0,8.0,1.0,0.4877758026123047,206.0606706773517,19,206,-5,1636,214,905,146,61,10.94
8,0,0,8.0,-0.0,0.4941596984863281,198.0631212517868,19,198,-5,1636,214,905,146,61,12.8
8,1,0,8.0,1.0,0.503119707107544,190.09471323527123,19,190,-6,1636,214,905,146,61,10.38
8,0,0,8.0,-0.0,0.5144197940826416,182.0988742414406,19,182,-6,1636,214,905,146,61,12.05
7,0,0,7.0,-0.0,0.5231027603149414,175.10282693320517,19,175,-6,1636,214,905,146,61,11.03
8,0,0,8.0,-0.0,0.5262317657470703,167.10774967068403,19,167,-6,1636,214,905,146,61,11.48
8,0,0,8.0,-0.0,0.536226749420166,159.11316727411344,19,159,-6,1636,214,905,146,61,11.17
8,0,0,8.0,-0.0,0.5421817302703857,151.11915828246265,19,151,-6,1636,214,905,146,61,10.85
6,0,0,6.0,-0.0,0.5504918098449707,145.1240848377691,19,145,-6,1636,214,905,146,61,9.3
6,0,0,6.0,-0.0,0.5594017505645752,139.12943613772032,19,139,-6,1636,214,905,146,61,9.09
4,0,0,4.0,-0.0,0.5661559104919434,135.1332675546625,19,135,-6,1636,214,905,146,61,7.66
5,0,0,5.0,-0.0,0.574981689453125,130.13838787997952,19,130,-6,1636,214,905,146,61,8.16
2,0,0,2.0,-0.0,0.582305908203125,128.14054783713078,19,128,-6,1636,214,905,146,61,6.15
3,0,0,3.0,-0.0,0.5960817337036133,125.14391715141412,19,125,-6,1636,214,905,146,61,6.75
4,-1,0,4.0,-1.0,0.6009948253631592,121.10326172320876,19,121,-5,1636,214,905,146,61,5.51
3,0,0,3.0,-0.0,0.6098856925964355,118.10588469674151,19,118,-5,1636,214,905,146,61,6.78
4,0,0,4.0,-0.0,0.6142446994781494,114.10959644131601,19,114,-5,1636,214,905,146,61,7.27
5,0,0,5.0,-0.0,0.6228108406066895,109.1146186356347,19,109,-5,1636,214,905,146,61,7.67
6,0,0,6.0,-0.0,0.6326537132263184,103.12128781197411,19,103,-5,1636,214,905,146,61,7.96
6,0,0,6.0,-0.0,0.6390838623046875,97.12878049270464,19,97,-5,1636,214,905,146,61,7.72
7,0,0,7.0,-0.0,0.6469318866729736,90.13878188659973,19,90,-5,1636,214,905,146,61,7.85
7,0,0,7.0,-0.0,0.6549668312072754,83.15046602394962,19,83,-5,1636,214,905,146,61,7.5
6,0,0,6.0,-0.0,0.6621878147125244,77.1621668954417,19,77,-5,1636,214,905,146,61,6.81
6,0,0,6.0,-0.0,0.6706347465515137,71.17583859709698,19,71,-5,1636,214,905,146,61,6.52
5,0,0,5.0,-0.0,0.6789717674255371,66.18912297349165,19,66,-5,1636,214,905,146,61,5.92
6,0,0,6.0,-0.0,0.6865098476409912,60.207972893961475,19,60,-5,1636,214,905,146,61,5.92
6,0,0,6.0,-0.0,0.6943197250366211,54.230987451824994,19,54,-5,1636,214,905,146,61,5.56
4,0,0,4.0,-0.0,0.7026858329772949,50.24937810560445,19,50,-5,1636,214,905,146,61,4.81
4,0,0,4.0,-0.0,0.712364912033081,46.2709412050371,19,46,-5,1636,214,905,146,61,4.59
2,0,0,2.0,-0.0,0.7186439037322998,44.28317965096906,19,44,-5,1636,214,905,146,61,4.07
3,-1,0,3.0,-1.0,0.7288928031921387,41.19465984809196,19,41,-4,1636,214,905,146,61,3.28
2,-1,0,2.0,-1.0,0.7353448867797852,39.11521443121589,19,39,-3,1636,214,905,146,61,2.3
3,0,0,3.0,-0.0,0.7422177791595459,36.124783736376884,19,36,-3,1636,214,905,146,61,4.46
3,-1,0,3.0,-1.0,0.7503228187561035,33.06055050963308,19,33,-2,1636,214,905,146,61,2.82
2,0,0,2.0,-0.0,0.759422779083252,31.064449134018133,19,31,-2,1636,214,905,146,61,4.52
0,-1,0,-0.0,-1.0,0.7684078216552734,31.016124838541646,19,31,-1,1636,214,905,146,61,-0.07
1,0,0,1.0,-0.0,0.776890754699707,30.01666203960727,19,30,-1,1636,214,905,146,61,5.16
0,0,1,-0.0,-0.0,0.7821807861328125,30.01666203960727,19,30,-1,1636,214,905,146,61,35.96
1,0,1,1.0,-0.0,0.03153181076049805,1559.1731783224081,20,-1539,250,68,465,1606,215,32,11.12
0,0,0,-0.0,-0.0,0.07038092613220215,1559.1731783224081,20,-1539,250,68,465,1606,215,32,262.0
-1,1,0,-1.0,1.0,0.11946582794189453,1558.0259946483563,20,-1538,249,68,465,1606,215,32,10.27
-3,2,0,-3.0,2.0,0.12732172012329102,1554.7456383601789,20,-1535,247,68,465,1606,215,32,25.65
-2,2,0,-2.0,2.0,0.13634490966796875,1552.4541861195132,20,-1533,245,68,465,1606,215,32,18.44
-2,3,0,-2.0,3.0,0.14879679679870605,1550.0080644951497,20,-1531,242,68,465,1606,215,32,19.1
-4,4,0,-4.0,4.0,0.15128493309020996,1545.4361843829074,20,-1527,238,68,465,1606,215,32,33.16
-3,4,0,-3.0,4.0,0.15929889678955078,1541.8599158159602,20,-1524,234,68,465,1606,215,32,26.62
-4,4,0,-4.0,4.0,0.16725873947143555,1537.3028328862208,20,-1520,230,68,465,1606,215,32,32.97
-5,4,0,-5.0,4.0,0.17670392990112305,1531.7640157674418,20,-1515,226,68,465,1606,215,32,38.95
-6,5,0,-6.0,5.0,0.1839609146118164,1525.0973739404315,20,-1509,221,68,465,1606,215,32,45.07
-7,5,0,-7.0,5.0,0.19494271278381348,1517.451811425984,20,-1502,216,68,465,1606,215,32,50.28
-6,5,0,-6.0,5.0,0.19933271408081055,1510.8067381369465,20,-1496,211,68,465,1606,215,32,44.72
-8,5,0,-8.0,5.0,0.2090609073638916,1502.1917321034623,20,-1488,206,68,465,1606,215,32,55.01
-10,6,0,-10.0,6.0,0.216019868850708,1491.4704153954915,20,-1478,200,68,465,1606,215,32,64.52
-11,6,0,-11.0,6.0,0.22325491905212402,1479.771941888344,20,-1467,194,68,465,1606,215,32,68.54
-13,7,0,-13.0,7.0,0.23147177696228027,1465.9757842474753,20,-1454,187,68,465,1606,215,32,76.48
-17,8,0,-17.0,8.0,0.2395768165588379,1448.1056591285044,20,-1437,179,68,465,1606,215,32,90.16
-20,7,0,-20.0,7.0,0.24737977981567383,1427.4007846431919,20,-1417,172,68,465,1606,215,32,98.37
-23,6,0,-23.0,6.0,0.2555978298187256,1403.8489947284215,20,-1394,166,68,465,1606,215,32,105.6
-23,5,0,-23.0,5.0,0.2634248733520508,1380.4209502901642,20,-1371,161,68,465,1606,215,32,104.78
-25,4,0,-25.0,4.0,0.2712738513946533,1355.125455446838,20,-1346,157,68,465,1606,215,32,109.16
-28,4,0,-28.0,4.0,0.28162193298339844,1326.8507828689706,20,-1318,153,68,465,1606,215,32,114.86
-30,3,0,-30.0,3.0,0.28834080696105957,1296.705055130117,20,-1288,150,68,465,1606,215,32,117.55
-31,4,0,-31.0,4.0,0.29529881477355957,1265.4505126633755,20,-1257,146,68,465,1606,215,32,118.26
-30,3,0,-30.0,3.0,0.3098878860473633,1235.3048206819237,20,-1227,143,68,465,1606,215,32,114.54
-30,3,0,-30.0,3.0,0.3148767948150635,1205.159325566541,20,-1197,140,68,465,1606,215,32,113.01
-29,2,0,-29.0,2.0,0.31935882568359375,1176.1241431073506,20,-1168,138,68,465,1606,215,32,108.47
-30,2,0,-30.0,2.0,0.3278968334197998,1146.0977270721726,20,-1138,136,68,465,1606,215,32,108.66
-30,1,0,-30.0,1.0,0.3378119468688965,1116.1939795573169,20,-1108,135,68,465,1606,215,32,106.25
-33,2,0,-33.0,2.0,0.3433189392089844,1083.1961964482705,20,-1075,133,68,465,1606,215,32,110.01
-33,2,0,-33.0,2.0,0.35460376739501953,1050.202361452306,20,-1042,131,68,465,1606,215,32,108.08
-33,2,0,-33.0,2.0,0.35928988456726074,1017.21285874688,20,-1009,129,68,465,1606,215,32,106.11
-35,2,0,-35.0,2.0,0.3701338768005371,982.2448778181539,20,-974,127,68,465,1606,215,32,106.77
-35,1,0,-35.0,1.0,0.375565767288208,947.415959333597,20,-939,126,68,465,1606,215,32,103.93
-33,2,0,-33.0,2.0,0.3833179473876953,914.4462805435867,20,-906,124,68,465,1606,215,32,99.67
-31,3,0,-31.0,3.0,0.391481876373291,883.3266666415093,20,-875,121,68,465,1606,215,32,95.74
-28,3,0,-28.0,3.0,0.4005417823791504,855.1800979910606,20,-847,118,68,465,1606,215,32,89.72
-25,4,0,-25.0,4.0,0.4073348045349121,829.8674592969651,20,-822,114,68,465,1606,215,32,83.91
-24,3,0,-24.0,3.0,0.4152688980102539,805.6829401197471,20,-798,111,68,465,1606,215,32,80.87
-23,5,0,-23.0,5.0,0.4232969284057617,782.2154434681023,20,-775,106,68,465,1606,215,32,76.52
-21,3,0,-21.0,3.0,0.4313178062438965,761.0026281163555,20,-754,103,68,465,1606,215,32,73.38
-21,3,0,-21.0,3.0,0.4398019313812256,739.7898350207307,20,-733,100,68,465,1606,215,32,72.2
-20,3,0,-20.0,3.0,0.4484727382659912,719.5679259110984,20,-713,97,68,465,1606,215,32,68.76
-21,3,0,-21.0,3.0,0.45537781715393066,698.3552104767315,20,-692,94,68,465,1606,215,32,69.8
-19,3,0,-19.0,3.0,0.46401381492614746,679.1244363148775,20,-673,91,68,465,1606,215,32,64.25
-19,3,0,-19.0,3.0,0.4712679386138916,659.893930870712,20,-654,88,68,465,1606,215,32,63.15
-20,3,0,-20.0,3.0,0.47936177253723145,639.6725724931467,20,-634,85,68,465,1606,215,32,64.11
-21,3,0,-21.0,3.0,0.4878199100494385,618.4601846521731,20,-613,82,68,465,1606,215,32,64.9
-21,3,0,-21.0,3.0,0.49529576301574707,597.247854747089,20,-592,79,68,465,1606,215,32,63.56
-20,3,0,-20.0,3.0,0.5053129196166992,577.0268624596259,20,-572,76,68,465,1606,215,32,60.25
-22,3,0,-22.0,3.0,0.5113508701324463,554.823395325035,20,-550,73,68,465,1606,215,32,62.78
-21,2,0,-21.0,2.0,0.524871826171875,533.7433840339381,20,-529,71,68,465,1606,215,32,58.04
-21,2,0,-21.0,2.0,0.5314438343048096,512.6646077115134,20,-508,69,68,465,1606,215,32,56.57
-23,3,0,-23.0,3.0,0.5352957248687744,489.47012166219093,20,-485,66,68,465,1606,215,32,59.42
-20,3,0,-20.0,3.0,0.5434067249298096,469.2483351062633,20,-465,63,68,465,1606,215,32,53.31
-20,2,0,-20.0,2.0,0.5527818202972412,449.16144090961325,20,-445,61,68,465,1606,215,32,50.84
-19,2,0,-19.0,2.0,0.5594987869262695,430.06627396251383,20,-426,59,68,465,1606,215,32,48.23
-18,3,0,-18.0,3.0,0.5673048496246338,411.82520563948003,20,-408,56,68,465,1606,215,32,45.88
-18,2,0,-18.0,2.0,0.5753028392791748,393.72071319655004,20,-390,54,68,465,1606,215,32,44.49
-19,2,0,-19.0,2.0,0.5834479331970215,374.626480644388,20,-371,52,68,465,1606,215,32,44.18
-18,2,0,-18.0,2.0,0.591289758682251,356.52349151213025,20,-353,50,68,465,1606,215,32,41.71
-16,1,0,-16.0,1.0,0.60005784034729,340.5436829541843,20,-337,49,68,465,1606,215,32,36.61
-16,2,0,-16.0,2.0,0.6083247661590576,324.4225639501667,20,-321,47,68,465,1606,215,32,37.17
-16,1,0,-16.0,1.0,0.6236648559570312,308.4493475434824,20,-305,46,68,465,1606,215,32,34.25
-15,2,0,-15.0,2.0,0.6243228912353516,293.318939040765,20,-290,44,68,465,1606,215,32,33.83
-15,1,0,-15.0,1.0,0.631328821182251,278.3415168457627,20,-275,43,68,465,1606,215,32,30.82
-16,2,0,-16.0,2.0,0.6392767429351807,262.2250941462315,20,-259,41,68,465,1606,215,32,32.11
-15,1,0,-15.0,1.0,0.6472947597503662,247.25695136840946,20,-244,40,68,465,1606,215,32,28.41
-14,2,0,-14.0,2.0,0.6562557220458984,233.1179958733345,20,-230,38,68,465,1606,215,32,28.12
-16,1,0,-16.0,1.0,0.6641378402709961,217.17504460687928,20,-214,37,68,465,1606,215,32,26.88
-14,2,0,-14.0,2.0,0.6723387241363525,203.03940504246953,20,-200,35,68,465,1606,215,32,25.48
-13,1,0,-13.0,1.0,0.6792769432067871,190.06577808748213,20,-187,34,68,465,1606,215,32,21.91
-11,2,0,-11.0,2.0,0.6886098384857178,178.88543819998318,20,-176,32,68,465,1606,215,32,22.63
-10,1,0,-10.0,1.0,0.6990268230438232,168.8697723099075,20,-166,31,68,465,1606,215,32,17.69
-10,2,0,-10.0,2.0,0.7064187526702881,158.67261893597143,20,-156,29,68,465,1606,215,32,19.16
-8,2,0,-8.0,2.0,0.7113358974456787,150.44268011438774,20,-148,27,68,465,1606,215,32,15.07
-8,2,0,-8.0,2.0,0.7193129062652588,142.21462653327893,20,-140,25,68,465,1606,215,32,14.52
-7,1,0,-7.0,1.0,0.7273099422454834,135.14806694880988,20,-133,24,68,465,1606,215,32,13.7
-7,1,0,-7.0,1.0,0.7352757453918457,128.08200498118384,20,-126,23,68,465,1606,215,32,13.28
-6,2,0,-6.0,2.0,0.7447507381439209,121.82364302548172,20,-120,21,68,465,1606,215,32,10.52
-7,2,0,-7.0,2.0,0.7521579265594482,114.58621208504974,20,-113,19,68,465,1606,215,32,11.4
-5,1,0,-5.0,1.0,0.7636027336120605,109.48972554536796,20,-108,18,68,465,1606,215,32,10.71
-5,1,0,-5.0,1.0,0.7673099040985107,104.39348638684312,20,-103,17,68,465,1606,215,32,10.45
-5,2,0,-5.0,2.0,0.7755389213562012,99.14131328563285,20,-98,15,68,465,1606,215,32,7.96
-7,1,0,-7.0,1.0,0.7835648059844971,92.07062506576133,20,-91,14,68,465,1606,215,32,12.51
-6,2,0,-6.0,2.0,0.7913517951965332,85.84287972802403,20,-85,12,68,465,1606,215,32,8.38
-5,1,0,-5.0,1.0,0.7994587421417236,80.75270893288967,20,-80,11,68,465,1606,215,32,8.74
-4,1,0,-4.0,1.0,0.8072967529296875,76.6550715869472,20,-76,10,68,465,1606,215,32,7.04
-5,1,0,-5.0,1.0,0.8175017833709717,71.56814934033156,20,-71,9,68,465,1606,215,32,8.11
-7,2,0,-7.0,2.0,0.8239097595214844,64.38167441127949,20,-64,7,68,465,1606,215,32,7.82
-6,1,0,-6.0,1.0,0.8323407173156738,58.309518948453004,20,-58,6,68,465,1606,215,32,8.18
-5,1,0,-5.0,1.0,0.8393878936767578,53.23532661682466,20,-53,5,68,465,1606,215,32,6.73
-3,1,0,-3.0,1.0,0.8475818634033203,50.15974481593781,20,-50,4,68,465,1606,215,32,4.41
-3,1,0,-3.0,1.0,0.8556277751922607,47.095647357266465,20,-47,3,68,465,1606,215,32,4.2
-3,1,0,-3.0,1.0,0.8635039329528809,44.04543109109048,20,-44,2,68,465,1606,215,32,3.98
-3,1,0,-3.0,1.0,0.8720319271087646,41.012193308819754,20,-41,1,68,465,1606,215,32,3.76
-3,1,0,-3.0,1.0,0.8795359134674072,38.0,20,-38,0,68,465,1606,215,32,3.52
-4,0,0,-4.0,-0.0,0.8872838020324707,34.0,20,-34,0,68,465,1606,215,32,8.93
-5,2,0,-5.0,2.0,0.8958759307861328,29.068883707497267,20,-29,-2,68,465,1606,215,32,3.22
-4,1,0,-4.0,1.0,0.9035947322845459,25.179356624028344,20,-25,-3,68,465,1606,215,32,2.99
-5,1,0,-5.0,1.0,0.9113068580627441,20.396078054371138,20,-20,-4,68,465,1606,215,32,2.78
-4,1,0,-4.0,1.0,0.922116756439209,16.76305461424021,20,-16,-5,68,465,1606,215,32,1.76
-3,2,0,-3.0,2.0,0.9354557991027832,14.7648230602334,20,-13,-7,68,465,1606,215,32,0.17
-2,0,0,-2.0,-0.0,0.9359908103942871,13.038404810405298,20,-11,-7,68,465,1606,215,32,1.22
-1,0,0,-1.0,-0.0,0.9447677135467529,12.206555615733702,20,-10,-7,68,465,1606,215,32,1.12
-1,1,0,-1.0,1.0,0.9512977600097656,12.041594578792296,20,-9,-8,68,465,1606,215,32,-0.49
-1,0,0,-1.0,-0.0,0.9614167213439941,11.313708498984761,20,-8,-8,68,465,1606,215,32,0.69
-1,0,0,-1.0,-0.0,0.9678068161010742,10.63014581273465,20,-7,-8,68,465,1606,215,32,0.53
0,1,0,-0.0,1.0,0.9755039215087891,11.40175425099138,20,-7,-9,68,465,1606,215,32,0.94
-1,0,0,-1.0,-0.0,0.9834039211273193,10.816653826391969,20,-6,-9,68,465,1606,215,32,0.32
0,0,1,-0.0,-0.0,0.9943017959594727,10.816653826391969,20,-6,-9,68,465,1606,215,32,30.13
-1,1,1,-1.0,1.0,1.0002467632293701,11.180339887498949,20,-5,-10,68,465,1606,215,32,10.48
0,0,0,-0.0,-0.0,0.06298184394836426,1280.7579786985518,21,1170,521,1243,996,73,475,31,235.93
3,0,0,3.0,-0.0,0.1054537296295166,1278.0179967433949,21,1167,521,1243,996,73,475,31,20.57
3,-1,0,3.0,-1.0,0.11123490333557129,1275.6880496422314,21,1164,522,1243,996,73,475,31,17.16
5,-1,0,5.0,-1.0,0.11911582946777344,1271.538438270743,21,1159,523,1243,996,73,475,31,28.36
4,-1,0,4.0,-1.0,0.12744879722595215,1268.3063510051504,21,1155,524,1243,996,73,475,31,22.84
5,-1,0,5.0,-1.0,0.1356487274169922,1264.1696879770532,21,1150,525,1243,996,73,475,31,28.19
6,-1,0,6.0,-1.0,0.1447467803955078,1259.1314466726658,21,1144,526,1243,996,73,475,31,33.2
6,-1,0,6.0,-1.0,0.15097284317016602,1254.1024679028424,21,1138,527,1243,996,73,475,31,33.08
7,-2,0,7.0,-2.0,0.1591198444366455,1248.6000160179399,21,1131,529,1243,996,73,475,31,35.26
8,0,0,8.0,-0.0,0.16913175582885742,1241.3581272138995,21,1123,529,1243,996,73,475,31,44.52
8,-1,0,8.0,-1.0,0.17978978157043457,1234.5545755453666,21,1115,530,1243,996,73,475,31,41.92
10,0,0,10.0,-0.0,0.18299388885498047,1225.5304973765442,21,1105,530,1243,996,73,475,31,52.25
13,1,0,13.0,1.0,0.19099974632263184,1213.3857589406593,21,1092,529,1243,996,73,475,31,64.65
14,0,0,14.0,-0.0,0.20020079612731934,1200.80181545499,21,1078,529,1243,996,73,475,31,65.59
16,2,0,16.0,2.0,0.2070016860961914,1185.568639936128,21,1062,527,1243,996,73,475,31,74.48
17,3,0,17.0,3.0,0.2154698371887207,1169.01710851467,21,1045,524,1243,996,73,475,31,78.15
20,3,0,20.0,3.0,0.22342276573181152,1149.8112888643946,21,1025,521,1243,996,73,475,31,84.7
19,4,0,19.0,4.0,0.23165583610534668,1131.0724998867227,21,1006,517,1243,996,73,475,31,82.94
21,5,0,21.0,5.0,0.24060273170471191,1110.1211645581757,21,985,512,1243,996,73,475,31,87.79
20,5,0,20.0,5.0,0.2513427734375,1090.079813591647,21,965,507,1243,996,73,475,31,84.72
17,5,0,17.0,5.0,0.26061272621154785,1072.7105853863845,21,948,502,1243,996,73,475,31,77.26
16,6,0,16.0,6.0,0.2629997730255127,1055.7651253948484,21,932,496,1243,996,73,475,31,75.98
16,6,0,16.0,6.0,0.27097272872924805,1038.8243354869965,21,916,490,1243,996,73,475,31,75.27
16,6,0,16.0,6.0,0.2820746898651123,1021.8884479237447,21,900,484,1243,996,73,475,31,74.54
18,7,0,18.0,7.0,0.28709983825683594,1002.7227931985989,21,882,477,1243,996,73,475,31,79.56
20,9,0,20.0,9.0,0.29499387741088867,980.8506512206636,21,862,468,1243,996,73,475,31,85.42
23,9,0,23.0,9.0,0.30353784561157227,956.3482629251752,21,839,459,1243,996,73,475,31,88.89
24,10,0,24.0,10.0,0.3109908103942871,930.4977162787666,21,815,449,1243,996,73,475,31,90.22
25,10,0,25.0,10.0,0.31903576850891113,903.7815001425953,21,790,439,1243,996,73,475,31,90.04
25,11,0,25.0,11.0,0.3274269104003906,876.5894135796987,21,765,428,1243,996,73,475,31,89.62
26,12,0,26.0,12.0,0.33791375160217285,848.0430413605196,21,739,416,1243,996,73,475,31,90.29
29,15,0,29.0,15.0,0.3448517322540283,815.4146184610624,21,710,401,1243,996,73,475,31,94.99
27,13,0,27.0,13.0,0.35102391242980957,785.5144810886684,21,683,388,1243,996,73,475,31,88.5
25,14,0,25.0,14.0,0.3589498996734619,756.8619424967806,21,658,374,1243,996,73,475,31,86.85
21,12,0,21.0,12.0,0.3702528476715088,732.6752350120754,21,637,362,1243,996,73,475,31,78.64
21,13,0,21.0,13.0,0.3758368492126465,707.9950564799163,21,616,349,1243,996,73,475,31,76.17
20,13,0,20.0,13.0,0.38294482231140137,684.1871089110055,21,596,336,1243,996,73,475,31,72.7
20,13,0,20.0,13.0,0.390974760055542,660.3824649398256,21,576,323,1243,996,73,475,31,71.12
20,13,0,20.0,13.0,0.3989837169647217,636.5814951755981,21,556,310,1243,996,73,475,31,69.5
20,13,0,20.0,13.0,0.40699172019958496,612.7846277445282,21,536,297,1243,996,73,475,31,67.85
19,13,0,19.0,13.0,0.41497278213500977,589.8686294421835,21,517,284,1243,996,73,475,31,64.56
19,12,0,19.0,12.0,0.42299389839172363,567.4398646552778,21,498,272,1243,996,73,475,31,62.83
17,12,0,17.0,12.0,0.43317174911499023,546.7732619651404,21,481,260,1243,996,73,475,31,57.94
16,11,0,16.0,11.0,0.4408078193664551,527.471326234896,21,465,249,1243,996,73,475,31,54.59
16,12,0,16.0,12.0,0.4470207691192627,507.71054745789945,21,449,237,1243,996,73,475,31,53.54
16,12,0,16.0,12.0,0.4552156925201416,487.96926132698155,21,433,225,1243,996,73,475,31,52.12
17,12,0,17.0,12.0,0.46299076080322266,467.3596045873028,21,416,213,1243,996,73,475,31,52.14
19,13,0,19.0,13.0,0.47353076934814453,444.5323385311804,21,397,200,1243,996,73,475,31,53.46
19,12,0,19.0,12.0,0.4807248115539551,422.1705816373282,21,378,188,1243,996,73,475,31,51.48
20,13,0,20.0,13.0,0.4880838394165039,398.4833748100415,21,358,175,1243,996,73,475,31,50.87
22,12,0,22.0,12.0,0.4963517189025879,373.45013053954074,21,336,163,1243,996,73,475,31,51.32
20,11,0,20.0,11.0,0.5040028095245361,350.65652710308984,21,316,152,1243,996,73,475,31,46.82
18,10,0,18.0,10.0,0.5114567279815674,330.1030142243479,21,298,142,1243,996,73,475,31,42.46
16,11,0,16.0,11.0,0.5189807415008545,310.94211679989576,21,282,131,1243,996,73,475,31,38.03
15,9,0,15.0,9.0,0.5275418758392334,293.5523803344132,21,267,122,1243,996,73,475,31,35.15
14,8,0,14.0,8.0,0.5350298881530762,277.49774773860776,21,253,114,1243,996,73,475,31,32.54
12,7,0,12.0,7.0,0.5430006980895996,263.68541863364385,21,241,107,1243,996,73,475,31,28.63
11,7,0,11.0,7.0,0.5542447566986084,250.79872407968904,21,230,100,1243,996,73,475,31,26.11
10,7,0,10.0,7.0,0.5591287612915039,238.8493248891443,21,220,93,1243,996,73,475,31,23.72
9,7,0,9.0,7.0,0.5670077800750732,227.85302280198084,21,211,86,1243,996,73,475,31,21.43
12,8,0,12.0,8.0,0.5753657817840576,213.74049686477292,21,199,78,1243,996,73,475,31,24.34
11,7,0,11.0,7.0,0.5829958915710449,200.9601950635996,21,188,71,1243,996,73,475,31,22.03
12,7,0,12.0,7.0,0.5911967754364014,187.275198571514,21,176,64,1243,996,73,475,31,22.07
11,7,0,11.0,7.0,0.5998098850250244,174.56803831171388,21,165,57,1243,996,73,475,31,19.77
11,6,0,11.0,6.0,0.6093268394470215,162.22515218054195,21,154,51,1243,996,73,475,31,18.83
12,6,0,12.0,6.0,0.6156327724456787,148.95972610071487,21,142,45,1243,996,73,475,31,18.74
9,4,0,9.0,4.0,0.6246728897094727,139.17614738165446,21,133,41,1243,996,73,475,31,15.37
9,5,0,9.0,5.0,0.6310317516326904,129.1200991325518,21,124,36,1243,996,73,475,31,14.04
9,3,0,9.0,3.0,0.6394917964935303,119.64113005150027,21,115,33,1243,996,73,475,31,15.06
7,3,0,7.0,3.0,0.6473426818847656,112.08925015361643,21,108,30,1243,996,73,475,31,11.51
5,3,0,5.0,3.0,0.6586897373199463,106.48004507887852,21,103,27,1243,996,73,475,31,8.47
4,1,0,4.0,1.0,0.6630027294158936,102.35721762533407,21,99,26,1243,996,73,475,31,10.51
4,2,0,4.0,2.0,0.672663688659668,97.98469268207153,21,95,24,1243,996,73,475,31,7.36
4,1,0,4.0,1.0,0.6790797710418701,93.86160024205851,21,91,23,1243,996,73,475,31,10.9
3,1,0,3.0,1.0,0.687208890914917,90.70832376358854,21,88,22,1243,996,73,475,31,7.36
3,1,0,3.0,1.0,0.6950058937072754,87.55569655939013,21,85,21,1243,996,73,475,31,7.22
2,1,0,2.0,1.0,0.703009843826294,85.37564055396598,21,83,20,1243,996,73,475,31,4.93
3,2,0,3.0,2.0,0.711845874786377,82.0,21,80,18,1243,996,73,475,31,5.19
3,0,0,3.0,-0.0,0.7189629077911377,79.07591289387686,21,77,18,1243,996,73,475,31,5.38
1,1,0,1.0,1.0,0.727083683013916,77.87810988975015,21,76,17,1243,996,73,475,31,2.64
1,0,0,1.0,-0.0,0.734954833984375,76.90253571892151,21,75,17,1243,996,73,475,31,3.74
1,0,0,1.0,-0.0,0.7671027183532715,75.92759709091287,21,74,17,1243,996,73,475,31,3.71
1,0,0,1.0,-0.0,0.7787337303161621,74.95331880577403,21,73,17,1243,996,73,475,31,3.68
2,1,0,2.0,1.0,0.7837238311767578,72.78049189171504,21,71,16,1243,996,73,475,31,4.55
3,0,0,3.0,-0.0,0.7928557395935059,69.85699678629192,21,68,16,1243,996,73,475,31,5.1
4,1,0,4.0,1.0,0.7990179061889648,65.73431371817918,21,64,15,1243,996,73,475,31,8.99
3,0,0,3.0,-0.0,0.8076317310333252,62.81719509815764,21,61,15,1243,996,73,475,31,4.81
4,1,0,4.0,1.0,0.8149778842926025,58.69412236331676,21,57,14,1243,996,73,475,31,9.48
5,0,0,5.0,-0.0,0.8237578868865967,53.85164807134504,21,52,14,1243,996,73,475,31,5.46
4,1,0,4.0,1.0,0.8311567306518555,49.72926703662542,21,48,13,1243,996,73,475,31,8.09
4,1,0,4.0,1.0,0.8390347957611084,45.60701700396552,21,44,12,1243,996,73,475,31,7.83
4,1,0,4.0,1.0,0.8469927310943604,41.48493702538308,21,40,11,1243,996,73,475,31,7.54
4,2,0,4.0,2.0,0.8569839000701904,37.107950630558946,21,36,9,1243,996,73,475,31,4.62
5,1,0,5.0,1.0,0.8629658222198486,32.01562118716424,21,31,8,1243,996,73,475,31,6.44
4,1,0,4.0,1.0,0.8715667724609375,27.892651361962706,21,27,7,1243,996,73,475,31,7.78
4,2,0,4.0,2.0,0.8790888786315918,23.53720459187964,21,23,5,1243,996,73,475,31,3.62
4,1,0,4.0,1.0,0.8869729042053223,19.4164878389476,21,19,4,1243,996,73,475,31,5.82
3,1,0,3.0,1.0,0.894993782043457,16.278820596099706,21,16,3,1243,996,73,475,31,3.7
2,0,0,2.0,-0.0,0.9044668674468994,14.317821063276353,21,14,3,1243,996,73,475,31,2.79
3,1,0,3.0,1.0,0.9184527397155762,11.180339887498949,21,11,2,1243,996,73,475,31,3.24
2,1,0,2.0,1.0,0.918928861618042,9.055385138137417,21,9,1,1243,996,73,475,31,1.64
1,0,0,1.0,-0.0,0.9317119121551514,8.06225774829855,21,8,1,1243,996,73,475,31,3.11
2,0,0,2.0,-0.0,0.9349567890167236,6.082762530298219,21,6,1,1243,996,73,475,31,2.39
2,1,0,2.0,1.0,0.944084882736206,4.0,21,4,0,1243,996,73,475,31,0.55
2,1,0,2.0,1.0,0.9511308670043945,2.23606797749979,21,2,-1,1243,996,73,475,31,-0.96
2,0,0,2.0,-0.0,0.9616239070892334,1.0,21,0,-1,1243,996,73,475,31,-2.32
0,1,0,-0.0,1.0,0.9829888343811035,2.0,21,0,-2,1243,996,73,475,31,6.98
0,0,1,-0.0,-0.0,0.9950048923492432,2.0,21,0,-2,1243,996,73,475,31,27.51
0,0,0,-0.0,-0.0,1.1069977283477783,2.0,21,0,-2,1243,996,73,475,31,17.51
-2,0,0,-2.0,-0.0,1.1830928325653076,2.8284271247461903,21,2,-2,1243,996,73,475,31,-2.02
-2,0,0,-2.0,-0.0,1.1910006999969482,4.47213595499958,21,4,-2,1243,996,73,475,31,-0.98
-1,-1,0,-1.0,-1.0,1.1991758346557617,5.0990195135927845,21,5,-1,1243,996,73,475,31,-0.59
-2,-1,0,-2.0,-1.0,1.2070167064666748,7.0,21,7,0,1243,996,73,475,31,-0.4
-1,-1,0,-1.0,-1.0,1.2159357070922852,8.06225774829855,21,8,1,1243,996,73,475,31,0.14
-2,-1,0,-2.0,-1.0,1.2229948043823242,10.198039027185569,21,10,2,1243,996,73,475,31,0.88
-1,-1,0,-1.0,-1.0,1.2311017513275146,11.40175425099138,21,11,3,1243,996,73,475,31,0.79
-1,0,0,-1.0,-0.0,1.240696907043457,12.36931687685298,21,12,3,1243,996,73,475,31,2.26
-1,-1,0,-1.0,-1.0,1.2482917308807373,13.601470508735444,21,13,4,1243,996,73,475,31,1.04
-1,0,0,-1.0,-0.0,1.2549588680267334,14.560219778561036,21,14,4,1243,996,73,475,31,2.23
0,0,1,-0.0,-0.0,1.2959938049316406,14.560219778561036,21,14,4,1243,996,73,475,31,31.25
0,0,0,-0.0,-0.0,0.08623147010803223,884.7609846732619,22,-579,-669,650,323,1229,992,49,191.65
0,-1,0,-0.0,-1.0,0.21029257774353027,884.0050904830808,22,-579,-668,650,323,1229,992,49,4.05
-2,-2,0,-2.0,-2.0,0.21827054023742676,881.183862766449,22,-577,-666,650,323,1229,992,49,14.31
-3,-2,0,-3.0,-2.0,0.22721457481384277,877.7083798164399,22,-574,-664,650,323,1229,992,49,14.75
-5,-4,0,-5.0,-4.0,0.23420047760009766,871.4132200052969,22,-569,-660,650,323,1229,992,49,23.9
-5,-6,0,-5.0,-6.0,0.24584650993347168,863.6040759514744,22,-564,-654,650,323,1229,992,49,30.67
-9,-7,0,-9.0,-7.0,0.2502133846282959,852.4282961047222,22,-555,-647,650,323,1229,992,49,36.45
-14,-14,0,-14.0,-14.0,0.2582285404205322,832.6884171165107,22,-541,-633,650,323,1229,992,49,55.17
-22,-19,0,-22.0,-19.0,0.2678093910217285,803.9633076204411,22,-519,-614,650,323,1229,992,49,67.47
-28,-20,0,-28.0,-20.0,0.27420639991760254,770.660106661815,22,-491,-594,650,323,1229,992,49,71.02
-31,-22,0,-31.0,-22.0,0.28235340118408203,734.0190733216679,22,-460,-572,650,323,1229,992,49,72.66
-31,-21,0,-31.0,-21.0,0.29051852226257324,698.3136830966439,22,-429,-551,650,323,1229,992,49,69.29
-30,-21,0,-30.0,-21.0,0.29822254180908203,663.4010853171707,22,-399,-530,650,323,1229,992,49,66.27
-27,-19,0,-27.0,-19.0,0.3083505630493164,632.0640790299667,22,-372,-511,650,323,1229,992,49,60.37
-24,-18,0,-24.0,-18.0,0.3142213821411133,603.4509093538595,22,-348,-493,650,323,1229,992,49,55.62
-19,-16,0,-19.0,-16.0,0.3227074146270752,579.4566420363132,22,-329,-477,650,323,1229,992,49,48.82
-15,-16,0,-15.0,-16.0,0.3307523727416992,557.7786299240945,22,-314,-461,650,323,1229,992,49,45.39
-12,-15,0,-12.0,-15.0,0.34085845947265625,538.6278863928231,22,-302,-446,650,323,1229,992,49,41.84
-11,-16,0,-11.0,-16.0,0.35271739959716797,519.2119027911436,22,-291,-430,650,323,1229,992,49,43.46
-10,-16,0,-10.0,-16.0,0.35484957695007324,500.35687264191745,22,-281,-414,650,323,1229,992,49,40.47
-9,-14,0,-9.0,-14.0,0.363478422164917,483.7189266505912,22,-272,-400,650,323,1229,992,49,37.0
-11,-16,0,-11.0,-16.0,0.3704414367675781,464.3027029858861,22,-261,-384,650,323,1229,992,49,40.89
-12,-18,0,-12.0,-18.0,0.3782644271850586,442.6703062099377,22,-249,-366,650,323,1229,992,49,42.12
-13,-19,0,-13.0,-19.0,0.3862955570220947,419.64866257382494,22,-236,-347,650,323,1229,992,49,42.86
-14,-20,0,-14.0,-20.0,0.39423346519470215,395.2379030406876,22,-222,-327,650,323,1229,992,49,41.93
-14,-20,0,-14.0,-20.0,0.40842556953430176,370.8274531369003,22,-208,-307,650,323,1229,992,49,40.27
-13,-18,0,-13.0,-18.0,0.41120052337646484,348.63447907514825,22,-195,-289,650,323,1229,992,49,36.01
-10,-17,0,-10.0,-17.0,0.41829752922058105,328.95136418625776,22,-185,-272,650,323,1229,992,49,31.52
-8,-15,0,-8.0,-15.0,0.42631959915161133,312.05448242254107,22,-177,-257,650,323,1229,992,49,27.05
-6,-14,0,-6.0,-14.0,0.4342343807220459,297.1363323459452,22,-171,-243,650,323,1229,992,49,23.37
-5,-14,0,-5.0,-14.0,0.44348859786987305,282.83740912404073,22,-166,-229,650,323,1229,992,49,21.56
-4,-14,0,-4.0,-14.0,0.45293259620666504,269.20066864701505,22,-162,-215,650,323,1229,992,49,19.82
-3,-13,0,-3.0,-13.0,0.45824551582336426,257.07002936943076,22,-159,-202,650,323,1229,992,49,17.44
-2,-11,0,-2.0,-11.0,0.466266393661499,247.24481794367298,22,-157,-191,650,323,1229,992,49,14.38
-3,-12,0,-3.0,-12.0,0.4831125736236572,236.12920192132103,22,-154,-179,650,323,1229,992,49,15.37
-4,-12,0,-4.0,-12.0,0.48775649070739746,224.47494292236718,22,-150,-167,650,323,1229,992,49,15.53
-3,-11,0,-3.0,-11.0,0.49059247970581055,214.34784813475503,22,-147,-156,650,323,1229,992,49,13.36
-4,-9,0,-4.0,-9.0,0.49828648567199707,205.08047201037937,22,-143,-147,650,323,1229,992,49,12.63
-4,-9,0,-4.0,-9.0,0.5098013877868652,195.86985475054604,22,-139,-138,650,323,1229,992,49,12.13
-3,-8,0,-3.0,-8.0,0.5166714191436768,188.13824704190267,22,-136,-130,650,323,1229,992,49,10.19
-4,-7,0,-4.0,-7.0,0.5222115516662598,180.42449944505873,22,-132,-123,650,323,1229,992,49,10.46
-4,-7,0,-4.0,-7.0,0.5302174091339111,172.74258305351347,22,-128,-116,650,323,1229,992,49,10.09
-4,-7,0,-4.0,-7.0,0.5387544631958008,165.0969412193939,22,-124,-109,650,323,1229,992,49,9.7
-4,-7,0,-4.0,-7.0,0.5508015155792236,157.49285698088025,22,-120,-102,650,323,1229,992,49,9.31
-4,-6,0,-4.0,-6.0,0.5616533756256104,150.57224179774968,22,-116,-96,650,323,1229,992,49,8.75
-4,-5,0,-4.0,-5.0,0.5623095035552979,144.30869689661813,22,-112,-91,650,323,1229,992,49,8.45
-3,-5,0,-3.0,-5.0,0.5702295303344727,138.84163640637487,22,-109,-86,650,323,1229,992,49,6.91
-4,-4,0,-4.0,-4.0,0.5782794952392578,133.22537295875736,22,-105,-82,650,323,1229,992,49,8.35
-4,-3,0,-4.0,-3.0,0.5864624977111816,128.22636234409833,22,-101,-79,650,323,1229,992,49,9.76
-4,-4,0,-4.0,-4.0,0.594226598739624,122.61321299109652,22,-97,-75,650,323,1229,992,49,7.96
-4,-3,0,-4.0,-3.0,0.6022155284881592,117.61377470347595,22,-93,-72,650,323,1229,992,49,9.7
-2,-4,0,-2.0,-4.0,0.6103904247283936,113.6001760562016,22,-91,-68,650,323,1229,992,49,4.8
-3,-2,0,-3.0,-2.0,0.6184144020080566,110.0,22,-88,-66,650,323,1229,992,49,7.25
-2,-3,0,-2.0,-3.0,0.6263613700866699,106.60675400742676,22,-86,-63,650,323,1229,992,49,4.63
-3,-3,0,-3.0,-3.0,0.6386744976043701,102.41581909060729,22,-83,-60,650,323,1229,992,49,6.13
-2,-3,0,-2.0,-3.0,0.6423835754394531,99.04544411531506,22,-81,-57,650,323,1229,992,49,4.37
-3,-3,0,-3.0,-3.0,0.6502244472503662,94.86832980505137,22,-78,-54,650,323,1229,992,49,5.76
-2,-3,0,-2.0,-3.0,0.6589164733886719,91.52595260361949,22,-76,-51,650,323,1229,992,49,4.11
-3,-3,0,-3.0,-3.0,0.66623854637146,87.36704184073076,22,-73,-48,650,323,1229,992,49,5.38
-4,-3,0,-4.0,-3.0,0.6742215156555176,82.37718130647589,22,-69,-45,650,323,1229,992,49,7.15
-5,-3,0,-5.0,-3.0,0.6880145072937012,76.55063683601855,22,-64,-42,650,323,1229,992,49,7.94
-4,-4,0,-4.0,-4.0,0.6910045146942139,71.02112361825881,22,-60,-38,650,323,1229,992,49,5.41
-5,-3,0,-5.0,-3.0,0.7038235664367676,65.19202405202648,22,-55,-35,650,323,1229,992,49,7.98
-3,-3,0,-3.0,-3.0,0.7063865661621094,61.05735008989499,22,-52,-32,650,323,1229,992,49,4.41
-2,-2,0,-2.0,-2.0,0.7215914726257324,58.309518948453004,22,-50,-30,650,323,1229,992,49,3.75
-2,-1,0,-2.0,-1.0,0.7257635593414307,56.08029957123981,22,-48,-29,650,323,1229,992,49,4.99
-2,-3,0,-2.0,-3.0,0.730271577835083,52.839379254491625,22,-46,-26,650,323,1229,992,49,2.86
-2,-2,0,-2.0,-2.0,0.7407515048980713,50.11985634456667,22,-44,-24,650,323,1229,992,49,3.33
-3,-3,0,-3.0,-3.0,0.7522604465484619,46.06517122512408,22,-41,-21,650,323,1229,992,49,3.48
-2,-1,0,-2.0,-1.0,0.7581925392150879,43.829214001622255,22,-39,-20,650,323,1229,992,49,6.79
-1,-1,0,-1.0,-1.0,0.7638204097747803,42.485291572496,22,-38,-19,650,323,1229,992,49,2.64
-1,-1,0,-1.0,-1.0,0.7702205181121826,41.14608122288197,22,-37,-18,650,323,1229,992,49,2.57
-1,-1,0,-1.0,-1.0,0.7784924507141113,39.81205847478876,22,-36,-17,650,323,1229,992,49,2.5
-1,0,0,-1.0,-0.0,0.7862865924835205,38.91015291668744,22,-35,-17,650,323,1229,992,49,2.02
-1,-1,0,-1.0,-1.0,0.7976174354553223,37.57658845611187,22,-34,-16,650,323,1229,992,49,2.45
-1,0,0,-1.0,-0.0,0.8070964813232422,36.6742416417845,22,-33,-16,650,323,1229,992,49,1.99
-1,0,0,-1.0,-0.0,0.8102164268493652,35.77708763999664,22,-32,-16,650,323,1229,992,49,1.94
0,0,1,-0.0,-0.0,0.8162164688110352,35.77708763999664,22,-32,-16,650,323,1229,992,49,37.72
-1,0,1,-1.0,-0.0,0.07435727119445801,706.7007853398778,23,445,549,1126,888,682,339,31,8.78
0,0,0,-0.0,-0.0,0.07751226425170898,706.7007853398778,23,445,549,1126,888,682,339,31,167.75
-1,0,0,-1.0,-0.0,0.0898122787475586,707.330898519215,23,446,549,1126,888,682,339,31,8.78
2,4,0,2.0,4.0,0.2177143096923828,702.9658597684528,23,444,545,1126,888,682,339,31,22.62
5,6,0,5.0,6.0,0.22561430931091309,695.1560975780907,23,439,539,1126,888,682,339,31,37.96
4,6,0,4.0,6.0,0.23407411575317383,687.9781973289561,23,435,533,1126,888,682,339,31,33.61
6,6,0,6.0,6.0,0.24143123626708984,679.5366068137904,23,429,527,1126,888,682,339,31,37.38
5,8,0,5.0,8.0,0.24944710731506348,670.1768423334247,23,424,519,1126,888,682,339,31,39.58
6,7,0,6.0,7.0,0.25858116149902344,660.9599080125813,23,418,512,1126,888,682,339,31,40.69
6,10,0,6.0,10.0,0.2654402256011963,649.4212808339437,23,412,502,1126,888,682,339,31,44.64
9,12,0,9.0,12.0,0.2736942768096924,634.4359699764823,23,403,490,1126,888,682,339,31,53.63
8,13,0,8.0,13.0,0.28521728515625,619.3173661379116,23,395,477,1126,888,682,339,31,51.77
12,15,0,12.0,15.0,0.2894561290740967,600.1108230985341,23,383,462,1126,888,682,339,31,60.98
14,19,0,14.0,19.0,0.29820919036865234,576.5500845546725,23,369,443,1126,888,682,339,31,65.22
15,21,0,15.0,21.0,0.3072531223297119,550.8175741568165,23,354,422,1126,888,682,339,31,66.03
16,20,0,16.0,20.0,0.31371617317199707,525.2123380119701,23,338,402,1126,888,682,339,31,65.22
15,21,0,15.0,21.0,0.3214602470397949,499.48973963435924,23,323,381,1126,888,682,339,31,61.99
17,20,0,17.0,20.0,0.32939624786376953,473.240953426476,23,306,361,1126,888,682,339,31,63.35
15,20,0,15.0,20.0,0.33805322647094727,448.28785395100766,23,291,341,1126,888,682,339,31,57.3
16,17,0,16.0,17.0,0.34574413299560547,424.97176376790026,23,275,324,1126,888,682,339,31,53.71
16,18,0,16.0,18.0,0.35400915145874023,400.8952481634074,23,259,306,1126,888,682,339,31,53.41
15,18,0,15.0,18.0,0.36139726638793945,377.46523018683456,23,244,288,1126,888,682,339,31,51.57
15,17,0,15.0,17.0,0.3699362277984619,354.79853438254224,23,229,271,1126,888,682,339,31,48.05
12,16,0,12.0,16.0,0.3790421485900879,334.8342873721268,23,217,255,1126,888,682,339,31,42.21
12,14,0,12.0,14.0,0.386580228805542,316.3953223421611,23,205,241,1126,888,682,339,31,41.2
10,13,0,10.0,13.0,0.39339327812194824,300.01499962501873,23,195,228,1126,888,682,339,31,35.41
9,12,0,9.0,12.0,0.40349411964416504,285.04736448527285,23,186,216,1126,888,682,339,31,32.23
8,12,0,8.0,12.0,0.409656286239624,270.7397274136177,23,178,204,1126,888,682,339,31,29.54
8,10,0,8.0,10.0,0.4173762798309326,257.9457307264456,23,170,194,1126,888,682,339,31,28.05
8,11,0,8.0,11.0,0.4268922805786133,244.40335513245313,23,162,183,1126,888,682,339,31,27.1
6,9,0,6.0,9.0,0.4347531795501709,233.69210512980536,23,156,174,1126,888,682,339,31,22.33
5,9,0,5.0,9.0,0.4440922737121582,223.66492796144863,23,151,165,1126,888,682,339,31,20.15
4,8,0,4.0,8.0,0.4497833251953125,215.07673049402624,23,147,157,1126,888,682,339,31,17.45
6,9,0,6.0,9.0,0.4576911926269531,204.41379601191306,23,141,148,1126,888,682,339,31,20.14
5,8,0,5.0,8.0,0.4683051109313965,195.18196638009363,23,136,140,1126,888,682,339,31,17.57
6,9,0,6.0,9.0,0.473480224609375,184.55622449540954,23,130,131,1126,888,682,339,31,18.64
6,9,0,6.0,9.0,0.48145031929016113,173.95401691251627,23,124,122,1126,888,682,339,31,17.81
5,8,0,5.0,8.0,0.4893813133239746,164.7938105633825,23,119,114,1126,888,682,339,31,15.43
6,8,0,6.0,8.0,0.4980301856994629,154.93547043850222,23,113,106,1126,888,682,339,31,16.0
5,7,0,5.0,7.0,0.5054621696472168,146.50938536489735,23,108,99,1126,888,682,339,31,13.78
5,7,0,5.0,7.0,0.5134222507476807,138.10503249338888,23,103,92,1126,888,682,339,31,13.17
5,6,0,5.0,6.0,0.5219283103942871,130.38404810405297,23,98,86,1126,888,682,339,31,12.53
4,5,0,4.0,5.0,0.5294821262359619,124.08464852672147,23,94,81,1126,888,682,339,31,10.58
5,5,0,5.0,5.0,0.5387332439422607,117.0341830406826,23,89,76,1126,888,682,339,31,12.04
3,4,0,3.0,4.0,0.5458042621612549,112.16059914247963,23,86,72,1126,888,682,339,31,8.32
3,4,0,3.0,4.0,0.5643482208251953,107.29864864013899,23,83,68,1126,888,682,339,31,8.05
3,3,0,3.0,3.0,0.564481258392334,103.07764064044152,23,80,65,1126,888,682,339,31,8.41
3,3,0,3.0,3.0,0.5695772171020508,98.85848471426213,23,77,62,1126,888,682,339,31,8.19
4,2,0,4.0,2.0,0.5777943134307861,94.49338601193207,23,73,60,1126,888,682,339,31,7.17
2,2,0,2.0,2.0,0.5854411125183105,91.67878707749138,23,71,58,1126,888,682,339,31,6.74
2,1,0,2.0,1.0,0.5988593101501465,89.49860334105779,23,69,57,1126,888,682,339,31,5.02
1,1,0,1.0,1.0,0.6014583110809326,88.09086218218096,23,68,56,1126,888,682,339,31,5.37
2,0,0,2.0,-0.0,0.6131172180175781,86.55634003352961,23,66,56,1126,888,682,339,31,2.75
1,0,0,1.0,-0.0,0.6174571514129639,85.7962703152066,23,65,56,1126,888,682,339,31,2.0
1,1,0,1.0,1.0,0.631263256072998,84.38601779915912,23,64,55,1126,888,682,339,31,5.62
2,0,0,2.0,-0.0,0.6334171295166016,82.87943049997388,23,62,55,1126,888,682,339,31,2.62
1,1,0,1.0,1.0,0.641411304473877,81.46778504415104,23,61,54,1126,888,682,339,31,5.84
1,0,0,1.0,-0.0,0.6509442329406738,80.72174428244226,23,60,54,1126,888,682,339,31,1.9
3,1,0,3.0,1.0,0.6575882434844971,77.83315488916018,23,57,53,1126,888,682,339,31,4.44
3,1,0,3.0,1.0,0.6656162738800049,74.96665925596525,23,54,52,1126,888,682,339,31,4.28
2,2,0,2.0,2.0,0.673504114151001,72.13875518748573,23,52,50,1126,888,682,339,31,8.0
3,1,0,3.0,1.0,0.6815071105957031,69.29646455628166,23,49,49,1126,888,682,339,31,4.03
4,2,0,4.0,2.0,0.6896541118621826,65.06919393998976,23,45,47,1126,888,682,339,31,5.25
3,1,0,3.0,1.0,0.7022881507873535,62.289646009589745,23,42,46,1126,888,682,339,31,3.64
2,2,0,2.0,2.0,0.707970142364502,59.464274989274024,23,40,44,1126,888,682,339,31,6.73
3,2,0,3.0,2.0,0.7137563228607178,55.97320787662612,23,37,42,1126,888,682,339,31,4.82
3,2,0,3.0,2.0,0.7218883037567139,52.49761899362675,23,34,40,1126,888,682,339,31,4.58
3,3,0,3.0,3.0,0.729438304901123,48.27007354458868,23,31,37,1126,888,682,339,31,6.35
3,1,0,3.0,1.0,0.7382962703704834,45.60701700396552,23,28,36,1126,888,682,339,31,2.81
2,2,0,2.0,2.0,0.7466583251953125,42.80186911806539,23,26,34,1126,888,682,339,31,4.89
3,3,0,3.0,3.0,0.7543272972106934,38.600518131237564,23,23,31,1126,888,682,339,31,5.18
2,3,0,2.0,3.0,0.7615172863006592,35.0,23,21,28,1126,888,682,339,31,6.04
3,4,0,3.0,4.0,0.7709662914276123,30.0,23,18,24,1126,888,682,339,31,9.33
3,3,0,3.0,3.0,0.7774112224578857,25.80697580112788,23,15,21,1126,888,682,339,31,4.3
2,3,0,2.0,3.0,0.785642147064209,22.20360331117452,23,13,18,1126,888,682,339,31,5.86
1,3,0,1.0,3.0,0.7938752174377441,19.209372712298546,23,12,15,1126,888,682,339,31,2.51
1,2,0,1.0,2.0,0.8015992641448975,17.029386365926403,23,11,13,1126,888,682,339,31,2.8
2,4,0,2.0,4.0,0.8118371963500977,12.727922061357855,23,9,9,1126,888,682,339,31,2.4
1,2,0,1.0,2.0,0.8179421424865723,10.63014581273465,23,8,7,1126,888,682,339,31,1.65
2,2,0,2.0,2.0,0.8256781101226807,7.810249675906654,23,6,5,1126,888,682,339,31,3.47
0,2,0,-0.0,2.0,0.8333821296691895,6.708203932499369,23,6,3,1126,888,682,339,31,-0.46
1,0,0,1.0,-0.0,0.8431422710418701,5.830951894845301,23,5,3,1126,888,682,339,31,0.81
0,1,0,-0.0,1.0,0.8584883213043213,5.385164807134504,23,5,2,1126,888,682,339,31,-0.43
0,0,1,-0.0,-0.0,0.8864231109619141,5.385164807134504,23,5,2,1126,888,682,339,31,28.51
0,0,0,-0.0,-0.0,0.08083128929138184,228.96506283710622,24,195,-120,1316,766,1121,886,43,80.75
-1,0,0,-1.0,-0.0,0.15133023262023926,229.8173187555716,24,196,-120,1316,766,1121,886,43,3.53
-2,0,0,-2.0,-0.0,0.15882229804992676,231.52537657889687,24,198,-120,1316,766,1121,886,43,2.52
-2,-1,0,-2.0,-1.0,0.1667952537536621,232.72515979154468,24,200,-119,1316,766,1121,886,43,2.08
-2,-2,0,-2.0,-2.0,0.17506814002990723,233.43735776434755,24,202,-117,1316,766,1121,886,43,2.64
-2,-3,0,-2.0,-3.0,0.1828441619873047,233.69210512980536,24,204,-114,1316,766,1121,886,43,6.35
-1,-3,0,-1.0,-3.0,0.19081926345825195,233.1222855069845,24,205,-111,1316,766,1121,886,43,1.17
0,-3,0,-0.0,-3.0,0.19934725761413574,231.70886905770354,24,205,-108,1316,766,1121,886,43,2.91
0,-3,0,-0.0,-3.0,0.20687222480773926,230.32585612562042,24,205,-105,1316,766,1121,886,43,2.84
1,-4,0,1.0,-4.0,0.2149641513824463,227.6334773270399,24,204,-101,1316,766,1121,886,43,5.14
2,-5,0,2.0,-5.0,0.22371625900268555,223.6515146382872,24,202,-96,1316,766,1121,886,43,7.12
1,-4,0,1.0,-4.0,0.23156428337097168,221.05429197371402,24,201,-92,1316,766,1121,886,43,4.86
2,-4,0,2.0,-4.0,0.24001431465148926,217.5890622251036,24,199,-88,1316,766,1121,886,43,6.41
2,-5,0,2.0,-5.0,0.24690914154052734,213.77090541044166,24,197,-83,1316,766,1121,886,43,6.6
3,-4,0,3.0,-4.0,0.2602403163909912,209.46837470128995,24,194,-79,1316,766,1121,886,43,7.7
4,-5,0,4.0,-5.0,0.2628152370452881,203.90193721492693,24,190,-74,1316,766,1121,886,43,9.16
4,-4,0,4.0,-4.0,0.27126216888427734,198.73600579663466,24,186,-70,1316,766,1121,886,43,8.84
4,-4,0,4.0,-4.0,0.27894020080566406,193.59752064528098,24,182,-66,1316,766,1121,886,43,8.62
5,-3,0,5.0,-3.0,0.2872593402862549,187.8776197422141,24,177,-63,1316,766,1121,886,43,10.21
5,-4,0,5.0,-4.0,0.29485416412353516,181.8378398463862,24,172,-59,1316,766,1121,886,43,9.6
4,-2,0,4.0,-2.0,0.30349230766296387,177.40631330367023,24,168,-57,1316,766,1121,886,43,8.98
5,-3,0,5.0,-3.0,0.31081223487854004,171.71196813268432,24,163,-54,1316,766,1121,886,43,9.53
6,-3,0,6.0,-3.0,0.3189241886138916,165.07574019219177,24,157,-51,1316,766,1121,886,43,10.77
11,-4,0,11.0,-4.0,0.3270902633666992,153.37861650177967,24,146,-47,1316,766,1121,886,43,16.25
17,-4,0,17.0,-4.0,0.3377242088317871,135.9779393872403,24,129,-43,1316,766,1121,886,43,17.64
17,-5,0,17.0,-5.0,0.3428182601928711,118.27087553578015,24,112,-38,1316,766,1121,886,43,17.3
18,-3,0,18.0,-3.0,0.3545362949371338,100.30453628824571,24,94,-35,1316,766,1121,886,43,13.78
14,-3,0,14.0,-3.0,0.3611612319946289,86.16263691415206,24,80,-32,1316,766,1121,886,43,11.09
11,-2,0,11.0,-2.0,0.3668491840362549,75.23961722390672,24,69,-30,1316,766,1121,886,43,8.45
11,-2,0,11.0,-2.0,0.37499427795410156,64.40496875241847,24,58,-28,1316,766,1121,886,43,7.43
11,-2,0,11.0,-2.0,0.38351917266845703,53.71219600798314,24,47,-26,1316,766,1121,886,43,6.34
8,-2,0,8.0,-2.0,0.39097023010253906,45.79301256742124,24,39,-24,1316,766,1121,886,43,4.99
8,-2,0,8.0,-2.0,0.4024791717529297,38.01315561749642,24,31,-22,1316,766,1121,886,43,4.17
5,-3,0,5.0,-3.0,0.4067802429199219,32.202484376209235,24,26,-19,1316,766,1121,886,43,5.28
3,-2,0,3.0,-2.0,0.41481518745422363,28.600699292150182,24,23,-17,1316,766,1121,886,43,5.39
2,-1,0,2.0,-1.0,0.424821138381958,26.40075756488817,24,21,-16,1316,766,1121,886,43,3.26
1,-1,0,1.0,-1.0,0.4307742118835449,25.0,24,20,-15,1316,766,1121,886,43,3.5
1,-2,0,1.0,-2.0,0.43895721435546875,23.021728866442675,24,19,-13,1316,766,1121,886,43,1.69
1,-1,0,1.0,-1.0,0.44679927825927734,21.633307652783937,24,18,-12,1316,766,1121,886,43,2.96
1,-2,0,1.0,-2.0,0.4548041820526123,19.72308292331602,24,17,-10,1316,766,1121,886,43,1.35
0,-1,0,-0.0,-1.0,0.47171735763549805,19.235384061671343,24,17,-9,1316,766,1121,886,43,0.39
1,0,0,1.0,-0.0,0.47878313064575195,18.35755975068582,24,16,-9,1316,766,1121,886,43,1.52
0,0,1,-0.0,-0.0,0.5158281326293945,18.35755975068582,24,16,-9,1316,766,1121,886,43,32.4
0,0,0,-0.0,-0.0,0.09172892570495605,1204.448421477649,25,-1014,-650,286,125,1300,775,68,228.15
-1,-1,0,-1.0,-1.0,0.1363210678100586,1203.0669141822495,25,-1013,-649,286,125,1300,775,68,7.3
-2,0,0,-2.0,-0.0,0.1437969207763672,1201.3833692872563,25,-1011,-649,286,125,1300,775,68,6.89
-2,0,0,-2.0,-0.0,0.15179991722106934,1199.7007960320773,25,-1009,-649,286,125,1300,775,68,6.88
-2,0,0,-2.0,-0.0,0.1600658893585205,1198.0191985106082,25,-1007,-649,286,125,1300,775,68,6.87
-2,0,0,-2.0,-0.0,0.170396089553833,1196.3385808373814,25,-1005,-649,286,125,1300,775,68,6.87
-3,0,0,-3.0,-0.0,0.17565608024597168,1193.819500594625,25,-1002,-649,286,125,1300,775,68,9.4
-4,0,0,-4.0,-0.0,0.18368887901306152,1190.4641951776625,25,-998,-649,286,125,1300,775,68,11.86
-4,0,0,-4.0,-0.0,0.19907402992248535,1187.112884270068,25,-994,-649,286,125,1300,775,68,11.83
-4,0,0,-4.0,-0.0,0.20122694969177246,1183.7656017979234,25,-990,-649,286,125,1300,775,68,11.8
-3,0,0,-3.0,-0.0,0.20809292793273926,1181.257804207024,25,-987,-649,286,125,1300,775,68,9.3
-5,-2,0,-5.0,-2.0,0.21564292907714844,1175.9817175449625,25,-982,-647,286,125,1300,775,68,18.67
-7,-2,0,-7.0,-2.0,0.22580194473266602,1169.0380661039228,25,-975,-645,286,125,1300,775,68,22.54
-10,-4,0,-10.0,-4.0,0.23232698440551758,1158.492986599401,25,-965,-641,286,125,1300,775,68,31.95
-18,-7,0,-18.0,-7.0,0.24004602432250977,1139.633713085042,25,-947,-634,286,125,1300,775,68,49.3
-24,-10,0,-24.0,-10.0,0.24851298332214355,1114.138680775423,25,-923,-624,286,125,1300,775,68,60.54
-27,-13,0,-27.0,-13.0,0.2557399272918701,1084.4985016126118,25,-896,-611,286,125,1300,775,68,66.43
-31,-16,0,-31.0,-16.0,0.26671409606933594,1049.880945631456,25,-865,-595,286,125,1300,775,68,72.34
-32,-16,0,-32.0,-16.0,0.27165699005126953,1014.4604477257849,25,-833,-579,286,125,1300,775,68,71.81
-32,-16,0,-32.0,-16.0,0.28086304664611816,979.065881337921,25,-801,-563,286,125,1300,775,68,70.3
-31,-16,0,-31.0,-16.0,0.28862905502319336,944.515219570336,25,-770,-547,286,125,1300,775,68,67.91
-29,-15,0,-29.0,-15.0,0.2960829734802246,912.197895195993,25,-741,-532,286,125,1300,775,68,63.77
-26,-15,0,-26.0,-15.0,0.3046259880065918,882.334403726841,25,-715,-517,286,125,1300,775,68,59.9
-26,-14,0,-26.0,-14.0,0.31194090843200684,853.070923194549,25,-689,-503,286,125,1300,775,68,57.61
-23,-14,0,-23.0,-14.0,0.31967687606811523,826.2427004216134,25,-666,-489,286,125,1300,775,68,53.98
-25,-15,0,-25.0,-15.0,0.3278059959411621,797.218288801756,25,-641,-474,286,125,1300,775,68,55.54
-25,-15,0,-25.0,-15.0,0.33980798721313477,768.2037490145436,25,-616,-459,286,125,1300,775,68,54.3
-27,-17,0,-27.0,-17.0,0.3436720371246338,736.4000271591522,25,-589,-442,286,125,1300,775,68,56.43
-28,-16,0,-28.0,-16.0,0.35309290885925293,704.4125211834327,25,-561,-426,286,125,1300,775,68,54.57
-26,-14,0,-26.0,-14.0,0.35975098609924316,675.2547667362297,25,-535,-412,286,125,1300,775,68,49.84
-22,-14,0,-22.0,-14.0,0.367764949798584,649.2865315097796,25,-513,-398,286,125,1300,775,68,45.8
-20,-13,0,-20.0,-13.0,0.37735795974731445,625.518984524051,25,-493,-385,286,125,1300,775,68,42.33
-16,-12,0,-16.0,-12.0,0.38385891914367676,605.5229145127375,25,-477,-373,286,125,1300,775,68,38.5
-14,-12,0,-14.0,-12.0,0.3921639919281006,587.1030573928226,25,-463,-361,286,125,1300,775,68,35.01
-14,-12,0,-14.0,-12.0,0.4011189937591553,568.6844467716696,25,-449,-349,286,125,1300,775,68,34.34
-12,-11,0,-12.0,-11.0,0.4076669216156006,552.4608583420187,25,-437,-338,286,125,1300,775,68,30.32
-11,-10,0,-11.0,-10.0,0.41698193550109863,537.6430042323624,25,-426,-328,286,125,1300,775,68,28.04
-12,-10,0,-12.0,-10.0,0.42389702796936035,522.0344816197489,25,-414,-318,286,125,1300,775,68,29.42
-14,-10,0,-14.0,-10.0,0.43175792694091797,504.8405688927941,25,-400,-308,286,125,1300,775,68,30.91
-14,-9,0,-14.0,-9.0,0.44440507888793945,488.2591524999813,25,-386,-299,286,125,1300,775,68,28.56
-15,-10,0,-15.0,-10.0,0.4482419490814209,470.27864080776624,25,-371,-289,286,125,1300,775,68,29.74
-15,-9,0,-15.0,-9.0,0.45568108558654785,452.91941888154895,25,-356,-280,286,125,1300,775,68,27.72
-15,-11,0,-15.0,-11.0,0.4645810127258301,434.32936810673993,25,-341,-269,286,125,1300,775,68,29.85
-15,-10,0,-15.0,-10.0,0.4721040725708008,416.3616216703936,25,-326,-259,286,125,1300,775,68,27.48
-14,-11,0,-14.0,-11.0,0.48038506507873535,398.5573986265968,25,-312,-248,286,125,1300,775,68,28.99
-15,-11,0,-15.0,-11.0,0.4894280433654785,379.97105152892897,25,-297,-237,286,125,1300,775,68,27.43
-13,-9,0,-13.0,-9.0,0.5002520084381104,364.1977484828812,25,-284,-228,286,125,1300,775,68,23.42
-13,-10,0,-13.0,-10.0,0.5058519840240479,347.80023001717524,25,-271,-218,286,125,1300,775,68,24.66
-12,-9,0,-12.0,-9.0,0.5133559703826904,332.8092546790128,25,-259,-209,286,125,1300,775,68,22.26
-12,-8,0,-12.0,-8.0,0.5232119560241699,318.4493680320311,25,-247,-201,286,125,1300,775,68,19.96
-11,-7,0,-11.0,-7.0,0.5340800285339355,305.50286414369344,25,-236,-194,286,125,1300,775,68,17.87
-11,-8,0,-11.0,-8.0,0.5356979370117188,291.92636057745796,25,-225,-186,286,125,1300,775,68,18.79
-12,-9,0,-12.0,-9.0,0.5436868667602539,276.9440376682625,25,-213,-177,286,125,1300,775,68,19.65
-13,-9,0,-13.0,-9.0,0.5516948699951172,261.19724347703215,25,-200,-168,286,125,1300,775,68,18.81
-14,-9,0,-14.0,-9.0,0.5596780776977539,244.69777277286363,25,-186,-159,286,125,1300,775,68,18.11
-13,-7,0,-13.0,-7.0,0.5676620006561279,230.28894893155424,25,-173,-152,286,125,1300,775,68,15.26
-12,-9,0,-12.0,-9.0,0.5775868892669678,215.3369452741447,25,-161,-143,286,125,1300,775,68,16.32
-12,-8,0,-12.0,-8.0,0.5841860771179199,201.06217943710845,25,-149,-135,286,125,1300,775,68,14.46
-9,-7,0,-9.0,-7.0,0.5916709899902344,189.69449122207,25,-140,-128,286,125,1300,775,68,12.9
-9,-8,0,-9.0,-8.0,0.5999929904937744,177.65415840897168,25,-131,-120,286,125,1300,775,68,14.65
-9,-7,0,-9.0,-7.0,0.6078429222106934,166.29191201017565,25,-122,-113,286,125,1300,775,68,11.88
-7,-8,0,-7.0,-8.0,0.617279052734375,155.72411502397438,25,-115,-105,286,125,1300,775,68,10.66
-8,-7,0,-8.0,-7.0,0.6257739067077637,145.09651959988565,25,-107,-98,286,125,1300,775,68,12.16
-7,-7,0,-7.0,-7.0,0.6419298648834229,135.20724832641184,25,-100,-91,286,125,1300,775,68,10.59
-7,-6,0,-7.0,-6.0,0.6426360607147217,125.99206324209474,25,-93,-85,286,125,1300,775,68,10.35
-7,-7,0,-7.0,-7.0,0.64768385887146,116.10340218959993,25,-86,-78,286,125,1300,775,68,9.81
-8,-6,0,-8.0,-6.0,0.6562979221343994,106.15083607772479,25,-78,-72,286,125,1300,775,68,8.51
-6,-6,0,-6.0,-6.0,0.6640069484710693,97.67292357659824,25,-72,-66,286,125,1300,775,68,8.63
-6,-6,0,-6.0,-6.0,0.6716930866241455,89.19641248391103,25,-66,-60,286,125,1300,775,68,8.21
-6,-5,0,-6.0,-5.0,0.680509090423584,81.39410298049853,25,-60,-55,286,125,1300,775,68,7.69
-4,-5,0,-4.0,-5.0,0.6899878978729248,75.07329751649384,25,-56,-50,286,125,1300,775,68,5.33
-4,-4,0,-4.0,-4.0,0.6958730220794678,69.42621983083913,25,-52,-46,286,125,1300,775,68,6.26
-4,-5,0,-4.0,-5.0,0.7036678791046143,63.12685640834652,25,-48,-41,286,125,1300,775,68,4.76
-3,-5,0,-3.0,-5.0,0.7177729606628418,57.62811813689564,25,-45,-36,286,125,1300,775,68,3.47
-3,-3,0,-3.0,-3.0,0.7198848724365234,53.41348144429457,25,-42,-33,286,125,1300,775,68,4.56
-3,-3,0,-3.0,-3.0,0.7290289402008057,49.20365840057018,25,-39,-30,286,125,1300,775,68,4.33
-1,-3,0,-1.0,-3.0,0.7357759475708008,46.61544808322666,25,-38,-27,286,125,1300,775,68,1.71
-2,-2,0,-2.0,-2.0,0.7436518669128418,43.829214001622255,25,-36,-25,286,125,1300,775,68,3.5
0,0,1,-0.0,-0.0,0.7756819725036621,43.829214001622255,25,-36,-25,286,125,1300,775,68,40.19
0,0,0,-0.0,-0.0,0.06441092491149902,1500.4762577261927,26,1398,545,1720,695,322,150,66,256.78
0,-1,0,-0.0,-1.0,0.07227706909179688,1500.8397649316198,26,1398,546,1720,695,322,150,66,10.52
1,0,0,1.0,-0.0,0.08828210830688477,1499.9083305322363,26,1397,546,1720,695,322,150,66,5.63
1,0,0,1.0,-0.0,0.12024688720703125,1498.9769844797484,26,1396,546,1720,695,322,150,66,5.63
4,0,0,4.0,-0.0,0.12823200225830078,1495.2524870402324,26,1392,546,1720,695,322,150,66,15.46
4,2,0,4.0,2.0,0.13627195358276367,1490.7984437877576,26,1388,544,1720,695,322,150,66,19.75
6,3,0,6.0,3.0,0.14475393295288086,1484.117582942807,26,1382,541,1720,695,322,150,66,26.82
8,4,0,8.0,4.0,0.15230298042297363,1475.2101545203652,26,1374,537,1720,695,322,150,66,33.41
11,6,0,11.0,6.0,0.16026687622070312,1462.781596821617,26,1363,531,1720,695,322,150,66,42.59
14,8,0,14.0,8.0,0.1692640781402588,1446.8344756743945,26,1349,523,1720,695,322,150,66,50.99
15,9,0,15.0,9.0,0.17743587493896484,1429.5985450468254,26,1334,514,1720,695,322,150,66,53.52
16,9,0,16.0,9.0,0.18424296379089355,1411.4350852943965,26,1318,505,1720,695,322,150,66,55.49
18,11,0,18.0,11.0,0.1930859088897705,1390.6962285128984,26,1300,494,1720,695,322,150,66,60.32
21,11,0,21.0,11.0,0.20023488998413086,1367.1612926059602,26,1279,483,1720,695,322,150,66,65.96
22,12,0,22.0,12.0,0.2102220058441162,1342.3449631149215,26,1257,471,1720,695,322,150,66,67.58
24,12,0,24.0,12.0,0.21630311012268066,1315.6633307955344,26,1233,459,1720,695,322,150,66,70.6
27,11,0,27.0,11.0,0.22484707832336426,1286.5224444213945,26,1206,448,1720,695,322,150,66,75.4
30,13,0,30.0,13.0,0.23259401321411133,1253.8743956234214,26,1176,435,1720,695,322,150,66,79.36
30,12,0,30.0,12.0,0.24106693267822266,1221.574803276492,26,1146,423,1720,695,322,150,66,78.47
30,12,0,30.0,12.0,0.25286293029785156,1189.275830074756,26,1116,411,1720,695,322,150,66,77.34
29,13,0,29.0,13.0,0.258436918258667,1157.5720279965303,26,1087,398,1720,695,322,150,66,74.33
30,14,0,30.0,14.0,0.26424598693847656,1124.59103677737,26,1057,384,1720,695,322,150,66,74.75
31,13,0,31.0,13.0,0.2722780704498291,1091.0164985003664,26,1026,371,1720,695,322,150,66,75.01
32,13,0,32.0,13.0,0.2834339141845703,1056.5036677645753,26,994,358,1720,695,322,150,66,75.21
33,13,0,33.0,13.0,0.2882380485534668,1021.0514188815371,26,961,345,1720,695,322,150,66,75.32
34,13,0,34.0,13.0,0.2962319850921631,984.658824161953,26,927,332,1720,695,322,150,66,75.34
35,14,0,35.0,14.0,0.30591893196105957,946.9889122898958,26,892,318,1720,695,322,150,66,74.68
35,14,0,35.0,14.0,0.3123009204864502,909.3211753830436,26,857,304,1720,695,322,150,66,72.95
37,14,0,37.0,14.0,0.32036709785461426,869.7700845625814,26,820,290,1720,695,322,150,66,73.8
38,14,0,38.0,14.0,0.32985901832580566,829.2767933567176,26,782,276,1720,695,322,150,66,73.2
41,14,0,41.0,14.0,0.3406369686126709,785.9548333078689,26,741,262,1720,695,322,150,66,73.92
41,14,0,41.0,14.0,0.34458494186401367,742.6331530439508,26,700,248,1720,695,322,150,66,71.51
41,12,0,41.0,12.0,0.35596394538879395,699.9835712357826,26,659,236,1720,695,322,150,66,66.89
40,13,0,40.0,13.0,0.36026692390441895,657.943766594076,26,619,223,1720,695,322,150,66,64.64
37,11,0,37.0,11.0,0.3683500289916992,619.409396118593,26,582,212,1720,695,322,150,66,58.6
34,11,0,34.0,11.0,0.37662792205810547,583.6994089426508,26,548,201,1720,695,322,150,66,54.56
31,10,0,31.0,10.0,0.38425207138061523,551.1533361960172,26,517,191,1720,695,322,150,66,49.78
26,8,0,26.0,8.0,0.3922278881072998,523.9942747778834,26,491,183,1720,695,322,150,66,42.81
24,7,0,24.0,7.0,0.40027594566345215,499.06412413636787,26,467,176,1720,695,322,150,66,39.02
21,7,0,21.0,7.0,0.40828990936279297,476.94548954780987,26,446,169,1720,695,322,150,66,35.85
20,6,0,20.0,6.0,0.41674208641052246,456.11950188519677,26,426,163,1720,695,322,150,66,32.87
18,5,0,18.0,5.0,0.42595791816711426,437.52485643675146,26,408,158,1720,695,322,150,66,29.36
16,5,0,16.0,5.0,0.4328010082244873,420.8004277564366,26,392,153,1720,695,322,150,66,27.13
14,5,0,14.0,5.0,0.4418039321899414,405.94088239545425,26,378,148,1720,695,322,150,66,25.45
14,5,0,14.0,5.0,0.44832396507263184,391.0818328687744,26,364,143,1720,695,322,150,66,24.88
13,5,0,13.0,5.0,0.4562489986419678,377.1538147758816,26,351,138,1720,695,322,150,66,24.49
12,5,0,12.0,5.0,0.4650449752807617,364.156559737704,26,339,133,1720,695,322,150,66,22.32
10,4,0,10.0,4.0,0.47808098793029785,353.3864739912947,26,329,129,1720,695,322,150,66,20.28
10,5,0,10.0,5.0,0.48366808891296387,342.2528305215313,26,319,124,1720,695,322,150,66,17.98
10,4,0,10.0,4.0,0.4887409210205078,331.48303123991127,26,309,120,1720,695,322,150,66,19.44
10,5,0,10.0,5.0,0.4972050189971924,320.35293037523473,26,299,115,1720,695,322,150,66,17.25
10,4,0,10.0,4.0,0.5059330463409424,309.58359129643804,26,289,111,1720,695,322,150,66,18.57
12,4,0,12.0,4.0,0.5122880935668945,296.94780686174465,26,277,107,1720,695,322,150,66,18.81
11,4,0,11.0,4.0,0.5202369689941406,285.24550829066527,26,266,103,1720,695,322,150,66,18.37
11,2,0,11.0,2.0,0.528296947479248,274.2735860413831,26,255,101,1720,695,322,150,66,14.67
10,3,0,10.0,3.0,0.5388519763946533,263.8730755495907,26,245,98,1720,695,322,150,66,14.86
11,3,0,11.0,3.0,0.5442860126495361,252.54900514553606,26,234,95,1720,695,322,150,66,14.91
10,4,0,10.0,4.0,0.5522580146789551,241.7788245483876,26,224,91,1720,695,322,150,66,16.95
11,3,0,11.0,3.0,0.5621469020843506,230.46257830719503,26,213,88,1720,695,322,150,66,14.05
9,3,0,9.0,3.0,0.5683488845825195,221.0,26,204,85,1720,695,322,150,66,12.95
8,3,0,8.0,3.0,0.5764000415802002,212.46176126540982,26,196,82,1720,695,322,150,66,12.72
7,2,0,7.0,2.0,0.5879631042480469,205.23401277566055,26,189,80,1720,695,322,150,66,10.05
5,2,0,5.0,2.0,0.5939149856567383,199.8499437077729,26,184,78,1720,695,322,150,66,10.41
4,1,0,4.0,1.0,0.6003060340881348,195.77793542685038,26,180,77,1720,695,322,150,66,6.92
1,1,0,1.0,1.0,0.6082561016082764,194.4659353203023,26,179,76,1720,695,322,150,66,3.32
1,0,0,1.0,-0.0,0.6163389682769775,193.54586019855861,26,178,76,1720,695,322,150,66,2.89
1,0,0,1.0,-0.0,0.6257679462432861,192.62658175859323,26,177,76,1720,695,322,150,66,2.88
2,1,0,2.0,1.0,0.6322989463806152,190.3943276465977,26,175,75,1720,695,322,150,66,6.52
5,2,0,5.0,2.0,0.6403090953826904,185.0108104949546,26,170,73,1720,695,322,150,66,9.93
5,2,0,5.0,2.0,0.6557209491729736,179.62739212046696,26,165,71,1720,695,322,150,66,9.79
7,2,0,7.0,2.0,0.6564309597015381,172.40939649566667,26,158,69,1720,695,322,150,66,9.05
7,3,0,7.0,3.0,0.6652379035949707,164.7938105633825,26,151,66,1720,695,322,150,66,12.0
7,3,0,7.0,3.0,0.6760261058807373,157.17824276915684,26,144,63,1720,695,322,150,66,11.76
8,2,0,8.0,2.0,0.6820080280303955,149.05368160498418,26,136,61,1720,695,322,150,66,8.57
7,4,0,7.0,4.0,0.6897909641265869,141.0319112825179,26,129,57,1720,695,322,150,66,8.96
7,3,0,7.0,3.0,0.6963610649108887,133.41664064126334,26,122,54,1720,695,322,150,66,10.78
8,4,0,8.0,4.0,0.7043271064758301,124.48293055676348,26,114,50,1720,695,322,150,66,9.78
8,4,0,8.0,4.0,0.7123188972473145,115.55085460523432,26,106,46,1720,695,322,150,66,9.36
10,4,0,10.0,4.0,0.7203989028930664,104.78549517943789,26,96,42,1720,695,322,150,66,10.36
8,3,0,8.0,3.0,0.7290329933166504,96.25487000666512,26,88,39,1720,695,322,150,66,8.37
9,5,0,9.0,5.0,0.7389819622039795,86.00581375697809,26,79,34,1720,695,322,150,66,7.89
9,4,0,9.0,4.0,0.7448680400848389,76.15773105863909,26,70,30,1720,695,322,150,66,9.62
8,3,0,8.0,3.0,0.7522540092468262,67.62396025078685,26,62,27,1720,695,322,150,66,7.36
6,3,0,6.0,3.0,0.7602629661560059,60.92618484691127,26,56,24,1720,695,322,150,66,6.41
6,2,0,6.0,2.0,0.7702090740203857,54.62600113499065,26,50,22,1720,695,322,150,66,5.49
6,2,0,6.0,2.0,0.7805850505828857,48.33218389437829,26,44,20,1720,695,322,150,66,5.08
5,2,0,5.0,2.0,0.7893350124359131,42.95346318982906,26,39,18,1720,695,322,150,66,5.6
4,1,0,4.0,1.0,0.792435884475708,38.91015291668744,26,35,17,1720,695,322,150,66,3.39
4,2,0,4.0,2.0,0.803459882736206,34.438350715445125,26,31,15,1720,695,322,150,66,6.63
5,2,0,5.0,2.0,0.8089730739593506,29.068883707497267,26,26,13,1720,695,322,150,66,4.44
5,2,0,5.0,2.0,0.8162760734558105,23.706539182259394,26,21,11,1720,695,322,150,66,3.9
5,2,0,5.0,2.0,0.8255820274353027,18.35755975068582,26,16,9,1720,695,322,150,66,3.24
4,2,0,4.0,2.0,0.8347930908203125,13.892443989449804,26,12,7,1720,695,322,150,66,3.88
4,2,0,4.0,2.0,0.8412890434265137,9.433981132056603,26,8,5,1720,695,322,150,66,3.0
2,2,0,2.0,2.0,0.8489489555358887,6.708203932499369,26,6,3,1720,695,322,150,66,1.03
1,0,0,1.0,-0.0,0.8585250377655029,5.830951894845301,26,5,3,1720,695,322,150,66,0.64
1,0,0,1.0,-0.0,0.8644120693206787,5.0,26,4,3,1720,695,322,150,66,0.28
0,0,1,-0.0,-0.0,0.8662219047546387,5.0,26,4,3,1720,695,322,150,66,28.4
-1,0,1,-1.0,-0.0,0.09214663505554199,984.9639587314857,27,-977,125,738,817,1716,692,2,68.96
0,0,0,-0.0,-0.0,0.09737873077392578,984.9639587314857,27,-977,125,738,817,1716,692,2,203.86
-1,0,0,-1.0,-0.0,0.10200166702270508,983.9720524486455,27,-976,125,738,817,1716,692,2,68.92
-2,0,0,-2.0,-0.0,0.10947465896606445,981.9882891358735,27,-974,125,738,817,1716,692,2,101.6
-1,0,0,-1.0,-0.0,0.11623167991638184,980.9964322055407,27,-973,125,738,817,1716,692,2,68.8
-3,0,0,-3.0,-0.0,0.1304798126220703,978.0209609205725,27,-970,125,738,817,1716,692,2,121.0
-4,0,0,-4.0,-0.0,0.13323378562927246,974.0538999459937,27,-966,125,738,817,1716,692,2,133.79
-5,0,0,-5.0,-0.0,0.14026570320129395,969.0954545347945,27,-961,125,738,817,1716,692,2,142.71
-6,0,0,-6.0,-0.0,0.1537337303161621,963.1458871842832,27,-955,125,738,817,1716,692,2,149.15
-8,0,0,-8.0,-0.0,0.15617060661315918,955.2141121235594,27,-947,125,738,817,1716,692,2,158.13
-10,0,0,-10.0,-0.0,0.16745662689208984,945.3010102607528,27,-937,125,738,817,1716,692,2,163.59
-15,-1,0,-15.0,-1.0,0.17229175567626953,930.5697179685142,27,-922,126,738,817,1716,692,2,170.7
-15,-1,0,-15.0,-1.0,0.18017983436584473,915.848240703666,27,-907,127,738,817,1716,692,2,169.08
-16,-2,0,-16.0,-2.0,0.18949270248413086,900.2899532928267,27,-891,129,738,817,1716,692,2,168.07
-17,-2,0,-17.0,-2.0,0.19774675369262695,883.7629772738842,27,-874,131,738,817,1716,692,2,167.33
-19,-4,0,-19.0,-4.0,0.2041306495666504,865.5922827752105,27,-855,135,738,817,1716,692,2,166.42
-22,-3,0,-22.0,-3.0,0.21222281455993652,844.353598914578,27,-833,138,738,817,1716,692,2,166.55
-20,-3,0,-20.0,-3.0,0.2230396270751953,825.136352368504,27,-813,141,738,817,1716,692,2,162.73
-21,-3,0,-21.0,-3.0,0.22812676429748535,804.9844718999243,27,-792,144,738,817,1716,692,2,160.99
-20,-1,0,-20.0,-1.0,0.24048280715942383,785.4992043280503,27,-772,145,738,817,1716,692,2,158.57
-19,-1,0,-19.0,-1.0,0.24436473846435547,767.0234676983489,27,-753,146,738,817,1716,692,2,155.47
-19,0,0,-19.0,-0.0,0.2567558288574219,748.3795828321347,27,-734,146,738,817,1716,692,2,153.57
-19,0,0,-19.0,-0.0,0.26073265075683594,729.7540681626928,27,-715,146,738,817,1716,692,2,151.17
-18,0,0,-18.0,-0.0,0.26816582679748535,712.1270953980055,27,-697,146,738,817,1716,692,2,148.08
-19,2,0,-19.0,2.0,0.27616381645202637,693.1233656427981,27,-678,144,738,817,1716,692,2,147.57
-19,3,0,-19.0,3.0,0.28641271591186523,673.9154249607291,27,-659,141,738,817,1716,692,2,145.96
-18,2,0,-18.0,2.0,0.30255675315856934,655.8978579016706,27,-641,139,738,817,1716,692,2,141.91
-21,4,0,-21.0,4.0,0.30269575119018555,634.5273831758564,27,-620,135,738,817,1716,692,2,142.66
-22,4,0,-22.0,4.0,0.30865979194641113,612.1805289291714,27,-598,131,738,817,1716,692,2,139.69
-22,5,0,-22.0,5.0,0.31616878509521484,589.6202167497312,27,-576,126,738,817,1716,692,2,137.75
-23,6,0,-23.0,6.0,0.32565879821777344,565.870126442455,27,-553,120,738,817,1716,692,2,133.39
-22,6,0,-22.0,6.0,0.33295679092407227,543.0994384088424,27,-531,114,738,817,1716,692,2,129.23
-23,6,0,-23.0,6.0,0.34032273292541504,519.353444197687,27,-508,108,738,817,1716,692,2,126.17
-23,7,0,-23.0,7.0,0.3484077453613281,495.40488491737744,27,-485,101,738,817,1716,692,2,121.63
-26,7,0,-26.0,7.0,0.35640883445739746,468.52641334294054,27,-459,94,738,817,1716,692,2,118.66
-25,6,0,-25.0,6.0,0.3681917190551758,442.83179650969055,27,-434,88,738,817,1716,692,2,114.62
-25,5,0,-25.0,5.0,0.37224864959716797,417.3367944478416,27,-409,83,738,817,1716,692,2,111.88
-26,5,0,-26.0,5.0,0.3801727294921875,390.86186818363336,27,-383,78,738,817,1716,692,2,106.8
-26,3,0,-26.0,3.0,0.3882637023925781,364.7930920398576,27,-357,75,738,817,1716,692,2,99.68
-24,4,0,-24.0,4.0,0.3975696563720703,340.4849482723135,27,-333,71,738,817,1716,692,2,95.53
-20,3,0,-20.0,3.0,0.4048476219177246,320.30142054009065,27,-313,68,738,817,1716,692,2,89.92
-18,3,0,-18.0,3.0,0.4123866558074951,302.0761493398643,27,-295,65,738,817,1716,692,2,85.89
-15,3,0,-15.0,3.0,0.4205026626586914,286.7821472825671,27,-280,62,738,817,1716,692,2,82.44
-12,2,0,-12.0,2.0,0.42832064628601074,274.63430230034993,27,-268,60,738,817,1716,692,2,76.9
-11,2,0,-11.0,2.0,0.43646764755249023,263.46346995361614,27,-257,58,738,817,1716,692,2,74.2
-11,1,0,-11.0,1.0,0.45049166679382324,252.5173261382276,27,-246,57,738,817,1716,692,2,70.41
-12,2,0,-12.0,2.0,0.45341968536376953,240.3767875648562,27,-234,55,738,817,1716,692,2,69.91
-11,2,0,-11.0,2.0,0.46027660369873047,229.21169254643183,27,-223,53,738,817,1716,692,2,67.13
-13,1,0,-13.0,1.0,0.4681737422943115,216.34232133357543,27,-210,52,738,817,1716,692,2,64.22
-12,2,0,-12.0,2.0,0.47617578506469727,204.215572373901,27,-198,50,738,817,1716,692,2,62.1
-11,1,0,-11.0,1.0,0.48634862899780273,193.31321734428818,27,-187,49,738,817,1716,692,2,57.99
-10,2,0,-10.0,2.0,0.4954078197479248,183.13383084509536,27,-177,47,738,817,1716,692,2,56.51
-9,1,0,-9.0,1.0,0.5009307861328125,174.18381095842403,27,-168,46,738,817,1716,692,2,52.32
-9,1,0,-9.0,1.0,0.5081536769866943,165.24527224704494,27,-159,45,738,817,1716,692,2,50.32
-10,2,0,-10.0,2.0,0.5161716938018799,155.08062419270823,27,-149,43,738,817,1716,692,2,49.97
-9,2,0,-9.0,2.0,0.5241377353668213,145.8800877433243,27,-140,41,738,817,1716,692,2,47.47
-9,1,0,-9.0,1.0,0.5321288108825684,136.97079980784227,27,-131,40,738,817,1716,692,2,43.88
-7,1,0,-7.0,1.0,0.5408487319946289,129.98846102635417,27,-124,39,738,817,1716,692,2,40.66
-6,1,0,-6.0,1.0,0.5481727123260498,123.96773773849388,27,-118,38,738,817,1716,692,2,38.29
-5,1,0,-5.0,1.0,0.56148362159729,118.90332207301863,27,-113,37,738,817,1716,692,2,36.01
-5,1,0,-5.0,1.0,0.5642266273498535,113.84199576606166,27,-108,36,738,817,1716,692,2,34.91
-4,1,0,-4.0,1.0,0.5721676349639893,109.73149046650191,27,-104,35,738,817,1716,692,2,32.8
-4,1,0,-4.0,1.0,0.5802347660064697,105.62196741208714,27,-100,34,738,817,1716,692,2,31.95
-4,1,0,-4.0,1.0,0.5882787704467773,101.51354589413178,27,-96,33,738,817,1716,692,2,31.1
-5,1,0,-5.0,1.0,0.6045346260070801,96.46242791885346,27,-91,32,738,817,1716,692,2,31.11
-6,2,0,-6.0,2.0,0.6047217845916748,90.13878188659973,27,-85,30,738,817,1716,692,2,33.7
-5,1,0,-5.0,1.0,0.6125507354736328,85.09406559801923,27,-80,29,738,817,1716,692,2,28.58
-4,1,0,-4.0,1.0,0.6201746463775635,80.99382692526635,27,-76,28,738,817,1716,692,2,26.69
-4,1,0,-4.0,1.0,0.6281607151031494,76.89603370785778,27,-72,27,738,817,1716,692,2,25.78
-5,1,0,-5.0,1.0,0.6361837387084961,71.8679344353238,27,-67,26,738,817,1716,692,2,25.49
-4,1,0,-4.0,1.0,0.6447217464447021,67.77905281132217,27,-63,25,738,817,1716,692,2,23.68
-4,1,0,-4.0,1.0,0.6521916389465332,63.694583757176716,27,-59,24,738,817,1716,692,2,22.74
-4,2,0,-4.0,2.0,0.6611497402191162,59.23681287847955,27,-55,22,738,817,1716,692,2,23.0
-5,1,0,-5.0,1.0,0.6764216423034668,54.230987451824994,27,-50,21,738,817,1716,692,2,21.32
-4,2,0,-4.0,2.0,0.6765506267547607,49.76946855251722,27,-46,19,738,817,1716,692,2,21.12
-4,1,0,-4.0,1.0,0.6866316795349121,45.69463863518345,27,-42,18,738,817,1716,692,2,18.73
-4,1,0,-4.0,1.0,0.693422794342041,41.6293165929973,27,-38,17,738,817,1716,692,2,17.71
-4,2,0,-4.0,2.0,0.7077517509460449,37.16180835212409,27,-34,15,738,817,1716,692,2,18.81
-4,1,0,-4.0,1.0,0.7082548141479492,33.1058907144937,27,-30,14,738,817,1716,692,2,15.7
-4,2,0,-4.0,2.0,0.7172996997833252,28.635642126552707,27,-26,12,738,817,1716,692,2,17.38
-4,2,0,-4.0,2.0,0.7258427143096924,24.166091947189145,27,-22,10,738,817,1716,692,2,16.14
-3,1,0,-3.0,1.0,0.7322826385498047,21.02379604162864,27,-19,9,738,817,1716,692,2,12.77
-3,2,0,-3.0,2.0,0.7401466369628906,17.46424919657298,27,-16,7,738,817,1716,692,2,11.83
-3,2,0,-3.0,2.0,0.7487888336181641,13.92838827718412,27,-13,5,738,817,1716,692,2,10.64
-1,1,0,-1.0,1.0,0.756159782409668,12.649110640673518,27,-12,4,738,817,1716,692,2,6.45
-2,1,0,-2.0,1.0,0.7691397666931152,10.44030650891055,27,-10,3,738,817,1716,692,2,8.93
-1,1,0,-1.0,1.0,0.7780036926269531,9.219544457292887,27,-9,2,738,817,1716,692,2,5.42
-2,1,0,-2.0,1.0,0.7806136608123779,7.0710678118654755,27,-7,1,738,817,1716,692,2,7.16
-1,2,0,-1.0,2.0,0.78971266746521,6.082762530298219,27,-6,-1,738,817,1716,692,2,2.78
-1,1,0,-1.0,1.0,0.796149730682373,5.385164807134504,27,-5,-2,738,817,1716,692,2,2.23
-2,1,0,-2.0,1.0,0.8042886257171631,4.242640687119285,27,-3,-3,738,817,1716,692,2,2.7
-1,1,0,-1.0,1.0,0.8121786117553711,4.47213595499958,27,-2,-4,738,817,1716,692,2,6.49
-1,2,0,-1.0,2.0,0.820894718170166,6.082762530298219,27,-1,-6,738,817,1716,692,2,1.69
-1,0,0,-1.0,-0.0,0.8317666053771973,6.0,27,0,-6,738,817,1716,692,2,-0.34
0,1,0,-0.0,1.0,0.8405616283416748,7.0,27,0,-7,738,817,1716,692,2,10.76
-1,0,0,-1.0,-0.0,0.8643877506256104,7.0710678118654755,27,1,-7,738,817,1716,692,2,10.04
0,1,0,-0.0,1.0,0.9060187339782715,8.06225774829855,27,1,-8,738,817,1716,692,2,6.63
-1,0,0,-1.0,-0.0,0.908585786819458,8.246211251235321,27,2,-8,738,817,1716,692,2,8.68
-1,0,0,-1.0,-0.0,0.9645247459411621,8.54400374531753,27,3,-8,738,817,1716,692,2,7.52
-1,0,0,-1.0,-0.0,0.9730727672576904,8.94427190999916,27,4,-8,738,817,1716,692,2,6.79
-2,0,0,-2.0,-0.0,0.9805407524108887,10.0,27,6,-8,738,817,1716,692,2,3.51
-1,0,0,-1.0,-0.0,0.9915037155151367,10.63014581273465,27,7,-8,738,817,1716,692,2,5.98
-2,0,0,-2.0,-0.0,0.9961767196655273,12.041594578792296,27,9,-8,738,817,1716,692,2,3.34
-1,0,0,-1.0,-0.0,1.0041377544403076,12.806248474865697,27,10,-8,738,817,1716,692,2,6.03
-2,0,0,-2.0,-0.0,1.0121498107910156,14.422205101855956,27,12,-8,738,817,1716,692,2,3.6
0,-1,0,-0.0,-1.0,1.0361297130584717,13.892443989449804,27,12,-7,738,817,1716,692,2,3.14
0,-1,0,-0.0,-1.0,1.0528948307037354,13.416407864998739,27,12,-6,738,817,1716,692,2,2.78
0,-2,0,-0.0,-2.0,1.0603487491607666,12.649110640673518,27,12,-4,738,817,1716,692,2,3.35
1,-1,0,1.0,-1.0,1.0702698230743408,11.40175425099138,27,11,-3,738,817,1716,692,2,6.0
1,-2,0,1.0,-2.0,1.0783867835998535,10.04987562112089,27,10,-1,738,817,1716,692,2,4.81
1,-1,0,1.0,-1.0,1.084136724472046,9.0,27,9,0,738,817,1716,692,2,4.49
1,-1,0,1.0,-1.0,1.0936086177825928,8.06225774829855,27,8,1,738,817,1716,692,2,3.81
1,-1,0,1.0,-1.0,1.1001667976379395,7.280109889280518,27,7,2,738,817,1716,692,2,2.99
1,0,0,1.0,-0.0,1.124152660369873,6.324555320336759,27,6,2,738,817,1716,692,2,5.18
1,-1,0,1.0,-1.0,1.1321687698364258,5.830951894845301,27,5,3,738,817,1716,692,2,1.45
1,0,0,1.0,-0.0,1.148169755935669,5.0,27,4,3,738,817,1716,692,2,3.59
0,0,1,-0.0,-0.0,1.1526336669921875,5.0,27,4,3,738,817,1716,692,2,18.4
1,0,1,1.0,-0.0,1.156296730041504,4.242640687119285,27,3,3,738,817,1716,692,2,2.91
2,0,1,2.0,-0.0,1.1658897399902344,3.1622776601683795,27,1,3,738,817,1716,692,2,2.29
1,0,1,1.0,-0.0,1.1721746921539307,3.0,27,0,3,738,817,1716,692,2,-0.52
1,0,1,1.0,-0.0,1.1804516315460205,3.1622776601683795,27,-1,3,738,817,1716,692,2,7.0
1,0,1,1.0,-0.0,1.1881628036499023,3.605551275463989,27,-2,3,738,817,1716,692,2,4.84
1,0,1,1.0,-0.0,1.1996796131134033,4.242640687119285,27,-3,3,738,817,1716,692,2,4.3
1,0,1,1.0,-0.0,1.2214946746826172,5.0,27,-4,3,738,817,1716,692,2,4.33
1,0,1,1.0,-0.0,1.236156702041626,5.830951894845301,27,-5,3,738,817,1716,692,2,4.55
0,0,0,-0.0,-0.0,1.3011868000030518,5.830951894845301,27,-5,3,738,817,1716,692,2,18.64
0,1,0,-0.0,1.0,1.4215936660766602,5.385164807134504,27,-5,2,738,817,1716,692,2,1.56
-1,1,0,-1.0,1.0,1.4338016510009766,4.123105625617661,27,-4,1,738,817,1716,692,2,4.42
-1,1,0,-1.0,1.0,1.440178632736206,3.0,27,-3,0,738,817,1716,692,2,3.23
-1,1,0,-1.0,1.0,1.452178716659546,2.23606797749979,27,-2,-1,738,817,1716,692,2,1.38
-1,0,0,-1.0,-0.0,1.5001776218414307,1.4142135623730951,27,-1,-1,738,817,1716,692,2,2.03
-1,0,0,-1.0,-0.0,1.508314609527588,1.0,27,0,-1,738,817,1716,692,2,-0.5
-1,1,0,-1.0,1.0,1.5243017673492432,2.23606797749979,27,1,-2,738,817,1716,692,2,1.51
-1,0,0,-1.0,-0.0,1.5321686267852783,2.8284271247461903,27,2,-2,738,817,1716,692,2,3.77
-1,0,0,-1.0,-0.0,1.5602576732635498,3.605551275463989,27,3,-2,738,817,1716,692,2,3.77
0,0,1,-0.0,-0.0,1.5881767272949219,3.605551275463989,27,3,-2,738,817,1716,692,2,17.99
0,0,0,-0.0,-0.0,1.7151868343353271,3.605551275463989,27,3,-2,738,817,1716,692,2,17.99
1,0,0,1.0,-0.0,1.7729778289794922,2.8284271247461903,27,2,-2,738,817,1716,692,2,2.55
1,0,0,1.0,-0.0,1.7881507873535156,2.23606797749979,27,1,-2,738,817,1716,692,2,1.3
1,0,0,1.0,-0.0,1.8042566776275635,2.0,27,0,-2,738,817,1716,692,2,-0.58
1,-1,0,1.0,-1.0,1.8281466960906982,1.4142135623730951,27,-1,-1,738,817,1716,692,2,0.11
0,0,1,-0.0,-0.0,1.9191687107086182,1.4142135623730951,27,-1,-1,738,817,1716,692,2,27.34
0,0,0,-0.0,-0.0,0.12792229652404785,325.59176893772974,28,283,161,1022,979,739,818,10,102.3
1,0,0,1.0,-0.0,0.2799861431121826,324.7229588433808,28,282,161,1022,979,739,818,10,9.3
4,0,0,4.0,-0.0,0.2879641056060791,321.2553501500014,28,278,161,1022,979,739,818,10,25.94
4,1,0,4.0,1.0,0.297640323638916,317.29481558953967,28,274,160,1022,979,739,818,10,29.03
5,2,0,5.0,2.0,0.30405426025390625,311.96954979612997,28,269,158,1022,979,739,818,10,35.43
4,2,0,4.0,2.0,0.3120861053466797,307.50772348024043,28,265,156,1022,979,739,818,10,32.54
5,3,0,5.0,3.0,0.319932222366333,301.6769795658926,28,260,153,1022,979,739,818,10,39.35
6,3,0,6.0,3.0,0.32787132263183594,294.98474536829866,28,254,150,1022,979,739,818,10,39.84
8,3,0,8.0,3.0,0.33646726608276367,286.574597618142,28,246,147,1022,979,739,818,10,42.71
11,7,0,11.0,7.0,0.3473942279815674,273.5415873317986,28,235,140,1022,979,739,818,10,52.64
11,6,0,11.0,6.0,0.35187530517578125,261.02107194630855,28,224,134,1022,979,739,818,10,49.92
13,6,0,13.0,6.0,0.36016321182250977,246.78938388836744,28,211,128,1022,979,739,818,10,49.22
14,8,0,14.0,8.0,0.3695182800292969,230.6707610426601,28,197,120,1022,979,739,818,10,50.8
13,7,0,13.0,7.0,0.37728118896484375,215.92822881689185,28,184,113,1022,979,739,818,10,46.32
14,7,0,14.0,7.0,0.38402724266052246,200.33971149025845,28,170,106,1022,979,739,818,10,44.25
12,6,0,12.0,6.0,0.392620325088501,186.98663053812163,28,158,100,1022,979,739,818,10,39.77
12,6,0,12.0,6.0,0.402996301651001,173.64331256918592,28,146,94,1022,979,739,818,10,37.68
11,7,0,11.0,7.0,0.40787529945373535,160.60510577189007,28,135,87,1022,979,739,818,10,38.27
12,5,0,12.0,5.0,0.41698431968688965,147.82760229402356,28,123,82,1022,979,739,818,10,32.38
10,5,0,10.0,5.0,0.42386627197265625,136.74063039199433,28,113,77,1022,979,739,818,10,29.45
8,4,0,8.0,4.0,0.4333322048187256,127.88275880665071,28,105,73,1022,979,739,818,10,25.45
6,2,0,6.0,2.0,0.4399881362915039,121.82774724995944,28,99,71,1022,979,739,818,10,19.49
4,2,0,4.0,2.0,0.45117926597595215,117.41379816699569,28,95,69,1022,979,739,818,10,16.74
5,2,0,5.0,2.0,0.4559612274169922,112.2007130102122,28,90,67,1022,979,739,818,10,17.19
5,2,0,5.0,2.0,0.46385812759399414,107.00467279516349,28,85,65,1022,979,739,818,10,16.57
4,1,0,4.0,1.0,0.47223424911499023,103.23274674249446,28,81,64,1022,979,739,818,10,12.87
3,2,0,3.0,2.0,0.48008227348327637,99.6393496566492,28,78,62,1022,979,739,818,10,14.4
3,1,0,3.0,1.0,0.48788928985595703,96.67471230885562,28,75,61,1022,979,739,818,10,10.86
2,2,0,2.0,2.0,0.49587321281433105,93.86160024205851,28,73,59,1022,979,739,818,10,11.99
3,1,0,3.0,1.0,0.503920316696167,90.9065454189081,28,70,58,1022,979,739,818,10,10.4
4,2,0,4.0,2.0,0.5130043029785156,86.55634003352961,28,66,56,1022,979,739,818,10,13.29
1,1,0,1.0,1.0,0.5201942920684814,85.14693182963201,28,65,55,1022,979,739,818,10,8.39
2,1,0,2.0,1.0,0.5288631916046143,82.97590011563598,28,63,54,1022,979,739,818,10,8.75
1,1,0,1.0,1.0,0.5441262722015381,81.5659242576212,28,62,53,1022,979,739,818,10,8.33
1,1,0,1.0,1.0,0.5519101619720459,80.15609770940699,28,61,52,1022,979,739,818,10,8.26
2,1,0,2.0,1.0,0.5598583221435547,77.98717843338096,28,59,51,1022,979,739,818,10,8.44
1,1,0,1.0,1.0,0.569878101348877,76.57675887630658,28,58,50,1022,979,739,818,10,8.21
1,1,0,1.0,1.0,0.5765132904052734,75.16648189186454,28,57,49,1022,979,739,818,10,8.13
2,2,0,2.0,2.0,0.5838751792907715,72.34638899074369,28,55,47,1022,979,739,818,10,10.91
2,0,0,2.0,-0.0,0.5918653011322021,70.83784299369935,28,53,47,1022,979,739,818,10,5.1
1,2,0,1.0,2.0,0.6012561321258545,68.76772498781678,28,52,45,1022,979,739,818,10,7.08
2,0,0,2.0,-0.0,0.6079223155975342,67.26812023536856,28,50,45,1022,979,739,818,10,4.91
1,2,0,1.0,2.0,0.6158392429351807,65.19202405202648,28,49,43,1022,979,739,818,10,6.92
2,1,0,2.0,1.0,0.6277363300323486,63.0317380372777,28,47,42,1022,979,739,818,10,7.48
2,1,0,2.0,1.0,0.631925106048584,60.876925020897694,28,45,41,1022,979,739,818,10,7.29
2,1,0,2.0,1.0,0.6453943252563477,58.728187440104094,28,43,40,1022,979,739,818,10,7.11
1,2,0,1.0,2.0,0.6484701633453369,56.639209034025185,28,42,38,1022,979,739,818,10,6.51
1,1,0,1.0,1.0,0.664114236831665,55.226805085936306,28,41,37,1022,979,739,818,10,7.79
2,1,0,2.0,1.0,0.6642851829528809,53.075418038862395,28,39,36,1022,979,739,818,10,6.79
1,1,0,1.0,1.0,0.6718921661376953,51.66236541235796,28,38,35,1022,979,739,818,10,7.88
1,1,0,1.0,1.0,0.6826910972595215,50.24937810560445,28,37,34,1022,979,739,818,10,7.8
1,2,0,1.0,2.0,0.688521146774292,48.16637831516918,28,36,32,1022,979,739,818,10,5.96
1,2,0,1.0,2.0,0.6989121437072754,46.09772228646444,28,35,30,1022,979,739,818,10,5.75
2,1,0,2.0,1.0,0.7075541019439697,43.93176527297759,28,33,29,1022,979,739,818,10,6.37
1,2,0,1.0,2.0,0.7120192050933838,41.86884283091664,28,32,27,1022,979,739,818,10,5.45
2,1,0,2.0,1.0,0.7201051712036133,39.698866482558415,28,30,26,1022,979,739,818,10,6.15
1,2,0,1.0,2.0,0.7279322147369385,37.64306044943742,28,29,24,1022,979,739,818,10,5.14
2,1,0,2.0,1.0,0.7358481884002686,35.4682957019364,28,27,23,1022,979,739,818,10,5.92
2,2,0,2.0,2.0,0.7444851398468018,32.64965543462902,28,25,21,1022,979,739,818,10,7.82
1,1,0,1.0,1.0,0.7528202533721924,31.240998703626616,28,24,20,1022,979,739,818,10,6.04
2,1,0,2.0,1.0,0.7607862949371338,29.068883707497267,28,22,19,1022,979,739,818,10,5.43
2,1,0,2.0,1.0,0.7680063247680664,26.90724809414742,28,20,18,1022,979,739,818,10,5.15
1,1,0,1.0,1.0,0.7788102626800537,25.495097567963924,28,19,17,1022,979,739,818,10,6.36
2,2,0,2.0,2.0,0.7838551998138428,22.67156809750927,28,17,15,1022,979,739,818,10,7.38
1,1,0,1.0,1.0,0.7941162586212158,21.2602916254693,28,16,14,1022,979,739,818,10,5.9
1,1,0,1.0,1.0,0.799950122833252,19.849433241279208,28,15,13,1022,979,739,818,10,5.74
1,0,0,1.0,-0.0,0.8081502914428711,19.1049731745428,28,14,13,1022,979,739,818,10,1.81
1,1,0,1.0,1.0,0.8161401748657227,17.69180601295413,28,13,12,1022,979,739,818,10,6.3
0,1,0,-0.0,1.0,0.823986291885376,17.029386365926403,28,13,11,1022,979,739,818,10,1.41
1,0,0,1.0,-0.0,0.8318982124328613,16.278820596099706,28,12,11,1022,979,739,818,10,1.7
1,1,0,1.0,1.0,0.8478522300720215,14.866068747318506,28,11,10,1022,979,739,818,10,5.91
0,1,0,-0.0,1.0,0.8559491634368896,14.212670403551895,28,11,9,1022,979,739,818,10,1.24
1,0,0,1.0,-0.0,0.8652400970458984,13.45362404707371,28,10,9,1022,979,739,818,10,1.58
1,2,0,1.0,2.0,0.8722021579742432,11.40175425099138,28,9,7,1022,979,739,818,10,2.98
1,0,0,1.0,-0.0,0.880230188369751,10.63014581273465,28,8,7,1022,979,739,818,10,1.44
0,1,0,-0.0,1.0,0.8887691497802734,10.0,28,8,6,1022,979,739,818,10,0.89
1,1,0,1.0,1.0,0.8969461917877197,8.602325267042627,28,7,5,1022,979,739,818,10,3.73
1,0,0,1.0,-0.0,0.9118421077728271,7.810249675906654,28,6,5,1022,979,739,818,10,1.26
1,1,0,1.0,1.0,0.9314641952514648,6.4031242374328485,28,5,4,1022,979,739,818,10,4.0
0,1,0,-0.0,1.0,0.9437422752380371,5.830951894845301,28,5,3,1022,979,739,818,10,0.28
1,0,0,1.0,-0.0,0.9440093040466309,5.0,28,4,3,1022,979,739,818,10,1.04
0,1,0,-0.0,1.0,0.9519991874694824,4.47213595499958,28,4,2,1022,979,739,818,10,-0.07
1,0,0,1.0,-0.0,0.9601001739501953,3.605551275463989,28,3,2,1022,979,739,818,10,0.92
1,1,0,1.0,1.0,0.9760823249816895,2.23606797749979,28,2,1,1022,979,739,818,10,1.58
1,0,0,1.0,-0.0,0.9998741149902344,1.4142135623730951,28,1,1,1022,979,739,818,10,-0.27
0,0,1,-0.0,-0.0,1.0060303211212158,1.4142135623730951,28,1,1,1022,979,739,818,10,27.34
0,1,1,-0.0,1.0,0.006584644317626953,657.7423507727019,29,-488,-441,533,538,1021,978,51,5.39
0,0,0,-0.0,-0.0,0.1035916805267334,657.7423507727019,29,-488,-441,533,538,1021,978,51,160.59
0,-1,0,-0.0,-1.0,0.17459654808044434,657.0722943481942,29,-488,-440,533,538,1021,978,51,3.01
-1,-3,0,-1.0,-3.0,0.18256163597106934,654.3225504290679,29,-487,-437,533,538,1021,978,51,9.5
-1,-2,0,-1.0,-2.0,0.19058871269226074,652.2430528568319,29,-486,-435,533,538,1021,978,51,8.1
-2,-4,0,-2.0,-4.0,0.19878053665161133,648.0871854928163,29,-484,-431,533,538,1021,978,51,13.55
-3,-4,0,-3.0,-4.0,0.20655369758605957,643.187375497996,29,-481,-427,533,538,1021,978,51,16.21
-4,-5,0,-4.0,-5.0,0.2145695686340332,636.8775392491087,29,-477,-422,533,538,1021,978,51,19.7
-5,-7,0,-5.0,-7.0,0.22955560684204102,628.4974144735999,29,-472,-415,533,538,1021,978,51,23.77
-6,-8,0,-6.0,-8.0,0.23339366912841797,618.7123725932754,29,-466,-407,533,538,1021,978,51,26.59
-6,-9,0,-6.0,-9.0,0.23862457275390625,608.2795410006817,29,-460,-398,533,538,1021,978,51,27.27
-8,-10,0,-8.0,-10.0,0.24652862548828125,595.691195167429,29,-452,-388,533,538,1021,978,51,31.46
-9,-9,0,-9.0,-9.0,0.2551696300506592,583.0008576323023,29,-443,-379,533,538,1021,978,51,32.37
-9,-10,0,-9.0,-10.0,0.26256370544433594,569.6639360184213,29,-434,-369,533,538,1021,978,51,32.37
-12,-12,0,-12.0,-12.0,0.2705557346343994,552.7503957483884,29,-422,-357,533,538,1021,978,51,38.08
-15,-14,0,-15.0,-14.0,0.2785506248474121,532.2574565001415,29,-407,-343,533,538,1021,978,51,42.82
-17,-14,0,-17.0,-14.0,0.2865417003631592,510.23621980412173,29,-390,-329,533,538,1021,978,51,45.03
-15,-13,0,-15.0,-13.0,0.29661059379577637,490.38862140143505,29,-375,-316,533,538,1021,978,51,41.18
-15,-13,0,-15.0,-13.0,0.30256152153015137,470.54117779425,29,-360,-303,533,538,1021,978,51,40.16
-15,-13,0,-15.0,-13.0,0.3108997344970703,450.6939094329987,29,-345,-290,533,538,1021,978,51,39.12
-16,-13,0,-16.0,-13.0,0.3190016746520996,430.08138764657093,29,-329,-277,533,538,1021,978,51,38.82
-16,-14,0,-16.0,-14.0,0.3283555507659912,408.8251459976502,29,-313,-263,533,538,1021,978,51,38.25
-18,-13,0,-18.0,-13.0,0.3366725444793701,386.6846260197061,29,-295,-250,533,538,1021,978,51,36.4
-17,-14,0,-17.0,-14.0,0.3430507183074951,364.66422912043345,29,-278,-236,533,538,1021,978,51,36.7
-17,-14,0,-17.0,-14.0,0.3506195545196533,342.64413025761877,29,-261,-222,533,538,1021,978,51,35.29
-13,-12,0,-13.0,-12.0,0.358623743057251,324.96769070170654,29,-248,-210,533,538,1021,978,51,29.03
-11,-12,0,-11.0,-12.0,0.3674767017364502,308.8251932728287,29,-237,-198,533,538,1021,978,51,25.2
-11,-10,0,-11.0,-10.0,0.37897157669067383,293.97278785629123,29,-226,-188,533,538,1021,978,51,24.49
-8,-10,0,-8.0,-10.0,0.38451266288757324,281.4391586115905,29,-218,-178,533,538,1021,978,51,19.48
-7,-11,0,-7.0,-11.0,0.390608549118042,269.09106265351886,29,-211,-167,533,538,1021,978,51,18.09
-7,-11,0,-7.0,-11.0,0.4003896713256836,256.81121470839236,29,-204,-156,533,538,1021,978,51,17.39
-8,-10,0,-8.0,-10.0,0.4065866470336914,244.40130932546168,29,-196,-146,533,538,1021,978,51,17.39
-9,-10,0,-9.0,-10.0,0.41474056243896484,231.22499864850255,29,-187,-136,533,538,1021,978,51,17.73
-9,-12,0,-9.0,-12.0,0.4230666160583496,216.9331694324314,29,-178,-124,533,538,1021,978,51,17.34
-9,-9,0,-9.0,-9.0,0.4359316825866699,204.41624201613726,29,-169,-115,533,538,1021,978,51,15.95
-9,-9,0,-9.0,-9.0,0.4385645389556885,191.92706948213427,29,-160,-106,533,538,1021,978,51,15.2
-8,-9,0,-8.0,-9.0,0.44658374786376953,180.31361568112376,29,-152,-97,533,538,1021,978,51,13.48
-8,-7,0,-8.0,-7.0,0.4555697441101074,169.81166037701888,29,-144,-90,533,538,1021,978,51,12.88
-5,-6,0,-5.0,-6.0,0.46253252029418945,162.40997506310995,29,-139,-84,533,538,1021,978,51,9.13
-2,-5,0,-2.0,-5.0,0.4710276126861572,158.14550262337528,29,-137,-79,533,538,1021,978,51,5.35
-1,-3,0,-1.0,-3.0,0.48087263107299805,155.79473675320358,29,-136,-76,533,538,1021,978,51,3.45
-1,-3,0,-1.0,-3.0,0.4869406223297119,153.47312468311839,29,-135,-73,533,538,1021,978,51,3.36
-1,-3,0,-1.0,-3.0,0.49457573890686035,151.18200951171406,29,-134,-70,533,538,1021,978,51,3.28
-2,-4,0,-2.0,-4.0,0.5026795864105225,147.58048651498612,29,-132,-66,533,538,1021,978,51,4.62
-3,-3,0,-3.0,-3.0,0.5105655193328857,143.56183336806478,29,-129,-63,533,538,1021,978,51,5.84
-2,-3,0,-2.0,-3.0,0.5185306072235107,140.45995870709916,29,-127,-60,533,538,1021,978,51,4.33
-2,-3,0,-2.0,-3.0,0.5280146598815918,137.38267721950973,29,-125,-57,533,538,1021,978,51,4.22
-3,-2,0,-3.0,-2.0,0.5345425605773926,133.82451195502264,29,-122,-55,533,538,1021,978,51,6.23
-2,-2,0,-2.0,-2.0,0.5431675910949707,131.18307817702708,29,-120,-53,533,538,1021,978,51,4.35
-2,-2,0,-2.0,-2.0,0.5505695343017578,128.5496013218244,29,-118,-51,533,538,1021,978,51,4.28
-3,-2,0,-3.0,-2.0,0.5611417293548584,125.00399993600205,29,-115,-49,533,538,1021,978,51,5.89
-4,-2,0,-4.0,-2.0,0.5665507316589355,120.5404496424333,29,-111,-47,533,538,1021,978,51,7.82
-3,-3,0,-3.0,-3.0,0.574718713760376,116.61903789690601,29,-108,-44,533,538,1021,978,51,4.91
-4,-2,0,-4.0,-2.0,0.5845737457275391,112.16059914247963,29,-104,-42,533,538,1021,978,51,7.32
-4,-2,0,-4.0,-2.0,0.5967636108398438,107.70329614269008,29,-100,-40,533,538,1021,978,51,7.16
-4,-3,0,-4.0,-3.0,0.5985527038574219,102.88342918079665,29,-96,-37,533,538,1021,978,51,5.65
-4,-3,0,-4.0,-3.0,0.6074516773223877,98.08159868191383,29,-92,-34,533,538,1021,978,51,5.43
-4,-2,0,-4.0,-2.0,0.6176056861877441,93.637599285757,29,-88,-32,533,538,1021,978,51,6.36
-5,-3,0,-5.0,-3.0,0.6235675811767578,87.92041856133307,29,-83,-29,533,538,1021,978,51,6.09
-5,-2,0,-5.0,-2.0,0.6305637359619141,82.54089895318563,29,-78,-27,533,538,1021,978,51,7.62
-6,-3,0,-6.0,-3.0,0.6418795585632324,75.8946638440411,29,-72,-24,533,538,1021,978,51,6.56
-6,-2,0,-6.0,-2.0,0.651714563369751,69.57010852370435,29,-66,-22,533,538,1021,978,51,10.1
-5,-2,0,-5.0,-2.0,0.6545755863189697,64.19501538281614,29,-61,-20,533,538,1021,978,51,6.63
-6,-1,0,-6.0,-1.0,0.6629047393798828,58.18934610390462,29,-55,-19,533,538,1021,978,51,5.36
-5,-2,0,-5.0,-2.0,0.67291259765625,52.81098370604357,29,-50,-17,533,538,1021,978,51,6.44
-5,-1,0,-5.0,-1.0,0.6800885200500488,47.75981574503821,29,-45,-16,533,538,1021,978,51,4.84
-6,-2,0,-6.0,-2.0,0.6871106624603271,41.43669871020132,29,-39,-14,533,538,1021,978,51,7.21
-4,-1,0,-4.0,-1.0,0.694556713104248,37.33630940518894,29,-35,-13,533,538,1021,978,51,4.55
-5,-1,0,-5.0,-1.0,0.7028405666351318,32.31098884280702,29,-30,-12,533,538,1021,978,51,3.84
-2,-1,0,-2.0,-1.0,0.7108025550842285,30.083217912982647,29,-28,-11,533,538,1021,978,51,4.24
-2,0,0,-2.0,-0.0,0.718780517578125,28.231188426986208,29,-26,-11,533,538,1021,978,51,2.08
-2,-1,0,-2.0,-1.0,0.7284905910491943,26.0,29,-24,-10,533,538,1021,978,51,4.45
-1,0,0,-1.0,-0.0,0.7346086502075195,25.079872407968907,29,-23,-10,533,538,1021,978,51,1.94
-1,0,0,-1.0,-0.0,0.7432386875152588,24.166091947189145,29,-22,-10,533,538,1021,978,51,1.87
0,0,1,-0.0,-0.0,0.7575716972351074,24.166091947189145,29,-22,-10,533,538,1021,978,51,34.17
0,0,0,-0.0,-0.0,0.09556102752685547,1268.0891135878423,30,1123,589,1678,1137,555,548,39,234.66
2,0,0,2.0,-0.0,0.10657501220703125,1266.3182854243241,30,1121,589,1678,1137,555,548,39,11.68
3,0,0,3.0,-0.0,0.11460590362548828,1263.6633254154367,30,1118,589,1678,1137,555,548,39,16.27
3,0,0,3.0,-0.0,0.12366390228271484,1261.0099127286828,30,1115,589,1678,1137,555,548,39,16.25
4,0,0,4.0,-0.0,0.13069391250610352,1257.4744530208159,30,1111,589,1678,1137,555,548,39,20.62
3,0,0,3.0,-0.0,0.13930106163024902,1254.824688950612,30,1108,589,1678,1137,555,548,39,16.18
4,-1,0,4.0,-1.0,0.1482679843902588,1251.7651536929761,30,1104,590,1678,1137,555,548,39,17.64
4,0,0,4.0,-0.0,0.15455293655395508,1248.2387592123553,30,1100,590,1678,1137,555,548,39,20.48
3,0,0,3.0,-0.0,0.16258597373962402,1245.5958413546507,30,1097,590,1678,1137,555,548,39,16.07
3,0,0,3.0,-0.0,0.1705760955810547,1242.9545446234147,30,1094,590,1678,1137,555,548,39,16.04
4,0,0,4.0,-0.0,0.17873692512512207,1239.4353553130554,30,1090,590,1678,1137,555,548,39,20.36
6,1,0,6.0,1.0,0.19148707389831543,1233.6843194269757,30,1084,589,1678,1137,555,548,39,31.11
6,1,0,6.0,1.0,0.19454193115234375,1227.9364804418835,30,1078,588,1678,1137,555,548,39,31.02
8,2,0,8.0,2.0,0.20268988609313965,1219.9573763045987,30,1070,586,1678,1137,555,548,39,40.49
10,3,0,10.0,3.0,0.21070599555969238,1209.7474943144127,30,1060,583,1678,1137,555,548,39,48.9
14,5,0,14.0,5.0,0.21853089332580566,1195.0732195141852,30,1046,578,1678,1137,555,548,39,63.44
17,4,0,17.0,4.0,0.22658896446228027,1178.268645089056,30,1029,574,1678,1137,555,548,39,68.28
19,6,0,19.0,6.0,0.23467087745666504,1158.7596817287008,30,1010,568,1678,1137,555,548,39,75.03
20,7,0,20.0,7.0,0.24255800247192383,1137.9020168714,30,990,561,1678,1137,555,548,39,77.68
23,8,0,23.0,8.0,0.2511110305786133,1113.9560134942492,30,967,553,1678,1137,555,548,39,83.47
23,10,0,23.0,10.0,0.25886988639831543,1089.02938436022,30,944,543,1678,1137,555,548,39,85.06
23,10,0,23.0,10.0,0.2669050693511963,1064.109956724398,30,921,533,1678,1137,555,548,39,83.93
22,11,0,22.0,11.0,0.2746410369873047,1039.5600030782255,30,899,522,1678,1137,555,548,39,82.87
22,12,0,22.0,12.0,0.28261899948120117,1014.5092409633339,30,877,510,1678,1137,555,548,39,83.59
27,13,0,27.0,13.0,0.2933690547943115,984.6364811441834,30,850,497,1678,1137,555,548,39,89.4
27,14,0,27.0,14.0,0.2991158962249756,954.2630664549478,30,823,483,1678,1137,555,548,39,89.12
29,15,0,29.0,15.0,0.31053900718688965,921.6615430840109,30,794,468,1678,1137,555,548,39,90.61
27,14,0,27.0,14.0,0.3159000873565674,891.2940031213045,30,767,454,1678,1137,555,548,39,85.63
27,13,0,27.0,13.0,0.32263803482055664,861.4412342115972,30,740,441,1678,1137,555,548,39,82.65
25,13,0,25.0,13.0,0.3305830955505371,833.312066395297,30,715,428,1678,1137,555,548,39,78.96
24,12,0,24.0,12.0,0.33983302116394043,806.5587393364478,30,691,416,1678,1137,555,548,39,75.04
24,12,0,24.0,12.0,0.34670209884643555,779.8108745074026,30,667,404,1678,1137,555,548,39,73.52
25,13,0,25.0,13.0,0.3547830581665039,751.6947518773827,30,642,391,1678,1137,555,548,39,74.18
23,12,0,23.0,12.0,0.36289095878601074,725.8112702349007,30,619,379,1678,1137,555,548,39,69.38
25,14,0,25.0,14.0,0.3706181049346924,697.1807513120252,30,594,365,1678,1137,555,548,39,72.22
24,12,0,24.0,12.0,0.3785359859466553,670.4543235746936,30,570,353,1678,1137,555,548,39,67.01
22,13,0,22.0,13.0,0.3865790367126465,644.9061947291249,30,548,340,1678,1137,555,548,39,65.4
23,13,0,23.0,13.0,0.39462709426879883,618.5094987144498,30,525,327,1678,1137,555,548,39,64.26
21,12,0,21.0,12.0,0.40305495262145996,594.340811319566,30,504,315,1678,1137,555,548,39,59.81
20,12,0,20.0,12.0,0.4130289554595947,571.0210153750911,30,484,303,1678,1137,555,548,39,57.92
19,13,0,19.0,13.0,0.4212958812713623,548.0191602489825,30,465,290,1678,1137,555,548,39,55.28
19,12,0,19.0,12.0,0.4337151050567627,525.5473337388365,30,446,278,1678,1137,555,548,39,54.73
21,11,0,21.0,11.0,0.43462491035461426,501.9103505607351,30,425,267,1678,1137,555,548,39,52.46
20,11,0,20.0,11.0,0.44512510299682617,479.1252445864234,30,405,256,1678,1137,555,548,39,50.2
21,11,0,21.0,11.0,0.45055294036865234,455.50082327038666,30,384,245,1678,1137,555,548,39,49.22
21,10,0,21.0,10.0,0.45856595039367676,432.4280286937932,30,363,235,1678,1137,555,548,39,46.43
21,9,0,21.0,9.0,0.46662092208862305,409.9268227379126,30,342,226,1678,1137,555,548,39,43.77
19,8,0,19.0,8.0,0.4746060371398926,389.6832046675864,30,323,218,1678,1137,555,548,39,39.63
20,8,0,20.0,8.0,0.4826030731201172,368.6583784481237,30,303,210,1678,1137,555,548,39,38.88
19,7,0,19.0,7.0,0.49083900451660156,349.09167850293994,30,284,203,1678,1137,555,548,39,35.65
19,8,0,19.0,8.0,0.4986400604248047,329.013677527242,30,265,195,1678,1137,555,548,39,34.96
18,8,0,18.0,8.0,0.5067501068115234,309.8031633150314,30,247,187,1678,1137,555,548,39,32.71
17,8,0,17.0,8.0,0.5145609378814697,291.44639301250584,30,230,179,1678,1137,555,548,39,30.56
16,8,0,16.0,8.0,0.5225570201873779,273.9288228719278,30,214,171,1678,1137,555,548,39,28.53
14,7,0,14.0,7.0,0.5320389270782471,258.6426105652354,30,200,164,1678,1137,555,548,39,25.12
12,7,0,12.0,7.0,0.5392448902130127,244.9346851713738,30,188,157,1678,1137,555,548,39,22.97
10,5,0,10.0,5.0,0.5466001033782959,234.0683660813652,30,178,152,1678,1137,555,548,39,18.69
8,6,0,8.0,6.0,0.5545880794525146,224.0892679268688,30,170,146,1678,1137,555,548,39,18.86
7,5,0,7.0,5.0,0.5643730163574219,215.52262062252305,30,163,141,1678,1137,555,548,39,16.38
6,5,0,6.0,5.0,0.5709409713745117,207.7137453323684,30,157,136,1678,1137,555,548,39,16.86
6,4,0,6.0,4.0,0.5785598754882812,200.5617112013158,30,151,132,1678,1137,555,548,39,13.63
6,4,0,6.0,4.0,0.5865740776062012,193.4140636044856,30,145,128,1678,1137,555,548,39,13.29
5,3,0,5.0,3.0,0.5948679447174072,187.6832437912346,30,140,125,1678,1137,555,548,39,10.96
5,4,0,5.0,4.0,0.6025679111480713,181.289823211343,30,135,121,1678,1137,555,548,39,13.05
4,3,0,4.0,3.0,0.6134929656982422,176.30938715791623,30,131,118,1678,1137,555,548,39,10.67
3,2,0,3.0,2.0,0.6191720962524414,172.74258305351347,30,128,116,1678,1137,555,548,39,8.22
2,2,0,2.0,2.0,0.6267740726470947,169.91762710207556,30,126,114,1678,1137,555,548,39,8.56
2,2,0,2.0,2.0,0.6345980167388916,167.09278859364338,30,124,112,1678,1137,555,548,39,8.49
2,2,0,2.0,2.0,0.6437480449676514,164.26807358704855,30,122,110,1678,1137,555,548,39,8.42
3,2,0,3.0,2.0,0.6517980098724365,160.70158679988197,30,119,108,1678,1137,555,548,39,7.93
3,3,0,3.0,3.0,0.6591260433197021,156.46405337968207,30,116,105,1678,1137,555,548,39,9.94
3,3,0,3.0,3.0,0.6674709320068359,152.22680447279973,30,113,102,1678,1137,555,548,39,9.8
3,3,0,3.0,3.0,0.6751658916473389,147.98986451781082,30,110,99,1678,1137,555,548,39,9.65
4,3,0,4.0,3.0,0.6837279796600342,143.01048912579805,30,106,96,1678,1137,555,548,39,9.58
3,3,0,3.0,3.0,0.6915440559387207,138.77319625922004,30,103,93,1678,1137,555,548,39,9.42
3,3,0,3.0,3.0,0.6986260414123535,134.5362404707371,30,100,90,1678,1137,555,548,39,9.27
2,2,0,2.0,2.0,0.7065610885620117,131.71180660821565,30,98,88,1678,1137,555,548,39,7.75
1,3,0,1.0,3.0,0.717303991317749,128.9728653632228,30,97,85,1678,1137,555,548,39,4.59
2,2,0,2.0,2.0,0.7225790023803711,126.15070352558483,30,95,83,1678,1137,555,548,39,7.37
3,5,0,3.0,5.0,0.7306830883026123,120.61509026651682,30,92,78,1678,1137,555,548,39,7.6
4,5,0,4.0,5.0,0.7390658855438232,114.33722053644648,30,88,73,1678,1137,555,548,39,8.61
6,6,0,6.0,6.0,0.7469429969787598,105.89145385724005,30,82,67,1678,1137,555,548,39,10.71
7,6,0,7.0,6.0,0.7555930614471436,96.67471230885562,30,75,61,1678,1137,555,548,39,12.3
7,5,0,7.0,5.0,0.7631649971008301,88.09086218218096,30,68,56,1678,1137,555,548,39,10.27
6,5,0,6.0,5.0,0.7746400833129883,80.2807573457052,30,62,51,1678,1137,555,548,39,11.68
7,5,0,7.0,5.0,0.7787289619445801,71.7007670809734,30,55,46,1678,1137,555,548,39,9.15
7,4,0,7.0,4.0,0.7869288921356201,63.7808748764079,30,48,42,1678,1137,555,548,39,7.06
6,4,0,6.0,4.0,0.7947399616241455,56.639209034025185,30,42,38,1678,1137,555,548,39,6.72
5,3,0,5.0,3.0,0.8027770519256592,50.93132631298737,30,37,35,1678,1137,555,548,39,5.29
4,3,0,4.0,3.0,0.8105618953704834,45.967379738244816,30,33,32,1678,1137,555,548,39,5.5
2,1,0,2.0,1.0,0.8189799785614014,43.840620433565945,30,31,31,1678,1137,555,548,39,3.09
1,1,0,1.0,1.0,0.8278310298919678,42.42640687119285,30,30,30,1678,1137,555,548,39,7.45
1,2,0,1.0,2.0,0.8359270095825195,40.311288741492746,30,29,28,1678,1137,555,548,39,2.92
1,0,0,1.0,-0.0,0.8425641059875488,39.59797974644666,30,28,28,1678,1137,555,548,39,1.26
0,1,0,-0.0,1.0,0.8505620956420898,38.897300677553446,30,28,27,1678,1137,555,548,39,1.21
1,1,0,1.0,1.0,0.8586030006408691,37.48332962798263,30,27,26,1678,1137,555,548,39,6.12
4,2,0,4.0,2.0,0.8682351112365723,33.24154027718932,30,23,24,1678,1137,555,548,39,3.27
3,3,0,3.0,3.0,0.8753840923309326,29.0,30,20,21,1678,1137,555,548,39,6.51
6,4,0,6.0,4.0,0.8836390972137451,22.02271554554524,30,14,17,1678,1137,555,548,39,3.42
6,3,0,6.0,3.0,0.8913590908050537,16.1245154965971,30,8,14,1678,1137,555,548,39,1.69
6,3,0,6.0,3.0,0.9009239673614502,11.180339887498949,30,2,11,1678,1137,555,548,39,0.33
5,2,0,5.0,2.0,0.9081530570983887,9.486832980505138,30,-3,9,1678,1137,555,548,39,-1.25
4,2,0,4.0,2.0,0.9145839214324951,9.899494936611665,30,-7,7,1678,1137,555,548,39,-1.03
4,1,0,4.0,1.0,0.9228320121765137,12.529964086141668,30,-11,6,1678,1137,555,548,39,-1.03
2,1,0,2.0,1.0,0.931678056716919,13.92838827718412,30,-13,5,1678,1137,555,548,39,-0.14
1,0,0,1.0,-0.0,0.9395079612731934,14.866068747318506,30,-14,5,1678,1137,555,548,39,1.87
0,0,1,-0.0,-0.0,0.9625868797302246,14.866068747318506,30,-14,5,1678,1137,555,548,39,31.34
0,0,0,-0.0,-0.0,0.13268041610717773,520.331625023888,31,-516,-67,1176,1065,1692,1132,50,138.8
-1,0,0,-1.0,-0.0,0.15385031700134277,519.3399657257277,31,-515,-67,1176,1065,1692,1132,50,6.12
-1,1,0,-1.0,1.0,0.1616194248199463,518.4785434326092,31,-514,-68,1176,1065,1692,1132,50,3.1
-1,0,0,-1.0,-0.0,0.1696643829345703,517.4871979092816,31,-513,-68,1176,1065,1692,1132,50,6.09
-2,0,0,-2.0,-0.0,0.17769432067871094,515.5046071569099,31,-511,-68,1176,1065,1692,1132,50,8.51
-2,0,0,-2.0,-0.0,0.18576431274414062,513.522151420949,31,-509,-68,1176,1065,1692,1132,50,8.49
-1,0,0,-1.0,-0.0,0.19371628761291504,512.5309746737264,31,-508,-68,1176,1065,1692,1132,50,6.06
-3,0,0,-3.0,-0.0,0.20368027687072754,509.5576513015971,31,-505,-68,1176,1065,1692,1132,50,10.78
-3,-2,0,-3.0,-2.0,0.21524739265441895,506.32005688102066,31,-502,-66,1176,1065,1692,1132,50,9.69
-5,-3,0,-5.0,-3.0,0.2194664478302002,500.9770453823209,31,-497,-63,1176,1065,1692,1132,50,14.32
-8,-5,0,-8.0,-5.0,0.22563838958740234,492.4276596618025,31,-489,-58,1176,1065,1692,1132,50,20.32
-12,-6,0,-12.0,-6.0,0.23365330696105957,479.8260101328397,31,-477,-52,1176,1065,1692,1132,50,27.13
-19,-9,0,-19.0,-9.0,0.24260735511779785,460.01413021775755,31,-458,-43,1176,1065,1692,1132,50,36.33
-21,-7,0,-21.0,-7.0,0.24971842765808105,438.4803302315852,31,-437,-36,1176,1065,1692,1132,50,37.73
-20,-6,0,-20.0,-6.0,0.25800228118896484,418.07774396635847,31,-417,-30,1176,1065,1692,1132,50,35.43
-20,-6,0,-20.0,-6.0,0.2674593925476074,397.7247792129628,31,-397,-24,1176,1065,1692,1132,50,34.17
-18,-4,0,-18.0,-4.0,0.27371835708618164,379.5273376187808,31,-379,-20,1176,1065,1692,1132,50,31.23
-18,-5,0,-18.0,-5.0,0.2840273380279541,361.3114999553709,31,-361,-15,1176,1065,1692,1132,50,29.82
-15,-3,0,-15.0,-3.0,0.28996944427490234,346.2080299473136,31,-346,-12,1176,1065,1692,1132,50,26.03
-15,-4,0,-15.0,-4.0,0.29768824577331543,331.09666262286606,31,-331,-8,1176,1065,1692,1132,50,24.79
-16,-2,0,-16.0,-2.0,0.30565738677978516,315.0571376750573,31,-315,-6,1176,1065,1692,1132,50,26.06
-15,-2,0,-15.0,-2.0,0.31526732444763184,300.0266654815868,31,-300,-4,1176,1065,1692,1132,50,24.07
-15,-3,0,-15.0,-3.0,0.3259263038635254,285.00175438056516,31,-285,-1,1176,1065,1692,1132,50,22.63
-13,-1,0,-13.0,-1.0,0.32971739768981934,272.0,31,-272,0,1176,1065,1692,1132,50,21.14
-13,-1,0,-13.0,-1.0,0.33803439140319824,259.0019304947359,31,-259,1,1176,1065,1692,1132,50,20.45
-14,-1,0,-14.0,-1.0,0.3536832332611084,245.0081631293129,31,-245,2,1176,1065,1692,1132,50,20.72
-14,-1,0,-14.0,-1.0,0.3544173240661621,231.01947969814148,31,-231,3,1176,1065,1692,1132,50,19.9
-12,-1,0,-12.0,-1.0,0.36238527297973633,219.03652663425797,31,-219,4,1176,1065,1692,1132,50,17.26
-12,0,0,-12.0,-0.0,0.3713383674621582,207.03864373589778,31,-207,4,1176,1065,1692,1132,50,18.55
-11,0,0,-11.0,-0.0,0.3823103904724121,196.04081207748553,31,-196,4,1176,1065,1692,1132,50,17.11
-11,0,0,-11.0,-0.0,0.3856832981109619,185.04323819042943,31,-185,4,1176,1065,1692,1132,50,16.54
-10,0,0,-10.0,-0.0,0.3936574459075928,175.04570831642803,31,-175,4,1176,1065,1692,1132,50,15.21
-9,-1,0,-9.0,-1.0,0.4026222229003906,166.0752841334315,31,-166,5,1176,1065,1692,1132,50,11.85
-9,0,0,-9.0,-0.0,0.40972423553466797,157.07959765672945,31,-157,5,1176,1065,1692,1132,50,13.3
-9,-1,0,-9.0,-1.0,0.41767430305480957,148.12157169028418,31,-148,6,1176,1065,1692,1132,50,10.98
-8,0,0,-8.0,-0.0,0.4262733459472656,140.12851244482687,31,-140,6,1176,1065,1692,1132,50,11.53
-9,-1,0,-9.0,-1.0,0.43425941467285156,131.18688958886096,31,-131,7,1176,1065,1692,1132,50,10.1
-8,-1,0,-8.0,-1.0,0.4416513442993164,123.25988804148737,31,-123,8,1176,1065,1692,1132,50,8.9
-9,-1,0,-9.0,-1.0,0.4496793746948242,114.35471131527551,31,-114,9,1176,1065,1692,1132,50,9.11
-9,-1,0,-9.0,-1.0,0.4586033821105957,105.47511554864494,31,-105,10,1176,1065,1692,1132,50,8.56
-9,-1,0,-9.0,-1.0,0.46631336212158203,96.62815324738438,31,-96,11,1176,1065,1692,1132,50,7.98
-8,0,0,-8.0,-0.0,0.4774653911590576,88.68483523128404,31,-88,11,1176,1065,1692,1132,50,7.97
-8,-1,0,-8.0,-1.0,0.4820692539215088,80.89499366462674,31,-80,12,1176,1065,1692,1132,50,6.45
-8,0,0,-8.0,-0.0,0.4896273612976074,72.99315036357864,31,-72,12,1176,1065,1692,1132,50,6.82
-7,0,0,-7.0,-0.0,0.4978482723236084,66.09841147864296,31,-65,12,1176,1065,1692,1132,50,5.96
-8,0,0,-8.0,-0.0,0.5072634220123291,58.249463516842795,31,-57,12,1176,1065,1692,1132,50,5.75
-7,0,0,-7.0,-0.0,0.5136523246765137,51.419840528729765,31,-50,12,1176,1065,1692,1132,50,4.9
-7,0,0,-7.0,-0.0,0.5221822261810303,44.64302857109943,31,-43,12,1176,1065,1692,1132,50,4.34
-5,0,0,-5.0,-0.0,0.5296673774719238,39.84971769034255,31,-38,12,1176,1065,1692,1132,50,3.43
-6,0,0,-6.0,-0.0,0.5411202907562256,34.17601498127012,31,-32,12,1176,1065,1692,1132,50,3.13
-4,1,0,-4.0,1.0,0.5471463203430176,30.083217912982647,31,-28,11,1176,1065,1692,1132,50,4.07
-3,0,0,-3.0,-0.0,0.554192304611206,27.313000567495326,31,-25,11,1176,1065,1692,1132,50,2.11
-2,0,0,-2.0,-0.0,0.5627844333648682,25.495097567963924,31,-23,11,1176,1065,1692,1132,50,1.85
-2,0,0,-2.0,-0.0,0.5734434127807617,23.706539182259394,31,-21,11,1176,1065,1692,1132,50,1.68
-1,0,0,-1.0,-0.0,0.5835592746734619,22.825424421026653,31,-20,11,1176,1065,1692,1132,50,1.61
-1,0,0,-1.0,-0.0,0.5945544242858887,21.95449840010015,31,-19,11,1176,1065,1692,1132,50,1.53
-1,0,0,-1.0,-0.0,0.5997202396392822,21.095023109728988,31,-18,11,1176,1065,1692,1132,50,1.44
0,0,1,-0.0,-0.0,0.5998852252960205,21.095023109728988,31,-18,11,1176,1065,1692,1132,50,33.230000000000004
0,0,0,-0.0,-0.0,0.0907888412475586,1053.422042678052,32,-427,-963,767,91,1194,1054,52,211.77
1,0,0,1.0,-0.0,0.13678383827209473,1053.8277847921831,32,-428,-963,767,91,1194,1054,52,9.85
1,-1,0,1.0,-1.0,0.1464550495147705,1053.3209387456418,32,-429,-962,767,91,1194,1054,52,2.48
1,-1,0,1.0,-1.0,0.15760493278503418,1052.8157483624568,32,-430,-961,767,91,1194,1054,52,2.47
1,-1,0,1.0,-1.0,0.1628129482269287,1052.3122160271637,32,-431,-960,767,91,1194,1054,52,2.46
1,-2,0,1.0,-2.0,0.17234086990356445,1050.898663049868,32,-432,-958,767,91,1194,1054,52,6.35
0,-3,0,-0.0,-3.0,0.1769120693206787,1048.1645863126648,32,-432,-955,767,91,1194,1054,52,12.16
1,-2,0,1.0,-2.0,0.1847689151763916,1046.755940991022,32,-433,-953,767,91,1194,1054,52,6.31
0,-4,0,-0.0,-4.0,0.1934528350830078,1043.115525720905,32,-433,-949,767,91,1194,1054,52,15.27
0,-3,0,-0.0,-3.0,0.20105791091918945,1040.3869472460715,32,-433,-946,767,91,1194,1054,52,12.08
0,-4,0,-0.0,-4.0,0.20879697799682617,1036.751175547923,32,-433,-942,767,91,1194,1054,52,15.2
-3,-6,0,-3.0,-6.0,0.21707701683044434,1030.0466008875521,32,-430,-936,767,91,1194,1054,52,28.18
-3,-8,0,-3.0,-8.0,0.22487998008728027,1021.524840618181,32,-427,-928,767,91,1194,1054,52,32.56
-5,-10,0,-5.0,-10.0,0.23287391662597656,1010.3504342553628,32,-422,-918,767,91,1194,1054,52,40.44
-7,-12,0,-7.0,-12.0,0.24275493621826172,996.5244603119384,32,-415,-906,767,91,1194,1054,52,45.48
-10,-15,0,-10.0,-15.0,0.2487480640411377,978.7267238611604,32,-405,-891,767,91,1194,1054,52,53.19
-12,-18,0,-12.0,-18.0,0.2568209171295166,957.380801980069,32,-393,-873,767,91,1194,1054,52,59.46
-15,-20,0,-15.0,-20.0,0.26715087890625,933.0021436202599,32,-378,-853,767,91,1194,1054,52,63.52
-17,-24,0,-17.0,-24.0,0.2791869640350342,904.1913514295522,32,-361,-829,767,91,1194,1054,52,69.46
-21,-27,0,-21.0,-27.0,0.281343936920166,871.0935655829401,32,-340,-802,767,91,1194,1054,52,73.54
-20,-25,0,-20.0,-25.0,0.28981900215148926,840.3148219566283,32,-320,-777,767,91,1194,1054,52,68.82
-17,-21,0,-17.0,-21.0,0.2967848777770996,814.45994376642,32,-303,-756,767,91,1194,1054,52,60.55
-17,-24,0,-17.0,-24.0,0.30475783348083496,785.8880327374886,32,-286,-732,767,91,1194,1054,52,63.4
-14,-23,0,-14.0,-23.0,0.314302921295166,759.3846192806383,32,-272,-709,767,91,1194,1054,52,59.67
-14,-23,0,-14.0,-23.0,0.3210480213165283,732.9120001746458,32,-258,-686,767,91,1194,1054,52,58.33
-12,-21,0,-12.0,-21.0,0.329571008682251,709.0423118545183,32,-246,-665,767,91,1194,1054,52,53.71
-11,-23,0,-11.0,-23.0,0.3377699851989746,683.6585405010311,32,-235,-642,767,91,1194,1054,52,55.36
-10,-22,0,-10.0,-22.0,0.34604787826538086,659.5642500924379,32,-225,-620,767,91,1194,1054,52,52.68
-9,-22,0,-9.0,-22.0,0.35445404052734375,635.8144383387341,32,-216,-598,767,91,1194,1054,52,51.82
-8,-20,0,-8.0,-20.0,0.3607339859008789,614.2865780724824,32,-208,-578,767,91,1194,1054,52,47.93
-7,-19,0,-7.0,-19.0,0.3687748908996582,594.0387192767824,32,-201,-559,767,91,1194,1054,52,46.39
-7,-18,0,-7.0,-18.0,0.3767659664154053,574.7321115093536,32,-194,-541,767,91,1194,1054,52,43.28
-8,-19,0,-8.0,-19.0,0.3848299980163574,554.1479946729032,32,-186,-522,767,91,1194,1054,52,43.32
-9,-18,0,-9.0,-18.0,0.3928959369659424,534.1769369787505,32,-177,-504,767,91,1194,1054,52,40.56
-10,-18,0,-10.0,-18.0,0.40342283248901367,513.8920120025218,32,-167,-486,767,91,1194,1054,52,39.56
-12,-19,0,-12.0,-19.0,0.411761999130249,492.05081038445616,32,-155,-467,767,91,1194,1054,52,39.96
-11,-18,0,-11.0,-18.0,0.4182300567626953,471.5262452928787,32,-144,-449,767,91,1194,1054,52,37.34
-12,-16,0,-12.0,-16.0,0.424746036529541,452.67317128365363,32,-132,-433,767,91,1194,1054,52,33.84
-10,-15,0,-10.0,-15.0,0.43415188789367676,435.4400073488884,32,-122,-418,767,91,1194,1054,52,31.2
-9,-13,0,-9.0,-13.0,0.44405698776245117,420.46878599962685,32,-113,-405,767,91,1194,1054,52,27.51
-7,-12,0,-7.0,-12.0,0.45543384552001953,407.04422364160877,32,-106,-393,767,91,1194,1054,52,25.24
-7,-11,0,-7.0,-11.0,0.4589259624481201,394.62007044751283,32,-99,-382,767,91,1194,1054,52,23.18
-4,-11,0,-4.0,-11.0,0.46835899353027344,382.9699727132664,32,-95,-371,767,91,1194,1054,52,23.25
-4,-9,0,-4.0,-9.0,0.4727790355682373,373.2626421167808,32,-91,-362,767,91,1194,1054,52,19.5
-3,-10,0,-3.0,-10.0,0.4809608459472656,362.83329505435415,32,-88,-352,767,91,1194,1054,52,21.78
-3,-9,0,-3.0,-9.0,0.4895939826965332,353.3751547576598,32,-85,-343,767,91,1194,1054,52,19.53
-3,-9,0,-3.0,-9.0,0.497020959854126,343.91859501922835,32,-82,-334,767,91,1194,1054,52,19.19
-3,-10,0,-3.0,-10.0,0.5048599243164062,333.492128842646,32,-79,-324,767,91,1194,1054,52,20.63
-3,-10,0,-3.0,-10.0,0.5127320289611816,323.066556610244,32,-76,-314,767,91,1194,1054,52,20.22
-4,-11,0,-4.0,-11.0,0.522817850112915,311.4369920224635,32,-72,-303,767,91,1194,1054,52,20.29
-3,-11,0,-3.0,-11.0,0.5287768840789795,300.04166377354994,32,-69,-292,767,91,1194,1054,52,21.01
-3,-10,0,-3.0,-10.0,0.5367999076843262,289.6204412675321,32,-66,-282,767,91,1194,1054,52,18.84
-5,-12,0,-5.0,-12.0,0.5451278686523438,276.80498550423545,32,-61,-270,767,91,1194,1054,52,19.58
-3,-9,0,-3.0,-9.0,0.5530369281768799,267.36678926149375,32,-58,-261,767,91,1194,1054,52,16.27
-4,-9,0,-4.0,-9.0,0.5644018650054932,257.72077913897436,32,-54,-252,767,91,1194,1054,52,15.22
-3,-10,0,-3.0,-10.0,0.5687699317932129,247.315587862957,32,-51,-242,767,91,1194,1054,52,16.8
-4,-8,0,-4.0,-8.0,0.577064037322998,238.6734170367534,32,-47,-234,767,91,1194,1054,52,13.13
-3,-9,0,-3.0,-9.0,0.5852169990539551,229.26185901715095,32,-44,-225,767,91,1194,1054,52,14.55
-3,-9,0,-3.0,-9.0,0.5935978889465332,219.85677155821242,32,-41,-216,767,91,1194,1054,52,14.13
-3,-7,0,-3.0,-7.0,0.6007418632507324,212.42645786248002,32,-38,-209,767,91,1194,1054,52,11.25
-1,-6,0,-1.0,-6.0,0.608893871307373,206.34437234875102,32,-37,-203,767,91,1194,1054,52,12.77
-1,-6,0,-1.0,-6.0,0.6167528629302979,200.26232796010336,32,-36,-197,767,91,1194,1054,52,12.58
-1,-5,0,-1.0,-5.0,0.6248629093170166,195.1640335717624,32,-35,-192,767,91,1194,1054,52,11.39
0,-5,0,-0.0,-5.0,0.632828950881958,190.24720760105785,32,-35,-187,767,91,1194,1054,52,8.42
0,-6,0,-0.0,-6.0,0.6439650058746338,184.3529224069963,32,-35,-181,767,91,1194,1054,52,9.16
-1,-7,0,-1.0,-7.0,0.649263858795166,177.29072169744248,32,-34,-174,767,91,1194,1054,52,11.67
0,-6,0,-0.0,-6.0,0.6568729877471924,171.40595088852663,32,-34,-168,767,91,1194,1054,52,8.73
0,-6,0,-0.0,-6.0,0.6647658348083496,165.5294535724685,32,-34,-162,767,91,1194,1054,52,8.51
0,-7,0,-0.0,-7.0,0.6743249893188477,158.68522300453813,32,-34,-155,767,91,1194,1054,52,9.04
0,-6,0,-0.0,-6.0,0.6807658672332764,152.82997088267732,32,-34,-149,767,91,1194,1054,52,8.02
2,-7,0,2.0,-7.0,0.6926670074462891,146.4923206178399,32,-36,-142,767,91,1194,1054,52,6.98
1,-7,0,1.0,-7.0,0.698889970779419,139.97856978837868,32,-37,-135,767,91,1194,1054,52,7.27
2,-8,0,2.0,-8.0,0.7055768966674805,132.85330255586422,32,-39,-127,767,91,1194,1054,52,7.03
2,-6,0,2.0,-6.0,0.7135410308837891,127.75758294520134,32,-41,-121,767,91,1194,1054,52,5.21
1,-7,0,1.0,-7.0,0.7241349220275879,121.49074038789952,32,-42,-114,767,91,1194,1054,52,6.21
2,-7,0,2.0,-7.0,0.7292468547821045,115.69356075426151,32,-44,-107,767,91,1194,1054,52,5.26
1,-7,0,1.0,-7.0,0.7380650043487549,109.65856099730654,32,-45,-100,767,91,1194,1054,52,5.47
1,-8,0,1.0,-8.0,0.7481570243835449,102.85912696499032,32,-46,-92,767,91,1194,1054,52,5.6
0,-8,0,-0.0,-8.0,0.7527730464935303,95.77055915050303,32,-46,-84,767,91,1194,1054,52,5.72
0,-7,0,-0.0,-7.0,0.7608180046081543,89.69392398596462,32,-46,-77,767,91,1194,1054,52,4.87
0,-7,0,-0.0,-7.0,0.769110918045044,83.7615663654877,32,-46,-70,767,91,1194,1054,52,4.47
-1,-6,0,-1.0,-6.0,0.7780580520629883,78.2368199762746,32,-45,-64,767,91,1194,1054,52,4.48
-1,-6,0,-1.0,-6.0,0.7868208885192871,72.80109889280519,32,-44,-58,767,91,1194,1054,52,4.14
-1,-5,0,-1.0,-5.0,0.7927370071411133,68.24954212300622,32,-43,-53,767,91,1194,1054,52,3.62
-1,-5,0,-1.0,-5.0,0.8010330200195312,63.7808748764079,32,-42,-48,767,91,1194,1054,52,3.34
-1,-3,0,-1.0,-3.0,0.8090620040893555,60.876925020897694,32,-41,-45,767,91,1194,1054,52,3.02
0,-4,0,-0.0,-4.0,0.8167848587036133,57.982756057296896,32,-41,-41,767,91,1194,1054,52,1.98
-2,-4,0,-2.0,-4.0,0.8247559070587158,53.75872022286245,32,-39,-37,767,91,1194,1054,52,3.53
-1,-2,0,-1.0,-2.0,0.8342080116271973,51.66236541235796,32,-38,-35,767,91,1194,1054,52,2.77
-2,-3,0,-2.0,-3.0,0.8447349071502686,48.16637831516918,32,-36,-32,767,91,1194,1054,52,3.58
0,-2,0,-0.0,-2.0,0.8488199710845947,46.861498055439924,32,-36,-30,767,91,1194,1054,52,1.16
-1,-1,0,-1.0,-1.0,0.8602509498596191,45.45327270945405,32,-35,-29,767,91,1194,1054,52,4.31
-1,-1,0,-1.0,-1.0,0.8666989803314209,44.04543109109048,32,-34,-28,767,91,1194,1054,52,4.25
-1,-1,0,-1.0,-1.0,0.873417854309082,42.638011210655684,32,-33,-27,767,91,1194,1054,52,4.19
-1,0,0,-1.0,-0.0,0.904973030090332,41.86884283091664,32,-32,-27,767,91,1194,1054,52,1.36
-1,-1,0,-1.0,-1.0,0.9127578735351562,40.45985664828782,32,-31,-26,767,91,1194,1054,52,4.32
0,0,1,-0.0,-0.0,0.9187819957733154,40.45985664828782,32,-31,-26,767,91,1194,1054,52,39.16
-1,0,1,-1.0,-0.0,0.008712291717529297,969.3894986020841,33,904,350,1701,467,798,117,60,5.59
-1,0,1,-1.0,-0.0,0.0178072452545166,970.3221114660843,33,905,350,1701,467,798,117,60,5.59
-1,0,1,-1.0,-0.0,0.02516317367553711,971.2548584177069,33,906,350,1701,467,798,117,60,5.59
-2,0,1,-2.0,-0.0,0.032740116119384766,973.1207530414712,33,908,350,1701,467,798,117,60,3.88
0,-1,1,-0.0,-1.0,0.04102826118469238,973.4808678140521,33,908,351,1701,467,798,117,60,9.17
-2,0,1,-2.0,-0.0,0.048684120178222656,975.3466050589401,33,910,351,1701,467,798,117,60,3.88
-1,0,1,-1.0,-0.0,0.05673408508300781,976.2796730445637,33,911,351,1701,467,798,117,60,5.61
-1,-1,1,-1.0,-1.0,0.07230424880981445,977.5725037049682,33,912,352,1701,467,798,117,60,4.48
-1,0,1,-1.0,-0.0,0.07318711280822754,978.5054930862677,33,913,352,1701,467,798,117,60,5.61
0,0,0,-0.0,-0.0,0.0857851505279541,978.5054930862677,33,913,352,1701,467,798,117,60,203.1
-1,0,0,-1.0,-0.0,0.09696125984191895,979.4386147176351,33,914,352,1701,467,798,117,60,5.61
1,1,0,1.0,1.0,0.17668819427490234,978.1462058404153,33,913,351,1701,467,798,117,60,6.13
5,5,0,5.0,5.0,0.18485522270202637,971.6892507381153,33,908,346,1701,467,798,117,60,20.92
7,7,0,7.0,7.0,0.1929922103881836,962.6640120000332,33,901,339,1701,467,798,117,60,27.3
11,9,0,11.0,9.0,0.2025911808013916,949.2101980067429,33,890,330,1701,467,798,117,60,37.5
15,11,0,15.0,11.0,0.20974016189575195,931.3356000926841,33,875,319,1701,467,798,117,60,46.11
20,13,0,20.0,13.0,0.21677017211914062,908.1084736968376,33,855,306,1701,467,798,117,60,54.97
22,14,0,22.0,14.0,0.22473716735839844,882.6964370608958,33,833,292,1701,467,798,117,60,57.48
22,13,0,22.0,13.0,0.23272013664245605,857.649112399704,33,811,279,1701,467,798,117,60,56.15
21,12,0,21.0,12.0,0.24248123168945312,833.8998740856123,33,790,267,1701,467,798,117,60,53.37
19,13,0,19.0,13.0,0.24916720390319824,811.761664529682,33,771,254,1701,467,798,117,60,49.57
16,10,0,16.0,10.0,0.25687408447265625,793.4488011207781,33,755,244,1701,467,798,117,60,42.96
15,10,0,15.0,10.0,0.2660841941833496,776.1159707157173,33,740,234,1701,467,798,117,60,40.57
16,5,0,16.0,5.0,0.27268218994140625,759.353014085017,33,724,229,1701,467,798,117,60,43.13
19,1,0,19.0,1.0,0.2808382511138916,740.951415411294,33,705,228,1701,467,798,117,60,41.33
20,1,0,20.0,1.0,0.2886831760406494,721.6328706482265,33,685,227,1701,467,798,117,60,42.07
20,0,0,20.0,-0.0,0.3025181293487549,702.676312394263,33,665,227,1701,467,798,117,60,40.57
19,0,0,19.0,-0.0,0.3047642707824707,684.7225715572695,33,646,227,1701,467,798,117,60,38.37
17,2,0,17.0,2.0,0.31600117683410645,668.0314363860431,33,629,225,1701,467,798,117,60,36.41
18,4,0,18.0,4.0,0.32087206840515137,649.7399479791895,33,611,221,1701,467,798,117,60,38.98
19,6,0,19.0,6.0,0.3288002014160156,629.832517420306,33,592,215,1701,467,798,117,60,41.91
20,8,0,20.0,8.0,0.34357309341430664,608.3033782579215,33,572,207,1701,467,798,117,60,43.5
24,9,0,24.0,9.0,0.34469127655029297,582.6731502308992,33,548,198,1701,467,798,117,60,48.29
27,9,0,27.0,9.0,0.35353922843933105,554.2219771896456,33,521,189,1701,467,798,117,60,49.3
30,8,0,30.0,8.0,0.36498427391052246,523.2991496266739,33,491,181,1701,467,798,117,60,48.6
31,7,0,31.0,7.0,0.37158727645874023,491.8089059787348,33,460,174,1701,467,798,117,60,46.71
31,8,0,31.0,8.0,0.3772122859954834,459.9967391188768,33,429,166,1701,467,798,117,60,45.26
28,7,0,28.0,7.0,0.38744115829467773,431.3722290551398,33,401,159,1701,467,798,117,60,40.57
26,7,0,26.0,7.0,0.3930821418762207,404.63440288734716,33,375,152,1701,467,798,117,60,37.42
25,6,0,25.0,6.0,0.40836024284362793,379.23080043688435,33,350,146,1701,467,798,117,60,34.39
22,6,0,22.0,6.0,0.4089682102203369,356.62865841095834,33,328,140,1701,467,798,117,60,30.85
23,6,0,23.0,6.0,0.41698718070983887,333.1381094981479,33,305,134,1701,467,798,117,60,30.04
20,7,0,20.0,7.0,0.42556023597717285,312.0160252294744,33,285,127,1701,467,798,117,60,27.73
20,6,0,20.0,6.0,0.43288612365722656,291.3176959952828,33,265,121,1701,467,798,117,60,25.54
18,6,0,18.0,6.0,0.4407021999359131,272.45917125323564,33,247,115,1701,467,798,117,60,23.26
16,6,0,16.0,6.0,0.4487032890319824,255.42513580303722,33,231,109,1701,467,798,117,60,21.34
14,6,0,14.0,6.0,0.4584972858428955,240.20407989873945,33,217,103,1701,467,798,117,60,20.05
13,6,0,13.0,6.0,0.4648122787475586,225.88713996153035,33,204,97,1701,467,798,117,60,19.77
11,6,0,11.0,6.0,0.47281312942504883,213.37759957408838,33,193,91,1701,467,798,117,60,16.19
9,5,0,9.0,5.0,0.4808192253112793,203.1058837158589,33,184,86,1701,467,798,117,60,13.81
8,4,0,8.0,4.0,0.48978114128112793,194.164878389476,33,176,82,1701,467,798,117,60,13.47
5,5,0,5.0,5.0,0.4968221187591553,187.5366630821824,33,171,77,1701,467,798,117,60,8.18
6,5,0,6.0,5.0,0.5063261985778809,180.02499826412998,33,165,72,1701,467,798,117,60,9.01
5,4,0,5.0,4.0,0.5127542018890381,173.85051049680584,33,160,68,1701,467,798,117,60,7.85
6,6,0,6.0,6.0,0.5235722064971924,166.01204775557707,33,154,62,1701,467,798,117,60,8.31
7,5,0,7.0,5.0,0.5287392139434814,157.66420012165096,33,147,57,1701,467,798,117,60,9.05
7,6,0,7.0,6.0,0.5367262363433838,149.0,33,140,51,1701,467,798,117,60,8.44
7,6,0,7.0,6.0,0.5446932315826416,140.40655255364686,33,133,45,1701,467,798,117,60,7.99
8,4,0,8.0,4.0,0.5529811382293701,131.55227098001768,33,125,41,1701,467,798,117,60,9.14
8,4,0,8.0,4.0,0.5609712600708008,122.71104269787622,33,117,37,1701,467,798,117,60,8.69
7,4,0,7.0,4.0,0.5694911479949951,114.84337159801605,33,110,33,1701,467,798,117,60,7.37
5,3,0,5.0,3.0,0.5767462253570557,109.20164833920778,33,105,30,1701,467,798,117,60,5.82
5,2,0,5.0,2.0,0.5847132205963135,103.84603988597736,33,100,28,1701,467,798,117,60,6.73
4,3,0,4.0,3.0,0.5927290916442871,99.20181449953424,33,96,25,1701,467,798,117,60,4.49
5,3,0,5.0,3.0,0.6060972213745117,93.62157870918435,33,91,22,1701,467,798,117,60,5.14
7,4,0,7.0,4.0,0.6098182201385498,85.90692637965812,33,84,18,1701,467,798,117,60,5.76
7,3,0,7.0,3.0,0.6170322895050049,78.44743462982075,33,77,15,1701,467,798,117,60,5.89
7,2,0,7.0,2.0,0.6267602443695068,71.19691004531025,33,70,13,1701,467,798,117,60,6.62
6,3,0,6.0,3.0,0.6336202621459961,64.77653896280658,33,64,10,1701,467,798,117,60,4.47
5,1,0,5.0,1.0,0.6407592296600342,59.682493245507096,33,59,9,1701,467,798,117,60,6.4
4,1,0,4.0,1.0,0.6519412994384766,55.57877292636101,33,55,8,1701,467,798,117,60,5.01
2,1,0,2.0,1.0,0.6566951274871826,53.46026561849464,33,53,7,1701,467,798,117,60,2.8
1,0,0,1.0,-0.0,0.6647140979766846,52.46903848937962,33,52,7,1701,467,798,117,60,3.75
1,0,0,1.0,-0.0,0.7158641815185547,51.478150704935004,33,51,7,1701,467,798,117,60,3.72
2,0,0,2.0,-0.0,0.7211191654205322,49.49747468305833,33,49,7,1701,467,798,117,60,3.87
1,1,0,1.0,1.0,0.7290542125701904,48.373546489791295,33,48,6,1701,467,798,117,60,1.52
2,0,0,2.0,-0.0,0.737145185470581,46.389654018972806,33,46,6,1701,467,798,117,60,3.94
1,0,0,1.0,-0.0,0.7451672554016113,45.39823785126467,33,45,6,1701,467,798,117,60,3.7
2,0,0,2.0,-0.0,0.7527163028717041,43.41658669218482,33,43,6,1701,467,798,117,60,3.8
1,0,0,1.0,-0.0,0.7620961666107178,42.42640687119285,33,42,6,1701,467,798,117,60,3.58
2,0,0,2.0,-0.0,0.7687382698059082,40.44749683231337,33,40,6,1701,467,798,117,60,3.65
0,0,1,-0.0,-0.0,0.7852692604064941,40.44749683231337,33,40,6,1701,467,798,117,60,39.15
0,0,0,-0.0,-0.0,0.1063375473022461,1565.0958437105378,34,-1559,-138,102,323,1661,461,27,262.52
0,1,0,-0.0,1.0,0.12417244911193848,1565.1843341919825,34,-1559,-139,102,323,1661,461,27,75.71
-5,2,0,-5.0,2.0,0.137298583984375,1560.3836066813826,34,-1554,-141,102,323,1661,461,27,40.36
-6,2,0,-6.0,2.0,0.14589452743530273,1554.5909429814649,34,-1548,-143,102,323,1661,461,27,47.0
-7,2,0,-7.0,2.0,0.154463529586792,1547.80683549337,34,-1541,-145,102,323,1661,461,27,53.18
-9,2,0,-9.0,2.0,0.16153955459594727,1539.0363868343075,34,-1532,-147,102,323,1661,461,27,64.5
-10,2,0,-10.0,2.0,0.1701066493988037,1529.2759724784798,34,-1522,-149,102,323,1661,461,27,69.5
-10,1,0,-10.0,1.0,0.1774005889892578,1519.422258623323,34,-1512,-150,102,323,1661,461,27,70.27
-12,1,0,-12.0,1.0,0.1860215663909912,1507.5811752605562,34,-1500,-151,102,323,1661,461,27,79.48
-13,1,0,-13.0,1.0,0.19402647018432617,1494.7484738242752,34,-1487,-152,102,323,1661,461,27,83.47
-15,0,0,-15.0,-0.0,0.20133566856384277,1479.8270169178559,34,-1472,-152,102,323,1661,461,27,92.12
-17,0,0,-17.0,-0.0,0.21108460426330566,1462.9179744606326,34,-1455,-152,102,323,1661,461,27,98.73
-19,-1,0,-19.0,-1.0,0.21762347221374512,1443.9172413957804,34,-1436,-151,102,323,1661,461,27,105.71
-21,-1,0,-21.0,-1.0,0.22534751892089844,1422.928318644337,34,-1415,-150,102,323,1661,461,27,110.68
-23,-3,0,-23.0,-3.0,0.23358654975891113,1399.7403330618147,34,-1392,-147,102,323,1661,461,27,116.54
-27,-3,0,-27.0,-3.0,0.24260759353637695,1372.5745881371984,34,-1365,-144,102,323,1661,461,27,125.68
-25,-5,0,-25.0,-5.0,0.2503855228424072,1347.1900385617464,34,-1340,-139,102,323,1661,461,27,118.05
-24,-3,0,-24.0,-3.0,0.257387638092041,1323.00869233728,34,-1316,-136,102,323,1661,461,27,115.67
-25,-4,0,-25.0,-4.0,0.265338659286499,1297.7307116655597,34,-1291,-132,102,323,1661,461,27,116.06
-27,-3,0,-27.0,-3.0,0.2733275890350342,1270.5656220754597,34,-1264,-129,102,323,1661,461,27,120.44
-27,-4,0,-27.0,-4.0,0.28142547607421875,1243.2996420815057,34,-1237,-125,102,323,1661,461,27,117.89
-28,-3,0,-28.0,-3.0,0.289386510848999,1215.139909640038,34,-1209,-122,102,323,1661,461,27,119.78
-29,-3,0,-29.0,-3.0,0.2977485656738281,1185.9852444276025,34,-1180,-119,102,323,1661,461,27,120.41
-30,-3,0,-30.0,-3.0,0.3061704635620117,1155.8356284524198,34,-1150,-116,102,323,1661,461,27,120.71
-33,-3,0,-33.0,-3.0,0.3134615421295166,1122.70120691126,34,-1117,-113,102,323,1661,461,27,123.11
-34,-4,0,-34.0,-4.0,0.32132959365844727,1088.4714052284517,34,-1083,-109,102,323,1661,461,27,122.36
-35,-4,0,-35.0,-4.0,0.3293795585632324,1053.246884638165,34,-1048,-105,102,323,1661,461,27,121.73
-36,-3,0,-36.0,-3.0,0.3421056270599365,1017.1273273292779,34,-1012,-102,102,323,1661,461,27,120.45
-37,-4,0,-37.0,-4.0,0.34870457649230957,979.9127512181888,34,-975,-98,102,323,1661,461,27,119.94
-37,-3,0,-37.0,-3.0,0.35331058502197266,942.798493846909,34,-938,-95,102,323,1661,461,27,116.54
-36,-2,0,-36.0,-2.0,0.36132359504699707,906.7816716277408,34,-902,-93,102,323,1661,461,27,111.74
-36,-3,0,-36.0,-3.0,0.3693125247955322,870.664114340312,34,-866,-90,102,323,1661,461,27,110.12
-35,-2,0,-35.0,-2.0,0.37740063667297363,835.6464563438296,34,-831,-88,102,323,1661,461,27,105.3
-33,-2,0,-33.0,-2.0,0.3858034610748291,802.6207074328446,34,-798,-86,102,323,1661,461,27,100.37
-32,-1,0,-32.0,-1.0,0.39331865310668945,770.7016283880553,34,-766,-85,102,323,1661,461,27,95.93
-32,-2,0,-32.0,-2.0,0.40195250511169434,738.6778729595195,34,-734,-83,102,323,1661,461,27,94.2
-30,-1,0,-30.0,-1.0,0.4116666316986084,708.7594796544171,34,-704,-82,102,323,1661,461,27,88.58
-30,-1,0,-30.0,-1.0,0.4177815914154053,678.8497624658935,34,-674,-81,102,323,1661,461,27,86.23
-30,-1,0,-30.0,-1.0,0.42541956901550293,648.9499210262684,34,-644,-80,102,323,1661,461,27,83.81
-33,-1,0,-33.0,-1.0,0.43336057662963867,616.0860329531907,34,-611,-79,102,323,1661,461,27,84.48
-31,-1,0,-31.0,-1.0,0.4429914951324463,585.2213256538076,34,-580,-78,102,323,1661,461,27,79.57
-28,0,0,-28.0,-0.0,0.44931864738464355,557.4836320467176,34,-552,-78,102,323,1661,461,27,73.09
-30,-1,0,-30.0,-1.0,0.45896458625793457,527.648557280317,34,-522,-77,102,323,1661,461,27,73.26
-26,-1,0,-26.0,-1.0,0.46567559242248535,501.78880019386645,34,-496,-76,102,323,1661,461,27,66.38
-25,-2,0,-25.0,-2.0,0.47366762161254883,476.77772598979493,34,-471,-74,102,323,1661,461,27,63.71
-22,-2,0,-22.0,-2.0,0.4814295768737793,454.7361872558638,34,-449,-72,102,323,1661,461,27,58.19
-21,-3,0,-21.0,-3.0,0.489316463470459,433.5262391136204,34,-428,-69,102,323,1661,461,27,56.75
-18,-3,0,-18.0,-3.0,0.49886059761047363,415.27821999233237,34,-410,-66,102,323,1661,461,27,51.87
-18,-3,0,-18.0,-3.0,0.5076766014099121,397.0302255496425,34,-392,-63,102,323,1661,461,27,50.45
-16,-3,0,-16.0,-3.0,0.5132856369018555,380.7571404451924,34,-376,-60,102,323,1661,461,27,45.17
-18,-2,0,-18.0,-2.0,0.5251185894012451,362.66789215479224,34,-358,-58,102,323,1661,461,27,45.72
-17,-3,0,-17.0,-3.0,0.5313975811004639,345.4070062983668,34,-341,-55,102,323,1661,461,27,44.4
-16,-2,0,-16.0,-2.0,0.5373215675354004,329.2931824377784,34,-325,-53,102,323,1661,461,27,40.67
-17,-3,0,-17.0,-3.0,0.5455615520477295,312.03204963593083,34,-308,-50,102,323,1661,461,27,41.72
-16,-3,0,-16.0,-3.0,0.5538346767425537,295.758347304011,34,-292,-47,102,323,1661,461,27,38.56
-16,-3,0,-16.0,-3.0,0.5623824596405029,279.48524111301475,34,-276,-44,102,323,1661,461,27,37.14
-16,-4,0,-16.0,-4.0,0.573662519454956,263.0589287593181,34,-260,-40,102,323,1661,461,27,34.49
-16,-3,0,-16.0,-3.0,0.5779926776885986,246.78938388836744,34,-244,-37,102,323,1661,461,27,34.05
-14,-3,0,-14.0,-3.0,0.585350513458252,232.4994623649698,34,-230,-34,102,323,1661,461,27,29.86
-14,-4,0,-14.0,-4.0,0.5933375358581543,218.07338214463496,34,-216,-30,102,323,1661,461,27,27.78
-13,-3,0,-13.0,-3.0,0.6014285087585449,204.78769494283586,34,-203,-27,102,323,1661,461,27,25.92
-11,-3,0,-11.0,-3.0,0.6093225479125977,193.49418595916518,34,-192,-24,102,323,1661,461,27,22.22
-11,-2,0,-11.0,-2.0,0.6180374622344971,182.33211456021672,34,-181,-22,102,323,1661,461,27,22.35
-10,-2,0,-10.0,-2.0,0.6253955364227295,172.16561793807728,34,-171,-20,102,323,1661,461,27,20.07
-11,-1,0,-11.0,-1.0,0.6333065032958984,161.1241757155021,34,-160,-19,102,323,1661,461,27,21.42
-8,-2,0,-8.0,-2.0,0.6432144641876221,152.9477034806342,34,-152,-17,102,323,1661,461,27,15.82
-8,-2,0,-8.0,-2.0,0.6494166851043701,144.77914214416384,34,-144,-15,102,323,1661,461,27,15.2
-7,-1,0,-7.0,-1.0,0.6573336124420166,137.71347065556077,34,-137,-14,102,323,1661,461,27,15.09
-6,-1,0,-6.0,-1.0,0.6668014526367188,131.64345787011217,34,-131,-13,102,323,1661,461,27,13.02
-5,-1,0,-5.0,-1.0,0.6781995296478271,126.57013865837392,34,-126,-12,102,323,1661,461,27,11.05
-6,0,0,-6.0,-0.0,0.6816985607147217,120.59850745345068,34,-120,-12,102,323,1661,461,27,11.81
-6,-1,0,-6.0,-1.0,0.6930356025695801,114.5294721894762,34,-114,-11,102,323,1661,461,27,12.04
-8,-1,0,-8.0,-1.0,0.7001936435699463,106.47065323364932,34,-106,-10,102,323,1661,461,27,14.39
-6,-1,0,-6.0,-1.0,0.7053625583648682,100.40418317978589,34,-100,-9,102,323,1661,461,27,11.14
-7,-1,0,-7.0,-1.0,0.7173914909362793,93.34345183246653,34,-93,-8,102,323,1661,461,27,11.95
-4,0,0,-4.0,-0.0,0.7213225364685059,89.35882720806042,34,-89,-8,102,323,1661,461,27,8.41
-5,-1,0,-5.0,-1.0,0.7336654663085938,84.29116205154607,34,-84,-7,102,323,1661,461,27,8.84
-4,0,0,-4.0,-0.0,0.7388405799865723,80.30566605165541,34,-80,-7,102,323,1661,461,27,8.06
-5,0,0,-5.0,-0.0,0.7473244667053223,75.32595834106593,34,-75,-7,102,323,1661,461,27,8.57
-5,0,0,-5.0,-0.0,0.7582576274871826,70.34912934784623,34,-70,-7,102,323,1661,461,27,8.22
-6,-1,0,-6.0,-1.0,0.761338472366333,64.28063471995279,34,-64,-6,102,323,1661,461,27,9.05
-4,0,0,-4.0,-0.0,0.7693436145782471,60.29925372672534,34,-60,-6,102,323,1661,461,27,7.01
-3,0,0,-3.0,-0.0,0.7776956558227539,57.3149195236284,34,-57,-6,102,323,1661,461,27,6.12
-2,0,0,-2.0,-0.0,0.7854435443878174,55.326304774492215,34,-55,-6,102,323,1661,461,27,5.3
-2,0,0,-2.0,-0.0,0.7986016273498535,53.33854141237835,34,-53,-6,102,323,1661,461,27,5.2
-2,-1,0,-2.0,-1.0,0.8020195960998535,51.24451190127583,34,-51,-5,102,323,1661,461,27,3.61
-3,0,0,-3.0,-0.0,0.8092925548553467,48.25971404805462,34,-48,-5,102,323,1661,461,27,5.79
-4,0,0,-4.0,-0.0,0.8182096481323242,44.28317965096906,34,-44,-5,102,323,1661,461,27,6.06
-2,0,0,-2.0,-0.0,0.8256206512451172,42.2965719651132,34,-42,-5,102,323,1661,461,27,4.83
-3,0,0,-3.0,-0.0,0.8369846343994141,39.319206502675,34,-39,-5,102,323,1661,461,27,5.15
-1,0,0,-1.0,-0.0,0.8413386344909668,38.3275357934736,34,-38,-5,102,323,1661,461,27,4.07
-2,0,0,-2.0,-0.0,0.8496346473693848,36.345563690772494,34,-36,-5,102,323,1661,461,27,4.44
-1,0,0,-1.0,-0.0,0.8653585910797119,35.35533905932738,34,-35,-5,102,323,1661,461,27,3.91
-1,0,0,-1.0,-0.0,0.878786563873291,34.36568055487916,34,-34,-5,102,323,1661,461,27,3.85
-1,0,0,-1.0,-0.0,0.8852076530456543,33.37663853655727,34,-33,-5,102,323,1661,461,27,3.79
-1,-1,0,-1.0,-1.0,0.8915066719055176,32.2490309931942,34,-32,-4,102,323,1661,461,27,1.74
-1,0,0,-1.0,-0.0,0.897876501083374,31.25699921617557,34,-31,-4,102,323,1661,461,27,3.96
-1,0,0,-1.0,-0.0,0.9063096046447754,30.265491900843113,34,-30,-4,102,323,1661,461,27,3.9
-1,0,0,-1.0,-0.0,0.9160234928131104,29.274562336608895,34,-29,-4,102,323,1661,461,27,3.84
-2,0,0,-2.0,-0.0,0.9232625961303711,27.294688127912362,34,-27,-4,102,323,1661,461,27,4.04
-1,-1,0,-1.0,-1.0,0.9295566082000732,26.1725046566048,34,-26,-3,102,323,1661,461,27,1.56
-2,0,0,-2.0,-0.0,0.9373326301574707,24.186773244895647,34,-24,-3,102,323,1661,461,27,4.14
-2,0,0,-2.0,-0.0,0.9457366466522217,22.20360331117452,34,-22,-3,102,323,1661,461,27,3.94
-2,0,0,-2.0,-0.0,0.9537315368652344,20.223748416156685,34,-20,-3,102,323,1661,461,27,3.72
-1,0,0,-1.0,-0.0,0.961322546005249,19.235384061671343,34,-19,-3,102,323,1661,461,27,3.41
-2,-1,0,-2.0,-1.0,0.9693114757537842,17.11724276862369,34,-17,-2,102,323,1661,461,27,2.4
0,0,1,-0.0,-0.0,0.9803376197814941,17.11724276862369,34,-17,-2,102,323,1661,461,27,32.03
0,0,0,-0.0,-0.0,0.09541869163513184,1235.840200025877,35,1215,226,1334,551,119,325,55,231.39
1,0,0,1.0,-0.0,0.14302968978881836,1234.85707675018,35,1214,226,1334,551,119,325,55,7.05
2,0,0,2.0,-0.0,0.15153765678405762,1232.8909116381708,35,1212,226,1334,551,119,325,55,10.84
2,0,0,2.0,-0.0,0.15841054916381836,1230.9248555456177,35,1210,226,1334,551,119,325,55,10.83
4,1,0,4.0,1.0,0.1663985252380371,1226.8092761305647,35,1206,225,1334,551,119,325,55,20.03
7,1,0,7.0,1.0,0.17791962623596191,1219.7446454073902,35,1199,224,1334,551,119,325,55,30.2
10,1,0,10.0,1.0,0.18900465965270996,1209.731375140779,35,1189,223,1334,551,119,325,55,38.2
13,3,0,13.0,3.0,0.1932387351989746,1196.4012704774264,35,1176,220,1334,551,119,325,55,47.83
17,4,0,17.0,4.0,0.19842958450317383,1178.9558940011284,35,1159,216,1334,551,119,325,55,57.33
22,4,0,22.0,4.0,0.2064046859741211,1156.5954348863738,35,1137,212,1334,551,119,325,55,68.83
26,5,0,26.0,5.0,0.21584773063659668,1130.1194627117966,35,1111,207,1334,551,119,325,55,75.58
30,6,0,30.0,6.0,0.2249295711517334,1099.5280805873035,35,1081,201,1334,551,119,325,55,80.82
33,5,0,33.0,5.0,0.2304086685180664,1066.1707180372193,35,1048,196,1334,551,119,325,55,82.81
36,7,0,36.0,7.0,0.23975467681884766,1029.4974502153952,35,1012,189,1334,551,119,325,55,86.97
37,8,0,37.0,8.0,0.24640274047851562,991.6582072468316,35,975,181,1334,551,119,325,55,85.65
38,7,0,38.0,7.0,0.25655674934387207,953.0188875358137,35,937,174,1334,551,119,325,55,86.3
35,9,0,35.0,9.0,0.2626936435699463,916.9672840401669,35,902,165,1334,551,119,325,55,78.8
37,9,0,37.0,9.0,0.27468371391296387,878.9544925648881,35,865,156,1334,551,119,325,55,79.43
34,10,0,34.0,10.0,0.27842068672180176,843.7280367511797,35,831,146,1334,551,119,325,55,73.54
31,8,0,31.0,8.0,0.2883336544036865,811.8152499183543,35,800,138,1334,551,119,325,55,68.25
30,9,0,30.0,9.0,0.2948586940765381,780.7310676539009,35,770,129,1334,551,119,325,55,65.13
28,9,0,28.0,9.0,0.3029756546020508,751.6408716933905,35,742,120,1334,551,119,325,55,60.92
29,8,0,29.0,8.0,0.3108646869659424,721.7430290622833,35,713,112,1334,551,119,325,55,60.84
30,8,0,30.0,8.0,0.318401575088501,690.8726365980925,35,683,104,1334,551,119,325,55,60.46
30,7,0,30.0,7.0,0.32666468620300293,660.1651308574242,35,653,97,1334,551,119,325,55,59.01
31,7,0,31.0,7.0,0.3377726078033447,628.4775254533769,35,622,90,1334,551,119,325,55,58.41
30,7,0,30.0,7.0,0.3432495594024658,597.7900969403893,35,592,83,1334,551,119,325,55,55.42
28,6,0,28.0,6.0,0.3506176471710205,569.2319386682374,35,564,77,1334,551,119,325,55,51.73
29,6,0,29.0,6.0,0.3621037006378174,539.6906521332382,35,535,71,1334,551,119,325,55,51.14
26,7,0,26.0,7.0,0.3672785758972168,513.0077972116993,35,509,64,1334,551,119,325,55,45.77
26,6,0,26.0,6.0,0.37437868118286133,486.4699374062081,35,483,58,1334,551,119,325,55,44.44
24,6,0,24.0,6.0,0.38245558738708496,461.93614277300276,35,459,52,1334,551,119,325,55,40.69
23,6,0,23.0,6.0,0.3904097080230713,438.41989005974625,35,436,46,1334,551,119,325,55,38.15
21,5,0,21.0,5.0,0.40004873275756836,417.02038319487457,35,415,41,1334,551,119,325,55,34.91
20,5,0,20.0,5.0,0.4119987487792969,396.63711374504527,35,395,36,1334,551,119,325,55,32.58
20,4,0,20.0,4.0,0.43054652214050293,376.36285682835387,35,375,32,1334,551,119,325,55,31.8
19,4,0,19.0,4.0,0.4318966865539551,357.0994259306503,35,356,28,1334,551,119,325,55,29.57
19,3,0,19.0,3.0,0.43204474449157715,337.9260274083664,35,337,25,1334,551,119,325,55,29.03
19,4,0,19.0,4.0,0.4392416477203369,318.69264189811474,35,318,21,1334,551,119,325,55,27.32
18,3,0,18.0,3.0,0.4465336799621582,300.53951487283666,35,300,18,1334,551,119,325,55,25.72
17,4,0,17.0,4.0,0.4545316696166992,283.346078144731,35,283,14,1334,551,119,325,55,23.19
15,2,0,15.0,2.0,0.46242475509643555,268.26852219371546,35,268,12,1334,551,119,325,55,21.47
15,3,0,15.0,3.0,0.47205471992492676,253.16002844051033,35,253,9,1334,551,119,325,55,19.93
13,2,0,13.0,2.0,0.47849059104919434,240.10206163213175,35,240,7,1334,551,119,325,55,17.86
13,2,0,13.0,2.0,0.4879636764526367,227.05505940189926,35,227,5,1334,551,119,325,55,17.16
13,2,0,13.0,2.0,0.4946446418762207,214.02102700435768,35,214,3,1334,551,119,325,55,16.44
12,1,0,12.0,1.0,0.5035006999969482,202.00990074746338,35,202,2,1334,551,119,325,55,15.88
12,2,0,12.0,2.0,0.5104105472564697,190.0,35,190,0,1334,551,119,325,55,14.26
13,1,0,13.0,1.0,0.5183775424957275,177.00282483621552,35,177,-1,1334,551,119,325,55,15.24
12,1,0,12.0,1.0,0.5288715362548828,165.01212076693034,35,165,-2,1334,551,119,325,55,13.76
13,2,0,13.0,2.0,0.5400946140289307,152.0526224699857,35,152,-4,1334,551,119,325,55,12.87
12,1,0,12.0,1.0,0.5433957576751709,140.089257261219,35,140,-5,1334,551,119,325,55,12.19
12,1,0,12.0,1.0,0.5504157543182373,128.14054783713078,35,128,-6,1334,551,119,325,55,11.43
12,1,0,12.0,1.0,0.5583615303039551,116.21101496846157,35,116,-7,1334,551,119,325,55,10.64
10,1,0,10.0,1.0,0.5663816928863525,106.30145812734649,35,106,-8,1334,551,119,325,55,8.84
10,1,0,10.0,1.0,0.5744225978851318,96.42095207992918,35,96,-9,1334,551,119,325,55,8.2
8,0,0,8.0,-0.0,0.5857326984405518,88.45903006477066,35,88,-9,1334,551,119,325,55,7.83
7,0,0,7.0,-0.0,0.5903546810150146,81.49846624323675,35,81,-9,1334,551,119,325,55,7.0
7,0,0,7.0,-0.0,0.5983796119689941,74.54528824815154,35,74,-9,1334,551,119,325,55,6.6
6,0,0,6.0,-0.0,0.6064636707305908,68.59300255857006,35,68,-9,1334,551,119,325,55,5.87
5,-1,0,5.0,-1.0,0.6155436038970947,63.50590523722971,35,63,-8,1334,551,119,325,55,6.18
5,0,0,5.0,-0.0,0.6227335929870605,58.54912467321779,35,58,-8,1334,551,119,325,55,5.11
4,-1,0,4.0,-1.0,0.6305465698242188,54.45181356024793,35,54,-7,1334,551,119,325,55,4.93
3,0,0,3.0,-0.0,0.6383795738220215,51.478150704935004,35,51,-7,1334,551,119,325,55,4.31
2,-1,0,2.0,-1.0,0.6509265899658203,49.36598018878993,35,49,-6,1334,551,119,325,55,2.76
2,0,0,2.0,-0.0,0.6583817005157471,47.38143096192854,35,47,-6,1334,551,119,325,55,4.05
2,0,0,2.0,-0.0,0.6624696254730225,45.39823785126467,35,45,-6,1334,551,119,325,55,3.96
1,0,0,1.0,-0.0,0.6704936027526855,44.40720662234904,35,44,-6,1334,551,119,325,55,3.7
2,0,0,2.0,-0.0,0.6783826351165771,42.42640687119285,35,42,-6,1334,551,119,325,55,3.81
1,0,0,1.0,-0.0,0.6878557205200195,41.43669871020132,35,41,-6,1334,551,119,325,55,3.58
2,0,0,2.0,-0.0,0.6948356628417969,39.45883931389772,35,39,-6,1334,551,119,325,55,3.66
1,0,0,1.0,-0.0,0.7103695869445801,38.47076812334269,35,38,-6,1334,551,119,325,55,3.44
1,0,0,1.0,-0.0,0.7425355911254883,37.48332962798263,35,37,-6,1334,551,119,325,55,3.4
0,0,1,-0.0,-0.0,0.7754266262054443,37.48332962798263,35,37,-6,1334,551,119,325,55,38.239999999999995
0,0,0,-0.0,-0.0,0.08597254753112793,1281.0308349138204,36,-1176,-508,121,49,1297,557,45,235.96
-1,0,0,-1.0,-0.0,0.09098243713378906,1280.1128856471994,36,-1175,-508,121,49,1297,557,45,6.61
-2,0,0,-2.0,-0.0,0.0994575023651123,1278.277356444993,36,-1173,-508,121,49,1297,557,45,10.99
-2,2,0,-2.0,2.0,0.10788154602050781,1277.2396016409764,36,-1171,-510,121,49,1297,557,45,5.66
-3,1,0,-3.0,1.0,0.11496448516845703,1274.8901913498275,36,-1168,-511,121,49,1297,557,45,12.53
-4,2,0,-4.0,2.0,0.12471437454223633,1272.0318392241602,36,-1164,-513,121,49,1297,557,45,14.57
-4,1,0,-4.0,1.0,0.13108348846435547,1268.7773642369255,36,-1160,-514,121,49,1297,557,45,16.71
-5,1,0,-5.0,1.0,0.14037036895751953,1264.614565786746,36,-1155,-515,121,49,1297,557,45,20.69
-5,2,0,-5.0,2.0,0.14699745178222656,1260.8683515736288,36,-1150,-517,121,49,1297,557,45,18.51
-6,1,0,-6.0,1.0,0.15533852577209473,1255.8104952579429,36,-1144,-518,121,49,1297,557,45,24.38
-7,1,0,-7.0,1.0,0.1630403995513916,1249.8519912373624,36,-1137,-519,121,49,1297,557,45,27.95
-7,1,0,-7.0,1.0,0.1709744930267334,1243.9051410778877,36,-1130,-520,121,49,1297,557,45,27.83
-7,1,0,-7.0,1.0,0.17893338203430176,1237.970112724859,36,-1123,-521,121,49,1297,557,45,27.7
-7,0,0,-7.0,-0.0,0.18703937530517578,1231.6237250069519,36,-1116,-521,121,49,1297,557,45,29.6
-8,0,0,-8.0,-0.0,0.19508838653564453,1224.37943465251,36,-1108,-521,121,49,1297,557,45,32.86
-9,0,0,-9.0,-0.0,0.20310640335083008,1216.240930079234,36,-1099,-521,121,49,1297,557,45,35.95
-10,0,0,-10.0,-0.0,0.21097946166992188,1207.212491651739,36,-1089,-521,121,49,1297,557,45,38.88
-13,-2,0,-13.0,-2.0,0.21905040740966797,1194.6283941042084,36,-1076,-519,121,49,1297,557,45,50.53
-14,-2,0,-14.0,-2.0,0.22843050956726074,1181.157483149474,36,-1062,-517,121,49,1297,557,45,52.74
-14,-4,0,-14.0,-4.0,0.23654437065124512,1166.8217515970466,36,-1048,-513,121,49,1297,557,45,55.59
-14,-5,0,-14.0,-5.0,0.2429823875427246,1152.050346122078,36,-1034,-508,121,49,1297,557,45,56.97
-13,-6,0,-13.0,-6.0,0.25182151794433594,1137.7367885411809,36,-1021,-502,121,49,1297,557,45,57.03
-15,-7,0,-15.0,-7.0,0.25914740562438965,1121.1873170884514,36,-1006,-495,121,49,1297,557,45,62.6
-17,-9,0,-17.0,-9.0,0.26781344413757324,1101.9605256087896,36,-989,-486,121,49,1297,557,45,68.09
-16,-9,0,-16.0,-9.0,0.27526140213012695,1083.6318563054522,36,-973,-477,121,49,1297,557,45,64.75
-20,-12,0,-20.0,-12.0,0.2834775447845459,1060.3933232532163,36,-953,-465,121,49,1297,557,45,73.98
-21,-14,0,-21.0,-14.0,0.29128456115722656,1035.3864013014659,36,-932,-451,121,49,1297,557,45,75.78
-24,-15,0,-24.0,-15.0,0.2999684810638428,1007.2536919763561,36,-908,-436,121,49,1297,557,45,80.36
-24,-15,0,-24.0,-15.0,0.3082313537597656,979.130736929446,36,-884,-421,121,49,1297,557,45,79.03
-26,-15,0,-26.0,-15.0,0.31499433517456055,949.2101980067429,36,-858,-406,121,49,1297,557,45,80.91
-27,-14,0,-27.0,-14.0,0.32477736473083496,918.8171744150193,36,-831,-392,121,49,1297,557,45,81.02
-28,-14,0,-28.0,-14.0,0.3310394287109375,887.5207039838564,36,-803,-378,121,49,1297,557,45,81.2
-28,-14,0,-28.0,-14.0,0.3406693935394287,856.2248536453494,36,-775,-364,121,49,1297,557,45,79.53
-30,-14,0,-30.0,-14.0,0.3470344543457031,823.1190679361036,36,-745,-350,121,49,1297,557,45,81.44
-28,-14,0,-28.0,-14.0,0.36052846908569336,791.8238440461363,36,-717,-336,121,49,1297,557,45,76.01
-28,-13,0,-28.0,-13.0,0.3731215000152588,760.9533494242601,36,-689,-323,121,49,1297,557,45,74.93
-30,-14,0,-30.0,-14.0,0.3785884380340576,727.8475115022377,36,-659,-309,121,49,1297,557,45,76.01
-30,-13,0,-30.0,-13.0,0.37985849380493164,695.1668864380696,36,-629,-296,121,49,1297,557,45,71.92
-30,-14,0,-30.0,-14.0,0.3876683712005615,662.0611754211237,36,-599,-282,121,49,1297,557,45,71.82
-31,-13,0,-31.0,-13.0,0.39533138275146484,628.4783210262706,36,-568,-269,121,49,1297,557,45,68.29
-29,-13,0,-29.0,-13.0,0.406266450881958,596.7051198037436,36,-539,-256,121,49,1297,557,45,64.98
-30,-12,0,-30.0,-12.0,0.42360854148864746,564.4616904626921,36,-509,-244,121,49,1297,557,45,62.12
-29,-11,0,-29.0,-11.0,0.4237353801727295,533.5625549080445,36,-480,-233,121,49,1297,557,45,58.24
-26,-9,0,-26.0,-9.0,0.42934656143188477,506.2529012262547,36,-454,-224,121,49,1297,557,45,52.13
-23,-9,0,-23.0,-9.0,0.43587255477905273,481.64924997346355,36,-431,-215,121,49,1297,557,45,47.94
-21,-8,0,-21.0,-8.0,0.44637250900268555,459.29184621545375,36,-410,-207,121,49,1297,557,45,43.75
-19,-7,0,-19.0,-7.0,0.45880937576293945,439.1821945388952,36,-391,-200,121,49,1297,557,45,39.65
-17,-7,0,-17.0,-7.0,0.4653193950653076,420.86221023037933,36,-374,-193,121,49,1297,557,45,36.81
-17,-7,0,-17.0,-7.0,0.4723093509674072,402.54813376787627,36,-357,-186,121,49,1297,557,45,35.73
-15,-6,0,-15.0,-6.0,0.47970151901245117,386.47638996451,36,-342,-180,121,49,1297,557,45,31.86
-15,-6,0,-15.0,-6.0,0.48878955841064453,370.4119328531412,36,-327,-174,121,49,1297,557,45,30.95
-13,-5,0,-13.0,-5.0,0.4941885471343994,356.59080190044165,36,-314,-169,121,49,1297,557,45,27.2
-12,-5,0,-12.0,-5.0,0.49903035163879395,343.6568055487917,36,-302,-164,121,49,1297,557,45,25.69
-14,-5,0,-14.0,-5.0,0.5097684860229492,328.97568299191965,36,-288,-159,121,49,1297,557,45,26.56
-14,-6,0,-14.0,-6.0,0.5259783267974854,313.82319863260585,36,-274,-153,121,49,1297,557,45,26.87
-14,-5,0,-14.0,-5.0,0.5262763500213623,299.17219122104245,36,-260,-148,121,49,1297,557,45,24.83
-16,-6,0,-16.0,-6.0,0.5323224067687988,282.3118842698621,36,-244,-142,121,49,1297,557,45,26.22
-14,-6,0,-14.0,-6.0,0.5422253608703613,267.20029940102984,36,-230,-136,121,49,1297,557,45,23.92
-14,-5,0,-14.0,-5.0,0.550187349319458,252.62026838715852,36,-216,-131,121,49,1297,557,45,21.94
-12,-5,0,-12.0,-5.0,0.556098461151123,239.774894432257,36,-204,-126,121,49,1297,557,45,19.83
-11,-5,0,-11.0,-5.0,0.5635294914245605,227.79376637651873,36,-193,-121,121,49,1297,557,45,18.57
-11,-4,0,-11.0,-4.0,0.5721583366394043,216.3631207022121,36,-182,-117,121,49,1297,557,45,16.75
-10,-4,0,-10.0,-4.0,0.5819635391235352,205.7984450864486,36,-172,-113,121,49,1297,557,45,15.53
-11,-5,0,-11.0,-5.0,0.593799352645874,193.86851214160592,36,-161,-108,121,49,1297,557,45,16.44
-10,-4,0,-10.0,-4.0,0.5949745178222656,183.34939323597447,36,-151,-104,121,49,1297,557,45,14.23
-10,-3,0,-10.0,-3.0,0.6033525466918945,173.44163283364233,36,-141,-101,121,49,1297,557,45,12.65
-9,-4,0,-9.0,-4.0,0.6115114688873291,163.8078142214223,36,-132,-97,121,49,1297,557,45,12.55
-9,-3,0,-9.0,-3.0,0.6189744472503662,154.80633061990713,36,-123,-94,121,49,1297,557,45,11.0
-10,-4,0,-10.0,-4.0,0.6293454170227051,144.46106741956464,36,-113,-90,121,49,1297,557,45,11.68
-10,-4,0,-10.0,-4.0,0.634972333908081,134.18271125595876,36,-103,-86,121,49,1297,557,45,10.97
-10,-3,0,-10.0,-3.0,0.6434094905853271,124.65151423067431,36,-93,-83,121,49,1297,557,45,9.48
-8,-4,0,-8.0,-4.0,0.6514174938201904,116.04309544302927,36,-85,-79,121,49,1297,557,45,9.05
-7,-3,0,-7.0,-3.0,0.6589553356170654,108.90362712049586,36,-78,-76,121,49,1297,557,45,7.41
-5,-2,0,-5.0,-2.0,0.6677834987640381,103.9471019317037,36,-73,-74,121,49,1297,557,45,5.63
-5,-3,0,-5.0,-3.0,0.6754765510559082,98.3107318658548,36,-68,-71,121,49,1297,557,45,6.5
-6,-4,0,-6.0,-4.0,0.6831843852996826,91.28526715741155,36,-62,-67,121,49,1297,557,45,7.2
-4,-3,0,-4.0,-3.0,0.6918213367462158,86.37129152675674,36,-58,-64,121,49,1297,557,45,6.11
-5,-4,0,-5.0,-4.0,0.7008073329925537,80.05623023850174,36,-53,-60,121,49,1297,557,45,6.76
-6,-3,0,-6.0,-3.0,0.7083163261413574,73.87827826905551,36,-47,-57,121,49,1297,557,45,5.17
-6,-4,0,-6.0,-4.0,0.715050458908081,67.00746227100382,36,-41,-53,121,49,1297,557,45,5.54
-6,-4,0,-6.0,-4.0,0.7229523658752441,60.21627686929839,36,-35,-49,121,49,1297,557,45,5.01
-5,-3,0,-5.0,-3.0,0.7316515445709229,54.91812087098393,36,-30,-46,121,49,1297,557,45,3.87
-4,-4,0,-4.0,-4.0,0.7389624118804932,49.39635614091387,36,-26,-42,121,49,1297,557,45,4.68
-5,-3,0,-5.0,-3.0,0.7471513748168945,44.294469180700204,36,-21,-39,121,49,1297,557,45,3.08
-4,-4,0,-4.0,-4.0,0.7549824714660645,38.91015291668744,36,-17,-35,121,49,1297,557,45,3.62
-5,-4,0,-5.0,-4.0,0.7631423473358154,33.24154027718932,36,-12,-31,121,49,1297,557,45,2.71
-3,-3,0,-3.0,-3.0,0.7709684371948242,29.410882339705484,36,-9,-28,121,49,1297,557,45,2.28
-3,-3,0,-3.0,-3.0,0.7789795398712158,25.709920264364882,36,-6,-25,121,49,1297,557,45,1.85
-2,-3,0,-2.0,-3.0,0.786982536315918,22.360679774997898,36,-4,-22,121,49,1297,557,45,2.09
-2,-2,0,-2.0,-2.0,0.7949504852294922,20.09975124224178,36,-2,-20,121,49,1297,557,45,1.07
-2,-3,0,-2.0,-3.0,0.8030743598937988,17.0,36,0,-17,121,49,1297,557,45,1.21
-1,-2,0,-1.0,-2.0,0.8136804103851318,15.033296378372908,36,1,-15,121,49,1297,557,45,1.22
-2,-2,0,-2.0,-2.0,0.8197343349456787,13.341664064126334,36,3,-13,121,49,1297,557,45,0.01
-1,-2,0,-1.0,-2.0,0.8269903659820557,11.704699910719626,36,4,-11,121,49,1297,557,45,0.34
-1,-2,0,-1.0,-2.0,0.8375544548034668,10.295630140987,36,5,-9,121,49,1297,557,45,-0.06
0,-1,0,-0.0,-1.0,0.8439404964447021,9.433981132056603,36,5,-8,121,49,1297,557,45,0.99
0,0,1,-0.0,-0.0,0.8749663829803467,9.433981132056603,36,5,-8,121,49,1297,557,45,29.71
0,0,0,-0.0,-0.0,0.07988405227661133,769.7298227300278,37,728,250,844,307,116,57,47,176.57
1,2,0,1.0,2.0,0.13147616386413574,768.1360556568087,37,727,248,844,307,116,57,47,6.67
4,3,0,4.0,3.0,0.13390612602233887,763.3832589204455,37,723,245,844,307,116,57,47,17.83
4,4,0,4.0,4.0,0.14198899269104004,758.31523787934,37,719,241,844,307,116,57,47,18.16
6,5,0,6.0,5.0,0.15053319931030273,751.0426086448092,37,713,236,844,307,116,57,47,24.46
9,7,0,9.0,7.0,0.15911316871643066,740.3087193867163,37,704,229,844,307,116,57,47,32.93
12,9,0,12.0,9.0,0.16581511497497559,726.1294650404982,37,692,220,844,307,116,57,47,40.06
14,10,0,14.0,10.0,0.17522120475769043,709.7774299032056,37,678,210,844,307,116,57,47,43.81
18,11,0,18.0,11.0,0.18217110633850098,689.3482429077484,37,660,199,844,307,116,57,47,50.41
19,10,0,19.0,10.0,0.19000911712646484,668.2828742381478,37,641,189,844,307,116,57,47,50.82
22,13,0,22.0,13.0,0.19784116744995117,643.5347698454218,37,619,176,844,307,116,57,47,54.64
24,12,0,24.0,12.0,0.20642304420471191,617.1879778479163,37,595,164,844,307,116,57,47,55.7
26,13,0,26.0,13.0,0.21382522583007812,588.6951672979828,37,569,151,844,307,116,57,47,56.6
25,13,0,25.0,13.0,0.2218320369720459,561.2307903171386,37,544,138,844,307,116,57,47,53.57
28,14,0,28.0,14.0,0.23023700714111328,530.6901167348041,37,516,124,844,307,116,57,47,55.02
28,14,0,28.0,14.0,0.23965215682983398,500.24394049303584,37,488,110,844,307,116,57,47,52.78
26,14,0,26.0,14.0,0.24718904495239258,471.86862578476223,37,462,96,844,307,116,57,47,48.53
25,12,0,25.0,12.0,0.25384521484375,445.0,37,437,84,844,307,116,57,47,45.36
23,12,0,23.0,12.0,0.26195406913757324,420.21423107743504,37,414,72,844,307,116,57,47,41.34
24,11,0,24.0,11.0,0.2698390483856201,394.7416876895573,37,390,61,844,307,116,57,47,40.47
23,10,0,23.0,10.0,0.2829442024230957,370.52665221276595,37,367,51,844,307,116,57,47,37.61
24,9,0,24.0,9.0,0.2859020233154297,345.56186132152953,37,343,42,844,307,116,57,47,36.74
22,9,0,22.0,9.0,0.29679012298583984,322.69180342859653,37,321,33,844,307,116,57,47,32.98
24,9,0,24.0,9.0,0.30177807807922363,297.9681191000138,37,297,24,844,307,116,57,47,32.77
21,6,0,21.0,6.0,0.3098111152648926,276.5863337187866,37,276,18,844,307,116,57,47,28.84
21,5,0,21.0,5.0,0.320634126663208,255.3311575190149,37,255,13,844,307,116,57,47,27.41
19,5,0,19.0,5.0,0.3257920742034912,236.13555429032706,37,236,8,844,307,116,57,47,24.13
16,3,0,16.0,3.0,0.334334135055542,220.05681084665386,37,220,5,844,307,116,57,47,20.98
15,2,0,15.0,2.0,0.3454561233520508,205.0219500443794,37,205,3,844,307,116,57,47,19.62
11,2,0,11.0,2.0,0.3506660461425781,194.0025773024678,37,194,1,844,307,116,57,47,15.11
12,2,0,12.0,2.0,0.3578050136566162,182.00274723201295,37,182,-1,844,307,116,57,47,15.34
10,1,0,10.0,1.0,0.36582016944885254,172.01162751395617,37,172,-2,844,307,116,57,47,13.76
9,2,0,9.0,2.0,0.37494516372680664,163.04907236779974,37,163,-4,844,307,116,57,47,11.44
9,1,0,9.0,1.0,0.38197803497314453,154.0811474515945,37,154,-5,844,307,116,57,47,11.77
10,1,0,10.0,1.0,0.3900270462036133,144.12494579357175,37,144,-6,844,307,116,57,47,12.05
9,1,0,9.0,1.0,0.39798808097839355,135.18135966175217,37,135,-7,844,307,116,57,47,10.71
8,2,0,8.0,2.0,0.40729308128356934,127.3184982632139,37,127,-9,844,307,116,57,47,8.67
9,0,0,9.0,-0.0,0.41379714012145996,118.3427226321923,37,118,-9,844,307,116,57,47,10.92
9,1,0,9.0,1.0,0.4218771457672119,109.45775440780794,37,109,-10,844,307,116,57,47,9.12
7,0,0,7.0,-0.0,0.4302542209625244,102.48902380255166,37,102,-10,844,307,116,57,47,8.64
8,1,0,8.0,1.0,0.437913179397583,94.64142856064674,37,94,-11,844,307,116,57,47,7.57
8,0,0,8.0,-0.0,0.44584012031555176,86.70063436907483,37,86,-11,844,307,116,57,47,8.12
6,1,0,6.0,1.0,0.4584832191467285,80.89499366462674,37,80,-12,844,307,116,57,47,5.55
6,0,0,6.0,-0.0,0.46351003646850586,74.96665925596525,37,74,-12,844,307,116,57,47,6.31
3,1,0,3.0,1.0,0.4716150760650635,72.18032973047436,37,71,-13,844,307,116,57,47,3.11
4,0,0,4.0,-0.0,0.47783708572387695,68.24954212300622,37,67,-13,844,307,116,57,47,4.91
2,0,0,2.0,-0.0,0.4863932132720947,66.2872536767062,37,65,-13,844,307,116,57,47,3.93
1,0,0,1.0,-0.0,0.4939432144165039,65.30696746902278,37,64,-13,844,307,116,57,47,3.45
2,0,0,2.0,-0.0,0.5044960975646973,63.34824385884742,37,62,-13,844,307,116,57,47,3.82
3,0,0,3.0,-0.0,0.5116190910339355,60.41522986797286,37,59,-13,844,307,116,57,47,4.1
3,0,0,3.0,-0.0,0.5198230743408203,57.48912940721924,37,56,-13,844,307,116,57,47,3.96
4,0,0,4.0,-0.0,0.525825023651123,53.600373133029585,37,52,-13,844,307,116,57,47,4.1
2,-1,0,2.0,-1.0,0.5338301658630371,51.419840528729765,37,50,-12,844,307,116,57,47,3.55
2,0,0,2.0,-0.0,0.5418012142181396,49.47726750741192,37,48,-12,844,307,116,57,47,3.33
2,0,0,2.0,-0.0,0.5501391887664795,47.53945729601885,37,46,-12,844,307,116,57,47,3.24
3,0,0,3.0,-0.0,0.5578160285949707,44.64302857109943,37,43,-12,844,307,116,57,47,3.36
2,0,0,2.0,-0.0,0.5658621788024902,42.720018726587654,37,41,-12,844,307,116,57,47,2.98
2,0,0,2.0,-0.0,0.5738000869750977,40.80441152620633,37,39,-12,844,307,116,57,47,2.87
2,0,0,2.0,-0.0,0.5817902088165283,38.897300677553446,37,37,-12,844,307,116,57,47,2.76
2,0,0,2.0,-0.0,0.5898001194000244,37.0,37,35,-12,844,307,116,57,47,2.64
2,0,0,2.0,-0.0,0.6006081104278564,35.11409973215888,37,33,-12,844,307,116,57,47,2.52
2,0,0,2.0,-0.0,0.6094701290130615,33.24154027718932,37,31,-12,844,307,116,57,47,2.39
0,0,1,-0.0,-0.0,0.6097021102905273,33.24154027718932,37,31,-12,844,307,116,57,47,36.95
1,0,1,1.0,-0.0,0.6152200698852539,32.31098884280702,37,30,-12,844,307,116,57,47,12.2
1,0,1,1.0,-0.0,0.003473520278930664,737.2604695763906,38,417,608,1232,927,814,319,73,2.08
0,0,0,-0.0,-0.0,0.08747339248657227,737.2604695763906,38,417,608,1232,927,814,319,73,172.08
0,1,0,-0.0,1.0,0.10748434066772461,736.4360121558424,38,417,607,1232,927,814,319,73,3.32
0,1,0,-0.0,1.0,0.1163644790649414,735.6119901143537,38,417,606,1232,927,814,319,73,3.32
0,1,0,-0.0,1.0,0.12357330322265625,734.7884049166807,38,417,605,1232,927,814,319,73,3.32
0,1,0,-0.0,1.0,0.13149547576904297,733.9652580333759,38,417,604,1232,927,814,319,73,3.31
0,1,0,-0.0,1.0,0.139479398727417,733.1425509408112,38,417,603,1232,927,814,319,73,3.31
0,1,0,-0.0,1.0,0.14781832695007324,732.3202851212029,38,417,602,1232,927,814,319,73,3.3
0,1,0,-0.0,1.0,0.15544748306274414,731.4984620626349,38,417,601,1232,927,814,319,73,3.3
-1,3,0,-1.0,3.0,0.16539645195007324,729.6081139899693,38,418,598,1232,927,814,319,73,4.98
-2,3,0,-2.0,3.0,0.1715383529663086,728.3028216339684,38,420,595,1232,927,814,319,73,3.35
-1,4,0,-1.0,4.0,0.1857614517211914,725.6183569894025,38,421,591,1232,927,814,319,73,6.73
0,6,0,-0.0,6.0,0.18798542022705078,720.7398976052318,38,421,585,1232,927,814,319,73,11.57
-1,5,0,-1.0,5.0,0.196183443069458,717.2754003867692,38,422,580,1232,927,814,319,73,8.34
0,7,0,-0.0,7.0,0.2039933204650879,711.6270090433611,38,422,573,1232,927,814,319,73,12.93
0,8,0,-0.0,8.0,0.21149945259094238,705.2013896753182,38,422,565,1232,927,814,319,73,14.29
2,9,0,2.0,9.0,0.21950149536132812,696.8041331679943,38,420,556,1232,927,814,319,73,18.29
2,10,0,2.0,10.0,0.22797250747680664,687.6336233780312,38,418,546,1232,927,814,319,73,19.39
5,13,0,5.0,13.0,0.23563647270202637,674.2833232403127,38,413,533,1232,927,814,319,73,26.45
7,14,0,7.0,14.0,0.24347829818725586,658.9362639891662,38,406,519,1232,927,814,319,73,29.53
9,15,0,9.0,15.0,0.2515444755554199,641.5800807381726,38,397,504,1232,927,814,319,73,32.43
11,15,0,11.0,15.0,0.2594723701477051,622.9903691069389,38,386,489,1232,927,814,319,73,34.99
11,15,0,11.0,15.0,0.2674875259399414,604.4013567158829,38,375,474,1232,927,814,319,73,34.37
14,17,0,14.0,17.0,0.27599334716796875,582.3830354672086,38,361,457,1232,927,814,319,73,38.28
13,18,0,13.0,18.0,0.2852895259857178,560.2008568361887,38,348,439,1232,927,814,319,73,36.83
16,20,0,16.0,20.0,0.29146647453308105,534.5886268898731,38,332,419,1232,927,814,319,73,41.13
15,19,0,15.0,19.0,0.2997725009918213,510.3812300623917,38,317,400,1232,927,814,319,73,38.93
16,20,0,16.0,20.0,0.30760931968688965,484.7690171617819,38,301,380,1232,927,814,319,73,38.89
14,18,0,14.0,18.0,0.31543850898742676,461.96644899819296,38,287,362,1232,927,814,319,73,34.87
15,20,0,15.0,20.0,0.32661938667297363,436.9759718794616,38,272,342,1232,927,814,319,73,34.83
15,19,0,15.0,19.0,0.3333923816680908,412.76870036377517,38,257,323,1232,927,814,319,73,34.37
13,19,0,13.0,19.0,0.34261345863342285,389.8102102305685,38,244,304,1232,927,814,319,73,29.7
14,17,0,14.0,17.0,0.3474705219268799,367.78934187928826,38,230,287,1232,927,814,319,73,29.7
11,14,0,11.0,14.0,0.35549139976501465,349.9857139941572,38,219,273,1232,927,814,319,73,25.51
11,13,0,11.0,13.0,0.36345934867858887,332.9624603465081,38,208,260,1232,927,814,319,73,23.31
10,11,0,10.0,11.0,0.3723874092102051,318.1273329973393,38,198,249,1232,927,814,319,73,19.88
8,9,0,8.0,9.0,0.3818395137786865,306.10455730027934,38,190,240,1232,927,814,319,73,17.16
8,9,0,8.0,9.0,0.3883674144744873,294.0833215264001,38,182,231,1232,927,814,319,73,16.73
7,8,0,7.0,8.0,0.3954644203186035,283.467811223779,38,175,223,1232,927,814,319,73,15.3
8,9,0,8.0,9.0,0.40595436096191406,271.4498111990502,38,167,214,1232,927,814,319,73,15.91
8,8,0,8.0,8.0,0.41149449348449707,260.2249027283899,38,159,206,1232,927,814,319,73,14.02
9,9,0,9.0,9.0,0.4194505214691162,247.6065427245411,38,150,197,1232,927,814,319,73,14.61
10,8,0,10.0,8.0,0.4274623394012451,235.2041666297602,38,140,189,1232,927,814,319,73,13.12
9,10,0,9.0,10.0,0.4354543685913086,221.81523843054606,38,131,179,1232,927,814,319,73,14.58
10,9,0,10.0,9.0,0.45072436332702637,208.6648029735729,38,121,170,1232,927,814,319,73,12.86
10,9,0,10.0,9.0,0.45149850845336914,195.5556186868585,38,111,161,1232,927,814,319,73,12.22
11,10,0,11.0,10.0,0.4594714641571045,181.11046352985792,38,100,151,1232,927,814,319,73,12.3
11,9,0,11.0,9.0,0.4676203727722168,167.5857989210303,38,89,142,1232,927,814,319,73,10.81
9,10,0,9.0,10.0,0.47744131088256836,154.3502510525979,38,80,132,1232,927,814,319,73,10.85
9,9,0,9.0,9.0,0.48362040519714355,142.0211251891774,38,71,123,1232,927,814,319,73,9.41
9,8,0,9.0,8.0,0.4917483329772949,130.64838307457157,38,62,115,1232,927,814,319,73,8.07
8,8,0,8.0,8.0,0.4995005130767822,119.85407794480753,38,54,107,1232,927,814,319,73,7.51
7,5,0,7.0,5.0,0.5078103542327881,112.30761327710601,38,47,102,1232,927,814,319,73,5.13
4,3,0,4.0,3.0,0.516425371170044,107.93516572461452,38,43,99,1232,927,814,319,73,3.66
2,3,0,2.0,3.0,0.5234804153442383,104.38869670610895,38,41,96,1232,927,814,319,73,4.69
1,2,0,1.0,2.0,0.5314815044403076,102.15674231297707,38,40,94,1232,927,814,319,73,5.48
1,1,0,1.0,1.0,0.5399625301361084,100.84641788382967,38,39,93,1232,927,814,319,73,2.66
1,1,0,1.0,1.0,0.5478103160858154,99.53893710503444,38,38,92,1232,927,814,319,73,2.63
0,1,0,-0.0,1.0,0.5568873882293701,98.6154146165801,38,38,91,1232,927,814,319,73,2.46
1,1,0,1.0,1.0,0.5660104751586914,97.30878685915265,38,37,90,1232,927,814,319,73,2.61
1,1,0,1.0,1.0,0.5786664485931396,96.00520819205592,38,36,89,1232,927,814,319,73,2.58
0,2,0,-0.0,2.0,0.5804765224456787,94.15412895885129,38,36,87,1232,927,814,319,73,2.81
2,2,0,2.0,2.0,0.592266321182251,91.54780172128658,38,34,85,1232,927,814,319,73,3.03
1,2,0,1.0,2.0,0.5959362983703613,89.31965069345043,38,33,83,1232,927,814,319,73,4.95
1,2,0,1.0,2.0,0.6034963130950928,87.09190547921202,38,32,81,1232,927,814,319,73,4.89
2,2,0,2.0,2.0,0.6115903854370117,84.50443775329198,38,30,79,1232,927,814,319,73,2.87
1,1,0,1.0,1.0,0.6195144653320312,83.21658488546619,38,29,78,1232,927,814,319,73,2.39
0,1,0,-0.0,1.0,0.6274833679199219,82.28000972289685,38,29,77,1232,927,814,319,73,2.51
1,1,0,1.0,1.0,0.6373343467712402,80.99382692526635,38,28,76,1232,927,814,319,73,2.36
0,0,1,-0.0,-0.0,0.6945734024047852,80.99382692526635,38,28,76,1232,927,814,319,73,41.38
0,0,0,-0.0,-0.0,0.7775814533233643,80.99382692526635,38,28,76,1232,927,814,319,73,41.38
1,1,0,1.0,1.0,0.7874634265899658,79.71198153351854,38,27,75,1232,927,814,319,73,2.33
1,2,0,1.0,2.0,0.7983713150024414,77.4919350642375,38,26,73,1232,927,814,319,73,4.36
1,2,0,1.0,2.0,0.8082654476165771,75.27283706623525,38,25,71,1232,927,814,319,73,4.29
2,4,0,2.0,4.0,0.811448335647583,70.83784299369935,38,23,67,1232,927,814,319,73,4.8
2,3,0,2.0,3.0,0.819488525390625,67.35725647619564,38,21,64,1232,927,814,319,73,3.48
2,3,0,2.0,3.0,0.8274703025817871,63.89053137985315,38,19,61,1232,927,814,319,73,3.33
2,3,0,2.0,3.0,0.8355114459991455,60.440052945046304,38,17,58,1232,927,814,319,73,3.18
1,2,0,1.0,2.0,0.8445324897766113,58.240879114244144,38,16,56,1232,927,814,319,73,3.54
0,3,0,-0.0,3.0,0.8514645099639893,55.362442142665635,38,16,53,1232,927,814,319,73,3.0
1,1,0,1.0,1.0,0.8602654933929443,54.120236510939236,38,15,52,1232,927,814,319,73,1.91
0,1,0,-0.0,1.0,0.8686904907226562,53.16013544000805,38,15,51,1232,927,814,319,73,2.66
0,1,0,-0.0,1.0,0.8756213188171387,52.20153254455275,38,15,50,1232,927,814,319,73,2.63
0,0,1,-0.0,-0.0,0.8994975090026855,52.20153254455275,38,15,50,1232,927,814,319,73,42.74
0,0,0,-0.0,-0.0,0.09221267700195312,422.01066337238444,39,-422,-3,795,874,1217,877,23,121.35
-3,-2,0,-3.0,-2.0,0.23122262954711914,419.0011933157231,39,-419,-1,795,874,1217,877,23,14.64
-5,-4,0,-5.0,-4.0,0.23939061164855957,414.01086942253096,39,-414,3,795,874,1217,877,23,21.33
-7,-5,0,-7.0,-5.0,0.2472217082977295,407.07861648580854,39,-407,8,795,874,1217,877,23,27.1
-10,-6,0,-10.0,-6.0,0.2553527355194092,397.24677468797654,39,-397,14,795,874,1217,877,23,34.2
-15,-6,0,-15.0,-6.0,0.2637157440185547,382.5232019106815,39,-382,20,795,874,1217,877,23,43.36
-16,-4,0,-16.0,-4.0,0.2712066173553467,366.7860411738702,39,-366,24,795,874,1217,877,23,44.24
-15,-3,0,-15.0,-3.0,0.27919578552246094,352.03692988094303,39,-351,27,795,874,1217,877,23,41.65
-14,-2,0,-14.0,-2.0,0.28928375244140625,338.2454729926182,39,-337,29,795,874,1217,877,23,39.26
-11,-1,0,-11.0,-1.0,0.29524779319763184,327.37745799000885,39,-326,30,795,874,1217,877,23,33.6
-11,-1,0,-11.0,-1.0,0.3032066822052002,316.5217212135685,39,-315,31,795,874,1217,877,23,32.79
-10,0,0,-10.0,-0.0,0.31261467933654785,306.57136200238926,39,-305,31,795,874,1217,877,23,31.24
-10,0,0,-10.0,-0.0,0.3194437026977539,296.62434155004877,39,-295,31,795,874,1217,877,23,30.53
-11,0,0,-11.0,-0.0,0.3272256851196289,285.68689154387187,39,-284,31,795,874,1217,877,23,31.49
-10,0,0,-10.0,-0.0,0.3356897830963135,275.74807342935327,39,-274,31,795,874,1217,877,23,29.01
-8,1,0,-8.0,1.0,0.3432157039642334,267.686383665662,39,-266,30,795,874,1217,877,23,27.3
-9,1,0,-9.0,1.0,0.35365867614746094,258.63101128828305,39,-257,29,795,874,1217,877,23,29.36
-9,1,0,-9.0,1.0,0.3596506118774414,249.57563983690395,39,-248,28,795,874,1217,877,23,28.76
-10,2,0,-10.0,2.0,0.3672165870666504,239.4159560263267,39,-238,26,795,874,1217,877,23,27.12
-11,2,0,-11.0,2.0,0.3752167224884033,228.26519664635694,39,-227,24,795,874,1217,877,23,27.97
-12,2,0,-12.0,2.0,0.38642358779907227,216.12265036316762,39,-215,22,795,874,1217,877,23,28.52
-12,2,0,-12.0,2.0,0.3931097984313965,203.98284241572867,39,-203,20,795,874,1217,877,23,27.39
-13,2,0,-13.0,2.0,0.4024677276611328,190.85072700935672,39,-190,18,795,874,1217,877,23,27.54
-12,1,0,-12.0,1.0,0.4073607921600342,178.80995498014084,39,-178,17,795,874,1217,877,23,26.79
-12,1,0,-12.0,1.0,0.415393590927124,166.76930173146374,39,-166,16,795,874,1217,877,23,25.65
-10,1,0,-10.0,1.0,0.42334675788879395,156.71949463930773,39,-156,15,795,874,1217,877,23,23.24
-9,0,0,-9.0,-0.0,0.4312007427215576,147.763324272297,39,-147,15,795,874,1217,877,23,18.36
-9,0,0,-9.0,-0.0,0.43993067741394043,138.81282361511128,39,-138,15,795,874,1217,877,23,17.57
-7,0,0,-7.0,-0.0,0.4472167491912842,131.85598204101322,39,-131,15,795,874,1217,877,23,14.69
-6,-1,0,-6.0,-1.0,0.45520663261413574,126.01983970788092,39,-125,16,795,874,1217,877,23,11.67
-6,0,0,-6.0,-0.0,0.46579670906066895,120.07081243999309,39,-119,16,795,874,1217,877,23,12.52
-6,-1,0,-6.0,-1.0,0.4753096103668213,114.27160627207444,39,-113,17,795,874,1217,877,23,10.82
-6,-1,0,-6.0,-1.0,0.48211669921875,108.50345616615168,39,-107,18,795,874,1217,877,23,10.35
-8,0,0,-8.0,-0.0,0.487290620803833,100.62305898749054,39,-99,18,795,874,1217,877,23,12.79
-6,-1,0,-6.0,-1.0,0.4966897964477539,94.92101980067429,39,-93,19,795,874,1217,877,23,9.3
-6,0,0,-6.0,-0.0,0.5032846927642822,89.05054744357274,39,-87,19,795,874,1217,877,23,9.85
-6,0,0,-6.0,-0.0,0.5112366676330566,83.19855767980596,39,-81,19,795,874,1217,877,23,9.35
-5,0,0,-5.0,-0.0,0.5218856334686279,78.33900688673555,39,-76,19,795,874,1217,877,23,8.07
-5,0,0,-5.0,-0.0,0.5272917747497559,73.49829930005184,39,-71,19,795,874,1217,877,23,7.68
-5,0,0,-5.0,-0.0,0.5352036952972412,68.6804193347711,39,-66,19,795,874,1217,877,23,7.28
-4,-1,0,-4.0,-1.0,0.5448145866394043,65.14598989960932,39,-62,20,795,874,1217,877,23,5.02
-4,0,0,-4.0,-0.0,0.5586757659912109,61.35144660071187,39,-58,20,795,874,1217,877,23,5.81
-4,0,0,-4.0,-0.0,0.5599007606506348,57.584720195551874,39,-54,20,795,874,1217,877,23,5.5
-4,-1,0,-4.0,-1.0,0.5672106742858887,54.230987451824994,39,-50,21,795,874,1217,877,23,4.14
-2,0,0,-2.0,-0.0,0.5824017524719238,52.392747589718944,39,-48,21,795,874,1217,877,23,3.57
-2,0,0,-2.0,-0.0,0.5832686424255371,50.566787519082126,39,-46,21,795,874,1217,877,23,3.45
-2,0,0,-2.0,-0.0,0.5918827056884766,48.75448697299562,39,-44,21,795,874,1217,877,23,3.33
-1,0,0,-1.0,-0.0,0.6081347465515137,47.853944456021594,39,-43,21,795,874,1217,877,23,2.59
-1,0,0,-1.0,-0.0,0.6152346134185791,46.95742752749558,39,-42,21,795,874,1217,877,23,2.55
-1,0,0,-1.0,-0.0,0.6243035793304443,46.06517122512408,39,-41,21,795,874,1217,877,23,2.5
-2,0,0,-2.0,-0.0,0.6398487091064453,44.294469180700204,39,-39,21,795,874,1217,877,23,3.02
-1,0,0,-1.0,-0.0,0.6491057872772217,43.41658669218482,39,-38,21,795,874,1217,877,23,2.35
-2,0,0,-2.0,-0.0,0.663184642791748,41.677331968349414,39,-36,21,795,874,1217,877,23,2.82
-2,0,0,-2.0,-0.0,0.6719977855682373,39.96248240537617,39,-34,21,795,874,1217,877,23,2.68
-1,0,0,-1.0,-0.0,0.6792027950286865,39.11521443121589,39,-33,21,795,874,1217,877,23,2.09
-1,0,0,-1.0,-0.0,0.6875677108764648,38.27531841800928,39,-32,21,795,874,1217,877,23,2.04
-2,1,0,-2.0,1.0,0.6957015991210938,36.05551275463989,39,-30,20,795,874,1217,877,23,4.94
-1,0,0,-1.0,-0.0,0.7033298015594482,35.22782990761707,39,-29,20,795,874,1217,877,23,1.92
-1,0,0,-1.0,-0.0,0.7192997932434082,34.40930106817051,39,-28,20,795,874,1217,877,23,1.86
-1,0,0,-1.0,-0.0,0.7300937175750732,33.60059523282288,39,-27,20,795,874,1217,877,23,1.8
-1,0,0,-1.0,-0.0,0.7432136535644531,32.802438933713454,39,-26,20,795,874,1217,877,23,1.74
0,0,1,-0.0,-0.0,0.7492215633392334,32.802438933713454,39,-26,20,795,874,1217,877,23,26.81
0,1,1,-0.0,1.0,0.7532267570495605,32.202484376209235,39,-26,19,795,874,1217,877,23,1.07
-1,0,1,-1.0,-0.0,0.7610776424407959,31.400636936215164,39,-25,19,795,874,1217,877,23,1.73
-1,0,1,-1.0,-0.0,0.7832107543945312,30.610455730027933,39,-24,19,795,874,1217,877,23,1.66
-1,0,1,-1.0,-0.0,0.7992095947265625,29.832867780352597,39,-23,19,795,874,1217,877,23,1.59
0,0,0,-0.0,-0.0,0.8262207508087158,29.832867780352597,39,-23,19,795,874,1217,877,23,25.9
-1,0,0,-1.0,-0.0,0.8408377170562744,29.068883707497267,39,-22,19,795,874,1217,877,23,1.52
-1,0,0,-1.0,-0.0,0.8539986610412598,28.319604517012593,39,-21,19,795,874,1217,877,23,1.45
0,1,0,-0.0,1.0,0.8625946044921875,27.65863337187866,39,-21,18,795,874,1217,877,23,1.16
-1,0,0,-1.0,-0.0,0.8632826805114746,26.90724809414742,39,-20,18,795,874,1217,877,23,1.43
-1,1,0,-1.0,1.0,0.8721246719360352,25.495097567963924,39,-19,17,795,874,1217,877,23,5.17
-1,1,0,-1.0,1.0,0.8798606395721436,24.08318915758459,39,-18,16,795,874,1217,877,23,5.06
-1,1,0,-1.0,1.0,0.8880345821380615,22.67156809750927,39,-17,15,795,874,1217,877,23,4.94
-1,1,0,-1.0,1.0,0.8957717418670654,21.2602916254693,39,-16,14,795,874,1217,877,23,4.81
-1,1,0,-1.0,1.0,0.9032187461853027,19.849433241279208,39,-15,13,795,874,1217,877,23,4.67
-1,2,0,-1.0,2.0,0.9117376804351807,17.804493814764857,39,-14,11,795,874,1217,877,23,2.24
-3,2,0,-3.0,2.0,0.9193336963653564,14.212670403551895,39,-11,9,795,874,1217,877,23,4.53
-2,2,0,-2.0,2.0,0.927351713180542,11.40175425099138,39,-9,7,795,874,1217,877,23,3.75
-1,1,0,-1.0,1.0,0.9352107048034668,10.0,39,-8,6,795,874,1217,877,23,3.22
-1,1,0,-1.0,1.0,0.948643684387207,8.602325267042627,39,-7,5,795,874,1217,877,23,2.89
-1,0,0,-1.0,-0.0,0.9544687271118164,7.810249675906654,39,-6,5,795,874,1217,877,23,0.76
-1,1,0,-1.0,1.0,0.9597716331481934,6.4031242374328485,39,-5,4,795,874,1217,877,23,3.2
0,1,0,-0.0,1.0,0.9672145843505859,5.830951894845301,39,-5,3,795,874,1217,877,23,-0.08
-1,0,0,-1.0,-0.0,0.9806907176971436,5.0,39,-4,3,795,874,1217,877,23,0.55
0,0,1,-0.0,-0.0,1.0032086372375488,5.0,39,-4,3,795,874,1217,877,23,28.4
0,0,0,-0.0,-0.0,0.06199049949645996,620.6230740151384,40,-618,57,181,928,799,871,27,154.96
2,-2,0,2.0,-2.0,0.12729454040527344,622.8009312774026,40,-620,59,181,928,799,871,27,3.72
2,-2,0,2.0,-2.0,0.13399863243103027,624.9839997951948,40,-622,61,181,928,799,871,27,3.73
3,-2,0,3.0,-2.0,0.14304161071777344,628.167175200997,40,-625,63,181,928,799,871,27,3.43
3,-3,0,3.0,-3.0,0.15001654624938965,631.458628890286,40,-628,66,181,928,799,871,27,2.9
2,-2,0,2.0,-2.0,0.15931057929992676,633.6592144047146,40,-630,68,181,928,799,871,27,3.75
1,-3,0,1.0,-3.0,0.16604161262512207,634.9818895055197,40,-631,71,181,928,799,871,27,4.64
2,-2,0,2.0,-2.0,0.174668550491333,637.1954174348714,40,-633,73,181,928,799,871,27,3.76
1,-2,0,1.0,-2.0,0.18236660957336426,638.4207076842041,40,-634,75,181,928,799,871,27,5.18
1,-2,0,1.0,-2.0,0.19008255004882812,639.6514675977849,40,-635,77,181,928,799,871,27,5.17
1,-2,0,1.0,-2.0,0.19870448112487793,640.8876656638041,40,-636,79,181,928,799,871,27,5.16
0,-1,0,-0.0,-1.0,0.2060856819152832,641.0117003612337,40,-636,80,181,928,799,871,27,35.06
1,-2,0,1.0,-2.0,0.21448063850402832,642.2561794175281,40,-637,82,181,928,799,871,27,5.15
0,-3,0,-0.0,-3.0,0.22199249267578125,642.6460923400997,40,-637,85,181,928,799,871,27,13.37
0,-3,0,-0.0,-3.0,0.23125457763671875,643.0497647927414,40,-637,88,181,928,799,871,27,12.97
0,-3,0,-0.0,-3.0,0.24012160301208496,643.4671708797582,40,-637,91,181,928,799,871,27,12.59
-2,-3,0,-2.0,-3.0,0.24600863456726074,641.9197769192035,40,-635,94,181,928,799,871,27,8.76
-2,-3,0,-2.0,-3.0,0.2540416717529297,640.3889443143128,40,-633,97,181,928,799,871,27,8.66
-3,-2,0,-3.0,-2.0,0.2632896900177002,637.7311345700475,40,-630,99,181,928,799,871,27,14.66
-5,-1,0,-5.0,-1.0,0.2700185775756836,632.9494450586081,40,-625,100,181,928,799,871,27,24.73
-7,-2,0,-7.0,-2.0,0.2792625427246094,626.3609183210588,40,-618,102,181,928,799,871,27,31.06
-10,-1,0,-10.0,-1.0,0.2860715389251709,616.662792780625,40,-608,103,181,928,799,871,27,41.47
-15,-1,0,-15.0,-1.0,0.29410767555236816,602.0506623200409,40,-593,104,181,928,799,871,27,53.56
-15,-1,0,-15.0,-1.0,0.3065476417541504,587.4597858577215,40,-578,105,181,928,799,871,27,52.67
-15,0,0,-15.0,-0.0,0.31041455268859863,572.7076042798803,40,-563,105,181,928,799,871,27,52.58
-14,1,0,-14.0,1.0,0.318556547164917,558.7638141469077,40,-549,104,181,928,799,871,27,50.63
-13,1,0,-13.0,1.0,0.3260626792907715,545.8067423548375,40,-536,103,181,928,799,871,27,47.73
-11,2,0,-11.0,2.0,0.33413052558898926,534.6269727576415,40,-525,101,181,928,799,871,27,45.29
-11,3,0,-11.0,3.0,0.3433187007904053,523.2590180780452,40,-514,98,181,928,799,871,27,43.29
-12,4,0,-12.0,4.0,0.35115766525268555,510.7249749131131,40,-502,94,181,928,799,871,27,44.63
-12,5,0,-12.0,5.0,0.35831665992736816,498.01706798060644,40,-490,89,181,928,799,871,27,43.71
-13,5,0,-13.0,5.0,0.36599254608154297,484.3397567823645,40,-477,84,181,928,799,871,27,45.11
-15,5,0,-15.0,5.0,0.380739688873291,468.70566456999427,40,-462,79,181,928,799,871,27,48.21
-13,5,0,-13.0,5.0,0.3897836208343506,455.05713926934493,40,-449,74,181,928,799,871,27,43.22
-15,5,0,-15.0,5.0,0.39133453369140625,439.45079360492684,40,-434,69,181,928,799,871,27,46.11
-17,6,0,-17.0,6.0,0.3995535373687744,421.7321424790859,40,-417,63,181,928,799,871,27,48.09
-16,5,0,-16.0,5.0,0.4059925079345703,405.17280264104596,40,-401,58,181,928,799,871,27,45.3
-14,5,0,-14.0,5.0,0.41400861740112305,390.6123397948406,40,-387,53,181,928,799,871,27,40.67
-15,3,0,-15.0,3.0,0.42203354835510254,375.3451744727778,40,-372,50,181,928,799,871,27,42.27
-13,4,0,-13.0,4.0,0.43102359771728516,361.9350770511198,40,-359,46,181,928,799,871,27,37.05
-14,3,0,-14.0,3.0,0.43977856636047363,347.66938317890464,40,-345,43,181,928,799,871,27,38.33
-13,4,0,-13.0,4.0,0.44736766815185547,334.2828143952363,40,-332,39,181,928,799,871,27,35.04
-13,2,0,-13.0,2.0,0.45555663108825684,321.1385993617086,40,-319,37,181,928,799,871,27,35.7
-12,2,0,-12.0,2.0,0.4620544910430908,308.9886729315494,40,-307,35,181,928,799,871,27,32.93
-13,2,0,-13.0,2.0,0.46997761726379395,295.8462438497403,40,-294,33,181,928,799,871,27,33.8
-13,2,0,-13.0,2.0,0.47884559631347656,282.70479302622374,40,-281,31,181,928,799,871,27,32.79
-13,0,0,-13.0,-0.0,0.4859795570373535,269.7869529832753,40,-268,31,181,928,799,871,27,30.32
-12,1,0,-12.0,1.0,0.49471449851989746,257.75181861628056,40,-256,30,181,928,799,871,27,29.68
-11,1,0,-11.0,1.0,0.5025136470794678,246.71035649116962,40,-245,29,181,928,799,871,27,27.71
-10,0,0,-10.0,-0.0,0.5100774765014648,236.78260071213003,40,-235,29,181,928,799,871,27,23.66
-8,0,0,-8.0,-0.0,0.5181245803833008,228.84492565927695,40,-227,29,181,928,799,871,27,20.08
-8,0,0,-8.0,-0.0,0.5261116027832031,220.91174708466727,40,-219,29,181,928,799,871,27,19.59
-7,0,0,-7.0,-0.0,0.534064531326294,213.974297521922,40,-212,29,181,928,799,871,27,17.6
-8,0,0,-8.0,-0.0,0.5420515537261963,206.0509645694482,40,-204,29,181,928,799,871,27,18.64
-8,0,0,-8.0,-0.0,0.5500166416168213,198.13379318026495,40,-196,29,181,928,799,871,27,18.12
-9,-1,0,-9.0,-1.0,0.5581445693969727,189.39112967612817,40,-187,30,181,928,799,871,27,17.89
-8,0,0,-8.0,-0.0,0.5659916400909424,181.49655644116226,40,-179,30,181,928,799,871,27,16.94
-8,-1,0,-8.0,-1.0,0.5798485279083252,173.78722622793657,40,-171,31,181,928,799,871,27,15.41
-6,-1,0,-6.0,-1.0,0.583972692489624,168.07438829280326,40,-165,32,181,928,799,871,27,12.15
-6,-1,0,-6.0,-1.0,0.5922055244445801,162.3884232326923,40,-159,33,181,928,799,871,27,11.79
-6,-2,0,-6.0,-2.0,0.5979516506195068,156.95222202950808,40,-153,35,181,928,799,871,27,10.62
-6,-1,0,-6.0,-1.0,0.6060395240783691,151.34397906755325,40,-147,36,181,928,799,871,27,11.02
-5,-2,0,-5.0,-2.0,0.6139955520629883,146.99659860010368,40,-142,38,181,928,799,871,27,8.44
-5,-1,0,-5.0,-1.0,0.6224746704101562,142.44297104455524,40,-137,39,181,928,799,871,27,8.98
-5,-1,0,-5.0,-1.0,0.6304295063018799,137.92751719653333,40,-132,40,181,928,799,871,27,8.7
-6,-2,0,-6.0,-2.0,0.6402606964111328,132.81566172707193,40,-126,42,181,928,799,871,27,8.83
-5,0,0,-5.0,-0.0,0.6466786861419678,128.08200498118384,40,-121,42,181,928,799,871,27,9.11
-5,-1,0,-5.0,-1.0,0.6540126800537109,123.71337841963576,40,-116,43,181,928,799,871,27,7.75
-5,-1,0,-5.0,-1.0,0.6668546199798584,119.4026800369238,40,-111,44,181,928,799,871,27,7.44
-6,0,0,-6.0,-0.0,0.6706385612487793,113.84638773364749,40,-105,44,181,928,799,871,27,9.12
-7,0,0,-7.0,-0.0,0.6794254779815674,107.42439201596628,40,-98,44,181,928,799,871,27,9.54
-8,0,0,-8.0,-0.0,0.6859526634216309,100.17983829094555,40,-90,44,181,928,799,871,27,9.72
-5,0,0,-5.0,-0.0,0.6940176486968994,95.71311299921238,40,-85,44,181,928,799,871,27,6.86
-4,1,0,-4.0,1.0,0.7026176452636719,91.706052144883,40,-81,43,181,928,799,871,27,7.2
-4,1,0,-4.0,1.0,0.7100555896759033,87.70974860299168,40,-77,42,181,928,799,871,27,6.96
-4,1,0,-4.0,1.0,0.7180814743041992,83.72574275573791,40,-73,41,181,928,799,871,27,6.71
-5,1,0,-5.0,1.0,0.7260065078735352,78.89233169326408,40,-68,40,181,928,799,871,27,6.9
-3,1,0,-3.0,1.0,0.737520694732666,75.8023746329889,40,-65,39,181,928,799,871,27,5.88
-5,2,0,-5.0,2.0,0.7420046329498291,70.49113419430843,40,-60,37,181,928,799,871,27,7.74
-5,1,0,-5.0,1.0,0.7500255107879639,65.73431371817918,40,-55,36,181,928,799,871,27,5.96
-7,2,0,-7.0,2.0,0.7583796977996826,58.82176467941097,40,-48,34,181,928,799,871,27,7.08
-8,2,0,-8.0,2.0,0.766007661819458,51.22499389946279,40,-40,32,181,928,799,871,27,6.51
-8,2,0,-8.0,2.0,0.7742915153503418,43.86342439892262,40,-32,30,181,928,799,871,27,5.55
-7,2,0,-7.0,2.0,0.7824444770812988,37.53664875824692,40,-25,28,181,928,799,871,27,4.44
-8,2,0,-8.0,2.0,0.7900006771087646,31.064449134018133,40,-17,26,181,928,799,871,27,3.52
-7,2,0,-7.0,2.0,0.8000855445861816,26.0,40,-10,24,181,928,799,871,27,2.3
-5,2,0,-5.0,2.0,0.806654691696167,22.561028345356956,40,-5,22,181,928,799,871,27,1.39
-4,2,0,-4.0,2.0,0.8140356540679932,20.024984394500787,40,-1,20,181,928,799,871,27,0.8
-4,1,0,-4.0,1.0,0.8224375247955322,19.235384061671343,40,3,19,181,928,799,871,27,-0.49
-3,1,0,-3.0,1.0,0.8329546451568604,18.973665961010276,40,6,18,181,928,799,871,27,-0.66
-2,1,0,-2.0,1.0,0.8422796726226807,18.788294228055936,40,8,17,181,928,799,871,27,-0.48
-3,2,0,-3.0,2.0,0.8506555557250977,18.601075237738275,40,11,15,181,928,799,871,27,-0.84
-2,1,0,-2.0,1.0,0.8540775775909424,19.1049731745428,40,13,14,181,928,799,871,27,0.53
-2,1,0,-2.0,1.0,0.8639576435089111,19.849433241279208,40,15,13,181,928,799,871,27,0.32
-2,1,0,-2.0,1.0,0.8699836730957031,20.808652046684813,40,17,12,181,928,799,871,27,0.29
-1,1,0,-1.0,1.0,0.8780615329742432,21.095023109728988,40,18,11,181,928,799,871,27,1.65
0,0,1,-0.0,-0.0,0.9510045051574707,21.095023109728988,40,18,11,181,928,799,871,27,33.230000000000004
0,0,0,-0.0,-0.0,0.08957552909851074,911.096043235838,41,800,-436,963,481,163,917,69,194.94
2,0,0,2.0,-0.0,0.1177375316619873,909.3404203047394,41,798,-436,963,481,163,917,69,6.39
3,0,0,3.0,-0.0,0.12575936317443848,906.708883821042,41,795,-436,963,481,163,917,69,8.61
4,0,0,4.0,-0.0,0.1329665184020996,903.2037422420259,41,791,-436,963,481,163,917,69,10.75
3,0,0,3.0,-0.0,0.140533447265625,900.5775924372092,41,788,-436,963,481,163,917,69,8.56
3,0,0,3.0,-0.0,0.1492173671722412,897.953785002324,41,785,-436,963,481,163,917,69,8.53
2,0,0,2.0,-0.0,0.15707945823669434,896.2058915227013,41,783,-436,963,481,163,917,69,6.31
2,0,0,2.0,-0.0,0.16452336311340332,894.4590544010385,41,781,-436,963,481,163,917,69,6.3
1,0,0,1.0,-0.0,0.17299652099609375,893.5860339105575,41,780,-436,963,481,163,917,69,4.04
1,0,0,1.0,-0.0,0.1814284324645996,892.7132798384932,41,779,-436,963,481,163,917,69,4.04
2,-1,0,2.0,-1.0,0.18874239921569824,890.4796460335295,41,777,-435,963,481,163,917,69,10.57
2,0,0,2.0,-0.0,0.19652652740478516,888.7350561331538,41,775,-435,963,481,163,917,69,6.27
5,-1,0,5.0,-1.0,0.2045583724975586,883.8868705892174,41,770,-434,963,481,163,917,69,14.46
8,-1,0,8.0,-1.0,0.21385741233825684,876.4319711192649,41,762,-433,963,481,163,917,69,19.92
10,-2,0,10.0,-2.0,0.22066545486450195,866.755444170961,41,752,-431,963,481,163,917,69,24.7
12,-2,0,12.0,-2.0,0.22859954833984375,855.3601580620879,41,740,-429,963,481,163,917,69,27.74
15,-3,0,15.0,-3.0,0.2372424602508545,840.8929777326007,41,725,-426,963,481,163,917,69,33.21
17,-4,0,17.0,-4.0,0.2447974681854248,824.2256972456028,41,708,-422,963,481,163,917,69,36.68
17,-5,0,17.0,-5.0,0.25269246101379395,807.0749655391376,41,691,-417,963,481,163,917,69,37.26
17,-7,0,17.0,-7.0,0.2621164321899414,788.9081061822093,41,674,-410,963,481,163,917,69,39.05
18,-10,0,18.0,-10.0,0.2685854434967041,768.33326102675,41,656,-400,963,481,163,917,69,43.68
18,-11,0,18.0,-11.0,0.2765054702758789,747.2382484857155,41,638,-389,963,481,163,917,69,45.6
18,-13,0,18.0,-13.0,0.28563833236694336,725.1041304529991,41,620,-376,963,481,163,917,69,43.64
22,-15,0,22.0,-15.0,0.2945125102996826,698.5162847063767,41,598,-361,963,481,163,917,69,48.75
23,-14,0,23.0,-14.0,0.3044004440307617,671.5906491308526,41,575,-347,963,481,163,917,69,50.06
25,-14,0,25.0,-14.0,0.31003642082214355,642.9533420085784,41,550,-333,963,481,163,917,69,49.26
26,-14,0,26.0,-14.0,0.31662654876708984,613.4631203259084,41,524,-319,963,481,163,917,69,48.32
26,-13,0,26.0,-13.0,0.3285343647003174,584.4997861419625,41,498,-306,963,481,163,917,69,45.8
25,-12,0,25.0,-12.0,0.33272552490234375,556.9245909456683,41,473,-294,963,481,163,917,69,42.81
24,-13,0,24.0,-13.0,0.34671854972839355,529.6810360962529,41,449,-281,963,481,163,917,69,41.87
23,-15,0,23.0,-15.0,0.3524503707885742,502.2270402915399,41,426,-266,963,481,163,917,69,41.97
25,-19,0,25.0,-19.0,0.35664939880371094,470.9670901453731,41,401,-247,963,481,163,917,69,41.9
24,-20,0,24.0,-20.0,0.36537647247314453,440.06590415527535,41,377,-227,963,481,163,917,69,39.26
23,-17,0,23.0,-17.0,0.3748154640197754,411.6017492674199,41,354,-210,963,481,163,917,69,36.23
20,-14,0,20.0,-14.0,0.38198351860046387,387.26218508912024,41,334,-196,963,481,163,917,69,31.82
19,-13,0,19.0,-13.0,0.38853955268859863,364.2993274767331,41,315,-183,963,481,163,917,69,29.6
18,-11,0,18.0,-11.0,0.396531343460083,343.20984834354624,41,297,-172,963,481,163,917,69,28.28
19,-12,0,19.0,-12.0,0.40451741218566895,320.7553584899245,41,278,-160,963,481,163,917,69,27.64
19,-12,0,19.0,-12.0,0.41272735595703125,298.30353668704635,41,259,-148,963,481,163,917,69,26.34
16,-11,0,16.0,-11.0,0.4246954917907715,278.9587783167972,41,243,-137,963,481,163,917,69,22.21
15,-12,0,15.0,-12.0,0.4285545349121094,260.0173071162764,41,228,-125,963,481,163,917,69,20.07
14,-11,0,14.0,-11.0,0.4365215301513672,242.47061677654884,41,214,-114,963,481,163,917,69,18.2
13,-10,0,13.0,-10.0,0.4467275142669678,226.31173190977086,41,201,-104,963,481,163,917,69,16.47
12,-11,0,12.0,-11.0,0.45801854133605957,210.6418761785035,41,189,-93,963,481,163,917,69,14.75
12,-9,0,12.0,-9.0,0.4639253616333008,195.92090240706835,41,177,-84,963,481,163,917,69,13.95
12,-8,0,12.0,-8.0,0.4691903591156006,181.66177363441105,41,165,-76,963,481,163,917,69,13.35
11,-8,0,11.0,-8.0,0.48155856132507324,168.34488409215172,41,154,-68,963,481,163,917,69,11.78
10,-6,0,10.0,-6.0,0.48961734771728516,156.7801007781281,41,144,-62,963,481,163,917,69,10.93
8,-6,0,8.0,-6.0,0.49251747131347656,147.07821048680188,41,136,-56,963,481,163,917,69,8.66
7,-5,0,7.0,-5.0,0.5009524822235107,138.7155362603627,41,129,-51,963,481,163,917,69,7.7
8,-4,0,8.0,-4.0,0.5088093280792236,129.80754985747168,41,121,-47,963,481,163,917,69,8.97
7,-4,0,7.0,-4.0,0.5193133354187012,121.8400590938793,41,114,-43,963,481,163,917,69,7.54
7,-3,0,7.0,-3.0,0.5252394676208496,114.23221962301179,41,107,-40,963,481,163,917,69,8.66
8,-3,0,8.0,-3.0,0.5327334403991699,105.6882207249228,41,99,-37,963,481,163,917,69,11.12
7,-3,0,7.0,-3.0,0.5405044555664062,98.08159868191383,41,92,-34,963,481,163,917,69,8.05
6,-2,0,6.0,-2.0,0.549046516418457,91.76055797563569,41,86,-32,963,481,163,917,69,7.78
5,-2,0,5.0,-2.0,0.5577085018157959,86.37708029332781,41,81,-30,963,481,163,917,69,7.57
4,-2,0,4.0,-2.0,0.5654103755950928,81.93289937503738,41,77,-28,963,481,163,917,69,5.35
4,-2,0,4.0,-2.0,0.572561502456665,77.4919350642375,41,73,-26,963,481,163,917,69,5.17
3,-1,0,3.0,-1.0,0.5808024406433105,74.33034373659252,41,70,-25,963,481,163,917,69,6.66
4,-2,0,4.0,-2.0,0.5885884761810303,69.8927750200262,41,66,-23,963,481,163,917,69,4.92
3,0,0,3.0,-0.0,0.5978493690490723,67.06713054842886,41,63,-23,963,481,163,917,69,3.01
4,-1,0,4.0,-1.0,0.6045055389404297,62.96824596572466,41,59,-22,963,481,163,917,69,4.84
3,-1,0,3.0,-1.0,0.6134903430938721,59.80802621722272,41,56,-21,963,481,163,917,69,5.86
2,-1,0,2.0,-1.0,0.6209053993225098,57.584720195551874,41,54,-20,963,481,163,917,69,4.29
3,0,0,3.0,-0.0,0.6318345069885254,54.78138369920935,41,51,-20,963,481,163,917,69,2.68
3,-1,0,3.0,-1.0,0.6381645202636719,51.62363799656123,41,48,-19,963,481,163,917,69,5.24
2,0,0,2.0,-0.0,0.645728349685669,49.76946855251722,41,46,-19,963,481,163,917,69,2.35
1,-1,0,1.0,-1.0,0.6525774002075195,48.46648326421054,41,45,-18,963,481,163,917,69,2.2
1,0,0,1.0,-0.0,0.6608273983001709,47.53945729601885,41,44,-18,963,481,163,917,69,2.2
1,0,0,1.0,-0.0,0.6685445308685303,46.61544808322666,41,43,-18,963,481,163,917,69,2.16
1,0,0,1.0,-0.0,0.6765553951263428,45.69463863518345,41,42,-18,963,481,163,917,69,2.13
0,-1,0,-0.0,-1.0,0.686307430267334,45.31004303683677,41,42,-17,963,481,163,917,69,0.47
0,0,1,-0.0,-0.0,0.6976535320281982,45.31004303683677,41,42,-17,963,481,163,917,69,40.64
1,0,1,1.0,-0.0,-0.0006120204925537109,504.3252918504088,42,438,-250,1360,248,921,498,16,8.35
0,0,0,-0.0,-0.0,0.06251978874206543,504.3252918504088,42,438,-250,1360,248,921,498,16,136.08
-1,0,0,-1.0,-0.0,0.11063599586486816,505.1940221340708,42,439,-250,1360,248,921,498,16,10.37
-2,2,0,-2.0,2.0,0.1181027889251709,507.9222381428086,42,441,-252,1360,248,921,498,16,5.45
-2,2,0,-2.0,2.0,0.12540698051452637,510.65154459768354,42,443,-254,1360,248,921,498,16,5.47
0,2,0,-0.0,2.0,0.13376092910766602,511.6492939504559,42,443,-256,1360,248,921,498,16,8.37
-1,2,0,-1.0,2.0,0.14151883125305176,513.5172830587107,42,444,-258,1360,248,921,498,16,5.72
-1,1,0,-1.0,1.0,0.1494128704071045,514.8844530571884,42,445,-259,1360,248,921,498,16,8.36
0,1,0,-0.0,1.0,0.15769600868225098,515.3882032022076,42,445,-260,1360,248,921,498,16,15.19
0,1,0,-0.0,1.0,0.16544389724731445,515.8933998414789,42,445,-261,1360,248,921,498,16,15.16
0,1,0,-0.0,1.0,0.17338800430297852,516.4000387296654,42,445,-262,1360,248,921,498,16,15.14
0,1,0,-0.0,1.0,0.18948984146118164,516.9081156259786,42,445,-263,1360,248,921,498,16,15.12
0,1,0,-0.0,1.0,0.20591282844543457,517.4176262942731,42,445,-264,1360,248,921,498,16,15.09
1,1,0,1.0,1.0,0.21343588829040527,517.069627806546,42,444,-265,1360,248,921,498,16,3.16
2,0,0,2.0,-0.0,0.2219548225402832,515.3532768887766,42,442,-265,1360,248,921,498,16,14.32
3,0,0,3.0,-0.0,0.2340068817138672,512.7826050091793,42,439,-265,1360,248,921,498,16,19.69
4,0,0,4.0,-0.0,0.2374098300933838,509.36234646860186,42,435,-265,1360,248,921,498,16,24.49
6,-2,0,6.0,-2.0,0.24634480476379395,503.1997615261756,42,429,-263,1360,248,921,498,16,38.62
9,-4,0,9.0,-4.0,0.25341081619262695,493.4379393601591,42,420,-259,1360,248,921,498,16,51.65
15,-6,0,15.0,-6.0,0.2617509365081787,477.5290567075474,42,405,-253,1360,248,921,498,16,65.03
21,-6,0,21.0,-6.0,0.26994800567626953,456.5796754127367,42,384,-247,1360,248,921,498,16,70.65
23,-8,0,23.0,-8.0,0.2774229049682617,432.9457240809753,42,361,-239,1360,248,921,498,16,71.79
23,-8,0,23.0,-8.0,0.28601980209350586,409.3958964132396,42,338,-231,1360,248,921,498,16,68.96
23,-9,0,23.0,-9.0,0.2936728000640869,385.36865466719007,42,315,-222,1360,248,921,498,16,66.83
20,-9,0,20.0,-9.0,0.30141592025756836,363.85986313414674,42,295,-213,1360,248,921,498,16,61.77
17,-9,0,17.0,-9.0,0.31670093536376953,344.81879299133334,42,278,-204,1360,248,921,498,16,57.05
16,-10,0,16.0,-10.0,0.3250439167022705,326.0061349115995,42,262,-194,1360,248,921,498,16,55.43
13,-9,0,13.0,-9.0,0.3254389762878418,310.20315923600776,42,249,-185,1360,248,921,498,16,50.65
11,-10,0,11.0,-10.0,0.3359699249267578,295.4132698441287,42,238,-175,1360,248,921,498,16,46.25
10,-9,0,10.0,-9.0,0.34148192405700684,282.02836736753983,42,228,-166,1360,248,921,498,16,42.72
9,-8,0,9.0,-8.0,0.34950995445251465,270.04629232781554,42,219,-158,1360,248,921,498,16,39.27
9,-8,0,9.0,-8.0,0.35931897163391113,258.0697580112788,42,210,-150,1360,248,921,498,16,38.02
7,-8,0,7.0,-8.0,0.3657197952270508,247.7357463104588,42,203,-142,1360,248,921,498,16,33.14
8,-8,0,8.0,-8.0,0.37426185607910156,236.60304309116566,42,195,-134,1360,248,921,498,16,33.81
7,-7,0,7.0,-7.0,0.381436824798584,226.87661845152752,42,188,-127,1360,248,921,498,16,30.47
8,-7,0,8.0,-7.0,0.3896138668060303,216.33307652783935,42,180,-120,1360,248,921,498,16,31.33
8,-6,0,8.0,-6.0,0.4019918441772461,206.3492185592182,42,172,-114,1360,248,921,498,16,30.5
8,-6,0,8.0,-6.0,0.4055488109588623,196.36700333813724,42,164,-108,1360,248,921,498,16,29.47
8,-6,0,8.0,-6.0,0.4134378433227539,186.3866948041088,42,156,-102,1360,248,921,498,16,28.42
8,-5,0,8.0,-5.0,0.42164087295532227,176.9547964876906,42,148,-97,1360,248,921,498,16,27.87
6,-5,0,6.0,-5.0,0.4300699234008789,169.19810873647495,42,142,-92,1360,248,921,498,16,22.58
7,-4,0,7.0,-4.0,0.4381368160247803,161.14899937635357,42,135,-88,1360,248,921,498,16,23.23
5,-3,0,5.0,-3.0,0.4518139362335205,155.32224567009067,42,130,-85,1360,248,921,498,16,19.51
7,-4,0,7.0,-4.0,0.4576699733734131,147.27525250360293,42,123,-81,1360,248,921,498,16,21.87
6,-4,0,6.0,-4.0,0.46160197257995605,140.06427096158393,42,117,-77,1360,248,921,498,16,22.07
5,-3,0,5.0,-3.0,0.4695258140563965,134.23859355639868,42,112,-74,1360,248,921,498,16,17.82
5,-3,0,5.0,-3.0,0.4774129390716553,128.41339493993607,42,107,-71,1360,248,921,498,16,17.33
6,-3,0,6.0,-3.0,0.48542094230651855,121.75795661885921,42,101,-68,1360,248,921,498,16,16.73
6,-2,0,6.0,-2.0,0.49349284172058105,115.67627241573788,42,95,-66,1360,248,921,498,16,14.33
5,-4,0,5.0,-4.0,0.5014278888702393,109.288608738514,42,90,-62,1360,248,921,498,16,16.06
6,-3,0,6.0,-3.0,0.509422779083252,102.6498904042279,42,84,-59,1360,248,921,498,16,14.85
6,-4,0,6.0,-4.0,0.5198638439178467,95.44108130150245,42,78,-55,1360,248,921,498,16,16.96
6,-4,0,6.0,-4.0,0.5259089469909668,88.23264701911646,42,72,-51,1360,248,921,498,16,16.2
6,-2,0,6.0,-2.0,0.5334908962249756,82.20097323024831,42,66,-49,1360,248,921,498,16,11.31
6,-4,0,6.0,-4.0,0.5416519641876221,75.0,42,60,-45,1360,248,921,498,16,14.13
6,-3,0,6.0,-3.0,0.549400806427002,68.41052550594829,42,54,-42,1360,248,921,498,16,11.27
5,-3,0,5.0,-3.0,0.557581901550293,62.625873247404705,42,49,-39,1360,248,921,498,16,10.57
5,-4,0,5.0,-4.0,0.5654850006103516,56.22277118748239,42,44,-35,1360,248,921,498,16,14.07
6,-2,0,6.0,-2.0,0.5734307765960693,50.32891812864648,42,38,-33,1360,248,921,498,16,8.0
4,-2,0,4.0,-2.0,0.5837669372558594,46.010868281309364,42,34,-31,1360,248,921,498,16,6.92
6,-3,0,6.0,-3.0,0.589810848236084,39.59797974644666,42,28,-28,1360,248,921,498,16,7.58
4,-2,0,4.0,-2.0,0.5974869728088379,35.38361202590826,42,24,-26,1360,248,921,498,16,5.61
4,-2,0,4.0,-2.0,0.6083288192749023,31.240998703626616,42,20,-24,1360,248,921,498,16,5.03
3,-1,0,3.0,-1.0,0.6136879920959473,28.600699292150182,42,17,-23,1360,248,921,498,16,3.27
3,-2,0,3.0,-2.0,0.6214039325714111,25.238858928247925,42,14,-21,1360,248,921,498,16,4.14
4,-2,0,4.0,-2.0,0.6300349235534668,21.470910553583888,42,10,-19,1360,248,921,498,16,3.33
3,-2,0,3.0,-2.0,0.6373898983001709,18.384776310850235,42,7,-17,1360,248,921,498,16,2.81
3,-1,0,3.0,-1.0,0.6455478668212891,16.492422502470642,42,4,-16,1360,248,921,498,16,1.19
4,-1,0,4.0,-1.0,0.6534318923950195,15.0,42,0,-15,1360,248,921,498,16,0.23
2,-1,0,2.0,-1.0,0.6618788242340088,14.142135623730951,42,-2,-14,1360,248,921,498,16,0.19
3,-1,0,3.0,-1.0,0.6729509830474854,13.92838827718412,42,-5,-13,1360,248,921,498,16,-0.88
2,-1,0,2.0,-1.0,0.6774258613586426,13.892443989449804,42,-7,-12,1360,248,921,498,16,-0.8
2,-1,0,2.0,-1.0,0.685417890548706,14.212670403551895,42,-9,-11,1360,248,921,498,16,1.54
1,0,0,1.0,-0.0,0.6950559616088867,14.866068747318506,42,-10,-11,1360,248,921,498,16,1.58
0,-1,0,-0.0,-1.0,0.7094237804412842,14.142135623730951,42,-10,-10,1360,248,921,498,16,1.13
1,0,0,1.0,-0.0,0.725456953048706,14.866068747318506,42,-11,-10,1360,248,921,498,16,1.62
0,-1,0,-0.0,-1.0,0.7574219703674316,14.212670403551895,42,-11,-9,1360,248,921,498,16,0.92
0,-1,0,-0.0,-1.0,0.766136884689331,13.601470508735444,42,-11,-8,1360,248,921,498,16,0.77
0,-2,0,-0.0,-2.0,0.7760798931121826,12.529964086141668,42,-11,-6,1360,248,921,498,16,0.51
1,-1,0,1.0,-1.0,0.7814469337463379,13.0,42,-12,-5,1360,248,921,498,16,1.23
0,-1,0,-0.0,-1.0,0.7903928756713867,12.649110640673518,42,-12,-4,1360,248,921,498,16,0.16
0,-2,0,-0.0,-2.0,0.7977588176727295,12.165525060596439,42,-12,-2,1360,248,921,498,16,-0.29
0,-1,0,-0.0,-1.0,0.8055379390716553,12.041594578792296,42,-12,-1,1360,248,921,498,16,-0.26
0,-1,0,-0.0,-1.0,0.823462963104248,12.0,42,-12,0,1360,248,921,498,16,-0.38
0,0,1,-0.0,-0.0,0.8604509830474854,12.0,42,-12,0,1360,248,921,498,16,30.48
-1,0,1,-1.0,-0.0,0.07437944412231445,902.0875788968608,43,-891,-141,480,107,1372,248,19,12.56
-1,0,1,-1.0,-0.0,0.08205437660217285,901.0998834757444,43,-890,-141,480,107,1372,248,19,12.55
-1,1,1,-1.0,1.0,0.09591031074523926,900.2694041230103,43,-889,-142,480,107,1372,248,19,8.67
-1,0,1,-1.0,-0.0,0.09782028198242188,899.2819357687555,43,-888,-142,480,107,1372,248,19,12.53
0,0,0,-0.0,-0.0,0.10124444961547852,899.2819357687555,43,-888,-142,480,107,1372,248,19,193.47
-1,1,0,-1.0,1.0,0.10660529136657715,898.4531150816941,43,-887,-143,480,107,1372,248,19,8.65
-2,1,0,-2.0,1.0,0.1137542724609375,896.6387232324956,43,-885,-144,480,107,1372,248,19,17.67
-1,0,0,-1.0,-0.0,0.12833929061889648,895.6517180243669,43,-884,-144,480,107,1372,248,19,12.48
-1,1,0,-1.0,1.0,0.13509345054626465,894.8262401159233,43,-883,-145,480,107,1372,248,19,8.59
-1,0,0,-1.0,-0.0,0.13840436935424805,893.8394710461157,43,-882,-145,480,107,1372,248,19,12.45
-2,1,0,-2.0,1.0,0.1466224193572998,892.0291475058424,43,-880,-146,480,107,1372,248,19,17.58
-1,0,0,-1.0,-0.0,0.15653038024902344,891.0426476886502,43,-879,-146,480,107,1372,248,19,12.42
-1,1,0,-1.0,1.0,0.16462326049804688,890.2207591378669,43,-878,-147,480,107,1372,248,19,8.53
-2,0,0,-2.0,-0.0,0.16991543769836426,888.2482761030274,43,-876,-147,480,107,1372,248,19,20.66
-1,0,0,-1.0,-0.0,0.1786813735961914,887.2620807856042,43,-875,-147,480,107,1372,248,19,12.38
-3,2,0,-3.0,2.0,0.1858062744140625,884.6383441836557,43,-872,-149,480,107,1372,248,19,23.57
-5,1,0,-5.0,1.0,0.19658541679382324,879.8801054689212,43,-867,-150,480,107,1372,248,19,39.04
-7,3,0,-7.0,3.0,0.20249533653259277,873.5038637579115,43,-860,-153,480,107,1372,248,19,47.57
-10,2,0,-10.0,2.0,0.21485042572021484,864.0167822444191,43,-850,-155,480,107,1372,248,19,62.74
-12,3,0,-12.0,3.0,0.22068524360656738,852.7649148505114,43,-838,-158,480,107,1372,248,19,69.09
-15,3,0,-15.0,3.0,0.2267322540283203,838.6000238492722,43,-823,-161,480,107,1372,248,19,78.39
-15,3,0,-15.0,3.0,0.23372745513916016,824.4755909061225,43,-808,-164,480,107,1372,248,19,77.45
-15,2,0,-15.0,2.0,0.2428443431854248,810.1882497296539,43,-793,-166,480,107,1372,248,19,77.36
-15,1,0,-15.0,1.0,0.2531552314758301,795.7216850130452,43,-778,-167,480,107,1372,248,19,77.33
-18,1,0,-18.0,1.0,0.2587623596191406,778.3469663331387,43,-760,-168,480,107,1372,248,19,84.06
-22,0,0,-22.0,-0.0,0.2657043933868408,756.8804396996926,43,-738,-168,480,107,1372,248,19,91.76
-22,-2,0,-22.0,-2.0,0.2737443447113037,734.9911564093816,43,-716,-166,480,107,1372,248,19,91.59
-23,-3,0,-23.0,-3.0,0.28174924850463867,711.9115113551684,43,-693,-163,480,107,1372,248,19,92.34
-23,-4,0,-23.0,-4.0,0.28976941108703613,688.6080162182255,43,-670,-159,480,107,1372,248,19,91.49
-24,-4,0,-24.0,-4.0,0.2977182865142822,664.3350058517163,43,-646,-155,480,107,1372,248,19,90.89
-26,-5,0,-26.0,-5.0,0.30907225608825684,637.8871373526824,43,-620,-150,480,107,1372,248,19,92.26
-26,-6,0,-26.0,-6.0,0.31508922576904297,611.2053664685873,43,-594,-144,480,107,1372,248,19,91.52
-27,-6,0,-27.0,-6.0,0.3240373134613037,583.552054233382,43,-567,-138,480,107,1372,248,19,89.73
-30,-6,0,-30.0,-6.0,0.329742431640625,552.9855332646597,43,-537,-132,480,107,1372,248,19,89.26
-30,-7,0,-30.0,-7.0,0.33779430389404297,522.181960622923,43,-507,-125,480,107,1372,248,19,87.52
-30,-8,0,-30.0,-8.0,0.3457303047180176,491.1394913871211,43,-477,-117,480,107,1372,248,19,84.06
-29,-7,0,-29.0,-7.0,0.35375523567199707,461.3068393163058,43,-448,-110,480,107,1372,248,19,80.68
-28,-8,0,-28.0,-8.0,0.36173033714294434,432.20828312284806,43,-420,-102,480,107,1372,248,19,74.98
-23,-6,0,-23.0,-6.0,0.36971139907836914,408.4421623681865,43,-397,-96,480,107,1372,248,19,67.63
-19,-6,0,-19.0,-6.0,0.3779604434967041,388.56659660861226,43,-378,-90,480,107,1372,248,19,59.24
-17,-6,0,-17.0,-6.0,0.38573622703552246,370.6440340812192,43,-361,-84,480,107,1372,248,19,54.21
-16,-4,0,-16.0,-4.0,0.39372825622558594,354.1539213392956,43,-345,-80,480,107,1372,248,19,52.57
-15,-5,0,-15.0,-5.0,0.4034383296966553,338.4154251803543,43,-330,-75,480,107,1372,248,19,48.04
-14,-4,0,-14.0,-4.0,0.41036224365234375,323.878063474512,43,-316,-71,480,107,1372,248,19,45.48
-13,-3,0,-13.0,-3.0,0.4177243709564209,310.53663229963706,43,-303,-68,480,107,1372,248,19,44.23
-13,-3,0,-13.0,-3.0,0.4262254238128662,297.1952220342716,43,-290,-65,480,107,1372,248,19,43.02
-13,-3,0,-13.0,-3.0,0.4344973564147949,283.8538356267183,43,-277,-62,480,107,1372,248,19,41.79
-13,-4,0,-13.0,-4.0,0.44180822372436523,270.29613389761977,43,-264,-58,480,107,1372,248,19,38.53
-13,-2,0,-13.0,-2.0,0.45027923583984375,257.1711492372346,43,-251,-56,480,107,1372,248,19,36.91
-13,-4,0,-13.0,-4.0,0.46130943298339844,243.61444948935193,43,-238,-52,480,107,1372,248,19,35.93
-13,-3,0,-13.0,-3.0,0.4690253734588623,230.27375013231534,43,-225,-49,480,107,1372,248,19,36.3
-13,-3,0,-13.0,-3.0,0.4740753173828125,216.9331694324314,43,-212,-46,480,107,1372,248,19,34.92
-14,-4,0,-14.0,-4.0,0.4840364456176758,202.40553352119602,43,-198,-42,480,107,1372,248,19,33.08
-15,-3,0,-15.0,-3.0,0.4899113178253174,187.1095935541521,43,-183,-39,480,107,1372,248,19,33.97
-15,-4,0,-15.0,-4.0,0.4977242946624756,171.60710940983768,43,-168,-35,480,107,1372,248,19,30.84
-14,-3,0,-14.0,-3.0,0.5059173107147217,157.2895419282541,43,-154,-32,480,107,1372,248,19,30.06
-15,-2,0,-15.0,-2.0,0.5188944339752197,142.20056258679148,43,-139,-30,480,107,1372,248,19,26.44
-14,-3,0,-14.0,-3.0,0.5225372314453125,127.88275880665071,43,-125,-27,480,107,1372,248,19,27.1
-12,-2,0,-12.0,-2.0,0.5297272205352783,115.73245007343446,43,-113,-25,480,107,1372,248,19,21.39
-10,-2,0,-10.0,-2.0,0.5378084182739258,105.53672346628922,43,-103,-23,480,107,1372,248,19,19.55
-11,-2,0,-11.0,-2.0,0.5457112789154053,94.36630754670864,43,-92,-21,480,107,1372,248,19,18.38
-9,0,0,-9.0,-0.0,0.5567953586578369,85.61541917201598,43,-83,-21,480,107,1372,248,19,13.26
-11,-1,0,-11.0,-1.0,0.5637953281402588,74.72616676907762,43,-72,-20,480,107,1372,248,19,14.08
-10,-1,0,-10.0,-1.0,0.5699422359466553,64.8459713474939,43,-62,-19,480,107,1372,248,19,12.18
-8,-1,0,-8.0,-1.0,0.5777392387390137,56.92099788303083,43,-54,-18,480,107,1372,248,19,10.11
-7,-2,0,-7.0,-2.0,0.5857343673706055,49.64876634922564,43,-47,-16,480,107,1372,248,19,10.82
-7,-1,0,-7.0,-1.0,0.5942583084106445,42.720018726587654,43,-40,-15,480,107,1372,248,19,7.97
-7,-2,0,-7.0,-2.0,0.602088451385498,35.4682957019364,43,-33,-13,480,107,1372,248,19,8.53
-6,0,0,-6.0,-0.0,0.6097352504730225,29.966648127543394,43,-27,-13,480,107,1372,248,19,4.96
-5,-1,0,-5.0,-1.0,0.6179153919219971,25.059928172283335,43,-22,-12,480,107,1372,248,19,4.82
-4,-1,0,-4.0,-1.0,0.6257443428039551,21.095023109728988,43,-18,-11,480,107,1372,248,19,4.06
-3,-1,0,-3.0,-1.0,0.6336982250213623,18.027756377319946,43,-15,-10,480,107,1372,248,19,3.63
-3,-1,0,-3.0,-1.0,0.6417384147644043,15.0,43,-12,-9,480,107,1372,248,19,3.08
-3,0,0,-3.0,-0.0,0.6502742767333984,12.727922061357855,43,-9,-9,480,107,1372,248,19,1.25
-2,-1,0,-2.0,-1.0,0.6633472442626953,10.63014581273465,43,-7,-8,480,107,1372,248,19,2.13
-2,0,0,-2.0,-0.0,0.6658663749694824,9.433981132056603,43,-5,-8,480,107,1372,248,19,0.27
-1,-1,0,-1.0,-1.0,0.6741592884063721,8.06225774829855,43,-4,-7,480,107,1372,248,19,2.3
-2,0,0,-2.0,-0.0,0.684253454208374,7.280109889280518,43,-2,-7,480,107,1372,248,19,-0.5
-1,-1,0,-1.0,-1.0,0.6904072761535645,6.082762530298219,43,-1,-6,480,107,1372,248,19,0.79
-2,-1,0,-2.0,-1.0,0.6978054046630859,5.0990195135927845,43,1,-5,480,107,1372,248,19,-0.81
-1,-1,0,-1.0,-1.0,0.7058444023132324,4.47213595499958,43,2,-4,480,107,1372,248,19,-0.7
-1,0,0,-1.0,-0.0,0.7137823104858398,5.0,43,3,-4,480,107,1372,248,19,0.32
-1,-1,0,-1.0,-1.0,0.7218043804168701,5.0,43,4,-3,480,107,1372,248,19,10.46
-1,0,0,-1.0,-0.0,0.7308204174041748,5.830951894845301,43,5,-3,480,107,1372,248,19,0.76
-1,-1,0,-1.0,-1.0,0.7377064228057861,6.324555320336759,43,6,-2,480,107,1372,248,19,0.15
-1,-1,0,-1.0,-1.0,0.7457432746887207,7.0710678118654755,43,7,-1,480,107,1372,248,19,0.07
-1,-1,0,-1.0,-1.0,0.7537882328033447,8.0,43,8,0,480,107,1372,248,19,0.24
-1,-1,0,-1.0,-1.0,0.761709451675415,9.055385138137417,43,9,1,480,107,1372,248,19,0.49
-1,-1,0,-1.0,-1.0,0.7702102661132812,10.198039027185569,43,10,2,480,107,1372,248,19,0.75
0,-1,0,-0.0,-1.0,0.7950313091278076,10.44030650891055,43,10,3,480,107,1372,248,19,1.97
0,0,1,-0.0,-0.0,0.8157403469085693,10.44030650891055,43,10,3,480,107,1372,248,19,30.01
0,0,0,-0.0,-0.0,0.08195805549621582,826.5911927912128,44,777,282,1247,386,470,104,21,184.18
2,2,0,2.0,2.0,0.12500596046447754,824.0297324732888,44,775,280,1247,386,470,104,21,21.16
3,3,0,3.0,3.0,0.1354210376739502,820.1908314532661,44,772,277,1247,386,470,104,21,29.18
3,3,0,3.0,3.0,0.1451730728149414,816.3559272768221,44,769,274,1247,386,470,104,21,29.07
4,3,0,4.0,3.0,0.1489391326904297,811.5824049349518,44,765,271,1247,386,470,104,21,34.89
4,5,0,4.0,5.0,0.15697693824768066,806.149489859046,44,761,266,1247,386,470,104,21,37.44
6,4,0,6.0,4.0,0.16496706008911133,799.167692039662,44,755,262,1247,386,470,104,21,45.97
5,6,0,5.0,6.0,0.1733551025390625,792.4872238717795,44,750,256,1247,386,470,104,21,43.27
8,8,0,8.0,8.0,0.18089509010314941,782.3477487664932,44,742,248,1247,386,470,104,21,57.59
13,10,0,13.0,10.0,0.19087696075439453,766.8670028107873,44,729,238,1247,386,470,104,21,74.0
15,13,0,15.0,13.0,0.19713401794433594,748.6127169638518,44,714,225,1247,386,470,104,21,79.42
18,12,0,18.0,12.0,0.20501303672790527,727.8633113435517,44,696,213,1247,386,470,104,21,83.75
23,12,0,23.0,12.0,0.21343302726745605,702.3745439578516,44,673,201,1247,386,470,104,21,90.69
24,13,0,24.0,13.0,0.2210249900817871,675.6811378157599,44,649,188,1247,386,470,104,21,90.16
26,11,0,26.0,11.0,0.22898197174072266,647.6557727682198,44,623,177,1247,386,470,104,21,90.36
27,11,0,27.0,11.0,0.23712801933288574,618.6857037300927,44,596,166,1247,386,470,104,21,89.1
28,11,0,28.0,11.0,0.24503207206726074,588.7690548933427,44,568,155,1247,386,470,104,21,87.56
29,11,0,29.0,11.0,0.25671911239624023,557.9041136252716,44,539,144,1247,386,470,104,21,85.74
28,10,0,28.0,10.0,0.2618100643157959,528.2773892568184,44,511,134,1247,386,470,104,21,81.71
28,9,0,28.0,9.0,0.26894712448120117,498.9128180353758,44,483,125,1247,386,470,104,21,78.99
29,9,0,29.0,9.0,0.27696704864501953,468.5851043300459,44,454,116,1247,386,470,104,21,76.98
27,7,0,27.0,7.0,0.29032397270202637,440.6926366528036,44,427,109,1247,386,470,104,21,73.64
24,8,0,24.0,8.0,0.29575395584106445,415.46359647988413,44,403,101,1247,386,470,104,21,65.64
24,7,0,24.0,7.0,0.30496907234191895,390.4830342025118,44,379,94,1247,386,470,104,21,63.51
22,7,0,22.0,7.0,0.3100130558013916,367.4479554984624,44,357,87,1247,386,470,104,21,58.33
23,7,0,23.0,7.0,0.317004919052124,343.4472302989209,44,334,80,1247,386,470,104,21,56.93
21,8,0,21.0,8.0,0.32533693313598633,321.1744074486633,44,313,72,1247,386,470,104,21,51.64
20,7,0,20.0,7.0,0.333204984664917,300.12330799189857,44,293,65,1247,386,470,104,21,48.26
19,6,0,19.0,6.0,0.34090113639831543,280.28021692584724,44,274,59,1247,386,470,104,21,45.12
18,6,0,18.0,6.0,0.3506441116333008,261.4287665885298,44,256,53,1247,386,470,104,21,41.71
19,6,0,19.0,6.0,0.36053013801574707,241.61539686038222,44,237,47,1247,386,470,104,21,40.53
19,5,0,19.0,5.0,0.3649411201477051,222.00900882621858,44,218,42,1247,386,470,104,21,38.69
18,5,0,18.0,5.0,0.3729081153869629,203.39370688396434,44,200,37,1247,386,470,104,21,35.25
18,5,0,18.0,5.0,0.38103413581848145,184.79177470872452,44,182,32,1247,386,470,104,21,32.88
18,4,0,18.0,4.0,0.3936500549316406,166.37307474468338,44,164,28,1247,386,470,104,21,31.31
17,4,0,17.0,4.0,0.39690709114074707,148.94629904767692,44,147,24,1247,386,470,104,21,27.96
14,4,0,14.0,4.0,0.4049060344696045,134.4953530795767,44,133,20,1247,386,470,104,21,23.12
13,2,0,13.0,2.0,0.41339993476867676,121.3424904969401,44,120,18,1247,386,470,104,21,24.0
11,3,0,11.0,3.0,0.42090702056884766,110.0272693471941,44,109,15,1247,386,470,104,21,17.88
8,3,0,8.0,3.0,0.4289510250091553,101.71037311896953,44,101,12,1247,386,470,104,21,13.61
7,2,0,7.0,2.0,0.4371070861816406,94.53041838477179,44,94,10,1247,386,470,104,21,12.4
8,2,0,8.0,2.0,0.4464759826660156,86.37129152675674,44,86,8,1247,386,470,104,21,12.76
7,2,0,7.0,2.0,0.45302510261535645,79.22752047110903,44,79,6,1247,386,470,104,21,10.91
7,2,0,7.0,2.0,0.4609830379486084,72.11102550927978,44,72,4,1247,386,470,104,21,10.17
7,2,0,7.0,2.0,0.46906113624572754,65.03076195155643,44,65,2,1247,386,470,104,21,9.4
5,1,0,5.0,1.0,0.47709012031555176,60.00833275470999,44,60,1,1247,386,470,104,21,7.92
3,1,0,3.0,1.0,0.4849700927734375,57.0,44,57,0,1247,386,470,104,21,5.29
2,0,0,2.0,-0.0,0.49399900436401367,55.0,44,55,0,1247,386,470,104,21,8.99
0,1,0,-0.0,1.0,0.5089359283447266,55.00909015790027,44,55,-1,1247,386,470,104,21,22.61
1,0,0,1.0,-0.0,0.5190660953521729,54.00925846556311,44,54,-1,1247,386,470,104,21,6.69
1,0,0,1.0,-0.0,0.5268630981445312,53.009433122794285,44,53,-1,1247,386,470,104,21,6.66
1,0,0,1.0,-0.0,0.5336401462554932,52.009614495783374,44,52,-1,1247,386,470,104,21,6.63
1,0,0,1.0,-0.0,0.5425460338592529,51.0098029794274,44,51,-1,1247,386,470,104,21,6.6
1,1,0,1.0,1.0,0.5531289577484131,50.039984012787215,44,50,-2,1247,386,470,104,21,1.89
1,0,0,1.0,-0.0,0.5574779510498047,49.040799340956916,44,49,-2,1247,386,470,104,21,5.88
2,1,0,2.0,1.0,0.5750160217285156,47.095647357266465,44,47,-3,1247,386,470,104,21,3.3
1,0,0,1.0,-0.0,0.5751399993896484,46.09772228646444,44,46,-3,1247,386,470,104,21,5.3
2,1,0,2.0,1.0,0.5830719470977783,44.181444068749045,44,44,-4,1247,386,470,104,21,3.1
3,1,0,3.0,1.0,0.5891990661621094,41.30375285612676,44,41,-5,1247,386,470,104,21,3.99
4,1,0,4.0,1.0,0.5968971252441406,37.48332962798263,44,37,-6,1247,386,470,104,21,4.49
2,1,0,2.0,1.0,0.6056430339813232,35.6931365951495,44,35,-7,1247,386,470,104,21,2.45
4,1,0,4.0,1.0,0.6147711277008057,32.01562118716424,44,31,-8,1247,386,470,104,21,3.76
3,1,0,3.0,1.0,0.6209230422973633,29.410882339705484,44,28,-9,1247,386,470,104,21,2.68
4,0,0,4.0,-0.0,0.6325030326843262,25.632011235952593,44,24,-9,1247,386,470,104,21,3.86
3,0,0,3.0,-0.0,0.6401569843292236,22.847319317591726,44,21,-9,1247,386,470,104,21,3.06
2,0,0,2.0,-0.0,0.6463561058044434,21.02379604162864,44,19,-9,1247,386,470,104,21,2.45
3,0,0,3.0,-0.0,0.6536459922790527,18.35755975068582,44,16,-9,1247,386,470,104,21,2.36
2,0,0,2.0,-0.0,0.6612019538879395,16.64331697709324,44,14,-9,1247,386,470,104,21,1.79
1,0,0,1.0,-0.0,0.6722171306610107,15.811388300841896,44,13,-9,1247,386,470,104,21,1.48
2,-1,0,2.0,-1.0,0.6776740550994873,13.601470508735444,44,11,-8,1247,386,470,104,21,3.52
2,-2,0,2.0,-2.0,0.6849000453948975,10.816653826391969,44,9,-6,1247,386,470,104,21,3.16
3,-1,0,3.0,-1.0,0.6938319206237793,7.810249675906654,44,6,-5,1247,386,470,104,21,1.95
2,-1,0,2.0,-1.0,0.7018070220947266,5.656854249492381,44,4,-4,1247,386,470,104,21,1.71
1,-1,0,1.0,-1.0,0.7089900970458984,4.242640687119285,44,3,-3,1247,386,470,104,21,7.37
1,0,0,1.0,-0.0,0.7173709869384766,3.605551275463989,44,2,-3,1247,386,470,104,21,-0.34
1,-1,0,1.0,-1.0,0.7335789203643799,2.23606797749979,44,1,-2,1247,386,470,104,21,0.93
0,0,1,-0.0,-0.0,0.7849481105804443,2.23606797749979,44,1,-2,1247,386,470,104,21,27.58
0,0,0,-0.0,-0.0,0.07671403884887695,614.6299699819397,45,119,603,1365,991,1246,388,39,154.04
-1,0,0,-1.0,-0.0,0.08470296859741211,614.8243651645565,45,120,603,1365,991,1246,388,39,17.49
-1,0,0,-1.0,-0.0,0.09432506561279297,615.0203248673981,45,121,603,1365,991,1246,388,39,17.37
-1,0,0,-1.0,-0.0,0.10071110725402832,615.2178475954676,45,122,603,1365,991,1246,388,39,17.26
-1,1,0,-1.0,1.0,0.10869097709655762,614.4371408044927,45,123,602,1365,991,1246,388,39,3.66
-1,0,0,-1.0,-0.0,0.11923503875732422,614.6381049040159,45,124,602,1365,991,1246,388,39,16.99
-2,0,0,-2.0,-0.0,0.12467694282531738,615.0447138216863,45,126,602,1365,991,1246,388,39,9.05
-2,0,0,-2.0,-0.0,0.13439106941223145,615.4575533698486,45,128,602,1365,991,1246,388,39,8.93
-1,0,0,-1.0,-0.0,0.14069604873657227,615.6663057208832,45,129,602,1365,991,1246,388,39,16.47
-2,0,0,-2.0,-0.0,0.14923405647277832,616.0884676732718,45,131,602,1365,991,1246,388,39,8.76
-3,1,0,-3.0,1.0,0.1605539321899414,615.7572573668946,45,134,601,1365,991,1246,388,39,1.43
-4,1,0,-4.0,1.0,0.16470599174499512,615.6654935920966,45,138,600,1365,991,1246,388,39,0.45
-4,1,0,-4.0,1.0,0.17381811141967773,615.601332032347,45,142,599,1365,991,1246,388,39,0.34
-5,2,0,-5.0,2.0,0.18611907958984375,614.8316842844064,45,147,597,1365,991,1246,388,39,3.05
-4,4,0,-4.0,4.0,0.19191288948059082,611.9231977952788,45,151,593,1365,991,1246,388,39,10.84
-4,4,0,-4.0,4.0,0.1992180347442627,609.0533638360436,45,155,589,1365,991,1246,388,39,10.67
-4,5,0,-4.0,5.0,0.2054450511932373,605.2577963149256,45,159,584,1365,991,1246,388,39,13.7
-3,4,0,-3.0,4.0,0.22193288803100586,602.1993025568861,45,162,580,1365,991,1246,388,39,11.39
-2,5,0,-2.0,5.0,0.22259306907653809,597.9305979793976,45,164,575,1365,991,1246,388,39,15.55
-1,4,0,-1.0,4.0,0.2288060188293457,594.3618426514273,45,165,571,1365,991,1246,388,39,13.69
-1,7,0,-1.0,7.0,0.23781800270080566,587.921763502594,45,166,564,1365,991,1246,388,39,22.13
-1,7,0,-1.0,7.0,0.24718189239501953,581.496345646299,45,167,557,1365,991,1246,388,39,21.93
-1,10,0,-1.0,10.0,0.253154993057251,572.2176159469402,45,168,547,1365,991,1246,388,39,28.92
0,12,0,-0.0,12.0,0.26265406608581543,560.7575233556836,45,168,535,1365,991,1246,388,39,33.74
0,14,0,-0.0,14.0,0.26899099349975586,547.4166603237428,45,168,521,1365,991,1246,388,39,36.97
0,18,0,-0.0,18.0,0.2768099308013916,530.3140578939992,45,168,503,1365,991,1246,388,39,42.81
2,19,0,2.0,19.0,0.288891077041626,511.6756785308444,45,166,484,1365,991,1246,388,39,44.73
2,22,0,2.0,22.0,0.29738497734069824,490.2448367907611,45,164,462,1365,991,1246,388,39,47.3
2,24,0,2.0,24.0,0.3006880283355713,466.99892933496113,45,162,438,1365,991,1246,388,39,48.0
1,24,0,1.0,24.0,0.3088810443878174,444.2037820640432,45,161,414,1365,991,1246,388,39,45.64
2,25,0,2.0,25.0,0.3166990280151367,420.240407386058,45,159,389,1365,991,1246,388,39,45.39
4,25,0,4.0,25.0,0.3246879577636719,395.6273499140321,45,155,364,1365,991,1246,388,39,44.6
3,23,0,3.0,23.0,0.3342270851135254,373.34300582708124,45,152,341,1365,991,1246,388,39,40.24
4,21,0,4.0,21.0,0.3406839370727539,352.5677239907249,45,148,320,1365,991,1246,388,39,37.35
4,21,0,4.0,21.0,0.34908008575439453,331.86895003901765,45,144,299,1365,991,1246,388,39,35.68
4,19,0,4.0,19.0,0.35875797271728516,313.04951684997053,45,140,280,1365,991,1246,388,39,32.37
5,18,0,5.0,18.0,0.3650510311126709,294.7354746208878,45,135,262,1365,991,1246,388,39,30.86
5,18,0,5.0,18.0,0.3726630210876465,276.4706132665821,45,130,244,1365,991,1246,388,39,29.41
4,16,0,4.0,16.0,0.3806769847869873,260.4995201531089,45,126,228,1365,991,1246,388,39,25.74
4,14,0,4.0,14.0,0.38942503929138184,246.3331078032346,45,122,214,1365,991,1246,388,39,23.05
5,13,0,5.0,13.0,0.4038200378417969,232.57256931977167,45,117,201,1365,991,1246,388,39,22.31
5,11,0,5.0,11.0,0.40466809272766113,220.55384830013736,45,112,190,1365,991,1246,388,39,20.32
4,10,0,4.0,10.0,0.4127390384674072,209.91426821443082,45,108,180,1365,991,1246,388,39,17.72
4,9,0,4.0,9.0,0.4226689338684082,200.14244927051334,45,104,171,1365,991,1246,388,39,16.57
4,8,0,4.0,8.0,0.42983388900756836,191.23022773609824,45,100,163,1365,991,1246,388,39,15.72
3,6,0,3.0,6.0,0.43672895431518555,184.54809671194118,45,97,157,1365,991,1246,388,39,12.93
3,6,0,3.0,6.0,0.4446899890899658,177.867928531256,45,94,151,1365,991,1246,388,39,12.62
3,5,0,3.0,5.0,0.4527139663696289,172.03778654702577,45,91,146,1365,991,1246,388,39,13.27
2,6,0,2.0,6.0,0.4607079029083252,165.89454481688057,45,89,140,1365,991,1246,388,39,10.3
4,6,0,4.0,6.0,0.4694480895996094,158.68522300453813,45,85,134,1365,991,1246,388,39,13.97
4,7,0,4.0,7.0,0.4789459705352783,150.63200191194434,45,81,127,1365,991,1246,388,39,13.61
4,7,0,4.0,7.0,0.48469090461730957,142.57980221616245,45,77,120,1365,991,1246,388,39,13.15
5,7,0,5.0,7.0,0.49300503730773926,133.98880550254935,45,72,113,1365,991,1246,388,39,13.14
6,6,0,6.0,6.0,0.5016019344329834,125.7179382586272,45,66,107,1365,991,1246,388,39,10.52
4,4,0,4.0,4.0,0.5091218948364258,120.22063050907694,45,62,103,1365,991,1246,388,39,7.97
4,4,0,4.0,4.0,0.5167250633239746,114.73883387938018,45,58,99,1365,991,1246,388,39,7.68
4,4,0,4.0,4.0,0.5246939659118652,109.27488274987991,45,54,95,1365,991,1246,388,39,7.39
5,4,0,5.0,4.0,0.5390529632568359,103.3537614216338,45,49,91,1365,991,1246,388,39,6.92
5,3,0,5.0,3.0,0.5411429405212402,98.38699100999075,45,44,88,1365,991,1246,388,39,5.53
5,4,0,5.0,4.0,0.5492029190063477,92.61209424259879,45,39,84,1365,991,1246,388,39,6.16
4,3,0,4.0,3.0,0.5592620372772217,88.23831367382311,45,35,81,1365,991,1246,388,39,4.88
4,2,0,4.0,2.0,0.5659260749816895,84.86459803710851,45,31,79,1365,991,1246,388,39,3.58
3,2,0,3.0,2.0,0.5730729103088379,81.93289937503738,45,28,77,1365,991,1246,388,39,3.44
2,2,0,2.0,2.0,0.5817360877990723,79.37883848986453,45,26,75,1365,991,1246,388,39,3.63
2,2,0,2.0,2.0,0.5902309417724609,76.84399781375251,45,24,73,1365,991,1246,388,39,3.52
3,2,0,3.0,2.0,0.5966880321502686,74.04052944165107,45,21,71,1365,991,1246,388,39,3.02
2,2,0,2.0,2.0,0.6047310829162598,71.56814934033156,45,19,69,1365,991,1246,388,39,3.21
3,3,0,3.0,3.0,0.6126630306243896,67.91170738539859,45,16,66,1365,991,1246,388,39,3.69
3,3,0,3.0,3.0,0.6208291053771973,64.32728814430156,45,13,63,1365,991,1246,388,39,3.45
3,3,0,3.0,3.0,0.630500078201294,60.8276253029822,45,10,60,1365,991,1246,388,39,3.19
3,2,0,3.0,2.0,0.6423940658569336,58.42088667591412,45,7,58,1365,991,1246,388,39,2.07
2,2,0,2.0,2.0,0.6453061103820801,56.22277118748239,45,5,56,1365,991,1246,388,39,2.27
3,2,0,3.0,2.0,0.6526830196380615,54.037024344425184,45,2,54,1365,991,1246,388,39,1.7
2,2,0,2.0,2.0,0.6648368835449219,52.0,45,0,52,1365,991,1246,388,39,1.91
1,2,0,1.0,2.0,0.6703569889068604,50.00999900019995,45,-1,50,1365,991,1246,388,39,2.59
1,2,0,1.0,2.0,0.6767449378967285,48.041648597857254,45,-2,48,1365,991,1246,388,39,2.48
1,2,0,1.0,2.0,0.6851139068603516,46.09772228646444,45,-3,46,1365,991,1246,388,39,2.35
1,2,0,1.0,2.0,0.6943080425262451,44.181444068749045,45,-4,44,1365,991,1246,388,39,2.23
0,1,0,-0.0,1.0,0.7006978988647461,43.18564576337837,45,-4,43,1365,991,1246,388,39,4.34
1,2,0,1.0,2.0,0.7124900817871094,41.30375285612676,45,-5,41,1365,991,1246,388,39,2.07
0,2,0,-0.0,2.0,0.7166550159454346,39.319206502675,45,-5,39,1365,991,1246,388,39,4.2
1,1,0,1.0,1.0,0.7247030735015869,38.47076812334269,45,-6,38,1365,991,1246,388,39,0.98
0,2,0,-0.0,2.0,0.7327079772949219,36.49657518178932,45,-6,36,1365,991,1246,388,39,3.78
1,3,0,1.0,3.0,0.7406959533691406,33.734255586866,45,-7,33,1365,991,1246,388,39,2.24
0,3,0,-0.0,3.0,0.7487950325012207,30.805843601498726,45,-7,30,1365,991,1246,388,39,3.39
0,3,0,-0.0,3.0,0.7623980045318604,27.892651361962706,45,-7,27,1365,991,1246,388,39,3.13
0,3,0,-0.0,3.0,0.7671411037445068,25.0,45,-7,24,1365,991,1246,388,39,2.84
0,3,0,-0.0,3.0,0.772968053817749,22.135943621178654,45,-7,21,1365,991,1246,388,39,2.51
0,2,0,-0.0,2.0,0.7813560962677002,20.248456731316587,45,-7,19,1365,991,1246,388,39,2.18
0,2,0,-0.0,2.0,0.7916278839111328,18.384776310850235,45,-7,17,1365,991,1246,388,39,1.94
0,0,1,-0.0,-0.0,0.807175874710083,18.384776310850235,45,-7,17,1365,991,1246,388,39,32.41
0,2,1,-0.0,2.0,0.8074400424957275,16.55294535724685,45,-7,15,1365,991,1246,388,39,11.69
0,1,1,-0.0,1.0,0.8075840473175049,15.652475842498529,45,-7,14,1365,991,1246,388,39,11.61
0,1,1,-0.0,1.0,0.8130600452423096,14.7648230602334,45,-7,13,1365,991,1246,388,39,11.48
0,0,0,-0.0,-0.0,0.9047400951385498,14.7648230602334,45,-7,13,1365,991,1246,388,39,21.31
0,0,1,-0.0,-0.0,1.0557188987731934,14.7648230602334,45,-7,13,1365,991,1246,388,39,31.31
0,0,0,-0.0,-0.0,0.0835413932800293,863.400254806541,46,-844,182,528,1160,1372,978,20,188.94
-2,0,0,-2.0,-0.0,0.19051623344421387,861.4452971605335,46,-842,182,528,1160,1372,978,20,19.1
-2,-1,0,-2.0,-1.0,0.20093345642089844,859.7028556425761,46,-840,183,528,1160,1372,978,20,15.87
-3,-2,0,-3.0,-2.0,0.20650029182434082,857.2012599150797,46,-837,185,528,1160,1372,978,20,21.22
-6,-3,0,-6.0,-3.0,0.21453642845153809,852.000586854258,46,-831,188,528,1160,1372,978,20,38.54
-8,-6,0,-8.0,-6.0,0.22316527366638184,845.5560300772504,46,-823,194,528,1160,1372,978,20,44.71
-10,-6,0,-10.0,-6.0,0.23077940940856934,837.2389145279858,46,-813,200,528,1160,1372,978,20,53.53
-11,-6,0,-11.0,-6.0,0.23853230476379395,828.0338157345991,46,-802,206,528,1160,1372,978,20,57.04
-15,-7,0,-15.0,-7.0,0.25101542472839355,815.3146631822588,46,-787,213,528,1160,1372,978,20,69.5
-16,-4,0,-16.0,-4.0,0.25452423095703125,800.9556791733236,46,-771,217,528,1160,1372,978,20,74.25
-16,-4,0,-16.0,-4.0,0.26514434814453125,786.6803671123362,46,-755,221,528,1160,1372,978,20,73.18
-16,-2,0,-16.0,-2.0,0.27052927017211914,771.9132075563936,46,-739,223,528,1160,1372,978,20,74.08
-14,0,0,-14.0,-0.0,0.2785353660583496,758.5209291773036,46,-725,223,528,1160,1372,978,20,69.8
-12,0,0,-12.0,-0.0,0.2865273952484131,747.0595692446486,46,-713,223,528,1160,1372,978,20,63.03
-11,0,0,-11.0,-0.0,0.2945432662963867,736.5683946518477,46,-702,223,528,1160,1372,978,20,59.15
-11,1,0,-11.0,1.0,0.3025052547454834,725.7857810676646,46,-691,222,528,1160,1372,978,20,60.09
-10,2,0,-10.0,2.0,0.31055331230163574,715.6542461272762,46,-681,220,528,1160,1372,978,20,58.17
-11,3,0,-11.0,3.0,0.31858134269714355,704.2648649478405,46,-670,217,528,1160,1372,978,20,62.95
-10,5,0,-10.0,5.0,0.32650136947631836,693.2128100374372,46,-660,212,528,1160,1372,978,20,59.83
-12,6,0,-12.0,6.0,0.3345162868499756,679.9558809216962,46,-648,206,528,1160,1372,978,20,65.8
-14,6,0,-14.0,6.0,0.34259724617004395,664.7977135941428,46,-634,200,528,1160,1372,978,20,70.5
-15,8,0,-15.0,8.0,0.35117125511169434,648.0933574725173,46,-619,192,528,1160,1372,978,20,72.21
-17,7,0,-17.0,7.0,0.35851025581359863,629.7848839087836,46,-602,185,528,1160,1372,978,20,75.27
-20,8,0,-20.0,8.0,0.3678872585296631,608.3198172014454,46,-582,177,528,1160,1372,978,20,79.55
-21,7,0,-21.0,7.0,0.3745253086090088,586.1919480852667,46,-561,170,528,1160,1372,978,20,80.09
-22,7,0,-22.0,7.0,0.3828463554382324,563.1074497820109,46,-539,163,528,1160,1372,978,20,80.16
-21,7,0,-21.0,7.0,0.3933694362640381,540.9805911490726,46,-518,156,528,1160,1372,978,20,76.16
-20,7,0,-20.0,7.0,0.3985302448272705,519.812466183719,46,-498,149,528,1160,1372,978,20,72.36
-19,7,0,-19.0,7.0,0.4065103530883789,499.6048438516184,46,-479,142,528,1160,1372,978,20,68.7
-19,7,0,-19.0,7.0,0.42097043991088867,479.40066750057827,46,-460,135,528,1160,1372,978,20,66.86
-17,6,0,-17.0,6.0,0.4224812984466553,461.4000433463352,46,-443,129,528,1160,1372,978,20,61.99
-16,6,0,-16.0,6.0,0.43097543716430664,444.3624646614518,46,-427,123,528,1160,1372,978,20,58.5
-16,6,0,-16.0,6.0,0.4472222328186035,427.3289131336657,46,-411,117,528,1160,1372,978,20,57.0
-15,5,0,-15.0,5.0,0.4476344585418701,411.5337167231866,46,-396,112,528,1160,1372,978,20,54.21
-15,6,0,-15.0,6.0,0.4553103446960449,395.47060573448437,46,-381,106,528,1160,1372,978,20,52.25
-16,5,0,-16.0,5.0,0.46262431144714355,378.7162526219333,46,-365,101,528,1160,1372,978,20,53.3
-15,5,0,-15.0,5.0,0.4707174301147461,362.92698990292797,46,-350,96,528,1160,1372,978,20,49.82
-16,4,0,-16.0,4.0,0.4785003662109375,346.4390278245221,46,-334,92,528,1160,1372,978,20,50.27
-17,4,0,-17.0,4.0,0.4897422790527344,328.9878417206326,46,-317,88,528,1160,1372,978,20,49.44
-19,5,0,-19.0,5.0,0.4955284595489502,309.3428518650463,46,-298,83,528,1160,1372,978,20,51.17
-18,3,0,-18.0,3.0,0.5029034614562988,291.20439557122074,46,-280,80,528,1160,1372,978,20,45.19
-18,4,0,-18.0,4.0,0.5105762481689453,272.80029325497435,46,-262,76,528,1160,1372,978,20,44.26
-15,2,0,-15.0,2.0,0.5219204425811768,257.84685377176896,46,-247,74,528,1160,1372,978,20,37.36
-15,3,0,-15.0,3.0,0.5308523178100586,242.62110378118388,46,-232,71,528,1160,1372,978,20,36.78
-11,2,0,-11.0,2.0,0.5372743606567383,231.52105735764079,46,-221,69,528,1160,1372,978,20,29.86
-10,2,0,-10.0,2.0,0.5440182685852051,221.38202275704322,46,-211,67,528,1160,1372,978,20,27.67
-10,2,0,-10.0,2.0,0.5532312393188477,211.24866863485792,46,-201,65,528,1160,1372,978,20,26.76
-9,2,0,-9.0,2.0,0.5585823059082031,202.07176942858692,46,-192,63,528,1160,1372,978,20,24.75
-9,2,0,-9.0,2.0,0.5681684017181396,192.89893727027115,46,-183,61,528,1160,1372,978,20,23.95
-8,1,0,-8.0,1.0,0.5746283531188965,185.0,46,-175,60,528,1160,1372,978,20,20.46
-5,2,0,-5.0,2.0,0.5829362869262695,179.62182495454164,46,-170,58,528,1160,1372,978,20,17.52
-6,2,0,-6.0,2.0,0.5905604362487793,173.29743217947575,46,-164,56,528,1160,1372,978,20,20.5
-6,1,0,-6.0,1.0,0.5985922813415527,167.29913329123974,46,-158,55,528,1160,1372,978,20,16.41
-5,2,0,-5.0,2.0,0.6065492630004883,161.91973320136123,46,-153,53,528,1160,1372,978,20,16.64
-5,2,0,-5.0,2.0,0.615267276763916,156.54072952429985,46,-148,51,528,1160,1372,978,20,16.29
-4,1,0,-4.0,1.0,0.6257784366607666,152.43359209832983,46,-144,50,528,1160,1372,978,20,13.11
-5,2,0,-5.0,2.0,0.6305363178253174,147.05441169852742,46,-139,48,528,1160,1372,978,20,15.75
-6,2,0,-6.0,2.0,0.6391363143920898,140.73023839957068,46,-133,46,528,1160,1372,978,20,18.14
-7,3,0,-7.0,3.0,0.6528012752532959,133.13526955694348,46,-126,43,528,1160,1372,978,20,17.4
-6,1,0,-6.0,1.0,0.6645803451538086,127.13772060250254,46,-120,42,528,1160,1372,978,20,13.82
-5,2,0,-5.0,2.0,0.664764404296875,121.75795661885921,46,-115,40,528,1160,1372,978,20,14.28
-5,2,0,-5.0,2.0,0.6704983711242676,116.37869220780924,46,-110,38,528,1160,1372,978,20,13.9
-6,2,0,-6.0,2.0,0.6795332431793213,110.05453193758083,46,-104,36,528,1160,1372,978,20,16.03
-6,2,0,-6.0,2.0,0.6877522468566895,103.73041983911952,46,-98,34,528,1160,1372,978,20,15.54
-6,2,0,-6.0,2.0,0.696465253829956,97.40636529508737,46,-92,32,528,1160,1372,978,20,15.04
-6,1,0,-6.0,1.0,0.7025322914123535,91.4166286842826,46,-86,31,528,1160,1372,978,20,11.26
-5,2,0,-5.0,2.0,0.711233377456665,86.03487664894976,46,-81,29,528,1160,1372,978,20,12.25
-5,1,0,-5.0,1.0,0.7185683250427246,80.99382692526635,46,-76,28,528,1160,1372,978,20,9.76
-4,1,0,-4.0,1.0,0.7419793605804443,76.89603370785778,46,-72,27,528,1160,1372,978,20,8.95
-5,3,0,-5.0,3.0,0.7429873943328857,71.16881339463234,46,-67,24,528,1160,1372,978,20,9.41
-4,1,0,-4.0,1.0,0.7431392669677734,67.06713054842886,46,-63,23,528,1160,1372,978,20,8.51
-4,1,0,-4.0,1.0,0.7512032985687256,62.96824596572466,46,-59,22,528,1160,1372,978,20,8.18
-4,2,0,-4.0,2.0,0.7609653472900391,58.52349955359813,46,-55,20,528,1160,1372,978,20,8.18
-4,2,0,-4.0,2.0,0.766545295715332,54.08326913195984,46,-51,18,528,1160,1372,978,20,7.79
-4,2,0,-4.0,2.0,0.7789793014526367,49.64876634922564,46,-47,16,528,1160,1372,978,20,7.38
-4,1,0,-4.0,1.0,0.7831974029541016,45.5411901469428,46,-43,15,528,1160,1372,978,20,7.41
-3,2,0,-3.0,2.0,0.7929673194885254,42.05948168962618,46,-40,13,528,1160,1372,978,20,5.26
-4,2,0,-4.0,2.0,0.7984974384307861,37.64306044943742,46,-36,11,528,1160,1372,978,20,6.26
-4,2,0,-4.0,2.0,0.8076162338256836,33.24154027718932,46,-32,9,528,1160,1372,978,20,5.76
-4,2,0,-4.0,2.0,0.81453537940979,28.861739379323623,46,-28,7,528,1160,1372,978,20,5.21
-4,2,0,-4.0,2.0,0.8228132724761963,24.515301344262525,46,-24,5,528,1160,1372,978,20,4.61
-5,2,0,-5.0,2.0,0.8304944038391113,19.235384061671343,46,-19,3,528,1160,1372,978,20,4.71
-4,2,0,-4.0,2.0,0.8384993076324463,15.033296378372908,46,-15,1,528,1160,1372,978,20,3.07
-5,2,0,-5.0,2.0,0.846522331237793,10.04987562112089,46,-10,-1,528,1160,1372,978,20,2.45
-4,2,0,-4.0,2.0,0.8545923233032227,6.708203932499369,46,-6,-3,528,1160,1372,978,20,0.48
-3,1,0,-3.0,1.0,0.8631823062896729,5.0,46,-3,-4,528,1160,1372,978,20,-0.72
-2,1,0,-2.0,1.0,0.8706443309783936,5.0990195135927845,46,-1,-5,528,1160,1372,978,20,2.2
-3,1,0,-3.0,1.0,0.8785243034362793,6.324555320336759,46,2,-6,528,1160,1372,978,20,-1.45
-1,0,0,-1.0,-0.0,0.8922872543334961,6.708203932499369,46,3,-6,528,1160,1372,978,20,0.79
-1,1,0,-1.0,1.0,0.8964483737945557,8.06225774829855,46,4,-7,528,1160,1372,978,20,1.42
0,0,1,-0.0,-0.0,0.9745593070983887,8.06225774829855,46,4,-7,528,1160,1372,978,20,29.3
0,0,0,-0.0,-0.0,0.08210229873657227,996.3232407206007,47,68,-994,592,173,524,1167,40,205.2
1,-1,0,1.0,-1.0,0.16309428215026855,995.2577555588301,47,67,-993,592,173,524,1167,40,6.38
1,-2,0,1.0,-2.0,0.17182230949401855,993.1953483580156,47,66,-991,592,173,524,1167,40,11.76
3,-2,0,3.0,-2.0,0.1799163818359375,991.0045408574069,47,63,-989,592,173,524,1167,40,11.14
2,-3,0,2.0,-3.0,0.1871204376220703,987.8851147780292,47,61,-986,592,173,524,1167,40,15.93
3,-5,0,3.0,-5.0,0.1966114044189453,982.7130812195388,47,58,-981,592,173,524,1167,40,24.29
4,-5,0,4.0,-5.0,0.20305943489074707,977.492710970266,47,54,-976,592,173,524,1167,40,24.04
5,-7,0,5.0,-7.0,0.21177244186401367,970.23811510371,47,49,-969,592,173,524,1167,40,31.48
4,-10,0,4.0,-10.0,0.22644424438476562,960.0552067459454,47,45,-959,592,173,524,1167,40,41.6
3,-10,0,3.0,-10.0,0.22759032249450684,949.9289447111295,47,42,-949,592,173,524,1167,40,41.59
3,-12,0,3.0,-12.0,0.23614740371704102,937.8112816553232,47,39,-937,592,173,524,1167,40,47.38
3,-15,0,3.0,-15.0,0.24307537078857422,922.702552288656,47,36,-922,592,173,524,1167,40,55.15
3,-20,0,3.0,-20.0,0.2510874271392822,902.6034566740813,47,33,-902,592,173,524,1167,40,66.14
2,-22,0,2.0,-22.0,0.2593064308166504,880.5458534341071,47,31,-880,592,173,524,1167,40,69.93
1,-28,0,1.0,-28.0,0.2682304382324219,852.528005405101,47,30,-852,592,173,524,1167,40,81.11
0,-28,0,-0.0,-28.0,0.2763662338256836,824.5459356518593,47,30,-824,592,173,524,1167,40,77.72
0,-26,0,-0.0,-26.0,0.283069372177124,798.5637106706014,47,30,-798,592,173,524,1167,40,73.18
-2,-24,0,-2.0,-24.0,0.29119038581848145,774.6612162745726,47,32,-774,592,173,524,1167,40,67.13
-2,-24,0,-2.0,-24.0,0.29908227920532227,750.7702711215995,47,34,-750,592,173,524,1167,40,65.83
-6,-29,0,-6.0,-29.0,0.30760836601257324,722.1087175765156,47,40,-721,592,173,524,1167,40,70.41
-9,-34,0,-9.0,-34.0,0.31578826904296875,688.7452359181876,47,49,-687,592,173,524,1167,40,73.92
-9,-29,0,-9.0,-29.0,0.3251314163208008,660.551284912837,47,58,-658,592,173,524,1167,40,65.47
-7,-28,0,-7.0,-28.0,0.3333282470703125,633.3442981506978,47,65,-630,592,173,524,1167,40,62.64
-5,-28,0,-5.0,-28.0,0.3394613265991211,606.0561030135741,47,70,-602,592,173,524,1167,40,61.27
-4,-25,0,-4.0,-25.0,0.3473222255706787,581.725880462611,47,74,-577,592,173,524,1167,40,55.88
-3,-24,0,-3.0,-24.0,0.3550693988800049,558.3350248730595,47,77,-553,592,173,524,1167,40,53.3
-2,-23,0,-2.0,-23.0,0.36319732666015625,535.8553909405036,47,79,-530,592,173,524,1167,40,50.85
-1,-23,0,-1.0,-23.0,0.37270021438598633,513.2728319324918,47,80,-507,592,173,524,1167,40,49.83
-1,-24,0,-1.0,-24.0,0.386688232421875,489.74483151943525,47,81,-483,592,173,524,1167,40,49.49
-2,-24,0,-2.0,-24.0,0.3896443843841553,466.44399449451595,47,83,-459,592,173,524,1167,40,47.35
-1,-22,0,-1.0,-22.0,0.3964083194732666,445.0,47,84,-437,592,173,524,1167,40,43.82
-1,-22,0,-1.0,-22.0,0.4030933380126953,423.6153915995027,47,85,-415,592,173,524,1167,40,42.29
-1,-21,0,-1.0,-21.0,0.4208822250366211,403.2765800291408,47,86,-394,592,173,524,1167,40,39.61
0,-18,0,-0.0,-18.0,0.4210944175720215,385.70973542289545,47,86,-376,592,173,524,1167,40,35.29
1,-17,0,1.0,-17.0,0.42713427543640137,368.92546672735944,47,85,-359,592,173,524,1167,40,33.63
1,-17,0,1.0,-17.0,0.43869543075561523,352.1647341799005,47,84,-342,592,173,524,1167,40,32.53
2,-16,0,2.0,-16.0,0.4430882930755615,336.1547262794322,47,82,-326,592,173,524,1167,40,31.17
1,-17,0,1.0,-17.0,0.4511404037475586,319.4401352366355,47,81,-309,592,173,524,1167,40,30.33
2,-16,0,2.0,-16.0,0.45914244651794434,303.4633421024688,47,79,-293,592,173,524,1167,40,28.95
0,-16,0,-0.0,-16.0,0.46709632873535156,288.0451353520833,47,79,-277,592,173,524,1167,40,26.41
1,-16,0,1.0,-16.0,0.4807872772216797,272.40594707164524,47,78,-261,592,173,524,1167,40,25.93
0,-15,0,-0.0,-15.0,0.48586225509643555,258.0697580112788,47,78,-246,592,173,524,1167,40,23.22
0,-15,0,-0.0,-15.0,0.49104928970336914,243.81345327934633,47,78,-231,592,173,524,1167,40,22.17
0,-14,0,-0.0,-14.0,0.5004253387451172,230.59271454232893,47,78,-217,592,173,524,1167,40,20.21
0,-13,0,-0.0,-13.0,0.5114853382110596,218.40329667841556,47,78,-204,592,173,524,1167,40,18.35
0,-11,0,-0.0,-11.0,0.5152113437652588,208.16579930430456,47,78,-193,592,173,524,1167,40,15.69
0,-11,0,-0.0,-11.0,0.5249724388122559,198.01010075246163,47,78,-182,592,173,524,1167,40,15.0
0,-9,0,-0.0,-9.0,0.5319364070892334,189.77091452590938,47,78,-173,592,173,524,1167,40,12.54
1,-7,0,1.0,-7.0,0.5390753746032715,182.98907071188705,47,77,-166,592,173,524,1167,40,11.2
0,-7,0,-0.0,-7.0,0.5470983982086182,176.6635219845908,47,77,-159,592,173,524,1167,40,9.85
1,-5,0,1.0,-5.0,0.5559344291687012,171.73234989366446,47,76,-154,592,173,524,1167,40,8.91
0,-4,0,-0.0,-4.0,0.5630934238433838,168.15469068687915,47,76,-150,592,173,524,1167,40,6.43
1,-5,0,1.0,-5.0,0.5712463855743408,163.24827717314508,47,75,-145,592,173,524,1167,40,8.53
1,-5,0,1.0,-5.0,0.579200267791748,158.35403373454054,47,74,-140,592,173,524,1167,40,8.32
1,-4,0,1.0,-4.0,0.5882503986358643,154.35349040433132,47,73,-136,592,173,524,1167,40,7.47
2,-5,0,2.0,-5.0,0.5971584320068359,149.00335566691106,47,71,-131,592,173,524,1167,40,9.72
1,-5,0,1.0,-5.0,0.6031203269958496,144.138821973818,47,70,-126,592,173,524,1167,40,7.76
1,-4,0,1.0,-4.0,0.6110854148864746,140.1606221447379,47,69,-122,592,173,524,1167,40,6.96
2,-5,0,2.0,-5.0,0.6191864013671875,134.82581355215328,47,67,-117,592,173,524,1167,40,8.98
2,-5,0,2.0,-5.0,0.6333153247833252,129.49517365523704,47,65,-112,592,173,524,1167,40,8.74
2,-5,0,2.0,-5.0,0.6458573341369629,124.16923934694937,47,63,-107,592,173,524,1167,40,8.49
3,-5,0,3.0,-5.0,0.6461882591247559,118.33849753989612,47,60,-102,592,173,524,1167,40,11.66
3,-5,0,3.0,-5.0,0.6515672206878662,112.50777750893491,47,57,-97,592,173,524,1167,40,11.41
2,-5,0,2.0,-5.0,0.6590862274169922,107.18675291284833,47,55,-92,592,173,524,1167,40,7.81
3,-4,0,3.0,-4.0,0.6682782173156738,102.2154587134451,47,52,-88,592,173,524,1167,40,7.86
3,-4,0,3.0,-4.0,0.6752114295959473,97.24710792614863,47,49,-84,592,173,524,1167,40,7.61
4,-5,0,4.0,-5.0,0.6831722259521484,90.91754506144565,47,45,-79,592,173,524,1167,40,7.85
4,-4,0,4.0,-4.0,0.6912684440612793,85.47514258543241,47,41,-75,592,173,524,1167,40,6.24
4,-3,0,4.0,-3.0,0.7005584239959717,80.95060222135473,47,37,-72,592,173,524,1167,40,4.85
3,-3,0,3.0,-3.0,0.70709228515625,76.92203845452875,47,34,-69,592,173,524,1167,40,4.88
3,-3,0,3.0,-3.0,0.7165532112121582,72.91776189653656,47,31,-66,592,173,524,1167,40,4.66
2,-2,0,2.0,-2.0,0.7242233753204346,70.26378868236469,47,29,-64,592,173,524,1167,40,3.77
3,-3,0,3.0,-3.0,0.7312092781066895,66.30987860040162,47,26,-61,592,173,524,1167,40,4.27
3,-4,0,3.0,-4.0,0.7394192218780518,61.465437442517235,47,23,-57,592,173,524,1167,40,5.07
2,-3,0,2.0,-3.0,0.7488393783569336,57.9396237474839,47,21,-54,592,173,524,1167,40,4.58
3,-3,0,3.0,-3.0,0.7571523189544678,54.08326913195984,47,18,-51,592,173,524,1167,40,3.57
3,-3,0,3.0,-3.0,0.7630734443664551,50.28916384272063,47,15,-48,592,173,524,1167,40,3.29
2,-3,0,2.0,-3.0,0.7710764408111572,46.84015371452148,47,13,-45,592,173,524,1167,40,3.69
3,-4,0,3.0,-4.0,0.781137228012085,42.20189569201838,47,10,-41,592,173,524,1167,40,3.52
3,-3,0,3.0,-3.0,0.7874412536621094,38.63935817272331,47,7,-38,592,173,524,1167,40,2.42
1,-3,0,1.0,-3.0,0.7950904369354248,35.510561809129406,47,6,-35,592,173,524,1167,40,4.16
2,-3,0,2.0,-3.0,0.8030753135681152,32.2490309931942,47,4,-32,592,173,524,1167,40,2.48
1,-3,0,1.0,-3.0,0.8123953342437744,29.154759474226502,47,3,-29,592,173,524,1167,40,3.4
2,-3,0,2.0,-3.0,0.8191413879394531,26.019223662515376,47,1,-26,592,173,524,1167,40,1.92
1,-3,0,1.0,-3.0,0.8271782398223877,23.0,47,0,-23,592,173,524,1167,40,2.55
1,-2,0,1.0,-2.0,0.8351762294769287,21.02379604162864,47,-1,-21,592,173,524,1167,40,1.65
0,-1,0,-0.0,-1.0,0.847130298614502,20.024984394500787,47,-1,-20,592,173,524,1167,40,4.69
1,-1,0,1.0,-1.0,0.8513693809509277,19.1049731745428,47,-2,-19,592,173,524,1167,40,0.68
0,-1,0,-0.0,-1.0,0.8598814010620117,18.110770276274835,47,-2,-18,592,173,524,1167,40,3.66
0,0,1,-0.0,-0.0,0.8850712776184082,18.110770276274835,47,-2,-18,592,173,524,1167,40,32.33
0,0,0,-0.0,-0.0,0.09250545501708984,915.9967248849747,48,795,455,1389,646,594,191,40,195.54
0,1,0,-0.0,1.0,0.13059449195861816,915.5004096121421,48,795,454,1389,646,594,191,40,3.01
0,2,0,-0.0,2.0,0.13848352432250977,914.510251446095,48,795,452,1389,646,594,191,40,5.24
0,1,0,-0.0,1.0,0.15687060356140137,914.0164112312207,48,795,451,1389,646,594,191,40,2.99
0,2,0,-0.0,2.0,0.15701961517333984,913.0312152385591,48,795,449,1389,646,594,191,40,5.21
0,1,0,-0.0,1.0,0.16323447227478027,912.5398621430189,48,795,448,1389,646,594,191,40,2.97
0,2,0,-0.0,2.0,0.17047953605651855,911.5596524638418,48,795,446,1389,646,594,191,40,5.18
2,3,0,2.0,3.0,0.18690943717956543,908.3490518517648,48,793,443,1389,646,594,191,40,15.75
3,4,0,3.0,4.0,0.1875925064086914,903.7815001425953,48,790,439,1389,646,594,191,40,21.14
6,4,0,6.0,4.0,0.19533944129943848,896.5941110669867,48,784,435,1389,646,594,191,40,32.46
8,2,0,8.0,2.0,0.2028665542602539,888.6309695255956,48,776,433,1389,646,594,191,40,33.32
9,1,0,9.0,1.0,0.21074748039245605,880.2914290165502,48,767,432,1389,646,594,191,40,33.76
13,2,0,13.0,2.0,0.2234344482421875,867.9953916928362,48,754,430,1389,646,594,191,40,45.02
19,5,0,19.0,5.0,0.22669339179992676,849.0288569889718,48,735,425,1389,646,594,191,40,60.41
26,7,0,26.0,7.0,0.23577141761779785,823.0461712443598,48,709,418,1389,646,594,191,40,71.99
27,10,0,27.0,10.0,0.24251842498779297,794.725109707753,48,682,408,1389,646,594,191,40,74.59
31,13,0,31.0,13.0,0.259920597076416,761.4630654207728,48,651,395,1389,646,594,191,40,79.61
33,14,0,33.0,14.0,0.2603724002838135,726.006198320648,48,618,381,1389,646,594,191,40,79.9
32,16,0,32.0,16.0,0.2676963806152344,690.3774330031364,48,586,365,1389,646,594,191,40,78.31
31,16,0,31.0,16.0,0.27863359451293945,655.611165249647,48,555,349,1389,646,594,191,40,75.07
30,17,0,30.0,17.0,0.28537940979003906,621.1674492437606,48,525,332,1389,646,594,191,40,72.96
29,16,0,29.0,16.0,0.29123353958129883,588.1088334653714,48,496,316,1389,646,594,191,40,68.79
29,18,0,29.0,18.0,0.30347537994384766,553.9792414883432,48,467,298,1389,646,594,191,40,69.0
31,18,0,31.0,18.0,0.3091895580291748,518.1659965686672,48,436,280,1389,646,594,191,40,66.56
31,20,0,31.0,20.0,0.3151564598083496,481.27435003332556,48,405,260,1389,646,594,191,40,66.55
31,19,0,31.0,19.0,0.3224935531616211,444.9235889453379,48,374,241,1389,646,594,191,40,61.6
30,18,0,30.0,18.0,0.3309354782104492,409.9573148511928,48,344,223,1389,646,594,191,40,56.95
28,17,0,28.0,17.0,0.3385345935821533,377.2161184254989,48,316,206,1389,646,594,191,40,52.36
27,16,0,27.0,16.0,0.3472104072570801,345.86268951709724,48,289,190,1389,646,594,191,40,48.01
26,14,0,26.0,14.0,0.35547757148742676,316.45694809878955,48,263,176,1389,646,594,191,40,42.94
23,14,0,23.0,14.0,0.366504430770874,289.5582842883277,48,240,162,1389,646,594,191,40,39.48
21,13,0,21.0,13.0,0.37355947494506836,264.8811054039151,48,219,149,1389,646,594,191,40,35.68
18,12,0,18.0,12.0,0.3784775733947754,243.24884377936928,48,201,137,1389,646,594,191,40,32.82
18,11,0,18.0,11.0,0.3885765075683594,222.1823575354263,48,183,126,1389,646,594,191,40,28.94
17,11,0,17.0,11.0,0.39470458030700684,201.94306128213466,48,166,115,1389,646,594,191,40,27.24
15,10,0,15.0,10.0,0.402848482131958,183.91846019364124,48,151,105,1389,646,594,191,40,24.63
15,10,0,15.0,10.0,0.41079044342041016,165.89454481688057,48,136,95,1389,646,594,191,40,23.04
13,9,0,13.0,9.0,0.4201374053955078,150.08331019803634,48,123,86,1389,646,594,191,40,21.42
11,8,0,11.0,8.0,0.4275515079498291,136.48443134658254,48,112,78,1389,646,594,191,40,17.82
10,8,0,10.0,8.0,0.4344635009765625,123.70933675353692,48,102,70,1389,646,594,191,40,14.89
7,6,0,7.0,6.0,0.4425334930419922,114.54693361238441,48,95,64,1389,646,594,191,40,11.33
7,6,0,7.0,6.0,0.4504854679107666,105.39449701004318,48,88,58,1389,646,594,191,40,10.69
7,6,0,7.0,6.0,0.4589855670928955,96.25487000666512,48,81,52,1389,646,594,191,40,10.02
8,6,0,8.0,6.0,0.46848559379577637,86.28441342444185,48,73,46,1389,646,594,191,40,10.56
8,6,0,8.0,6.0,0.4745035171508789,76.32168761236873,48,65,40,1389,646,594,191,40,9.74
7,6,0,7.0,6.0,0.4824485778808594,67.23094525588644,48,58,34,1389,646,594,191,40,7.84
6,4,0,6.0,4.0,0.4914414882659912,60.03332407921454,48,52,30,1389,646,594,191,40,7.94
4,2,0,4.0,2.0,0.49848055839538574,55.569775957799216,48,48,28,1389,646,594,191,40,6.53
1,1,0,1.0,1.0,0.5067164897918701,54.20332093147061,48,47,27,1389,646,594,191,40,3.24
1,0,0,1.0,-0.0,0.514439582824707,53.33854141237835,48,46,27,1389,646,594,191,40,2.02
1,0,0,1.0,-0.0,0.5624544620513916,52.478567053607705,48,45,27,1389,646,594,191,40,1.99
1,0,0,1.0,-0.0,0.5784974098205566,51.62363799656123,48,44,27,1389,646,594,191,40,1.95
1,0,0,1.0,-0.0,0.6025354862213135,50.774009099144415,48,43,27,1389,646,594,191,40,1.91
1,0,0,1.0,-0.0,0.6113815307617188,49.92995093127971,48,42,27,1389,646,594,191,40,1.88
2,0,0,2.0,-0.0,0.6270115375518799,48.25971404805462,48,40,27,1389,646,594,191,40,2.1
2,0,0,2.0,-0.0,0.6344563961029053,46.61544808322666,48,38,27,1389,646,594,191,40,2.0
3,0,0,3.0,-0.0,0.643958568572998,44.204072210600685,48,35,27,1389,646,594,191,40,2.11
2,0,0,2.0,-0.0,0.652740478515625,42.638011210655684,48,33,27,1389,646,594,191,40,1.73
3,0,0,3.0,-0.0,0.6584935188293457,40.36087214122113,48,30,27,1389,646,594,191,40,1.78
3,0,0,3.0,-0.0,0.6710546016693115,38.18376618407357,48,27,27,1389,646,594,191,40,1.58
2,0,0,2.0,-0.0,0.6795375347137451,36.796738985948195,48,25,27,1389,646,594,191,40,1.27
2,0,0,2.0,-0.0,0.6849246025085449,35.4682957019364,48,23,27,1389,646,594,191,40,1.15
1,1,0,1.0,1.0,0.6905174255371094,34.058772731852805,48,22,26,1389,646,594,191,40,4.44
2,0,0,2.0,-0.0,0.6985695362091064,32.802438933713454,48,20,26,1389,646,594,191,40,0.98
1,0,0,1.0,-0.0,0.7067875862121582,32.202484376209235,48,19,26,1389,646,594,191,40,0.86
2,1,0,2.0,1.0,0.7147274017333984,30.23243291566195,48,17,25,1389,646,594,191,40,1.98
1,0,0,1.0,-0.0,0.7233855724334717,29.68164415931166,48,16,25,1389,646,594,191,40,0.72
1,1,0,1.0,1.0,0.7363755702972412,28.30194339616981,48,15,24,1389,646,594,191,40,2.98
0,0,1,-0.0,-0.0,0.7426674365997314,28.30194339616981,48,15,24,1389,646,594,191,40,35.43
1,0,1,1.0,-0.0,0.747234582901001,27.784887978899608,48,14,24,1389,646,594,191,40,10.62
0,0,0,-0.0,-0.0,0.09077954292297363,295.4132698441287,49,287,-70,1662,552,1375,622,70,95.87
0,1,0,-0.0,1.0,0.18680262565612793,295.65182225043026,49,287,-71,1662,552,1375,622,70,5.38
-2,0,0,-2.0,-0.0,0.1948544979095459,297.59368272864936,49,289,-71,1662,552,1375,622,70,3.32
-1,0,0,-1.0,-0.0,0.20540666580200195,298.564900817226,49,290,-71,1662,552,1375,622,70,4.02
0,1,0,-0.0,1.0,0.2107245922088623,298.80428377116687,49,290,-72,1662,552,1375,622,70,5.4
0,-1,0,-0.0,-1.0,0.25124359130859375,298.564900817226,49,290,-71,1662,552,1375,622,70,0.65
2,-4,0,2.0,-4.0,0.2596755027770996,295.6907167971291,49,288,-67,1662,552,1375,622,70,4.33
5,-4,0,5.0,-4.0,0.267256498336792,289.9275771636772,49,283,-63,1662,552,1375,622,70,8.34
6,-4,0,6.0,-4.0,0.2747197151184082,283.21370023358685,49,277,-59,1662,552,1375,622,70,9.44
7,-6,0,7.0,-6.0,0.28358960151672363,275.1526848860465,49,270,-53,1662,552,1375,622,70,10.12
7,-5,0,7.0,-5.0,0.2907295227050781,267.3443472377899,49,263,-48,1662,552,1375,622,70,9.93
6,-6,0,6.0,-6.0,0.29886865615844727,260.40929322894755,49,257,-42,1662,552,1375,622,70,8.45
7,-5,0,7.0,-5.0,0.3067436218261719,252.7231687044146,49,250,-37,1662,552,1375,622,70,9.36
7,-5,0,7.0,-5.0,0.3162815570831299,245.0979396078229,49,243,-32,1662,552,1375,622,70,9.08
9,-5,0,9.0,-5.0,0.3261566162109375,235.55254190944322,49,234,-27,1662,552,1375,622,70,10.74
10,-4,0,10.0,-4.0,0.3308227062225342,225.17770760001977,49,224,-23,1662,552,1375,622,70,11.54
10,-4,0,10.0,-4.0,0.3390665054321289,214.84180226389836,49,214,-19,1662,552,1375,622,70,11.11
11,-3,0,11.0,-3.0,0.34685850143432617,203.62956563328422,49,203,-16,1662,552,1375,622,70,11.95
11,-3,0,11.0,-3.0,0.3550136089324951,192.43960091415696,49,192,-13,1662,552,1375,622,70,11.45
12,-2,0,12.0,-2.0,0.36492252349853516,180.33579788827288,49,180,-11,1662,552,1375,622,70,12.43
12,-1,0,12.0,-1.0,0.37563657760620117,168.2973558912914,49,168,-10,1662,552,1375,622,70,13.64
11,-2,0,11.0,-2.0,0.384981632232666,157.20368952413298,49,157,-8,1662,552,1375,622,70,10.64
12,0,0,12.0,-0.0,0.38831067085266113,145.2205219657332,49,145,-8,1662,552,1375,622,70,11.71
12,-1,0,12.0,-1.0,0.3976097106933594,133.18408313308313,49,133,-7,1662,552,1375,622,70,11.9
10,0,0,10.0,-0.0,0.4093616008758545,123.1990259701756,49,123,-7,1662,552,1375,622,70,9.8
11,-1,0,11.0,-1.0,0.4168386459350586,112.16059914247963,49,112,-6,1662,552,1375,622,70,10.33
11,-2,0,11.0,-2.0,0.418750524520874,101.07917688624102,49,101,-4,1662,552,1375,622,70,8.17
9,-1,0,9.0,-1.0,0.4283325672149658,92.04890004774636,49,92,-3,1662,552,1375,622,70,7.8
8,-1,0,8.0,-1.0,0.4351515769958496,84.02380615040002,49,84,-2,1662,552,1375,622,70,6.81
9,-2,0,9.0,-2.0,0.4430685043334961,75.0,49,75,0,1662,552,1375,622,70,5.72
7,-2,0,7.0,-2.0,0.4561436176300049,68.0294054067798,49,68,2,1662,552,1375,622,70,4.36
6,-1,0,6.0,-1.0,0.46123766899108887,62.07253821135398,49,62,3,1662,552,1375,622,70,4.4
6,-2,0,6.0,-2.0,0.46691465377807617,56.22277118748239,49,56,5,1662,552,1375,622,70,3.24
5,-3,0,5.0,-3.0,0.47475647926330566,51.62363799656123,49,51,8,1662,552,1375,622,70,2.01
5,-1,0,5.0,-1.0,0.48392653465270996,46.87216658103186,49,46,9,1662,552,1375,622,70,2.78
4,-2,0,4.0,-2.0,0.4909236431121826,43.41658669218482,49,42,11,1662,552,1375,622,70,1.52
3,-2,0,3.0,-2.0,0.4987616539001465,41.10960958218893,49,39,13,1662,552,1375,622,70,0.93
3,-1,0,3.0,-1.0,0.5070827007293701,38.62641583165593,49,36,14,1662,552,1375,622,70,1.35
4,-2,0,4.0,-2.0,0.5180234909057617,35.77708763999664,49,32,16,1662,552,1375,622,70,0.8
2,-2,0,2.0,-2.0,0.5244705677032471,34.9857113690718,49,30,18,1662,552,1375,622,70,0.01
2,-2,0,2.0,-2.0,0.5369985103607178,34.40930106817051,49,28,20,1662,552,1375,622,70,-0.13
2,0,0,2.0,-0.0,0.5390546321868896,32.802438933713454,49,26,20,1662,552,1375,622,70,1.27
1,-1,0,1.0,-1.0,0.5471465587615967,32.64965543462902,49,25,21,1662,552,1375,622,70,-0.07
1,0,0,1.0,-0.0,0.5548946857452393,31.89043743820395,49,24,21,1662,552,1375,622,70,1.14
0,0,1,-0.0,-0.0,0.5758626461029053,31.89043743820395,49,24,21,1662,552,1375,622,70,36.53
0,0,0,-0.0,-0.0,0.0988163948059082,373.1621631409058,50,-115,355,1523,886,1638,531,43,111.97
-1,1,0,-1.0,1.0,0.1357882022857666,371.9032132154816,50,-114,354,1523,886,1638,531,43,4.77
-1,0,0,-1.0,-0.0,0.1449892520904541,371.5979009628553,50,-113,354,1523,886,1638,531,43,1.16
-2,1,0,-2.0,1.0,0.15470027923583984,370.04053831979,50,-111,353,1523,886,1638,531,43,4.68
-2,2,0,-2.0,2.0,0.16194725036621094,367.535032343857,50,-109,351,1523,886,1638,531,43,7.45
-3,1,0,-3.0,1.0,0.16781139373779297,365.6993300513415,50,-106,350,1523,886,1638,531,43,5.0
-5,2,0,-5.0,2.0,0.17591643333435059,362.36031791574527,50,-101,348,1523,886,1638,531,43,8.2
-6,3,0,-6.0,3.0,0.18402338027954102,357.8407467016578,50,-95,345,1523,886,1638,531,43,10.56
-6,4,0,-6.0,4.0,0.19695639610290527,352.42304124446804,50,-89,341,1523,886,1638,531,43,12.33
-6,4,0,-6.0,4.0,0.2015242576599121,347.0705980056507,50,-83,337,1523,886,1638,531,43,12.06
-7,4,0,-7.0,4.0,0.2102043628692627,341.5625857730908,50,-76,333,1523,886,1638,531,43,12.04
-6,5,0,-6.0,5.0,0.21582436561584473,335.38634438509865,50,-70,328,1523,886,1638,531,43,13.38
-5,5,0,-5.0,5.0,0.22392940521240234,329.4753405036559,50,-65,323,1523,886,1638,531,43,12.96
-4,6,0,-4.0,6.0,0.23207330703735352,322.8157369150395,50,-61,317,1523,886,1638,531,43,14.58
-4,7,0,-4.0,7.0,0.24032926559448242,315.19676394277906,50,-57,310,1523,886,1638,531,43,16.09
-3,7,0,-3.0,7.0,0.24820327758789062,307.77426793024785,50,-54,303,1523,886,1638,531,43,16.09
-3,11,0,-3.0,11.0,0.2557833194732666,296.42030969554025,50,-51,292,1523,886,1638,531,43,22.3
-3,9,0,-3.0,9.0,0.2640683650970459,287.04180880143576,50,-48,283,1523,886,1638,531,43,18.67
-3,11,0,-3.0,11.0,0.271801233291626,275.6972977742074,50,-45,272,1523,886,1638,531,43,21.2
-4,14,0,-4.0,14.0,0.28238821029663086,261.2374398894615,50,-41,258,1523,886,1638,531,43,23.7
-4,14,0,-4.0,14.0,0.2878232002258301,246.78938388836744,50,-37,244,1523,886,1638,531,43,22.75
-3,15,0,-3.0,15.0,0.29602837562561035,231.51025895195227,50,-34,229,1523,886,1638,531,43,23.78
-3,15,0,-3.0,15.0,0.3043093681335449,216.23366990364843,50,-31,214,1523,886,1638,531,43,22.71
-4,15,0,-4.0,15.0,0.31180238723754883,200.8233054204616,50,-27,199,1523,886,1638,531,43,20.71
-2,14,0,-2.0,14.0,0.3205103874206543,186.6815470259447,50,-25,185,1523,886,1638,531,43,21.64
-3,13,0,-3.0,13.0,0.33275938034057617,173.40126873814967,50,-22,172,1523,886,1638,531,43,17.51
-2,12,0,-2.0,12.0,0.33814334869384766,161.24515496597098,50,-20,160,1523,886,1638,531,43,16.98
-1,12,0,-1.0,12.0,0.34444642066955566,149.21461054467824,50,-19,148,1523,886,1638,531,43,16.05
0,9,0,-0.0,9.0,0.3523373603820801,140.29255147726127,50,-19,139,1523,886,1638,531,43,11.8
-1,7,0,-1.0,7.0,0.3598003387451172,133.2216198670471,50,-18,132,1523,886,1638,531,43,13.04
0,6,0,-0.0,6.0,0.3677823543548584,127.27922061357856,50,-18,126,1523,886,1638,531,43,8.84
-1,7,0,-1.0,7.0,0.37575221061706543,120.20815280171308,50,-17,119,1523,886,1638,531,43,13.14
-1,5,0,-1.0,5.0,0.3837893009185791,115.11733144926528,50,-16,114,1523,886,1638,531,43,8.88
0,5,0,-0.0,5.0,0.39185023307800293,110.16805344563369,50,-16,109,1523,886,1638,531,43,7.45
0,5,0,-0.0,5.0,0.3997623920440674,105.22357150372724,50,-16,104,1523,886,1638,531,43,7.22
-1,6,0,-1.0,6.0,0.40777134895324707,99.14131328563285,50,-15,98,1523,886,1638,531,43,10.5
0,5,0,-0.0,5.0,0.4174642562866211,94.2019108086455,50,-15,93,1523,886,1638,531,43,6.78
-1,4,0,-1.0,4.0,0.4238274097442627,90.09439494219383,50,-14,89,1523,886,1638,531,43,6.89
-1,5,0,-1.0,5.0,0.4326133728027344,85.0,50,-13,84,1523,886,1638,531,43,8.19
-1,5,0,-1.0,5.0,0.43980836868286133,79.90619500389191,50,-12,79,1523,886,1638,531,43,7.93
0,4,0,-0.0,4.0,0.4492192268371582,75.95393340703298,50,-12,75,1523,886,1638,531,43,5.62
0,3,0,-0.0,3.0,0.4566152095794678,72.99315036357864,50,-12,72,1523,886,1638,531,43,4.94
-1,3,0,-1.0,3.0,0.46389126777648926,69.87131027825369,50,-11,69,1523,886,1638,531,43,4.96
0,2,0,-0.0,2.0,0.4757254123687744,67.89698078707183,50,-11,67,1523,886,1638,531,43,4.33
-1,1,0,-1.0,1.0,0.47982120513916016,66.75327707311455,50,-10,66,1523,886,1638,531,43,1.98
0,2,0,-0.0,2.0,0.4877743721008301,64.77653896280658,50,-10,64,1523,886,1638,531,43,4.34
0,1,0,-0.0,1.0,0.5019943714141846,63.788713735268246,50,-10,63,1523,886,1638,531,43,3.81
0,1,0,-0.0,1.0,0.5037832260131836,62.80127387243033,50,-10,62,1523,886,1638,531,43,3.78
0,0,1,-0.0,-0.0,0.5577974319458008,62.80127387243033,50,-10,62,1523,886,1638,531,43,35.95
0,0,0,-0.0,-0.0,0.6067912578582764,62.80127387243033,50,-10,62,1523,886,1638,531,43,35.95
-1,1,0,-1.0,1.0,0.6079154014587402,61.66036003787198,50,-9,61,1523,886,1638,531,43,1.92
0,3,0,-0.0,3.0,0.615868330001831,58.69412236331676,50,-9,58,1523,886,1638,531,43,4.68
0,2,0,-0.0,2.0,0.6237812042236328,56.71860364994893,50,-9,56,1523,886,1638,531,43,4.16
0,4,0,-0.0,4.0,0.6328732967376709,52.773099207835045,50,-9,52,1523,886,1638,531,43,4.76
0,3,0,-0.0,3.0,0.6429252624511719,49.8196748283246,50,-9,49,1523,886,1638,531,43,4.21
-1,2,0,-1.0,2.0,0.6488614082336426,47.67598976424087,50,-8,47,1523,886,1638,531,43,3.19
0,3,0,-0.0,3.0,0.6558113098144531,44.721359549995796,50,-8,44,1523,886,1638,531,43,4.08
0,3,0,-0.0,3.0,0.6642212867736816,41.773197148410844,50,-8,41,1523,886,1638,531,43,3.89
0,2,0,-0.0,2.0,0.6717772483825684,39.81205847478876,50,-8,39,1523,886,1638,531,43,3.48
0,1,0,-0.0,1.0,0.6805362701416016,38.8329756778952,50,-8,38,1523,886,1638,531,43,3.17
0,1,0,-0.0,1.0,0.6877963542938232,37.8549864614954,50,-8,37,1523,886,1638,531,43,3.13
0,1,0,-0.0,1.0,0.6961562633514404,36.87817782917155,50,-8,36,1523,886,1638,531,43,3.08
0,2,0,-0.0,2.0,0.7062473297119141,34.92849839314596,50,-8,34,1523,886,1638,531,43,3.18
0,1,0,-0.0,1.0,0.714003324508667,33.95585369269929,50,-8,33,1523,886,1638,531,43,2.92
0,1,0,-0.0,1.0,0.7198033332824707,32.984845004941285,50,-8,32,1523,886,1638,531,43,2.86
0,1,0,-0.0,1.0,0.7277822494506836,32.01562118716424,50,-8,31,1523,886,1638,531,43,2.81
0,0,1,-0.0,-0.0,0.740814208984375,32.01562118716424,50,-8,31,1523,886,1638,531,43,36.57
-1,0,1,-1.0,-0.0,0.7471733093261719,31.78049716414141,50,-7,31,1523,886,1638,531,43,10.2
0,1,1,-0.0,1.0,0.03819012641906738,1331.7694995756585,51,-1293,-319,237,537,1530,855,17,46.62
0,0,0,-0.0,-0.0,0.14081907272338867,1331.7694995756585,51,-1293,-319,237,537,1530,855,17,240.97
-4,-2,0,-4.0,-2.0,0.21888208389282227,1327.4072472304797,51,-1289,-317,237,537,1530,855,17,50.59
-5,-3,0,-5.0,-3.0,0.23426413536071777,1321.836601097125,51,-1284,-314,237,537,1530,855,17,60.0
-9,-6,0,-9.0,-6.0,0.23589515686035156,1311.6741211139297,51,-1275,-308,237,537,1530,855,17,89.08
-9,-5,0,-9.0,-5.0,0.24755620956420898,1301.7545851657294,51,-1266,-303,237,537,1530,855,17,87.76
-11,-5,0,-11.0,-5.0,0.2507941722869873,1289.8949569635506,51,-1255,-298,237,537,1530,855,17,97.54
-15,-7,0,-15.0,-7.0,0.25927019119262695,1273.6879523650996,51,-1240,-291,237,537,1530,855,17,114.38
-21,-8,0,-21.0,-8.0,0.2676851749420166,1251.419194354953,51,-1219,-283,237,537,1530,855,17,131.67
-26,-9,0,-26.0,-9.0,0.2747950553894043,1224.060864499801,51,-1193,-274,237,537,1530,855,17,141.45
-26,-7,0,-26.0,-7.0,0.28522419929504395,1197.1541254157712,51,-1167,-267,237,537,1530,855,17,140.07
-27,-6,0,-27.0,-6.0,0.2958052158355713,1169.4960453118258,51,-1140,-261,237,537,1530,855,17,141.03
-26,-4,0,-26.0,-4.0,0.29877805709838867,1143.260687682385,51,-1114,-257,237,537,1530,855,17,134.52
-28,-3,0,-28.0,-3.0,0.3068242073059082,1115.308029200902,51,-1086,-254,237,537,1530,855,17,135.21
-30,-4,0,-30.0,-4.0,0.3153359889984131,1085.1893843933417,51,-1056,-250,237,537,1530,855,17,137.02
-32,-4,0,-32.0,-4.0,0.32382702827453613,1053.1343693945232,51,-1024,-246,237,537,1530,855,17,137.48
-36,-5,0,-36.0,-5.0,0.3309140205383301,1016.9685344198217,51,-988,-241,237,537,1530,855,17,140.24
-37,-5,0,-37.0,-5.0,0.3388400077819824,979.8453959681599,51,-951,-236,237,537,1530,855,17,138.28
-43,-5,0,-43.0,-5.0,0.34677720069885254,936.9231558671181,51,-908,-231,237,537,1530,855,17,140.24
-47,-8,0,-47.0,-8.0,0.35477399826049805,889.4099167425558,51,-861,-223,237,537,1530,855,17,140.31
-46,-7,0,-46.0,-7.0,0.36818909645080566,843.1375925671919,51,-815,-216,237,537,1530,855,17,134.72
-45,-8,0,-45.0,-8.0,0.38482117652893066,797.5988966893071,51,-770,-208,237,537,1530,855,17,130.04
-43,-6,0,-43.0,-6.0,0.3851170539855957,754.54158268448,51,-727,-202,237,537,1530,855,17,123.36
-37,-7,0,-37.0,-7.0,0.38678407669067383,717.0251041630272,51,-690,-195,237,537,1530,855,17,115.47
-33,-8,0,-33.0,-8.0,0.3948090076446533,683.0944297825887,51,-657,-187,237,537,1530,855,17,109.62
-27,-5,0,-27.0,-5.0,0.4028642177581787,655.7621520033007,51,-630,-182,237,537,1530,855,17,98.26
-22,-6,0,-22.0,-6.0,0.41080498695373535,632.9612942352794,51,-608,-176,237,537,1530,855,17,91.58
-19,-5,0,-19.0,-5.0,0.4188392162322998,613.320470879621,51,-589,-171,237,537,1530,855,17,84.03
-18,-5,0,-18.0,-5.0,0.4267702102661133,594.6402273644123,51,-571,-166,237,537,1530,855,17,81.27
-18,-6,0,-18.0,-6.0,0.43482398986816406,575.6813354625978,51,-553,-160,237,537,1530,855,17,79.14
-20,-5,0,-20.0,-5.0,0.4453260898590088,555.0801743892498,51,-533,-155,237,537,1530,855,17,80.26
-21,-6,0,-21.0,-6.0,0.45169806480407715,533.2400960167943,51,-512,-149,237,537,1530,855,17,81.71
-26,-7,0,-26.0,-7.0,0.45925307273864746,506.32005688102066,51,-486,-142,237,537,1530,855,17,84.72
-27,-7,0,-27.0,-7.0,0.468764066696167,478.44121896007243,51,-459,-135,237,537,1530,855,17,82.34
-29,-9,0,-29.0,-9.0,0.47478508949279785,448.08034993737454,51,-430,-126,237,537,1530,855,17,81.98
-29,-8,0,-29.0,-8.0,0.48279404640197754,418.0011961705373,51,-401,-118,237,537,1530,855,17,78.09
-28,-8,0,-28.0,-8.0,0.49077415466308594,388.8817300928394,51,-373,-110,237,537,1530,855,17,74.25
-26,-8,0,-26.0,-8.0,0.4987761974334717,361.6807984950266,51,-347,-102,237,537,1530,855,17,68.93
-22,-7,0,-22.0,-7.0,0.5069551467895508,338.60005906674024,51,-325,-95,237,537,1530,855,17,61.63
-21,-8,0,-21.0,-8.0,0.5147662162780762,316.2040480449294,51,-304,-87,237,537,1530,855,17,56.76
-16,-7,0,-16.0,-7.0,0.523327112197876,298.9046670763105,51,-288,-80,237,537,1530,855,17,48.31
-14,-8,0,-14.0,-8.0,0.5308101177215576,283.30195904723286,51,-274,-72,237,537,1530,855,17,43.53
-14,-8,0,-14.0,-8.0,0.5396690368652344,267.76108753887297,51,-260,-64,237,537,1530,855,17,41.69
-15,-8,0,-15.0,-8.0,0.547126054763794,251.31852299422738,51,-245,-56,237,537,1530,855,17,41.03
-13,-7,0,-13.0,-7.0,0.5570220947265625,237.11811402758752,51,-232,-49,237,537,1530,855,17,36.56
-12,-6,0,-12.0,-6.0,0.5627901554107666,224.1628872048181,51,-220,-43,237,537,1530,855,17,33.6
-11,-5,0,-11.0,-5.0,0.5709609985351562,212.42645786248002,51,-209,-38,237,537,1530,855,17,30.83
-10,-5,0,-10.0,-5.0,0.579888105392456,201.71762441591463,51,-199,-33,237,537,1530,855,17,28.02
-8,-4,0,-8.0,-4.0,0.5883321762084961,193.18902660347973,51,-191,-29,237,537,1530,855,17,23.78
-5,-3,0,-5.0,-3.0,0.5960299968719482,187.8084130170957,51,-186,-26,237,537,1530,855,17,17.12
-4,-3,0,-4.0,-3.0,0.6028361320495605,183.44754018519845,51,-182,-23,237,537,1530,855,17,14.26
-4,-2,0,-4.0,-2.0,0.6137070655822754,179.2344832893492,51,-178,-21,237,537,1530,855,17,14.27
-6,-3,0,-6.0,-3.0,0.6206190586090088,172.9392957080605,51,-172,-18,237,537,1530,855,17,18.09
-6,-4,0,-6.0,-4.0,0.6268010139465332,166.5893153836704,51,-166,-14,237,537,1530,855,17,17.24
-6,-2,0,-6.0,-2.0,0.6409761905670166,160.44936896105264,51,-160,-12,237,537,1530,855,17,17.44
-5,-2,0,-5.0,-2.0,0.6468331813812256,155.32224567009067,51,-155,-10,237,537,1530,855,17,14.91
-4,-2,0,-4.0,-2.0,0.6517500877380371,151.21177202850313,51,-151,-8,237,537,1530,855,17,12.33
-4,-2,0,-4.0,-2.0,0.6588780879974365,147.12239802287073,51,-147,-6,237,537,1530,855,17,12.02
-5,-2,0,-5.0,-2.0,0.6678550243377686,142.0563268566381,51,-142,-4,237,537,1530,855,17,13.8
-4,-1,0,-4.0,-1.0,0.6753242015838623,138.03260484392808,51,-138,-3,237,537,1530,855,17,12.3
-5,-2,0,-5.0,-2.0,0.6842122077941895,133.00375934536586,51,-133,-1,237,537,1530,855,17,13.07
-4,-1,0,-4.0,-1.0,0.6939330101013184,129.0,51,-129,0,237,537,1530,855,17,11.64
-4,-1,0,-4.0,-1.0,0.705700159072876,125.00399993600205,51,-125,1,237,537,1530,855,17,11.36
-3,0,0,-3.0,-0.0,0.7067902088165283,122.00409829181969,51,-122,1,237,537,1530,855,17,12.97
-3,-1,0,-3.0,-1.0,0.7169520854949951,119.01680553602503,51,-119,2,237,537,1530,855,17,8.84
-3,0,0,-3.0,-0.0,0.7241671085357666,116.01724009818541,51,-116,2,237,537,1530,855,17,12.23
-3,-1,0,-3.0,-1.0,0.7317430973052979,113.03981599418853,51,-113,3,237,537,1530,855,17,8.52
-4,0,0,-4.0,-0.0,0.738781213760376,109.04127658827184,51,-109,3,237,537,1530,855,17,13.19
-4,-1,0,-4.0,-1.0,0.7468202114105225,105.07616285342742,51,-105,4,237,537,1530,855,17,10.04
-4,0,0,-4.0,-0.0,0.7548041343688965,101.07917688624102,51,-101,4,237,537,1530,855,17,12.36
-5,0,0,-5.0,-0.0,0.7671151161193848,96.08329719571451,51,-96,4,237,537,1530,855,17,13.38
-5,-1,0,-5.0,-1.0,0.77121901512146,91.13725912051558,51,-91,5,237,537,1530,855,17,10.67
-4,0,0,-4.0,-0.0,0.7787652015686035,87.14355971613737,51,-87,5,237,537,1530,855,17,11.11
-5,0,0,-5.0,-0.0,0.7908861637115479,82.15229759416349,51,-82,5,237,537,1530,855,17,11.95
-4,0,0,-4.0,-0.0,0.7960970401763916,78.16009211867653,51,-78,5,237,537,1530,855,17,10.44
-5,0,0,-5.0,-0.0,0.8028061389923096,73.17103251970687,51,-73,5,237,537,1530,855,17,11.16
-5,0,0,-5.0,-0.0,0.8123950958251953,68.18357573492314,51,-68,5,237,537,1530,855,17,10.7
-4,0,0,-4.0,-0.0,0.8210752010345459,64.19501538281614,51,-64,5,237,537,1530,855,17,9.33
-5,-1,0,-5.0,-1.0,0.8277671337127686,59.30430001273095,51,-59,6,237,537,1530,855,17,8.04
-5,0,0,-5.0,-0.0,0.8347711563110352,54.3323108288245,51,-54,6,237,537,1530,855,17,9.09
-5,0,0,-5.0,-0.0,0.8427979946136475,49.36598018878993,51,-49,6,237,537,1530,855,17,8.57
-5,0,0,-5.0,-0.0,0.8525831699371338,44.40720662234904,51,-44,6,237,537,1530,855,17,8.02
-4,0,0,-4.0,-0.0,0.8667840957641602,40.44749683231337,51,-40,6,237,537,1530,855,17,6.86
-5,0,0,-5.0,-0.0,0.8682022094726562,35.510561809129406,51,-35,6,237,537,1530,855,17,6.94
-4,0,0,-4.0,-0.0,0.8763291835784912,31.575306807693888,51,-31,6,237,537,1530,855,17,5.84
-4,0,0,-4.0,-0.0,0.8830151557922363,27.65863337187866,51,-27,6,237,537,1530,855,17,5.33
-5,-1,0,-5.0,-1.0,0.8914260864257812,23.08679276123039,51,-22,7,237,537,1530,855,17,4.04
-3,0,0,-3.0,-0.0,0.8999300003051758,20.248456731316587,51,-19,7,237,537,1530,855,17,3.51
-3,0,0,-3.0,-0.0,0.9067630767822266,17.46424919657298,51,-16,7,237,537,1530,855,17,3.03
-1,0,0,-1.0,-0.0,0.9185960292816162,16.55294535724685,51,-15,7,237,537,1530,855,17,2.15
-2,0,0,-2.0,-0.0,0.9227890968322754,14.7648230602334,51,-13,7,237,537,1530,855,17,2.16
-1,0,0,-1.0,-0.0,0.9334671497344971,13.892443989449804,51,-12,7,237,537,1530,855,17,1.74
-1,0,0,-1.0,-0.0,0.9470250606536865,13.038404810405298,51,-11,7,237,537,1530,855,17,1.58
-1,0,0,-1.0,-0.0,0.9471909999847412,12.206555615733702,51,-10,7,237,537,1530,855,17,1.42
-1,0,0,-1.0,-0.0,0.9547920227050781,11.40175425099138,51,-9,7,237,537,1530,855,17,1.24
-2,0,0,-2.0,-0.0,0.9627971649169922,9.899494936611665,51,-7,7,237,537,1530,855,17,0.93
-1,0,0,-1.0,-0.0,0.970811128616333,9.219544457292887,51,-6,7,237,537,1530,855,17,0.65
-2,0,0,-2.0,-0.0,0.9793291091918945,8.06225774829855,51,-4,7,237,537,1530,855,17,0.14
-3,0,0,-3.0,-0.0,0.9867780208587646,7.0710678118654755,51,-1,7,237,537,1530,855,17,-0.79
-2,0,0,-2.0,-0.0,0.9951291084289551,7.0710678118654755,51,1,7,237,537,1530,855,17,11.07
-1,0,0,-1.0,-0.0,1.0039269924163818,7.280109889280518,51,2,7,237,537,1530,855,17,2.04
-1,0,0,-1.0,-0.0,1.0117771625518799,7.615773105863909,51,3,7,237,537,1530,855,17,1.31
-1,0,0,-1.0,-0.0,1.0201241970062256,8.06225774829855,51,4,7,237,537,1530,855,17,1.06
0,1,0,-0.0,1.0,1.026780128479004,7.211102550927978,51,4,6,237,537,1530,855,17,1.1
-1,0,0,-1.0,-0.0,1.0445120334625244,7.810249675906654,51,5,6,237,537,1530,855,17,0.88
0,0,1,-0.0,-0.0,1.0502090454101562,7.810249675906654,51,5,6,237,537,1530,855,17,29.23
0,0,0,-0.0,-0.0,0.08511137962341309,572.8699677937394,52,362,444,594,975,232,531,53,147.45
2,0,0,2.0,-0.0,0.12547731399536133,571.6082574630985,52,360,444,594,975,232,531,53,4.18
4,0,0,4.0,-0.0,0.13364839553833008,569.0975311842426,52,356,444,594,975,232,531,53,7.2
6,0,0,6.0,-0.0,0.13965535163879395,565.3635998187361,52,350,444,594,975,232,531,53,10.0
8,-1,0,8.0,-1.0,0.14716339111328125,561.2388083516677,52,342,445,594,975,232,531,53,10.61
9,0,0,9.0,-0.0,0.15514445304870605,555.8003238574083,52,333,445,594,975,232,531,53,13.56
11,-1,0,11.0,-1.0,0.16315627098083496,550.0909015790027,52,322,446,594,975,232,531,53,13.87
11,0,0,11.0,-0.0,0.17139649391174316,543.7251143730626,52,311,446,594,975,232,531,53,15.22
13,0,0,13.0,-0.0,0.1799013614654541,536.3953765647127,52,298,446,594,975,232,531,53,16.95
13,0,0,13.0,-0.0,0.18799638748168945,529.2834779208586,52,285,446,594,975,232,531,53,16.35
13,2,0,13.0,2.0,0.19524645805358887,520.6918474491415,52,272,444,594,975,232,531,53,19.17
14,2,0,14.0,2.0,0.20801949501037598,511.78901903030317,52,258,442,594,975,232,531,53,19.45
13,4,0,13.0,4.0,0.21387934684753418,501.8655198357425,52,245,438,594,975,232,531,53,21.23
14,5,0,14.0,5.0,0.22160935401916504,490.7647094076753,52,231,433,594,975,232,531,53,22.91
14,5,0,14.0,5.0,0.22802042961120605,479.86769009801026,52,217,428,594,975,232,531,53,22.21
13,7,0,13.0,7.0,0.23563528060913086,467.821547173706,52,204,421,594,975,232,531,53,23.91
12,7,0,12.0,7.0,0.2433633804321289,456.3551248753541,52,192,414,594,975,232,531,53,22.69
11,7,0,11.0,7.0,0.2510833740234375,445.43237421633376,52,181,407,594,975,232,531,53,21.57
10,7,0,10.0,7.0,0.2614133358001709,435.01839041585356,52,171,400,594,975,232,531,53,20.54
8,7,0,8.0,7.0,0.26729631423950195,425.4621017200004,52,163,393,594,975,232,531,53,19.23
8,8,0,8.0,8.0,0.27518630027770996,415.03011938894264,52,155,385,594,975,232,531,53,20.41
6,8,0,6.0,8.0,0.28324127197265625,405.3763683294822,52,149,377,594,975,232,531,53,19.54
6,8,0,6.0,8.0,0.2933492660522461,395.73981351387937,52,143,369,594,975,232,531,53,19.19
4,8,0,4.0,8.0,0.3002464771270752,386.8358825135021,52,139,361,594,975,232,531,53,19.25
3,9,0,3.0,9.0,0.3079063892364502,377.35924528226417,52,136,352,594,975,232,531,53,20.65
3,9,0,3.0,9.0,0.3156113624572754,367.88313361718554,52,133,343,594,975,232,531,53,20.33
4,11,0,4.0,11.0,0.3242664337158203,356.1811336946414,52,129,332,594,975,232,531,53,23.7
3,11,0,3.0,11.0,0.3314473628997803,344.84344273887535,52,126,321,594,975,232,531,53,21.04
3,11,0,3.0,11.0,0.33960747718811035,333.51011978649166,52,123,310,594,975,232,531,53,20.57
5,10,0,5.0,10.0,0.34713029861450195,322.3724553990306,52,118,300,594,975,232,531,53,20.21
5,11,0,5.0,11.0,0.35509228706359863,310.3063002905355,52,113,289,594,975,232,531,53,21.43
8,13,0,8.0,13.0,0.36589741706848145,295.29815441346733,52,105,276,594,975,232,531,53,22.28
10,15,0,10.0,15.0,0.37341833114624023,277.7516876636396,52,95,261,594,975,232,531,53,23.4
10,14,0,10.0,14.0,0.3791353702545166,261.21638539724114,52,85,247,594,975,232,531,53,21.32
9,14,0,9.0,14.0,0.38713645935058594,245.08161905781512,52,76,233,594,975,232,531,53,20.24
8,12,0,8.0,12.0,0.39568233489990234,231.22499864850255,52,68,221,594,975,232,531,53,17.4
6,12,0,6.0,12.0,0.405010461807251,218.0022935659164,52,62,209,594,975,232,531,53,16.89
6,12,0,6.0,12.0,0.4113943576812744,204.80478510034868,52,56,197,594,975,232,531,53,16.12
7,13,0,7.0,13.0,0.4190714359283447,190.41270965983338,52,49,184,594,975,232,531,53,15.93
8,13,0,8.0,13.0,0.4271113872528076,175.8465239918037,52,41,171,594,975,232,531,53,14.79
8,13,0,8.0,13.0,0.4351062774658203,161.4094173212951,52,33,158,594,975,232,531,53,13.72
8,13,0,8.0,13.0,0.4445183277130127,147.13938969562162,52,25,145,594,975,232,531,53,12.62
8,12,0,8.0,12.0,0.4531064033508301,134.08206442324789,52,17,133,594,975,232,531,53,10.86
7,11,0,7.0,11.0,0.46178245544433594,122.40914998479485,52,10,122,594,975,232,531,53,9.36
6,10,0,6.0,10.0,0.46707630157470703,112.0714058089752,52,4,112,594,975,232,531,53,8.04
7,10,0,7.0,10.0,0.4765923023223877,102.04410811016969,52,-3,102,594,975,232,531,53,6.99
5,8,0,5.0,8.0,0.483675479888916,94.33981132056604,52,-8,94,594,975,232,531,53,5.49
4,8,0,4.0,8.0,0.49193549156188965,86.83317338436964,52,-12,86,594,975,232,531,53,5.18
3,5,0,3.0,5.0,0.503075361251831,82.37718130647589,52,-15,81,594,975,232,531,53,3.34
1,6,0,1.0,6.0,0.507143497467041,76.68767828015137,52,-16,75,594,975,232,531,53,4.7
1,5,0,1.0,5.0,0.5154232978820801,72.03471385380801,52,-17,70,594,975,232,531,53,3.9
1,4,0,1.0,4.0,0.5230863094329834,68.41052550594829,52,-18,66,594,975,232,531,53,3.14
0,2,0,-0.0,2.0,0.5310864448547363,66.48308055437865,52,-18,64,594,975,232,531,53,3.33
0,4,0,-0.0,4.0,0.5391044616699219,62.6418390534633,52,-18,60,594,975,232,531,53,3.89
0,3,0,-0.0,3.0,0.5502684116363525,59.77457653551382,52,-18,57,594,975,232,531,53,3.4
0,3,0,-0.0,3.0,0.5573184490203857,56.92099788303083,52,-18,54,594,975,232,531,53,3.26
0,2,0,-0.0,2.0,0.563725471496582,55.02726596879042,52,-18,52,594,975,232,531,53,2.87
0,2,0,-0.0,2.0,0.5713844299316406,53.14132102234569,52,-18,50,594,975,232,531,53,2.79
0,1,0,-0.0,1.0,0.5791163444519043,52.20153254455275,52,-18,49,594,975,232,531,53,2.48
0,1,0,-0.0,1.0,0.5952043533325195,51.264022471905186,52,-18,48,594,975,232,531,53,2.45
-1,2,0,-1.0,2.0,0.6512644290924072,49.040799340956916,52,-17,46,594,975,232,531,53,4.37
0,1,0,-0.0,1.0,0.6592404842376709,48.104053883222775,52,-17,45,594,975,232,531,53,2.41
0,2,0,-0.0,2.0,0.667168378829956,46.238512086787566,52,-17,43,594,975,232,531,53,2.54
0,2,0,-0.0,2.0,0.6753764152526855,44.384682042344295,52,-17,41,594,975,232,531,53,2.44
-1,1,0,-1.0,1.0,0.6831662654876709,43.08131845707603,52,-16,40,594,975,232,531,53,2.26
0,2,0,-0.0,2.0,0.691218376159668,41.23105625617661,52,-16,38,594,975,232,531,53,2.36
0,2,0,-0.0,2.0,0.6991214752197266,39.395431207184416,52,-16,36,594,975,232,531,53,2.25
0,3,0,-0.0,3.0,0.7072863578796387,36.6742416417845,52,-16,33,594,975,232,531,53,2.23
0,2,0,-0.0,2.0,0.7155303955078125,34.88552708502482,52,-16,31,594,975,232,531,53,1.96
0,1,0,-0.0,1.0,0.7237973213195801,34.0,52,-16,30,594,975,232,531,53,1.81
-1,2,0,-1.0,2.0,0.731797456741333,31.76476034853718,52,-15,28,594,975,232,531,53,5.61
0,1,0,-0.0,1.0,0.739830493927002,30.886890422961002,52,-15,27,594,975,232,531,53,1.72
0,1,0,-0.0,1.0,0.7483882904052734,30.01666203960727,52,-15,26,594,975,232,531,53,1.66
0,1,0,-0.0,1.0,0.7552263736724854,29.154759474226502,52,-15,25,594,975,232,531,53,1.6
0,1,0,-0.0,1.0,0.7667052745819092,28.30194339616981,52,-15,24,594,975,232,531,53,1.54
0,0,1,-0.0,-0.0,0.810091495513916,28.30194339616981,52,-15,24,594,975,232,531,53,35.43
0,0,0,-0.0,-0.0,0.06728529930114746,505.3098059606601,53,-193,-467,416,484,609,951,49,136.25
0,-2,0,-0.0,-2.0,0.16028618812561035,503.4620144559071,53,-193,-465,416,484,609,951,49,6.74
0,-1,0,-0.0,-1.0,0.16982412338256836,502.5385557347814,53,-193,-464,416,484,609,951,49,4.45
0,-2,0,-0.0,-2.0,0.17635607719421387,500.6925204154742,53,-193,-462,416,484,609,951,49,6.71
0,-3,0,-0.0,-3.0,0.18540716171264648,497.92569726817675,53,-193,-459,416,484,609,951,49,8.86
0,-4,0,-0.0,-4.0,0.19501924514770508,494.2408319837607,53,-193,-455,416,484,609,951,49,10.9
-1,-5,0,-1.0,-5.0,0.20023727416992188,489.24840316550853,53,-192,-450,416,484,609,951,49,14.58
-1,-5,0,-1.0,-5.0,0.20865225791931152,484.25819559404465,53,-191,-445,416,484,609,951,49,14.48
-1,-6,0,-1.0,-6.0,0.21626925468444824,478.3523805731503,53,-190,-439,416,484,609,951,49,16.04
-2,-7,0,-2.0,-7.0,0.22426509857177734,471.1348002429878,53,-188,-432,416,484,609,951,49,19.25
-3,-11,0,-3.0,-11.0,0.23437118530273438,459.85432475948295,53,-185,-421,416,484,609,951,49,25.91
-4,-12,0,-4.0,-12.0,0.24424409866333008,447.26055046247933,53,-181,-409,416,484,609,951,49,28.09
-4,-14,0,-4.0,-14.0,0.24823713302612305,432.84408278270365,53,-177,-395,416,484,609,951,49,29.64
-6,-18,0,-6.0,-18.0,0.2563791275024414,413.9685978428799,53,-171,-377,416,484,609,951,49,34.9
-8,-21,0,-8.0,-21.0,0.2642841339111328,391.54182407502776,53,-163,-356,416,484,609,951,49,38.12
-12,-22,0,-12.0,-22.0,0.2739992141723633,366.5474048469038,53,-151,-334,416,484,609,951,49,38.82
-18,-23,0,-18.0,-23.0,0.2809422016143799,338.2454729926182,53,-133,-311,416,484,609,951,49,37.9
-19,-20,0,-19.0,-20.0,0.28827810287475586,312.5331982366033,53,-114,-291,416,484,609,951,49,33.33
-17,-18,0,-17.0,-18.0,0.2967371940612793,289.72055501810706,53,-97,-273,416,484,609,951,49,29.22
-15,-13,0,-15.0,-13.0,0.304246187210083,272.6242835845699,53,-82,-260,416,484,609,951,49,22.75
-11,-13,0,-11.0,-13.0,0.31268930435180664,257.00194551792794,53,-71,-247,416,484,609,951,49,20.88
-9,-13,0,-9.0,-13.0,0.32199811935424805,242.0743687382041,53,-62,-234,416,484,609,951,49,19.69
-7,-11,0,-7.0,-11.0,0.3282902240753174,229.68238939892626,53,-55,-223,416,484,609,951,49,16.81
-5,-12,0,-5.0,-12.0,0.33649230003356934,216.8432613663611,53,-50,-211,416,484,609,951,49,17.52
-4,-10,0,-4.0,-10.0,0.34429430961608887,206.196508214858,53,-46,-201,416,484,609,951,49,15.09
-3,-8,0,-3.0,-8.0,0.3524792194366455,197.7321420508057,53,-43,-193,416,484,609,951,49,12.86
-3,-8,0,-3.0,-8.0,0.3607621192932129,189.274932307477,53,-40,-185,416,484,609,951,49,12.47
-2,-9,0,-2.0,-9.0,0.36841726303100586,180.05554698481245,53,-38,-176,416,484,609,951,49,15.89
-2,-7,0,-2.0,-7.0,0.37842512130737305,172.7917822120022,53,-36,-169,416,484,609,951,49,11.75
-1,-6,0,-1.0,-6.0,0.3863542079925537,166.715326230074,53,-35,-163,416,484,609,951,49,10.94
-2,-6,0,-2.0,-6.0,0.3922572135925293,160.4306703844374,53,-33,-157,416,484,609,951,49,9.82
-1,-7,0,-1.0,-7.0,0.40044617652893066,153.37535656030275,53,-32,-150,416,484,609,951,49,10.88
-2,-9,0,-2.0,-9.0,0.41008710861206055,144.15616532080756,53,-30,-141,416,484,609,951,49,14.13
-2,-9,0,-2.0,-9.0,0.4163072109222412,134.937022347464,53,-28,-132,416,484,609,951,49,13.67
-2,-7,0,-2.0,-7.0,0.424288272857666,127.67536959022284,53,-26,-125,416,484,609,951,49,10.0
-2,-8,0,-2.0,-8.0,0.43419408798217773,119.4361754243663,53,-24,-117,416,484,609,951,49,10.96
-1,-7,0,-1.0,-7.0,0.4405331611633301,112.37882362794157,53,-23,-110,416,484,609,951,49,9.43
-1,-6,0,-1.0,-6.0,0.44898009300231934,106.30145812734649,53,-22,-104,416,484,609,951,49,9.06
-1,-5,0,-1.0,-5.0,0.4567720890045166,101.20276676059801,53,-21,-99,416,484,609,951,49,9.51
-1,-6,0,-1.0,-6.0,0.46491217613220215,95.12623192369179,53,-20,-93,416,484,609,951,49,8.58
-1,-5,0,-1.0,-5.0,0.4723031520843506,90.02777349240623,53,-19,-88,416,484,609,951,49,8.97
-1,-4,0,-1.0,-4.0,0.48026323318481445,85.90692637965812,53,-18,-84,416,484,609,951,49,7.55
-2,-4,0,-2.0,-4.0,0.4887073040008545,81.58431221748455,53,-16,-80,416,484,609,951,49,4.93
-1,-4,0,-1.0,-4.0,0.49677515029907227,77.46612162745726,53,-15,-76,416,484,609,951,49,6.88
-1,-3,0,-1.0,-3.0,0.505958080291748,74.33034373659252,53,-14,-73,416,484,609,951,49,5.11
-1,-3,0,-1.0,-3.0,0.5140681266784668,71.19691004531025,53,-13,-70,416,484,609,951,49,4.98
-1,-3,0,-1.0,-3.0,0.520625114440918,68.06614430096654,53,-12,-67,416,484,609,951,49,4.85
-2,-2,0,-2.0,-2.0,0.529137134552002,65.76473218982953,53,-10,-65,416,484,609,951,49,2.36
-1,-2,0,-1.0,-2.0,0.5364720821380615,63.63961030678928,53,-9,-63,416,484,609,951,49,3.23
0,-2,0,-0.0,-2.0,0.5443792343139648,61.66036003787198,53,-9,-61,416,484,609,951,49,4.21
-1,-2,0,-1.0,-2.0,0.5522942543029785,59.53990258641679,53,-8,-59,416,484,609,951,49,3.12
0,-1,0,-0.0,-1.0,0.5603382587432861,58.54912467321779,53,-8,-58,416,484,609,951,49,3.87
-1,-1,0,-1.0,-1.0,0.5690851211547852,57.42821606144492,53,-7,-57,416,484,609,951,49,1.72
0,-2,0,-0.0,-2.0,0.5765511989593506,55.44366510251645,53,-7,-55,416,484,609,951,49,4.3
-1,-1,0,-1.0,-1.0,0.5842761993408203,54.3323108288245,53,-6,-54,416,484,609,951,49,1.66
0,-2,0,-0.0,-2.0,0.5922641754150391,52.3450093132096,53,-6,-52,416,484,609,951,49,4.38
-1,-1,0,-1.0,-1.0,0.6010363101959229,51.24451190127583,53,-5,-51,416,484,609,951,49,1.59
0,-1,0,-0.0,-1.0,0.6094512939453125,50.24937810560445,53,-5,-50,416,484,609,951,49,4.2
0,-1,0,-0.0,-1.0,0.6189532279968262,49.25444142409901,53,-5,-49,416,484,609,951,49,4.17
0,0,1,-0.0,-0.0,0.6583311557769775,49.25444142409901,53,-5,-49,416,484,609,951,49,31.84
0,0,0,-0.0,-0.0,0.7333922386169434,49.25444142409901,53,-5,-49,416,484,609,951,49,31.84
1,0,0,1.0,-0.0,0.842048168182373,49.36598018878993,53,-6,-49,416,484,609,951,49,3.95
2,0,0,2.0,-0.0,0.8497343063354492,49.64876634922564,53,-8,-49,416,484,609,951,49,1.61
3,0,0,3.0,-0.0,0.8566610813140869,50.21951811795888,53,-11,-49,416,484,609,951,49,0.67
3,-1,0,3.0,-1.0,0.8643581867218018,50.0,53,-14,-48,416,484,609,951,49,-0.17
3,0,0,3.0,-0.0,0.8722600936889648,50.92150822589606,53,-17,-48,416,484,609,951,49,0.46
2,-1,0,2.0,-1.0,0.8849611282348633,50.695167422546305,53,-19,-47,416,484,609,951,49,-0.01
1,0,0,1.0,-0.0,0.8883001804351807,51.07837115648854,53,-20,-47,416,484,609,951,49,1.64
2,-2,0,2.0,-2.0,0.8971490859985352,50.08991914547278,53,-22,-45,416,484,609,951,49,0.52
2,-1,0,2.0,-1.0,0.9051971435546875,50.11985634456667,53,-24,-44,416,484,609,951,49,10.11
1,-1,0,1.0,-1.0,0.912269115447998,49.73932046178355,53,-25,-43,416,484,609,951,49,0.34
1,-1,0,1.0,-1.0,0.9202561378479004,49.39635614091387,53,-26,-42,416,484,609,951,49,0.3
0,-1,0,-0.0,-1.0,0.928389310836792,48.54894437575342,53,-26,-41,416,484,609,951,49,1.78
1,-2,0,1.0,-2.0,0.9362752437591553,47.43416490252569,53,-27,-39,416,484,609,951,49,0.82
0,-2,0,-0.0,-2.0,0.952897310256958,45.803929962395145,53,-27,-37,416,484,609,951,49,1.78
0,-1,0,-0.0,-1.0,0.9613091945648193,45.0,53,-27,-36,416,484,609,951,49,1.55
0,-1,0,-0.0,-1.0,0.9722011089324951,44.204072210600685,53,-27,-35,416,484,609,951,49,1.51
0,-1,0,-0.0,-1.0,0.9762833118438721,43.41658669218482,53,-27,-34,416,484,609,951,49,1.47
0,0,1,-0.0,-0.0,1.0013082027435303,43.41658669218482,53,-27,-34,416,484,609,951,49,40.06
0,0,0,-0.0,-0.0,0.09617233276367188,1074.6501756385655,54,1067,128,1510,646,443,518,13,214.16
2,0,0,2.0,-0.0,0.18217945098876953,1072.6644396082122,54,1065,128,1510,646,443,518,13,31.12
3,0,0,3.0,-0.0,0.19423747062683105,1069.6859352165009,54,1062,128,1510,646,443,518,13,42.21
5,0,0,5.0,-0.0,0.2038593292236328,1064.722029451819,54,1057,128,1510,646,443,518,13,60.64
10,3,0,10.0,3.0,0.20613646507263184,1054.4353939431282,54,1047,125,1510,646,443,518,13,93.75
17,3,0,17.0,3.0,0.2216503620147705,1037.2000771307337,54,1030,122,1510,646,443,518,13,120.28
23,5,0,23.0,5.0,0.22650432586669922,1013.7741365807277,54,1007,117,1510,646,443,518,13,132.68
29,4,0,29.0,4.0,0.23101329803466797,984.5064753469121,54,978,113,1510,646,443,518,13,141.79
31,6,0,31.0,6.0,0.23816347122192383,953.0257079428656,54,947,107,1510,646,443,518,13,140.76
32,4,0,32.0,4.0,0.24616336822509766,920.7790180059492,54,915,103,1510,646,443,518,13,140.75
32,4,0,32.0,4.0,0.2546563148498535,888.532497998807,54,883,99,1510,646,443,518,13,137.86
31,4,0,31.0,4.0,0.2654874324798584,857.280000933184,54,852,95,1510,646,443,518,13,133.63
28,3,0,28.0,3.0,0.27169132232666016,829.1200154380547,54,824,92,1510,646,443,518,13,127.92
27,3,0,27.0,3.0,0.2781364917755127,801.9538640096449,54,797,89,1510,646,443,518,13,124.46
27,2,0,27.0,2.0,0.28711652755737305,774.8993483027328,54,770,87,1510,646,443,518,13,119.94
29,1,0,29.0,1.0,0.29480433464050293,745.9738601318413,54,741,86,1510,646,443,518,13,118.77
29,1,0,29.0,1.0,0.30215930938720703,717.055785835384,54,712,85,1510,646,443,518,13,115.9
26,1,0,26.0,1.0,0.3112494945526123,691.1237226430591,54,686,84,1510,646,443,518,13,109.58
25,0,0,25.0,-0.0,0.31813836097717285,666.3159911033202,54,661,84,1510,646,443,518,13,105.09
25,1,0,25.0,1.0,0.32616639137268066,641.3930152410455,54,636,83,1510,646,443,518,13,103.23
23,0,0,23.0,-0.0,0.3351914882659912,618.5935660835796,54,613,83,1510,646,443,518,13,97.42
24,0,0,24.0,-0.0,0.34280943870544434,594.8193002921139,54,589,83,1510,646,443,518,13,96.37
25,0,0,25.0,-0.0,0.35079431533813477,570.0745565274774,54,564,83,1510,646,443,518,13,95.01
26,0,0,26.0,-0.0,0.3589334487915039,544.3647674124401,54,538,83,1510,646,443,518,13,93.34
27,2,0,27.0,2.0,0.3668384552001953,517.3799377633424,54,511,81,1510,646,443,518,13,92.52
29,2,0,29.0,2.0,0.37430334091186523,488.43116198702967,54,482,79,1510,646,443,518,13,90.89
29,4,0,29.0,4.0,0.3829514980316162,459.1666364186318,54,453,75,1510,646,443,518,13,89.02
29,3,0,29.0,3.0,0.39095044136047363,430.0697617828996,54,424,72,1510,646,443,518,13,84.19
29,4,0,29.0,4.0,0.4018974304199219,400.81042900603273,54,395,68,1510,646,443,518,13,81.26
27,3,0,27.0,3.0,0.4062013626098633,373.6964008389698,54,368,65,1510,646,443,518,13,75.12
25,5,0,25.0,5.0,0.4147164821624756,348.20827101032506,54,343,60,1510,646,443,518,13,71.39
24,4,0,24.0,4.0,0.422168493270874,323.878063474512,54,319,56,1510,646,443,518,13,67.9
23,5,0,23.0,5.0,0.4311795234680176,300.36144892445833,54,296,51,1510,646,443,518,13,62.44
22,4,0,22.0,4.0,0.4402744770050049,278.0017985553331,54,274,47,1510,646,443,518,13,59.68
21,4,0,21.0,4.0,0.4461684226989746,256.62813563598206,54,253,43,1510,646,443,518,13,55.19
19,4,0,19.0,4.0,0.45483851432800293,237.22773868163057,54,234,39,1510,646,443,518,13,49.85
19,4,0,19.0,4.0,0.46280837059020996,217.83020910791964,54,215,35,1510,646,443,518,13,46.93
17,3,0,17.0,3.0,0.4706864356994629,200.5691900566984,54,198,32,1510,646,443,518,13,43.71
16,4,0,16.0,4.0,0.4781973361968994,184.14125013152267,54,182,28,1510,646,443,518,13,38.51
16,3,0,16.0,3.0,0.4866194725036621,167.87197502859135,54,166,25,1510,646,443,518,13,37.15
14,3,0,14.0,3.0,0.49418139457702637,153.5838533179839,54,152,22,1510,646,443,518,13,32.55
12,2,0,12.0,2.0,0.5021564960479736,141.4213562373095,54,140,20,1510,646,443,518,13,30.0
13,3,0,13.0,3.0,0.5101323127746582,128.1327436684316,54,127,17,1510,646,443,518,13,27.58
10,2,0,10.0,2.0,0.5181663036346436,117.957619508025,54,117,15,1510,646,443,518,13,23.6
10,2,0,10.0,2.0,0.5263934135437012,107.78682665335315,54,107,13,1510,646,443,518,13,22.17
7,1,0,7.0,1.0,0.5367114543914795,100.71742649611338,54,100,12,1510,646,443,518,13,19.3
5,1,0,5.0,1.0,0.542311429977417,95.63472172804185,54,95,11,1510,646,443,518,13,14.64
2,1,0,2.0,1.0,0.5501663684844971,93.53608929178085,54,93,10,1510,646,443,518,13,7.3
1,0,0,1.0,-0.0,0.5596895217895508,92.5418824100742,54,92,10,1510,646,443,518,13,6.39
1,1,0,1.0,1.0,0.5661303997039795,91.44397191723465,54,91,9,1510,646,443,518,13,4.09
2,0,0,2.0,-0.0,0.5786914825439453,89.45389874119518,54,89,9,1510,646,443,518,13,8.6
3,1,0,3.0,1.0,0.5823154449462891,86.37129152675674,54,86,8,1510,646,443,518,13,9.42
2,1,0,2.0,1.0,0.5905144214630127,84.29116205154607,54,84,7,1510,646,443,518,13,6.78
2,0,0,2.0,-0.0,0.5983192920684814,82.29823813423954,54,82,7,1510,646,443,518,13,8.52
2,0,0,2.0,-0.0,0.6083145141601562,80.30566605165541,54,80,7,1510,646,443,518,13,8.41
1,1,0,1.0,1.0,0.6142144203186035,79.22752047110903,54,79,6,1510,646,443,518,13,3.69
1,0,0,1.0,-0.0,0.6233704090118408,78.23042886243178,54,78,6,1510,646,443,518,13,6.5
1,0,0,1.0,-0.0,0.6381723880767822,77.23341245859851,54,77,6,1510,646,443,518,13,6.46
2,0,0,2.0,-0.0,0.663494348526001,75.23961722390672,54,75,6,1510,646,443,518,13,8.31
2,0,0,2.0,-0.0,0.6701343059539795,73.24616030891995,54,73,6,1510,646,443,518,13,8.19
3,0,0,3.0,-0.0,0.6788945198059082,70.25667228100119,54,70,6,1510,646,443,518,13,9.6
4,0,0,4.0,-0.0,0.6861453056335449,66.27216610312357,54,66,6,1510,646,443,518,13,10.62
2,0,0,2.0,-0.0,0.6942794322967529,64.28063471995279,54,64,6,1510,646,443,518,13,7.63
3,0,0,3.0,-0.0,0.703566312789917,61.29437168288782,54,61,6,1510,646,443,518,13,8.87
2,0,0,2.0,-0.0,0.7102034091949463,59.30430001273095,54,59,6,1510,646,443,518,13,7.31
4,0,0,4.0,-0.0,0.718144416809082,55.326304774492215,54,55,6,1510,646,443,518,13,9.52
2,0,0,2.0,-0.0,0.726581335067749,53.33854141237835,54,53,6,1510,646,443,518,13,6.89
3,0,0,3.0,-0.0,0.7346103191375732,50.35871324805669,54,50,6,1510,646,443,518,13,7.91
3,0,0,3.0,-0.0,0.7427685260772705,47.38143096192854,54,47,6,1510,646,443,518,13,7.63
2,0,0,2.0,-0.0,0.756291389465332,45.39823785126467,54,45,6,1510,646,443,518,13,6.3
4,-1,0,4.0,-1.0,0.7593274116516113,41.593268686170845,54,41,7,1510,646,443,518,13,6.37
2,0,0,2.0,-0.0,0.7661364078521729,39.6232255123179,54,39,7,1510,646,443,518,13,5.61
4,0,0,4.0,-0.0,0.7741982936859131,35.6931365951495,54,35,7,1510,646,443,518,13,7.04
3,0,0,3.0,-0.0,0.7824223041534424,32.7566787083184,54,32,7,1510,646,443,518,13,5.86
3,0,0,3.0,-0.0,0.7901413440704346,29.832867780352597,54,29,7,1510,646,443,518,13,5.5
3,0,0,3.0,-0.0,0.799039363861084,26.92582403567252,54,26,7,1510,646,443,518,13,5.12
2,0,0,2.0,-0.0,0.8106534481048584,25.0,54,24,7,1510,646,443,518,13,4.13
2,1,0,2.0,1.0,0.8159933090209961,22.80350850198276,54,22,6,1510,646,443,518,13,4.7
1,0,0,1.0,-0.0,0.824913501739502,21.840329667841555,54,21,6,1510,646,443,518,13,3.27
1,0,0,1.0,-0.0,0.836463451385498,20.8806130178211,54,20,6,1510,646,443,518,13,3.17
1,0,0,1.0,-0.0,0.8461673259735107,19.924858845171276,54,19,6,1510,646,443,518,13,3.06
1,0,0,1.0,-0.0,0.8541653156280518,18.973665961010276,54,18,6,1510,646,443,518,13,2.94
1,0,0,1.0,-0.0,0.8638663291931152,18.027756377319946,54,17,6,1510,646,443,518,13,2.82
1,0,0,1.0,-0.0,0.8701164722442627,17.08800749063506,54,16,6,1510,646,443,518,13,2.7
1,1,0,1.0,1.0,0.8791522979736328,15.811388300841896,54,15,5,1510,646,443,518,13,2.44
1,0,0,1.0,-0.0,0.8941714763641357,14.866068747318506,54,14,5,1510,646,443,518,13,2.66
0,0,1,-0.0,-0.0,1.0071744918823242,14.866068747318506,54,14,5,1510,646,443,518,13,21.34
0,0,0,-0.0,-0.0,1.1191644668579102,14.866068747318506,54,14,5,1510,646,443,518,13,21.34
1,0,0,1.0,-0.0,1.1822893619537354,13.92838827718412,54,13,5,1510,646,443,518,13,2.51
1,1,0,1.0,1.0,1.192448377609253,12.649110640673518,54,12,4,1510,646,443,518,13,2.23
2,1,0,2.0,1.0,1.2017643451690674,10.44030650891055,54,10,3,1510,646,443,518,13,3.86
1,1,0,1.0,1.0,1.2100443840026855,9.219544457292887,54,9,2,1510,646,443,518,13,1.61
1,1,0,1.0,1.0,1.2166345119476318,8.06225774829855,54,8,1,1510,646,443,518,13,1.23
1,1,0,1.0,1.0,1.2221853733062744,7.0,54,7,0,1510,646,443,518,13,0.79
1,0,0,1.0,-0.0,1.2466464042663574,6.0,54,6,0,1510,646,443,518,13,7.5
0,1,0,-0.0,1.0,1.2541284561157227,6.082762530298219,54,6,-1,1510,646,443,518,13,4.92
0,0,1,-0.0,-0.0,1.2691752910614014,6.082762530298219,54,6,-1,1510,646,443,518,13,28.72
1,0,1,1.0,-0.0,0.023601531982421875,379.7959978725421,55,-263,274,1242,921,1504,647,54,3.83
0,0,0,-0.0,-0.0,0.08366560935974121,379.7959978725421,55,-263,274,1242,921,1504,647,54,113.27
0,1,0,-0.0,1.0,0.14357447624206543,379.07519043060574,55,-263,273,1242,921,1504,647,54,2.53
-1,0,0,-1.0,-0.0,0.15294766426086426,378.38208202820596,55,-262,273,1242,921,1504,647,54,2.4
-1,1,0,-1.0,1.0,0.16011357307434082,376.9681684174408,55,-261,272,1242,921,1504,647,54,8.2
-1,1,0,-1.0,1.0,0.1681375503540039,375.55425706547385,55,-260,271,1242,921,1504,647,54,8.19
-1,1,0,-1.0,1.0,0.17556357383728027,374.14034799791375,55,-259,270,1242,921,1504,647,54,8.18
-1,0,0,-1.0,-0.0,0.18410754203796387,373.44879167029046,55,-258,270,1242,921,1504,647,54,2.38
-1,1,0,-1.0,1.0,0.19381260871887207,372.03494459526246,55,-257,269,1242,921,1504,647,54,8.09
-2,1,0,-2.0,1.0,0.20758366584777832,369.9310746612131,55,-255,268,1242,921,1504,647,54,6.12
-3,1,0,-3.0,1.0,0.22070550918579102,367.14166203251847,55,-252,267,1242,921,1504,647,54,6.79
-4,2,0,-4.0,2.0,0.23670744895935059,362.9448993993441,55,-248,265,1242,921,1504,647,54,9.54
-5,2,0,-5.0,2.0,0.24299359321594238,358.07541105191797,55,-243,263,1242,921,1504,647,54,10.21
-7,3,0,-7.0,3.0,0.2432255744934082,351.1353015576759,55,-236,260,1242,921,1504,647,54,13.22
-6,3,0,-6.0,3.0,0.2500905990600586,344.88983748437704,55,-230,257,1242,921,1504,647,54,12.26
-7,4,0,-7.0,4.0,0.2612636089324951,337.25064862799,55,-223,253,1242,921,1504,647,54,14.23
-8,4,0,-8.0,4.0,0.26355457305908203,328.977202857584,55,-215,249,1242,921,1504,647,54,14.59
-7,5,0,-7.0,5.0,0.27155566215515137,320.62439083762797,55,-208,244,1242,921,1504,647,54,15.13
-7,7,0,-7.0,7.0,0.27961158752441406,310.75713990188547,55,-201,237,1242,921,1504,647,54,18.13
-8,7,0,-8.0,7.0,0.2876546382904053,300.24823063591896,55,-193,230,1242,921,1504,647,54,17.7
-9,9,0,-9.0,9.0,0.2956974506378174,287.5708608325955,55,-184,221,1242,921,1504,647,54,20.24
-9,10,0,-9.0,10.0,0.30765366554260254,274.1277074649697,55,-175,211,1242,921,1504,647,54,21.39
-8,11,0,-8.0,11.0,0.3117034435272217,260.5551764981844,55,-167,200,1242,921,1504,647,54,20.3
-12,11,0,-12.0,11.0,0.3202085494995117,244.42994906516674,55,-155,189,1242,921,1504,647,54,20.75
-13,13,0,-13.0,13.0,0.3283076286315918,226.14154859291116,55,-142,176,1242,921,1504,647,54,21.73
-15,12,0,-15.0,12.0,0.33861565589904785,207.4246851269154,55,-127,164,1242,921,1504,647,54,19.74
-14,13,0,-14.0,13.0,0.34453654289245605,188.6001060445089,55,-113,151,1242,921,1504,647,54,18.93
-13,12,0,-13.0,12.0,0.3516695499420166,171.2337583538947,55,-100,139,1242,921,1504,647,54,16.71
-12,12,0,-12.0,12.0,0.35956764221191406,154.50889942006577,55,-88,127,1242,921,1504,647,54,15.39
-12,11,0,-12.0,11.0,0.368166446685791,138.67948658687772,55,-76,116,1242,921,1504,647,54,13.39
-12,11,0,-12.0,11.0,0.3779294490814209,122.96747537458837,55,-64,105,1242,921,1504,647,54,12.11
-11,11,0,-11.0,11.0,0.3835885524749756,107.91200118615167,55,-53,94,1242,921,1504,647,54,10.83
-11,10,0,-11.0,10.0,0.39165759086608887,93.91485505499116,55,-42,84,1242,921,1504,647,54,9.0
-9,9,0,-9.0,9.0,0.3999505043029785,81.93900170248598,55,-33,75,1242,921,1504,647,54,7.43
-7,8,0,-7.0,8.0,0.40783262252807617,71.8679344353238,55,-26,67,1242,921,1504,647,54,6.22
-7,7,0,-7.0,7.0,0.41559648513793945,62.93647591023825,55,-19,60,1242,921,1504,647,54,4.87
-4,6,0,-4.0,6.0,0.4236326217651367,56.04462507680822,55,-15,54,1242,921,1504,647,54,4.5
-3,3,0,-3.0,3.0,0.4372446537017822,52.392747589718944,55,-12,51,1242,921,1504,647,54,2.56
-2,4,0,-2.0,4.0,0.4428994655609131,48.05205510693585,55,-10,47,1242,921,1504,647,54,3.76
-2,2,0,-2.0,2.0,0.44762563705444336,45.70557952810576,55,-8,45,1242,921,1504,647,54,1.91
-1,1,0,-1.0,1.0,0.45641160011291504,44.553338819890925,55,-7,44,1242,921,1504,647,54,1.61
-1,1,0,-1.0,1.0,0.4656946659088135,43.41658669218482,55,-6,43,1242,921,1504,647,54,1.54
-2,1,0,-2.0,1.0,0.47466063499450684,42.190046219457976,55,-4,42,1242,921,1504,647,54,0.81
0,1,0,-0.0,1.0,0.48350048065185547,41.19465984809196,55,-4,41,1242,921,1504,647,54,4.1
0,0,1,-0.0,-0.0,0.5425865650177002,41.19465984809196,55,-4,41,1242,921,1504,647,54,39.379999999999995
0,0,0,-0.0,-0.0,0.09701347351074219,931.292113141736,56,-884,-293,362,587,1246,880,33,197.42
-1,0,0,-1.0,-0.0,0.19900059700012207,930.3429475198917,56,-883,-293,362,587,1246,880,33,7.69
-2,0,0,-2.0,-0.0,0.21634149551391602,928.4449364394208,56,-881,-293,362,587,1246,880,33,12.7
-4,-1,0,-4.0,-1.0,0.22403454780578613,924.3338141602308,56,-877,-292,362,587,1246,880,33,25.21
-5,-3,0,-5.0,-3.0,0.2310185432434082,918.6430209825795,56,-872,-289,362,587,1246,880,33,30.63
-7,-3,0,-7.0,-3.0,0.24973440170288086,911.0548830888291,56,-865,-286,362,587,1246,880,33,39.2
-9,-4,0,-9.0,-4.0,0.2499535083770752,901.2546809864568,56,-856,-282,362,587,1246,880,33,46.61
-12,-6,0,-12.0,-6.0,0.25641441345214844,887.9819817991804,56,-844,-276,362,587,1246,880,33,56.42
-19,-9,0,-19.0,-9.0,0.2648744583129883,867.129748076953,56,-825,-267,362,587,1246,880,33,74.1
-25,-11,0,-25.0,-11.0,0.2710404396057129,839.961903898028,56,-800,-256,362,587,1246,880,33,84.47
-32,-15,0,-32.0,-15.0,0.2802615165710449,804.9254623876673,56,-768,-241,362,587,1246,880,33,93.06
-36,-14,0,-36.0,-14.0,0.2951984405517578,766.3895876119403,56,-732,-227,362,587,1246,880,33,95.18
-37,-12,0,-37.0,-12.0,0.2953214645385742,727.4957044546724,56,-695,-215,362,587,1246,880,33,94.31
-38,-12,0,-38.0,-12.0,0.3030984401702881,687.6467116186916,56,-657,-203,362,587,1246,880,33,92.65
-36,-10,0,-36.0,-10.0,0.31105542182922363,650.299930801165,56,-621,-193,362,587,1246,880,33,85.94
-30,-8,0,-30.0,-8.0,0.31905555725097656,619.2786125807995,56,-591,-185,362,587,1246,880,33,76.24
-28,-8,0,-28.0,-8.0,0.32755255699157715,590.1677727561884,56,-563,-177,362,587,1246,880,33,72.28
-25,-9,0,-25.0,-9.0,0.33602356910705566,563.6204396577541,56,-538,-168,362,587,1246,880,33,66.6
-22,-8,0,-22.0,-8.0,0.3448984622955322,540.2369850352713,56,-516,-160,362,587,1246,880,33,60.57
-19,-8,0,-19.0,-8.0,0.35721540451049805,519.7239651969111,56,-497,-152,362,587,1246,880,33,54.12
-19,-7,0,-19.0,-7.0,0.3590884208679199,499.50875868196744,56,-478,-145,362,587,1246,880,33,53.03
-17,-7,0,-17.0,-7.0,0.3672175407409668,481.21201148766016,56,-461,-138,362,587,1246,880,33,48.28
-18,-7,0,-18.0,-7.0,0.37505149841308594,461.96320199773487,56,-443,-131,362,587,1246,880,33,48.69
-19,-7,0,-19.0,-7.0,0.38310742378234863,441.760115900021,56,-424,-124,362,587,1246,880,33,48.89
-20,-6,0,-20.0,-6.0,0.3910794258117676,420.880030412468,56,-404,-118,362,587,1246,880,33,50.34
-20,-5,0,-20.0,-5.0,0.4045875072479248,400.2811511925087,56,-384,-113,362,587,1246,880,33,47.01
-19,-5,0,-19.0,-5.0,0.41463255882263184,380.64287724847816,56,-365,-108,362,587,1246,880,33,44.68
-17,-4,0,-17.0,-4.0,0.41524362564086914,363.2079294288603,56,-348,-104,362,587,1246,880,33,39.83
-14,-4,0,-14.0,-4.0,0.42496252059936523,348.648820448313,56,-334,-100,362,587,1246,880,33,36.4
-14,-5,0,-14.0,-5.0,0.4316225051879883,333.80383460949037,56,-320,-95,362,587,1246,880,33,34.44
-13,-4,0,-13.0,-4.0,0.4390685558319092,320.2030605725061,56,-307,-91,362,587,1246,880,33,33.38
-13,-5,0,-13.0,-5.0,0.45131540298461914,306.32009401931174,56,-294,-86,362,587,1246,880,33,30.84
-12,-5,0,-12.0,-5.0,0.45677947998046875,293.4024539774676,56,-282,-81,362,587,1246,880,33,28.28
-13,-6,0,-13.0,-6.0,0.46672654151916504,279.2597357300189,56,-269,-75,362,587,1246,880,33,28.52
-13,-4,0,-13.0,-4.0,0.47905945777893066,265.6633207652121,56,-256,-71,362,587,1246,880,33,29.03
-14,-6,0,-14.0,-6.0,0.4793965816497803,250.57733337235433,56,-242,-65,362,587,1246,880,33,27.74
-14,-5,0,-14.0,-5.0,0.49178147315979004,235.762592452662,56,-228,-60,362,587,1246,880,33,27.01
-17,-5,0,-17.0,-5.0,0.49646544456481934,218.05045287731002,56,-211,-55,362,587,1246,880,33,29.62
-17,-5,0,-17.0,-5.0,0.5040855407714844,200.33971149025845,56,-194,-50,362,587,1246,880,33,27.97
-16,-5,0,-16.0,-5.0,0.5115325450897217,183.60010893242955,56,-178,-45,362,587,1246,880,33,25.12
-16,-5,0,-16.0,-5.0,0.5239684581756592,166.86521506892922,56,-162,-40,362,587,1246,880,33,23.5
-13,-4,0,-13.0,-4.0,0.5289266109466553,153.28731193415845,56,-149,-36,362,587,1246,880,33,19.87
-13,-4,0,-13.0,-4.0,0.5356485843658447,139.71399357258383,56,-136,-32,362,587,1246,880,33,18.64
-13,-5,0,-13.0,-5.0,0.5450344085693359,125.92855117089213,56,-123,-27,362,587,1246,880,33,16.56
-14,-5,0,-14.0,-5.0,0.5511155128479004,111.19802156513397,56,-109,-22,362,587,1246,880,33,15.9
-14,-5,0,-14.0,-5.0,0.5590145587921143,96.5090669315583,56,-95,-17,362,587,1246,880,33,14.29
-15,-3,0,-15.0,-3.0,0.5697464942932129,81.21576201698781,56,-80,-14,362,587,1246,880,33,15.54
-15,-4,0,-15.0,-4.0,0.5752184391021729,65.76473218982953,56,-65,-10,362,587,1246,880,33,12.12
-14,-3,0,-14.0,-3.0,0.5830385684967041,51.478150704935004,56,-51,-7,362,587,1246,880,33,10.69
-13,-4,0,-13.0,-4.0,0.5911204814910889,38.118237105091836,56,-38,-3,362,587,1246,880,33,7.49
-12,-3,0,-12.0,-3.0,0.6000795364379883,26.0,56,-26,0,362,587,1246,880,33,5.7
-12,-3,0,-12.0,-3.0,0.6081216335296631,14.317821063276353,56,-14,3,362,587,1246,880,33,3.36
-11,-4,0,-11.0,-4.0,0.6152224540710449,7.615773105863909,56,-3,7,362,587,1246,880,33,-0.42
-12,-2,0,-12.0,-2.0,0.6231265068054199,12.727922061357855,56,9,9,362,587,1246,880,33,-2.84
-11,-3,0,-11.0,-3.0,0.6329424381256104,23.323807579381203,56,20,12,362,587,1246,880,33,-0.73
-11,-3,0,-11.0,-3.0,0.6390485763549805,34.438350715445125,56,31,15,362,587,1246,880,33,0.61
-10,-2,0,-10.0,-2.0,0.6484196186065674,44.384682042344295,56,41,17,362,587,1246,880,33,1.12
-9,-3,0,-9.0,-3.0,0.6550414562225342,53.85164807134504,56,50,20,362,587,1246,880,33,3.11
-7,-2,0,-7.0,-2.0,0.6632814407348633,61.09828148156051,56,57,22,362,587,1246,880,33,2.97
-5,-1,0,-5.0,-1.0,0.6752634048461914,66.12866246946176,56,62,23,362,587,1246,880,33,2.63
-2,0,0,-2.0,-0.0,0.6790304183959961,68.00735254367721,56,64,23,362,587,1246,880,33,2.37
-1,0,0,-1.0,-0.0,0.6869924068450928,68.9492567037528,56,65,23,362,587,1246,880,33,3.06
0,0,1,-0.0,-0.0,0.7230474948883057,68.9492567037528,56,65,23,362,587,1246,880,33,37.8
0,0,0,-0.0,-0.0,0.8110575675964355,68.9492567037528,56,65,23,362,587,1246,880,33,37.8
2,0,0,2.0,-0.0,0.8311395645141602,67.06713054842886,56,63,23,362,587,1246,880,33,3.58
1,0,0,1.0,-0.0,0.839045524597168,66.12866246946176,56,62,23,362,587,1246,880,33,2.9
1,1,0,1.0,1.0,0.8550915718078613,64.8459713474939,56,61,22,362,587,1246,880,33,2.82
1,0,0,1.0,-0.0,0.8675384521484375,63.90618123468183,56,60,22,362,587,1246,880,33,2.89
1,0,0,1.0,-0.0,0.8710365295410156,62.96824596572466,56,59,22,362,587,1246,880,33,2.85
1,0,0,1.0,-0.0,0.8790314197540283,62.03224967708329,56,58,22,362,587,1246,880,33,2.82
1,0,0,1.0,-0.0,0.8882045745849609,61.09828148156051,56,57,22,362,587,1246,880,33,2.79
2,0,0,2.0,-0.0,0.8955545425415039,59.23681287847955,56,55,22,362,587,1246,880,33,3.29
4,1,0,4.0,1.0,0.9047644138336182,55.154328932550705,56,51,21,362,587,1246,880,33,5.75
3,1,0,3.0,1.0,0.9142765998840332,52.0,56,48,20,362,587,1246,880,33,6.04
4,1,0,4.0,1.0,0.9190576076507568,47.92702786528704,56,44,19,362,587,1246,880,33,5.29
4,2,0,4.0,2.0,0.931877613067627,43.46262762420146,56,40,17,362,587,1246,880,33,6.53
4,2,0,4.0,2.0,0.9371554851531982,39.0,56,36,15,362,587,1246,880,33,6.17
5,1,0,5.0,1.0,0.9430985450744629,34.0147027033899,56,31,14,362,587,1246,880,33,4.47
3,1,0,3.0,1.0,0.9518444538116455,30.870698080866262,56,28,13,362,587,1246,880,33,4.66
3,2,0,3.0,2.0,0.9593775272369385,27.313000567495326,56,25,11,362,587,1246,880,33,4.03
5,1,0,5.0,1.0,0.9691746234893799,22.360679774997898,56,20,10,362,587,1246,880,33,3.48
5,2,0,5.0,2.0,0.976083517074585,17.0,56,15,8,362,587,1246,880,33,4.41
4,1,0,4.0,1.0,0.9830505847930908,13.038404810405298,56,11,7,362,587,1246,880,33,2.28
4,2,0,4.0,2.0,0.9910285472869873,8.602325267042627,56,7,5,362,587,1246,880,33,2.93
5,1,0,5.0,1.0,0.9993104934692383,4.47213595499958,56,2,4,362,587,1246,880,33,-0.32
3,1,0,3.0,1.0,1.0073065757751465,3.1622776601683795,56,-1,3,362,587,1246,880,33,-1.88
2,2,0,2.0,2.0,1.0161845684051514,3.1622776601683795,56,-3,1,362,587,1246,880,33,8.64
2,0,0,2.0,-0.0,1.023038625717163,5.0990195135927845,56,-5,1,362,587,1246,880,33,0.32
0,0,1,-0.0,-0.0,1.029045581817627,5.0990195135927845,56,-5,1,362,587,1246,880,33,28.43
1,1,1,1.0,1.0,1.0329184532165527,6.0,56,-6,0,362,587,1246,880,33,9.62
1,0,1,1.0,-0.0,1.0397944450378418,7.0,56,-7,0,362,587,1246,880,33,17.009999999999998
0,0,0,-0.0,-0.0,1.1450505256652832,7.0,56,-7,0,362,587,1246,880,33,18.99
1,1,0,1.0,1.0,1.1830193996429443,8.06225774829855,56,-8,-1,362,587,1246,880,33,0.12
1,1,0,1.0,1.0,1.199021577835083,9.219544457292887,56,-9,-2,362,587,1246,880,33,0.44
1,1,0,1.0,1.0,1.2102134227752686,10.44030650891055,56,-10,-3,362,587,1246,880,33,0.74
1,0,0,1.0,-0.0,1.2230424880981445,11.40175425099138,56,-11,-3,362,587,1246,880,33,2.05
0,1,0,-0.0,1.0,1.2324354648590088,11.704699910719626,56,-11,-4,362,587,1246,880,33,0.95
1,1,0,1.0,1.0,1.23905348777771,13.0,56,-12,-5,362,587,1246,880,33,1.26
1,0,0,1.0,-0.0,1.2490265369415283,13.92838827718412,56,-13,-5,362,587,1246,880,33,1.8
1,1,0,1.0,1.0,1.256894588470459,15.231546211727817,56,-14,-6,362,587,1246,880,33,1.44
2,1,0,2.0,1.0,1.2647955417633057,17.46424919657298,56,-16,-7,362,587,1246,880,33,3.73
2,1,0,2.0,1.0,1.271585464477539,19.697715603592208,56,-18,-8,362,587,1246,880,33,4.0
4,1,0,4.0,1.0,1.2794044017791748,23.769728648009426,56,-22,-9,362,587,1246,880,33,1.96
4,1,0,4.0,1.0,1.2890844345092773,27.85677655436824,56,-26,-10,362,587,1246,880,33,2.37
4,2,0,4.0,2.0,1.2965586185455322,32.31098884280702,56,-30,-12,362,587,1246,880,33,2.95
3,2,0,3.0,2.0,1.3058104515075684,35.84689665786984,56,-33,-14,362,587,1246,880,33,2.19
4,1,0,4.0,1.0,1.311185598373413,39.92492955535426,56,-37,-15,362,587,1246,880,33,2.55
1,1,0,1.0,1.0,1.3202755451202393,41.23105625617661,56,-38,-16,362,587,1246,880,33,2.18
2,1,0,2.0,1.0,1.3270914554595947,43.46262762420146,56,-40,-17,362,587,1246,880,33,4.22
0,0,1,-0.0,-0.0,1.3460545539855957,43.46262762420146,56,-40,-17,362,587,1246,880,33,30.07
0,0,0,-0.0,-0.0,1.431030511856079,43.46262762420146,56,-40,-17,362,587,1246,880,33,30.07
-1,0,0,-1.0,-0.0,1.6327435970306396,42.5440947723653,56,-39,-17,362,587,1246,880,33,2.4
-2,0,0,-2.0,-0.0,1.6416454315185547,40.718546143004666,56,-37,-17,362,587,1246,880,33,2.67
-2,0,0,-2.0,-0.0,1.6559665203094482,38.91015291668744,56,-35,-17,362,587,1246,880,33,2.54
-3,-1,0,-3.0,-1.0,1.657806634902954,35.77708763999664,56,-32,-16,362,587,1246,880,33,4.56
-2,0,0,-2.0,-0.0,1.6646864414215088,34.0,56,-30,-16,362,587,1246,880,33,2.28
-3,-2,0,-3.0,-2.0,1.6781764030456543,30.4138126514911,56,-27,-14,362,587,1246,880,33,4.82
-2,-2,0,-2.0,-2.0,1.6791446208953857,27.730849247724095,56,-25,-12,362,587,1246,880,33,2.86
-3,-1,0,-3.0,-1.0,1.6870214939117432,24.596747752497688,56,-22,-11,362,587,1246,880,33,4.05
-3,-1,0,-3.0,-1.0,1.6950066089630127,21.470910553583888,56,-19,-10,362,587,1246,880,33,3.69
-2,-2,0,-2.0,-2.0,1.7032005786895752,18.788294228055936,56,-17,-8,362,587,1246,880,33,2.38
-1,0,0,-1.0,-0.0,1.712026596069336,17.88854381999832,56,-16,-8,362,587,1246,880,33,1.74
-2,-1,0,-2.0,-1.0,1.7193655967712402,15.652475842498529,56,-14,-7,362,587,1246,880,33,7.59
-2,-1,0,-2.0,-1.0,1.727440595626831,13.416407864998739,56,-12,-6,362,587,1246,880,33,7.55
-2,0,0,-2.0,-0.0,1.7350094318389893,11.661903789690601,56,-10,-6,362,587,1246,880,33,1.18
-1,-1,0,-1.0,-1.0,1.7437524795532227,10.295630140987,56,-9,-5,362,587,1246,880,33,2.08
-1,0,0,-1.0,-0.0,1.7519984245300293,9.433981132056603,56,-8,-5,362,587,1246,880,33,1.08
-1,0,0,-1.0,-0.0,1.759075403213501,8.602325267042627,56,-7,-5,362,587,1246,880,33,0.86
0,0,1,-0.0,-0.0,1.7620084285736084,8.602325267042627,56,-7,-5,362,587,1246,880,33,29.46
0,0,0,-0.0,-0.0,0.09002280235290527,143.58969322343438,57,137,43,506,635,369,592,24,59.1
1,0,0,1.0,-0.0,0.14345264434814453,142.63590010933433,57,136,43,506,635,369,592,24,4.34
2,0,0,2.0,-0.0,0.15106582641601562,140.73023839957068,57,134,43,506,635,369,592,24,6.05
4,-1,0,4.0,-1.0,0.1605086326599121,137.2443077143821,57,130,44,506,635,369,592,24,7.69
6,0,0,6.0,-0.0,0.16954874992370605,131.5750736271882,57,124,44,506,635,369,592,24,11.23
7,1,0,7.0,1.0,0.1758577823638916,124.65151423067431,57,117,43,506,635,369,592,24,12.99
13,2,0,13.0,2.0,0.18648982048034668,111.7899816620434,57,104,41,506,635,369,592,24,17.19
17,4,0,17.0,4.0,0.19128870964050293,94.54099639838793,57,87,37,506,635,369,592,24,18.22
20,5,0,20.0,5.0,0.1990067958831787,74.24957912338628,57,67,32,506,635,369,592,24,16.52
19,5,0,19.0,5.0,0.20700478553771973,55.072679252057455,57,48,27,506,635,369,592,24,12.98
18,5,0,18.0,5.0,0.21506166458129883,37.20215047547655,57,30,22,506,635,369,592,24,9.44
17,5,0,17.0,5.0,0.22425580024719238,21.400934559032695,57,13,17,506,635,369,592,24,5.74
13,4,0,13.0,4.0,0.2310178279876709,13.0,57,0,13,506,635,369,592,24,1.63
10,3,0,10.0,3.0,0.2460646629333496,14.142135623730951,57,-10,10,506,635,369,592,24,-1.88
8,3,0,8.0,3.0,0.25134873390197754,19.313207915827967,57,-18,7,506,635,369,592,24,-1.48
4,1,0,4.0,1.0,0.25499463081359863,22.80350850198276,57,-22,6,506,635,369,592,24,0.26
1,1,0,1.0,1.0,0.26683568954467773,23.53720459187964,57,-23,5,506,635,369,592,24,1.07
-1,0,0,-1.0,-0.0,0.33503174781799316,22.561028345356956,57,-22,5,506,635,369,592,24,3.09
-1,0,0,-1.0,-0.0,0.3430447578430176,21.587033144922902,57,-21,5,506,635,369,592,24,3.0
-3,0,0,-3.0,-0.0,0.35102272033691406,18.681541692269406,57,-18,5,506,635,369,592,24,3.2
-2,1,0,-2.0,1.0,0.3609926700592041,16.492422502470642,57,-16,4,506,635,369,592,24,3.16
-2,1,0,-2.0,1.0,0.3670368194580078,14.317821063276353,57,-14,3,506,635,369,592,24,2.81
-2,0,0,-2.0,-0.0,0.37597060203552246,12.36931687685298,57,-12,3,506,635,369,592,24,2.67
-1,0,0,-1.0,-0.0,0.384124755859375,11.40175425099138,57,-11,3,506,635,369,592,24,2.41
-1,0,0,-1.0,-0.0,0.3917396068572998,10.44030650891055,57,-10,3,506,635,369,592,24,2.22
-1,0,0,-1.0,-0.0,0.3990936279296875,9.486832980505138,57,-9,3,506,635,369,592,24,2.01
0,1,0,-0.0,1.0,0.4070017337799072,9.219544457292887,57,-9,2,506,635,369,592,24,-0.25
-1,0,0,-1.0,-0.0,0.427459716796875,8.246211251235321,57,-8,2,506,635,369,592,24,2.3
0,1,0,-0.0,1.0,0.4341576099395752,8.06225774829855,57,-8,1,506,635,369,592,24,-0.45
0,0,1,-0.0,-0.0,0.48203468322753906,8.06225774829855,57,-8,1,506,635,369,592,24,29.3
0,0,0,-0.0,-0.0,0.08881044387817383,382.04973498224024,58,279,261,793,895,514,634,68,113.71
1,1,0,1.0,1.0,0.13878250122070312,380.63630935579437,58,278,260,793,895,514,634,68,7.24
2,0,0,2.0,-0.0,0.14675140380859375,379.17805843693014,58,276,260,793,895,514,634,68,3.35
2,0,0,2.0,-0.0,0.1588904857635498,377.72476752259706,58,274,260,793,895,514,634,68,3.33
2,0,0,2.0,-0.0,0.16463041305541992,376.27649408380535,58,272,260,793,895,514,634,68,3.31
4,1,0,4.0,1.0,0.17227435111999512,372.6996109469394,58,268,259,793,895,514,634,68,6.82
7,1,0,7.0,1.0,0.17951631546020508,366.9945503682582,58,261,258,793,895,514,634,68,9.26
10,3,0,10.0,3.0,0.18691635131835938,357.8072106595953,58,251,255,793,895,514,634,68,13.61
12,3,0,12.0,3.0,0.1982114315032959,347.3110997362451,58,239,252,793,895,514,634,68,14.61
17,4,0,17.0,4.0,0.2028512954711914,332.84831380074615,58,222,248,793,895,514,634,68,18.02
20,6,0,20.0,6.0,0.21127033233642578,315.2269024052357,58,202,242,793,895,514,634,68,20.17
20,6,0,20.0,6.0,0.21889233589172363,298.0268444284843,58,182,236,793,895,514,634,68,18.95
20,6,0,20.0,6.0,0.22884130477905273,281.3254343282882,58,162,230,793,895,514,634,68,17.69
18,6,0,18.0,6.0,0.23493432998657227,266.2930716334918,58,144,224,793,895,514,634,68,15.68
17,6,0,17.0,6.0,0.24355244636535645,252.29546171106605,58,127,218,793,895,514,634,68,14.23
13,6,0,13.0,6.0,0.25254249572753906,240.7072911234722,58,114,212,793,895,514,634,68,12.04
10,5,0,10.0,5.0,0.2588014602661133,231.65707414193074,58,104,207,793,895,514,634,68,9.72
7,4,0,7.0,4.0,0.26743030548095703,224.98444390668436,58,97,203,793,895,514,634,68,7.66
10,6,0,10.0,6.0,0.274822473526001,215.3555200128383,58,87,197,793,895,514,634,68,9.74
8,5,0,8.0,5.0,0.2827904224395752,207.6174366473105,58,79,192,793,895,514,634,68,8.05
7,7,0,7.0,7.0,0.29265642166137695,198.5170017907786,58,72,185,793,895,514,634,68,9.4
6,6,0,6.0,6.0,0.2988123893737793,190.77997798511248,58,66,179,793,895,514,634,68,8.13
4,6,0,4.0,6.0,0.30766940116882324,183.77431811871864,58,62,173,793,895,514,634,68,8.23
5,6,0,5.0,6.0,0.314800500869751,176.459627110566,58,57,167,793,895,514,634,68,7.68
4,7,0,4.0,7.0,0.32297229766845703,168.5496959356498,58,53,160,793,895,514,634,68,8.71
4,7,0,4.0,7.0,0.334700345993042,160.65490966665163,58,49,153,793,895,514,634,68,8.4
4,7,0,4.0,7.0,0.3395874500274658,152.7776161615307,58,45,146,793,895,514,634,68,8.08
3,8,0,3.0,8.0,0.3476552963256836,144.2497833620557,58,42,138,793,895,514,634,68,9.82
2,8,0,2.0,8.0,0.35475945472717285,136.01470508735443,58,40,130,793,895,514,634,68,9.59
4,10,0,4.0,10.0,0.36299848556518555,125.2836781069266,58,36,120,793,895,514,634,68,9.83
4,9,0,4.0,9.0,0.38477635383605957,115.52056094046635,58,32,111,793,895,514,634,68,8.41
4,9,0,4.0,9.0,0.384993314743042,105.77334257741882,58,28,102,793,895,514,634,68,7.88
4,9,0,4.0,9.0,0.38678836822509766,96.04686356149273,58,24,93,793,895,514,634,68,7.34
3,8,0,3.0,8.0,0.39707040786743164,87.55569655939013,58,21,85,793,895,514,634,68,7.01
2,8,0,2.0,8.0,0.40278148651123047,79.30952023559341,58,19,77,793,895,514,634,68,9.94
2,9,0,2.0,9.0,0.4167804718017578,70.09279563550022,58,17,68,793,895,514,634,68,8.37
2,8,0,2.0,8.0,0.41893649101257324,61.84658438426491,58,15,60,793,895,514,634,68,9.78
1,7,0,1.0,7.0,0.42786645889282227,54.817880294662984,58,14,53,793,895,514,634,68,5.3
2,8,0,2.0,8.0,0.43477535247802734,46.57252408878007,58,12,45,793,895,514,634,68,7.64
1,7,0,1.0,7.0,0.4445013999938965,39.56008088970496,58,11,38,793,895,514,634,68,4.41
3,5,0,3.0,5.0,0.451188325881958,33.95585369269929,58,8,33,793,895,514,634,68,2.85
1,4,0,1.0,4.0,0.45879530906677246,29.832867780352597,58,7,29,793,895,514,634,68,6.76
2,4,0,2.0,4.0,0.4677574634552002,25.495097567963924,58,5,25,793,895,514,634,68,2.53
1,2,0,1.0,2.0,0.4748983383178711,23.345235059857504,58,4,23,793,895,514,634,68,2.23
0,1,0,-0.0,1.0,0.48289036750793457,22.360679774997898,58,4,22,793,895,514,634,68,2.95
1,1,0,1.0,1.0,0.4907872676849365,21.213203435596427,58,3,21,793,895,514,634,68,1.08
0,1,0,-0.0,1.0,0.5057263374328613,20.223748416156685,58,3,20,793,895,514,634,68,3.16
0,0,1,-0.0,-0.0,0.5208034515380859,20.223748416156685,58,3,20,793,895,514,634,68,32.97
0,0,0,-0.0,-0.0,0.08632016181945801,1033.0851852582148,59,927,-456,1717,419,790,875,49,209.46
0,-1,0,-0.0,-1.0,0.16420316696166992,1032.6441787953875,59,927,-455,1717,419,790,875,49,2.42
0,-2,0,-0.0,-2.0,0.16627216339111328,1031.7645080152738,59,927,-453,1717,419,790,875,49,4.18
0,-1,0,-0.0,-1.0,0.17441034317016602,1031.325845695724,59,927,-452,1717,419,790,875,49,2.41
2,-2,0,2.0,-2.0,0.18244624137878418,1028.6520305720492,59,925,-450,1717,419,790,875,49,12.75
2,-1,0,2.0,-1.0,0.19042515754699707,1026.4160949634413,59,923,-449,1717,419,790,875,49,14.75
3,-1,0,3.0,-1.0,0.19832515716552734,1023.2809975759346,59,920,-448,1717,419,790,875,49,15.64
5,-3,0,5.0,-3.0,0.2081592082977295,1017.4723583468988,59,915,-445,1717,419,790,875,49,25.3
5,-2,0,5.0,-2.0,0.21555113792419434,1012.1012795170254,59,910,-443,1717,419,790,875,49,24.02
7,-3,0,7.0,-3.0,0.22275424003601074,1004.4944001834953,59,903,-440,1717,419,790,875,49,31.47
9,-3,0,9.0,-3.0,0.23030424118041992,995.0904481503177,59,894,-437,1717,419,790,875,49,35.38
10,-3,0,10.0,-3.0,0.24146819114685059,984.7903330151042,59,884,-434,1717,419,790,875,49,37.39
14,-4,0,14.0,-4.0,0.2465381622314453,970.4638066409277,59,870,-430,1717,419,790,875,49,47.2
14,-5,0,14.0,-5.0,0.2543361186981201,955.6992204663558,59,856,-425,1717,419,790,875,49,48.38
21,-5,0,21.0,-5.0,0.2631692886352539,934.6790893135461,59,835,-420,1717,419,790,875,49,59.95
25,-7,0,25.0,-7.0,0.27137017250061035,909.2133962937414,59,810,-413,1717,419,790,875,49,67.03
30,-7,0,30.0,-7.0,0.2790513038635254,879.338387652899,59,780,-406,1717,419,790,875,49,72.16
32,-10,0,32.0,-10.0,0.2862973213195801,846.3568987135392,59,748,-396,1717,419,790,875,49,75.18
31,-11,0,31.0,-11.0,0.2944183349609375,813.8267628924475,59,717,-385,1717,419,790,875,49,73.14
30,-12,0,30.0,-12.0,0.30234313011169434,781.7275740307489,59,687,-373,1717,419,790,875,49,71.21
27,-13,0,27.0,-13.0,0.31264328956604004,751.7978451685001,59,660,-360,1717,419,790,875,49,67.85
26,-12,0,26.0,-12.0,0.31844019889831543,723.2288711051295,59,634,-348,1717,419,790,875,49,64.18
24,-12,0,24.0,-12.0,0.3271291255950928,696.4165420206501,59,610,-336,1717,419,790,875,49,61.08
24,-12,0,24.0,-12.0,0.3345203399658203,669.6058542157468,59,586,-324,1717,419,790,875,49,59.64
23,-13,0,23.0,-13.0,0.343217134475708,643.187375497996,59,563,-311,1717,419,790,875,49,58.99
22,-13,0,22.0,-13.0,0.3523292541503906,617.6447198835266,59,541,-298,1717,419,790,875,49,55.57
22,-14,0,22.0,-14.0,0.3583083152770996,591.6223457578322,59,519,-284,1717,419,790,875,49,53.88
20,-14,0,20.0,-14.0,0.3669312000274658,567.3631993705619,59,499,-270,1717,419,790,875,49,49.65
19,-13,0,19.0,-13.0,0.3742661476135254,544.4713031923721,59,480,-257,1717,419,790,875,49,46.76
19,-13,0,19.0,-13.0,0.3827192783355713,521.590835809066,59,461,-244,1717,419,790,875,49,45.46
20,-13,0,20.0,-13.0,0.3909423351287842,497.83732282744734,59,441,-231,1717,419,790,875,49,45.44
20,-11,0,20.0,-11.0,0.39933133125305176,475.0168418066879,59,421,-220,1717,419,790,875,49,44.7
19,-11,0,19.0,-11.0,0.4062952995300293,453.08387744434253,59,402,-209,1717,419,790,875,49,41.65
20,-11,0,20.0,-11.0,0.41699934005737305,430.2650346007679,59,382,-198,1717,419,790,875,49,41.97
19,-10,0,19.0,-10.0,0.4254281520843506,408.794569435554,59,363,-188,1717,419,790,875,49,40.2
17,-8,0,17.0,-8.0,0.4317762851715088,390.020512281085,59,346,-180,1717,419,790,875,49,34.65
14,-7,0,14.0,-7.0,0.4397001266479492,374.370137697974,59,332,-173,1717,419,790,875,49,30.99
15,-8,0,15.0,-8.0,0.4469902515411377,357.37095573087635,59,317,-165,1717,419,790,875,49,32.1
12,-7,0,12.0,-7.0,0.4598681926727295,343.49526925417763,59,305,-158,1717,419,790,875,49,26.29
11,-6,0,11.0,-6.0,0.4625232219696045,330.9682764254,59,294,-152,1717,419,790,875,49,24.92
9,-6,0,9.0,-6.0,0.470872163772583,320.22023671217283,59,285,-146,1717,419,790,875,49,20.4
9,-6,0,9.0,-6.0,0.4783463478088379,309.4769781421552,59,276,-140,1717,419,790,875,49,19.93
10,-8,0,10.0,-8.0,0.48992228507995605,296.95117443781896,59,266,-132,1717,419,790,875,49,20.72
10,-6,0,10.0,-6.0,0.4977881908416748,285.3278815678552,59,256,-126,1717,419,790,875,49,20.43
10,-5,0,10.0,-5.0,0.5030112266540527,274.14777037211155,59,246,-121,1717,419,790,875,49,21.76
10,-5,0,10.0,-5.0,0.5117521286010742,262.9676786222976,59,236,-116,1717,419,790,875,49,21.26
10,-4,0,10.0,-4.0,0.5198132991790771,252.23005372080465,59,226,-112,1717,419,790,875,49,18.09
8,-4,0,8.0,-4.0,0.5277602672576904,243.28584011405184,59,218,-108,1717,419,790,875,49,18.25
10,-4,0,10.0,-4.0,0.5342941284179688,232.55106965997814,59,208,-104,1717,419,790,875,49,17.18
9,-4,0,9.0,-4.0,0.5423471927642822,222.71281956816046,59,199,-100,1717,419,790,875,49,16.54
8,-4,0,8.0,-4.0,0.5507092475891113,213.76856644511605,59,191,-96,1717,419,790,875,49,17.3
8,-4,0,8.0,-4.0,0.5620701313018799,204.8243149628481,59,183,-92,1717,419,790,875,49,16.95
7,-3,0,7.0,-3.0,0.5665872097015381,197.2232237846243,59,176,-89,1717,419,790,875,49,13.01
7,-4,0,7.0,-4.0,0.5743122100830078,189.1718795170149,59,169,-85,1717,419,790,875,49,13.36
8,-3,0,8.0,-3.0,0.5822691917419434,180.6792738528689,59,161,-82,1717,419,790,875,49,12.5
7,-3,0,7.0,-3.0,0.5914943218231201,173.08090593707902,59,154,-79,1717,419,790,875,49,12.04
8,-2,0,8.0,-2.0,0.5983631610870361,165.0605949341029,59,146,-77,1717,419,790,875,49,10.46
7,-3,0,7.0,-3.0,0.606837272644043,157.47063218263906,59,139,-74,1717,419,790,875,49,11.21
8,-2,0,8.0,-2.0,0.6147751808166504,149.4824404403407,59,131,-72,1717,419,790,875,49,9.72
6,-2,0,6.0,-2.0,0.6222941875457764,143.26548781894402,59,125,-70,1717,419,790,875,49,8.55
7,-2,0,7.0,-2.0,0.630378246307373,136.19104228986575,59,118,-68,1717,419,790,875,49,8.59
7,-3,0,7.0,-3.0,0.6389241218566895,128.63125592172378,59,111,-65,1717,419,790,875,49,9.56
8,-2,0,8.0,-2.0,0.64853835105896,120.7393887677091,59,103,-63,1717,419,790,875,49,8.23
7,-2,0,7.0,-2.0,0.6543822288513184,113.74093370462545,59,96,-61,1717,419,790,875,49,7.45
7,-2,0,7.0,-2.0,0.6623351573944092,106.78014796768171,59,89,-59,1717,419,790,875,49,7.06
4,-2,0,4.0,-2.0,0.6713101863861084,102.34256201600583,59,85,-57,1717,419,790,875,49,6.58
4,-2,0,4.0,-2.0,0.6788232326507568,97.9081201943945,59,81,-55,1717,419,790,875,49,6.4
3,-1,0,3.0,-1.0,0.6883113384246826,94.86832980505137,59,78,-54,1717,419,790,875,49,4.46
2,-2,0,2.0,-2.0,0.6943173408508301,92.0869154657707,59,76,-52,1717,419,790,875,49,4.83
3,-1,0,3.0,-1.0,0.7024023532867432,89.05054744357274,59,73,-51,1717,419,790,875,49,4.32
3,-2,0,3.0,-2.0,0.7103142738342285,85.44588931013593,59,70,-49,1717,419,790,875,49,7.64
4,-2,0,4.0,-2.0,0.7204673290252686,81.02468759581859,59,66,-47,1717,419,790,875,49,5.71
4,-3,0,4.0,-3.0,0.7264022827148438,76.02631123499285,59,62,-44,1717,419,790,875,49,7.98
3,-2,0,3.0,-2.0,0.7343113422393799,72.42237223399962,59,59,-42,1717,419,790,875,49,7.04
4,-3,0,4.0,-3.0,0.7462773323059082,67.42403132415029,59,55,-39,1717,419,790,875,49,7.69
3,-2,0,3.0,-2.0,0.7525613307952881,63.8200595424354,59,52,-37,1717,419,790,875,49,6.83
4,-3,0,4.0,-3.0,0.758284330368042,58.82176467941097,59,48,-34,1717,419,790,875,49,7.37
4,-2,0,4.0,-2.0,0.7675752639770508,54.405882034941776,59,44,-32,1717,419,790,875,49,4.78
3,-4,0,3.0,-4.0,0.774287223815918,49.64876634922564,59,41,-28,1717,419,790,875,49,3.75
3,-3,0,3.0,-3.0,0.7824783325195312,45.48626166217664,59,38,-25,1717,419,790,875,49,4.1
2,-2,0,2.0,-2.0,0.7903311252593994,42.720018726587654,59,36,-23,1717,419,790,875,49,3.54
2,-2,0,2.0,-2.0,0.7985882759094238,39.96248240537617,59,34,-21,1717,419,790,875,49,3.37
2,-2,0,2.0,-2.0,0.8063232898712158,37.21558813185679,59,32,-19,1717,419,790,875,49,3.18
3,-3,0,3.0,-3.0,0.8143172264099121,33.12099032335839,59,29,-16,1717,419,790,875,49,3.14
1,-1,0,1.0,-1.0,0.8249032497406006,31.76476034853718,59,28,-15,1717,419,790,875,49,2.58
2,-1,0,2.0,-1.0,0.8327553272247314,29.5296461204668,59,26,-14,1717,419,790,875,49,5.54
1,-1,0,1.0,-1.0,0.8383212089538574,28.178005607210743,59,25,-13,1717,419,790,875,49,2.45
1,-1,0,1.0,-1.0,0.8463852405548096,26.832815729997478,59,24,-12,1717,419,790,875,49,2.35
0,0,1,-0.0,-0.0,0.8623461723327637,26.832815729997478,59,24,-12,1717,419,790,875,49,34.980000000000004
0,0,0,-0.0,-0.0,0.08388590812683105,487.9641380265562,60,-422,-245,1271,186,1693,431,30,133.25
0,1,0,-0.0,1.0,0.09808897972106934,488.4669896727925,60,-422,-246,1271,186,1693,431,30,8.57
-1,1,0,-1.0,1.0,0.10589098930358887,488.1085944746312,60,-421,-247,1271,186,1693,431,30,1.86
-1,1,0,-1.0,1.0,0.1143338680267334,487.75403637489256,60,-420,-248,1271,186,1693,431,30,1.84
0,2,0,-0.0,2.0,0.12189078330993652,488.7739763939975,60,-420,-250,1271,186,1693,431,30,4.69
-2,2,0,-2.0,2.0,0.12987589836120605,488.0860579856794,60,-418,-252,1271,186,1693,431,30,3.16
-1,2,0,-1.0,2.0,0.13868188858032227,488.26734480200497,60,-417,-254,1271,186,1693,431,30,19.84
-3,3,0,-3.0,3.0,0.14675283432006836,487.2832851637741,60,-414,-257,1271,186,1693,431,30,4.3
-3,4,0,-3.0,4.0,0.15414094924926758,486.8695923961569,60,-411,-261,1271,186,1693,431,30,1.84
-5,4,0,-5.0,4.0,0.1618959903717041,484.83089835529256,60,-406,-265,1271,186,1693,431,30,8.36
-5,4,0,-5.0,4.0,0.17102384567260742,482.86851212312445,60,-401,-269,1271,186,1693,431,30,8.04
-4,4,0,-4.0,4.0,0.1778428554534912,481.80701530799655,60,-397,-273,1271,186,1693,431,30,4.5
-3,3,0,-3.0,3.0,0.18593096733093262,481.0530116317743,60,-394,-276,1271,186,1693,431,30,3.3
-3,3,0,-3.0,3.0,0.19402575492858887,480.33529955646605,60,-391,-279,1271,186,1693,431,30,3.14
-3,2,0,-3.0,2.0,0.20266199111938477,479.06680118747533,60,-388,-281,1271,186,1693,431,30,5.5
-3,1,0,-3.0,1.0,0.210784912109375,477.23055224911997,60,-385,-282,1271,186,1693,431,30,7.97
-5,1,0,-5.0,1.0,0.21794486045837402,473.8027015541385,60,-380,-283,1271,186,1693,431,30,13.64
-6,1,0,-6.0,1.0,0.2265489101409912,469.6083474556218,60,-374,-284,1271,186,1693,431,30,16.06
-8,0,0,-8.0,-0.0,0.23415493965148926,463.26234468171486,60,-366,-284,1271,186,1693,431,30,22.52
-8,-2,0,-8.0,-2.0,0.24364876747131348,455.72798904609755,60,-358,-282,1271,186,1693,431,30,26.06
-8,-2,0,-8.0,-2.0,0.25359177589416504,448.2186966202994,60,-350,-280,1271,186,1693,431,30,25.69
-5,-3,0,-5.0,-3.0,0.2578737735748291,442.4409565128436,60,-345,-277,1271,186,1693,431,30,22.5
-4,-2,0,-4.0,-2.0,0.26597094535827637,438.0707705382773,60,-341,-275,1271,186,1693,431,30,17.76
-4,-3,0,-4.0,-3.0,0.2738919258117676,433.07389669662615,60,-337,-272,1271,186,1693,431,30,21.62
-5,-4,0,-5.0,-4.0,0.2837507724761963,426.67083331298846,60,-332,-268,1271,186,1693,431,30,26.61
-6,-6,0,-6.0,-6.0,0.28995275497436523,418.2343840479881,60,-326,-262,1271,186,1693,431,30,28.61
-8,-6,0,-8.0,-6.0,0.3007168769836426,408.24012541640246,60,-318,-256,1271,186,1693,431,30,32.9
-8,-6,0,-8.0,-6.0,0.31066179275512695,398.24615503479754,60,-310,-250,1271,186,1693,431,30,32.39
-9,-8,0,-9.0,-8.0,0.31472182273864746,386.21884987659524,60,-301,-242,1271,186,1693,431,30,35.31
-12,-9,0,-12.0,-9.0,0.3218557834625244,371.22769293251815,60,-289,-233,1271,186,1693,431,30,39.72
-13,-10,0,-13.0,-10.0,0.3298947811126709,354.8309456628607,60,-276,-223,1271,186,1693,431,30,41.03
-16,-11,0,-16.0,-11.0,0.3379547595977783,335.4757815401881,60,-260,-212,1271,186,1693,431,30,41.96
-14,-9,0,-14.0,-9.0,0.34935998916625977,318.9435686763412,60,-246,-203,1271,186,1693,431,30,36.7
-15,-11,0,-15.0,-11.0,0.35608696937561035,300.3747659175118,60,-231,-192,1271,186,1693,431,30,38.51
-16,-10,0,-16.0,-10.0,0.3618438243865967,281.6895454219059,60,-215,-182,1271,186,1693,431,30,35.94
-17,-10,0,-17.0,-10.0,0.3706507682800293,262.2746651889961,60,-198,-172,1271,186,1693,431,30,34.63
-16,-11,0,-16.0,-11.0,0.3783869743347168,242.99176940793694,60,-182,-161,1271,186,1693,431,30,33.28
-17,-10,0,-17.0,-10.0,0.38600587844848633,223.66492796144863,60,-165,-151,1271,186,1693,431,30,30.75
-15,-10,0,-15.0,-10.0,0.39443182945251465,205.86646157157313,60,-150,-141,1271,186,1693,431,30,28.03
-14,-8,0,-14.0,-8.0,0.40191197395324707,190.22355269524328,60,-136,-133,1271,186,1693,431,30,24.1
-13,-7,0,-13.0,-7.0,0.4098677635192871,176.08236708995025,60,-123,-126,1271,186,1693,431,30,21.27
-9,-6,0,-9.0,-6.0,0.41832876205444336,165.51737068960466,60,-114,-120,1271,186,1693,431,30,17.45
-7,-6,0,-7.0,-6.0,0.4258887767791748,156.348968656656,60,-107,-114,1271,186,1693,431,30,16.35
-8,-4,0,-8.0,-4.0,0.4345707893371582,147.98986451781082,60,-99,-110,1271,186,1693,431,30,13.28
-5,-4,0,-5.0,-4.0,0.44383788108825684,141.6756859873987,60,-94,-106,1271,186,1693,431,30,11.81
-6,-3,0,-6.0,-3.0,0.45003795623779297,135.47324459095236,60,-88,-103,1271,186,1693,431,30,10.19
-5,-3,0,-5.0,-3.0,0.4578878879547119,129.9576854210631,60,-83,-100,1271,186,1693,431,30,9.42
-4,-3,0,-4.0,-3.0,0.46856093406677246,125.09996003196804,60,-79,-97,1271,186,1693,431,30,8.94
-4,-2,0,-4.0,-2.0,0.47389698028564453,121.03718436910205,60,-75,-95,1271,186,1693,431,30,7.07
-4,-2,0,-4.0,-2.0,0.48589491844177246,117.00427342623003,60,-71,-93,1271,186,1693,431,30,6.84
-6,-3,0,-6.0,-3.0,0.49030494689941406,111.01801655587259,60,-65,-90,1271,186,1693,431,30,8.47
-5,-4,0,-5.0,-4.0,0.49791884422302246,104.86181383134664,60,-60,-86,1271,186,1693,431,30,9.05
-4,-2,0,-4.0,-2.0,0.5058889389038086,100.9554357129917,60,-56,-84,1271,186,1693,431,30,5.94
-3,-3,0,-3.0,-3.0,0.5143008232116699,96.79876032264049,60,-53,-81,1271,186,1693,431,30,7.33
-3,-2,0,-3.0,-2.0,0.5264577865600586,93.49331526906082,60,-50,-79,1271,186,1693,431,30,5.42
-4,-3,0,-4.0,-3.0,0.5327978134155273,88.83692925805124,60,-46,-76,1271,186,1693,431,30,6.57
-4,-2,0,-4.0,-2.0,0.5386378765106201,85.0881895447306,60,-42,-74,1271,186,1693,431,30,5.01
-4,-3,0,-4.0,-3.0,0.5458967685699463,80.52949770115296,60,-38,-71,1271,186,1693,431,30,5.93
-4,-3,0,-4.0,-3.0,0.5542519092559814,76.02631123499285,60,-34,-68,1271,186,1693,431,30,5.6
-5,-3,0,-5.0,-3.0,0.5619888305664062,71.17583859709698,60,-29,-65,1271,186,1693,431,30,5.2
-4,-3,0,-4.0,-3.0,0.570253849029541,66.85057965343307,60,-25,-62,1271,186,1693,431,30,4.82
-3,-2,0,-3.0,-2.0,0.5778989791870117,63.90618123468183,60,-22,-60,1271,186,1693,431,30,3.55
-3,-2,0,-3.0,-2.0,0.5879747867584229,61.032778078668514,60,-19,-58,1271,186,1693,431,30,3.32
-2,-2,0,-2.0,-2.0,0.5939548015594482,58.52349955359813,60,-17,-56,1271,186,1693,431,30,3.47
-3,-1,0,-3.0,-1.0,0.6049098968505859,56.753854494650845,60,-14,-55,1271,186,1693,431,30,1.82
-3,-2,0,-3.0,-2.0,0.6101589202880859,54.12947441089743,60,-11,-53,1271,186,1693,431,30,2.69
-1,-2,0,-1.0,-2.0,0.6193218231201172,51.97114584074513,60,-10,-51,1271,186,1693,431,30,3.92
-2,-2,0,-2.0,-2.0,0.6260719299316406,49.64876634922564,60,-8,-49,1271,186,1693,431,30,2.73
-2,-1,0,-2.0,-1.0,0.6363189220428467,48.373546489791295,60,-6,-48,1271,186,1693,431,30,1.4
-1,-2,0,-1.0,-2.0,0.6419217586517334,46.2709412050371,60,-5,-46,1271,186,1693,431,30,3.34
-1,-1,0,-1.0,-1.0,0.6503748893737793,45.17742799230607,60,-4,-45,1271,186,1693,431,30,1.81
-1,-2,0,-1.0,-2.0,0.6578829288482666,43.104524124504614,60,-3,-43,1271,186,1693,431,30,3.09
-2,-1,0,-2.0,-1.0,0.6659009456634521,42.01190307520001,60,-1,-42,1271,186,1693,431,30,1.01
-1,-1,0,-1.0,-1.0,0.6738808155059814,41.0,60,0,-41,1271,186,1693,431,30,1.52
-1,-2,0,-1.0,-2.0,0.6818568706512451,39.01281840626232,60,1,-39,1271,186,1693,431,30,2.61
-1,-1,0,-1.0,-1.0,0.6917779445648193,38.05259518088089,60,2,-38,1271,186,1693,431,30,1.34
-2,-2,0,-2.0,-2.0,0.6979529857635498,36.22154055254967,60,4,-36,1271,186,1693,431,30,1.5
-1,-1,0,-1.0,-1.0,0.7061917781829834,35.35533905932738,60,5,-35,1271,186,1693,431,30,1.1
-1,-2,0,-1.0,-2.0,0.7139148712158203,33.54101966249684,60,6,-33,1271,186,1693,431,30,1.96
-2,-2,0,-2.0,-2.0,0.7236738204956055,32.01562118716424,60,8,-31,1271,186,1693,431,30,0.99
-1,-2,0,-1.0,-2.0,0.73052978515625,30.364452901377952,60,9,-29,1271,186,1693,431,30,1.53
-1,-2,0,-1.0,-2.0,0.7400858402252197,28.792360097775937,60,10,-27,1271,186,1693,431,30,1.35
0,-2,0,-0.0,-2.0,0.7486739158630371,26.92582403567252,60,10,-25,1271,186,1693,431,30,2.55
-1,-2,0,-1.0,-2.0,0.7541999816894531,25.495097567963924,60,11,-23,1271,186,1693,431,30,1.02
-1,-2,0,-1.0,-2.0,0.7618799209594727,24.186773244895647,60,12,-21,1271,186,1693,431,30,0.81
0,-2,0,-0.0,-2.0,0.7699518203735352,22.47220505424423,60,12,-19,1271,186,1693,431,30,1.75
-1,-3,0,-1.0,-3.0,0.7779178619384766,20.615528128088304,60,13,-16,1271,186,1693,431,30,0.7
0,-2,0,-0.0,-2.0,0.7863368988037109,19.1049731745428,60,13,-14,1271,186,1693,431,30,1.13
0,-2,0,-0.0,-2.0,0.7939538955688477,17.69180601295413,60,13,-12,1271,186,1693,431,30,0.88
0,-1,0,-0.0,-1.0,0.803973913192749,17.029386365926403,60,13,-11,1271,186,1693,431,30,0.79
0,-2,0,-0.0,-2.0,0.8098788261413574,15.811388300841896,60,13,-9,1271,186,1693,431,30,0.5
0,-1,0,-0.0,-1.0,0.8270797729492188,15.264337522473747,60,13,-8,1271,186,1693,431,30,0.46
0,0,1,-0.0,-0.0,0.8280107975006104,15.264337522473747,60,13,-8,1271,186,1693,431,30,31.46
0,0,0,-0.0,-0.0,0.09709858894348145,749.0961220030445,61,-196,723,1062,917,1258,194,62,173.73
-1,0,0,-1.0,-0.0,0.15429043769836426,748.8350953314088,61,-195,723,1062,917,1258,194,62,1.09
-1,1,0,-1.0,1.0,0.17002654075622559,747.6095237488619,61,-194,722,1062,917,1258,194,62,4.9
-2,1,0,-2.0,1.0,0.17024755477905273,746.1266648498765,61,-192,721,1062,917,1258,194,62,4.87
-3,0,0,-3.0,-0.0,0.17510652542114258,745.3603155521496,61,-189,721,1062,917,1258,194,62,2.39
-3,1,0,-3.0,1.0,0.18311452865600586,743.6370082237704,61,-186,720,1062,917,1258,194,62,5.24
-4,2,0,-4.0,2.0,0.19165658950805664,740.7077696365822,61,-182,718,1062,917,1258,194,62,8.41
-4,3,0,-4.0,3.0,0.19953155517578125,736.8235881131928,61,-178,715,1062,917,1258,194,62,10.99
-6,4,0,-6.0,4.0,0.20816349983215332,731.5087149173276,61,-172,711,1062,917,1258,194,62,14.08
-6,7,0,-6.0,7.0,0.2169654369354248,723.3062974978167,61,-166,704,1062,917,1258,194,62,20.78
-7,8,0,-7.0,8.0,0.2230815887451172,713.9306689028004,61,-159,696,1062,917,1258,194,62,22.9
-7,9,0,-7.0,9.0,0.23187565803527832,703.6142409019305,61,-152,687,1062,917,1258,194,62,24.66
-7,10,0,-7.0,10.0,0.23964858055114746,692.3539557191827,61,-145,677,1062,917,1258,194,62,26.31
-10,12,0,-10.0,12.0,0.24730253219604492,678.5646616203942,61,-135,665,1062,917,1258,194,62,30.09
-11,12,0,-11.0,12.0,0.2551276683807373,664.669090600729,61,-124,653,1062,917,1258,194,62,29.72
-12,13,0,-12.0,13.0,0.263136625289917,649.7260961359025,61,-112,640,1062,917,1258,194,62,30.94
-13,15,0,-13.0,15.0,0.27229762077331543,632.7922249838409,61,-99,625,1062,917,1258,194,62,33.5
-13,15,0,-13.0,15.0,0.2790665626525879,616.0324666768789,61,-86,610,1062,917,1258,194,62,32.64
-13,18,0,-13.0,18.0,0.2871825695037842,596.4838639896304,61,-73,592,1062,917,1258,194,62,36.02
-12,19,0,-12.0,19.0,0.2990696430206299,576.2377981354573,61,-61,573,1062,917,1258,194,62,36.28
-11,20,0,-11.0,20.0,0.30419254302978516,555.2557969080557,61,-50,553,1062,917,1258,194,62,36.49
-10,21,0,-10.0,21.0,0.31115150451660156,533.5016401099438,61,-40,532,1062,917,1258,194,62,36.64
-9,22,0,-9.0,22.0,0.319286584854126,510.9412882122563,61,-31,510,1062,917,1258,194,62,36.71
-8,25,0,-8.0,25.0,0.3305976390838623,485.5450545520982,61,-23,485,1062,917,1258,194,62,38.79
-7,25,0,-7.0,25.0,0.3361635208129883,460.2781767583599,61,-16,460,1062,917,1258,194,62,37.48
-6,28,0,-6.0,28.0,0.3433394432067871,432.11572524035734,61,-10,432,1062,917,1258,194,62,38.91
-4,25,0,-4.0,25.0,0.3534715175628662,407.04422364160877,61,-6,407,1062,917,1258,194,62,35.1
-4,24,0,-4.0,24.0,0.3608064651489258,383.00522189651673,61,-2,383,1062,917,1258,194,62,32.7
-4,24,0,-4.0,24.0,0.36718058586120605,359.0055709874152,61,2,359,1062,917,1258,194,62,31.22
-3,23,0,-3.0,23.0,0.37673163414001465,336.0372003216311,61,5,336,1062,917,1258,194,62,29.27
-2,20,0,-2.0,20.0,0.3831005096435547,316.07752213657966,61,7,316,1062,917,1258,194,62,25.9
-1,20,0,-1.0,20.0,0.39737749099731445,296.10808837314795,61,8,296,1062,917,1258,194,62,25.43
0,19,0,-0.0,19.0,0.3991115093231201,277.1154993860863,61,8,277,1062,917,1258,194,62,24.77
0,18,0,-0.0,18.0,0.4071965217590332,259.12352266824405,61,8,259,1062,917,1258,194,62,22.97
-1,16,0,-1.0,16.0,0.4150965213775635,243.16660954991332,61,9,243,1062,917,1258,194,62,19.2
0,14,0,-0.0,14.0,0.4236185550689697,229.17678765529462,61,9,229,1062,917,1258,194,62,18.15
0,14,0,-0.0,14.0,0.4311485290527344,215.18828964420902,61,9,215,1062,917,1258,194,62,17.44
1,14,0,1.0,14.0,0.43912458419799805,201.1591409804685,61,8,201,1062,917,1258,194,62,17.12
0,12,0,-0.0,12.0,0.44841456413269043,189.16923639957952,61,8,189,1062,917,1258,194,62,14.83
0,11,0,-0.0,11.0,0.45627665519714355,178.1796845883391,61,8,178,1062,917,1258,194,62,13.61
0,8,0,-0.0,8.0,0.4631235599517822,170.18813119603846,61,8,170,1062,917,1258,194,62,11.18
0,6,0,-0.0,6.0,0.4758415222167969,164.19500601419034,61,8,164,1062,917,1258,194,62,9.52
0,6,0,-0.0,6.0,0.4797966480255127,158.2024020045208,61,8,158,1062,917,1258,194,62,9.33
0,6,0,-0.0,6.0,0.4888424873352051,152.21038072352357,61,8,152,1062,917,1258,194,62,9.14
0,5,0,-0.0,5.0,0.49685049057006836,147.2175261305528,61,8,147,1062,917,1258,194,62,8.29
1,5,0,1.0,5.0,0.505272626876831,142.1724305201258,61,7,142,1062,917,1258,194,62,6.96
1,5,0,1.0,5.0,0.5115225315093994,137.13132391981054,61,6,137,1062,917,1258,194,62,6.8
1,6,0,1.0,6.0,0.519120454788208,131.0953851209111,61,5,131,1062,917,1258,194,62,7.51
0,5,0,-0.0,5.0,0.5276775360107422,126.09916732476864,61,5,126,1062,917,1258,194,62,8.18
1,6,0,1.0,6.0,0.538583517074585,120.06664815842908,61,4,120,1062,917,1258,194,62,7.16
0,5,0,-0.0,5.0,0.5431654453277588,115.06954418958998,61,4,115,1062,917,1258,194,62,8.07
0,5,0,-0.0,5.0,0.5512504577636719,110.07270324653611,61,4,110,1062,917,1258,194,62,7.9
0,4,0,-0.0,4.0,0.5602915287017822,106.07544484940895,61,4,106,1062,917,1258,194,62,7.24
0,4,0,-0.0,4.0,0.568211555480957,102.07840124139877,61,4,102,1062,917,1258,194,62,7.12
0,3,0,-0.0,3.0,0.5751006603240967,99.08077512817509,61,4,99,1062,917,1258,194,62,6.52
1,3,0,1.0,3.0,0.5831184387207031,96.04686356149273,61,3,96,1062,917,1258,194,62,3.99
1,3,0,1.0,3.0,0.5980024337768555,93.02150289046077,61,2,93,1062,917,1258,194,62,3.89
0,1,0,-0.0,1.0,0.6001255512237549,92.02173656261873,61,2,92,1062,917,1258,194,62,6.0
0,2,0,-0.0,2.0,0.6070654392242432,90.0222194794152,61,2,90,1062,917,1258,194,62,6.48
1,1,0,1.0,1.0,0.6150856018066406,89.00561780022652,61,1,89,1062,917,1258,194,62,1.57
0,2,0,-0.0,2.0,0.6230685710906982,87.00574693662483,61,1,87,1062,917,1258,194,62,6.94
0,2,0,-0.0,2.0,0.63144850730896,85.00588214941364,61,1,85,1062,917,1258,194,62,6.91
0,2,0,-0.0,2.0,0.6420145034790039,83.00602387778854,61,1,83,1062,917,1258,194,62,6.87
0,1,0,-0.0,1.0,0.6512596607208252,82.00609733428362,61,1,82,1062,917,1258,194,62,6.37
0,2,0,-0.0,2.0,0.6607866287231445,80.00624975587844,61,1,80,1062,917,1258,194,62,6.81
0,1,0,-0.0,1.0,0.6668305397033691,79.00632886041473,61,1,79,1062,917,1258,194,62,6.33
0,1,0,-0.0,1.0,0.671088457107544,78.00640999302557,61,1,78,1062,917,1258,194,62,6.32
0,2,0,-0.0,2.0,0.6791634559631348,76.00657866263946,61,1,76,1062,917,1258,194,62,6.74
0,2,0,-0.0,2.0,0.687253475189209,74.00675644831355,61,1,74,1062,917,1258,194,62,6.7
0,1,0,-0.0,1.0,0.6963036060333252,73.00684899377592,61,1,73,1062,917,1258,194,62,6.25
0,1,0,-0.0,1.0,0.7032556533813477,72.00694410957877,61,1,72,1062,917,1258,194,62,6.23
0,2,0,-0.0,2.0,0.7111384868621826,70.00714249274856,61,1,70,1062,917,1258,194,62,6.61
1,2,0,1.0,2.0,0.7206125259399414,68.0,61,0,68,1062,917,1258,194,62,2.49
0,2,0,-0.0,2.0,0.7283215522766113,66.0,61,0,66,1062,917,1258,194,62,7.59
0,3,0,-0.0,3.0,0.7370126247406006,63.0,61,0,63,1062,917,1258,194,62,8.0
0,2,0,-0.0,2.0,0.7440664768218994,61.0,61,0,61,1062,917,1258,194,62,7.54
0,2,0,-0.0,2.0,0.751091480255127,59.0,61,0,59,1062,917,1258,194,62,7.52
0,1,0,-0.0,1.0,0.7596006393432617,58.0,61,0,58,1062,917,1258,194,62,7.09
0,1,0,-0.0,1.0,0.7670655250549316,57.0,61,0,57,1062,917,1258,194,62,7.08
0,2,0,-0.0,2.0,0.7750895023345947,55.0,61,0,55,1062,917,1258,194,62,7.49
0,2,0,-0.0,2.0,0.7830946445465088,53.0,61,0,53,1062,917,1258,194,62,7.47
1,2,0,1.0,2.0,0.7948975563049316,51.0098029794274,61,-1,51,1062,917,1258,194,62,2.17
0,1,0,-0.0,1.0,0.7993836402893066,50.00999900019995,61,-1,50,1062,917,1258,194,62,5.82
0,2,0,-0.0,2.0,0.80845046043396,48.010415536631214,61,-1,48,1062,917,1258,194,62,6.03
0,1,0,-0.0,1.0,0.8151865005493164,47.01063709417264,61,-1,47,1062,917,1258,194,62,5.74
0,1,0,-0.0,1.0,0.823784589767456,46.010868281309364,61,-1,46,1062,917,1258,194,62,5.72
0,1,0,-0.0,1.0,0.8313095569610596,45.0111097397076,61,-1,45,1062,917,1258,194,62,5.69
0,1,0,-0.0,1.0,0.839139461517334,44.01136216933077,61,-1,44,1062,917,1258,194,62,5.66
0,1,0,-0.0,1.0,0.8510556221008301,43.01162633521314,61,-1,43,1062,917,1258,194,62,5.63
0,0,1,-0.0,-0.0,0.8514266014099121,43.01162633521314,61,-1,43,1062,917,1258,194,62,39.94
0,1,1,-0.0,1.0,0.8568096160888672,42.01190307520001,61,-1,42,1062,917,1258,194,62,15.6
0,1,1,-0.0,1.0,0.8630685806274414,41.012193308819754,61,-1,41,1062,917,1258,194,62,15.57
0,1,1,-0.0,1.0,0.8714566230773926,40.01249804748511,61,-1,40,1062,917,1258,194,62,15.54
0,0,0,-0.0,-0.0,0.9811086654663086,40.01249804748511,61,-1,40,1062,917,1258,194,62,29.02
0,0,1,-0.0,-0.0,1.1310925483703613,40.01249804748511,61,-1,40,1062,917,1258,194,62,39.019999999999996
0,0,0,-0.0,-0.0,0.08552122116088867,444.3422104639621,62,104,-432,1167,445,1063,877,58,125.47
1,-3,0,1.0,-3.0,0.2062664031982422,441.1915683691156,62,103,-429,1167,445,1063,877,58,10.09
2,-6,0,2.0,-6.0,0.2135171890258789,434.8907908889311,62,101,-423,1167,445,1063,877,58,15.38
3,-8,0,3.0,-8.0,0.22429227828979492,426.4141179651537,62,98,-415,1167,445,1063,877,58,18.12
3,-9,0,3.0,-9.0,0.23300623893737793,416.9664255068986,62,95,-406,1167,445,1063,877,58,19.71
3,-10,0,3.0,-10.0,0.2375192642211914,406.5464303127012,62,92,-396,1167,445,1063,877,58,21.23
2,-13,0,2.0,-13.0,0.24551129341125488,393.4323321741618,62,90,-383,1167,445,1063,877,58,24.04
2,-16,0,2.0,-16.0,0.25600719451904297,377.4029676618879,62,88,-367,1167,445,1063,877,58,26.35
1,-20,0,1.0,-20.0,0.26152825355529785,357.7401291440478,62,87,-347,1167,445,1063,877,58,28.4
0,-26,0,-0.0,-26.0,0.27198123931884766,332.58081724597406,62,87,-321,1167,445,1063,877,58,31.33
-3,-25,0,-3.0,-25.0,0.2782473564147949,309.38002521171273,62,90,-296,1167,445,1063,877,58,27.66
-2,-24,0,-2.0,-24.0,0.28550124168395996,287.1375976774898,62,92,-272,1167,445,1063,877,58,25.54
-2,-22,0,-2.0,-22.0,0.29384827613830566,267.0880004792428,62,94,-250,1167,445,1063,877,58,22.49
-1,-20,0,-1.0,-20.0,0.30219030380249023,248.84734276258607,62,95,-230,1167,445,1063,877,58,20.07
0,-19,0,-0.0,-19.0,0.3116872310638428,231.40008643040736,62,95,-211,1167,445,1063,877,58,18.54
0,-16,0,-0.0,-16.0,0.32034730911254883,216.91011963483862,62,95,-195,1167,445,1063,877,58,15.47
1,-15,0,1.0,-15.0,0.32708740234375,203.06649157357302,62,94,-180,1167,445,1063,877,58,14.42
3,-14,0,3.0,-14.0,0.33721137046813965,189.30662957223657,62,91,-166,1167,445,1063,877,58,14.18
3,-12,0,3.0,-12.0,0.3415262699127197,177.36967046256808,62,88,-154,1167,445,1063,877,58,12.43
3,-11,0,3.0,-11.0,0.3502833843231201,166.35504200354134,62,85,-143,1167,445,1063,877,58,11.32
3,-11,0,3.0,-11.0,0.35944628715515137,155.3962676514465,62,82,-132,1167,445,1063,877,58,10.69
4,-10,0,4.0,-10.0,0.3655383586883545,144.80331487918363,62,78,-122,1167,445,1063,877,58,10.59
4,-10,0,4.0,-10.0,0.37351036071777344,134.23859355639868,62,74,-112,1167,445,1063,877,58,9.98
5,-10,0,5.0,-10.0,0.3815653324127197,123.14625451064275,62,69,-102,1167,445,1063,877,58,10.34
4,-8,0,4.0,-8.0,0.389559268951416,114.28473213863697,62,65,-94,1167,445,1063,877,58,8.68
3,-8,0,3.0,-8.0,0.3974752426147461,106.01886624558857,62,62,-86,1167,445,1063,877,58,7.16
4,-7,0,4.0,-7.0,0.40632033348083496,98.00510190801293,62,58,-79,1167,445,1063,877,58,7.88
4,-7,0,4.0,-7.0,0.414034366607666,90.0,62,54,-72,1167,445,1063,877,58,7.44
3,-6,0,3.0,-6.0,0.4215352535247803,83.40863264674707,62,51,-66,1167,445,1063,877,58,5.97
2,-6,0,2.0,-6.0,0.4295213222503662,77.46612162745726,62,49,-60,1167,445,1063,877,58,4.62
3,-5,0,3.0,-5.0,0.44019341468811035,71.7007670809734,62,46,-55,1167,445,1063,877,58,5.54
2,-5,0,2.0,-5.0,0.44692420959472656,66.60330322138685,62,44,-50,1167,445,1063,877,58,4.04
2,-4,0,2.0,-4.0,0.4543173313140869,62.289646009589745,62,42,-46,1167,445,1063,877,58,3.95
2,-5,0,2.0,-5.0,0.46442723274230957,57.28001396647874,62,40,-41,1167,445,1063,877,58,3.5
2,-4,0,2.0,-4.0,0.4694821834564209,53.03772242470448,62,38,-37,1167,445,1063,877,58,3.38
1,-4,0,1.0,-4.0,0.47771334648132324,49.57822102496216,62,37,-33,1167,445,1063,877,58,2.21
1,-3,0,1.0,-3.0,0.4855382442474365,46.861498055439924,62,36,-30,1167,445,1063,877,58,2.09
1,-2,0,1.0,-2.0,0.49469828605651855,44.82186966202994,62,35,-28,1167,445,1063,877,58,2.28
0,-1,0,-0.0,-1.0,0.503467321395874,44.204072210600685,62,35,-27,1167,445,1063,877,58,0.93
0,-1,0,-0.0,-1.0,0.5095212459564209,43.60045871318328,62,35,-26,1167,445,1063,877,58,0.89
1,-1,0,1.0,-1.0,0.5175752639770508,42.20189569201838,62,34,-25,1167,445,1063,877,58,3.58
0,-1,0,-0.0,-1.0,0.5355823040008545,41.617304093369626,62,34,-24,1167,445,1063,877,58,0.83
0,-1,0,-0.0,-1.0,0.5417733192443848,41.048751503547585,62,34,-23,1167,445,1063,877,58,0.79
0,0,1,-0.0,-0.0,0.5775043964385986,41.048751503547585,62,34,-23,1167,445,1063,877,58,39.34
0,0,0,-0.0,-0.0,0.11107277870178223,546.0595205652952,63,-34,545,1099,1013,1133,468,27,143.09
-2,3,0,-2.0,3.0,0.17711091041564941,542.943827665441,63,-32,542,1099,1013,1133,468,27,15.66
-4,5,0,-4.0,5.0,0.1850888729095459,537.7294858941622,63,-28,537,1099,1013,1133,468,27,23.18
-3,8,0,-3.0,8.0,0.19338679313659668,529.5904077681166,63,-25,529,1099,1013,1133,468,27,33.2
-5,9,0,-5.0,9.0,0.2023177146911621,520.3844732503075,63,-20,520,1099,1013,1133,468,27,35.23
-4,14,0,-4.0,14.0,0.211594820022583,506.2529012262547,63,-16,506,1099,1013,1133,468,27,47.01
-4,16,0,-4.0,16.0,0.21942377090454102,490.146916750478,63,-12,490,1099,1013,1133,468,27,49.98
-5,18,0,-5.0,18.0,0.22629070281982422,472.0519039258289,63,-7,472,1099,1013,1133,468,27,51.96
-4,17,0,-4.0,17.0,0.23304486274719238,455.00989000240423,63,-3,455,1099,1013,1133,468,27,49.19
-3,17,0,-3.0,17.0,0.24346375465393066,438.0,63,0,438,1099,1013,1133,468,27,48.27
-3,16,0,-3.0,16.0,0.24907779693603516,422.01066337238444,63,3,422,1099,1013,1133,468,27,45.34
-3,14,0,-3.0,14.0,0.25704479217529297,408.0441152620633,63,6,408,1099,1013,1133,468,27,40.7
-2,15,0,-2.0,15.0,0.26505374908447266,393.0814165029937,63,8,393,1099,1013,1133,468,27,41.92
-1,14,0,-1.0,14.0,0.27347588539123535,379.1068450977903,63,9,379,1099,1013,1133,468,27,39.93
0,13,0,-0.0,13.0,0.2814188003540039,366.1106390150387,63,9,366,1099,1013,1133,468,27,38.91
0,13,0,-0.0,13.0,0.289104700088501,353.1147122395214,63,9,353,1099,1013,1133,468,27,38.02
0,13,0,-0.0,13.0,0.2973928451538086,340.1190967881692,63,9,340,1099,1013,1133,468,27,37.11
2,14,0,2.0,14.0,0.30570077896118164,326.0751447136074,63,7,326,1099,1013,1133,468,27,36.02
1,15,0,1.0,15.0,0.3135697841644287,311.05787242890995,63,6,311,1099,1013,1133,468,27,37.46
2,15,0,2.0,15.0,0.32109880447387695,296.0270257932542,63,4,296,1099,1013,1133,468,27,35.17
2,13,0,2.0,13.0,0.329042911529541,283.0070670495703,63,2,283,1099,1013,1133,468,27,31.12
2,11,0,2.0,11.0,0.3391287326812744,272.0,63,0,272,1099,1013,1133,468,27,27.08
3,12,0,3.0,12.0,0.345247745513916,260.0173071162764,63,-3,260,1099,1013,1133,468,27,27.21
2,11,0,2.0,11.0,0.35305285453796387,249.0501957437496,63,-5,249,1099,1013,1133,468,27,25.34
3,9,0,3.0,9.0,0.3637537956237793,240.13329631685815,63,-8,240,1099,1013,1133,468,27,20.88
1,10,0,1.0,10.0,0.3690657615661621,230.17601960239037,63,-9,230,1099,1013,1133,468,27,23.11
2,10,0,2.0,10.0,0.377072811126709,220.27482833950864,63,-11,220,1099,1013,1133,468,27,21.59
2,11,0,2.0,11.0,0.3850438594818115,209.40391591371923,63,-13,209,1099,1013,1133,468,27,22.16
1,12,0,1.0,12.0,0.39449572563171387,197.4968354176846,63,-14,197,1099,1013,1133,468,27,23.13
0,12,0,-0.0,12.0,0.4011037349700928,185.52897347853784,63,-14,185,1099,1013,1133,468,27,23.18
0,10,0,-0.0,10.0,0.4091176986694336,175.55910685578235,63,-14,175,1099,1013,1133,468,27,20.1
0,10,0,-0.0,10.0,0.41932082176208496,165.59287424282482,63,-14,165,1099,1013,1133,468,27,19.3
-1,10,0,-1.0,10.0,0.42515087127685547,155.54420593516173,63,-13,155,1099,1013,1133,468,27,20.47
-1,10,0,-1.0,10.0,0.4344358444213867,145.49570440394453,63,-12,145,1099,1013,1133,468,27,19.66
-1,10,0,-1.0,10.0,0.44266486167907715,135.44740676735012,63,-11,135,1099,1013,1133,468,27,18.83
-2,9,0,-2.0,9.0,0.4493129253387451,126.3210196285638,63,-9,126,1099,1013,1133,468,27,14.83
-1,8,0,-1.0,8.0,0.46320271492004395,118.27087553578015,63,-8,118,1099,1013,1133,468,27,14.48
-2,8,0,-2.0,8.0,0.4650537967681885,110.16351483136329,63,-6,110,1099,1013,1133,468,27,12.39
-2,8,0,-2.0,8.0,0.4760777950286865,102.07840124139877,63,-4,102,1099,1013,1133,468,27,11.7
-2,7,0,-2.0,7.0,0.4815819263458252,95.02105029939419,63,-2,95,1099,1013,1133,468,27,10.04
-1,7,0,-1.0,7.0,0.48959970474243164,88.0056816347672,63,-1,88,1099,1013,1133,468,27,10.48
-2,7,0,-2.0,7.0,0.4973948001861572,81.00617260431454,63,1,81,1099,1013,1133,468,27,8.9
-1,6,0,-1.0,6.0,0.5055327415466309,75.02666192761077,63,2,75,1099,1013,1133,468,27,8.35
-1,5,0,-1.0,5.0,0.5130329132080078,70.06425622241343,63,3,70,1099,1013,1133,468,27,7.0
-1,4,0,-1.0,4.0,0.5211148262023926,66.12110101926616,63,4,66,1099,1013,1133,468,27,5.72
0,4,0,-0.0,4.0,0.5290489196777344,62.12889826803627,63,4,62,1099,1013,1133,468,27,7.65
0,3,0,-0.0,3.0,0.5394947528839111,59.135437767890075,63,4,59,1099,1013,1133,468,27,6.74
0,3,0,-0.0,3.0,0.5450599193572998,56.142675390472796,63,4,56,1099,1013,1133,468,27,6.57
0,3,0,-0.0,3.0,0.5532448291778564,53.150729063673246,63,4,53,1099,1013,1133,468,27,6.39
0,3,0,-0.0,3.0,0.5610687732696533,50.15974481593781,63,4,50,1099,1013,1133,468,27,6.2
0,2,0,-0.0,2.0,0.5690748691558838,48.16637831516918,63,4,48,1099,1013,1133,468,27,5.45
0,3,0,-0.0,3.0,0.5771288871765137,45.17742799230607,63,4,45,1099,1013,1133,468,27,5.87
-1,2,0,-1.0,2.0,0.5858418941497803,43.289721643826724,63,5,43,1099,1013,1133,468,27,2.58
0,3,0,-0.0,3.0,0.5932826995849609,40.311288741492746,63,5,40,1099,1013,1133,468,27,5.23
0,3,0,-0.0,3.0,0.6023168563842773,37.33630940518894,63,5,37,1099,1013,1133,468,27,4.99
0,2,0,-0.0,2.0,0.6104228496551514,35.35533905932738,63,5,35,1099,1013,1133,468,27,4.37
-1,2,0,-1.0,2.0,0.6198089122772217,33.54101966249684,63,6,33,1099,1013,1133,468,27,2.08
0,2,0,-0.0,2.0,0.625053882598877,31.575306807693888,63,6,31,1099,1013,1133,468,27,3.83
-1,1,0,-1.0,1.0,0.6346917152404785,30.805843601498726,63,7,30,1099,1013,1133,468,27,0.89
0,2,0,-0.0,2.0,0.6446318626403809,28.861739379323623,63,7,28,1099,1013,1133,468,27,3.38
0,1,0,-0.0,1.0,0.6533317565917969,27.892651361962706,63,7,27,1099,1013,1133,468,27,2.97
0,1,0,-0.0,1.0,0.6669328212738037,26.92582403567252,63,7,26,1099,1013,1133,468,27,2.9
0,0,1,-0.0,-0.0,0.7230799198150635,26.92582403567252,63,7,26,1099,1013,1133,468,27,35.010000000000005
0,0,0,-0.0,-0.0,0.808093786239624,26.92582403567252,63,7,26,1099,1013,1133,468,27,25.01
0,1,0,-0.0,1.0,0.8237159252166748,25.96150997149434,63,7,25,1099,1013,1133,468,27,2.82
0,1,0,-0.0,1.0,0.8250157833099365,25.0,63,7,24,1099,1013,1133,468,27,2.74
1,1,0,1.0,1.0,0.8349587917327881,23.769728648009426,63,6,23,1099,1013,1133,468,27,1.87
0,1,0,-0.0,1.0,0.8436517715454102,22.80350850198276,63,6,22,1099,1013,1133,468,27,2.78
1,1,0,1.0,1.0,0.8523778915405273,21.587033144922902,63,5,21,1099,1013,1133,468,27,1.74
0,1,0,-0.0,1.0,0.8594439029693604,20.615528128088304,63,5,20,1099,1013,1133,468,27,2.83
1,1,0,1.0,1.0,0.8659417629241943,19.4164878389476,63,4,19,1099,1013,1133,468,27,1.59
0,1,0,-0.0,1.0,0.8731489181518555,18.439088914585774,63,4,18,1099,1013,1133,468,27,2.93
0,1,0,-0.0,1.0,0.8970768451690674,17.46424919657298,63,4,17,1099,1013,1133,468,27,2.82
1,0,0,1.0,-0.0,0.921130895614624,17.26267650163207,63,3,17,1099,1013,1133,468,27,-0.02
0,1,0,-0.0,1.0,0.9290907382965088,16.278820596099706,63,3,16,1099,1013,1133,468,27,3.08
0,1,0,-0.0,1.0,0.9374978542327881,15.297058540778355,63,3,15,1099,1013,1133,468,27,2.95
1,1,0,1.0,1.0,0.9454498291015625,14.142135623730951,63,2,14,1099,1013,1133,468,27,1.18
0,1,0,-0.0,1.0,0.9537277221679688,13.152946437965905,63,2,13,1099,1013,1133,468,27,3.21
1,1,0,1.0,1.0,0.9611477851867676,12.041594578792296,63,1,12,1099,1013,1133,468,27,0.92
0,0,1,-0.0,-0.0,0.9660847187042236,12.041594578792296,63,1,12,1099,1013,1133,468,27,30.49
0,1,1,-0.0,1.0,0.9773297309875488,11.045361017187261,63,1,11,1099,1013,1133,468,27,13.79
0,0,0,-0.0,-0.0,1.088075876235962,11.045361017187261,63,1,11,1099,1013,1133,468,27,20.19
0,-1,0,-0.0,-1.0,1.1855556964874268,12.041594578792296,63,1,12,1099,1013,1133,468,27,3.75
0,0,1,-0.0,-0.0,1.2350828647613525,12.041594578792296,63,1,12,1099,1013,1133,468,27,30.49
0,0,0,-0.0,-0.0,0.08538627624511719,581.3105882400561,64,-569,-119,529,882,1098,1001,8,148.81
0,-1,0,-0.0,-1.0,0.16239333152770996,581.106702766368,64,-569,-118,529,882,1098,1001,8,3.85
0,-1,0,-0.0,-1.0,0.1703932285308838,580.9044671888829,64,-569,-117,529,882,1098,1001,8,3.82
0,-1,0,-0.0,-1.0,0.1785292625427246,580.7038832313764,64,-569,-116,529,882,1098,1001,8,3.79
0,-2,0,-0.0,-2.0,0.18636822700500488,580.3076770128067,64,-569,-114,529,882,1098,1001,8,7.0
0,-2,0,-0.0,-2.0,0.19466233253479004,579.9180976655238,64,-569,-112,529,882,1098,1001,8,6.88
0,-2,0,-0.0,-2.0,0.20236921310424805,579.5351585538189,64,-569,-110,529,882,1098,1001,8,6.77
-2,-3,0,-2.0,-3.0,0.2103722095489502,577.0077989074324,64,-567,-107,529,882,1098,1001,8,35.0
-2,-3,0,-2.0,-3.0,0.21854233741760254,574.4919494649164,64,-565,-104,529,882,1098,1001,8,34.77
-4,-4,0,-4.0,-4.0,0.22642040252685547,569.8429608234185,64,-561,-100,529,882,1098,1001,8,52.94
-4,-3,0,-4.0,-3.0,0.23473525047302246,565.3830559894769,64,-557,-97,529,882,1098,1001,8,51.7
-5,-3,0,-5.0,-3.0,0.2425093650817871,559.9464260087746,64,-552,-94,529,882,1098,1001,8,58.17
-5,-3,0,-5.0,-3.0,0.25124526023864746,554.5178085508165,64,-547,-91,529,882,1098,1001,8,57.75
-4,-1,0,-4.0,-1.0,0.25991034507751465,550.4080304646726,64,-543,-90,529,882,1098,1001,8,50.62
-4,-1,0,-4.0,-1.0,0.266376256942749,546.2984532286358,64,-539,-89,529,882,1098,1001,8,50.38
-5,-1,0,-5.0,-1.0,0.27562522888183594,541.2023651093923,64,-534,-88,529,882,1098,1001,8,57.79
-6,-1,0,-6.0,-1.0,0.282346248626709,535.1196127969895,64,-528,-87,529,882,1098,1001,8,64.64
-8,-1,0,-8.0,-1.0,0.2904503345489502,527.0635635291061,64,-520,-86,529,882,1098,1001,8,71.69
-9,0,0,-9.0,-0.0,0.29840826988220215,518.1862599490651,64,-511,-86,529,882,1098,1001,8,72.38
-11,-1,0,-11.0,-1.0,0.30683231353759766,507.17354031928755,64,-500,-85,529,882,1098,1001,8,79.24
-12,-1,0,-12.0,-1.0,0.31548428535461426,495.17673612559787,64,-488,-84,529,882,1098,1001,8,80.53
-12,0,0,-12.0,-0.0,0.3288142681121826,483.35494204569795,64,-476,-84,529,882,1098,1001,8,77.95
-14,0,0,-14.0,-0.0,0.3307614326477051,469.5742752749558,64,-462,-84,529,882,1098,1001,8,80.9
-15,0,0,-15.0,-0.0,0.3383803367614746,454.82414183945866,64,-447,-84,529,882,1098,1001,8,81.04
-14,-1,0,-14.0,-1.0,0.34804534912109375,440.883204488445,64,-433,-83,529,882,1098,1001,8,78.48
-15,0,0,-15.0,-0.0,0.3591623306274414,426.16076778605515,64,-418,-83,529,882,1098,1001,8,77.5
-17,-1,0,-17.0,-1.0,0.3658602237701416,409.2981798151563,64,-401,-82,529,882,1098,1001,8,79.22
-18,-1,0,-18.0,-1.0,0.3704242706298828,391.47158262126766,64,-383,-81,529,882,1098,1001,8,78.09
-20,-2,0,-20.0,-2.0,0.3784053325653076,371.4969717238621,64,-363,-79,529,882,1098,1001,8,78.21
-23,-3,0,-23.0,-3.0,0.3870983123779297,348.3905854066668,64,-340,-76,529,882,1098,1001,8,78.01
-23,-4,0,-23.0,-4.0,0.3949143886566162,325.07383776612966,64,-317,-72,529,882,1098,1001,8,75.27
-24,-4,0,-24.0,-4.0,0.40251922607421875,300.7873002638243,64,-293,-68,529,882,1098,1001,8,71.82
-21,-5,0,-21.0,-5.0,0.4103832244873047,279.20064469839605,64,-272,-63,529,882,1098,1001,8,68.48
-20,-5,0,-20.0,-5.0,0.4211733341217041,258.58847615468096,64,-252,-58,529,882,1098,1001,8,63.53
-19,-5,0,-19.0,-5.0,0.4263792037963867,238.9518780005715,64,-233,-53,529,882,1098,1001,8,58.89
-18,-5,0,-18.0,-5.0,0.43468141555786133,220.29298672449835,64,-215,-48,529,882,1098,1001,8,54.47
-15,-4,0,-15.0,-4.0,0.44603633880615234,204.78281177872327,64,-200,-44,529,882,1098,1001,8,49.31
-14,-4,0,-14.0,-4.0,0.450695276260376,190.25246384738358,64,-186,-40,529,882,1098,1001,8,45.47
-12,-4,0,-12.0,-4.0,0.4584372043609619,177.68511473953018,64,-174,-36,529,882,1098,1001,8,40.63
-11,-3,0,-11.0,-3.0,0.4663994312286377,166.30694513459142,64,-163,-33,529,882,1098,1001,8,38.18
-11,-4,0,-11.0,-4.0,0.4751613140106201,154.74172029546526,64,-152,-29,529,882,1098,1001,8,35.42
-11,-3,0,-11.0,-3.0,0.4859154224395752,143.37712509323097,64,-141,-26,529,882,1098,1001,8,34.23
-12,-3,0,-12.0,-3.0,0.49034929275512695,131.03434664239754,64,-129,-23,529,882,1098,1001,8,33.4
-10,-4,0,-10.0,-4.0,0.5027523040771484,120.50726119201282,64,-119,-19,529,882,1098,1001,8,28.32
-9,-2,0,-9.0,-2.0,0.5069482326507568,111.30588483993108,64,-110,-17,529,882,1098,1001,8,27.05
-10,-3,0,-10.0,-3.0,0.5154523849487305,100.9752444909147,64,-100,-14,529,882,1098,1001,8,25.41
-8,-3,0,-8.0,-3.0,0.5232243537902832,92.65527507918802,64,-92,-11,529,882,1098,1001,8,21.45
-7,-3,0,-7.0,-3.0,0.530388355255127,85.37564055396598,64,-85,-8,529,882,1098,1001,8,18.82
-7,-3,0,-7.0,-3.0,0.5397353172302246,78.16009211867653,64,-78,-5,529,882,1098,1001,8,17.55
-7,-2,0,-7.0,-2.0,0.5467202663421631,71.06335201775947,64,-71,-3,529,882,1098,1001,8,16.9
-7,-3,0,-7.0,-3.0,0.5547232627868652,64.0,64,-64,0,529,882,1098,1001,8,15.03
-5,-3,0,-5.0,-3.0,0.5623962879180908,59.07622195096772,64,-59,3,529,882,1098,1001,8,11.45
-5,-2,0,-5.0,-2.0,0.5717263221740723,54.230987451824994,64,-54,5,529,882,1098,1001,8,11.09
-3,-2,0,-3.0,-2.0,0.5786693096160889,51.478150704935004,64,-51,7,529,882,1098,1001,8,7.24
-3,-1,0,-3.0,-1.0,0.5890243053436279,48.662100242385755,64,-48,8,529,882,1098,1001,8,7.71
-3,-1,0,-3.0,-1.0,0.5947732925415039,45.89117562233506,64,-45,9,529,882,1098,1001,8,7.3
-2,-1,0,-2.0,-1.0,0.6023893356323242,44.14748010928823,64,-43,10,529,882,1098,1001,8,5.05
-3,-2,0,-3.0,-2.0,0.6112864017486572,41.7612260356422,64,-40,12,529,882,1098,1001,8,5.52
-3,-1,0,-3.0,-1.0,0.6190602779388428,39.21734310225516,64,-37,13,529,882,1098,1001,8,6.01
-3,-1,0,-3.0,-1.0,0.6273193359375,36.76955262170047,64,-34,14,529,882,1098,1001,8,5.54
-3,0,0,-3.0,-0.0,0.6344103813171387,34.0147027033899,64,-31,14,529,882,1098,1001,8,6.49
-4,-1,0,-4.0,-1.0,0.6559994220733643,30.886890422961002,64,-27,15,529,882,1098,1001,8,5.71
-2,0,0,-2.0,-0.0,0.6562561988830566,29.154759474226502,64,-25,15,529,882,1098,1001,8,4.42
-3,-1,0,-3.0,-1.0,0.6583702564239502,27.202941017470888,64,-22,16,529,882,1098,1001,8,3.6
-3,0,0,-3.0,-0.0,0.666541337966919,24.839484696748443,64,-19,16,529,882,1098,1001,8,4.41
-3,0,0,-3.0,-0.0,0.6751492023468018,22.627416997969522,64,-16,16,529,882,1098,1001,8,3.85
-4,0,0,-4.0,-0.0,0.6850724220275879,20.0,64,-12,16,529,882,1098,1001,8,3.67
-4,-1,0,-4.0,-1.0,0.6909663677215576,18.788294228055936,64,-8,17,529,882,1098,1001,8,1.2
-4,0,0,-4.0,-0.0,0.6984124183654785,17.46424919657298,64,-4,17,529,882,1098,1001,8,1.31
-3,0,0,-3.0,-0.0,0.7065072059631348,17.029386365926403,64,-1,17,529,882,1098,1001,8,-0.03
-3,0,0,-3.0,-0.0,0.7143673896789551,17.11724276862369,64,2,17,529,882,1098,1001,8,8.12
-2,0,0,-2.0,-0.0,0.7227663993835449,17.46424919657298,64,4,17,529,882,1098,1001,8,3.52
-1,0,0,-1.0,-0.0,0.7309343814849854,17.72004514666935,64,5,17,529,882,1098,1001,8,4.98
-1,0,0,-1.0,-0.0,0.7386672496795654,18.027756377319946,64,6,17,529,882,1098,1001,8,4.45
-1,0,0,-1.0,-0.0,0.7465991973876953,18.384776310850235,64,7,17,529,882,1098,1001,8,4.07
-1,0,0,-1.0,-0.0,0.7623462677001953,18.788294228055936,64,8,17,529,882,1098,1001,8,3.8
-1,1,0,-1.0,1.0,0.7703614234924316,18.35755975068582,64,9,16,529,882,1098,1001,8,0.63
-1,1,0,-1.0,1.0,0.7788162231445312,18.027756377319946,64,10,15,529,882,1098,1001,8,0.37
-2,1,0,-2.0,1.0,0.7863583564758301,18.439088914585774,64,12,14,529,882,1098,1001,8,3.06
-1,1,0,-1.0,1.0,0.7952253818511963,18.384776310850235,64,13,13,529,882,1098,1001,8,-0.28
-1,2,0,-1.0,2.0,0.8029742240905762,17.804493814764857,64,14,11,529,882,1098,1001,8,0.56
-1,2,0,-1.0,2.0,0.8104023933410645,17.4928556845359,64,15,9,529,882,1098,1001,8,-0.02
-1,2,0,-1.0,2.0,0.8186612129211426,17.46424919657298,64,16,7,529,882,1098,1001,8,-0.62
-1,1,0,-1.0,1.0,0.8263723850250244,18.027756377319946,64,17,6,529,882,1098,1001,8,2.69
-1,1,0,-1.0,1.0,0.8345084190368652,18.681541692269406,64,18,5,529,882,1098,1001,8,2.48
0,1,0,-0.0,1.0,0.8423933982849121,18.439088914585774,64,18,4,529,882,1098,1001,8,0.39
0,1,0,-0.0,1.0,0.8531363010406494,18.24828759089466,64,18,3,529,882,1098,1001,8,0.24
1,1,0,1.0,1.0,0.8663833141326904,17.11724276862369,64,17,2,529,882,1098,1001,8,2.55
1,0,0,1.0,-0.0,0.8747682571411133,16.1245154965971,64,16,2,529,882,1098,1001,8,4.74
0,1,0,-0.0,1.0,0.8834133148193359,16.0312195418814,64,16,1,529,882,1098,1001,8,-0.08
1,0,0,1.0,-0.0,0.8903853893280029,15.033296378372908,64,15,1,529,882,1098,1001,8,5.48
0,1,0,-0.0,1.0,0.898402214050293,15.0,64,15,0,529,882,1098,1001,8,-0.26
1,0,0,1.0,-0.0,0.9064114093780518,14.0,64,14,0,529,882,1098,1001,8,8.25
1,0,0,1.0,-0.0,0.914893388748169,13.0,64,13,0,529,882,1098,1001,8,8.21
1,1,0,1.0,1.0,0.9224212169647217,12.041594578792296,64,12,-1,529,882,1098,1001,8,1.58
2,0,0,2.0,-0.0,0.9324114322662354,10.04987562112089,64,10,-1,529,882,1098,1001,8,5.36
1,1,0,1.0,1.0,0.9384152889251709,9.219544457292887,64,9,-2,529,882,1098,1001,8,0.96
2,0,0,2.0,-0.0,0.9472012519836426,7.280109889280518,64,7,-2,529,882,1098,1001,8,3.49
1,0,0,1.0,-0.0,0.954681396484375,6.324555320336759,64,6,-2,529,882,1098,1001,8,2.55
2,0,0,2.0,-0.0,0.9623782634735107,4.47213595499958,64,4,-2,529,882,1098,1001,8,2.17
1,0,0,1.0,-0.0,0.9712324142456055,3.605551275463989,64,3,-2,529,882,1098,1001,8,1.13
1,0,0,1.0,-0.0,0.978384256362915,2.8284271247461903,64,2,-2,529,882,1098,1001,8,0.42
1,0,0,1.0,-0.0,1.0585603713989258,2.23606797749979,64,1,-2,529,882,1098,1001,8,-0.45
0,0,1,-0.0,-0.0,1.081423282623291,2.23606797749979,64,1,-2,529,882,1098,1001,8,27.58
0,0,0,-0.0,-0.0,0.1422734260559082,839.5600038115203,65,-235,-806,293,78,528,884,24,185.87
0,-3,0,-0.0,-3.0,0.26226139068603516,836.6803451737109,65,-235,-803,293,78,528,884,24,21.65
1,-5,0,1.0,-5.0,0.2693483829498291,832.1658488546619,65,-236,-798,293,78,528,884,24,29.95
2,-5,0,2.0,-5.0,0.2773754596710205,827.9450464855744,65,-238,-793,293,78,528,884,24,27.85
1,-6,0,1.0,-6.0,0.2853124141693115,822.4901215212253,65,-239,-787,293,78,528,884,24,34.56
2,-9,0,2.0,-9.0,0.29393625259399414,814.4722217485382,65,-241,-778,293,78,528,884,24,45.63
2,-12,0,2.0,-12.0,0.30139636993408203,803.6199350439236,65,-243,-766,293,78,528,884,24,56.0
1,-16,0,1.0,-16.0,0.3131682872772217,788.6925890358042,65,-244,-750,293,78,528,884,24,68.07
0,-20,0,-0.0,-20.0,0.31740641593933105,769.6986423269824,65,-244,-730,293,78,528,884,24,77.15
0,-22,0,-0.0,-22.0,0.3252534866333008,748.8658090739622,65,-244,-708,293,78,528,884,24,79.64
-7,-30,0,-7.0,-30.0,0.333301305770874,718.2290720932981,65,-237,-678,293,78,528,884,24,94.67
-12,-39,0,-12.0,-39.0,0.3417503833770752,677.4555335961173,65,-225,-639,293,78,528,884,24,103.23
-15,-37,0,-15.0,-37.0,0.34976840019226074,637.5766620571992,65,-210,-602,293,78,528,884,24,98.44
-17,-34,0,-17.0,-34.0,0.3575584888458252,599.8941573311079,65,-193,-568,293,78,528,884,24,91.59
-18,-32,0,-18.0,-32.0,0.36844348907470703,563.8448368123983,65,-175,-536,293,78,528,884,24,86.1
-17,-31,0,-17.0,-31.0,0.37329745292663574,529.1398680878242,65,-158,-505,293,78,528,884,24,81.42
-15,-30,0,-15.0,-30.0,0.381258487701416,496.05846429629645,65,-143,-475,293,78,528,884,24,76.8
-15,-28,0,-15.0,-28.0,0.3905212879180908,464.9655901246887,65,-128,-447,293,78,528,884,24,71.47
-14,-27,0,-14.0,-27.0,0.4033684730529785,435.19650733892615,65,-114,-420,293,78,528,884,24,67.16
-12,-24,0,-12.0,-24.0,0.408705472946167,408.9254210733297,65,-102,-396,293,78,528,884,24,60.99
-12,-23,0,-12.0,-23.0,0.4134693145751953,383.7043132413291,65,-90,-373,293,78,528,884,24,57.16
-11,-22,0,-11.0,-22.0,0.4212663173675537,359.78048863160996,65,-79,-351,293,78,528,884,24,53.38
-9,-19,0,-9.0,-19.0,0.42929840087890625,339.29927792437167,65,-70,-332,293,78,528,884,24,47.58
-8,-17,0,-8.0,-17.0,0.43818044662475586,321.04361074470864,65,-62,-315,293,78,528,884,24,43.1
-6,-15,0,-6.0,-15.0,0.44701147079467773,305.1819129633996,65,-56,-300,293,78,528,884,24,38.88
-4,-14,0,-4.0,-14.0,0.45372843742370605,290.68883707497264,65,-52,-286,293,78,528,884,24,36.67
-2,-12,0,-2.0,-12.0,0.46170830726623535,278.52468472291645,65,-50,-274,293,78,528,884,24,34.26
-2,-11,0,-2.0,-11.0,0.47218847274780273,267.3443472377899,65,-48,-263,293,78,528,884,24,32.95
0,-10,0,-0.0,-10.0,0.4808642864227295,257.51310646256434,65,-48,-253,293,78,528,884,24,26.18
-1,-10,0,-1.0,-10.0,0.48683643341064453,247.50353532828578,65,-47,-243,293,78,528,884,24,26.72
0,-10,0,-0.0,-10.0,0.4979133605957031,237.6930794112441,65,-47,-233,293,78,528,884,24,24.7
-1,-9,0,-1.0,-9.0,0.5033552646636963,228.67444107289296,65,-46,-224,293,78,528,884,24,23.86
-1,-10,0,-1.0,-10.0,0.5097923278808594,218.68013169924697,65,-45,-214,293,78,528,884,24,24.44
-1,-8,0,-1.0,-8.0,0.5174024105072021,210.64662351910604,65,-44,-206,293,78,528,884,24,21.2
-1,-9,0,-1.0,-9.0,0.5254333019256592,201.6382900145704,65,-43,-197,293,78,528,884,24,21.84
-1,-7,0,-1.0,-7.0,0.5332484245300293,194.58674158328466,65,-42,-190,293,78,528,884,24,18.82
-1,-8,0,-1.0,-8.0,0.5430243015289307,186.560981987124,65,-41,-182,293,78,528,884,24,19.5
0,-8,0,-0.0,-8.0,0.5492603778839111,178.76520914316635,65,-41,-174,293,78,528,884,24,17.5
-1,-7,0,-1.0,-7.0,0.557659387588501,171.72361514946044,65,-40,-167,293,78,528,884,24,17.19
0,-6,0,-0.0,-6.0,0.5691454410552979,165.89454481688057,65,-40,-161,293,78,528,884,24,13.78
0,-5,0,-0.0,-5.0,0.5745363235473633,161.04657711357916,65,-40,-156,293,78,528,884,24,11.98
0,-5,0,-0.0,-5.0,0.5813934803009033,156.20819440733575,65,-40,-151,293,78,528,884,24,11.69
0,-5,0,-0.0,-5.0,0.5894162654876709,151.38031576133008,65,-40,-146,293,78,528,884,24,11.41
1,-4,0,1.0,-4.0,0.5981144905090332,147.80054127099805,65,-41,-142,293,78,528,884,24,8.34
0,-4,0,-0.0,-4.0,0.6058542728424072,143.96180048887967,65,-41,-138,293,78,528,884,24,9.46
1,-3,0,1.0,-3.0,0.6161954402923584,141.38246001537814,65,-42,-135,293,78,528,884,24,6.24
0,-4,0,-0.0,-4.0,0.6216902732849121,137.56816492197603,65,-42,-131,293,78,528,884,24,9.08
0,-4,0,-0.0,-4.0,0.6312253475189209,133.76471881628578,65,-42,-127,293,78,528,884,24,8.87
0,-4,0,-0.0,-4.0,0.6378684043884277,129.9730741346068,65,-42,-123,293,78,528,884,24,8.66
0,-4,0,-0.0,-4.0,0.6452562808990479,126.19429464123962,65,-42,-119,293,78,528,884,24,8.45
0,-4,0,-0.0,-4.0,0.6535992622375488,122.42957159118053,65,-42,-115,293,78,528,884,24,8.23
0,-4,0,-0.0,-4.0,0.6614212989807129,118.68024266911489,65,-42,-111,293,78,528,884,24,8.01
0,-3,0,-0.0,-3.0,0.669243335723877,115.8792474949678,65,-42,-108,293,78,528,884,24,6.57
0,-3,0,-0.0,-3.0,0.6778254508972168,113.08846094982458,65,-42,-105,293,78,528,884,24,6.43
-1,-2,0,-1.0,-2.0,0.685326337814331,110.86027241532469,65,-41,-103,293,78,528,884,24,7.58
-1,-3,0,-1.0,-3.0,0.6934993267059326,107.70329614269008,65,-40,-100,293,78,528,884,24,9.2
-1,-3,0,-1.0,-3.0,0.7015573978424072,104.546640309481,65,-39,-97,293,78,528,884,24,9.05
-2,-3,0,-2.0,-3.0,0.7094254493713379,101.01980003939822,65,-37,-94,293,78,528,884,24,7.76
-2,-3,0,-2.0,-3.0,0.717273473739624,97.49871794028884,65,-35,-91,293,78,528,884,24,7.56
-1,-3,0,-1.0,-3.0,0.7254464626312256,94.33981132056604,65,-34,-88,293,78,528,884,24,8.98
-2,-3,0,-2.0,-3.0,0.733431339263916,90.82400563727631,65,-32,-85,293,78,528,884,24,7.24
-1,-3,0,-1.0,-3.0,0.7472703456878662,87.66413177577246,65,-31,-82,293,78,528,884,24,8.92
-2,-4,0,-2.0,-4.0,0.7501533031463623,83.21658488546619,65,-29,-78,293,78,528,884,24,8.86
-1,-3,0,-1.0,-3.0,0.7577733993530273,80.05623023850174,65,-28,-75,293,78,528,884,24,8.75
-1,-3,0,-1.0,-3.0,0.7653822898864746,76.89603370785778,65,-27,-72,293,78,528,884,24,8.59
-1,-3,0,-1.0,-3.0,0.7764523029327393,73.7360156233031,65,-26,-69,293,78,528,884,24,8.42
-2,-3,0,-2.0,-3.0,0.7812492847442627,70.22819946431775,65,-24,-66,293,78,528,884,24,6.3
-1,-3,0,-1.0,-3.0,0.7893452644348145,67.06713054842886,65,-23,-63,293,78,528,884,24,8.49
-1,-4,0,-1.0,-4.0,0.7975172996520996,62.96824596572466,65,-22,-59,293,78,528,884,24,7.47
-2,-3,0,-2.0,-3.0,0.806281328201294,59.464274989274024,65,-20,-56,293,78,528,884,24,5.78
-1,-4,0,-1.0,-4.0,0.8150522708892822,55.362442142665635,65,-19,-52,293,78,528,884,24,7.16
-1,-3,0,-1.0,-3.0,0.8226273059844971,52.20153254455275,65,-18,-49,293,78,528,884,24,7.82
-2,-4,0,-2.0,-4.0,0.8297243118286133,47.75981574503821,65,-16,-45,293,78,528,884,24,6.77
-1,-3,0,-1.0,-3.0,0.8373093605041504,44.598206241955516,65,-15,-42,293,78,528,884,24,7.85
0,-3,0,-0.0,-3.0,0.8467004299163818,41.78516483155236,65,-15,-39,293,78,528,884,24,3.94
-1,-3,0,-1.0,-3.0,0.8532853126525879,38.62641583165593,65,-14,-36,293,78,528,884,24,6.68
0,-4,0,-0.0,-4.0,0.8613364696502686,34.92849839314596,65,-14,-32,293,78,528,884,24,3.9
-1,-2,0,-1.0,-2.0,0.8693184852600098,32.69556544854363,65,-13,-30,293,78,528,884,24,5.79
-1,-3,0,-1.0,-3.0,0.8804404735565186,29.546573405388315,65,-12,-27,293,78,528,884,24,5.37
-1,-3,0,-1.0,-3.0,0.8858134746551514,26.40075756488817,65,-11,-24,293,78,528,884,24,5.04
0,-2,0,-0.0,-2.0,0.8934452533721924,24.596747752497688,65,-11,-22,293,78,528,884,24,2.39
-1,-2,0,-1.0,-2.0,0.9015612602233887,22.360679774997898,65,-10,-20,293,78,528,884,24,8.09
-1,-3,0,-1.0,-3.0,0.9109103679656982,19.235384061671343,65,-9,-17,293,78,528,884,24,4.0
0,-1,0,-0.0,-1.0,0.921241283416748,18.35755975068582,65,-9,-16,293,78,528,884,24,1.76
-1,-2,0,-1.0,-2.0,0.9261484146118164,16.1245154965971,65,-8,-14,293,78,528,884,24,4.99
0,-2,0,-0.0,-2.0,0.9332613945007324,14.422205101855956,65,-8,-12,293,78,528,884,24,1.48
-1,-1,0,-1.0,-1.0,0.9450962543487549,13.038404810405298,65,-7,-11,293,78,528,884,24,2.8
0,-2,0,-0.0,-2.0,0.950803279876709,11.40175425099138,65,-7,-9,293,78,528,884,24,1.06
0,-2,0,-0.0,-2.0,0.9609954357147217,9.899494936611665,65,-7,-7,293,78,528,884,24,0.64
0,-2,0,-0.0,-2.0,0.9652774333953857,8.602325267042627,65,-7,-5,293,78,528,884,24,0.17
-1,-2,0,-1.0,-2.0,0.9733104705810547,6.708203932499369,65,-6,-3,293,78,528,884,24,0.65
0,-2,0,-0.0,-2.0,0.9812824726104736,6.082762530298219,65,-6,-1,293,78,528,884,24,-0.93
0,-2,0,-0.0,-2.0,0.9893143177032471,6.082762530298219,65,-6,1,293,78,528,884,24,10.63
0,-1,0,-0.0,-1.0,0.9981613159179688,6.324555320336759,65,-6,2,293,78,528,884,24,1.01
0,-1,0,-0.0,-1.0,1.0166022777557373,6.708203932499369,65,-6,3,293,78,528,884,24,0.58
0,-1,0,-0.0,-1.0,1.0186612606048584,7.211102550927978,65,-6,4,293,78,528,884,24,0.51
0,0,1,-0.0,-0.0,1.0293233394622803,7.211102550927978,65,-6,4,293,78,528,884,24,29.05
0,0,0,-0.0,-0.0,0.08302950859069824,468.5402864215627,66,433,179,732,253,299,74,74,129.83
1,0,0,1.0,-0.0,0.15404343605041504,467.61629569552,66,432,179,732,253,299,74,74,3.58
4,3,0,4.0,3.0,0.16204452514648438,462.77424301704605,66,428,176,732,253,299,74,74,10.07
5,4,0,5.0,4.0,0.17188048362731934,456.63223714494796,66,423,172,732,253,299,74,74,11.63
8,5,0,8.0,5.0,0.17801642417907715,447.34103321738775,66,415,167,732,253,299,74,74,16.27
8,7,0,8.0,7.0,0.18611836433410645,437.32024878800206,66,407,160,732,253,299,74,74,16.03
10,8,0,10.0,8.0,0.19569158554077148,425.1035168050248,66,397,152,732,253,299,74,74,18.44
15,9,0,15.0,9.0,0.2054595947265625,407.8884651470301,66,382,143,732,253,299,74,74,23.86
19,11,0,19.0,11.0,0.21108055114746094,386.25509705374765,66,363,132,732,253,299,74,74,27.05
23,11,0,23.0,11.0,0.22041559219360352,360.8891796660022,66,340,121,732,253,299,74,74,29.51
26,11,0,26.0,11.0,0.22690248489379883,332.7100840070827,66,314,110,732,253,299,74,74,30.59
27,10,0,27.0,10.0,0.2352275848388672,303.92268753747226,66,287,100,732,253,299,74,74,30.57
26,9,0,26.0,9.0,0.25286245346069336,276.40911707105465,66,261,91,732,253,299,74,74,29.39
25,7,0,25.0,7.0,0.2533085346221924,250.50349298961882,66,236,84,732,253,299,74,74,24.12
24,5,0,24.0,5.0,0.2583765983581543,226.24102192131292,66,212,79,732,253,299,74,74,20.67
20,5,0,20.0,5.0,0.2667665481567383,205.7668583615933,66,192,74,732,253,299,74,74,17.7
18,3,0,18.0,3.0,0.2745513916015625,187.92817777012579,66,174,71,732,253,299,74,74,14.51
17,3,0,17.0,3.0,0.2821965217590332,171.09354166653983,66,157,68,732,253,299,74,74,13.05
14,2,0,14.0,2.0,0.2907114028930664,157.4960316960399,66,143,66,732,253,299,74,74,10.46
13,1,0,13.0,1.0,0.29948854446411133,145.34441853748632,66,130,65,732,253,299,74,74,8.81
12,2,0,12.0,2.0,0.30704736709594727,133.76471881628578,66,118,63,732,253,299,74,74,8.32
10,1,0,10.0,1.0,0.3140695095062256,124.53112060846478,66,108,62,732,253,299,74,74,6.53
8,0,0,8.0,-0.0,0.3256855010986328,117.66052864066182,66,100,62,732,253,299,74,74,4.84
8,1,0,8.0,1.0,0.33011436462402344,110.38568747804219,66,92,61,732,253,299,74,74,5.08
7,0,0,7.0,-0.0,0.33811259269714355,104.62313319720452,66,85,61,732,253,299,74,74,3.85
5,1,0,5.0,1.0,0.34603452682495117,100.0,66,80,60,732,253,299,74,74,3.79
4,0,0,4.0,-0.0,0.35410356521606445,96.82974749528164,66,76,60,732,253,299,74,74,2.56
6,0,0,6.0,-0.0,0.36217451095581055,92.19544457292888,66,70,60,732,253,299,74,74,2.92
6,0,0,6.0,-0.0,0.3700544834136963,87.72684879784524,66,64,60,732,253,299,74,74,2.67
6,1,0,6.0,1.0,0.3780324459075928,82.73451516749222,66,58,59,732,253,299,74,74,3.01
5,0,0,5.0,-0.0,0.387237548828125,79.30952023559341,66,53,59,732,253,299,74,74,1.98
3,0,0,3.0,-0.0,0.3940255641937256,77.33692520394123,66,50,59,732,253,299,74,74,1.48
2,1,0,2.0,1.0,0.4025084972381592,75.28612089887484,66,48,58,732,253,299,74,74,2.59
2,2,0,2.0,2.0,0.4122123718261719,72.47068372797375,66,46,56,732,253,299,74,74,4.74
3,1,0,3.0,1.0,0.4182264804840088,69.81403870282824,66,43,55,732,253,299,74,74,2.18
3,3,0,3.0,3.0,0.4260134696960449,65.60487786742691,66,40,52,732,253,299,74,74,4.62
4,2,0,4.0,2.0,0.43402957916259766,61.61168720299745,66,36,50,732,253,299,74,74,2.63
3,3,0,3.0,3.0,0.44437146186828613,57.42821606144492,66,33,47,732,253,299,74,74,4.03
3,2,0,3.0,2.0,0.45302343368530273,54.08326913195984,66,30,45,732,253,299,74,74,2.62
3,2,0,3.0,2.0,0.4590275287628174,50.774009099144415,66,27,43,732,253,299,74,74,2.45
3,3,0,3.0,3.0,0.4661555290222168,46.647615158762406,66,24,40,732,253,299,74,74,3.26
2,1,0,2.0,1.0,0.4740605354309082,44.77722635447622,66,22,39,732,253,299,74,74,1.62
2,2,0,2.0,2.0,0.48204541206359863,42.05948168962618,66,20,37,732,253,299,74,74,2.71
1,1,0,1.0,1.0,0.4900534152984619,40.70626487409524,66,19,36,732,253,299,74,74,2.51
1,1,0,1.0,1.0,0.4984705448150635,39.35733730830886,66,18,35,732,253,299,74,74,2.44
1,1,0,1.0,1.0,0.506352424621582,38.01315561749642,66,17,34,732,253,299,74,74,2.37
1,1,0,1.0,1.0,0.5140063762664795,36.6742416417845,66,16,33,732,253,299,74,74,2.3
1,0,0,1.0,-0.0,0.5301403999328613,36.24913792078372,66,15,33,732,253,299,74,74,0.45
1,1,0,1.0,1.0,0.5382354259490967,34.92849839314596,66,14,32,732,253,299,74,74,2.12
0,0,1,-0.0,-0.0,0.5480544567108154,34.92849839314596,66,14,32,732,253,299,74,74,37.46
0,0,0,-0.0,-0.0,0.646031379699707,34.92849839314596,66,14,32,732,253,299,74,74,27.46
0,0,1,-0.0,-0.0,0.80303955078125,34.92849839314596,66,14,32,732,253,299,74,74,37.46
0,0,0,-0.0,-0.0,0.07999873161315918,1380.026449021902,67,1053,892,1771,1113,718,221,42,245.62
1,3,0,1.0,3.0,0.21862363815307617,1377.3253065271108,67,1052,889,1771,1113,718,221,42,16.03
1,5,0,1.0,5.0,0.22600769996643066,1373.3379045231366,67,1051,884,1771,1113,718,221,42,21.96
3,5,0,3.0,5.0,0.2340087890625,1367.8249156964498,67,1048,879,1771,1113,718,221,42,29.86
4,6,0,4.0,6.0,0.2419886589050293,1360.905948256528,67,1044,873,1771,1113,718,221,42,36.0
6,6,0,6.0,6.0,0.25494980812072754,1352.4544354616905,67,1038,867,1771,1113,718,221,42,43.55
9,9,0,9.0,9.0,0.2603316307067871,1339.7779666795539,67,1029,858,1771,1113,718,221,42,58.43
14,11,0,14.0,11.0,0.2660987377166748,1321.9810891234413,67,1015,847,1771,1113,718,221,42,74.57
19,15,0,19.0,15.0,0.27439165115356445,1297.7827244958996,67,996,832,1771,1113,718,221,42,89.57
23,16,0,23.0,16.0,0.2823357582092285,1269.875978196296,67,973,816,1771,1113,718,221,42,94.9
29,20,0,29.0,20.0,0.29027676582336426,1234.808487175238,67,944,796,1771,1113,718,221,42,105.87
29,20,0,29.0,20.0,0.2980036735534668,1199.7503907063335,67,915,776,1771,1113,718,221,42,104.17
33,24,0,33.0,24.0,0.30663561820983887,1159.063415003683,67,882,752,1771,1113,718,221,42,110.53
35,22,0,35.0,22.0,0.31559181213378906,1118.1721692118795,67,847,730,1771,1113,718,221,42,107.76
35,22,0,35.0,22.0,0.32205867767333984,1077.3151813652307,67,812,708,1771,1113,718,221,42,105.43
37,24,0,37.0,24.0,0.3300027847290039,1033.67354614501,67,775,684,1771,1113,718,221,42,106.38
36,24,0,36.0,24.0,0.33807373046875,990.8183486391439,67,739,660,1771,1113,718,221,42,103.0
37,25,0,37.0,25.0,0.3470187187194824,946.5880835928582,67,702,635,1771,1113,718,221,42,101.82
36,28,0,36.0,28.0,0.35414981842041016,901.113200435994,67,666,607,1771,1113,718,221,42,101.0
34,26,0,34.0,26.0,0.3620448112487793,858.478304909332,67,632,581,1771,1113,718,221,42,95.09
35,28,0,35.0,28.0,0.37296271324157715,813.7677801436968,67,597,553,1771,1113,718,221,42,94.49
33,28,0,33.0,28.0,0.3780696392059326,770.5329324564915,67,564,525,1771,1113,718,221,42,90.6
33,30,0,33.0,30.0,0.38784074783325195,725.9380138827281,67,531,495,1771,1113,718,221,42,89.96
32,28,0,32.0,28.0,0.39394474029541016,683.4398290998265,67,499,467,1771,1113,718,221,42,84.01
31,26,0,31.0,26.0,0.40207362174987793,643.043544404265,67,468,441,1771,1113,718,221,42,78.43
30,23,0,30.0,23.0,0.4099726676940918,605.4485940193437,67,438,418,1771,1113,718,221,42,72.2
31,21,0,31.0,21.0,0.4185757637023926,568.5578246757317,67,407,397,1771,1113,718,221,42,68.09
27,20,0,27.0,20.0,0.42596864700317383,535.2840367505835,67,380,377,1771,1113,718,221,42,62.4
27,18,0,27.0,18.0,0.4339938163757324,503.47790418249735,67,353,359,1771,1113,718,221,42,58.1
25,15,0,25.0,15.0,0.44338369369506836,475.31042488041436,67,328,344,1771,1113,718,221,42,51.97
23,16,0,23.0,16.0,0.4501967430114746,447.89396066479844,67,305,328,1771,1113,718,221,42,49.53
20,14,0,20.0,14.0,0.45807576179504395,424.0530627173915,67,285,314,1771,1113,718,221,42,44.0
21,13,0,21.0,13.0,0.46901583671569824,400.37107787651195,67,264,301,1771,1113,718,221,42,41.78
19,14,0,19.0,14.0,0.4740276336669922,377.3512952144195,67,245,287,1771,1113,718,221,42,39.83
18,12,0,18.0,12.0,0.49628663063049316,356.58659537341,67,227,275,1771,1113,718,221,42,35.68
17,12,0,17.0,12.0,0.4969296455383301,336.55460181076114,67,210,263,1771,1113,718,221,42,33.59
15,10,0,15.0,10.0,0.49814462661743164,319.4276130831522,67,195,253,1771,1113,718,221,42,29.14
14,11,0,14.0,11.0,0.5084197521209717,302.2002647252315,67,181,242,1771,1113,718,221,42,28.47
13,10,0,13.0,10.0,0.5139918327331543,286.4402206394905,67,168,232,1771,1113,718,221,42,25.78
12,10,0,12.0,10.0,0.5220096111297607,271.3300573102803,67,156,222,1771,1113,718,221,42,24.29
12,9,0,12.0,9.0,0.5302467346191406,257.1089263327899,67,144,213,1771,1113,718,221,42,22.17
11,8,0,11.0,8.0,0.5380957126617432,244.36448187083164,67,133,205,1771,1113,718,221,42,19.75
10,9,0,10.0,9.0,0.5464878082275391,231.39792566053828,67,123,196,1771,1113,718,221,42,19.64
9,8,0,9.0,8.0,0.5544357299804688,219.8635940759634,67,114,188,1771,1113,718,221,42,17.44
7,7,0,7.0,7.0,0.5661227703094482,210.261741645978,67,107,181,1771,1113,718,221,42,15.19
6,8,0,6.0,8.0,0.577561616897583,200.32473636573192,67,101,173,1771,1113,718,221,42,16.11
4,6,0,4.0,6.0,0.5779786109924316,193.12690128513947,67,97,167,1771,1113,718,221,42,13.7
4,7,0,4.0,7.0,0.5862486362457275,185.06485349736184,67,93,160,1771,1113,718,221,42,16.18
3,6,0,3.0,6.0,0.5953776836395264,178.3704011320264,67,90,154,1771,1113,718,221,42,12.54
3,6,0,3.0,6.0,0.6050417423248291,171.67702234137218,67,87,148,1771,1113,718,221,42,12.24
3,5,0,3.0,5.0,0.6099896430969238,165.8463143998081,67,84,143,1771,1113,718,221,42,13.0
3,4,0,3.0,4.0,0.6179897785186768,160.87883639559305,67,81,139,1771,1113,718,221,42,9.44
4,5,0,4.0,5.0,0.6260907649993896,154.5477272560163,67,77,134,1771,1113,718,221,42,10.21
4,4,0,4.0,4.0,0.6339907646179199,149.093930124603,67,73,130,1771,1113,718,221,42,8.4
5,4,0,5.0,4.0,0.6426026821136475,143.17821063276352,67,68,126,1771,1113,718,221,42,8.08
4,4,0,4.0,4.0,0.6501896381378174,137.7679207943562,67,64,122,1771,1113,718,221,42,7.84
4,4,0,4.0,4.0,0.6582596302032471,132.3782459469833,67,60,118,1771,1113,718,221,42,7.58
3,4,0,3.0,4.0,0.6682066917419434,127.45587471748802,67,57,114,1771,1113,718,221,42,7.8
4,4,0,4.0,4.0,0.674203634262085,122.10241602851272,67,53,110,1771,1113,718,221,42,7.11
3,5,0,3.0,5.0,0.6848406791687012,116.29703349613007,67,50,105,1771,1113,718,221,42,8.95
4,5,0,4.0,5.0,0.690131664276123,110.07270324653611,67,46,100,1771,1113,718,221,42,7.77
5,6,0,5.0,6.0,0.6980326175689697,102.55242561733974,67,41,94,1771,1113,718,221,42,8.09
5,5,0,5.0,5.0,0.7126696109771729,96.00520819205592,67,36,89,1771,1113,718,221,42,6.68
6,5,0,6.0,5.0,0.7213437557220459,89.19641248391103,67,30,84,1771,1113,718,221,42,6.1
7,6,0,7.0,6.0,0.7270567417144775,81.32035415564789,67,23,78,1771,1113,718,221,42,6.17
7,4,0,7.0,4.0,0.7301816940307617,75.7099729229908,67,16,74,1771,1113,718,221,42,4.11
7,5,0,7.0,5.0,0.7382748126983643,69.58448102845921,67,9,69,1771,1113,718,221,42,4.13
6,5,0,6.0,5.0,0.7459497451782227,64.07027391856539,67,3,64,1771,1113,718,221,42,3.58
5,4,0,5.0,4.0,0.7541697025299072,60.03332407921454,67,-2,60,1771,1113,718,221,42,2.56
2,2,0,2.0,2.0,0.7644026279449463,58.137767414994535,67,-4,58,1771,1113,718,221,42,1.76
2,3,0,2.0,3.0,0.7699587345123291,55.326304774492215,67,-6,55,1771,1113,718,221,42,2.4
1,3,0,1.0,3.0,0.7779808044433594,52.46903848937962,67,-7,52,1771,1113,718,221,42,2.99
1,2,0,1.0,2.0,0.7862577438354492,50.635955604688654,67,-8,50,1771,1113,718,221,42,2.09
0,3,0,-0.0,3.0,0.7939596176147461,47.67598976424087,67,-8,47,1771,1113,718,221,42,4.29
2,3,0,2.0,3.0,0.8019688129425049,45.12205669071391,67,-10,44,1771,1113,718,221,42,1.77
0,2,0,-0.0,2.0,0.8100707530975342,43.174066289845804,67,-10,42,1771,1113,718,221,42,3.38
0,2,0,-0.0,2.0,0.8180208206176758,41.23105625617661,67,-10,40,1771,1113,718,221,42,3.27
1,3,0,1.0,3.0,0.8265178203582764,38.600518131237564,67,-11,37,1771,1113,718,221,42,2.06
0,2,0,-0.0,2.0,0.8343887329101562,36.68787265568828,67,-11,35,1771,1113,718,221,42,2.85
0,3,0,-0.0,3.0,0.8490316867828369,33.83784863137726,67,-11,32,1771,1113,718,221,42,2.87
0,3,0,-0.0,3.0,0.8499786853790283,31.016124838541646,67,-11,29,1771,1113,718,221,42,2.63
1,3,0,1.0,3.0,0.8580567836761475,28.635642126552707,67,-12,26,1771,1113,718,221,42,1.33
0,2,0,-0.0,2.0,0.8662886619567871,26.832815729997478,67,-12,24,1771,1113,718,221,42,1.95
0,2,0,-0.0,2.0,0.8745007514953613,25.059928172283335,67,-12,22,1771,1113,718,221,42,1.78
0,2,0,-0.0,2.0,0.885725736618042,23.323807579381203,67,-12,20,1771,1113,718,221,42,1.6
0,0,1,-0.0,-0.0,0.8929896354675293,23.323807579381203,67,-12,20,1771,1113,718,221,42,33.91
0,0,0,-0.0,-0.0,0.09541893005371094,698.0329505116503,68,65,-695,1848,398,1783,1093,30,166.5
-1,0,0,-1.0,-0.0,0.22190093994140625,698.1267793173386,68,66,-695,1848,398,1783,1093,30,42.12
-1,-2,0,-1.0,-2.0,0.22797513008117676,696.231283410908,68,67,-693,1848,398,1783,1093,30,11.04
-1,-6,0,-1.0,-6.0,0.23599696159362793,690.3571539427979,68,68,-687,1848,398,1783,1093,30,28.53
-1,-9,0,-1.0,-9.0,0.24340295791625977,681.5020176052305,68,69,-678,1848,398,1783,1093,30,38.66
-1,-12,0,-1.0,-12.0,0.25239992141723633,669.6685747442536,68,70,-666,1848,398,1783,1093,30,46.94
-3,-16,0,-3.0,-16.0,0.25945305824279785,654.0863857320377,68,73,-650,1848,398,1783,1093,30,54.64
-1,-19,0,-1.0,-19.0,0.27098894119262695,635.3243266238119,68,74,-631,1848,398,1783,1093,30,60.85
-2,-24,0,-2.0,-24.0,0.27644801139831543,611.7393235684624,68,76,-607,1848,398,1783,1093,30,67.24
-1,-27,0,-1.0,-27.0,0.2834811210632324,585.0888821367229,68,77,-580,1848,398,1783,1093,30,69.95
0,-27,0,-0.0,-27.0,0.29155993461608887,558.3350248730595,68,77,-553,1848,398,1783,1093,30,68.3
0,-28,0,-0.0,-28.0,0.30643510818481445,530.6166224309223,68,77,-525,1848,398,1783,1093,30,67.23
1,-28,0,1.0,-28.0,0.3074641227722168,502.7772866787043,68,76,-497,1848,398,1783,1093,30,65.38
1,-26,0,1.0,-26.0,0.31585097312927246,476.9339576922574,68,75,-471,1848,398,1783,1093,30,60.88
1,-24,0,1.0,-24.0,0.32362890243530273,453.08387744434253,68,74,-447,1848,398,1783,1093,30,56.49
3,-23,0,3.0,-23.0,0.33870410919189453,429.9034775388541,68,71,-424,1848,398,1783,1093,30,55.27
4,-22,0,4.0,-22.0,0.33939194679260254,407.5450895299807,68,67,-402,1848,398,1783,1093,30,53.3
4,-21,0,4.0,-21.0,0.3479299545288086,386.17353612074453,68,63,-381,1848,398,1783,1093,30,49.91
4,-22,0,4.0,-22.0,0.3554060459136963,363.8158875035558,68,59,-359,1848,398,1783,1093,30,49.52
4,-20,0,4.0,-20.0,0.3644709587097168,343.43267171310305,68,55,-339,1848,398,1783,1093,30,44.78
4,-20,0,4.0,-20.0,0.3739020824432373,323.0510795524448,68,51,-319,1848,398,1783,1093,30,42.98
4,-19,0,4.0,-19.0,0.38321995735168457,303.65934861288235,68,47,-300,1848,398,1783,1093,30,39.89
4,-17,0,4.0,-17.0,0.38880300521850586,286.2481440987871,68,43,-283,1848,398,1783,1093,30,35.68
4,-16,0,4.0,-16.0,0.3954129219055176,269.8332818612263,68,39,-267,1848,398,1783,1093,30,32.92
4,-14,0,4.0,-14.0,0.403425931930542,255.4094751570505,68,35,-253,1848,398,1783,1093,30,29.02
4,-14,0,4.0,-14.0,0.41158509254455566,241.0020746798666,68,31,-239,1848,398,1783,1093,30,27.81
3,-12,0,3.0,-12.0,0.4194190502166748,228.72035327010144,68,28,-227,1848,398,1783,1093,30,24.66
2,-12,0,2.0,-12.0,0.4274420738220215,216.566387050253,68,26,-215,1848,398,1783,1093,30,24.89
3,-11,0,3.0,-11.0,0.4355049133300781,205.29247428973133,68,23,-204,1848,398,1783,1093,30,21.52
2,-9,0,2.0,-9.0,0.4433779716491699,196.12750954417385,68,21,-195,1848,398,1783,1093,30,18.8
1,-9,0,1.0,-9.0,0.452970027923584,187.0721785835617,68,20,-186,1848,398,1783,1093,30,21.08
1,-9,0,1.0,-9.0,0.4593989849090576,178.01685313475238,68,19,-177,1848,398,1783,1093,30,20.52
1,-8,0,1.0,-8.0,0.4673960208892822,169.95587662684687,68,18,-169,1848,398,1783,1093,30,17.93
0,-9,0,-0.0,-9.0,0.47646212577819824,161.00931650062986,68,18,-160,1848,398,1783,1093,30,16.37
0,-8,0,-0.0,-8.0,0.48618197441101074,153.06207890917986,68,18,-152,1848,398,1783,1093,30,14.73
0,-8,0,-0.0,-8.0,0.49135494232177734,145.12063946937388,68,18,-144,1848,398,1783,1093,30,14.19
0,-7,0,-0.0,-7.0,0.4996790885925293,138.1774221788784,68,18,-137,1848,398,1783,1093,30,12.68
0,-8,0,-0.0,-8.0,0.5085248947143555,130.24976007655445,68,18,-129,1848,398,1783,1093,30,13.14
0,-8,0,-0.0,-8.0,0.5214760303497314,122.3315167894194,68,18,-121,1848,398,1783,1093,30,12.56
0,-7,0,-0.0,-7.0,0.5268940925598145,115.41230437002807,68,18,-114,1848,398,1783,1093,30,11.15
0,-8,0,-0.0,-8.0,0.5325450897216797,107.5174404457249,68,18,-106,1848,398,1783,1093,30,11.43
0,-7,0,-0.0,-7.0,0.539402961730957,100.62305898749054,68,18,-99,1848,398,1783,1093,30,10.09
0,-7,0,-0.0,-7.0,0.54746413230896,93.74433316206373,68,18,-92,1848,398,1783,1093,30,9.58
0,-6,0,-0.0,-6.0,0.5553920269012451,87.86353054595519,68,18,-86,1848,398,1783,1093,30,8.38
0,-7,0,-0.0,-7.0,0.5634069442749023,81.02468759581859,68,18,-79,1848,398,1783,1093,30,8.57
0,-7,0,-0.0,-7.0,0.5727519989013672,74.21590126111789,68,18,-72,1848,398,1783,1093,30,8.01
0,-6,0,-0.0,-6.0,0.5800409317016602,68.41052550594829,68,18,-66,1848,398,1783,1093,30,6.9
1,-8,0,1.0,-8.0,0.5874519348144531,60.440052945046304,68,17,-58,1848,398,1783,1093,30,8.33
0,-6,0,-0.0,-6.0,0.5954039096832275,54.70831746635972,68,17,-52,1848,398,1783,1093,30,5.82
0,-6,0,-0.0,-6.0,0.6039021015167236,49.040799340956916,68,17,-46,1848,398,1783,1093,30,5.28
1,-4,0,1.0,-4.0,0.6114449501037598,44.94441010848846,68,16,-42,1848,398,1783,1093,30,5.82
0,-5,0,-0.0,-5.0,0.6194500923156738,40.311288741492746,68,16,-37,1848,398,1783,1093,30,4.09
0,-4,0,-0.0,-4.0,0.6278529167175293,36.6742416417845,68,16,-33,1848,398,1783,1093,30,3.33
0,-4,0,-0.0,-4.0,0.6362869739532471,33.12099032335839,68,16,-29,1848,398,1783,1093,30,2.96
1,-4,0,1.0,-4.0,0.6439809799194336,29.154759474226502,68,15,-25,1848,398,1783,1093,30,3.67
0,-4,0,-0.0,-4.0,0.6513919830322266,25.80697580112788,68,15,-21,1848,398,1783,1093,30,2.17
1,-3,0,1.0,-3.0,0.6593990325927734,22.80350850198276,68,14,-18,1848,398,1783,1093,30,2.83
0,-3,0,-0.0,-3.0,0.6673769950866699,20.518284528683193,68,14,-15,1848,398,1783,1093,30,1.31
2,-4,0,2.0,-4.0,0.6796360015869141,16.278820596099706,68,12,-11,1848,398,1783,1093,30,2.56
1,-2,0,1.0,-2.0,0.6883089542388916,14.212670403551895,68,11,-9,1848,398,1783,1093,30,1.82
0,-3,0,-0.0,-3.0,0.6933901309967041,12.529964086141668,68,11,-6,1848,398,1783,1093,30,0.08
2,-3,0,2.0,-3.0,0.6993911266326904,9.486832980505138,68,9,-3,1848,398,1783,1093,30,0.82
1,-3,0,1.0,-3.0,0.7094841003417969,8.0,68,8,0,1848,398,1783,1093,30,-0.66
1,-1,0,1.0,-1.0,0.7155630588531494,7.0710678118654755,68,7,1,1848,398,1783,1093,30,0.02
1,-2,0,1.0,-2.0,0.7238481044769287,6.708203932499369,68,6,3,1848,398,1783,1093,30,-1.21
1,-2,0,1.0,-2.0,0.7345750331878662,7.0710678118654755,68,5,5,1848,398,1783,1093,30,-0.42
0,-1,0,-0.0,-1.0,0.7474141120910645,7.810249675906654,68,5,6,1848,398,1783,1093,30,0.57
0,0,1,-0.0,-0.0,0.780440092086792,7.810249675906654,68,5,6,1848,398,1783,1093,30,29.23
0,0,0,-0.0,-0.0,0.07246971130371094,576.0703082089893,69,-279,504,1564,896,1843,392,63,147.97
-3,0,0,-3.0,-0.0,0.13045978546142578,574.6233549030181,69,-276,504,1564,896,1843,392,63,3.8
-3,1,0,-3.0,1.0,0.13883090019226074,572.3093569041135,69,-273,503,1564,896,1843,392,63,6.11
-7,2,0,-7.0,2.0,0.15157175064086914,567.23628233744,69,-266,501,1564,896,1843,392,63,11.37
-7,3,0,-7.0,3.0,0.15599870681762695,561.3243269269558,69,-259,498,1564,896,1843,392,63,13.08
-10,5,0,-10.0,5.0,0.1631307601928711,552.3133168772956,69,-249,493,1564,896,1843,392,63,18.39
-13,6,0,-13.0,6.0,0.17240190505981445,541.1700287340384,69,-236,487,1564,896,1843,392,63,21.42
-14,8,0,-14.0,8.0,0.17851471900939941,527.9441258315126,69,-222,479,1564,896,1843,392,63,24.3
-16,11,0,-16.0,11.0,0.18787479400634766,511.33159495575865,69,-206,468,1564,896,1843,392,63,28.49
-18,13,0,-18.0,13.0,0.19892168045043945,492.309861774066,69,-188,455,1564,896,1843,392,63,30.71
-20,14,0,-20.0,14.0,0.20254969596862793,471.9163061391289,69,-168,441,1564,896,1843,392,63,31.29
-24,15,0,-24.0,15.0,0.21312689781188965,449.6798861412416,69,-144,426,1564,896,1843,392,63,31.99
-23,17,0,-23.0,17.0,0.22172069549560547,426.5231529471759,69,-121,409,1564,896,1843,392,63,31.85
-23,19,0,-23.0,19.0,0.2317488193511963,402.1243588742169,69,-98,390,1564,896,1843,392,63,31.74
-18,19,0,-18.0,19.0,0.23731184005737305,379.5273376187808,69,-80,371,1564,896,1843,392,63,29.14
-15,19,0,-15.0,19.0,0.2447679042816162,357.9511139806664,69,-65,352,1564,896,1843,392,63,27.27
-13,18,0,-13.0,18.0,0.2541227340698242,338.02366781040644,69,-52,334,1564,896,1843,392,63,24.84
-8,15,0,-8.0,15.0,0.25885486602783203,322.02018570269786,69,-44,319,1564,896,1843,392,63,20.95
-5,13,0,-5.0,13.0,0.2670269012451172,308.475282640279,69,-39,306,1564,896,1843,392,63,18.6
-3,10,0,-3.0,10.0,0.27480077743530273,298.18115299260614,69,-36,296,1564,896,1843,392,63,15.48
0,8,0,-0.0,8.0,0.2842369079589844,290.24127893874777,69,-36,288,1564,896,1843,392,63,13.2
0,9,0,-0.0,9.0,0.2906486988067627,281.3129929455801,69,-36,279,1564,896,1843,392,63,13.96
1,9,0,1.0,9.0,0.299332857131958,272.5233934912744,69,-37,270,1564,896,1843,392,63,12.69
2,8,0,2.0,8.0,0.30774974822998047,264.8867682614592,69,-39,262,1564,896,1843,392,63,10.68
3,10,0,3.0,10.0,0.31446290016174316,255.47602627252522,69,-42,252,1564,896,1843,392,63,11.91
4,10,0,4.0,10.0,0.32314491271972656,246.3331078032346,69,-46,242,1564,896,1843,392,63,11.05
3,10,0,3.0,10.0,0.3316938877105713,237.11811402758752,69,-49,232,1564,896,1843,392,63,11.02
4,11,0,4.0,11.0,0.33844590187072754,227.26636354727023,69,-53,221,1564,896,1843,392,63,11.01
2,12,0,2.0,12.0,0.3472778797149658,216.1157097482735,69,-55,209,1564,896,1843,392,63,12.13
2,12,0,2.0,12.0,0.35496973991394043,205.08047201037937,69,-57,197,1564,896,1843,392,63,11.54
1,12,0,1.0,12.0,0.3625798225402832,193.8788281375767,69,-58,185,1564,896,1843,392,63,11.43
0,11,0,-0.0,11.0,0.3735496997833252,183.412104289766,69,-58,174,1564,896,1843,392,63,10.76
0,11,0,-0.0,11.0,0.3786637783050537,173.0115603073968,69,-58,163,1564,896,1843,392,63,10.23
0,12,0,-0.0,12.0,0.38776683807373047,161.75598906995685,69,-58,151,1564,896,1843,392,63,10.21
-2,11,0,-2.0,11.0,0.3944718837738037,150.78461459976612,69,-56,140,1564,896,1843,392,63,10.42
-1,11,0,-1.0,11.0,0.4029097557067871,140.2355161861645,69,-55,129,1564,896,1843,392,63,9.11
-2,10,0,-2.0,10.0,0.41165590286254883,130.26895255585654,69,-53,119,1564,896,1843,392,63,8.86
-3,10,0,-3.0,10.0,0.4184577465057373,119.9208072020865,69,-50,109,1564,896,1843,392,63,9.25
-3,9,0,-3.0,9.0,0.42722177505493164,110.4943437466371,69,-47,100,1564,896,1843,392,63,8.63
-3,9,0,-3.0,9.0,0.4344809055328369,101.07917688624102,69,-44,91,1564,896,1843,392,63,8.11
-3,9,0,-3.0,9.0,0.4429607391357422,91.67878707749138,69,-41,82,1564,896,1843,392,63,7.56
-4,8,0,-4.0,8.0,0.4505758285522461,82.73451516749222,69,-37,74,1564,896,1843,392,63,11.03
-3,8,0,-3.0,8.0,0.45851969718933105,74.24284477308234,69,-34,66,1564,896,1843,392,63,6.73
-3,8,0,-3.0,8.0,0.46671390533447266,65.76473218982953,69,-31,58,1564,896,1843,392,63,6.19
-4,8,0,-4.0,8.0,0.4747147560119629,56.824290580701486,69,-27,50,1564,896,1843,392,63,7.74
-4,7,0,-4.0,7.0,0.4826807975769043,48.76474136094644,69,-23,43,1564,896,1843,392,63,7.27
-3,7,0,-3.0,7.0,0.49076271057128906,41.182520563948,69,-20,36,1564,896,1843,392,63,5.17
-3,6,0,-3.0,6.0,0.498734712600708,34.48187929913333,69,-17,30,1564,896,1843,392,63,5.57
-3,4,0,-3.0,4.0,0.5067577362060547,29.5296461204668,69,-14,26,1564,896,1843,392,63,3.67
-2,4,0,-2.0,4.0,0.5187559127807617,25.059928172283335,69,-12,22,1564,896,1843,392,63,5.28
-2,2,0,-2.0,2.0,0.5262408256530762,22.360679774997898,69,-10,20,1564,896,1843,392,63,2.1
-1,2,0,-1.0,2.0,0.5355076789855957,20.12461179749811,69,-9,18,1564,896,1843,392,63,7.2
-1,2,0,-1.0,2.0,0.541029691696167,17.88854381999832,69,-8,16,1564,896,1843,392,63,7.18
-1,0,0,-1.0,-0.0,0.5570096969604492,17.46424919657298,69,-7,16,1564,896,1843,392,63,0.2
0,0,1,-0.0,-0.0,0.5894947052001953,17.46424919657298,69,-7,16,1564,896,1843,392,63,32.129999999999995
0,0,0,-0.0,-0.0,0.08251547813415527,902.498753461743,70,-810,-398,761,482,1571,880,22,193.87
-3,0,0,-3.0,-0.0,0.15664148330688477,899.8072015715367,70,-807,-398,761,482,1571,880,22,22.21
-3,1,0,-3.0,1.0,0.16350531578063965,897.5616970437186,70,-804,-399,761,482,1571,880,22,18.37
-5,0,0,-5.0,-0.0,0.1714944839477539,893.0856621847649,70,-799,-399,761,482,1571,880,22,33.25
-5,1,0,-5.0,1.0,0.17947936058044434,889.0646770623608,70,-794,-400,761,482,1571,880,22,29.96
-6,0,0,-6.0,-0.0,0.18747448921203613,883.7103597899031,70,-788,-400,761,482,1571,880,22,37.95
-7,0,0,-7.0,-0.0,0.20020341873168945,877.4742161454091,70,-781,-400,761,482,1571,880,22,42.39
-8,0,0,-8.0,-0.0,0.203566312789917,870.3614191817098,70,-773,-400,761,482,1571,880,22,46.47
-12,-2,0,-12.0,-2.0,0.2115793228149414,858.7927573052767,70,-761,-398,761,482,1571,880,22,64.85
-16,-4,0,-16.0,-4.0,0.21981048583984375,842.7698380934145,70,-745,-394,761,482,1571,880,22,78.24
-20,-6,0,-20.0,-6.0,0.22978830337524414,822.2949592451604,70,-725,-388,761,482,1571,880,22,88.05
-24,-8,0,-24.0,-8.0,0.2375023365020752,797.371306230667,70,-701,-380,761,482,1571,880,22,95.1
-24,-9,0,-24.0,-9.0,0.24347138404846191,771.9909325892371,70,-677,-371,761,482,1571,880,22,94.31
-26,-10,0,-26.0,-10.0,0.25194525718688965,744.3937130309471,70,-651,-361,761,482,1571,880,22,95.72
-25,-11,0,-25.0,-11.0,0.26070427894592285,717.2001115448882,70,-626,-350,761,482,1571,880,22,93.48
-27,-12,0,-27.0,-12.0,0.26801228523254395,687.782669162287,70,-599,-338,761,482,1571,880,22,94.17
-28,-13,0,-28.0,-13.0,0.27832627296447754,657.0129374677488,70,-571,-325,761,482,1571,880,22,93.41
-30,-13,0,-30.0,-13.0,0.28432226181030273,624.5198155383061,70,-541,-312,761,482,1571,880,22,92.05
-30,-14,0,-30.0,-14.0,0.291614294052124,591.5445883447841,70,-511,-298,761,482,1571,880,22,89.76
-32,-15,0,-32.0,-15.0,0.3000204563140869,556.3542037227722,70,-479,-283,761,482,1571,880,22,88.41
-31,-14,0,-31.0,-14.0,0.30753540992736816,522.5562170714267,70,-448,-269,761,482,1571,880,22,83.42
-33,-13,0,-33.0,-13.0,0.3154923915863037,487.60742406161125,70,-415,-256,761,482,1571,880,22,80.19
-32,-13,0,-32.0,-13.0,0.32349538803100586,453.583509400419,70,-383,-243,761,482,1571,880,22,75.67
-30,-12,0,-30.0,-12.0,0.3370692729949951,421.86490728668105,70,-353,-231,761,482,1571,880,22,70.06
-28,-12,0,-28.0,-12.0,0.34009242057800293,391.9004975755964,70,-325,-219,761,482,1571,880,22,65.26
-25,-10,0,-25.0,-10.0,0.34762048721313477,365.62412393057434,70,-300,-209,761,482,1571,880,22,58.69
-23,-11,0,-23.0,-11.0,0.35618138313293457,340.4893537248999,70,-277,-198,761,482,1571,880,22,55.19
-20,-10,0,-20.0,-10.0,0.36594438552856445,318.42267507198665,70,-257,-188,761,482,1571,880,22,49.77
-17,-9,0,-17.0,-9.0,0.37151145935058594,299.4010688023675,70,-240,-179,761,482,1571,880,22,44.55
-15,-8,0,-15.0,-8.0,0.37998533248901367,282.6057324259365,70,-225,-171,761,482,1571,880,22,40.16
-14,-8,0,-14.0,-8.0,0.38808345794677734,266.62708039507163,70,-211,-163,761,482,1571,880,22,37.8
-13,-8,0,-13.0,-8.0,0.39997434616088867,251.45377308761942,70,-198,-155,761,482,1571,880,22,35.62
-12,-9,0,-12.0,-9.0,0.4109914302825928,236.4571842850202,70,-186,-146,761,482,1571,880,22,35.85
-14,-9,0,-14.0,-9.0,0.41161632537841797,219.89315587348324,70,-172,-137,761,482,1571,880,22,34.15
-14,-9,0,-14.0,-9.0,0.4194953441619873,203.3420763147657,70,-158,-128,761,482,1571,880,22,32.26
-14,-9,0,-14.0,-9.0,0.43457841873168945,186.80738743422327,70,-144,-119,761,482,1571,880,22,30.32
-12,-7,0,-12.0,-7.0,0.43547940254211426,173.11268006705922,70,-132,-112,761,482,1571,880,22,25.61
-11,-7,0,-11.0,-7.0,0.4438514709472656,160.20611723651504,70,-121,-105,761,482,1571,880,22,23.75
-10,-6,0,-10.0,-6.0,0.4550454616546631,148.73466307488647,70,-111,-99,761,482,1571,880,22,20.87
-9,-7,0,-9.0,-7.0,0.4610304832458496,137.3608386695422,70,-102,-92,761,482,1571,880,22,20.94
-7,-5,0,-7.0,-5.0,0.46851444244384766,128.81770064707723,70,-95,-87,761,482,1571,880,22,16.62
-7,-7,0,-7.0,-7.0,0.47550249099731445,118.92854997854805,70,-88,-80,761,482,1571,880,22,18.32
-6,-7,0,-6.0,-7.0,0.4845774173736572,109.78615577567146,70,-82,-73,761,482,1571,880,22,15.48
-6,-5,0,-6.0,-5.0,0.49276232719421387,101.9803902718557,70,-76,-68,761,482,1571,880,22,15.24
-7,-7,0,-7.0,-7.0,0.5001814365386963,92.09777413162601,70,-69,-61,761,482,1571,880,22,15.5
-6,-7,0,-6.0,-7.0,0.5080134868621826,82.97590011563598,70,-63,-54,761,482,1571,880,22,12.85
-7,-5,0,-7.0,-5.0,0.5162773132324219,74.41102068914255,70,-56,-49,761,482,1571,880,22,12.26
-7,-6,0,-7.0,-6.0,0.5235414505004883,65.19202405202648,70,-49,-43,761,482,1571,880,22,14.24
-6,-6,0,-6.0,-6.0,0.5315513610839844,56.72741841473134,70,-43,-37,761,482,1571,880,22,10.91
-6,-5,0,-6.0,-5.0,0.5395073890686035,48.91829923454004,70,-37,-32,761,482,1571,880,22,11.47
-5,-4,0,-5.0,-4.0,0.5501682758331299,42.5205832509386,70,-32,-28,761,482,1571,880,22,9.16
-3,-5,0,-3.0,-5.0,0.5569713115692139,37.013511046643494,70,-29,-23,761,482,1571,880,22,5.4
-4,-3,0,-4.0,-3.0,0.5635182857513428,32.01562118716424,70,-25,-20,761,482,1571,880,22,8.02
-2,-3,0,-2.0,-3.0,0.5714764595031738,28.600699292150182,70,-23,-17,761,482,1571,880,22,3.84
-2,-3,0,-2.0,-3.0,0.5810973644256592,25.238858928247925,70,-21,-14,761,482,1571,880,22,3.41
-1,-1,0,-1.0,-1.0,0.5881004333496094,23.853720883753127,70,-20,-13,761,482,1571,880,22,3.43
-2,-2,0,-2.0,-2.0,0.5954923629760742,21.095023109728988,70,-18,-11,761,482,1571,880,22,3.64
0,-1,0,-0.0,-1.0,0.6067874431610107,20.591260281974,70,-18,-10,761,482,1571,880,22,0.63
-1,0,0,-1.0,-0.0,0.6115913391113281,19.72308292331602,70,-17,-10,761,482,1571,880,22,1.79
0,-1,0,-0.0,-1.0,0.6195082664489746,19.235384061671343,70,-17,-9,761,482,1571,880,22,0.56
-1,-1,0,-1.0,-1.0,0.6514832973480225,17.88854381999832,70,-16,-8,761,482,1571,880,22,2.57
0,-1,0,-0.0,-1.0,0.661670446395874,17.46424919657298,70,-16,-7,761,482,1571,880,22,0.39
-1,-1,0,-1.0,-1.0,0.6686294078826904,16.15549442140351,70,-15,-6,761,482,1571,880,22,2.15
-1,-1,0,-1.0,-1.0,0.6754822731018066,14.866068747318506,70,-14,-5,761,482,1571,880,22,1.94
-1,-1,0,-1.0,-1.0,0.6835064888000488,13.601470508735444,70,-13,-4,761,482,1571,880,22,1.73
-2,-1,0,-2.0,-1.0,0.6925783157348633,11.40175425099138,70,-11,-3,761,482,1571,880,22,3.03
-1,-1,0,-1.0,-1.0,0.6995193958282471,10.198039027185569,70,-10,-2,761,482,1571,880,22,1.2
-2,-1,0,-2.0,-1.0,0.7079832553863525,8.06225774829855,70,-8,-1,761,482,1571,880,22,1.9
-1,-1,0,-1.0,-1.0,0.7154734134674072,7.0,70,-7,0,761,482,1571,880,22,0.43
-2,0,0,-2.0,-0.0,0.7262494564056396,5.0,70,-5,0,761,482,1571,880,22,7.62
-1,0,0,-1.0,-0.0,0.7326154708862305,4.0,70,-4,0,761,482,1571,880,22,7.14
-1,0,0,-1.0,-0.0,0.7413513660430908,3.0,70,-3,0,761,482,1571,880,22,7.13
-1,-1,0,-1.0,-1.0,0.74747633934021,2.23606797749979,70,-2,1,761,482,1571,880,22,-1.27
0,0,1,-0.0,-0.0,0.7655224800109863,2.23606797749979,70,-2,1,761,482,1571,880,22,27.58
0,0,0,-0.0,-0.0,0.1060783863067627,516.5510623355642,71,464,-227,1227,254,763,481,4,138.16
3,2,0,3.0,2.0,0.1394953727722168,514.7445968633376,71,461,-229,1227,254,763,481,4,41.46
4,2,0,4.0,2.0,0.14710354804992676,512.0644490686694,71,457,-231,1227,254,763,481,4,53.25
4,2,0,4.0,2.0,0.15537738800048828,509.40946202441114,71,453,-233,1227,254,763,481,4,52.76
3,2,0,3.0,2.0,0.16304755210876465,507.66622893393253,71,450,-235,1227,254,763,481,4,40.07
2,1,0,2.0,1.0,0.1710186004638672,506.3595560468865,71,448,-236,1227,254,763,481,4,32.76
2,1,0,2.0,1.0,0.18019938468933105,505.0594024468805,71,446,-237,1227,254,763,481,4,32.58
3,1,0,3.0,1.0,0.18738555908203125,502.8846786292062,71,443,-238,1227,254,763,481,4,46.5
3,0,0,3.0,-0.0,0.19557452201843262,500.24394049303584,71,440,-238,1227,254,763,481,4,52.89
4,1,0,4.0,1.0,0.204878568649292,497.20921149954575,71,436,-239,1227,254,763,481,4,56.41
5,1,0,5.0,1.0,0.21122956275939941,493.3163285357581,71,431,-240,1227,254,763,481,4,64.06
6,0,0,6.0,-0.0,0.2194674015045166,488.082984747471,71,425,-240,1227,254,763,481,4,73.35
7,0,0,7.0,-0.0,0.23285937309265137,482.0,71,418,-240,1227,254,763,481,4,77.28
8,0,0,8.0,-0.0,0.23674750328063965,475.0789408087881,71,410,-240,1227,254,763,481,4,80.29
6,-1,0,6.0,-1.0,0.24309444427490234,469.40068172085137,71,404,-239,1227,254,763,481,4,74.39
8,-2,0,8.0,-2.0,0.25115251541137695,461.50297940533386,71,396,-237,1227,254,763,481,4,83.22
8,-3,0,8.0,-3.0,0.26572442054748535,453.10043036836765,71,388,-234,1227,254,763,481,4,84.49
10,-4,0,10.0,-4.0,0.27200841903686523,442.4748580428045,71,378,-230,1227,254,763,481,4,89.08
10,-4,0,10.0,-4.0,0.27507543563842773,431.8564576337837,71,368,-226,1227,254,763,481,4,87.61
11,-5,0,11.0,-5.0,0.2830474376678467,419.86902719776793,71,357,-221,1227,254,763,481,4,89.01
11,-5,0,11.0,-5.0,0.29123640060424805,407.8872393198885,71,346,-216,1227,254,763,481,4,87.26
10,-6,0,10.0,-6.0,0.29906439781188965,396.2272075463774,71,336,-210,1227,254,763,481,4,87.2
12,-8,0,12.0,-8.0,0.30719447135925293,381.81147180251145,71,324,-202,1227,254,763,481,4,88.69
12,-8,0,12.0,-8.0,0.3150455951690674,367.39624385668395,71,312,-194,1227,254,763,481,4,86.42
13,-9,0,13.0,-9.0,0.32532453536987305,351.6048918886084,71,299,-185,1227,254,763,481,4,84.89
15,-10,0,15.0,-10.0,0.3310353755950928,333.58806933102386,71,284,-175,1227,254,763,481,4,84.29
15,-11,0,15.0,-11.0,0.3394775390625,315.0507895562238,71,269,-164,1227,254,763,481,4,80.44
17,-12,0,17.0,-12.0,0.34723448753356934,294.29237163066256,71,252,-152,1227,254,763,481,4,78.33
15,-11,0,15.0,-11.0,0.35569238662719727,275.77164466275354,71,237,-141,1227,254,763,481,4,73.19
16,-11,0,16.0,-11.0,0.3630504608154297,256.40007800310826,71,221,-130,1227,254,763,481,4,70.45
16,-11,0,16.0,-11.0,0.3710315227508545,237.0358622656074,71,205,-119,1227,254,763,481,4,66.59
16,-11,0,16.0,-11.0,0.382035493850708,217.68095920406083,71,189,-108,1227,254,763,481,4,62.6
16,-10,0,16.0,-10.0,0.38704657554626465,198.82907232092595,71,173,-98,1227,254,763,481,4,59.3
17,-10,0,17.0,-10.0,0.39678144454956055,179.10890541790488,71,156,-88,1227,254,763,481,4,56.46
18,-9,0,18.0,-9.0,0.40305447578430176,159.0125781188394,71,138,-79,1227,254,763,481,4,50.92
16,-8,0,16.0,-8.0,0.41132044792175293,141.15594213493105,71,122,-71,1227,254,763,481,4,45.91
15,-7,0,15.0,-7.0,0.4191443920135498,124.67958934805648,71,107,-64,1227,254,763,481,4,40.98
15,-6,0,15.0,-6.0,0.4278683662414551,108.75660899458019,71,92,-58,1227,254,763,481,4,36.29
14,-5,0,14.0,-5.0,0.44733452796936035,94.30270409696638,71,78,-53,1227,254,763,481,4,31.85
12,-4,0,12.0,-4.0,0.4477424621582031,82.20097323024831,71,66,-49,1227,254,763,481,4,27.67
12,-4,0,12.0,-4.0,0.45113158226013184,70.2922470831599,71,54,-45,1227,254,763,481,4,24.59
12,-4,0,12.0,-4.0,0.4595475196838379,58.69412236331676,71,42,-41,1227,254,763,481,4,21.44
9,-4,0,9.0,-4.0,0.46713948249816895,49.57822102496216,71,33,-37,1227,254,763,481,4,18.3
8,-4,0,8.0,-4.0,0.47519755363464355,41.400483088968905,71,25,-33,1227,254,763,481,4,15.86
7,-3,0,7.0,-3.0,0.48369455337524414,34.9857113690718,71,18,-30,1227,254,763,481,4,12.95
7,-3,0,7.0,-3.0,0.4930534362792969,29.154759474226502,71,11,-27,1227,254,763,481,4,10.98
4,-3,0,4.0,-3.0,0.4990355968475342,25.0,71,7,-24,1227,254,763,481,4,9.19
4,-2,0,4.0,-2.0,0.5070555210113525,22.20360331117452,71,3,-22,1227,254,763,481,4,6.55
4,-1,0,4.0,-1.0,0.5150425434112549,21.02379604162864,71,-1,-21,1227,254,763,481,4,2.97
2,-1,0,2.0,-1.0,0.5230495929718018,20.223748416156685,71,-3,-20,1227,254,763,481,4,2.4
2,-2,0,2.0,-2.0,0.5310225486755371,18.681541692269406,71,-5,-18,1227,254,763,481,4,4.1
2,0,0,2.0,-0.0,0.5416755676269531,19.313207915827967,71,-7,-18,1227,254,763,481,4,4.14
0,-1,0,-0.0,-1.0,0.5479624271392822,18.384776310850235,71,-7,-17,1227,254,763,481,4,4.55
1,-1,0,1.0,-1.0,0.5550904273986816,17.88854381999832,71,-8,-16,1227,254,763,481,4,1.58
0,-1,0,-0.0,-1.0,0.6270735263824463,17.0,71,-8,-15,1227,254,763,481,4,4.02
-1,-1,0,-1.0,-1.0,0.6371495723724365,15.652475842498529,71,-7,-14,1227,254,763,481,4,5.36
0,-1,0,-0.0,-1.0,0.6472375392913818,14.7648230602334,71,-7,-13,1227,254,763,481,4,3.82
-1,-1,0,-1.0,-1.0,0.6530454158782959,13.416407864998739,71,-6,-12,1227,254,763,481,4,5.11
-1,-1,0,-1.0,-1.0,0.663609504699707,12.083045973594572,71,-5,-11,1227,254,763,481,4,4.76
-1,-1,0,-1.0,-1.0,0.6679444313049316,10.770329614269007,71,-4,-10,1227,254,763,481,4,4.39
0,-1,0,-0.0,-1.0,0.6754915714263916,9.848857801796104,71,-4,-9,1227,254,763,481,4,3.64
-1,-1,0,-1.0,-1.0,0.6833305358886719,8.54400374531753,71,-3,-8,1227,254,763,481,4,3.98
0,-1,0,-0.0,-1.0,0.6910445690155029,7.615773105863909,71,-3,-7,1227,254,763,481,4,3.42
0,-2,0,-0.0,-2.0,0.6990394592285156,5.830951894845301,71,-3,-5,1227,254,763,481,4,3.68
0,-2,0,-0.0,-2.0,0.7150523662567139,4.242640687119285,71,-3,-3,1227,254,763,481,4,2.49
1,-1,0,1.0,-1.0,0.7230525016784668,4.47213595499958,71,-4,-2,1227,254,763,481,4,4.58
0,-1,0,-0.0,-1.0,0.7318634986877441,4.123105625617661,71,-4,-1,1227,254,763,481,4,0.0
0,-1,0,-0.0,-1.0,0.747105598449707,4.0,71,-4,0,1227,254,763,481,4,-0.78
0,-1,0,-0.0,-1.0,0.8190205097198486,4.123105625617661,71,-4,1,1227,254,763,481,4,6.49
-1,-1,0,-1.0,-1.0,0.8277795314788818,3.605551275463989,71,-3,2,1227,254,763,481,4,-0.06
0,-1,0,-0.0,-1.0,0.8430423736572266,4.242640687119285,71,-3,3,1227,254,763,481,4,2.48
-1,-1,0,-1.0,-1.0,0.8512084484100342,4.47213595499958,71,-2,4,1227,254,763,481,4,4.58
0,0,1,-0.0,-0.0,0.8930604457855225,4.47213595499958,71,-2,4,1227,254,763,481,4,18.24
0,0,0,-0.0,-0.0,1.0200424194335938,4.47213595499958,71,-2,4,1227,254,763,481,4,18.24
-1,0,0,-1.0,-0.0,1.083059549331665,4.123105625617661,71,-1,4,1227,254,763,481,4,0.0
-1,0,0,-1.0,-0.0,1.092395544052124,4.0,71,0,4,1227,254,763,481,4,-0.78
-1,0,0,-1.0,-0.0,1.0990424156188965,4.123105625617661,71,1,4,1227,254,763,481,4,6.49
0,1,0,-0.0,1.0,1.115297555923462,3.1622776601683795,71,1,3,1227,254,763,481,4,2.93
0,0,1,-0.0,-0.0,1.1780633926391602,3.1622776601683795,71,1,3,1227,254,763,481,4,27.86
0,0,0,-0.0,-0.0,0.10092926025390625,220.00227271553356,72,-160,-151,1066,100,1226,251,46,78.61
-1,0,0,-1.0,-0.0,0.29064440727233887,219.27608168699112,72,-159,-151,1066,100,1226,251,46,2.23
-3,0,0,-3.0,-0.0,0.3008992671966553,217.11057090800531,72,-156,-151,1066,100,1226,251,46,4.2
-5,-2,0,-5.0,-2.0,0.3061842918395996,212.13674834879504,72,-151,-149,1066,100,1226,251,46,8.63
-5,-2,0,-5.0,-2.0,0.3146064281463623,207.18349355100662,72,-146,-147,1066,100,1226,251,46,8.45
-6,-3,0,-6.0,-3.0,0.32195425033569336,200.83824337013107,72,-140,-144,1066,100,1226,251,46,10.11
-7,-3,0,-7.0,-3.0,0.32991647720336914,193.82982226685345,72,-133,-141,1066,100,1226,251,46,10.3
-8,-5,0,-8.0,-5.0,0.3406534194946289,184.7187050625897,72,-125,-136,1066,100,1226,251,46,12.57
-8,-4,0,-8.0,-4.0,0.3463263511657715,176.3887751530692,72,-117,-132,1066,100,1226,251,46,11.0
-8,-5,0,-8.0,-5.0,0.3540353775024414,167.36188335460378,72,-109,-127,1066,100,1226,251,46,11.55
-6,-4,0,-6.0,-4.0,0.3625943660736084,160.4306703844374,72,-103,-123,1066,100,1226,251,46,9.54
-6,-5,0,-6.0,-5.0,0.3699004650115967,152.75143207184672,72,-97,-118,1066,100,1226,251,46,10.46
-8,-6,0,-8.0,-6.0,0.37795329093933105,143.05593311708537,72,-89,-112,1066,100,1226,251,46,11.15
-9,-8,0,-9.0,-8.0,0.38630127906799316,131.20975573485381,72,-80,-104,1066,100,1226,251,46,12.38
-10,-11,0,-10.0,-11.0,0.3959643840789795,116.40017182117903,72,-70,-93,1066,100,1226,251,46,14.04
-12,-11,0,-12.0,-11.0,0.40224337577819824,100.43903623591775,72,-58,-82,1066,100,1226,251,46,12.22
-10,-12,0,-10.0,-12.0,0.41063928604125977,84.87638069569178,72,-48,-70,1066,100,1226,251,46,11.92
-10,-13,0,-10.0,-13.0,0.417905330657959,68.5054742338158,72,-38,-57,1066,100,1226,251,46,11.25
-8,-10,0,-8.0,-10.0,0.4259302616119385,55.758407437802596,72,-30,-47,1066,100,1226,251,46,8.42
-7,-10,0,-7.0,-10.0,0.4339122772216797,43.56604182158393,72,-23,-37,1066,100,1226,251,46,8.2
-6,-7,0,-6.0,-7.0,0.44188427925109863,34.48187929913333,72,-17,-30,1066,100,1226,251,46,5.01
-5,-6,0,-5.0,-6.0,0.44989943504333496,26.832815729997478,72,-12,-24,1066,100,1226,251,46,3.9
-3,-4,0,-3.0,-4.0,0.46042943000793457,21.93171219946131,72,-9,-20,1066,100,1226,251,46,3.15
-3,-3,0,-3.0,-3.0,0.4696624279022217,18.027756377319946,72,-6,-17,1066,100,1226,251,46,1.75
-1,-3,0,-1.0,-3.0,0.47390031814575195,14.866068747318506,72,-5,-14,1066,100,1226,251,46,5.54
-2,-2,0,-2.0,-2.0,0.4841573238372803,12.36931687685298,72,-3,-12,1066,100,1226,251,46,1.0
-1,-3,0,-1.0,-3.0,0.48990845680236816,9.219544457292887,72,-2,-9,1066,100,1226,251,46,3.12
0,-1,0,-0.0,-1.0,0.4978914260864258,8.246211251235321,72,-2,-8,1066,100,1226,251,46,2.07
-1,-1,0,-1.0,-1.0,0.505953311920166,7.0710678118654755,72,-1,-7,1066,100,1226,251,46,0.44
0,-1,0,-0.0,-1.0,0.5138852596282959,6.082762530298219,72,-1,-6,1066,100,1226,251,46,2.41
0,0,1,-0.0,-0.0,0.553929328918457,6.082762530298219,72,-1,-6,1066,100,1226,251,46,28.72
0,0,0,-0.0,-0.0,0.08489680290222168,737.9762868819024,73,-305,672,762,778,1067,106,74,172.18
0,1,0,-0.0,1.0,0.17882180213928223,737.0658043892689,73,-305,671,762,778,1067,106,74,3.97
-1,4,0,-1.0,4.0,0.1851518154144287,733.0109139705902,73,-304,667,762,778,1067,106,74,11.62
-2,6,0,-2.0,6.0,0.19405484199523926,726.7220926874317,73,-302,661,762,778,1067,106,74,16.56
-3,8,0,-3.0,8.0,0.20088887214660645,718.1991367301969,73,-299,653,762,778,1067,106,74,21.0
-5,11,0,-5.0,11.0,0.21449065208435059,706.1161377563892,73,-294,642,762,778,1067,106,74,29.0
-6,13,0,-6.0,13.0,0.21690082550048828,691.7983810330868,73,-288,629,762,778,1067,106,74,32.14
-5,12,0,-5.0,12.0,0.2248687744140625,678.8063052152654,73,-283,617,762,778,1067,106,74,28.35
-7,12,0,-7.0,12.0,0.2334597110748291,664.9819546423797,73,-276,605,762,778,1067,106,74,28.08
-6,14,0,-6.0,14.0,0.2412266731262207,649.7545690489602,73,-270,591,762,778,1067,106,74,31.31
-8,15,0,-8.0,15.0,0.24962782859802246,632.7874840734447,73,-262,576,762,778,1067,106,74,32.21
-11,17,0,-11.0,17.0,0.25688982009887695,612.765860667841,73,-251,559,762,778,1067,106,74,34.36
-11,21,0,-11.0,21.0,0.26500368118286133,589.1044050081446,73,-240,538,762,778,1067,106,74,38.84
-13,25,0,-13.0,25.0,0.2729806900024414,560.9795005167301,73,-227,513,762,778,1067,106,74,42.27
-14,28,0,-14.0,28.0,0.2826097011566162,529.7112420932748,73,-213,485,762,778,1067,106,74,43.96
-13,29,0,-13.0,29.0,0.2918057441711426,497.9317222270539,73,-200,456,762,778,1067,106,74,44.42
-14,30,0,-14.0,30.0,0.2969038486480713,464.83545475791755,73,-186,426,762,778,1067,106,74,42.79
-12,30,0,-12.0,30.0,0.3055417537689209,432.5413275052454,73,-174,396,762,778,1067,106,74,40.05
-12,28,0,-12.0,28.0,0.31594181060791016,402.07959411041986,73,-162,368,762,778,1067,106,74,38.06
-11,29,0,-11.0,29.0,0.32446885108947754,371.1091483647365,73,-151,339,762,778,1067,106,74,34.9
-9,26,0,-9.0,26.0,0.32984066009521484,343.70481521212355,73,-142,313,762,778,1067,106,74,30.21
-8,25,0,-8.0,25.0,0.3370656967163086,317.6476034853718,73,-134,288,762,778,1067,106,74,27.4
-7,23,0,-7.0,23.0,0.34647274017333984,293.86051112730337,73,-127,265,762,778,1067,106,74,24.3
-6,21,0,-6.0,21.0,0.3559987545013428,272.35454833727306,73,-121,244,762,778,1067,106,74,21.39
-5,19,0,-5.0,19.0,0.3612697124481201,253.1422524984717,73,-116,225,762,778,1067,106,74,18.65
-4,17,0,-4.0,17.0,0.36894774436950684,236.2371689637344,73,-112,208,762,778,1067,106,74,16.08
-4,14,0,-4.0,14.0,0.3835327625274658,222.03603311174518,73,-108,194,762,778,1067,106,74,13.89
-5,13,0,-5.0,13.0,0.3852677345275879,208.25465180878913,73,-103,181,762,778,1067,106,74,13.64
-5,12,0,-5.0,12.0,0.3928656578063965,195.35864454894235,73,-98,169,762,778,1067,106,74,12.76
-5,11,0,-5.0,11.0,0.4024686813354492,183.33848477611022,73,-93,158,762,778,1067,106,74,12.05
-5,10,0,-5.0,10.0,0.40917277336120605,172.18594600024707,73,-88,148,762,778,1067,106,74,11.61
-5,8,0,-5.0,8.0,0.41690969467163086,162.75441622272496,73,-83,140,762,778,1067,106,74,11.56
-5,7,0,-5.0,7.0,0.4286367893218994,154.18495387034366,73,-78,133,762,778,1067,106,74,9.28
-5,7,0,-5.0,7.0,0.4352538585662842,145.6193668438371,73,-73,126,762,778,1067,106,74,8.94
-5,7,0,-5.0,7.0,0.4416928291320801,137.05838172107534,73,-68,119,762,778,1067,106,74,8.6
-6,6,0,-6.0,6.0,0.4489567279815674,128.89142717807107,73,-62,113,762,778,1067,106,74,6.75
-5,7,0,-5.0,7.0,0.46114373207092285,120.3536455617361,73,-57,106,762,778,1067,106,74,7.75
-6,6,0,-6.0,6.0,0.46578264236450195,112.25417586887359,73,-51,100,762,778,1067,106,74,6.05
-7,6,0,-7.0,6.0,0.47290468215942383,103.78824596263297,73,-44,94,762,778,1067,106,74,5.47
-8,7,0,-8.0,7.0,0.480954647064209,94.15412895885129,73,-36,87,762,778,1067,106,74,5.42
-7,6,0,-7.0,6.0,0.48926281929016113,86.03487664894976,73,-29,81,762,778,1067,106,74,4.43
-7,6,0,-7.0,6.0,0.49687886238098145,78.16009211867653,73,-22,75,762,778,1067,106,74,3.9
-4,7,0,-4.0,7.0,0.5049078464508057,70.3420215802759,73,-18,68,762,778,1067,106,74,4.77
-5,6,0,-5.0,6.0,0.5143857002258301,63.34824385884742,73,-13,62,762,778,1067,106,74,3.39
-4,7,0,-4.0,7.0,0.5212666988372803,55.731499172371095,73,-9,55,762,778,1067,106,74,3.71
-3,6,0,-3.0,6.0,0.5294108390808105,49.36598018878993,73,-6,49,762,778,1067,106,74,3.27
-3,6,0,-3.0,6.0,0.5370006561279297,43.104524124504614,73,-3,43,762,778,1067,106,74,2.81
-2,6,0,-2.0,6.0,0.5452916622161865,37.013511046643494,73,-1,37,762,778,1067,106,74,2.96
-3,6,0,-3.0,6.0,0.5528967380523682,31.064449134018133,73,2,31,762,778,1067,106,74,1.81
-3,6,0,-3.0,6.0,0.5663716793060303,25.495097567963924,73,5,25,762,778,1067,106,74,1.15
-1,4,0,-1.0,4.0,0.5688927173614502,21.840329667841555,73,6,21,762,778,1067,106,74,1.25
-1,3,0,-1.0,3.0,0.5773358345031738,19.313207915827967,73,7,18,762,778,1067,106,74,0.71
-1,2,0,-1.0,2.0,0.5865857601165771,17.88854381999832,73,8,16,762,778,1067,106,74,0.27
-1,2,0,-1.0,2.0,0.593714714050293,16.64331697709324,73,9,14,762,778,1067,106,74,0.04
-1,1,0,-1.0,1.0,0.6017286777496338,16.401219466856727,73,10,13,762,778,1067,106,74,-0.3
0,1,0,-0.0,1.0,0.6170506477355957,15.620499351813308,73,10,12,762,778,1067,106,74,0.87
0,0,1,-0.0,-0.0,0.6229147911071777,15.620499351813308,73,10,12,762,778,1067,106,74,31.57
0,0,0,-0.0,-0.0,0.7059197425842285,15.620499351813308,73,10,12,762,778,1067,106,74,21.57
1,0,0,1.0,-0.0,0.7770378589630127,15.0,73,9,12,762,778,1067,106,74,0.43
1,-1,0,1.0,-1.0,0.7858927249908447,15.264337522473747,73,8,13,762,778,1067,106,74,0.28
1,-1,0,1.0,-1.0,0.794670820236206,15.652475842498529,73,7,14,762,778,1067,106,74,0.15
0,-1,0,-0.0,-1.0,0.8009867668151855,16.55294535724685,73,7,15,762,778,1067,106,74,1.44
0,-1,0,-0.0,-1.0,0.8091378211975098,17.46424919657298,73,7,16,762,778,1067,106,74,1.55
1,0,0,1.0,-0.0,0.8169636726379395,17.08800749063506,73,6,16,762,778,1067,106,74,0.11
0,0,1,-0.0,-0.0,0.910916805267334,17.08800749063506,73,6,16,762,778,1067,106,74,32.019999999999996
0,0,0,-0.0,-0.0,0.0498661994934082,701.9928774567446,74,637,-295,1393,467,756,762,55,167.08
0,-2,0,-0.0,-2.0,0.15895342826843262,701.1547618036976,74,637,-293,1393,467,756,762,55,2.97
1,-3,0,1.0,-3.0,0.16741228103637695,698.9964234529388,74,636,-290,1393,467,756,762,55,7.05
2,-4,0,2.0,-4.0,0.17557334899902344,695.5228249310011,74,634,-286,1393,467,756,762,55,10.72
5,-5,0,5.0,-5.0,0.18283820152282715,688.9136375482778,74,629,-281,1393,467,756,762,55,19.08
7,-7,0,7.0,-7.0,0.19141221046447754,679.6763935874189,74,622,-274,1393,467,756,762,55,24.61
9,-8,0,9.0,-8.0,0.19969439506530762,668.2252614201292,74,613,-266,1393,467,756,762,55,28.98
12,-8,0,12.0,-8.0,0.20712041854858398,654.0374607008379,74,601,-258,1393,467,756,762,55,34.35
13,-9,0,13.0,-9.0,0.21483421325683594,638.5491367154136,74,588,-249,1393,467,756,762,55,35.9
17,-10,0,17.0,-10.0,0.22294926643371582,619.0008077539156,74,571,-239,1393,467,756,762,55,42.03
17,-9,0,17.0,-9.0,0.23100829124450684,599.8466470690655,74,554,-230,1393,467,756,762,55,41.15
17,-9,0,17.0,-9.0,0.23885035514831543,580.6978560318611,74,537,-221,1393,467,756,762,55,40.31
19,-10,0,19.0,-10.0,0.2468433380126953,559.3254866354653,74,518,-211,1393,467,756,762,55,42.36
20,-10,0,20.0,-10.0,0.25488829612731934,537.0335185069922,74,498,-201,1393,467,756,762,55,42.71
21,-10,0,21.0,-10.0,0.2628593444824219,513.819034291257,74,477,-191,1393,467,756,762,55,42.94
24,-11,0,24.0,-11.0,0.2708413600921631,487.4515360525598,74,453,-180,1393,467,756,762,55,45.23
25,-13,0,25.0,-13.0,0.279130220413208,459.4268168054625,74,428,-167,1393,467,756,762,55,44.3
25,-11,0,25.0,-11.0,0.2874782085418701,432.1400236034612,74,403,-156,1393,467,756,762,55,42.99
25,-13,0,25.0,-13.0,0.29486632347106934,404.1447760394782,74,378,-143,1393,467,756,762,55,40.65
24,-12,0,24.0,-12.0,0.3034672737121582,377.4612562899668,74,354,-131,1393,467,756,762,55,37.87
23,-11,0,23.0,-11.0,0.31079840660095215,352.08095659947304,74,331,-120,1393,467,756,762,55,35.24
21,-9,0,21.0,-9.0,0.32196521759033203,329.27344259748617,74,310,-111,1393,467,756,762,55,32.2
21,-7,0,21.0,-7.0,0.32683539390563965,307.1432890362412,74,289,-104,1393,467,756,762,55,31.3
20,-8,0,20.0,-8.0,0.33548521995544434,285.616876252087,74,269,-96,1393,467,756,762,55,28.96
19,-8,0,19.0,-8.0,0.3465542793273926,265.03584663211126,74,250,-88,1393,467,756,762,55,26.37
17,-6,0,17.0,-6.0,0.35082125663757324,247.00809703327542,74,233,-82,1393,467,756,762,55,25.87
14,-6,0,14.0,-6.0,0.3587992191314697,231.81242417092315,74,219,-76,1393,467,756,762,55,19.96
12,-5,0,12.0,-5.0,0.3669743537902832,218.83783950679097,74,207,-71,1393,467,756,762,55,17.61
11,-6,0,11.0,-6.0,0.38000035285949707,206.49697334343668,74,196,-65,1393,467,756,762,55,15.18
10,-5,0,10.0,-5.0,0.3869502544403076,195.43796969882797,74,186,-60,1393,467,756,762,55,13.88
9,-6,0,9.0,-6.0,0.39246034622192383,185.05404615949362,74,177,-54,1393,467,756,762,55,12.0
10,-7,0,10.0,-7.0,0.40224432945251465,173.4877517290486,74,167,-47,1393,467,756,762,55,12.15
9,-6,0,9.0,-6.0,0.4087843894958496,163.23296235748464,74,158,-41,1393,467,756,762,55,10.77
8,-6,0,8.0,-6.0,0.41748523712158203,154.02921800749363,74,150,-35,1393,467,756,762,55,9.34
7,-5,0,7.0,-5.0,0.42313241958618164,146.11296999240005,74,143,-30,1393,467,756,762,55,8.15
7,-4,0,7.0,-4.0,0.4331982135772705,138.4629914453678,74,136,-26,1393,467,756,762,55,8.01
7,-3,0,7.0,-3.0,0.43883323669433594,131.03434664239754,74,129,-23,1393,467,756,762,55,8.12
5,-3,0,5.0,-3.0,0.44901537895202637,125.60254774486066,74,124,-20,1393,467,756,762,55,5.95
5,-3,0,5.0,-3.0,0.4552323818206787,120.20815280171308,74,119,-17,1393,467,756,762,55,5.71
5,-2,0,5.0,-2.0,0.46370530128479004,114.9826073804208,74,114,-15,1393,467,756,762,55,6.12
3,-2,0,3.0,-2.0,0.4708232879638672,111.75866856758807,74,111,-13,1393,467,756,762,55,3.92
3,-2,0,3.0,-2.0,0.4804093837738037,108.55873986004075,74,108,-11,1393,467,756,762,55,3.8
3,0,0,3.0,-0.0,0.48685240745544434,105.57461816175325,74,105,-11,1393,467,756,762,55,5.72
3,-2,0,3.0,-2.0,0.49544239044189453,102.39628899525607,74,102,-9,1393,467,756,762,55,3.63
3,-1,0,3.0,-1.0,0.5034692287445068,99.32270636667126,74,99,-8,1393,467,756,762,55,4.55
2,0,0,2.0,-0.0,0.5109083652496338,97.32933781753577,74,97,-8,1393,467,756,762,55,5.31
1,0,0,1.0,-0.0,0.5348873138427734,96.33275663033837,74,96,-8,1393,467,756,762,55,4.71
1,0,0,1.0,-0.0,0.5589354038238525,95.33624704172071,74,95,-8,1393,467,756,762,55,4.69
1,0,0,1.0,-0.0,0.5693364143371582,94.33981132056604,74,94,-8,1393,467,756,762,55,4.67
1,0,0,1.0,-0.0,0.5764703750610352,93.34345183246653,74,93,-8,1393,467,756,762,55,4.65
2,0,0,2.0,-0.0,0.5828793048858643,91.35097153287424,74,91,-8,1393,467,756,762,55,5.16
1,0,0,1.0,-0.0,0.5908262729644775,90.35485598461214,74,90,-8,1393,467,756,762,55,4.59
1,0,0,1.0,-0.0,0.5988242626190186,89.35882720806042,74,89,-8,1393,467,756,762,55,4.57
2,-1,0,2.0,-1.0,0.6068453788757324,87.28115489611719,74,87,-7,1393,467,756,762,55,3.18
2,0,0,2.0,-0.0,0.6148433685302734,85.28774824088158,74,85,-7,1393,467,756,762,55,5.16
3,0,0,3.0,-0.0,0.624678373336792,82.29823813423954,74,82,-7,1393,467,756,762,55,5.56
2,0,0,2.0,-0.0,0.6312403678894043,80.30566605165541,74,80,-7,1393,467,756,762,55,5.02
3,0,0,3.0,-0.0,0.6428673267364502,77.31752712031083,74,77,-7,1393,467,756,762,55,5.39
2,-1,0,2.0,-1.0,0.6472272872924805,75.23961722390672,74,75,-6,1393,467,756,762,55,3.01
4,0,0,4.0,-0.0,0.657609224319458,71.25307010929424,74,71,-6,1393,467,756,762,55,5.77
3,-1,0,3.0,-1.0,0.6635243892669678,68.18357573492314,74,68,-5,1393,467,756,762,55,3.9
4,-1,0,4.0,-1.0,0.6707973480224609,64.1248781675256,74,64,-4,1393,467,756,762,55,4.59
6,-2,0,6.0,-2.0,0.6802253723144531,58.034472514187634,74,58,-2,1393,467,756,762,55,4.43
4,-1,0,4.0,-1.0,0.687718391418457,54.00925846556311,74,54,-1,1393,467,756,762,55,3.99
6,-1,0,6.0,-1.0,0.6948182582855225,48.0,74,48,0,1393,467,756,762,55,4.77
5,-1,0,5.0,-1.0,0.7029414176940918,43.01162633521314,74,43,1,1393,467,756,762,55,3.9
4,-1,0,4.0,-1.0,0.7121543884277344,39.05124837953327,74,39,2,1393,467,756,762,55,3.11
4,-1,0,4.0,-1.0,0.7188563346862793,35.12833614050059,74,35,3,1393,467,756,762,55,2.8
4,0,0,4.0,-0.0,0.726804256439209,31.144823004794873,74,31,3,1393,467,756,762,55,4.36
2,-1,0,2.0,-1.0,0.7348654270172119,29.274562336608895,74,29,4,1393,467,756,762,55,1.46
1,0,0,1.0,-0.0,0.7428562641143799,28.284271247461902,74,28,4,1393,467,756,762,55,3.44
2,0,0,2.0,-0.0,0.7508692741394043,26.30589287593181,74,26,4,1393,467,756,762,55,3.34
1,0,0,1.0,-0.0,0.7613933086395264,25.317977802344327,74,25,4,1393,467,756,762,55,3.24
1,0,0,1.0,-0.0,0.7668204307556152,24.331050121192877,74,24,4,1393,467,756,762,55,3.17
0,0,1,-0.0,-0.0,0.7808554172515869,24.331050121192877,74,24,4,1393,467,756,762,55,34.22
1,-1,1,1.0,-1.0,0.0014050006866455078,1270.3121663591198,75,-1243,262,127,724,1369,463,64,4.51
0,0,0,-0.0,-0.0,0.054431915283203125,1270.3121663591198,75,-1243,262,127,724,1369,463,64,234.89
0,2,0,-0.0,2.0,0.10562992095947266,1269.901177257506,75,-1243,260,127,724,1369,463,64,1.78
0,1,0,-0.0,1.0,0.1160590648651123,1269.696814204084,75,-1243,259,127,724,1369,463,64,1.05
0,1,0,-0.0,1.0,0.12141895294189453,1269.493205968429,75,-1243,258,127,724,1369,463,64,1.05
-1,1,0,-1.0,1.0,0.12975597381591797,1268.3110817145769,75,-1242,257,127,724,1369,463,64,5.67
-1,1,0,-1.0,1.0,0.13742399215698242,1267.1294330099038,75,-1241,256,127,724,1369,463,64,5.66
-1,1,0,-1.0,1.0,0.14587783813476562,1265.9482611860565,75,-1240,255,127,724,1369,463,64,5.66
-1,0,0,-1.0,-0.0,0.15344500541687012,1264.9687743181648,75,-1239,255,127,724,1369,463,64,6.41
-2,1,0,-2.0,1.0,0.16172003746032715,1262.8083781793657,75,-1237,254,127,724,1369,463,64,10.05
-2,2,0,-2.0,2.0,0.16942405700683594,1260.4479362512361,75,-1235,252,127,724,1369,463,64,9.59
-3,1,0,-3.0,1.0,0.17806386947631836,1257.3086335502512,75,-1232,251,127,724,1369,463,64,14.24
-3,1,0,-3.0,1.0,0.1878049373626709,1254.1694462870637,75,-1229,250,127,724,1369,463,64,14.22
-3,1,0,-3.0,1.0,0.19343996047973633,1251.0303753306712,75,-1226,249,127,724,1369,463,64,14.2
-7,1,0,-7.0,1.0,0.20276284217834473,1243.971462695186,75,-1219,248,127,724,1369,463,64,26.87
-7,2,0,-7.0,2.0,0.20956206321716309,1236.713386359184,75,-1212,246,127,724,1369,463,64,27.03
-9,1,0,-9.0,1.0,0.2196638584136963,1227.694587427997,75,-1203,245,127,724,1369,463,64,31.6
-12,2,0,-12.0,2.0,0.22546100616455078,1215.536918402728,75,-1191,243,127,724,1369,463,64,40.49
-16,3,0,-16.0,3.0,0.23842906951904297,1199.2601886162986,75,-1175,240,127,724,1369,463,64,50.42
-18,4,0,-18.0,4.0,0.24151301383972168,1180.823864934987,75,-1157,236,127,724,1369,463,64,54.53
-20,6,0,-20.0,6.0,0.25197887420654297,1160.0297409980487,75,-1137,230,127,724,1369,463,64,56.99
-20,6,0,-20.0,6.0,0.2576279640197754,1139.2387809410282,75,-1117,224,127,724,1369,463,64,56.41
-19,5,0,-19.0,5.0,0.267164945602417,1119.627170088329,75,-1098,219,127,724,1369,463,64,54.16
-26,8,0,-26.0,8.0,0.27887392044067383,1092.5680756822433,75,-1072,211,127,724,1369,463,64,65.85
-35,6,0,-35.0,6.0,0.282451868057251,1057.0685881247252,75,-1037,205,127,724,1369,463,64,78.45
-38,8,0,-38.0,8.0,0.29036498069763184,1018.2386753605463,75,-999,197,127,724,1369,463,64,81.6
-41,8,0,-41.0,8.0,0.2985529899597168,976.4655651890649,75,-958,189,127,724,1369,463,64,83.92
-42,9,0,-42.0,9.0,0.3057899475097656,933.5180769540566,75,-916,180,127,724,1369,463,64,82.12
-45,8,0,-45.0,8.0,0.31459593772888184,887.8203647134932,75,-871,172,127,724,1369,463,64,82.51
-44,7,0,-44.0,7.0,0.3217148780822754,843.2994723109935,75,-827,165,127,724,1369,463,64,78.28
-44,8,0,-44.0,8.0,0.32940006256103516,798.584998606911,75,-783,157,127,724,1369,463,64,76.8
-43,7,0,-43.0,7.0,0.3386838436126709,755.0496672405068,75,-740,150,127,724,1369,463,64,72.52
-40,7,0,-40.0,7.0,0.3459498882293701,714.4571365729367,75,-700,143,127,724,1369,463,64,67.83
-36,7,0,-36.0,7.0,0.3553450107574463,677.7846265592043,75,-664,136,127,724,1369,463,64,62.93
-32,6,0,-32.0,6.0,0.361407995223999,645.2317413147,75,-632,130,127,724,1369,463,64,56.63
-27,6,0,-27.0,6.0,0.37039899826049805,617.5767158823267,75,-605,124,127,724,1369,463,64,50.05
-25,7,0,-25.0,7.0,0.37738704681396484,591.6831922574783,75,-580,117,127,724,1369,463,64,45.29
-22,6,0,-22.0,6.0,0.3867380619049072,568.9332122490301,75,-558,111,127,724,1369,463,64,40.73
-19,6,0,-19.0,6.0,0.3949899673461914,549.1320424087453,75,-539,105,127,724,1369,463,64,35.75
-18,7,0,-18.0,7.0,0.40144896507263184,530.1367748043895,75,-521,98,127,724,1369,463,64,33.37
-16,6,0,-16.0,6.0,0.4124629497528076,513.3117960849916,75,-505,92,127,724,1369,463,64,30.08
-14,6,0,-14.0,6.0,0.4183368682861328,498.47467337869836,75,-491,86,127,724,1369,463,64,26.66
-12,6,0,-12.0,6.0,0.4254188537597656,485.6346363265289,75,-479,80,127,724,1369,463,64,23.26
-12,5,0,-12.0,5.0,0.43341493606567383,472.9841434974327,75,-467,75,127,724,1369,463,64,22.96
-13,6,0,-13.0,6.0,0.44208502769470215,459.2134579909435,75,-454,69,127,724,1369,463,64,23.74
-13,5,0,-13.0,5.0,0.4497559070587158,445.6197930972097,75,-441,64,127,724,1369,463,64,23.39
-13,4,0,-13.0,4.0,0.4573979377746582,432.1851455105786,75,-428,60,127,724,1369,463,64,23.22
-14,4,0,-14.0,4.0,0.46547889709472656,417.77027180018445,75,-414,56,127,724,1369,463,64,24.03
-14,3,0,-14.0,3.0,0.473430871963501,403.49597271843993,75,-400,53,127,724,1369,463,64,24.13
-14,2,0,-14.0,2.0,0.48827505111694336,389.3545941683493,75,-386,51,127,724,1369,463,64,25.43
-16,3,0,-16.0,3.0,0.493833065032959,373.1005226477176,75,-370,48,127,724,1369,463,64,25.53
-17,2,0,-17.0,2.0,0.4974329471588135,355.9845502265513,75,-353,46,127,724,1369,463,64,27.14
-16,2,0,-16.0,2.0,0.5054888725280762,339.8602654032978,75,-337,44,127,724,1369,463,64,25.96
-17,0,0,-17.0,-0.0,0.5135748386383057,323.0108357315587,75,-320,44,127,724,1369,463,64,22.84
-16,1,0,-16.0,1.0,0.5214550495147705,307.02605752606735,75,-304,43,127,724,1369,463,64,22.07
-14,1,0,-14.0,1.0,0.5299479961395264,293.025596151599,75,-290,42,127,724,1369,463,64,19.79
-14,0,0,-14.0,-0.0,0.5375359058380127,279.1773629791642,75,-276,42,127,724,1369,463,64,18.14
-14,1,0,-14.0,1.0,0.545435905456543,265.1886121235224,75,-262,41,127,724,1369,463,64,18.45
-13,0,0,-13.0,-0.0,0.5537738800048828,252.3529274646918,75,-249,41,127,724,1369,463,64,16.09
-12,0,0,-12.0,-0.0,0.5614669322967529,240.52026941611388,75,-237,41,127,724,1369,463,64,14.73
-13,0,0,-13.0,-0.0,0.5724210739135742,227.72132091659753,75,-224,41,127,724,1369,463,64,14.91
-14,0,0,-14.0,-0.0,0.5805058479309082,213.96495040076073,75,-210,41,127,724,1369,463,64,14.94
-14,0,0,-14.0,-0.0,0.5854380130767822,200.24235316236172,75,-196,41,127,724,1369,463,64,14.19
-16,-1,0,-16.0,-1.0,0.593440055847168,184.83506160899236,75,-180,42,127,724,1369,463,64,14.03
-18,-1,0,-18.0,-1.0,0.6016778945922852,167.60966559241146,75,-162,43,127,724,1369,463,64,14.01
-18,-1,0,-18.0,-1.0,0.6106860637664795,150.57224179774968,75,-144,44,127,724,1369,463,64,12.73
-17,0,0,-17.0,-0.0,0.6210050582885742,134.40610105199838,75,-127,44,127,724,1369,463,64,11.43
-14,0,0,-14.0,-0.0,0.625683069229126,121.26417442921878,75,-113,44,127,724,1369,463,64,9.15
-12,0,0,-12.0,-0.0,0.6334400177001953,110.16805344563369,75,-101,44,127,724,1369,463,64,7.54
-9,0,0,-9.0,-0.0,0.6423208713531494,101.9803902718557,75,-92,44,127,724,1369,463,64,5.79
-6,0,0,-6.0,-0.0,0.6540830135345459,96.60227740586657,75,-86,44,127,724,1369,463,64,4.3
-5,0,0,-5.0,-0.0,0.6584508419036865,92.17917335276988,75,-81,44,127,724,1369,463,64,3.7
-1,0,0,-1.0,-0.0,0.6668410301208496,91.30169768410661,75,-80,44,127,724,1369,463,64,2.13
-2,1,0,-2.0,1.0,0.7163169384002686,89.06739021662193,75,-78,43,127,724,1369,463,64,5.97
-2,0,0,-2.0,-0.0,0.7221329212188721,87.32124598286491,75,-76,43,127,724,1369,463,64,2.44
-4,1,0,-4.0,1.0,0.730309009552002,83.35466393669883,75,-72,42,127,724,1369,463,64,4.13
-6,1,0,-6.0,1.0,0.7374298572540283,77.69813382572325,75,-66,41,127,724,1369,463,64,4.15
-7,1,0,-7.0,1.0,0.745405912399292,71.28113354878694,75,-59,40,127,724,1369,463,64,3.97
-9,1,0,-9.0,1.0,0.7536859512329102,63.41135544995076,75,-50,39,127,724,1369,463,64,3.81
-11,1,0,-11.0,1.0,0.7614939212799072,54.45181356024793,75,-39,38,127,724,1369,463,64,3.34
-13,1,0,-13.0,1.0,0.7695350646972656,45.221676218380054,75,-26,37,127,724,1369,463,64,2.46
-12,1,0,-12.0,1.0,0.7788388729095459,38.62641583165593,75,-14,36,127,724,1369,463,64,1.13
-10,1,0,-10.0,1.0,0.7854099273681641,35.22782990761707,75,-4,35,127,724,1369,463,64,-0.03
-9,1,0,-9.0,1.0,0.7935209274291992,34.36568055487916,75,5,34,127,724,1369,463,64,-0.91
-8,0,0,-8.0,-0.0,0.8013908863067627,36.40054944640259,75,13,34,127,724,1369,463,64,-0.9
-6,2,0,-6.0,2.0,0.8093900680541992,37.21558813185679,75,19,32,127,724,1369,463,64,-0.49
-7,0,0,-7.0,-0.0,0.8181109428405762,41.23105625617661,75,26,32,127,724,1369,463,64,-0.44
-4,1,0,-4.0,1.0,0.8254280090332031,43.139309220245984,75,30,31,127,724,1369,463,64,-0.02
-2,1,0,-2.0,1.0,0.8351528644561768,43.86342439892262,75,32,30,127,724,1369,463,64,0.48
-2,0,0,-2.0,-0.0,0.84403395652771,45.34313619501854,75,34,30,127,724,1369,463,64,0.95
-1,1,0,-1.0,1.0,0.8516969680786133,45.45327270945405,75,35,29,127,724,1369,463,64,2.91
-1,1,0,-1.0,1.0,0.8598840236663818,45.60701700396552,75,36,28,127,724,1369,463,64,2.17
0,0,1,-0.0,-0.0,0.8824460506439209,45.60701700396552,75,36,28,127,724,1369,463,64,40.730000000000004
0,0,0,-0.0,-0.0,0.08283042907714844,1074.8144025830693,76,1051,-225,1142,471,91,696,56,214.18
3,0,0,3.0,-0.0,0.17319250106811523,1071.8810568341994,76,1048,-225,1142,471,91,696,56,13.21
6,0,0,6.0,-0.0,0.18095946311950684,1066.0154783116425,76,1042,-225,1142,471,91,696,56,22.44
9,0,0,9.0,-0.0,0.1983184814453125,1057.2199392746998,76,1033,-225,1142,471,91,696,56,30.72
14,-1,0,14.0,-1.0,0.19864940643310547,1043.3297657021005,76,1019,-224,1142,471,91,696,56,43.82
19,0,0,19.0,-0.0,0.20518851280212402,1024.780952203933,76,1000,-224,1142,471,91,696,56,52.9
24,-1,0,24.0,-1.0,0.2135913372039795,1001.1518366361818,76,976,-223,1142,471,91,696,56,61.96
28,0,0,28.0,-0.0,0.22089242935180664,973.8752486843476,76,948,-223,1142,471,91,696,56,66.68
31,-1,0,31.0,-1.0,0.22878050804138184,943.4897985670009,76,917,-222,1142,471,91,696,56,70.26
31,-3,0,31.0,-3.0,0.23680949211120605,912.6647796425585,76,886,-219,1142,471,91,696,56,70.0
34,-4,0,34.0,-4.0,0.25240635871887207,878.7087116900572,76,852,-215,1142,471,91,696,56,72.74
34,-4,0,34.0,-4.0,0.25280237197875977,844.7751180047859,76,818,-211,1142,471,91,696,56,71.01
34,-6,0,34.0,-6.0,0.26128149032592773,810.358562612872,76,784,-205,1142,471,91,696,56,70.53
32,-6,0,32.0,-6.0,0.26876044273376465,777.8849529332728,76,752,-199,1142,471,91,696,56,66.67
32,-6,0,32.0,-6.0,0.27881431579589844,745.4186743032401,76,720,-193,1142,471,91,696,56,64.96
32,-8,0,32.0,-8.0,0.2848184108734131,712.4387692988079,76,688,-185,1142,471,91,696,56,65.39
32,-8,0,32.0,-8.0,0.2961924076080322,679.45934389042,76,656,-177,1142,471,91,696,56,63.57
31,-9,0,31.0,-9.0,0.3015165328979492,647.1854448301507,76,625,-168,1142,471,91,696,56,60.95
34,-11,0,34.0,-11.0,0.31737232208251953,611.4981602588841,76,591,-157,1142,471,91,696,56,61.35
32,-9,0,32.0,-9.0,0.32350850105285645,578.2603220003946,76,559,-148,1142,471,91,696,56,58.2
32,-9,0,32.0,-9.0,0.3247385025024414,545.0229352972221,76,527,-139,1142,471,91,696,56,56.13
32,-10,0,32.0,-10.0,0.3333883285522461,511.53299013846606,76,495,-129,1142,471,91,696,56,53.15
32,-9,0,32.0,-9.0,0.34072351455688477,478.29802424848043,76,463,-120,1142,471,91,696,56,51.65
32,-11,0,32.0,-11.0,0.350461483001709,444.56945464122924,76,431,-109,1142,471,91,696,56,48.19
35,-12,0,35.0,-12.0,0.3573794364929199,407.7070026379238,76,396,-97,1142,471,91,696,56,47.78
33,-11,0,33.0,-11.0,0.36476850509643555,373.048254251377,76,363,-86,1142,471,91,696,56,43.58
28,-9,0,28.0,-9.0,0.37279534339904785,343.73536332475305,76,335,-77,1142,471,91,696,56,37.58
24,-6,0,24.0,-6.0,0.3817875385284424,319.0015673942685,76,311,-71,1142,471,91,696,56,33.97
23,-4,0,23.0,-4.0,0.3904683589935303,295.6907167971291,76,288,-67,1142,471,91,696,56,30.22
20,-4,0,20.0,-4.0,0.3977384567260742,275.30528509274933,76,268,-63,1142,471,91,696,56,27.23
20,-4,0,20.0,-4.0,0.40508031845092773,254.9215565620138,76,248,-59,1142,471,91,696,56,25.88
18,-4,0,18.0,-4.0,0.41295433044433594,236.48467180770933,76,230,-55,1142,471,91,696,56,24.11
15,-4,0,15.0,-4.0,0.4207484722137451,220.9660607423683,76,215,-51,1142,471,91,696,56,20.49
14,-3,0,14.0,-3.0,0.4291994571685791,206.65188119153427,76,201,-48,1142,471,91,696,56,18.99
11,-3,0,11.0,-3.0,0.43675732612609863,195.25624189766637,76,190,-45,1142,471,91,696,56,15.82
10,-3,0,10.0,-3.0,0.445157527923584,184.83506160899236,76,180,-42,1142,471,91,696,56,13.92
11,-3,0,11.0,-3.0,0.45412254333496094,173.44163283364233,76,169,-39,1142,471,91,696,56,14.67
8,-2,0,8.0,-2.0,0.4609675407409668,165.19685227025363,76,161,-37,1142,471,91,696,56,12.76
9,-2,0,9.0,-2.0,0.4688425064086914,155.97756248896826,76,152,-35,1142,471,91,696,56,13.8
9,-3,0,9.0,-3.0,0.47823047637939453,146.53668482670133,76,143,-32,1142,471,91,696,56,11.0
10,-2,0,10.0,-2.0,0.4855635166168213,136.34148304899725,76,133,-30,1142,471,91,696,56,12.71
10,-2,0,10.0,-2.0,0.4935624599456787,126.14673994994877,76,123,-28,1142,471,91,696,56,12.17
9,-1,0,9.0,-1.0,0.5094795227050781,117.15374513859982,76,114,-27,1142,471,91,696,56,9.25
11,-1,0,11.0,-1.0,0.5098755359649658,106.23088063270491,76,103,-26,1142,471,91,696,56,9.38
10,-1,0,10.0,-1.0,0.5167675018310547,96.30160954002794,76,93,-25,1142,471,91,696,56,8.36
8,-1,0,8.0,-1.0,0.5248804092407227,88.32326986700618,76,85,-24,1142,471,91,696,56,7.23
7,-1,0,7.0,-1.0,0.5332434177398682,81.32035415564789,76,78,-23,1142,471,91,696,56,6.58
6,-1,0,6.0,-1.0,0.5410864353179932,75.28612089887484,76,72,-22,1142,471,91,696,56,6.09
5,-1,0,5.0,-1.0,0.5488224029541016,70.21395872616783,76,67,-21,1142,471,91,696,56,5.83
5,0,0,5.0,-0.0,0.55857253074646,65.45991139621256,76,62,-21,1142,471,91,696,56,4.02
3,-1,0,3.0,-1.0,0.5663354396820068,62.297672508690084,76,59,-20,1142,471,91,696,56,7.7
4,-1,0,4.0,-1.0,0.5727963447570801,58.18934610390462,76,55,-19,1142,471,91,696,56,5.38
5,-1,0,5.0,-1.0,0.5808954238891602,53.14132102234569,76,50,-18,1142,471,91,696,56,4.81
4,-1,0,4.0,-1.0,0.59466552734375,49.040799340956916,76,46,-17,1142,471,91,696,56,4.82
4,0,0,4.0,-0.0,0.5972893238067627,45.31004303683677,76,42,-17,1142,471,91,696,56,2.86
5,-1,0,5.0,-1.0,0.6047964096069336,40.311288741492746,76,37,-16,1142,471,91,696,56,3.83
5,-1,0,5.0,-1.0,0.6127803325653076,35.34119409414458,76,32,-15,1142,471,91,696,56,3.43
5,-1,0,5.0,-1.0,0.6209344863891602,30.4138126514911,76,27,-14,1142,471,91,696,56,2.98
3,-1,0,3.0,-1.0,0.6301214694976807,27.294688127912362,76,24,-13,1142,471,91,696,56,3.27
3,-1,0,3.0,-1.0,0.6400213241577148,24.186773244895647,76,21,-12,1142,471,91,696,56,2.98
3,-1,0,3.0,-1.0,0.6457624435424805,21.095023109728988,76,18,-11,1142,471,91,696,56,2.65
2,-1,0,2.0,-1.0,0.653395414352417,18.867962264113206,76,16,-10,1142,471,91,696,56,3.71
3,-1,0,3.0,-1.0,0.6618623733520508,15.811388300841896,76,13,-9,1142,471,91,696,56,2.05
2,0,0,2.0,-0.0,0.6690125465393066,14.212670403551895,76,11,-9,1142,471,91,696,56,0.7
0,-1,0,-0.0,-1.0,0.6767325401306152,13.601470508735444,76,11,-8,1142,471,91,696,56,0.4
1,0,0,1.0,-0.0,0.6860125064849854,12.806248474865697,76,10,-8,1142,471,91,696,56,0.86
0,0,1,-0.0,-0.0,0.7127983570098877,12.806248474865697,76,10,-8,1142,471,91,696,56,30.72
0,0,0,-0.0,-0.0,0.06365370750427246,594.3778259659423,77,-559,-202,573,277,1132,479,36,150.88
0,1,0,-0.0,1.0,0.08993172645568848,594.718420767341,77,-559,-203,573,277,1132,479,36,11.35
0,1,0,-0.0,1.0,0.09694266319274902,595.0605011257259,77,-559,-204,573,277,1132,479,36,11.32
-1,1,0,-1.0,1.0,0.10466575622558594,594.465305968313,77,-558,-205,573,277,1132,479,36,2.92
-1,1,0,-1.0,1.0,0.1206967830657959,593.8728820210601,77,-557,-206,573,277,1132,479,36,2.9
-2,1,0,-2.0,1.0,0.15360665321350098,592.346182565567,77,-555,-207,573,277,1132,479,36,6.87
-2,2,0,-2.0,2.0,0.16088080406188965,591.1767925079604,77,-553,-209,573,277,1132,479,36,5.06
-3,2,0,-3.0,2.0,0.1720736026763916,589.0848835269837,77,-550,-211,573,277,1132,479,36,8.65
-5,2,0,-5.0,2.0,0.17739367485046387,585.1444266161988,77,-545,-213,573,277,1132,479,36,15.16
-5,2,0,-5.0,2.0,0.1860036849975586,581.2271500885003,77,-540,-215,573,277,1132,479,36,15.02
-6,2,0,-6.0,2.0,0.1926267147064209,576.4069742811931,77,-534,-217,573,277,1132,479,36,17.84
-7,2,0,-7.0,2.0,0.20066165924072266,570.6925617177782,77,-527,-219,573,277,1132,479,36,20.44
-8,0,0,-8.0,-0.0,0.2094707489013672,563.3134118765503,77,-519,-219,573,277,1132,479,36,25.6
-7,1,0,-7.0,1.0,0.21693158149719238,557.2647485710899,77,-512,-220,573,277,1132,479,36,21.38
-8,0,0,-8.0,-0.0,0.22551679611206055,549.9236310616229,77,-504,-220,573,277,1132,479,36,25.08
-6,0,0,-6.0,-0.0,0.23267674446105957,544.4299771320459,77,-498,-220,573,277,1132,479,36,19.91
-7,0,0,-7.0,-0.0,0.24071979522705078,538.0343855182492,77,-491,-220,573,277,1132,479,36,22.23
-6,-2,0,-6.0,-2.0,0.25002169609069824,531.741478540089,77,-485,-218,573,277,1132,479,36,23.71
-7,-2,0,-7.0,-2.0,0.25820159912109375,524.5378918629235,77,-478,-216,573,277,1132,479,36,25.42
-6,-3,0,-6.0,-3.0,0.26467370986938477,517.8349157791506,77,-472,-213,573,277,1132,479,36,25.5
-7,-4,0,-7.0,-4.0,0.2726297378540039,509.8097684430929,77,-465,-209,573,277,1132,479,36,27.54
-8,-5,0,-8.0,-5.0,0.28222179412841797,500.46478397585577,77,-457,-204,573,277,1132,479,36,29.82
-9,-4,0,-9.0,-4.0,0.2895777225494385,490.61593940678284,77,-448,-200,573,277,1132,479,36,33.79
-13,-8,0,-13.0,-8.0,0.2973926067352295,475.4881701998484,77,-435,-192,573,277,1132,479,36,40.0
-19,-9,0,-19.0,-9.0,0.3046395778656006,454.47222137332,77,-416,-183,573,277,1132,479,36,49.43
-20,-10,0,-20.0,-10.0,0.31522464752197266,432.1400236034612,77,-396,-173,573,277,1132,479,36,48.88
-21,-10,0,-21.0,-10.0,0.32218480110168457,408.89362919957557,77,-375,-163,573,277,1132,479,36,48.71
-23,-11,0,-23.0,-11.0,0.3288846015930176,383.4162229222963,77,-352,-152,573,277,1132,479,36,48.98
-23,-11,0,-23.0,-11.0,0.3367187976837158,357.9413359756037,77,-329,-141,573,277,1132,479,36,46.78
-23,-11,0,-23.0,-11.0,0.3446187973022461,332.46954747766,77,-306,-130,573,277,1132,479,36,44.5
-22,-11,0,-22.0,-11.0,0.35293078422546387,307.92369184588574,77,-284,-119,573,277,1132,479,36,41.03
-18,-11,0,-18.0,-11.0,0.3606717586517334,287.08883642524313,77,-266,-108,573,277,1132,479,36,34.68
-15,-10,0,-15.0,-10.0,0.3692176342010498,269.45314991664134,77,-251,-98,573,277,1132,479,36,29.75
-13,-8,0,-13.0,-8.0,0.377652645111084,254.44842306447882,77,-238,-90,573,277,1132,479,36,26.08
-10,-6,0,-10.0,-6.0,0.3846735954284668,242.98148077579904,77,-228,-84,573,277,1132,479,36,21.33
-9,-6,0,-9.0,-6.0,0.3927187919616699,232.47580519271247,77,-219,-78,573,277,1132,479,36,19.2
-9,-5,0,-9.0,-5.0,0.40062379837036133,222.32633672149595,77,-210,-73,573,277,1132,479,36,18.71
-9,-4,0,-9.0,-4.0,0.4086117744445801,212.51352898109803,77,-201,-69,573,277,1132,479,36,18.67
-9,-5,0,-9.0,-5.0,0.4173545837402344,202.3857702507763,77,-192,-64,573,277,1132,479,36,17.48
-8,-3,0,-8.0,-3.0,0.42562174797058105,193.84787850270635,77,-184,-61,573,277,1132,479,36,17.19
-6,-3,0,-6.0,-3.0,0.4328486919403076,187.21111078138497,77,-178,-58,573,277,1132,479,36,12.98
-7,-3,0,-7.0,-3.0,0.44063258171081543,179.62739212046696,77,-171,-55,573,277,1132,479,36,14.36
-8,-4,0,-8.0,-4.0,0.4490985870361328,170.79227148791014,77,-163,-51,573,277,1132,479,36,14.56
-8,-3,0,-8.0,-3.0,0.45699262619018555,162.2621335986927,77,-155,-48,573,277,1132,479,36,15.1
-6,-3,0,-6.0,-3.0,0.4647376537322998,155.64703659241314,77,-149,-45,573,277,1132,479,36,11.44
-7,-3,0,-7.0,-3.0,0.4761507511138916,148.08105888330215,77,-142,-42,573,277,1132,479,36,12.55
-5,-3,0,-5.0,-3.0,0.480968713760376,142.44297104455524,77,-137,-39,573,277,1132,479,36,9.29
-7,-3,0,-7.0,-3.0,0.48946261405944824,134.892549831338,77,-130,-36,573,277,1132,479,36,11.69
-9,-3,0,-9.0,-3.0,0.4973926544189453,125.41929676090518,77,-121,-33,573,277,1132,479,36,13.9
-8,-3,0,-8.0,-3.0,0.5046327114105225,116.91449867317569,77,-113,-30,573,277,1132,479,36,11.92
-9,-3,0,-9.0,-3.0,0.512697696685791,107.44766167767449,77,-104,-27,573,277,1132,479,36,12.53
-8,-3,0,-8.0,-3.0,0.5225977897644043,98.95453501482385,77,-96,-24,573,277,1132,479,36,10.67
-6,-2,0,-6.0,-2.0,0.5298926830291748,92.64987857520376,77,-90,-22,573,277,1132,479,36,9.26
-7,-2,0,-7.0,-2.0,0.5395617485046387,85.37564055396598,77,-83,-20,573,277,1132,479,36,10.35
-5,-1,0,-5.0,-1.0,0.5464956760406494,80.2807573457052,77,-78,-19,573,277,1132,479,36,8.7
-6,-2,0,-6.0,-2.0,0.5526885986328125,73.97972695272672,77,-72,-17,573,277,1132,479,36,8.22
-5,-2,0,-5.0,-2.0,0.5609216690063477,68.65857557508748,77,-67,-15,573,277,1132,479,36,6.63
-5,-1,0,-5.0,-1.0,0.5711417198181152,63.56099432828282,77,-62,-14,573,277,1132,479,36,8.56
-5,-1,0,-5.0,-1.0,0.5771677494049072,58.463663928973865,77,-57,-13,573,277,1132,479,36,8.25
-4,-1,0,-4.0,-1.0,0.5846707820892334,54.3415126767741,77,-53,-12,573,277,1132,479,36,7.76
-3,-1,0,-3.0,-1.0,0.5934607982635498,51.19570294468082,77,-50,-11,573,277,1132,479,36,5.37
-2,-1,0,-2.0,-1.0,0.6006367206573486,49.03060268852505,77,-48,-10,573,277,1132,479,36,3.64
-3,0,0,-3.0,-0.0,0.6086835861206055,46.09772228646444,77,-45,-10,573,277,1132,479,36,4.12
-1,-1,0,-1.0,-1.0,0.6166806221008301,44.91102314577124,77,-44,-9,573,277,1132,479,36,1.97
-2,0,0,-2.0,-0.0,0.6246957778930664,42.95346318982906,77,-42,-9,573,277,1132,479,36,3.68
-1,0,0,-1.0,-0.0,0.6407437324523926,41.97618372363071,77,-41,-9,573,277,1132,479,36,3.26
-2,0,0,-2.0,-0.0,0.6408777236938477,40.024992192379,77,-39,-9,573,277,1132,479,36,3.51
-3,-1,0,-3.0,-1.0,0.6506407260894775,36.87817782917155,77,-36,-8,573,277,1132,479,36,4.89
-2,0,0,-2.0,-0.0,0.6566567420959473,34.92849839314596,77,-34,-8,573,277,1132,479,36,3.35
-1,0,0,-1.0,-0.0,0.665644645690918,33.95585369269929,77,-33,-8,573,277,1132,479,36,3.01
-1,-1,0,-1.0,-1.0,0.6728987693786621,32.7566787083184,77,-32,-7,573,277,1132,479,36,1.79
-1,0,0,-1.0,-0.0,0.680640697479248,31.78049716414141,77,-31,-7,573,277,1132,479,36,3.06
0,0,1,-0.0,-0.0,0.6916396617889404,31.78049716414141,77,-31,-7,573,277,1132,479,36,36.5
0,0,0,-0.0,-0.0,0.08700966835021973,1069.483052694151,78,737,775,1341,1059,604,284,64,213.58
2,3,0,2.0,3.0,0.23362374305725098,1065.9310484266794,78,735,772,1341,1059,604,284,64,14.02
6,5,0,6.0,5.0,0.24102568626403809,1058.1729537273195,78,729,767,1341,1059,604,284,64,25.86
5,5,0,5.0,5.0,0.2510967254638672,1051.104181325524,78,724,762,1341,1059,604,284,64,25.67
9,6,0,9.0,6.0,0.25697875022888184,1040.558023370153,78,715,756,1341,1059,604,284,64,31.54
11,9,0,11.0,9.0,0.2673037052154541,1026.4623714486568,78,704,747,1341,1059,604,284,64,39.89
14,9,0,14.0,9.0,0.2729637622833252,1010.3187615797303,78,690,738,1341,1059,604,284,64,42.86
18,12,0,18.0,12.0,0.28200864791870117,989.2724599421537,78,672,726,1341,1059,604,284,64,51.48
20,14,0,20.0,14.0,0.28899574279785156,965.4263306954084,78,652,712,1341,1059,604,284,64,55.52
25,20,0,25.0,20.0,0.29699277877807617,933.8056542985805,78,627,692,1341,1059,604,284,64,66.14
26,20,0,26.0,20.0,0.30646777153015137,901.5458945611144,78,601,672,1341,1059,604,284,64,65.45
26,21,0,26.0,21.0,0.3131246566772461,868.5769971626004,78,575,651,1341,1059,604,284,64,65.06
27,22,0,27.0,22.0,0.321225643157959,834.2331808313548,78,548,629,1341,1059,604,284,64,65.16
27,23,0,27.0,23.0,0.3289916515350342,799.1726972313306,78,521,606,1341,1059,604,284,64,64.46
29,24,0,29.0,24.0,0.3373417854309082,762.0944823314233,78,492,582,1341,1059,604,284,64,64.64
29,25,0,29.0,25.0,0.35042572021484375,724.3051842973375,78,463,557,1341,1059,604,284,64,63.5
29,25,0,29.0,25.0,0.3530247211456299,686.5711907733968,78,434,532,1341,1059,604,284,64,61.34
31,27,0,31.0,27.0,0.36100077629089355,646.0913248140699,78,403,505,1341,1059,604,284,64,61.53
27,26,0,27.0,26.0,0.36910271644592285,608.9474525769855,78,376,479,1341,1059,604,284,64,56.74
25,26,0,25.0,26.0,0.37699270248413086,573.0706762695156,78,351,453,1341,1059,604,284,64,53.86
23,29,0,23.0,29.0,0.38517260551452637,536.0596981680305,78,328,424,1341,1059,604,284,64,54.97
21,29,0,21.0,29.0,0.39374470710754395,500.2739249651135,78,307,395,1341,1059,604,284,64,50.77
20,31,0,20.0,31.0,0.40584468841552734,463.5353276720125,78,287,364,1341,1059,604,284,64,47.92
18,33,0,18.0,33.0,0.4100337028503418,426.5231529471759,78,269,331,1341,1059,604,284,64,44.73
17,32,0,17.0,32.0,0.4174678325653076,391.0306893326916,78,252,299,1341,1059,604,284,64,40.98
16,32,0,16.0,32.0,0.42504167556762695,356.3495474951526,78,236,267,1341,1059,604,284,64,37.67
15,29,0,15.0,29.0,0.4329957962036133,324.7845439672276,78,221,238,1341,1059,604,284,64,33.32
13,27,0,13.0,27.0,0.4416067600250244,296.2853354454115,78,208,211,1341,1059,604,284,64,29.05
12,24,0,12.0,24.0,0.44902968406677246,270.8966592632696,78,196,187,1341,1059,604,284,64,25.25
11,23,0,11.0,23.0,0.45705080032348633,247.226616690032,78,185,164,1341,1059,604,284,64,22.39
10,20,0,10.0,20.0,0.46500372886657715,226.62965384079817,78,175,144,1341,1059,604,284,64,19.09
10,19,0,10.0,19.0,0.47315382957458496,207.0024154448445,78,165,125,1341,1059,604,284,64,17.24
9,17,0,9.0,17.0,0.4851267337799072,189.73665961010275,78,156,108,1341,1059,604,284,64,14.69
8,14,0,8.0,14.0,0.4890587329864502,175.32826355154492,78,148,94,1341,1059,604,284,64,12.2
6,13,0,6.0,13.0,0.4969806671142578,163.47782724271815,78,142,81,1341,1059,604,284,64,9.74
7,11,0,7.0,11.0,0.5113246440887451,152.0690632574555,78,135,70,1341,1059,604,284,64,9.23
6,10,0,6.0,10.0,0.5186946392059326,142.2708684165525,78,129,60,1341,1059,604,284,64,7.72
7,9,0,7.0,9.0,0.5209977626800537,132.23085872821065,78,122,51,1341,1059,604,284,64,7.67
8,8,0,8.0,8.0,0.5299878120422363,121.8400590938793,78,114,43,1341,1059,604,284,64,7.69
8,8,0,8.0,8.0,0.5434436798095703,111.6288493177279,78,106,35,1341,1059,604,284,64,7.02
10,8,0,10.0,8.0,0.545529842376709,99.72462083156798,78,96,27,1341,1059,604,284,64,7.39
9,8,0,9.0,8.0,0.5531256198883057,89.05054744357274,78,87,19,1341,1059,604,284,64,6.02
10,7,0,10.0,7.0,0.5609836578369141,77.92945527847606,78,77,12,1341,1059,604,284,64,5.79
11,8,0,11.0,8.0,0.5703277587890625,66.12110101926616,78,66,4,1341,1059,604,284,64,5.01
12,7,0,12.0,7.0,0.5769777297973633,54.08326913195984,78,54,-3,1341,1059,604,284,64,4.31
10,6,0,10.0,6.0,0.585418701171875,44.91102314577124,78,44,-9,1341,1059,604,284,64,2.74
10,4,0,10.0,4.0,0.59326171875,36.40054944640259,78,34,-13,1341,1059,604,284,64,2.14
7,2,0,7.0,2.0,0.6013357639312744,30.886890422961002,78,27,-15,1341,1059,604,284,64,1.3
4,1,0,4.0,1.0,0.6090297698974609,28.0178514522438,78,23,-16,1341,1059,604,284,64,0.78
1,1,0,1.0,1.0,0.6172347068786621,27.80287754891569,78,22,-17,1341,1059,604,284,64,-0.07
0,-1,0,-0.0,-1.0,0.6431906223297119,27.202941017470888,78,22,-16,1341,1059,604,284,64,0.69
0,-1,0,-0.0,-1.0,0.6507186889648438,26.627053911388696,78,22,-15,1341,1059,604,284,64,0.63
0,-1,0,-0.0,-1.0,0.6570117473602295,26.076809620810597,78,22,-14,1341,1059,604,284,64,0.57
1,0,0,1.0,-0.0,0.6665966510772705,25.238858928247925,78,21,-14,1341,1059,604,284,64,1.36
1,0,0,1.0,-0.0,0.6892526149749756,24.413111231467404,78,20,-14,1341,1059,604,284,64,1.29
1,-1,0,1.0,-1.0,0.699852705001831,23.021728866442675,78,19,-13,1341,1059,604,284,64,2.91
0,0,1,-0.0,-0.0,0.7410116195678711,23.021728866442675,78,19,-13,1341,1059,604,284,64,33.82
0,0,0,-0.0,-0.0,0.10053539276123047,720.1090195241273,79,-549,-466,773,606,1322,1072,44,169.66
-2,0,0,-2.0,-0.0,0.1156153678894043,718.585415938843,79,-547,-466,773,606,1322,1072,44,6.69
-3,-2,0,-3.0,-2.0,0.12352538108825684,715.0048950881386,79,-544,-464,773,606,1322,1072,44,15.84
-5,-4,0,-5.0,-4.0,0.13150453567504883,708.6049675242194,79,-539,-460,773,606,1322,1072,44,25.57
-7,-5,0,-7.0,-5.0,0.14280152320861816,700.0349991250438,79,-532,-455,773,606,1322,1072,44,30.04
-7,-7,0,-7.0,-7.0,0.1477375030517578,690.1659220796113,79,-525,-448,773,606,1322,1072,44,33.11
-8,-6,0,-8.0,-6.0,0.1555624008178711,680.1860039724428,79,-517,-442,773,606,1322,1072,44,33.36
-6,-4,0,-6.0,-4.0,0.16350436210632324,673.0267453823808,79,-511,-438,773,606,1322,1072,44,25.41
-6,-5,0,-6.0,-5.0,0.17340350151062012,665.2172577436638,79,-505,-433,773,606,1322,1072,44,29.1
-7,-5,0,-7.0,-5.0,0.17961335182189941,656.6490691381508,79,-498,-428,773,606,1322,1072,44,28.96
-8,-7,0,-8.0,-7.0,0.18751931190490723,646.0193495554139,79,-490,-421,773,606,1322,1072,44,35.59
-9,-6,0,-9.0,-6.0,0.19550251960754395,635.2841883755647,79,-481,-415,773,606,1322,1072,44,32.98
-10,-8,0,-10.0,-8.0,0.20380139350891113,622.4869476543263,79,-471,-407,773,606,1322,1072,44,38.29
-12,-9,0,-12.0,-9.0,0.21161437034606934,607.5236620906218,79,-459,-398,773,606,1322,1072,44,41.2
-15,-11,0,-15.0,-11.0,0.21987652778625488,588.9864175004378,79,-444,-387,773,606,1322,1072,44,46.31
-17,-14,0,-17.0,-14.0,0.2280423641204834,566.9726624802998,79,-427,-373,773,606,1322,1072,44,51.59
-19,-15,0,-19.0,-15.0,0.2425994873046875,542.7964627740309,79,-408,-358,773,606,1322,1072,44,52.48
-21,-18,0,-21.0,-18.0,0.24997448921203613,515.139786854015,79,-387,-340,773,606,1322,1072,44,56.3
-22,-21,0,-22.0,-21.0,0.2568223476409912,484.75354562911656,79,-365,-319,773,606,1322,1072,44,55.85
-27,-24,0,-27.0,-24.0,0.25953054428100586,448.63013719544074,79,-338,-295,773,606,1322,1072,44,59.67
-26,-24,0,-26.0,-24.0,0.2696244716644287,413.26141847503743,79,-312,-271,773,606,1322,1072,44,55.04
-31,-23,0,-31.0,-23.0,0.27551937103271484,374.78660595063957,79,-281,-248,773,606,1322,1072,44,52.62
-28,-21,0,-28.0,-21.0,0.2869224548339844,339.90881130091344,79,-253,-227,773,606,1322,1072,44,46.9
-26,-19,0,-26.0,-19.0,0.2939434051513672,307.88471868541967,79,-227,-208,773,606,1322,1072,44,41.69
-24,-18,0,-24.0,-18.0,0.3059964179992676,278.044960393099,79,-203,-190,773,606,1322,1072,44,37.49
-23,-16,0,-23.0,-16.0,0.3087763786315918,250.3517525403008,79,-180,-174,773,606,1322,1072,44,33.0
-21,-15,0,-21.0,-15.0,0.31551337242126465,224.8599564173221,79,-159,-159,773,606,1322,1072,44,29.21
-22,-16,0,-22.0,-16.0,0.33473753929138184,198.0353503796734,79,-137,-143,773,606,1322,1072,44,27.39
-17,-13,0,-17.0,-13.0,0.3348734378814697,176.91806012954132,79,-120,-130,773,606,1322,1072,44,22.15
-16,-12,0,-16.0,-12.0,0.33954954147338867,157.2895419282541,79,-104,-118,773,606,1322,1072,44,19.34
-12,-11,0,-12.0,-11.0,0.35744142532348633,141.1134295522577,79,-92,-107,773,606,1322,1072,44,16.75
-11,-10,0,-11.0,-10.0,0.3580944538116455,126.37246535539299,79,-81,-97,773,606,1322,1072,44,14.6
-10,-10,0,-10.0,-10.0,0.3669295310974121,112.29425630903836,79,-71,-87,773,606,1322,1072,44,13.61
-9,-9,0,-9.0,-9.0,0.37241649627685547,99.6393496566492,79,-62,-78,773,606,1322,1072,44,11.8
-8,-7,0,-8.0,-7.0,0.3796215057373047,89.20201791439474,79,-54,-71,773,606,1322,1072,44,9.21
-7,-7,0,-7.0,-7.0,0.388655424118042,79.40403012442127,79,-47,-64,773,606,1322,1072,44,8.69
-6,-6,0,-6.0,-6.0,0.39585232734680176,71.02816342831905,79,-41,-58,773,606,1322,1072,44,7.4
-5,-5,0,-5.0,-5.0,0.4041464328765869,64.07027391856539,79,-36,-53,773,606,1322,1072,44,6.28
-4,-4,0,-4.0,-4.0,0.41362738609313965,58.52349955359813,79,-32,-49,773,606,1322,1072,44,5.31
-4,-3,0,-4.0,-3.0,0.42453837394714355,53.85164807134504,79,-28,-46,773,606,1322,1072,44,3.91
-4,-4,0,-4.0,-4.0,0.4318723678588867,48.373546489791295,79,-24,-42,773,606,1322,1072,44,4.47
-5,-5,0,-5.0,-5.0,0.43549251556396484,41.593268686170845,79,-19,-37,773,606,1322,1072,44,4.31
-5,-4,0,-5.0,-4.0,0.44449448585510254,35.84689665786984,79,-14,-33,773,606,1322,1072,44,3.01
-3,-3,0,-3.0,-3.0,0.4541764259338379,31.953090617340916,79,-11,-30,773,606,1322,1072,44,2.57
-2,-2,0,-2.0,-2.0,0.46059131622314453,29.410882339705484,79,-9,-28,773,606,1322,1072,44,2.07
-2,-2,0,-2.0,-2.0,0.46822547912597656,26.92582403567252,79,-7,-26,773,606,1322,1072,44,1.83
-1,-1,0,-1.0,-1.0,0.47550249099731445,25.709920264364882,79,-6,-25,773,606,1322,1072,44,1.58
-1,0,0,-1.0,-0.0,0.49953436851501465,25.495097567963924,79,-5,-25,773,606,1322,1072,44,0.1
0,-1,0,-0.0,-1.0,0.5097525119781494,24.515301344262525,79,-5,-24,773,606,1322,1072,44,2.95
-2,-1,0,-2.0,-1.0,0.5265083312988281,23.194827009486403,79,-3,-23,773,606,1322,1072,44,0.56
-1,-2,0,-1.0,-2.0,0.53175950050354,21.095023109728988,79,-2,-21,773,606,1322,1072,44,2.08
-1,-1,0,-1.0,-1.0,0.5414295196533203,20.024984394500787,79,-1,-20,773,606,1322,1072,44,0.98
-1,0,0,-1.0,-0.0,0.5475044250488281,20.0,79,0,-20,773,606,1322,1072,44,-0.21
0,0,1,-0.0,-0.0,0.5855255126953125,452.21676218380054,80,-260,-370,513,256,773,626,61,126.9
0,0,0,-0.0,-0.0,0.10808658599853516,452.21676218380054,80,-260,-370,513,256,773,626,61,126.9
2,2,0,2.0,2.0,0.11958861351013184,455.0032966913537,80,-262,-372,513,256,773,626,61,3.82
2,2,0,2.0,2.0,0.12655258178710938,457.7903450270659,80,-264,-374,513,256,773,626,61,3.84
4,1,0,4.0,1.0,0.1393115520477295,460.92190227846623,80,-268,-375,513,256,773,626,61,1.78
3,2,0,3.0,2.0,0.1423647403717041,464.29516473898366,80,-271,-377,513,256,773,626,61,2.69
5,1,0,5.0,1.0,0.150634765625,468.03845995815345,80,-276,-378,513,256,773,626,61,1.59
5,2,0,5.0,2.0,0.16166973114013672,472.6108335618218,80,-281,-380,513,256,773,626,61,1.9
7,1,0,7.0,1.0,0.16776561737060547,477.60339194775406,80,-288,-381,513,256,773,626,61,1.34
6,2,0,6.0,2.0,0.17309975624084473,482.83019789569914,80,-294,-383,513,256,773,626,61,1.72
7,0,0,7.0,-0.0,0.18110871315002441,487.1242141384474,80,-301,-383,513,256,773,626,61,1.22
7,1,0,7.0,1.0,0.18906664848327637,492.26009385283305,80,-308,-384,513,256,773,626,61,1.39
7,0,0,7.0,-0.0,0.1986377239227295,496.6699105039483,80,-315,-384,513,256,773,626,61,1.25
6,-3,0,6.0,-3.0,0.20575857162475586,498.1987555183172,80,-321,-381,513,256,773,626,61,1.58
6,-4,0,6.0,-4.0,0.21309566497802734,499.05711096025874,80,-327,-377,513,256,773,626,61,2.52
6,-5,0,6.0,-5.0,0.22123265266418457,499.2724707011193,80,-333,-372,513,256,773,626,61,9.11
6,-7,0,6.0,-7.0,0.230987548828125,498.1425498790482,80,-339,-365,513,256,773,626,61,2.42
5,-7,0,5.0,-7.0,0.23793673515319824,496.4876634922564,80,-344,-358,513,256,773,626,61,3.55
3,-8,0,3.0,-8.0,0.24521160125732422,492.8579917176955,80,-347,-350,513,256,773,626,61,7.59
2,-9,0,2.0,-9.0,0.25313663482666016,487.9364712746937,80,-349,-341,513,256,773,626,61,10.02
0,-12,0,-0.0,-12.0,0.261096715927124,479.6269383593878,80,-349,-329,513,256,773,626,61,15.82
0,-14,0,-0.0,-14.0,0.270871639251709,470.1340234443791,80,-349,-315,513,256,773,626,61,17.36
-3,-17,0,-3.0,-17.0,0.2776145935058594,456.6399018920707,80,-346,-298,513,256,773,626,61,22.87
-5,-17,0,-5.0,-17.0,0.28524160385131836,441.86196939768416,80,-341,-281,513,256,773,626,61,24.19
-9,-16,0,-9.0,-16.0,0.2945685386657715,424.79289071263895,80,-332,-265,513,256,773,626,61,26.88
-11,-14,0,-11.0,-14.0,0.3027946949005127,407.4825149622987,80,-321,-251,513,256,773,626,61,27.07
-13,-14,0,-13.0,-14.0,0.3218085765838623,388.6296437483893,80,-308,-237,513,256,773,626,61,28.36
-13,-13,0,-13.0,-13.0,0.3221285343170166,370.4065334197009,80,-295,-224,513,256,773,626,61,27.15
-14,-12,0,-14.0,-12.0,0.32573461532592773,352.00142045167945,80,-281,-212,513,256,773,626,61,27.45
-14,-12,0,-14.0,-12.0,0.33519673347473145,333.600059952033,80,-267,-200,513,256,773,626,61,26.49
-16,-12,0,-16.0,-12.0,0.34108567237854004,313.6000637755037,80,-251,-188,513,256,773,626,61,29.56
-15,-11,0,-15.0,-11.0,0.3497655391693115,295.0,80,-236,-177,513,256,773,626,61,26.51
-12,-11,0,-12.0,-11.0,0.3574047088623047,278.8045910669335,80,-224,-166,513,256,773,626,61,21.28
-12,-9,0,-12.0,-9.0,0.3661837577819824,263.80485211610494,80,-212,-157,513,256,773,626,61,22.27
-10,-8,0,-10.0,-8.0,0.37311863899230957,251.00796800101784,80,-202,-149,513,256,773,626,61,18.31
-8,-8,0,-8.0,-8.0,0.3854837417602539,239.82702099638396,80,-194,-141,513,256,773,626,61,14.75
-10,-9,0,-10.0,-9.0,0.39237356185913086,226.45087767549057,80,-184,-132,513,256,773,626,61,16.47
-10,-9,0,-10.0,-9.0,0.4007687568664551,213.08449028495716,80,-174,-123,513,256,773,626,61,15.78
-10,-7,0,-10.0,-7.0,0.40512776374816895,200.8780724718355,80,-164,-116,513,256,773,626,61,17.35
-11,-8,0,-11.0,-8.0,0.4158926010131836,187.27786842016332,80,-153,-108,513,256,773,626,61,17.09
-11,-7,0,-11.0,-7.0,0.4210805892944336,174.25555945220228,80,-142,-101,513,256,773,626,61,14.76
-10,-6,0,-10.0,-6.0,0.4293806552886963,162.63148526653748,80,-132,-95,513,256,773,626,61,12.74
-8,-6,0,-8.0,-6.0,0.4374115467071533,152.63354808167173,80,-124,-89,513,256,773,626,61,12.85
-8,-4,0,-8.0,-4.0,0.44612574577331543,143.80890097626084,80,-116,-85,513,256,773,626,61,9.3
-8,-5,0,-8.0,-5.0,0.45362162590026855,134.40238093129153,80,-108,-80,513,256,773,626,61,10.28
-6,-5,0,-6.0,-5.0,0.4610917568206787,126.60568707605516,80,-102,-75,513,256,773,626,61,9.41
-7,-3,0,-7.0,-3.0,0.4694497585296631,119.20151005754919,80,-95,-72,513,256,773,626,61,7.11
-6,-4,0,-6.0,-4.0,0.4773247241973877,112.0044641967453,80,-89,-68,513,256,773,626,61,8.51
-5,-3,0,-5.0,-3.0,0.48555874824523926,106.21205204683694,80,-84,-65,513,256,773,626,61,6.84
-4,-3,0,-4.0,-3.0,0.4931786060333252,101.21264743103995,80,-80,-62,513,256,773,626,61,8.53
-4,-2,0,-4.0,-2.0,0.5011377334594727,96.82974749528164,80,-76,-60,513,256,773,626,61,5.17
-3,-3,0,-3.0,-3.0,0.5139496326446533,92.61749294814668,80,-73,-57,513,256,773,626,61,5.68
-3,-2,0,-3.0,-2.0,0.5174517631530762,89.02246907382428,80,-70,-55,513,256,773,626,61,5.9
-3,-2,0,-3.0,-2.0,0.5250935554504395,85.42833253669417,80,-67,-53,513,256,773,626,61,5.77
-3,-3,0,-3.0,-3.0,0.5330886840820312,81.21576201698781,80,-64,-50,513,256,773,626,61,5.42
-3,-2,0,-3.0,-2.0,0.5419406890869141,77.62087348130012,80,-61,-48,513,256,773,626,61,5.65
-2,-1,0,-2.0,-1.0,0.5490837097167969,75.43208866258443,80,-59,-47,513,256,773,626,61,3.78
-2,-2,0,-2.0,-2.0,0.5583715438842773,72.62231062146122,80,-57,-45,513,256,773,626,61,4.75
-2,-2,0,-2.0,-2.0,0.5651016235351562,69.81403870282824,80,-55,-43,513,256,773,626,61,4.64
-3,-2,0,-3.0,-2.0,0.573082685470581,66.21933252457322,80,-52,-41,513,256,773,626,61,5.39
-3,-2,0,-3.0,-2.0,0.5813546180725098,62.625873247404705,80,-49,-39,513,256,773,626,61,5.24
-3,-2,0,-3.0,-2.0,0.5907647609710693,59.033888572581766,80,-46,-37,513,256,773,626,61,5.08
-3,-2,0,-3.0,-2.0,0.5974586009979248,55.44366510251645,80,-43,-35,513,256,773,626,61,4.91
-2,-1,0,-2.0,-1.0,0.6051485538482666,53.2634959423431,80,-41,-34,513,256,773,626,61,3.32
-1,-1,0,-1.0,-1.0,0.6134605407714844,51.85556864985669,80,-40,-33,513,256,773,626,61,4.27
0,0,1,-0.0,-0.0,0.62911057472229,51.85556864985669,80,-40,-33,513,256,773,626,61,42.63
0,0,0,-0.0,-0.0,0.09080052375793457,547.2339536249556,81,428,341,981,630,553,289,68,143.29
1,1,0,1.0,1.0,0.14119458198547363,545.8287277159384,81,427,340,981,630,553,289,68,6.48
2,2,0,2.0,2.0,0.14899563789367676,543.0184158939732,81,425,338,981,630,553,289,68,9.07
2,2,0,2.0,2.0,0.15764856338500977,540.2082931610732,81,423,336,981,630,553,289,68,9.05
3,2,0,3.0,2.0,0.16475653648376465,536.6153184544772,81,420,334,981,630,553,289,68,10.81
3,2,0,3.0,2.0,0.17433857917785645,533.0225135958143,81,417,332,981,630,553,289,68,10.77
5,2,0,5.0,2.0,0.1807565689086914,527.8674075939904,81,412,330,981,630,553,289,68,11.77
8,5,0,8.0,5.0,0.18878960609436035,518.498794598406,81,404,325,981,630,553,289,68,19.46
11,5,0,11.0,5.0,0.1968085765838623,506.80272296032507,81,393,320,981,630,553,289,68,21.47
12,7,0,12.0,7.0,0.20685172080993652,493.08214325809854,81,381,313,981,630,553,289,68,24.42
16,8,0,16.0,8.0,0.21275067329406738,475.6574397610112,81,365,305,981,630,553,289,68,27.81
18,11,0,18.0,11.0,0.2216346263885498,454.80215478821117,81,347,294,981,630,553,289,68,31.24
19,11,0,19.0,11.0,0.22878456115722656,433.21241902789444,81,328,283,981,630,553,289,68,30.76
20,11,0,20.0,11.0,0.23718953132629395,410.9111826173632,81,308,272,981,630,553,289,68,30.17
21,11,0,21.0,11.0,0.24478459358215332,387.9304061297593,81,287,261,981,630,553,289,68,29.44
20,12,0,20.0,12.0,0.25275158882141113,365.08903023783114,81,267,249,981,630,553,289,68,28.44
19,12,0,19.0,12.0,0.26177453994750977,343.0349836386954,81,248,237,981,630,553,289,68,26.73
21,15,0,21.0,15.0,0.2688727378845215,317.5106297433206,81,227,222,981,630,553,289,68,28.31
20,14,0,20.0,14.0,0.27861666679382324,293.4501661270615,81,207,208,981,630,553,289,68,25.67
19,15,0,19.0,15.0,0.28620052337646484,269.4308816746885,81,188,193,981,630,553,289,68,24.63
15,14,0,15.0,14.0,0.293332576751709,248.93774322107123,81,173,179,981,630,553,289,68,22.31
14,14,0,14.0,14.0,0.3014035224914551,229.14187744713973,81,159,165,981,630,553,289,68,21.87
14,13,0,14.0,13.0,0.3088226318359375,210.06903627141244,81,145,152,981,630,553,289,68,19.06
12,13,0,12.0,13.0,0.31825852394104004,192.37983262286096,81,133,139,981,630,553,289,68,18.61
14,14,0,14.0,14.0,0.3247847557067871,172.58621034138272,81,119,125,981,630,553,289,68,18.31
11,11,0,11.0,11.0,0.33281970024108887,157.0350279396288,81,108,114,981,630,553,289,68,15.15
10,11,0,10.0,11.0,0.34094858169555664,142.1724305201258,81,98,103,981,630,553,289,68,14.21
8,10,0,8.0,10.0,0.3490145206451416,129.41792766073794,81,90,93,981,630,553,289,68,10.89
8,10,0,8.0,10.0,0.3574695587158203,116.67476162392619,81,82,83,981,630,553,289,68,10.13
7,10,0,7.0,10.0,0.36557555198669434,104.66135867644753,81,75,73,981,630,553,289,68,8.44
8,10,0,8.0,10.0,0.37290263175964355,91.96738552334735,81,67,63,981,630,553,289,68,8.45
7,10,0,7.0,10.0,0.3808445930480957,80.05623023850174,81,60,53,981,630,553,289,68,6.85
8,9,0,8.0,9.0,0.3888406753540039,68.11754546370561,81,52,44,981,630,553,289,68,6.93
8,7,0,8.0,7.0,0.39708471298217773,57.48912940721924,81,44,37,981,630,553,289,68,8.5
6,7,0,6.0,7.0,0.40482258796691895,48.41487374764082,81,38,30,981,630,553,289,68,4.77
7,5,0,7.0,5.0,0.4128246307373047,39.824615503479755,81,31,25,981,630,553,289,68,5.87
6,5,0,6.0,5.0,0.42089271545410156,32.01562118716424,81,25,20,981,630,553,289,68,6.64
4,4,0,4.0,4.0,0.4287545680999756,26.40075756488817,81,21,16,981,630,553,289,68,3.65
4,4,0,4.0,4.0,0.4391825199127197,20.808652046684813,81,17,12,981,630,553,289,68,3.01
3,4,0,3.0,4.0,0.44476962089538574,16.1245154965971,81,14,8,981,630,553,289,68,1.41
4,4,0,4.0,4.0,0.453540563583374,10.770329614269007,81,10,4,981,630,553,289,68,1.05
3,4,0,3.0,4.0,0.4623415470123291,7.0,81,7,0,981,630,553,289,68,-0.68
2,4,0,2.0,4.0,0.46906566619873047,6.4031242374328485,81,5,-4,981,630,553,289,68,-2.07
2,3,0,2.0,3.0,0.4767775535583496,7.615773105863909,81,3,-7,981,630,553,289,68,-1.73
1,3,0,1.0,3.0,0.48542356491088867,10.198039027185569,81,2,-10,981,630,553,289,68,-0.62
2,4,0,2.0,4.0,0.4950387477874756,14.0,81,0,-14,981,630,553,289,68,-0.55
1,1,0,1.0,1.0,0.5013425350189209,15.033296378372908,81,-1,-15,981,630,553,289,68,0.46
1,2,0,1.0,2.0,0.5089817047119141,17.11724276862369,81,-2,-17,981,630,553,289,68,1.03
1,1,0,1.0,1.0,0.5169956684112549,18.24828759089466,81,-3,-18,981,630,553,289,68,0.78
0,0,1,-0.0,-0.0,0.5568296909332275,18.24828759089466,81,-3,-18,981,630,553,289,68,32.370000000000005
0,0,0,-0.0,-0.0,0.06883978843688965,664.2988785177948,82,362,-557,1346,91,984,648,53,161.57
2,0,0,2.0,-0.0,0.10681271553039551,663.2111277715416,82,360,-557,1346,91,984,648,53,3.86
2,1,0,2.0,1.0,0.11588883399963379,662.9690792186315,82,358,-558,1346,91,984,648,53,0.91
3,0,0,3.0,-0.0,0.12278270721435547,661.3539143302926,82,355,-558,1346,91,984,648,53,5.29
3,0,0,3.0,-0.0,0.13095974922180176,659.748436906068,82,352,-558,1346,91,984,648,53,5.25
2,0,0,2.0,-0.0,0.13992977142333984,658.6835355464717,82,350,-558,1346,91,984,648,53,3.77
1,0,0,1.0,-0.0,0.14699077606201172,658.1527178398643,82,349,-558,1346,91,984,648,53,2.27
1,0,0,1.0,-0.0,0.1641218662261963,657.6229922987791,82,348,-558,1346,91,984,648,53,2.27
2,-1,0,2.0,-1.0,0.17878270149230957,655.7171646373152,82,346,-557,1346,91,984,648,53,6.91
2,0,0,2.0,-0.0,0.18754076957702637,654.6640359757056,82,344,-557,1346,91,984,648,53,3.71
2,-1,0,2.0,-1.0,0.19565176963806152,652.7633568147036,82,342,-556,1346,91,984,648,53,6.87
4,-1,0,4.0,-1.0,0.20279574394226074,649.8222833975456,82,338,-555,1346,91,984,648,53,9.09
6,-4,0,6.0,-4.0,0.21078968048095703,643.2923130272893,82,332,-551,1346,91,984,648,53,18.45
8,-5,0,8.0,-5.0,0.2188587188720703,634.8952669535346,82,324,-546,1346,91,984,648,53,22.24
9,-6,0,9.0,-6.0,0.22727680206298828,625.1599795252412,82,315,-540,1346,91,984,648,53,24.82
9,-8,0,9.0,-8.0,0.2379627227783203,613.7263233722341,82,306,-532,1346,91,984,648,53,28.28
10,-9,0,10.0,-9.0,0.244215726852417,600.9534091757863,82,296,-523,1346,91,984,648,53,30.32
11,-11,0,11.0,-11.0,0.25104284286499023,585.9769620044801,82,285,-512,1346,91,984,648,53,33.77
10,-13,0,10.0,-13.0,0.2587716579437256,569.7595984272665,82,275,-499,1346,91,984,648,53,35.95
9,-15,0,9.0,-15.0,0.26826977729797363,552.2789150420284,82,266,-484,1346,91,984,648,53,38.82
9,-18,0,9.0,-18.0,0.2759246826171875,532.1700855929428,82,257,-466,1346,91,984,648,53,41.52
10,-19,0,10.0,-19.0,0.2835087776184082,510.70343644819934,82,247,-447,1346,91,984,648,53,42.9
9,-19,0,9.0,-19.0,0.2907836437225342,489.72237032833203,82,238,-428,1346,91,984,648,53,40.02
11,-20,0,11.0,-20.0,0.2997868061065674,466.897204960578,82,227,-408,1346,91,984,648,53,43.16
10,-17,0,10.0,-17.0,0.306776762008667,447.1800532224129,82,217,-391,1346,91,984,648,53,37.43
9,-18,0,9.0,-18.0,0.31479573249816895,427.0749348767731,82,208,-373,1346,91,984,648,53,36.24
9,-15,0,9.0,-15.0,0.3228578567504883,409.59125967237145,82,199,-358,1346,91,984,648,53,32.67
8,-16,0,8.0,-16.0,0.3318657875061035,391.72056366752054,82,191,-342,1346,91,984,648,53,31.9
7,-17,0,7.0,-17.0,0.3452787399291992,373.47155179477863,82,184,-325,1346,91,984,648,53,30.16
8,-17,0,8.0,-17.0,0.3475687503814697,354.73934092513616,82,176,-308,1346,91,984,648,53,30.26
8,-16,0,8.0,-16.0,0.3580048084259033,336.87980052238214,82,168,-292,1346,91,984,648,53,28.79
8,-16,0,8.0,-16.0,0.3630988597869873,319.02351010544663,82,160,-276,1346,91,984,648,53,27.76
8,-16,0,8.0,-16.0,0.3711397647857666,301.1710477452971,82,152,-260,1346,91,984,648,53,26.71
10,-19,0,10.0,-19.0,0.38630080223083496,279.72307734614964,82,142,-241,1346,91,984,648,53,28.89
11,-20,0,11.0,-20.0,0.3916327953338623,256.90854403853524,82,131,-221,1346,91,984,648,53,28.84
11,-17,0,11.0,-17.0,0.3948667049407959,236.67699507979225,82,120,-204,1346,91,984,648,53,25.25
9,-14,0,9.0,-14.0,0.4027576446533203,220.04772209682153,82,111,-190,1346,91,984,648,53,21.52
8,-13,0,8.0,-13.0,0.41094374656677246,204.78769494283586,82,103,-177,1346,91,984,648,53,20.18
7,-13,0,7.0,-13.0,0.4187946319580078,190.03157632351525,82,96,-164,1346,91,984,648,53,18.58
6,-9,0,6.0,-9.0,0.42679572105407715,179.2344832893492,82,90,-155,1346,91,984,648,53,14.44
5,-10,0,5.0,-10.0,0.43547964096069336,168.0773631397161,82,85,-145,1346,91,984,648,53,14.1
5,-9,0,5.0,-9.0,0.444016695022583,157.78466338652817,82,80,-136,1346,91,984,648,53,14.12
5,-10,0,5.0,-10.0,0.45105767250061035,146.63219291819925,82,75,-126,1346,91,984,648,53,12.93
5,-9,0,5.0,-9.0,0.45954275131225586,136.34148304899725,82,70,-117,1346,91,984,648,53,12.85
5,-8,0,5.0,-8.0,0.4667997360229492,126.90941651429968,82,65,-109,1346,91,984,648,53,12.32
4,-7,0,4.0,-7.0,0.47478580474853516,118.84864324004712,82,61,-102,1346,91,984,648,53,11.19
3,-7,0,3.0,-7.0,0.48277878761291504,111.30588483993108,82,58,-95,1346,91,984,648,53,8.27
3,-7,0,3.0,-7.0,0.49646973609924316,103.77379245262264,82,55,-88,1346,91,984,648,53,7.87
3,-6,0,3.0,-6.0,0.49880480766296387,97.09788875150684,82,52,-82,1346,91,984,648,53,7.71
3,-4,0,3.0,-4.0,0.5117557048797607,92.11405973031478,82,49,-78,1346,91,984,648,53,6.92
2,-5,0,2.0,-5.0,0.5174696445465088,86.82165628459296,82,47,-73,1346,91,984,648,53,5.81
3,-5,0,3.0,-5.0,0.522803783416748,80.99382692526635,82,44,-68,1346,91,984,648,53,8.04
3,-4,0,3.0,-4.0,0.5309288501739502,76.00657866263946,82,41,-64,1346,91,984,648,53,6.58
3,-5,0,3.0,-5.0,0.5396907329559326,70.178344238091,82,38,-59,1346,91,984,648,53,7.74
3,-4,0,3.0,-4.0,0.5467677116394043,65.19202405202648,82,35,-55,1346,91,984,648,53,6.19
4,-5,0,4.0,-5.0,0.5578927993774414,58.83026432033091,82,31,-50,1346,91,984,648,53,5.86
3,-4,0,3.0,-4.0,0.5630316734313965,53.85164807134504,82,28,-46,1346,91,984,648,53,5.5
4,-5,0,4.0,-5.0,0.5707948207855225,47.50789408087881,82,24,-41,1346,91,984,648,53,5.1
3,-4,0,3.0,-4.0,0.5787627696990967,42.5440947723653,82,21,-37,1346,91,984,648,53,4.7
4,-3,0,4.0,-3.0,0.5869457721710205,38.01315561749642,82,17,-34,1346,91,984,648,53,2.58
3,-4,0,3.0,-4.0,0.5972447395324707,33.1058907144937,82,14,-30,1346,91,984,648,53,3.62
3,-2,0,3.0,-2.0,0.6031126976013184,30.083217912982647,82,11,-28,1346,91,984,648,53,1.6
3,-3,0,3.0,-3.0,0.6117358207702637,26.248809496813376,82,8,-25,1346,91,984,648,53,1.92
2,-3,0,2.0,-3.0,0.6199398040771484,22.80350850198276,82,6,-22,1346,91,984,648,53,2.3
2,-3,0,2.0,-3.0,0.6309967041015625,19.4164878389476,82,4,-19,1346,91,984,648,53,1.88
2,-2,0,2.0,-2.0,0.635117769241333,17.11724276862369,82,2,-17,1346,91,984,648,53,0.86
2,-3,0,2.0,-3.0,0.6459157466888428,14.0,82,0,-14,1346,91,984,648,53,0.87
2,-3,0,2.0,-3.0,0.6517598628997803,11.180339887498949,82,-2,-11,1346,91,984,648,53,0.22
2,-3,0,2.0,-3.0,0.6617677211761475,8.94427190999916,82,-4,-8,1346,91,984,648,53,-0.53
1,-2,0,1.0,-2.0,0.6669816970825195,7.810249675906654,82,-5,-6,1346,91,984,648,53,-0.64
1,-1,0,1.0,-1.0,0.6748278141021729,7.810249675906654,82,-6,-5,1346,91,984,648,53,11.66
0,0,1,-0.0,-0.0,0.6907997131347656,7.810249675906654,82,-6,-5,1346,91,984,648,53,29.23
0,0,0,-0.0,-0.0,0.10118460655212402,722.3364866874717,83,-641,333,711,429,1352,96,59,169.98
0,3,0,-0.0,3.0,0.1651146411895752,720.9583899227472,83,-641,330,711,429,1352,96,59,4.33
0,4,0,-0.0,4.0,0.1731555461883545,719.1362875004987,83,-641,326,711,429,1352,96,59,5.47
-2,5,0,-2.0,5.0,0.18115973472595215,715.0957977781718,83,-639,321,711,429,1352,96,59,11.55
-3,7,0,-3.0,7.0,0.18926572799682617,709.2897856306687,83,-636,314,711,429,1352,96,59,15.62
-6,8,0,-6.0,8.0,0.19965267181396484,700.382752500374,83,-630,306,711,429,1352,96,59,22.68
-9,10,0,-9.0,10.0,0.2052936553955078,687.936770350299,83,-621,296,711,429,1352,96,59,29.46
-13,10,0,-13.0,10.0,0.2131485939025879,671.9077317608422,83,-608,286,711,429,1352,96,59,35.98
-13,11,0,-13.0,11.0,0.2234656810760498,655.4769256045555,83,-595,275,711,429,1352,96,59,35.79
-15,11,0,-15.0,11.0,0.2291555404663086,637.2566202088449,83,-580,264,711,429,1352,96,59,38.26
-14,11,0,-14.0,11.0,0.23802971839904785,619.9717735510222,83,-566,253,711,429,1352,96,59,36.01
-17,12,0,-17.0,12.0,0.2451326847076416,599.5681779414248,83,-549,241,711,429,1352,96,59,39.92
-16,11,0,-16.0,11.0,0.25313854217529297,580.5075365574507,83,-533,230,711,429,1352,96,59,37.38
-16,11,0,-16.0,11.0,0.26134371757507324,561.4712815451918,83,-517,219,711,429,1352,96,59,36.54
-17,11,0,-17.0,11.0,0.2691316604614258,541.5385489510419,83,-500,208,711,429,1352,96,59,37.04
-18,12,0,-18.0,12.0,0.27728271484375,520.3268203735033,83,-482,196,711,429,1352,96,59,37.53
-17,10,0,-17.0,10.0,0.28519368171691895,500.8203270635089,83,-465,186,711,429,1352,96,59,35.0
-18,9,0,-18.0,9.0,0.29315757751464844,480.7681353833675,83,-447,177,711,429,1352,96,59,35.48
-21,10,0,-21.0,10.0,0.301743745803833,457.56420314530726,83,-426,167,711,429,1352,96,59,38.09
-22,9,0,-22.0,9.0,0.30958056449890137,433.7971876349592,83,-404,158,711,429,1352,96,59,39.01
-24,9,0,-24.0,9.0,0.3179056644439697,408.1678576272267,83,-380,149,711,429,1352,96,59,39.39
-27,9,0,-27.0,9.0,0.3259587287902832,379.74860105074777,83,-353,140,711,429,1352,96,59,38.67
-25,10,0,-25.0,10.0,0.33316659927368164,352.82290175100593,83,-328,130,711,429,1352,96,59,38.0
-25,9,0,-25.0,9.0,0.3484337329864502,326.266762021509,83,-303,121,711,429,1352,96,59,34.27
-25,10,0,-25.0,10.0,0.36161351203918457,299.3409427392117,83,-278,111,711,429,1352,96,59,34.78
-23,8,0,-23.0,8.0,0.3617665767669678,275.0163631495406,83,-255,103,711,429,1352,96,59,28.82
-23,8,0,-23.0,8.0,0.3659365177154541,250.69702830308938,83,-232,95,711,429,1352,96,59,27.05
-21,7,0,-21.0,7.0,0.3731865882873535,228.61539755668252,83,-211,88,711,429,1352,96,59,23.71
-20,7,0,-20.0,7.0,0.3811795711517334,207.46565980903924,83,-191,81,711,429,1352,96,59,21.87
-17,5,0,-17.0,5.0,0.3940446376800537,189.87364219396014,83,-174,76,711,429,1352,96,59,17.69
-16,5,0,-16.0,5.0,0.39923858642578125,173.21951391226105,83,-158,71,711,429,1352,96,59,16.19
-14,5,0,-14.0,5.0,0.4056816101074219,158.40454538932903,83,-144,66,711,429,1352,96,59,14.67
-13,5,0,-13.0,5.0,0.41346263885498047,144.5060552364502,83,-131,61,711,429,1352,96,59,13.69
-13,4,0,-13.0,4.0,0.42113161087036133,131.04579352272242,83,-118,57,711,429,1352,96,59,11.66
-10,5,0,-10.0,5.0,0.4297676086425781,119.86659251017358,83,-108,52,711,429,1352,96,59,12.63
-9,4,0,-9.0,4.0,0.4413595199584961,110.02272492535349,83,-99,48,711,429,1352,96,59,10.71
-8,4,0,-8.0,4.0,0.44575071334838867,101.07917688624102,83,-91,44,711,429,1352,96,59,10.78
-8,4,0,-8.0,4.0,0.4531257152557373,92.13576938409967,83,-83,40,711,429,1352,96,59,10.33
-7,5,0,-7.0,5.0,0.46205759048461914,83.6719785830358,83,-76,35,711,429,1352,96,59,6.72
-6,3,0,-6.0,3.0,0.4691355228424072,76.96752561957543,83,-70,32,711,429,1352,96,59,7.92
-7,6,0,-7.0,6.0,0.4778475761413574,68.15423684555495,83,-63,26,711,429,1352,96,59,5.4
-6,4,0,-6.0,4.0,0.48566460609436035,61.09828148156051,83,-57,22,711,429,1352,96,59,5.05
-6,4,0,-6.0,4.0,0.49515366554260254,54.08326913195984,83,-51,18,711,429,1352,96,59,4.56
-6,4,0,-6.0,4.0,0.5011746883392334,47.12748667179272,83,-45,14,711,429,1352,96,59,4.03
-6,3,0,-6.0,3.0,0.5094375610351562,40.52159917870962,83,-39,11,711,429,1352,96,59,4.24
-4,4,0,-4.0,4.0,0.5174875259399414,35.6931365951495,83,-35,7,711,429,1352,96,59,2.01
-4,2,0,-4.0,2.0,0.5253925323486328,31.400636936215164,83,-31,5,711,429,1352,96,59,2.74
-4,2,0,-4.0,2.0,0.5343015193939209,27.16615541441225,83,-27,3,711,429,1352,96,59,2.34
-4,1,0,-4.0,1.0,0.5420346260070801,23.08679276123039,83,-23,2,711,429,1352,96,59,3.27
-3,3,0,-3.0,3.0,0.5492606163024902,20.024984394500787,83,-20,-1,711,429,1352,96,59,0.55
-4,1,0,-4.0,1.0,0.5615415573120117,16.1245154965971,83,-16,-2,711,429,1352,96,59,1.66
-2,0,0,-2.0,-0.0,0.5669827461242676,14.142135623730951,83,-14,-2,711,429,1352,96,59,2.93
-1,1,0,-1.0,1.0,0.5738406181335449,13.341664064126334,83,-13,-3,711,429,1352,96,59,0.15
-1,0,0,-1.0,-0.0,0.5811796188354492,12.36931687685298,83,-12,-3,711,429,1352,96,59,2.26
-2,1,0,-2.0,1.0,0.5907037258148193,10.770329614269007,83,-10,-4,711,429,1352,96,59,0.1
0,0,1,-0.0,-0.0,0.594517707824707,10.770329614269007,83,-10,-4,711,429,1352,96,59,30.11
-1,1,1,-1.0,1.0,0.5987896919250488,10.295630140987,83,-9,-5,711,429,1352,96,59,9.62
-1,0,1,-1.0,-0.0,0.001711130142211914,983.7123563318701,84,741,647,1460,1081,720,434,74,4.71
-1,0,1,-1.0,-0.0,0.01770806312561035,984.4658450144424,84,742,647,1460,1081,720,434,74,4.71
0,1,1,-0.0,1.0,0.02618098258972168,983.8089245376868,84,742,646,1460,1081,720,434,74,2.72
0,0,0,-0.0,-0.0,0.08375215530395508,983.8089245376868,84,742,646,1460,1081,720,434,74,203.72
3,3,0,3.0,3.0,0.12974214553833008,979.5764390796667,84,739,643,1460,1081,720,434,74,14.92
3,3,0,3.0,3.0,0.13948798179626465,975.344041864203,84,736,640,1460,1081,720,434,74,14.89
5,4,0,5.0,4.0,0.14574599266052246,968.9463349432723,84,731,636,1460,1081,720,434,74,20.38
6,4,0,6.0,4.0,0.15383410453796387,961.7946766332199,84,725,632,1460,1081,720,434,74,20.63
8,6,0,8.0,6.0,0.16450119018554688,951.8219371289989,84,717,626,1460,1081,720,434,74,27.1
8,6,0,8.0,6.0,0.16975712776184082,941.8497757073577,84,709,620,1460,1081,720,434,74,26.94
9,6,0,9.0,6.0,0.1788020133972168,931.1261998247069,84,700,614,1460,1081,720,434,74,27.56
10,7,0,10.0,7.0,0.18984699249267578,918.9934711411175,84,690,607,1460,1081,720,434,74,30.29
12,8,0,12.0,8.0,0.19375014305114746,904.7016082665046,84,678,599,1460,1081,720,434,74,33.69
15,9,0,15.0,9.0,0.20171403884887695,887.5071830695231,84,663,590,1460,1081,720,434,74,37.83
15,9,0,15.0,9.0,0.20970416069030762,870.3246520695596,84,648,581,1460,1081,720,434,74,37.37
17,9,0,17.0,9.0,0.2177281379699707,851.6718851764451,84,631,572,1460,1081,720,434,74,38.86
15,9,0,15.0,9.0,0.22577500343322754,834.5208205910743,84,616,563,1460,1081,720,434,74,36.38
15,10,0,15.0,10.0,0.23372602462768555,816.7068017348698,84,601,553,1460,1081,720,434,74,37.29
15,12,0,15.0,12.0,0.24264001846313477,797.5443561332498,84,586,541,1460,1081,720,434,74,39.81
15,14,0,15.0,14.0,0.24993109703063965,777.026383078464,84,571,527,1460,1081,720,434,74,43.27
17,15,0,17.0,15.0,0.26285219192504883,754.3606564502155,84,554,512,1460,1081,720,434,74,44.58
16,15,0,16.0,15.0,0.2684822082519531,732.4295187934467,84,538,497,1460,1081,720,434,74,43.7
17,15,0,17.0,15.0,0.2737390995025635,709.7640452995629,84,521,482,1460,1081,720,434,74,43.08
17,14,0,17.0,14.0,0.2846560478210449,687.7790342835408,84,504,468,1460,1081,720,434,74,40.5
16,14,0,16.0,14.0,0.2897021770477295,666.5283189782712,84,488,454,1460,1081,720,434,74,39.59
18,15,0,18.0,15.0,0.2978520393371582,643.1337341486606,84,470,439,1460,1081,720,434,74,40.7
18,15,0,18.0,15.0,0.3059961795806885,619.7418817540089,84,452,424,1460,1081,720,434,74,39.78
17,15,0,17.0,15.0,0.31427001953125,597.0812340042182,84,435,409,1460,1081,720,434,74,38.79
18,14,0,18.0,14.0,0.3217442035675049,574.3814063842945,84,417,395,1460,1081,720,434,74,36.67
17,13,0,17.0,13.0,0.3297572135925293,553.1039685267137,84,400,382,1460,1081,720,434,74,34.14
17,13,0,17.0,13.0,0.3386051654815674,531.8364410229897,84,383,369,1460,1081,720,434,74,33.29
16,11,0,16.0,11.0,0.345844030380249,512.6919152863637,84,367,358,1460,1081,720,434,74,29.74
15,12,0,15.0,12.0,0.35384202003479004,493.5787677767349,84,352,346,1460,1081,720,434,74,29.69
15,12,0,15.0,12.0,0.3617980480194092,474.4733922992943,84,337,334,1460,1081,720,434,74,28.93
17,13,0,17.0,13.0,0.3739051818847656,453.2559983055933,84,320,321,1460,1081,720,434,74,29.92
17,13,0,17.0,13.0,0.38212013244628906,432.0567092408125,84,303,308,1460,1081,720,434,74,28.96
17,14,0,17.0,14.0,0.38582801818847656,410.16094402075873,84,286,294,1460,1081,720,434,74,28.97
18,14,0,18.0,14.0,0.3937530517578125,387.5874094962322,84,268,280,1460,1081,720,434,74,28.16
18,15,0,18.0,15.0,0.4017620086669922,364.3144246389374,84,250,265,1460,1081,720,434,74,27.89
16,13,0,16.0,13.0,0.41012120246887207,343.8895171417704,84,234,252,1460,1081,720,434,74,24.44
16,13,0,16.0,13.0,0.41776013374328613,323.488794241779,84,218,239,1460,1081,720,434,74,23.4
15,12,0,15.0,12.0,0.4301919937133789,304.52914474644297,84,203,227,1460,1081,720,434,74,21.28
13,11,0,13.0,11.0,0.43814611434936523,287.67342595380615,84,190,216,1460,1081,720,434,74,19.11
12,11,0,12.0,11.0,0.4417281150817871,271.4940146669904,84,178,205,1460,1081,720,434,74,18.27
10,8,0,10.0,8.0,0.44979000091552734,258.90731932488893,84,168,197,1460,1081,720,434,74,14.39
7,8,0,7.0,8.0,0.45797109603881836,248.2780699135548,84,161,189,1460,1081,720,434,74,15.49
7,7,0,7.0,7.0,0.46698904037475586,238.41140912296962,84,154,182,1460,1081,720,434,74,12.72
6,6,0,6.0,6.0,0.47373008728027344,229.95651762887695,84,148,176,1460,1081,720,434,74,11.36
6,7,0,6.0,7.0,0.48345017433166504,220.73740054644117,84,142,169,1460,1081,720,434,74,13.81
6,8,0,6.0,8.0,0.49011921882629395,210.75341041131458,84,136,161,1460,1081,720,434,74,12.43
7,8,0,7.0,8.0,0.4978179931640625,200.124960961895,84,129,153,1460,1081,720,434,74,13.73
6,7,0,6.0,7.0,0.5057430267333984,190.90573590125572,84,123,146,1460,1081,720,434,74,13.06
6,7,0,6.0,7.0,0.5137970447540283,181.6865432551349,84,117,139,1460,1081,720,434,74,12.77
6,7,0,6.0,7.0,0.5224871635437012,172.46738822165773,84,111,132,1460,1081,720,434,74,12.46
7,7,0,7.0,7.0,0.5312421321868896,162.60688792299052,84,104,125,1460,1081,720,434,74,10.25
4,6,0,4.0,6.0,0.543179988861084,155.43809056984713,84,100,119,1460,1081,720,434,74,8.25
4,6,0,4.0,6.0,0.547544002532959,148.27339613025663,84,96,113,1460,1081,720,434,74,8.0
4,5,0,4.0,5.0,0.5537350177764893,141.8731828077456,84,92,108,1460,1081,720,434,74,9.0
2,5,0,2.0,5.0,0.5627360343933105,136.7808466123821,84,90,103,1460,1081,720,434,74,5.16
3,4,0,3.0,4.0,0.5705862045288086,131.79529581893277,84,87,99,1460,1081,720,434,74,6.97
3,5,0,3.0,5.0,0.5778100490570068,126.0634760745554,84,84,94,1460,1081,720,434,74,6.06
3,5,0,3.0,5.0,0.5857431888580322,120.34118164618461,84,81,89,1460,1081,720,434,74,5.86
4,5,0,4.0,5.0,0.5938570499420166,113.95174417269794,84,77,84,1460,1081,720,434,74,7.42
5,5,0,5.0,5.0,0.6020891666412354,106.88779163215975,84,72,79,1460,1081,720,434,74,7.97
4,4,0,4.0,4.0,0.610429048538208,101.23734488813898,84,68,75,1460,1081,720,434,74,7.17
4,4,0,4.0,4.0,0.6198410987854004,95.58765610684259,84,64,71,1460,1081,720,434,74,6.96
5,3,0,5.0,3.0,0.6269381046295166,90.02777349240623,84,59,68,1460,1081,720,434,74,4.41
4,3,0,4.0,3.0,0.6340491771697998,85.14693182963201,84,55,65,1460,1081,720,434,74,4.53
5,4,0,5.0,4.0,0.6417360305786133,78.87331614684399,84,50,61,1460,1081,720,434,74,4.91
4,3,0,4.0,3.0,0.6498491764068604,74.02702209328699,84,46,58,1460,1081,720,434,74,4.07
4,3,0,4.0,3.0,0.6577060222625732,69.20260110718382,84,42,55,1460,1081,720,434,74,3.84
4,3,0,4.0,3.0,0.6657061576843262,64.40496875241847,84,38,52,1460,1081,720,434,74,3.61
4,4,0,4.0,4.0,0.6746602058410645,58.82176467941097,84,34,48,1460,1081,720,434,74,4.42
4,3,0,4.0,3.0,0.6817669868469238,54.08326913195984,84,30,45,1460,1081,720,434,74,3.12
4,4,0,4.0,4.0,0.6897401809692383,48.54894437575342,84,26,41,1460,1081,720,434,74,3.72
3,2,0,3.0,2.0,0.6977200508117676,45.27692569068709,84,23,39,1460,1081,720,434,74,2.22
3,3,0,3.0,3.0,0.7057430744171143,41.182520563948,84,20,36,1460,1081,720,434,74,2.92
2,1,0,2.0,1.0,0.7138621807098389,39.35733730830886,84,18,35,1460,1081,720,434,74,1.43
2,2,0,2.0,2.0,0.7217221260070801,36.6742416417845,84,16,33,1460,1081,720,434,74,2.38
1,1,0,1.0,1.0,0.731410026550293,35.34119409414458,84,15,32,1460,1081,720,434,74,2.23
0,1,0,-0.0,1.0,0.7401120662689209,34.438350715445125,84,15,31,1460,1081,720,434,74,1.84
0,0,1,-0.0,-0.0,0.7637250423431396,34.438350715445125,84,15,31,1460,1081,720,434,74,37.31
0,0,0,-0.0,-0.0,0.07883167266845703,597.2202273868493,85,-464,-376,981,674,1445,1050,42,151.32
-1,0,0,-1.0,-0.0,0.1167764663696289,596.4436268416321,85,-463,-376,981,674,1445,1050,42,3.92
-2,0,0,-2.0,-0.0,0.12514758110046387,594.8924272505072,85,-461,-376,981,674,1445,1050,42,6.42
-2,-1,0,-2.0,-1.0,0.1355266571044922,592.7107220221345,85,-459,-375,981,674,1445,1050,42,9.93
-5,-4,0,-5.0,-4.0,0.14080452919006348,586.3079395675961,85,-454,-371,981,674,1445,1050,42,24.83
-5,-4,0,-5.0,-4.0,0.1487865447998047,579.9051646605676,85,-449,-367,981,674,1445,1050,42,24.69
-4,-5,0,-4.0,-5.0,0.15716552734375,573.6453608284478,85,-445,-362,981,674,1445,1050,42,21.07
-4,-4,0,-4.0,-4.0,0.1649646759033203,568.0184856146849,85,-441,-358,981,674,1445,1050,42,20.29
-6,-5,0,-6.0,-5.0,0.1728055477142334,560.2088896117233,85,-435,-353,981,674,1445,1050,42,27.52
-7,-5,0,-7.0,-5.0,0.18311548233032227,551.6230597065355,85,-428,-348,981,674,1445,1050,42,27.62
-8,-6,0,-8.0,-6.0,0.18916654586791992,541.6308706120802,85,-420,-342,981,674,1445,1050,42,30.86
-10,-7,0,-10.0,-7.0,0.19679665565490723,529.4572692862002,85,-410,-335,981,674,1445,1050,42,34.07
-13,-9,0,-13.0,-9.0,0.2048184871673584,513.6973817336428,85,-397,-326,981,674,1445,1050,42,39.6
-16,-10,0,-16.0,-10.0,0.2128005027770996,494.99191912595904,85,-381,-316,981,674,1445,1050,42,42.55
-21,-13,0,-21.0,-13.0,0.22589850425720215,470.54117779425,85,-360,-303,981,674,1445,1050,42,48.4
-23,-15,0,-23.0,-15.0,0.22997045516967773,443.29786825564594,85,-337,-288,981,674,1445,1050,42,49.7
-27,-17,0,-27.0,-17.0,0.23690056800842285,411.7535670762307,85,-310,-271,981,674,1445,1050,42,51.04
-27,-18,0,-27.0,-18.0,0.2448594570159912,379.6024235960566,85,-283,-253,981,674,1445,1050,42,48.97
-27,-17,0,-27.0,-17.0,0.2552616596221924,348.1838594765702,85,-256,-236,981,674,1445,1050,42,45.3
-27,-18,0,-27.0,-18.0,0.26191258430480957,316.17242131469976,85,-229,-218,981,674,1445,1050,42,42.9
-23,-15,0,-23.0,-15.0,0.2688934803009033,289.21445330411825,85,-206,-203,981,674,1445,1050,42,36.58
-20,-14,0,-20.0,-14.0,0.27685546875,265.1735280905694,85,-186,-189,981,674,1445,1050,42,32.41
-17,-12,0,-17.0,-12.0,0.2848055362701416,244.72433471152803,85,-169,-177,981,674,1445,1050,42,27.81
-15,-12,0,-15.0,-12.0,0.2927875518798828,225.7011298155151,85,-154,-165,981,674,1445,1050,42,25.58
-13,-9,0,-13.0,-9.0,0.3008246421813965,210.27838690650069,85,-141,-156,981,674,1445,1050,42,20.85
-10,-9,0,-10.0,-9.0,0.311551570892334,196.9009903479411,85,-131,-147,981,674,1445,1050,42,19.21
-9,-7,0,-9.0,-7.0,0.3175995349884033,185.69868066305693,85,-122,-140,981,674,1445,1050,42,15.86
-9,-7,0,-9.0,-7.0,0.32484865188598633,174.52220489095365,85,-113,-133,981,674,1445,1050,42,15.12
-10,-7,0,-10.0,-7.0,0.3328065872192383,162.74212730574712,85,-103,-126,981,674,1445,1050,42,14.52
-9,-8,0,-9.0,-8.0,0.3413255214691162,150.86417732516887,85,-94,-118,981,674,1445,1050,42,14.52
-10,-8,0,-10.0,-8.0,0.3489365577697754,138.40520221436765,85,-84,-110,981,674,1445,1050,42,13.65
-11,-8,0,-11.0,-8.0,0.36309266090393066,125.4312560727987,85,-73,-102,981,674,1445,1050,42,12.71
-11,-8,0,-11.0,-8.0,0.3698585033416748,112.60550608207397,85,-62,-94,981,674,1445,1050,42,11.55
-9,-6,0,-9.0,-6.0,0.37522459030151367,102.7277956543408,85,-53,-88,981,674,1445,1050,42,8.9
-8,-6,0,-8.0,-6.0,0.381725549697876,93.53608929178085,85,-45,-82,981,674,1445,1050,42,8.02
-8,-8,0,-8.0,-8.0,0.38876867294311523,82.73451516749222,85,-37,-74,981,674,1445,1050,42,8.56
-8,-7,0,-8.0,-7.0,0.4000725746154785,73.00684899377592,85,-29,-67,981,674,1445,1050,42,6.95
-8,-9,0,-8.0,-9.0,0.41460752487182617,61.68468205316454,85,-21,-58,981,674,1445,1050,42,7.03
-7,-8,0,-7.0,-8.0,0.4147775173187256,51.92301994298868,85,-14,-50,981,674,1445,1050,42,5.53
-6,-9,0,-6.0,-9.0,0.42089247703552246,41.773197148410844,85,-8,-41,981,674,1445,1050,42,5.08
-6,-7,0,-6.0,-7.0,0.4288976192474365,34.058772731852805,85,-2,-34,981,674,1445,1050,42,3.09
-5,-7,0,-5.0,-7.0,0.43679356575012207,27.16615541441225,85,3,-27,981,674,1445,1050,42,2.22
-5,-7,0,-5.0,-7.0,0.44481348991394043,21.540659228538015,85,8,-20,981,674,1445,1050,42,0.99
-5,-5,0,-5.0,-5.0,0.4527854919433594,19.849433241279208,85,13,-15,981,674,1445,1050,42,-0.75
-3,-5,0,-3.0,-5.0,0.4608495235443115,18.867962264113206,85,16,-10,981,674,1445,1050,42,-0.92
-2,-3,0,-2.0,-3.0,0.4689645767211914,19.313207915827967,85,18,-7,981,674,1445,1050,42,-0.16
-1,-3,0,-1.0,-3.0,0.4768054485321045,19.4164878389476,85,19,-4,981,674,1445,1050,42,2.15
0,-2,0,-0.0,-2.0,0.48487257957458496,19.1049731745428,85,19,-2,981,674,1445,1050,42,-0.35
0,-1,0,-0.0,-1.0,0.49312448501586914,19.026297590440446,85,19,-1,981,674,1445,1050,42,-0.17
-1,-1,0,-1.0,-1.0,0.501051664352417,20.0,85,20,0,981,674,1445,1050,42,0.73
0,0,1,-0.0,-0.0,0.5458755493164062,20.0,85,20,0,981,674,1445,1050,42,32.9
0,0,0,-0.0,-0.0,0.07161641120910645,280.6652810733811,86,178,-217,1139,457,961,674,33,92.63
0,-3,0,-0.0,-3.0,0.13366937637329102,278.3522947633089,86,178,-214,1139,457,961,674,33,6.77
1,-2,0,1.0,-2.0,0.1418774127960205,276.1756687327832,86,177,-212,1139,457,961,674,33,7.97
0,-3,0,-0.0,-3.0,0.15150046348571777,273.87953556262653,86,177,-209,1139,457,961,674,33,6.65
1,-2,0,1.0,-2.0,0.1578524112701416,271.7075633838705,86,176,-207,1139,457,961,674,33,7.85
0,-2,0,-0.0,-2.0,0.16727352142333984,270.1869722988138,86,176,-205,1139,457,961,674,33,4.86
1,-3,0,1.0,-3.0,0.17387652397155762,267.26204369494747,86,175,-202,1139,457,961,674,33,8.71
1,-3,0,1.0,-3.0,0.18302345275878906,264.3425807545958,86,174,-199,1139,457,961,674,33,8.63
1,-5,0,1.0,-5.0,0.18959736824035645,259.9326835932719,86,173,-194,1139,457,961,674,33,11.04
2,-4,0,2.0,-4.0,0.2007284164428711,255.6188568944005,86,171,-190,1139,457,961,674,33,11.7
2,-5,0,2.0,-5.0,0.2058885097503662,250.57134712492567,86,169,-185,1139,457,961,674,33,12.48
3,-5,0,3.0,-5.0,0.21516752243041992,244.85914318236107,86,166,-180,1139,457,961,674,33,14.21
4,-6,0,4.0,-6.0,0.22242355346679688,237.73935307390738,86,162,-174,1139,457,961,674,33,16.5
5,-7,0,5.0,-7.0,0.2295854091644287,229.21169254643183,86,157,-167,1139,457,961,674,33,18.39
5,-8,0,5.0,-8.0,0.2443075180053711,219.9659064491586,86,152,-159,1139,457,961,674,33,18.3
7,-9,0,7.0,-9.0,0.24732542037963867,208.62646045025065,86,145,-150,1139,457,961,674,33,21.02
8,-8,0,8.0,-8.0,0.25487637519836426,197.31446981911895,86,137,-142,1139,457,961,674,33,22.26
7,-9,0,7.0,-9.0,0.26189446449279785,185.98118184375537,86,130,-133,1139,457,961,674,33,19.45
6,-9,0,6.0,-9.0,0.26967954635620117,175.36248173426378,86,124,-124,1139,457,961,674,33,17.27
8,-9,0,8.0,-9.0,0.2775905132293701,163.3431969810803,86,116,-115,1139,457,961,674,33,19.28
7,-7,0,7.0,-7.0,0.2858774662017822,153.44380078712857,86,109,-108,1139,457,961,674,33,18.87
7,-8,0,7.0,-8.0,0.2935795783996582,142.84257068535277,86,102,-100,1139,457,961,674,33,16.33
7,-7,0,7.0,-7.0,0.30179452896118164,132.94359706281458,86,95,-93,1139,457,961,674,33,17.09
7,-8,0,7.0,-8.0,0.30982136726379395,122.34786471369249,86,88,-85,1139,457,961,674,33,14.76
6,-7,0,6.0,-7.0,0.31760454177856445,113.17243480636087,86,82,-78,1139,457,961,674,33,12.8
7,-8,0,7.0,-8.0,0.32605457305908203,102.59142264341595,86,75,-70,1139,457,961,674,33,13.06
8,-8,0,8.0,-8.0,0.3363654613494873,91.28526715741155,86,67,-62,1139,457,961,674,33,13.84
8,-8,0,8.0,-8.0,0.3427145481109619,79.98124780221924,86,59,-54,1139,457,961,674,33,12.76
7,-7,0,7.0,-7.0,0.35462236404418945,70.09279563550022,86,52,-47,1139,457,961,674,33,11.08
5,-6,0,5.0,-6.0,0.36399340629577637,62.369864518050704,86,47,-41,1139,457,961,674,33,7.92
5,-6,0,5.0,-6.0,0.36600542068481445,54.67174773134658,86,42,-35,1139,457,961,674,33,7.2
5,-5,0,5.0,-5.0,0.3744785785675049,47.634021455258214,86,37,-30,1139,457,961,674,33,7.19
6,-5,0,6.0,-5.0,0.38306641578674316,39.824615503479755,86,31,-25,1139,457,961,674,33,9.2
4,-4,0,4.0,-4.0,0.3914303779602051,34.20526275297414,86,27,-21,1139,457,961,674,33,5.54
4,-4,0,4.0,-4.0,0.39764952659606934,28.600699292150182,86,23,-17,1139,457,961,674,33,4.91
3,-3,0,3.0,-3.0,0.4059255123138428,24.413111231467404,86,20,-14,1139,457,961,674,33,4.02
2,-3,0,2.0,-3.0,0.4257793426513672,21.095023109728988,86,18,-11,1139,457,961,674,33,2.3
2,-2,0,2.0,-2.0,0.42638635635375977,18.35755975068582,86,16,-9,1139,457,961,674,33,2.71
1,-3,0,1.0,-3.0,0.4298975467681885,16.15549442140351,86,15,-6,1139,457,961,674,33,0.7
1,-1,0,1.0,-1.0,0.43767452239990234,14.866068747318506,86,14,-5,1139,457,961,674,33,1.68
0,-1,0,-0.0,-1.0,0.4478154182434082,14.560219778561036,86,14,-4,1139,457,961,674,33,0.02
0,0,1,-0.0,-0.0,0.5036184787750244,14.560219778561036,86,14,-4,1139,457,961,674,33,31.25
0,0,0,-0.0,-0.0,0.07447266578674316,523.2895947752066,87,-374,-366,751,95,1125,461,14,139.3
-2,0,0,-2.0,-0.0,0.1844635009765625,521.8620507375489,87,-372,-366,751,95,1125,461,14,13.34
-2,1,0,-2.0,1.0,0.19282054901123047,521.1420151935555,87,-370,-367,751,95,1125,461,14,6.9
-4,2,0,-4.0,2.0,0.20049548149108887,519.7278133792726,87,-366,-369,751,95,1125,461,14,12.49
-4,0,0,-4.0,-0.0,0.20968365669250488,516.9187557053816,87,-362,-369,751,95,1125,461,14,23.01
-5,1,0,-5.0,1.0,0.2164456844329834,514.1488111432332,87,-357,-370,751,95,1125,461,14,22.33
-5,1,0,-5.0,1.0,0.2255384922027588,511.414704520705,87,-352,-371,751,95,1125,461,14,22.01
-4,0,0,-4.0,-0.0,0.23725152015686035,508.6698339787804,87,-348,-371,751,95,1125,461,14,22.32
-4,-1,0,-4.0,-1.0,0.2407364845275879,505.2088676973119,87,-344,-370,751,95,1125,461,14,27.15
-4,-2,0,-4.0,-2.0,0.2504465579986572,501.02295356600183,87,-340,-368,751,95,1125,461,14,31.76
-5,-3,0,-5.0,-3.0,0.2564706802368164,495.429106936603,87,-335,-365,751,95,1125,461,14,38.9
-5,-4,0,-5.0,-4.0,0.26532459259033203,489.10223880084624,87,-330,-361,751,95,1125,461,14,42.66
-6,-6,0,-6.0,-6.0,0.2776296138763428,480.625633939764,87,-324,-355,751,95,1125,461,14,51.9
-7,-7,0,-7.0,-7.0,0.2853386402130127,470.73665674132496,87,-317,-348,751,95,1125,461,14,55.74
-10,-9,0,-10.0,-9.0,0.2889115810394287,457.35106865514155,87,-307,-339,751,95,1125,461,14,62.82
-11,-10,0,-11.0,-10.0,0.29862451553344727,442.5573409175358,87,-296,-329,751,95,1125,461,14,64.45
-13,-12,0,-13.0,-12.0,0.30702948570251465,424.9447022848973,87,-283,-317,751,95,1125,461,14,67.77
-13,-13,0,-13.0,-13.0,0.3125295639038086,406.5907032877166,87,-270,-304,751,95,1125,461,14,67.55
-15,-14,0,-15.0,-14.0,0.32172346115112305,386.16706229299257,87,-255,-290,751,95,1125,461,14,67.44
-18,-16,0,-18.0,-16.0,0.33019447326660156,362.27751793342077,87,-237,-274,751,95,1125,461,14,68.02
-18,-17,0,-18.0,-17.0,0.33646368980407715,337.6536687198882,87,-219,-257,751,95,1125,461,14,65.76
-17,-18,0,-17.0,-18.0,0.34801554679870605,312.92970456637704,87,-202,-239,751,95,1125,461,14,63.37
-17,-18,0,-17.0,-18.0,0.35500550270080566,288.2117277280715,87,-185,-221,751,95,1125,461,14,59.82
-15,-17,0,-15.0,-17.0,0.3626236915588379,265.5484889808262,87,-170,-204,751,95,1125,461,14,55.79
-14,-15,0,-14.0,-15.0,0.3688185214996338,245.0652974209119,87,-156,-189,751,95,1125,461,14,50.13
-11,-14,0,-11.0,-14.0,0.37645769119262695,227.26636354727023,87,-145,-175,751,95,1125,461,14,46.11
-8,-12,0,-8.0,-12.0,0.3846406936645508,212.92721761202816,87,-137,-163,751,95,1125,461,14,38.73
-6,-10,0,-6.0,-10.0,0.3925604820251465,201.41995928904365,87,-131,-153,751,95,1125,461,14,33.12
-3,-9,0,-3.0,-9.0,0.4010045528411865,192.66551326067673,87,-128,-144,751,95,1125,461,14,26.67
-4,-8,0,-4.0,-8.0,0.40952157974243164,184.04347312523745,87,-124,-136,751,95,1125,461,14,26.14
-3,-9,0,-3.0,-9.0,0.4164295196533203,175.41379649275024,87,-121,-127,751,95,1125,461,14,24.62
-4,-8,0,-4.0,-8.0,0.4245796203613281,166.88319268278636,87,-117,-119,751,95,1125,461,14,24.09
-6,-10,0,-6.0,-10.0,0.43255162239074707,155.56991997169632,87,-111,-109,751,95,1125,461,14,26.9
-6,-9,0,-6.0,-9.0,0.4404916763305664,145.0,87,-105,-100,751,95,1125,461,14,24.94
-7,-8,0,-7.0,-8.0,0.44845151901245117,134.41726079637243,87,-98,-92,751,95,1125,461,14,24.78
-7,-7,0,-7.0,-7.0,0.45656251907348633,124.52309022827855,87,-91,-85,751,95,1125,461,14,24.12
-6,-8,0,-6.0,-8.0,0.46486854553222656,114.69088891450794,87,-85,-77,751,95,1125,461,14,20.68
-7,-6,0,-7.0,-6.0,0.47246360778808594,105.47511554864494,87,-78,-71,751,95,1125,461,14,21.28
-5,-6,0,-5.0,-6.0,0.4818916320800781,97.74456506629922,87,-73,-65,751,95,1125,461,14,16.82
-5,-6,0,-5.0,-6.0,0.48885250091552734,90.02777349240623,87,-68,-59,751,95,1125,461,14,15.86
-7,-6,0,-7.0,-6.0,0.5006945133209229,80.8084154033477,87,-61,-53,751,95,1125,461,14,19.62
-6,-4,0,-6.0,-4.0,0.5068635940551758,73.66138744281159,87,-55,-49,751,95,1125,461,14,13.7
-5,-5,0,-5.0,-5.0,0.5129134654998779,66.60330322138685,87,-50,-44,751,95,1125,461,14,13.89
-5,-3,0,-5.0,-3.0,0.5204696655273438,60.876925020897694,87,-45,-41,751,95,1125,461,14,10.57
-6,-5,0,-6.0,-5.0,0.5284476280212402,53.075418038862395,87,-39,-36,751,95,1125,461,14,13.22
-7,-5,0,-7.0,-5.0,0.5367004871368408,44.553338819890925,87,-32,-31,751,95,1125,461,14,11.18
-9,-5,0,-9.0,-5.0,0.5450985431671143,34.713109915419565,87,-23,-26,751,95,1125,461,14,9.3
-10,-4,0,-10.0,-4.0,0.5563235282897949,25.553864678361276,87,-13,-22,751,95,1125,461,14,6.65
-10,-5,0,-10.0,-5.0,0.5612075328826904,17.26267650163207,87,-3,-17,751,95,1125,461,14,4.48
-9,-5,0,-9.0,-5.0,0.5704965591430664,13.416407864998739,87,6,-12,751,95,1125,461,14,1.01
-8,-4,0,-8.0,-4.0,0.5764575004577637,16.1245154965971,87,14,-8,751,95,1125,461,14,-1.71
-7,-4,0,-7.0,-4.0,0.5942544937133789,21.37755832643195,87,21,-4,751,95,1125,461,14,-1.1
-4,-3,0,-4.0,-3.0,0.5944545269012451,25.019992006393608,87,25,-1,751,95,1125,461,14,-0.08
-3,-2,0,-3.0,-2.0,0.6007466316223145,28.0178514522438,87,28,1,751,95,1125,461,14,0.75
-2,-1,0,-2.0,-1.0,0.6085076332092285,30.066592756745816,87,30,2,751,95,1125,461,14,1.86
0,0,1,-0.0,-0.0,0.7404375076293945,30.066592756745816,87,30,2,751,95,1125,461,14,25.97
0,0,0,-0.0,-0.0,0.841045618057251,30.066592756745816,87,30,2,751,95,1125,461,14,25.97
0,2,0,-0.0,2.0,0.8535184860229492,30.0,87,30,0,751,95,1125,461,14,-0.23
0,3,0,-0.0,3.0,0.8587765693664551,30.14962686336267,87,30,-3,751,95,1125,461,14,5.69
1,1,0,1.0,1.0,0.8644566535949707,29.274562336608895,87,29,-4,751,95,1125,461,14,1.57
1,2,0,1.0,2.0,0.8725235462188721,28.635642126552707,87,28,-6,751,95,1125,461,14,0.63
1,1,0,1.0,1.0,0.8804576396942139,27.892651361962706,87,27,-7,751,95,1125,461,14,1.22
1,1,0,1.0,1.0,0.888542652130127,27.202941017470888,87,26,-8,751,95,1125,461,14,1.08
1,1,0,1.0,1.0,0.8971655368804932,26.570660511172846,87,25,-9,751,95,1125,461,14,0.94
1,0,0,1.0,-0.0,0.9044234752655029,25.632011235952593,87,24,-9,751,95,1125,461,14,2.95
1,0,0,1.0,-0.0,0.9129366874694824,24.698178070456937,87,23,-9,751,95,1125,461,14,2.86
1,0,0,1.0,-0.0,0.9204435348510742,23.769728648009426,87,22,-9,751,95,1125,461,14,2.76
1,1,0,1.0,1.0,0.9289426803588867,23.259406699226016,87,21,-10,751,95,1125,461,14,0.6
1,0,0,1.0,-0.0,0.9366154670715332,22.360679774997898,87,20,-10,751,95,1125,461,14,2.44
1,0,0,1.0,-0.0,0.9444584846496582,21.470910553583888,87,19,-10,751,95,1125,461,14,2.34
1,0,0,1.0,-0.0,0.9524905681610107,20.591260281974,87,18,-10,751,95,1125,461,14,2.23
0,1,0,-0.0,1.0,0.9604716300964355,21.095023109728988,87,18,-11,751,95,1125,461,14,2.28
1,0,0,1.0,-0.0,0.9698076248168945,20.248456731316587,87,17,-11,751,95,1125,461,14,2.01
1,0,0,1.0,-0.0,0.9882276058197021,19.4164878389476,87,16,-11,751,95,1125,461,14,1.9
0,0,1,-0.0,-0.0,0.9914736747741699,19.4164878389476,87,16,-11,751,95,1125,461,14,22.72
1,0,1,1.0,-0.0,0.9980075359344482,18.601075237738275,87,15,-11,751,95,1125,461,14,1.79
1,0,1,1.0,-0.0,1.0164926052093506,17.804493814764857,87,14,-11,751,95,1125,461,14,1.67
0,0,0,-0.0,-0.0,1.1014716625213623,17.804493814764857,87,14,-11,751,95,1125,461,14,22.23
0,1,0,-0.0,1.0,1.1444644927978516,18.439088914585774,87,14,-12,751,95,1125,461,14,1.97
1,-1,0,1.0,-1.0,1.2187526226043701,17.029386365926403,87,13,-11,751,95,1125,461,14,4.87
0,-1,0,-0.0,-1.0,1.2244675159454346,16.401219466856727,87,13,-10,751,95,1125,461,14,1.02
1,-1,0,1.0,-1.0,1.2326536178588867,15.0,87,12,-9,751,95,1125,461,14,4.04
1,-1,0,1.0,-1.0,1.2485706806182861,13.601470508735444,87,11,-8,751,95,1125,461,14,3.81
1,-2,0,1.0,-2.0,1.266190528869629,11.661903789690601,87,10,-6,751,95,1125,461,14,2.01
1,-1,0,1.0,-1.0,1.2741734981536865,10.295630140987,87,9,-5,751,95,1125,461,14,2.74
0,0,1,-0.0,-0.0,1.2820534706115723,10.295630140987,87,9,-5,751,95,1125,461,14,29.97
1,0,1,1.0,-0.0,1.2859456539154053,9.433981132056603,87,8,-5,751,95,1125,461,14,11.51
0,-1,1,-0.0,-1.0,1.2895054817199707,8.94427190999916,87,8,-4,751,95,1125,461,14,10.26
1,-1,1,1.0,-1.0,0.023946046829223633,409.5851559810243,88,36,408,780,506,743,99,19,7.09
1,-1,1,1.0,-1.0,0.03325819969177246,410.4948233534742,88,35,409,780,506,743,99,19,7.08
0,-1,1,-0.0,-1.0,0.05119609832763672,411.4911906711977,88,35,410,780,506,743,99,19,9.71
1,0,1,1.0,-0.0,0.06452608108520508,411.40734072206345,88,34,410,780,506,743,99,19,0.69
0,-1,1,-0.0,-1.0,0.07275915145874023,412.4039282063157,88,34,411,780,506,743,99,19,9.76
1,0,1,1.0,-0.0,0.07987618446350098,412.3226891646881,88,33,411,780,506,743,99,19,0.67
1,-1,1,1.0,-1.0,0.09595322608947754,413.2408498684514,88,32,412,780,506,743,99,19,7.07
0,0,0,-0.0,-0.0,0.10589408874511719,413.2408498684514,88,32,412,780,506,743,99,19,119.7
1,-1,0,1.0,-1.0,0.11220622062683105,414.16180412973864,88,31,413,780,506,743,99,19,7.07
1,3,0,1.0,3.0,0.22390222549438477,411.0960958218893,88,30,410,780,506,743,99,19,18.28
1,6,0,1.0,6.0,0.23190617561340332,405.0395042461908,88,29,404,780,506,743,99,19,30.78
1,8,0,1.0,8.0,0.24007415771484375,396.9886648255842,88,28,396,780,506,743,99,19,37.16
0,8,0,-0.0,8.0,0.24924206733703613,389.00899732525465,88,28,388,780,506,743,99,19,36.16
0,10,0,-0.0,10.0,0.25676417350769043,379.0356183790647,88,28,378,780,506,743,99,19,40.66
0,10,0,-0.0,10.0,0.263897180557251,369.06368014205896,88,28,368,780,506,743,99,19,39.94
0,10,0,-0.0,10.0,0.27193617820739746,359.0933026387432,88,28,358,780,506,743,99,19,39.21
-1,11,0,-1.0,11.0,0.2799050807952881,348.209706929603,88,29,347,780,506,743,99,19,39.4
-2,14,0,-2.0,14.0,0.28797411918640137,334.43983016381287,88,31,333,780,506,743,99,19,43.34
-2,15,0,-2.0,15.0,0.297802209854126,319.70767898190996,88,33,318,780,506,743,99,19,43.56
-1,19,0,-1.0,19.0,0.3051431179046631,300.9269014229203,88,34,299,780,506,743,99,19,47.63
-2,19,0,-2.0,19.0,0.31261610984802246,282.3047998175022,88,36,280,780,506,743,99,19,44.93
0,19,0,-0.0,19.0,0.32030200958251953,263.47106102948004,88,36,261,780,506,743,99,19,43.76
0,19,0,-0.0,19.0,0.3280642032623291,244.6630335788388,88,36,242,780,506,743,99,19,41.45
1,17,0,1.0,17.0,0.3359031677246094,227.705950734714,88,35,225,780,506,743,99,19,38.14
1,17,0,1.0,17.0,0.34479403495788574,210.76052761368766,88,34,208,780,506,743,99,19,36.07
1,20,0,1.0,20.0,0.3518950939178467,190.87430418995638,88,33,188,780,506,743,99,19,35.95
2,20,0,2.0,20.0,0.3598940372467041,170.83617883809038,88,31,168,780,506,743,99,19,33.92
1,19,0,1.0,19.0,0.3684201240539551,151.99013125857877,88,30,149,780,506,743,99,19,29.74
1,17,0,1.0,17.0,0.37770915031433105,135.14806694880988,88,29,132,780,506,743,99,19,25.96
1,16,0,1.0,16.0,0.3871781826019287,119.33147112141039,88,28,116,780,506,743,99,19,23.01
2,15,0,2.0,15.0,0.39205408096313477,104.29285689825551,88,26,101,780,506,743,99,19,21.02
1,13,0,1.0,13.0,0.40030407905578613,91.48223871331527,88,25,88,780,506,743,99,19,17.21
2,12,0,2.0,12.0,0.4086291790008545,79.40403012442127,88,23,76,780,506,743,99,19,15.86
1,10,0,1.0,10.0,0.415985107421875,69.57010852370435,88,22,66,780,506,743,99,19,12.52
1,8,0,1.0,8.0,0.4253361225128174,61.68468205316454,88,21,58,780,506,743,99,19,10.39
2,7,0,2.0,7.0,0.431934118270874,54.42425929675111,88,19,51,780,506,743,99,19,10.69
1,7,0,1.0,7.0,0.4401571750640869,47.53945729601885,88,18,44,780,506,743,99,19,8.23
1,5,0,1.0,5.0,0.44833803176879883,42.5440947723653,88,17,39,780,506,743,99,19,6.82
0,5,0,-0.0,5.0,0.45632314682006836,38.01315561749642,88,17,34,780,506,743,99,19,5.06
0,4,0,-0.0,4.0,0.4733121395111084,34.48187929913333,88,17,30,780,506,743,99,19,4.04
0,4,0,-0.0,4.0,0.4735391139984131,31.064449134018133,88,17,26,780,506,743,99,19,3.57
0,3,0,-0.0,3.0,0.47991108894348145,28.600699292150182,88,17,23,780,506,743,99,19,2.74
0,3,0,-0.0,3.0,0.48789215087890625,26.248809496813376,88,17,20,780,506,743,99,19,2.39
0,2,0,-0.0,2.0,0.4958782196044922,24.758836806279895,88,17,18,780,506,743,99,19,1.77
0,1,0,-0.0,1.0,0.5038931369781494,24.041630560342615,88,17,17,780,506,743,99,19,1.36
0,2,0,-0.0,2.0,0.5118992328643799,22.67156809750927,88,17,15,780,506,743,99,19,1.44
1,1,0,1.0,1.0,0.5199050903320312,21.2602916254693,88,16,14,780,506,743,99,19,5.0
0,1,0,-0.0,1.0,0.5288300514221191,20.615528128088304,88,16,13,780,506,743,99,19,1.04
1,0,0,1.0,-0.0,0.5360031127929688,19.849433241279208,88,15,13,780,506,743,99,19,1.41
0,1,0,-0.0,1.0,0.5440471172332764,19.209372712298546,88,15,12,780,506,743,99,19,0.98
0,1,0,-0.0,1.0,0.5549461841583252,18.601075237738275,88,15,11,780,506,743,99,19,0.88
1,0,0,1.0,-0.0,0.5681822299957275,17.804493814764857,88,14,11,780,506,743,99,19,1.46
1,0,0,1.0,-0.0,0.6079630851745605,17.029386365926403,88,13,11,780,506,743,99,19,1.34
0,1,0,-0.0,1.0,0.6202361583709717,16.401219466856727,88,13,10,780,506,743,99,19,0.85
2,0,0,2.0,-0.0,0.6256120204925537,14.866068747318506,88,11,10,780,506,743,99,19,1.32
0,1,0,-0.0,1.0,0.6319050788879395,14.212670403551895,88,11,9,780,506,743,99,19,0.83
2,1,0,2.0,1.0,0.640052080154419,12.041594578792296,88,9,8,780,506,743,99,19,2.85
0,1,0,-0.0,1.0,0.6479001045227051,11.40175425099138,88,9,7,780,506,743,99,19,0.65
1,1,0,1.0,1.0,0.6559782028198242,10.0,88,8,6,780,506,743,99,19,3.37
1,1,0,1.0,1.0,0.6639041900634766,8.602325267042627,88,7,5,780,506,743,99,19,3.03
1,3,0,1.0,3.0,0.6722590923309326,6.324555320336759,88,6,2,780,506,743,99,19,0.24
0,3,0,-0.0,3.0,0.6813020706176758,6.082762530298219,88,6,-1,780,506,743,99,19,-1.66
1,2,0,1.0,2.0,0.6879000663757324,5.830951894845301,88,5,-3,780,506,743,99,19,-1.37
1,3,0,1.0,3.0,0.7002980709075928,7.211102550927978,88,4,-6,780,506,743,99,19,-1.28
0,2,0,-0.0,2.0,0.7039501667022705,8.94427190999916,88,4,-8,780,506,743,99,19,0.3
1,2,0,1.0,2.0,0.7119262218475342,10.44030650891055,88,3,-10,780,506,743,99,19,-0.16
0,1,0,-0.0,1.0,0.7199251651763916,11.40175425099138,88,3,-11,780,506,743,99,19,2.35
1,0,0,1.0,-0.0,0.7352590560913086,11.180339887498949,88,2,-11,780,506,743,99,19,-0.17
0,1,0,-0.0,1.0,0.7458820343017578,12.165525060596439,88,2,-12,780,506,743,99,19,3.05
0,0,1,-0.0,-0.0,-0.008024454116821289,761.0781825804758,89,702,-294,1480,224,778,518,55,175.39
0,0,0,-0.0,-0.0,0.07394170761108398,761.0781825804758,89,702,-294,1480,224,778,518,55,175.39
3,0,0,3.0,-0.0,0.20207667350769043,758.3119410902086,89,699,-294,1480,224,778,518,55,10.09
5,-2,0,5.0,-2.0,0.21077561378479004,752.9276193632427,89,694,-292,1480,224,778,518,55,20.53
6,-3,0,6.0,-3.0,0.21876168251037598,746.2338775477833,89,688,-289,1480,224,778,518,55,22.38
8,-3,0,8.0,-3.0,0.2259535789489746,737.6964145229391,89,680,-286,1480,224,778,518,55,27.08
9,-4,0,9.0,-4.0,0.2399766445159912,727.8495723705552,89,671,-282,1480,224,778,518,55,30.36
10,-6,0,10.0,-6.0,0.2433485984802246,716.3078946933365,89,661,-276,1480,224,778,518,55,31.43
9,-6,0,9.0,-6.0,0.2501816749572754,705.6939846704093,89,652,-270,1480,224,778,518,55,28.9
10,-7,0,10.0,-7.0,0.2578916549682617,693.7816659439769,89,642,-263,1480,224,778,518,55,31.02
10,-8,0,10.0,-8.0,0.266582727432251,681.5049522930849,89,632,-255,1480,224,778,518,55,31.03
13,-8,0,13.0,-8.0,0.2763216495513916,666.460801547998,89,619,-247,1480,224,778,518,55,36.31
15,-9,0,15.0,-9.0,0.2828977108001709,649.1995070854567,89,604,-238,1480,224,778,518,55,39.45
19,-11,0,19.0,-11.0,0.2899036407470703,627.4982071687535,89,585,-227,1480,224,778,518,55,45.26
23,-12,0,23.0,-12.0,0.2996985912322998,601.7216964677275,89,562,-215,1480,224,778,518,55,49.71
24,-12,0,24.0,-12.0,0.310443639755249,575.024347310616,89,538,-203,1480,224,778,518,55,49.56
26,-12,0,26.0,-12.0,0.3140275478363037,546.465918424928,89,512,-191,1480,224,778,518,55,50.44
27,-11,0,27.0,-11.0,0.3249776363372803,517.3248495867949,89,485,-180,1480,224,778,518,55,50.36
27,-10,0,27.0,-10.0,0.3304586410522461,488.53249636027283,89,458,-170,1480,224,778,518,55,50.1
27,-10,0,27.0,-10.0,0.33807969093322754,459.7401439944091,89,431,-160,1480,224,778,518,55,48.34
28,-9,0,28.0,-9.0,0.3458895683288574,430.360314155476,89,403,-151,1480,224,778,518,55,44.72
26,-9,0,26.0,-9.0,0.3557915687561035,402.85605369660266,89,377,-142,1480,224,778,518,55,41.9
25,-8,0,25.0,-8.0,0.36461853981018066,376.64306710730784,89,352,-134,1480,224,778,518,55,38.3
23,-8,0,23.0,-8.0,0.3713517189025879,352.30242690052535,89,329,-126,1480,224,778,518,55,35.75
19,-7,0,19.0,-7.0,0.3782515525817871,332.0557182160849,89,310,-119,1480,224,778,518,55,31.62
18,-7,0,18.0,-7.0,0.38613057136535645,312.74270575027003,89,292,-112,1480,224,778,518,55,30.31
14,-6,0,14.0,-6.0,0.3957695960998535,297.5231083462258,89,278,-106,1480,224,778,518,55,23.96
11,-5,0,11.0,-5.0,0.4019176959991455,285.4645336990219,89,267,-101,1480,224,778,518,55,19.69
9,-5,0,9.0,-5.0,0.4100615978240967,275.2816739269071,89,258,-96,1480,224,778,518,55,16.25
7,-3,0,7.0,-3.0,0.41793060302734375,267.67517628648346,89,251,-93,1480,224,778,518,55,14.54
7,-5,0,7.0,-5.0,0.4259026050567627,259.3838853899756,89,244,-88,1480,224,778,518,55,12.88
6,-4,0,6.0,-4.0,0.4338996410369873,252.38858928247924,89,238,-84,1480,224,778,518,55,11.39
6,-4,0,6.0,-4.0,0.442002534866333,245.40578640284747,89,232,-80,1480,224,778,518,55,11.15
7,-3,0,7.0,-3.0,0.4506807327270508,237.81084920583416,89,225,-77,1480,224,778,518,55,13.19
8,-4,0,8.0,-4.0,0.45807766914367676,228.9497761518888,89,217,-73,1480,224,778,518,55,13.38
8,-4,0,8.0,-4.0,0.46827173233032227,220.0954338463204,89,209,-69,1480,224,778,518,55,13.02
10,-4,0,10.0,-4.0,0.47519755363464355,209.34660255184463,89,199,-65,1480,224,778,518,55,15.32
10,-4,0,10.0,-4.0,0.48191356658935547,198.600100704909,89,189,-61,1480,224,778,518,55,14.8
10,-4,0,10.0,-4.0,0.4923126697540283,187.85632808079689,89,179,-57,1480,224,778,518,55,14.27
11,-3,0,11.0,-3.0,0.4979996681213379,176.4652940382329,89,168,-54,1480,224,778,518,55,14.82
13,-4,0,13.0,-4.0,0.5059115886688232,162.8649747490233,89,155,-50,1480,224,778,518,55,16.85
11,-3,0,11.0,-3.0,0.5139455795288086,151.47607071745688,89,144,-47,1480,224,778,518,55,13.52
10,-4,0,10.0,-4.0,0.5219085216522217,140.73023839957068,89,134,-43,1480,224,778,518,55,12.17
9,-4,0,9.0,-4.0,0.5301496982574463,130.9427355755179,89,125,-39,1480,224,778,518,55,10.49
7,-3,0,7.0,-3.0,0.5382957458496094,123.36936410632909,89,118,-36,1480,224,778,518,55,8.93
7,-2,0,7.0,-2.0,0.5464487075805664,116.09048195265622,89,111,-34,1480,224,778,518,55,10.48
7,-4,0,7.0,-4.0,0.5559847354888916,108.24047302187847,89,104,-30,1480,224,778,518,55,7.44
6,-2,0,6.0,-2.0,0.5637936592102051,101.92153844992725,89,98,-28,1480,224,778,518,55,8.59
8,-3,0,8.0,-3.0,0.5721416473388672,93.40770846134703,89,90,-25,1480,224,778,518,55,8.49
7,-3,0,7.0,-3.0,0.579810619354248,85.86617494683223,89,83,-22,1480,224,778,518,55,7.06
8,-2,0,8.0,-2.0,0.5867977142333984,77.62087348130012,89,75,-20,1480,224,778,518,55,9.63
6,-2,0,6.0,-2.0,0.5939147472381592,71.30918594402827,89,69,-18,1480,224,778,518,55,7.0
5,-2,0,5.0,-2.0,0.6019456386566162,65.96969000988257,89,64,-16,1480,224,778,518,55,5.51
5,-2,0,5.0,-2.0,0.6099326610565186,60.63827174318213,89,59,-14,1480,224,778,518,55,5.21
3,-2,0,3.0,-2.0,0.6179287433624268,57.271284253105414,89,56,-12,1480,224,778,518,55,3.16
3,-2,0,3.0,-2.0,0.6364495754241943,53.9351462406472,89,53,-10,1480,224,778,518,55,2.97
3,0,0,3.0,-0.0,0.637251615524292,50.99019513592785,89,50,-10,1480,224,778,518,55,3.79
2,-2,0,2.0,-2.0,0.642899751663208,48.662100242385755,89,48,-8,1480,224,778,518,55,1.93
3,-1,0,3.0,-1.0,0.65061354637146,45.5411901469428,89,45,-7,1480,224,778,518,55,3.92
2,-1,0,2.0,-1.0,0.658510684967041,43.41658669218482,89,43,-6,1480,224,778,518,55,2.72
3,-1,0,3.0,-1.0,0.6672656536102295,40.311288741492746,89,40,-5,1480,224,778,518,55,3.55
2,-1,0,2.0,-1.0,0.6739575862884521,38.2099463490856,89,38,-4,1480,224,778,518,55,2.47
3,-1,0,3.0,-1.0,0.685565710067749,35.12833614050059,89,35,-3,1480,224,778,518,55,3.14
2,-1,0,2.0,-1.0,0.6927285194396973,33.06055050963308,89,33,-2,1480,224,778,518,55,2.17
1,-1,0,1.0,-1.0,0.698596715927124,32.01562118716424,89,32,-1,1480,224,778,518,55,1.13
1,0,0,1.0,-0.0,0.7058975696563721,31.016124838541646,89,31,-1,1480,224,778,518,55,5.24
1,-1,0,1.0,-1.0,0.7139947414398193,30.0,89,30,0,1480,224,778,518,55,1.03
0,0,1,-0.0,-0.0,0.7199397087097168,30.0,89,30,0,1480,224,778,518,55,35.95
1,-1,1,1.0,-1.0,0.007415294647216797,1428.9583618846282,90,-1339,499,112,722,1450,224,39,6.71
1,0,1,1.0,-0.0,0.01538228988647461,1429.8954507235835,90,-1340,499,112,722,1450,224,39,8.7
0,0,0,-0.0,-0.0,0.0745084285736084,1429.8954507235835,90,-1340,499,112,722,1450,224,39,250.31
-1,0,0,-1.0,-0.0,0.17534232139587402,1428.9583618846282,90,-1339,499,112,722,1450,224,39,7.93
-4,0,0,-4.0,-0.0,0.18444347381591797,1425.2108615920663,90,-1335,499,112,722,1450,224,39,23.51
-5,3,0,-5.0,3.0,0.19130635261535645,1419.4773686114197,90,-1330,496,112,722,1450,224,39,34.18
-9,5,0,-9.0,5.0,0.20011329650878906,1409.2984070096722,90,-1321,491,112,722,1450,224,39,53.33
-11,9,0,-11.0,9.0,0.2075343132019043,1395.8595917928135,90,-1310,482,112,722,1450,224,39,63.83
-14,10,0,-14.0,10.0,0.21535730361938477,1379.2751719653334,90,-1296,472,112,722,1450,224,39,73.74
-17,13,0,-17.0,13.0,0.22363638877868652,1358.8679111672334,90,-1279,459,112,722,1450,224,39,83.64
-17,13,0,-17.0,13.0,0.23250436782836914,1338.4916884314225,90,-1262,446,112,722,1450,224,39,82.86
-17,14,0,-17.0,14.0,0.24203133583068848,1317.8197904114204,90,-1245,432,112,722,1450,224,39,82.75
-19,13,0,-19.0,13.0,0.24738335609436035,1295.6222443289557,90,-1226,419,112,722,1450,224,39,86.11
-21,13,0,-21.0,13.0,0.25533533096313477,1271.558492559426,90,-1205,406,112,722,1450,224,39,89.75
-23,13,0,-23.0,13.0,0.26372337341308594,1245.6215316058085,90,-1182,393,112,722,1450,224,39,92.99
-26,12,0,-26.0,12.0,0.27133631706237793,1217.1676137656636,90,-1156,381,112,722,1450,224,39,97.49
-27,11,0,-27.0,11.0,0.2815582752227783,1188.0829095648164,90,-1129,370,112,722,1450,224,39,97.98
-29,12,0,-29.0,12.0,0.2908632755279541,1156.790387235302,90,-1100,358,112,722,1450,224,39,100.32
-31,12,0,-31.0,12.0,0.30231547355651855,1123.6000177999288,90,-1069,346,112,722,1450,224,39,102.19
-31,14,0,-31.0,14.0,0.3042943477630615,1089.8018168456135,90,-1038,332,112,722,1450,224,39,100.55
-34,14,0,-34.0,14.0,0.31129026412963867,1053.1571582627162,90,-1004,318,112,722,1450,224,39,103.14
-35,14,0,-35.0,14.0,0.32315945625305176,1015.5673291318503,90,-969,304,112,722,1450,224,39,102.43
-36,13,0,-36.0,13.0,0.32906246185302734,977.3279899808457,90,-933,291,112,722,1450,224,39,101.7
-37,12,0,-37.0,12.0,0.3354072570800781,938.4332688049801,90,-896,279,112,722,1450,224,39,101.4
-38,12,0,-38.0,12.0,0.34334635734558105,898.5838859004762,90,-858,267,112,722,1450,224,39,100.61
-35,11,0,-35.0,11.0,0.35547327995300293,861.896165439898,90,-823,256,112,722,1450,224,39,94.62
-34,11,0,-34.0,11.0,0.362762451171875,826.1634220903271,90,-789,245,112,722,1450,224,39,90.56
-32,12,0,-32.0,12.0,0.36742448806762695,792.0467157939612,90,-757,233,112,722,1450,224,39,84.83
-29,10,0,-29.0,10.0,0.3792903423309326,761.3888625400295,90,-728,223,112,722,1450,224,39,79.05
-29,11,0,-29.0,11.0,0.38376736640930176,730.441647224472,90,-699,212,112,722,1450,224,39,76.75
-29,10,0,-29.0,10.0,0.39133334159851074,699.7885394888945,90,-670,202,112,722,1450,224,39,75.07
-29,9,0,-29.0,9.0,0.3993344306945801,669.4251265078119,90,-641,193,112,722,1450,224,39,74.05
-29,7,0,-29.0,7.0,0.41091132164001465,639.6405240445605,90,-612,186,112,722,1450,224,39,69.62
-29,7,0,-29.0,7.0,0.4167444705963135,609.8606398186392,90,-583,179,112,722,1450,224,39,67.57
-28,5,0,-28.0,5.0,0.42844343185424805,581.63648441273,90,-555,174,112,722,1450,224,39,62.85
-28,6,0,-28.0,6.0,0.43169546127319336,553.1301835915303,90,-527,168,112,722,1450,224,39,61.57
-28,6,0,-28.0,6.0,0.43944239616394043,524.6379704138845,90,-499,162,112,722,1450,224,39,59.47
-27,5,0,-27.0,5.0,0.4475233554840088,497.42637646188405,90,-472,157,112,722,1450,224,39,55.69
-27,6,0,-27.0,6.0,0.4554634094238281,469.9212700016887,90,-445,151,112,722,1450,224,39,54.33
-23,5,0,-23.0,5.0,0.4655733108520508,446.5422712353221,90,-422,146,112,722,1450,224,39,47.89
-20,4,0,-20.0,4.0,0.47324037551879883,426.34258525275186,90,-402,142,112,722,1450,224,39,42.42
-19,4,0,-19.0,4.0,0.4808323383331299,407.1031810241723,90,-383,138,112,722,1450,224,39,40.0
-15,3,0,-15.0,3.0,0.4875502586364746,391.9808668800047,90,-368,135,112,722,1450,224,39,33.42
-14,3,0,-14.0,3.0,0.5012092590332031,377.809475794348,90,-354,132,112,722,1450,224,39,31.36
-13,3,0,-13.0,3.0,0.5073482990264893,364.5846952355515,90,-341,129,112,722,1450,224,39,29.4
-11,3,0,-11.0,3.0,0.5113494396209717,353.23646470884063,90,-330,126,112,722,1450,224,39,26.45
-12,2,0,-12.0,2.0,0.5213804244995117,341.32096331752024,90,-318,124,112,722,1450,224,39,25.75
-11,3,0,-11.0,3.0,0.5273323059082031,329.98484813700156,90,-307,121,112,722,1450,224,39,25.2
-10,4,0,-10.0,4.0,0.5354733467102051,319.2146613174276,90,-297,117,112,722,1450,224,39,26.58
-10,3,0,-10.0,3.0,0.5436804294586182,308.8122406900348,90,-287,114,112,722,1450,224,39,23.15
-10,4,0,-10.0,4.0,0.5514054298400879,298.04194335697116,90,-277,110,112,722,1450,224,39,25.83
-10,4,0,-10.0,4.0,0.5593104362487793,287.2716484444645,90,-267,106,112,722,1450,224,39,25.31
-11,4,0,-11.0,4.0,0.5698513984680176,275.5721321178903,90,-256,102,112,722,1450,224,39,24.47
-8,3,0,-8.0,3.0,0.5764822959899902,267.02996086581743,90,-248,99,112,722,1450,224,39,20.2
-10,4,0,-10.0,4.0,0.5838983058929443,256.25963396524236,90,-238,95,112,722,1450,224,39,23.98
-8,4,0,-8.0,4.0,0.5949223041534424,247.34793308212625,90,-230,91,112,722,1450,224,39,18.32
-9,2,0,-9.0,2.0,0.6028332710266113,238.24777018893587,90,-221,89,112,722,1450,224,39,17.32
-7,4,0,-7.0,4.0,0.6073274612426758,230.2628932329306,90,-214,85,112,722,1450,224,39,15.76
-7,3,0,-7.0,3.0,0.6158394813537598,222.64994947226015,90,-207,82,112,722,1450,224,39,16.89
-8,3,0,-8.0,3.0,0.6233394145965576,214.1074496602115,90,-199,79,112,722,1450,224,39,18.01
-9,4,0,-9.0,4.0,0.6316683292388916,204.26698215815497,90,-190,75,112,722,1450,224,39,18.22
-10,4,0,-10.0,4.0,0.6393234729766846,193.49676999888138,90,-180,71,112,722,1450,224,39,20.32
-10,4,0,-10.0,4.0,0.6525073051452637,182.72657168567466,90,-170,67,112,722,1450,224,39,19.69
-9,5,0,-9.0,5.0,0.6555233001708984,172.52536045462998,90,-161,62,112,722,1450,224,39,15.4
-9,4,0,-9.0,4.0,0.6636133193969727,162.68988905276197,90,-152,58,112,722,1450,224,39,15.73
-8,4,0,-8.0,4.0,0.6713113784790039,153.79206741571556,90,-144,54,112,722,1450,224,39,13.58
-9,5,0,-9.0,5.0,0.679363489151001,143.6175476743702,90,-135,49,112,722,1450,224,39,13.54
-10,4,0,-10.0,4.0,0.6873502731323242,132.85330255586422,90,-125,45,112,722,1450,224,39,15.24
-9,4,0,-9.0,4.0,0.6953103542327881,123.03251602726817,90,-116,41,112,722,1450,224,39,12.98
-8,4,0,-8.0,4.0,0.7033863067626953,114.16216536138407,90,-108,37,112,722,1450,224,39,11.09
-7,3,0,-7.0,3.0,0.712449312210083,106.56922632730333,90,-101,34,112,722,1450,224,39,10.45
-8,4,0,-8.0,4.0,0.7197363376617432,97.71898484941399,90,-93,30,112,722,1450,224,39,9.95
-8,4,0,-8.0,4.0,0.7275063991546631,88.88756943465155,90,-85,26,112,722,1450,224,39,9.29
-10,3,0,-10.0,3.0,0.7354452610015869,78.44743462982075,90,-75,23,112,722,1450,224,39,13.04
-8,2,0,-8.0,2.0,0.7480072975158691,70.21395872616783,90,-67,21,112,722,1450,224,39,9.22
-8,3,0,-8.0,3.0,0.7513093948364258,61.68468205316454,90,-59,18,112,722,1450,224,39,8.75
-7,2,0,-7.0,2.0,0.7593903541564941,54.405882034941776,90,-52,16,112,722,1450,224,39,9.09
-7,2,0,-7.0,2.0,0.769355297088623,47.12748667179272,90,-45,14,112,722,1450,224,39,8.52
-7,2,0,-7.0,2.0,0.7774293422698975,39.84971769034255,90,-38,12,112,722,1450,224,39,7.9
-5,2,0,-5.0,2.0,0.7836744785308838,34.48187929913333,90,-33,10,112,722,1450,224,39,5.57
-6,1,0,-6.0,1.0,0.7913472652435303,28.460498941515414,90,-27,9,112,722,1450,224,39,4.57
-4,2,0,-4.0,2.0,0.7993993759155273,24.041630560342615,90,-23,7,112,722,1450,224,39,3.83
-5,1,0,-5.0,1.0,0.8073604106903076,18.973665961010276,90,-18,6,112,722,1450,224,39,4.04
-3,1,0,-3.0,1.0,0.8191924095153809,15.811388300841896,90,-15,5,112,722,1450,224,39,7.77
-4,1,0,-4.0,1.0,0.8236064910888672,11.704699910719626,90,-11,4,112,722,1450,224,39,3.57
-1,0,0,-1.0,-0.0,0.8323514461517334,10.770329614269007,90,-10,4,112,722,1450,224,39,1.67
-1,0,0,-1.0,-0.0,0.8398644924163818,9.848857801796104,90,-9,4,112,722,1450,224,39,1.48
0,0,1,-0.0,-0.0,0.9003703594207764,9.848857801796104,90,-9,4,112,722,1450,224,39,29.84
0,0,0,-0.0,-0.0,0.06527352333068848,1774.0405857815092,91,1682,-564,1803,154,121,718,29,280.05
1,0,0,1.0,-0.0,0.09125161170959473,1773.0924961772298,91,1681,-564,1803,154,121,718,29,11.0
4,0,0,4.0,-0.0,0.0995473861694336,1769.3007093199278,91,1677,-564,1803,154,121,718,29,33.9
5,-2,0,5.0,-2.0,0.10777544975280762,1763.9240346454833,91,1672,-562,1803,154,121,718,29,47.17
7,-1,0,7.0,-1.0,0.11618161201477051,1756.9706884293773,91,1665,-561,1803,154,121,718,29,55.69
8,-2,0,8.0,-2.0,0.12391448020935059,1748.750982844613,91,1657,-559,1803,154,121,718,29,64.04
12,-3,0,12.0,-3.0,0.13373351097106934,1736.421895738475,91,1645,-556,1803,154,121,718,29,84.73
14,-2,0,14.0,-2.0,0.13926053047180176,1722.5205368877319,91,1631,-554,1803,154,121,718,29,90.25
15,-2,0,15.0,-2.0,0.15003752708435059,1707.6767844062294,91,1616,-552,1803,154,121,718,29,93.66
15,-3,0,15.0,-3.0,0.15526151657104492,1692.5135154556374,91,1601,-549,1803,154,121,718,29,95.02
14,-3,0,14.0,-3.0,0.16571259498596191,1678.2982452472504,91,1587,-546,1803,154,121,718,29,90.92
15,-3,0,15.0,-3.0,0.17122459411621094,1663.139501064177,91,1572,-543,1803,154,121,718,29,94.14
15,-4,0,15.0,-4.0,0.1811513900756836,1647.6559106803822,91,1557,-539,1803,154,121,718,29,95.72
16,-3,0,16.0,-3.0,0.19003558158874512,1631.5566186927133,91,1541,-536,1803,154,121,718,29,96.67
19,-4,0,19.0,-4.0,0.19528841972351074,1612.298979718092,91,1522,-532,1803,154,121,718,29,107.19
22,-4,0,22.0,-4.0,0.2032785415649414,1590.2150797926674,91,1500,-528,1803,154,121,718,29,114.72
27,-6,0,27.0,-6.0,0.21128559112548828,1562.7581386766155,91,1473,-522,1803,154,121,718,29,127.8
32,-7,0,32.0,-7.0,0.21938443183898926,1530.2633760238791,91,1441,-515,1803,154,121,718,29,136.95
38,-8,0,38.0,-8.0,0.22725343704223633,1491.7969030669021,91,1403,-507,1803,154,121,718,29,145.38
38,-10,0,38.0,-10.0,0.23522138595581055,1452.664448522094,91,1365,-497,1803,154,121,718,29,144.9
42,-10,0,42.0,-10.0,0.24414539337158203,1409.786508660088,91,1323,-487,1803,154,121,718,29,147.61
41,-10,0,41.0,-10.0,0.2595334053039551,1367.8643938636608,91,1282,-477,1803,154,121,718,29,143.97
42,-11,0,42.0,-11.0,0.2597694396972656,1324.6720348825968,91,1240,-466,1803,154,121,718,29,143.32
42,-11,0,42.0,-11.0,0.26729345321655273,1281.4948302665914,91,1198,-455,1803,154,121,718,29,140.69
40,-12,0,40.0,-12.0,0.27523350715637207,1239.8439417926759,91,1158,-443,1803,154,121,718,29,136.69
42,-13,0,42.0,-13.0,0.2872025966644287,1195.974916124916,91,1116,-430,1803,154,121,718,29,136.86
41,-15,0,41.0,-15.0,0.29126548767089844,1152.3237392330334,91,1075,-415,1803,154,121,718,29,135.2
43,-15,0,43.0,-15.0,0.299222469329834,1106.808023100664,91,1032,-400,1803,154,121,718,29,133.71
47,-21,0,47.0,-21.0,0.30731940269470215,1055.3985029362132,91,985,-379,1803,154,121,718,29,135.53
48,-20,0,48.0,-20.0,0.31523752212524414,1003.4191546906009,91,937,-359,1803,154,121,718,29,132.86
48,-19,0,48.0,-19.0,0.3242335319519043,951.7988232814747,91,889,-340,1803,154,121,718,29,129.41
48,-16,0,48.0,-16.0,0.3312985897064209,901.253016638502,91,841,-324,1803,154,121,718,29,123.22
44,-13,0,44.0,-13.0,0.34036946296691895,855.5290760693058,91,797,-311,1803,154,121,718,29,114.56
41,-13,0,41.0,-13.0,0.34986162185668945,812.6130690556238,91,756,-298,1803,154,121,718,29,108.75
37,-11,0,37.0,-11.0,0.35657548904418945,774.1640652988228,91,719,-287,1803,154,121,718,29,100.78
35,-12,0,35.0,-12.0,0.36324357986450195,737.2116385407925,91,684,-275,1803,154,121,718,29,96.94
33,-11,0,33.0,-11.0,0.3778035640716553,702.4934163392566,91,651,-264,1803,154,121,718,29,91.47
31,-12,0,31.0,-12.0,0.3792424201965332,669.2563036684825,91,620,-252,1803,154,121,718,29,88.53
30,-11,0,30.0,-11.0,0.3926575183868408,637.3233088472443,91,590,-241,1803,154,121,718,29,83.72
29,-11,0,29.0,-11.0,0.39728355407714844,606.3175735536618,91,561,-230,1803,154,121,718,29,80.47
29,-11,0,29.0,-11.0,0.4032425880432129,575.3129583105182,91,532,-219,1803,154,121,718,29,77.86
27,-12,0,27.0,-12.0,0.4112246036529541,545.7783432859901,91,505,-207,1803,154,121,718,29,73.68
27,-11,0,27.0,-11.0,0.4193425178527832,516.6236541235796,91,478,-196,1803,154,121,718,29,72.33
25,-10,0,25.0,-10.0,0.42725157737731934,489.69888707245394,91,453,-186,1803,154,121,718,29,66.92
23,-9,0,23.0,-9.0,0.43541455268859863,465.0043010553773,91,430,-177,1803,154,121,718,29,61.71
22,-9,0,22.0,-9.0,0.4440305233001709,441.23463146040564,91,408,-168,1803,154,121,718,29,59.66
19,-8,0,19.0,-8.0,0.45131444931030273,420.61978079971465,91,389,-160,1803,154,121,718,29,53.45
18,-6,0,18.0,-6.0,0.45970749855041504,401.69266859130005,91,371,-154,1803,154,121,718,29,47.67
16,-7,0,16.0,-7.0,0.46733641624450684,384.2317009305713,91,355,-147,1803,154,121,718,29,45.68
15,-6,0,15.0,-6.0,0.475475549697876,368.0774375046642,91,340,-141,1803,154,121,718,29,42.97
17,-6,0,17.0,-6.0,0.4838135242462158,350.0771343575584,91,323,-135,1803,154,121,718,29,42.71
17,-6,0,17.0,-6.0,0.491957426071167,332.07980968435885,91,306,-129,1803,154,121,718,29,41.21
16,-6,0,16.0,-6.0,0.49925661087036133,315.0063491423625,91,290,-123,1803,154,121,718,29,39.08
14,-5,0,14.0,-5.0,0.5072314739227295,300.1666203960727,91,276,-118,1803,154,121,718,29,34.61
14,-6,0,14.0,-6.0,0.520674467086792,284.93508032532606,91,262,-112,1803,154,121,718,29,36.47
14,-5,0,14.0,-5.0,0.5278475284576416,270.09813031563175,91,248,-107,1803,154,121,718,29,32.27
12,-4,0,12.0,-4.0,0.5312213897705078,257.4975728040946,91,236,-103,1803,154,121,718,29,28.05
11,-4,0,11.0,-4.0,0.53924560546875,245.81700510745793,91,225,-99,1803,154,121,718,29,26.4
9,-5,0,9.0,-5.0,0.5499014854431152,235.5674001214939,91,216,-94,1803,154,121,718,29,23.3
8,-4,0,8.0,-4.0,0.5561203956604004,226.6362724719942,91,208,-90,1803,154,121,718,29,21.57
9,-3,0,9.0,-3.0,0.5632035732269287,217.18655575334307,91,199,-87,1803,154,121,718,29,21.14
6,-4,0,6.0,-4.0,0.5718154907226562,210.09045670853305,91,193,-83,1803,154,121,718,29,16.46
6,-3,0,6.0,-3.0,0.5794315338134766,203.39370688396434,91,187,-80,1803,154,121,718,29,16.96
5,-3,0,5.0,-3.0,0.5872795581817627,197.61831898890347,91,182,-77,1803,154,121,718,29,14.21
5,-2,0,5.0,-2.0,0.5966665744781494,192.23423212320952,91,177,-75,1803,154,121,718,29,15.55
5,-4,0,5.0,-4.0,0.6064674854278564,186.07794065928394,91,172,-71,1803,154,121,718,29,13.32
4,-2,0,4.0,-2.0,0.6112914085388184,181.61773041198373,91,168,-69,1803,154,121,718,29,12.35
5,-3,0,5.0,-3.0,0.6198194026947021,175.85505395068975,91,163,-66,1803,154,121,718,29,13.11
6,-3,0,6.0,-3.0,0.6279544830322266,169.1685549976709,91,157,-63,1803,154,121,718,29,14.87
7,-3,0,7.0,-3.0,0.6391515731811523,161.55494421403512,91,150,-60,1803,154,121,718,29,16.98
6,-2,0,6.0,-2.0,0.6448874473571777,155.24174696260025,91,144,-58,1803,154,121,718,29,14.06
8,-3,0,8.0,-3.0,0.6516134738922119,146.70037491431302,91,136,-55,1803,154,121,718,29,17.1
7,-2,0,7.0,-2.0,0.659529447555542,139.46325680981354,91,129,-53,1803,154,121,718,29,13.54
8,-3,0,8.0,-3.0,0.6672666072845459,130.92364186807515,91,121,-50,1803,154,121,718,29,15.81
8,-2,0,8.0,-2.0,0.6752314567565918,122.7721466783081,91,113,-48,1803,154,121,718,29,12.99
5,-2,0,5.0,-2.0,0.6841316223144531,117.38824472663352,91,108,-46,1803,154,121,718,29,12.26
6,-1,0,6.0,-1.0,0.6959614753723145,111.48542505637228,91,102,-45,1803,154,121,718,29,9.56
5,-2,0,5.0,-2.0,0.7020795345306396,106.10372283760829,91,97,-43,1803,154,121,718,29,11.22
7,-1,0,7.0,-1.0,0.7104434967041016,99.31767214348109,91,90,-42,1803,154,121,718,29,9.45
7,-1,0,7.0,-1.0,0.7152414321899414,92.57429448826494,91,83,-41,1803,154,121,718,29,8.9
6,-2,0,6.0,-2.0,0.7237305641174316,86.31338250816034,91,77,-39,1803,154,121,718,29,9.22
6,-1,0,6.0,-1.0,0.7312605381011963,80.52949770115296,91,71,-38,1803,154,121,718,29,7.43
5,-1,0,5.0,-1.0,0.7395665645599365,75.66372975210778,91,66,-37,1803,154,121,718,29,6.55
6,-1,0,6.0,-1.0,0.7472844123840332,69.9714227381436,91,60,-36,1803,154,121,718,29,6.57
6,-1,0,6.0,-1.0,0.7552564144134521,64.35060217278468,91,54,-35,1803,154,121,718,29,6.07
7,-2,0,7.0,-2.0,0.7632853984832764,57.42821606144492,91,47,-33,1803,154,121,718,29,6.68
5,-1,0,5.0,-1.0,0.77120041847229,52.80151512977634,91,42,-32,1803,154,121,718,29,4.7
5,-2,0,5.0,-2.0,0.7803695201873779,47.634021455258214,91,37,-30,1803,154,121,718,29,5.3
3,-1,0,3.0,-1.0,0.7879705429077148,44.68780594300866,91,34,-29,1803,154,121,718,29,3.67
3,-1,0,3.0,-1.0,0.7975714206695557,41.773197148410844,91,31,-28,1803,154,121,718,29,3.44
3,-2,0,3.0,-2.0,0.8037114143371582,38.2099463490856,91,28,-26,1803,154,121,718,29,4.92
3,-1,0,3.0,-1.0,0.812138557434082,35.35533905932738,91,25,-25,1803,154,121,718,29,2.98
3,-1,0,3.0,-1.0,0.8193645477294922,32.55764119219941,91,22,-24,1803,154,121,718,29,2.7
3,-2,0,3.0,-2.0,0.8276035785675049,29.068883707497267,91,19,-22,1803,154,121,718,29,3.7
3,-2,0,3.0,-2.0,0.843639612197876,25.612496949731394,91,16,-20,1803,154,121,718,29,3.31
3,-2,0,3.0,-2.0,0.8438065052032471,22.20360331117452,91,13,-18,1803,154,121,718,29,2.87
3,-2,0,3.0,-2.0,0.8523774147033691,18.867962264113206,91,10,-16,1803,154,121,718,29,2.38
3,-1,0,3.0,-1.0,0.8599746227264404,16.55294535724685,91,7,-15,1803,154,121,718,29,0.98
2,-2,0,2.0,-2.0,0.8722004890441895,13.92838827718412,91,5,-13,1803,154,121,718,29,1.91
2,-1,0,2.0,-1.0,0.8774065971374512,12.36931687685298,91,3,-12,1803,154,121,718,29,0.53
2,-1,0,2.0,-1.0,0.8841464519500732,11.045361017187261,91,1,-11,1803,154,121,718,29,0.12
1,0,0,1.0,-0.0,0.9054365158081055,11.0,91,0,-11,1803,154,121,718,29,-0.44
2,-1,0,2.0,-1.0,0.9057474136352539,10.198039027185569,91,-2,-10,1803,154,121,718,29,-0.47
2,-1,0,2.0,-1.0,0.9074795246124268,9.848857801796104,91,-4,-9,1803,154,121,718,29,-0.86
2,0,0,2.0,-0.0,0.9152195453643799,10.816653826391969,91,-6,-9,1803,154,121,718,29,-0.25
1,-2,0,1.0,-2.0,0.9274585247039795,9.899494936611665,91,-7,-7,1803,154,121,718,29,-0.4
1,0,0,1.0,-0.0,0.9312775135040283,10.63014581273465,91,-8,-7,1803,154,121,718,29,0.85
0,0,1,-0.0,-0.0,0.9742434024810791,10.63014581273465,91,-8,-7,1803,154,121,718,29,30.07
0,0,0,-0.0,-0.0,0.08185315132141113,1158.4528475514228,92,-1013,562,798,723,1811,161,9,223.31
-1,0,0,-1.0,-0.0,0.08638119697570801,1157.5785070568647,92,-1012,562,798,723,1811,161,9,20.9
-1,0,0,-1.0,-0.0,0.0916903018951416,1156.7043701828052,92,-1011,562,798,723,1811,161,9,20.89
-3,2,0,-3.0,2.0,0.0988471508026123,1153.110575790544,92,-1008,560,798,723,1811,161,9,65.78
-2,2,0,-2.0,2.0,0.10691118240356445,1150.3912377969505,92,-1006,558,798,723,1811,161,9,52.6
-4,1,0,-4.0,1.0,0.11481833457946777,1146.4087403714261,92,-1002,557,798,723,1811,161,9,68.67
-6,3,0,-6.0,3.0,0.1231532096862793,1139.7069798856196,92,-996,554,798,723,1811,161,9,96.39
-7,3,0,-7.0,3.0,0.1309802532196045,1132.1316177900871,92,-989,551,798,723,1811,161,9,101.51
-9,4,0,-9.0,4.0,0.15006732940673828,1122.3230372758103,92,-980,547,798,723,1811,161,9,114.88
-12,5,0,-12.0,5.0,0.15553736686706543,1109.4088515962003,92,-968,542,798,723,1811,161,9,128.15
-15,7,0,-15.0,7.0,0.1556682586669922,1092.9016424180174,92,-953,535,798,723,1811,161,9,139.7
-16,8,0,-16.0,8.0,0.1654503345489502,1075.0339529521846,92,-937,527,798,723,1811,161,9,142.6
-16,10,0,-16.0,10.0,0.17110419273376465,1056.1865365549781,92,-921,517,798,723,1811,161,9,143.64
-16,10,0,-16.0,10.0,0.17940616607666016,1037.3398671602283,92,-905,507,798,723,1811,161,9,142.17
-16,11,0,-16.0,11.0,0.18688130378723145,1018.0063850487383,92,-889,496,798,723,1811,161,9,140.99
-16,11,0,-16.0,11.0,0.1948552131652832,998.6761236757391,92,-873,485,798,723,1811,161,9,139.42
-17,12,0,-17.0,12.0,0.20281314849853516,977.9902862503287,92,-856,473,798,723,1811,161,9,140.41
-21,13,0,-21.0,13.0,0.21098828315734863,953.3231351435882,92,-835,460,798,723,1811,161,9,146.18
-28,14,0,-28.0,14.0,0.21947836875915527,922.0439252009635,92,-807,446,798,723,1811,161,9,151.89
-28,15,0,-28.0,15.0,0.23050928115844727,890.2819778025387,92,-779,431,798,723,1811,161,9,150.33
-28,14,0,-28.0,14.0,0.23491525650024414,859.0052386336185,92,-751,417,798,723,1811,161,9,145.68
-27,15,0,-27.0,15.0,0.24520635604858398,828.1183490298956,92,-724,402,798,723,1811,161,9,144.25
-27,14,0,-27.0,14.0,0.2525172233581543,797.7173684958852,92,-697,388,798,723,1811,161,9,138.97
-27,15,0,-27.0,15.0,0.2589542865753174,766.830489743333,92,-670,373,798,723,1811,161,9,137.83
-29,18,0,-29.0,18.0,0.2701702117919922,732.7386983092949,92,-641,355,798,723,1811,161,9,134.71
-32,18,0,-32.0,18.0,0.27485036849975586,696.0244248587833,92,-609,337,798,723,1811,161,9,134.14
-33,19,0,-33.0,19.0,0.28290414810180664,657.9513659838393,92,-576,318,798,723,1811,161,9,129.84
-33,20,0,-33.0,20.0,0.29149317741394043,619.3972876918335,92,-543,298,798,723,1811,161,9,124.49
-33,19,0,-33.0,19.0,0.29987335205078125,581.3269303928728,92,-510,279,798,723,1811,161,9,120.07
-31,18,0,-31.0,18.0,0.30681824684143066,545.4924380777427,92,-479,261,798,723,1811,161,9,113.85
-28,17,0,-28.0,17.0,0.3149423599243164,512.7738292853878,92,-451,244,798,723,1811,161,9,106.86
-25,17,0,-25.0,17.0,0.3236231803894043,482.70591461054215,92,-426,227,798,723,1811,161,9,99.99
-23,16,0,-23.0,16.0,0.3316781520843506,454.89559241654564,92,-403,211,798,723,1811,161,9,94.29
-18,14,0,-18.0,14.0,0.3395853042602539,432.4742766916895,92,-385,197,798,723,1811,161,9,85.83
-15,12,0,-15.0,12.0,0.34859633445739746,413.67257583746107,92,-370,185,798,723,1811,161,9,79.0
-13,12,0,-13.0,12.0,0.35491418838500977,396.7089613305956,92,-357,173,798,723,1811,161,9,73.86
-12,10,0,-12.0,10.0,0.3634493350982666,381.5678183495039,92,-345,163,798,723,1811,161,9,69.37
-12,10,0,-12.0,10.0,0.3708372116088867,366.46691528704196,92,-333,153,798,723,1811,161,9,67.37
-11,9,0,-11.0,9.0,0.37882018089294434,352.7321930303499,92,-322,144,798,723,1811,161,9,63.38
-12,9,0,-12.0,9.0,0.3868231773376465,338.11980125393427,92,-310,135,798,723,1811,161,9,63.17
-9,7,0,-9.0,7.0,0.3951892852783203,327.08561570328953,92,-301,128,798,723,1811,161,9,55.16
-11,8,0,-11.0,8.0,0.4041612148284912,313.8470965295043,92,-290,120,798,723,1811,161,9,57.82
-10,8,0,-10.0,8.0,0.41086721420288086,301.56922919953223,92,-280,112,798,723,1811,161,9,54.31
-12,8,0,-12.0,8.0,0.4196321964263916,287.4717377412952,92,-268,104,798,723,1811,161,9,55.81
-13,7,0,-13.0,7.0,0.43022727966308594,272.8259518447613,92,-255,97,798,723,1811,161,9,55.24
-13,8,0,-13.0,8.0,0.43540215492248535,257.84685377176896,92,-242,89,798,723,1811,161,9,52.97
-12,6,0,-12.0,6.0,0.44293928146362305,244.51789300580847,92,-230,83,798,723,1811,161,9,49.63
-11,7,0,-11.0,7.0,0.45299530029296875,231.81242417092315,92,-219,76,798,723,1811,161,9,46.05
-10,5,0,-10.0,5.0,0.46042728424072266,220.7306050369998,92,-209,71,798,723,1811,161,9,42.85
-7,4,0,-7.0,4.0,0.46962523460388184,212.82152146810716,92,-202,67,798,723,1811,161,9,35.48
-7,2,0,-7.0,2.0,0.4796633720397949,205.54804791094466,92,-195,65,798,723,1811,161,9,35.14
-5,3,0,-5.0,3.0,0.4828643798828125,199.85995096566995,92,-190,62,798,723,1811,161,9,28.5
-5,3,0,-5.0,3.0,0.4909632205963135,194.18032856085088,92,-185,59,798,723,1811,161,9,27.88
-6,3,0,-6.0,3.0,0.5054333209991455,187.55532517100121,92,-179,56,798,723,1811,161,9,30.05
-5,2,0,-5.0,2.0,0.5105133056640625,182.18671740826773,92,-174,54,798,723,1811,161,9,27.28
-7,3,0,-7.0,3.0,0.5166943073272705,174.61385970191483,92,-167,51,798,723,1811,161,9,31.1
-5,2,0,-5.0,2.0,0.5228452682495117,169.24833824885843,92,-162,49,798,723,1811,161,9,25.9
-5,2,0,-5.0,2.0,0.5318343639373779,163.88410539158457,92,-157,47,798,723,1811,161,9,25.32
-4,2,0,-4.0,2.0,0.5400123596191406,159.48040632002414,92,-153,45,798,723,1811,161,9,21.5
-6,2,0,-6.0,2.0,0.5468442440032959,153.16004700965587,92,-147,43,798,723,1811,161,9,27.38
-8,2,0,-8.0,2.0,0.5548162460327148,144.9206679531943,92,-139,41,798,723,1811,161,9,29.7
-9,2,0,-9.0,2.0,0.5646042823791504,135.72398461583714,92,-130,39,798,723,1811,161,9,29.16
-8,2,0,-8.0,2.0,0.5723881721496582,127.4872542648872,92,-122,37,798,723,1811,161,9,27.18
-7,2,0,-7.0,2.0,0.5788421630859375,120.20815280171308,92,-115,35,798,723,1811,161,9,25.91
-8,1,0,-8.0,1.0,0.5869672298431396,112.27199116431488,92,-107,34,798,723,1811,161,9,23.01
-8,1,0,-8.0,1.0,0.5951251983642578,104.35516278555652,92,-99,33,798,723,1811,161,9,21.79
-9,2,0,-9.0,2.0,0.6031992435455322,95.1892851112981,92,-90,31,798,723,1811,161,9,22.61
-9,1,0,-9.0,1.0,0.6108741760253906,86.37708029332781,92,-81,30,798,723,1811,161,9,19.87
-9,2,0,-9.0,2.0,0.6190953254699707,77.25283166331187,92,-72,28,798,723,1811,161,9,19.4
-8,1,0,-8.0,1.0,0.6271681785583496,69.46221994724903,92,-64,27,798,723,1811,161,9,16.2
-9,2,0,-9.0,2.0,0.6378073692321777,60.41522986797286,92,-55,25,798,723,1811,161,9,16.22
-8,2,0,-8.0,2.0,0.6433432102203369,52.32590180780452,92,-47,23,798,723,1811,161,9,14.22
-8,1,0,-8.0,1.0,0.6523323059082031,44.77722635447622,92,-39,22,798,723,1811,161,9,11.77
-6,2,0,-6.0,2.0,0.6588811874389648,38.58756276314948,92,-33,20,798,723,1811,161,9,10.68
-6,2,0,-6.0,2.0,0.6671142578125,32.449961479175904,92,-27,18,798,723,1811,161,9,9.51
-5,2,0,-5.0,2.0,0.6749413013458252,27.202941017470888,92,-22,16,798,723,1811,161,9,8.26
-5,2,0,-5.0,2.0,0.6831672191619873,22.02271554554524,92,-17,14,798,723,1811,161,9,7.17
-4,1,0,-4.0,1.0,0.6920351982116699,18.384776310850235,92,-13,13,798,723,1811,161,9,4.83
-3,2,0,-3.0,2.0,0.698810338973999,14.866068747318506,92,-10,11,798,723,1811,161,9,5.47
-3,1,0,-3.0,1.0,0.7071962356567383,12.206555615733702,92,-7,10,798,723,1811,161,9,3.13
-3,1,0,-3.0,1.0,0.7148911952972412,9.848857801796104,92,-4,9,798,723,1811,161,9,2.17
-1,1,0,-1.0,1.0,0.7230381965637207,8.54400374531753,92,-3,8,798,723,1811,161,9,2.46
-1,1,0,-1.0,1.0,0.7312793731689453,7.280109889280518,92,-2,7,798,723,1811,161,9,2.01
-1,0,0,-1.0,-0.0,0.7409181594848633,7.0710678118654755,92,-1,7,798,723,1811,161,9,-0.33
-1,1,0,-1.0,1.0,0.7507531642913818,6.0,92,0,6,798,723,1811,161,9,1.03
-1,1,0,-1.0,1.0,0.7576463222503662,5.0990195135927845,92,1,5,798,723,1811,161,9,0.4
-1,0,0,-1.0,-0.0,0.7650253772735596,5.385164807134504,92,2,5,798,723,1811,161,9,2.43
0,1,0,-0.0,1.0,0.7713572978973389,4.47213595499958,92,2,4,798,723,1811,161,9,1.57
-1,0,0,-1.0,-0.0,0.7788753509521484,5.0,92,3,4,798,723,1811,161,9,1.3
0,1,0,-0.0,1.0,0.7868473529815674,4.242640687119285,92,3,3,798,723,1811,161,9,0.64
-1,1,0,-1.0,1.0,0.7949211597442627,4.47213595499958,92,4,2,798,723,1811,161,9,2.32
-1,0,0,-1.0,-0.0,0.8028571605682373,5.385164807134504,92,5,2,798,723,1811,161,9,1.7
-1,2,0,-1.0,2.0,0.8108482360839844,6.0,92,6,0,798,723,1811,161,9,0.24
-1,1,0,-1.0,1.0,0.8188533782958984,7.0710678118654755,92,7,-1,798,723,1811,161,9,0.81
-1,1,0,-1.0,1.0,0.8319792747497559,8.246211251235321,92,8,-2,798,723,1811,161,9,1.14
0,2,0,-0.0,2.0,0.8381962776184082,8.94427190999916,92,8,-4,798,723,1811,161,9,0.76
-2,1,0,-2.0,1.0,0.8444571495056152,11.180339887498949,92,10,-5,798,723,1811,161,9,7.29
0,1,0,-0.0,1.0,0.8508272171020508,11.661903789690601,92,10,-6,798,723,1811,161,9,2.46
-1,1,0,-1.0,1.0,0.8589203357696533,13.038404810405298,92,11,-7,798,723,1811,161,9,2.79
-1,1,0,-1.0,1.0,0.874854326248169,14.422205101855956,92,12,-8,798,723,1811,161,9,3.04
0,0,1,-0.0,-0.0,0.9158482551574707,14.422205101855956,92,12,-8,798,723,1811,161,9,21.21
0,0,0,-0.0,-0.0,0.9928493499755859,14.422205101855956,92,12,-8,798,723,1811,161,9,21.21
0,-1,0,-0.0,-1.0,1.042842149734497,13.892443989449804,92,12,-7,798,723,1811,161,9,0.93
2,-1,0,2.0,-1.0,1.052929162979126,11.661903789690601,92,10,-6,798,723,1811,161,9,5.82
1,-1,0,1.0,-1.0,1.0588421821594238,10.295630140987,92,9,-5,798,723,1811,161,9,3.31
0,-1,0,-0.0,-1.0,1.0682432651519775,9.848857801796104,92,9,-4,798,723,1811,161,9,0.45
1,-1,0,1.0,-1.0,1.0779881477355957,8.54400374531753,92,8,-3,798,723,1811,161,9,2.46
1,-1,0,1.0,-1.0,1.0832412242889404,7.280109889280518,92,7,-2,798,723,1811,161,9,2.01
1,-1,0,1.0,-1.0,1.0908482074737549,6.082762530298219,92,6,-1,798,723,1811,161,9,1.49
1,-1,0,1.0,-1.0,1.099116325378418,5.0,92,5,0,798,723,1811,161,9,0.87
1,0,0,1.0,-0.0,1.1068601608276367,4.0,92,4,0,798,723,1811,161,9,7.79
0,-1,0,-0.0,-1.0,1.1149492263793945,4.123105625617661,92,4,1,798,723,1811,161,9,4.24
1,0,0,1.0,-0.0,1.1281771659851074,3.1622776601683795,92,3,1,798,723,1811,161,9,1.84
2,-2,0,2.0,-2.0,1.1314551830291748,3.1622776601683795,92,1,3,798,723,1811,161,9,8.64
1,0,0,1.0,-0.0,1.1388702392578125,3.0,92,0,3,798,723,1811,161,9,-1.16
1,-1,0,1.0,-1.0,1.150050163269043,4.123105625617661,92,-1,4,798,723,1811,161,9,0.14
1,0,0,1.0,-0.0,1.1548292636871338,4.47213595499958,92,-2,4,798,723,1811,161,9,1.78
0,-1,0,-0.0,-1.0,1.178856372833252,5.385164807134504,92,-2,5,798,723,800,719,9,1.7
0,0,1,-0.0,-0.0,-0.0007178783416748047,987.4775946825325,93,986,54,1786,772,800,719,46,204.16
0,0,0,-0.0,-0.0,0.08403420448303223,987.4775946825325,93,986,54,1786,772,800,719,46,204.16
2,0,0,2.0,-0.0,0.1834850311279297,985.4805934162275,93,984,54,1786,772,800,719,46,12.78
1,-2,0,1.0,-2.0,0.19100522994995117,984.5938248841499,93,983,56,1786,772,800,719,46,4.27
2,-1,0,2.0,-1.0,0.19909119606018066,982.6545679942673,93,981,57,1786,772,800,719,46,9.63
4,-1,0,4.0,-1.0,0.20882606506347656,978.7200825568054,93,977,58,1786,772,800,719,46,17.87
6,-1,0,6.0,-1.0,0.21535515785217285,972.7908305488904,93,971,59,1786,772,800,719,46,25.12
9,-1,0,9.0,-1.0,0.2229611873626709,963.8692857436635,93,962,60,1786,772,800,719,46,34.72
11,-2,0,11.0,-2.0,0.2310330867767334,953.0188875358137,93,951,62,1786,772,800,719,46,39.51
13,-1,0,13.0,-1.0,0.23979520797729492,940.1132910452867,93,938,63,1786,772,800,719,46,45.32
13,-2,0,13.0,-2.0,0.2469940185546875,927.2809714428523,93,925,65,1786,772,800,719,46,44.21
14,-1,0,14.0,-1.0,0.2558441162109375,913.3876504529717,93,911,66,1786,772,800,719,46,47.02
18,0,0,18.0,-0.0,0.2645270824432373,895.4356481623903,93,893,66,1786,772,800,719,46,56.37
22,0,0,22.0,-0.0,0.270963191986084,873.4969948431419,93,871,66,1786,772,800,719,46,63.27
26,0,0,26.0,-0.0,0.27944421768188477,847.5735956245924,93,845,66,1786,772,800,719,46,68.88
30,1,0,30.0,1.0,0.2899770736694336,817.5879157619687,93,815,65,1786,772,800,719,46,74.07
35,2,0,35.0,2.0,0.29503321647644043,782.5400948194284,93,780,63,1786,772,800,719,46,79.36
37,2,0,37.0,2.0,0.30542612075805664,745.4998323272782,93,743,61,1786,772,800,719,46,79.24
39,3,0,39.0,3.0,0.3118870258331299,706.385164057117,93,704,58,1786,772,800,719,46,80.12
42,3,0,42.0,3.0,0.322249174118042,664.2808141140312,93,662,55,1786,772,800,719,46,79.66
43,2,0,43.0,2.0,0.32720518112182617,621.2648388569886,93,619,53,1786,772,800,719,46,76.19
44,3,0,44.0,3.0,0.33604907989501953,577.1698190307598,93,575,50,1786,772,800,719,46,74.44
42,2,0,42.0,2.0,0.3432271480560303,535.156986313362,93,533,48,1786,772,800,719,46,68.59
42,3,0,42.0,3.0,0.351337194442749,493.0578059416563,93,491,45,1786,772,800,719,46,66.0
42,2,0,42.0,2.0,0.36586618423461914,451.0543204537564,93,449,43,1786,772,800,719,46,61.39
42,0,0,42.0,-0.0,0.3704080581665039,409.26519519744164,93,407,43,1786,772,800,719,46,56.51
36,0,0,36.0,-0.0,0.3750441074371338,373.48360071092816,93,371,43,1786,772,800,719,46,49.07
32,1,0,32.0,1.0,0.3835301399230957,341.5918617297549,93,339,42,1786,772,800,719,46,43.8
28,2,0,28.0,2.0,0.39099621772766113,313.56179614232343,93,311,40,1786,772,800,719,46,39.17
25,3,0,25.0,3.0,0.39899206161499023,288.38342532122056,93,286,37,1786,772,800,719,46,36.73
25,2,0,25.0,2.0,0.40723323822021484,263.3362869032675,93,261,35,1786,772,800,719,46,32.9
21,2,0,21.0,2.0,0.41570210456848145,242.25812679866902,93,240,33,1786,772,800,719,46,28.56
21,1,0,21.0,1.0,0.4253051280975342,221.32555207205516,93,219,32,1786,772,800,719,46,25.8
18,1,0,18.0,1.0,0.43125224113464355,203.37649815059754,93,201,31,1786,772,800,719,46,22.29
18,2,0,18.0,2.0,0.43927812576293945,185.28356645962967,93,183,29,1786,772,800,719,46,22.0
16,1,0,16.0,1.0,0.4482271671295166,169.33103672983285,93,167,28,1786,772,800,719,46,18.38
17,2,0,17.0,2.0,0.45510411262512207,152.2366578718805,93,150,26,1786,772,800,719,46,18.69
17,2,0,17.0,2.0,0.4629662036895752,135.14806694880988,93,133,24,1786,772,800,719,46,17.22
17,3,0,17.0,3.0,0.47185516357421875,117.88553770501282,93,116,21,1786,772,800,719,46,18.4
16,3,0,16.0,3.0,0.4818460941314697,101.6070863670443,93,100,18,1786,772,800,719,46,16.35
16,3,0,16.0,3.0,0.48720407485961914,85.32877591996736,93,84,15,1786,772,800,719,46,14.92
18,3,0,18.0,3.0,0.49538302421569824,67.08203932499369,93,66,12,1786,772,800,719,46,13.54
15,3,0,15.0,3.0,0.510883092880249,51.78802950489621,93,51,9,1786,772,800,719,46,10.81
15,3,0,15.0,3.0,0.5113952159881592,36.49657518178932,93,36,6,1786,772,800,719,46,9.0
13,1,0,13.0,1.0,0.5189640522003174,23.53720459187964,93,23,5,1786,772,800,719,46,5.36
12,2,0,12.0,2.0,0.5275251865386963,11.40175425099138,93,11,3,1786,772,800,719,46,4.42
10,2,0,10.0,2.0,0.5350661277770996,1.4142135623730951,93,1,1,1786,772,800,719,46,0.31
8,0,0,8.0,-0.0,0.5436091423034668,7.0710678118654755,93,-7,1,1786,772,800,719,46,-2.48
5,1,0,5.0,1.0,0.55100417137146,12.0,93,-12,0,1786,772,800,719,46,0.04
1,0,0,1.0,-0.0,0.5599141120910645,13.0,93,-13,0,1786,772,800,719,46,6.94
0,0,1,-0.0,-0.0,0.6800072193145752,13.0,93,-13,0,1786,772,800,719,46,30.78
-1,0,1,-1.0,-0.0,0.04876255989074707,1288.9844840028138,94,-1116,-645,682,127,1799,772,68,4.57
-1,0,1,-1.0,-0.0,0.05747556686401367,1288.1187833425922,94,-1115,-645,682,127,1799,772,68,4.57
-1,0,1,-1.0,-0.0,0.06755447387695312,1287.253277331233,94,-1114,-645,682,127,1799,772,68,4.57
-2,1,1,-2.0,1.0,0.07276344299316406,1286.0248831185188,94,-1112,-646,682,127,1799,772,68,4.85
0,0,0,-0.0,-0.0,0.07980847358703613,1286.0248831185188,94,-1112,-646,682,127,1799,772,68,236.46
-1,0,0,-1.0,-0.0,0.08122444152832031,1285.1603012854077,94,-1111,-646,682,127,1799,772,68,4.56
-1,1,0,-1.0,1.0,0.08879566192626953,1284.7992061018717,94,-1110,-647,682,127,1799,772,68,1.59
-1,0,0,-1.0,-0.0,0.09746766090393066,1283.9353566282066,94,-1109,-647,682,127,1799,772,68,4.55
-2,1,0,-2.0,1.0,0.11033344268798828,1282.713140183728,94,-1107,-648,682,127,1799,772,68,4.82
-3,1,0,-3.0,1.0,0.11693263053894043,1280.6314848542495,94,-1104,-649,682,127,1799,772,68,7.79
-5,1,0,-5.0,1.0,0.12837767601013184,1276.8324087365577,94,-1099,-650,682,127,1799,772,68,13.29
-7,0,0,-7.0,-0.0,0.12926959991455078,1270.8123386243935,94,-1092,-650,682,127,1799,772,68,20.16
-9,0,0,-9.0,-0.0,0.13678359985351562,1263.087091217387,94,-1083,-650,682,127,1799,772,68,24.77
-10,0,0,-10.0,-0.0,0.14475655555725098,1254.5234154849402,94,-1073,-650,682,127,1799,772,68,26.89
-12,0,0,-12.0,-0.0,0.15428662300109863,1244.2752910831268,94,-1061,-650,682,127,1799,772,68,31.06
-13,0,0,-13.0,-0.0,0.16430449485778809,1233.2088225438545,94,-1048,-650,682,127,1799,772,68,32.91
-15,-1,0,-15.0,-1.0,0.17226552963256836,1219.954917199812,94,-1033,-649,682,127,1799,772,68,38.02
-16,-3,0,-16.0,-3.0,0.17675256729125977,1204.8257135370245,94,-1017,-646,682,127,1799,772,68,42.3
-19,-3,0,-19.0,-3.0,0.18571853637695312,1187.2038578104437,94,-998,-643,682,127,1799,772,68,47.05
-21,-5,0,-21.0,-5.0,0.1931314468383789,1166.8646022568344,94,-977,-638,682,127,1799,772,68,52.15
-25,-6,0,-25.0,-6.0,0.2019035816192627,1142.6845583974607,94,-952,-632,682,127,1799,772,68,58.39
-28,-7,0,-28.0,-7.0,0.20891165733337402,1115.5272296093897,94,-924,-625,682,127,1799,772,68,62.48
-28,-9,0,-28.0,-9.0,0.21858954429626465,1087.3233189810655,94,-896,-616,682,127,1799,772,68,63.46
-30,-9,0,-30.0,-9.0,0.227433443069458,1057.5466892766485,94,-866,-607,682,127,1799,772,68,64.67
-29,-10,0,-29.0,-10.0,0.2327594757080078,1028.0943536465902,94,-837,-597,682,127,1799,772,68,63.32
-31,-12,0,-31.0,-12.0,0.24080944061279297,995.9221857153299,94,-806,-585,682,127,1799,772,68,66.07
-30,-12,0,-30.0,-12.0,0.24891352653503418,964.6268708676946,94,-776,-573,682,127,1799,772,68,63.73
-30,-13,0,-30.0,-13.0,0.2573275566101074,932.8000857632894,94,-746,-560,682,127,1799,772,68,63.31
-29,-14,0,-29.0,-14.0,0.26471948623657227,901.2241674522494,94,-717,-546,682,127,1799,772,68,61.96
-28,-13,0,-28.0,-13.0,0.2727634906768799,871.0970095230496,94,-689,-533,682,127,1799,772,68,58.77
-27,-14,0,-27.0,-14.0,0.2808656692504883,841.1926057687383,94,-662,-519,682,127,1799,772,68,57.54
-24,-15,0,-24.0,-15.0,0.2891654968261719,813.0559636335005,94,-638,-504,682,127,1799,772,68,54.88
-25,-16,0,-25.0,-16.0,0.2969486713409424,783.5260046737441,94,-613,-488,682,127,1799,772,68,55.52
-25,-18,0,-25.0,-18.0,0.30480051040649414,752.7575971054692,94,-588,-470,682,127,1799,772,68,56.56
-26,-17,0,-26.0,-17.0,0.3133525848388672,721.8400099745095,94,-562,-453,682,127,1799,772,68,54.54
-28,-18,0,-28.0,-18.0,0.32199549674987793,688.7532214080744,94,-534,-435,682,127,1799,772,68,55.19
-28,-18,0,-28.0,-18.0,0.3308844566345215,655.6866629724902,94,-506,-417,682,127,1799,772,68,53.49
-26,-16,0,-26.0,-16.0,0.3367605209350586,625.460630255814,94,-480,-401,682,127,1799,772,68,48.84
-24,-17,0,-24.0,-17.0,0.3514595031738281,596.1476327219626,94,-456,-384,682,127,1799,772,68,47.21
-21,-14,0,-21.0,-14.0,0.35275745391845703,571.0735504293646,94,-435,-370,682,127,1799,772,68,41.14
-20,-15,0,-20.0,-15.0,0.363567590713501,546.122696836526,94,-415,-355,682,127,1799,772,68,40.66
-20,-16,0,-20.0,-16.0,0.37140846252441406,520.5247352431967,94,-395,-339,682,127,1799,772,68,40.87
-19,-15,0,-19.0,-15.0,0.3768045902252197,496.33859410688586,94,-376,-324,682,127,1799,772,68,38.07
-19,-14,0,-19.0,-14.0,0.38472747802734375,472.8096868720014,94,-357,-310,682,127,1799,772,68,35.59
-19,-15,0,-19.0,-15.0,0.3927435874938965,448.63013719544074,94,-338,-295,682,127,1799,772,68,35.66
-16,-13,0,-16.0,-13.0,0.40361762046813965,428.0280364649026,94,-322,-282,682,127,1799,772,68,31.58
-16,-13,0,-16.0,-13.0,0.4109005928039551,407.4272941274308,94,-306,-269,682,127,1799,772,68,30.61
-14,-12,0,-14.0,-12.0,0.4167954921722412,388.98971708774,94,-292,-257,682,127,1799,772,68,28.73
-13,-11,0,-13.0,-11.0,0.4248616695404053,371.96370790710216,94,-279,-246,682,127,1799,772,68,26.29
-14,-11,0,-14.0,-11.0,0.43660449981689453,354.18921496849674,94,-265,-235,682,127,1799,772,68,25.13
-14,-11,0,-14.0,-11.0,0.44089460372924805,336.4178948867019,94,-251,-224,682,127,1799,772,68,24.29
-16,-10,0,-16.0,-10.0,0.44872450828552246,317.8380090549272,94,-235,-214,682,127,1799,772,68,22.78
-15,-10,0,-15.0,-10.0,0.45751452445983887,300.0266654815868,94,-220,-204,682,127,1799,772,68,21.48
-16,-9,0,-16.0,-9.0,0.4648854732513428,282.207370562854,94,-204,-195,682,127,1799,772,68,20.03
-16,-10,0,-16.0,-10.0,0.47274160385131836,263.75936002348806,94,-188,-185,682,127,1799,772,68,19.79
-15,-9,0,-15.0,-9.0,0.4807605743408203,246.78938388836744,94,-173,-176,682,127,1799,772,68,17.69
-14,-8,0,-14.0,-8.0,0.48874354362487793,231.3114783144148,94,-159,-168,682,127,1799,772,68,15.7
-14,-8,0,-14.0,-8.0,0.4967224597930908,215.92822881689185,94,-145,-160,682,127,1799,772,68,14.82
-14,-7,0,-14.0,-7.0,0.5047504901885986,201.41995928904365,94,-131,-153,682,127,1799,772,68,13.24
-12,-7,0,-12.0,-7.0,0.5143616199493408,188.35339126227592,94,-119,-146,682,127,1799,772,68,11.89
-13,-6,0,-13.0,-6.0,0.5207414627075195,175.60182231400674,94,-106,-140,682,127,1799,772,68,10.69
-11,-6,0,-11.0,-6.0,0.5288405418395996,164.2589419179364,94,-95,-134,682,127,1799,772,68,9.5
-8,-6,0,-8.0,-6.0,0.5367295742034912,154.76756766196203,94,-87,-128,682,127,1799,772,68,8.52
-7,-5,0,-7.0,-5.0,0.549675464630127,146.72763884149435,94,-80,-123,682,127,1799,772,68,7.24
-6,-5,0,-6.0,-5.0,0.5581715106964111,139.2838827718412,94,-74,-118,682,127,1799,772,68,6.92
-6,-5,0,-6.0,-5.0,0.5607526302337646,131.88252348207476,94,-68,-113,682,127,1799,772,68,6.59
-6,-6,0,-6.0,-6.0,0.5687375068664551,123.664869708418,94,-62,-107,682,127,1799,772,68,7.1
-4,-5,0,-4.0,-5.0,0.5813655853271484,117.33712115098103,94,-58,-102,682,127,1799,772,68,6.66
-4,-4,0,-4.0,-4.0,0.5878925323486328,111.89280584559492,94,-54,-98,682,127,1799,772,68,5.29
-4,-4,0,-4.0,-4.0,0.5931715965270996,106.47065323364932,94,-50,-94,682,127,1799,772,68,5.08
-3,-4,0,-3.0,-4.0,0.6094515323638916,101.53324578678651,94,-47,-90,682,127,1799,772,68,5.57
-2,-4,0,-2.0,-4.0,0.6099076271057129,97.06183596038146,94,-45,-86,682,127,1799,772,68,7.77
-2,-3,0,-2.0,-3.0,0.6167416572570801,93.47726996441435,94,-43,-83,682,127,1799,772,68,5.33
-2,-3,0,-2.0,-3.0,0.6247694492340088,89.89438247187641,94,-41,-80,682,127,1799,772,68,5.22
-1,-2,0,-1.0,-2.0,0.6327986717224121,87.65842800324451,94,-40,-78,682,127,1799,772,68,7.03
-2,-3,0,-2.0,-3.0,0.6410775184631348,84.07734534343957,94,-38,-75,682,127,1799,772,68,5.06
-2,-4,0,-2.0,-4.0,0.6491985321044922,79.60527620704548,94,-36,-71,682,127,1799,772,68,8.2
-2,-3,0,-2.0,-3.0,0.6568214893341064,76.02631123499285,94,-34,-68,682,127,1799,772,68,4.84
-2,-3,0,-2.0,-3.0,0.6660685539245605,72.44998274671983,94,-32,-65,682,127,1799,772,68,4.71
0,-3,0,-0.0,-3.0,0.6727526187896729,69.77105417004964,94,-32,-62,682,127,1799,772,68,2.58
-1,-2,0,-1.0,-2.0,0.6807606220245361,67.53517601961218,94,-31,-60,682,127,1799,772,68,6.64
0,-1,0,-0.0,-1.0,0.6887445449829102,66.64833081180653,94,-31,-59,682,127,1799,772,68,2.02
0,-2,0,-0.0,-2.0,0.6991374492645264,64.88451279003334,94,-31,-57,682,127,1799,772,68,2.19
0,0,1,-0.0,-0.0,0.7107524871826172,64.88451279003334,94,-31,-57,682,127,1799,772,68,46.58
0,-1,1,-0.0,-1.0,0.0058689117431640625,842.6986412710062,95,-554,635,159,818,713,184,17,14.24
-1,0,1,-1.0,-0.0,0.0560908317565918,842.0415666699596,95,-553,635,159,818,713,184,17,7.67
0,0,0,-0.0,-0.0,0.08762097358703613,842.0415666699596,95,-553,635,159,818,713,184,17,186.19
-1,0,0,-1.0,-0.0,0.19882893562316895,841.3851674471092,95,-552,635,159,818,713,184,17,7.66
-1,-1,0,-1.0,-1.0,0.21445798873901367,841.4849968953695,95,-551,636,159,818,713,184,17,66.73
-2,0,0,-2.0,-0.0,0.23894381523132324,840.1767671151114,95,-549,636,159,818,713,184,17,13.78
-3,3,0,-3.0,3.0,0.24608087539672852,835.9455723909302,95,-546,633,159,818,713,184,17,39.83
-7,6,0,-7.0,6.0,0.2542569637298584,826.8313008105099,95,-539,627,159,818,713,184,17,65.21
-9,7,0,-9.0,7.0,0.2641468048095703,815.6592425762121,95,-530,620,159,818,713,184,17,72.67
-9,10,0,-9.0,10.0,0.26982879638671875,802.2100722379395,95,-521,610,159,818,713,184,17,82.2
-11,11,0,-11.0,11.0,0.2786409854888916,786.7026121731134,95,-510,599,159,818,713,184,17,86.13
-12,13,0,-12.0,13.0,0.28560590744018555,769.0253571892152,95,-498,586,159,818,713,184,17,91.28
-14,15,0,-14.0,15.0,0.2947368621826172,748.52989252267,95,-484,571,159,818,713,184,17,95.8
-14,17,0,-14.0,17.0,0.3026309013366699,726.5094631179968,95,-470,554,159,818,713,184,17,98.11
-16,21,0,-16.0,21.0,0.31032395362854004,700.1464132593982,95,-454,533,159,818,713,184,17,101.66
-16,22,0,-16.0,22.0,0.31796979904174805,673.0267453823808,95,-438,511,159,818,713,184,17,99.82
-17,23,0,-17.0,23.0,0.32956385612487793,644.5036850166181,95,-421,488,159,818,713,184,17,99.06
-18,25,0,-18.0,25.0,0.3335838317871094,613.8224498989915,95,-403,463,159,818,713,184,17,98.31
-19,26,0,-19.0,26.0,0.34247589111328125,581.743070435738,95,-384,437,159,818,713,184,17,96.51
-18,23,0,-18.0,23.0,0.34999680519104004,552.5866447897561,95,-366,414,159,818,713,184,17,90.93
-16,22,0,-16.0,22.0,0.35766100883483887,525.5130826154568,95,-350,392,159,818,713,184,17,85.15
-15,21,0,-15.0,21.0,0.3656928539276123,499.8659820391862,95,-335,371,159,818,713,184,17,80.64
-14,19,0,-14.0,19.0,0.3736128807067871,476.38744735771536,95,-321,352,159,818,713,184,17,75.65
-12,17,0,-12.0,17.0,0.3836209774017334,455.7477372406801,95,-309,335,159,818,713,184,17,69.43
-12,16,0,-12.0,16.0,0.3896329402923584,435.85548063549686,95,-297,319,159,818,713,184,17,66.63
-10,14,0,-10.0,14.0,0.39763593673706055,418.8006685763527,95,-287,305,159,818,713,184,17,60.27
-10,14,0,-10.0,14.0,0.40816497802734375,401.75863400803223,95,-277,291,159,818,713,184,17,58.57
-9,12,0,-9.0,12.0,0.4149899482727051,386.86560974064366,95,-268,279,159,818,713,184,17,53.71
-8,10,0,-8.0,10.0,0.4216268062591553,374.1136191052125,95,-260,269,159,818,713,184,17,48.87
-9,12,0,-9.0,12.0,0.4310169219970703,359.23529893372114,95,-251,257,159,818,713,184,17,51.03
-9,11,0,-9.0,11.0,0.44057679176330566,345.0797009387831,95,-242,246,159,818,713,184,17,48.92
-9,10,0,-9.0,10.0,0.44663095474243164,331.6398649137344,95,-233,236,159,818,713,184,17,47.24
-10,11,0,-10.0,11.0,0.45365285873413086,316.7869946825469,95,-223,225,159,818,713,184,17,48.23
-10,10,0,-10.0,10.0,0.4633769989013672,302.6450065671,95,-213,215,159,818,713,184,17,47.41
-9,8,0,-9.0,8.0,0.4740409851074219,290.6286290096005,95,-204,207,159,818,713,184,17,40.54
-11,9,0,-11.0,9.0,0.47766900062561035,276.5013562353718,95,-193,198,159,818,713,184,17,41.89
-9,8,0,-9.0,8.0,0.4869978427886963,264.4919658515169,95,-184,190,159,818,713,184,17,37.94
-10,8,0,-10.0,8.0,0.4959869384765625,251.79356624028344,95,-174,182,159,818,713,184,17,37.04
-11,7,0,-11.0,7.0,0.5018208026885986,239.15267090291925,95,-163,175,159,818,713,184,17,34.8
-10,6,0,-10.0,6.0,0.5096259117126465,227.96929617823537,95,-153,169,159,818,713,184,17,31.3
-8,5,0,-8.0,5.0,0.5182600021362305,218.908656749796,95,-145,164,159,818,713,184,17,27.01
-8,5,0,-8.0,5.0,0.5266058444976807,209.88091861815357,95,-137,159,159,818,713,184,17,26.12
-9,5,0,-9.0,5.0,0.5372209548950195,200.24984394500785,95,-128,154,159,818,713,184,17,25.95
-9,5,0,-9.0,5.0,0.5425698757171631,190.68822721919673,95,-119,149,159,818,713,184,17,24.89
-9,4,0,-9.0,4.0,0.549623966217041,182.00274723201295,95,-110,145,159,818,713,184,17,22.38
-9,5,0,-9.0,5.0,0.5576498508453369,172.62966141425406,95,-101,140,159,818,713,184,17,22.75
-8,4,0,-8.0,4.0,0.5655949115753174,164.7573974060042,95,-93,136,159,818,713,184,17,19.6
-6,4,0,-6.0,4.0,0.577430009841919,158.09174551506476,95,-87,132,159,818,713,184,17,17.48
-6,5,0,-6.0,5.0,0.5816278457641602,150.63200191194434,95,-81,127,159,818,713,184,17,18.5
-6,3,0,-6.0,3.0,0.5919778347015381,144.91721774861674,95,-75,124,159,818,713,184,17,14.42
-5,4,0,-5.0,4.0,0.5979659557342529,138.92443989449805,95,-70,120,159,818,713,184,17,15.07
-4,4,0,-4.0,4.0,0.6058168411254883,133.46160496562297,95,-66,116,159,818,713,184,17,14.28
-5,3,0,-5.0,3.0,0.6138060092926025,128.41339493993607,95,-61,113,159,818,713,184,17,12.27
-4,4,0,-4.0,4.0,0.6221468448638916,123.00406497347964,95,-57,109,159,818,713,184,17,13.29
-4,3,0,-4.0,3.0,0.6298298835754395,118.51160280748886,95,-53,106,159,818,713,184,17,10.96
-4,3,0,-4.0,3.0,0.6381008625030518,114.06138698087096,95,-49,103,159,818,713,184,17,10.56
-4,4,0,-4.0,4.0,0.6456317901611328,108.74741376235114,95,-45,99,159,818,713,184,17,11.9
-2,4,0,-2.0,4.0,0.6553549766540527,104.27847332982968,95,-43,95,159,818,713,184,17,13.28
-2,3,0,-2.0,3.0,0.662390947341919,100.72239075796404,95,-41,92,159,818,713,184,17,9.88
-3,4,0,-3.0,4.0,0.6704139709472656,95.85405573057407,95,-38,88,159,818,713,184,17,10.99
-3,4,0,-3.0,4.0,0.6776340007781982,91.0,95,-35,84,159,818,713,184,17,10.56
-4,4,0,-4.0,4.0,0.6880249977111816,85.7962703152066,95,-31,80,159,818,713,184,17,9.88
-3,4,0,-3.0,4.0,0.6942059993743896,80.99382692526635,95,-28,76,159,818,713,184,17,9.58
-3,4,0,-3.0,4.0,0.7060859203338623,76.21679604916491,95,-25,72,159,818,713,184,17,9.13
-3,4,0,-3.0,4.0,0.7100968360900879,71.47027354082255,95,-22,68,159,818,713,184,17,8.66
-2,3,0,-2.0,3.0,0.7183878421783447,68.00735254367721,95,-20,65,159,818,713,184,17,7.22
-2,4,0,-2.0,4.0,0.7321879863739014,63.60031446463138,95,-18,61,159,818,713,184,17,8.63
-3,4,0,-3.0,4.0,0.741865873336792,58.9406481131655,95,-15,57,159,818,713,184,17,7.43
-2,4,0,-2.0,4.0,0.7420799732208252,54.57105459856901,95,-13,53,159,818,713,184,17,7.64
-2,4,0,-2.0,4.0,0.750579833984375,50.21951811795888,95,-11,49,159,818,713,184,17,7.19
-2,3,0,-2.0,3.0,0.7600538730621338,46.87216658103186,95,-9,46,159,818,713,184,17,5.43
-1,3,0,-1.0,3.0,0.7656509876251221,43.73785545725808,95,-8,43,159,818,713,184,17,6.53
-1,3,0,-1.0,3.0,0.7737448215484619,40.607881008493905,95,-7,40,159,818,713,184,17,6.24
-1,2,0,-1.0,2.0,0.7843048572540283,38.47076812334269,95,-6,38,159,818,713,184,17,4.33
-1,3,0,-1.0,3.0,0.7906899452209473,35.35533905932738,95,-5,35,159,818,713,184,17,5.65
-1,1,0,-1.0,1.0,0.7976818084716797,34.23448553724738,95,-4,34,159,818,713,184,17,2.22
0,2,0,-0.0,2.0,0.8060200214385986,32.2490309931942,95,-4,32,159,818,713,184,17,5.17
0,1,0,-0.0,1.0,0.8136169910430908,31.25699921617557,95,-4,31,159,818,713,184,17,4.35
-1,2,0,-1.0,2.0,0.823232889175415,29.154759474226502,95,-3,29,159,818,713,184,17,3.62
0,1,0,-0.0,1.0,0.8297269344329834,28.160255680657446,95,-3,28,159,818,713,184,17,4.51
0,2,0,-0.0,2.0,0.8384130001068115,26.1725046566048,95,-3,26,159,818,713,184,17,4.98
-1,2,0,-1.0,2.0,0.847430944442749,24.08318915758459,95,-2,24,159,818,713,184,17,3.27
0,2,0,-0.0,2.0,0.8536310195922852,22.090722034374522,95,-2,22,159,818,713,184,17,5.08
-1,2,0,-1.0,2.0,0.873870849609375,20.024984394500787,95,-1,20,159,818,713,184,17,2.89
-1,2,0,-1.0,2.0,0.8741209506988525,18.0,95,0,18,159,818,713,184,17,2.57
0,1,0,-0.0,1.0,0.8777070045471191,17.0,95,0,17,159,818,713,184,17,7.5
-1,2,0,-1.0,2.0,0.8866899013519287,15.033296378372908,95,1,15,159,818,713,184,17,2.14
0,1,0,-0.0,1.0,0.8936328887939453,14.035668847618199,95,1,14,159,818,713,184,17,4.53
-1,1,0,-1.0,1.0,0.9016318321228027,13.152946437965905,95,2,13,159,818,713,184,17,0.75
-1,2,0,-1.0,2.0,0.9144430160522461,11.40175425099138,95,3,11,159,818,713,184,17,1.26
0,1,0,-0.0,1.0,0.9327239990234375,10.44030650891055,95,3,10,159,818,713,184,17,2.42
0,1,0,-0.0,1.0,0.9328467845916748,9.486832980505138,95,3,9,159,818,713,184,17,2.21
-1,1,0,-1.0,1.0,0.9416439533233643,8.94427190999916,95,4,8,159,818,713,184,17,-0.14
0,1,0,-0.0,1.0,0.9510478973388672,8.06225774829855,95,4,7,159,818,713,184,17,1.38
0,2,0,-0.0,2.0,0.958204984664917,6.4031242374328485,95,4,5,159,818,713,184,17,0.82
0,0,1,-0.0,-0.0,0.9648439884185791,6.4031242374328485,95,4,5,159,818,713,184,17,28.81
-1,0,1,-1.0,-0.0,0.9682698249816895,7.0710678118654755,95,5,5,159,818,713,184,17,10.79
0,1,1,-0.0,1.0,0.9736099243164062,6.4031242374328485,95,5,4,159,818,154,813,17,10.33
0,1,1,-0.0,1.0,0.004784345626831055,1706.1688075920272,96,1704,-86,1858,729,154,813,61,66.21
0,1,1,-0.0,1.0,0.02163529396057129,1706.2195052219981,96,1704,-87,1858,729,154,813,61,65.63
0,1,1,-0.0,1.0,0.03696036338806152,1706.27078741916,96,1704,-88,1858,729,154,813,61,65.07
0,1,1,-0.0,1.0,0.053342342376708984,1706.3226541308065,96,1704,-89,1858,729,154,813,61,64.51
0,1,1,-0.0,1.0,0.06878519058227539,1706.3751053036376,96,1704,-90,1858,729,154,813,61,63.97
0,0,0,-0.0,-0.0,0.07973718643188477,1706.3751053036376,96,1704,-90,1858,729,154,813,61,274.54
1,0,0,1.0,-0.0,0.14124321937561035,1705.3764980203052,96,1703,-90,1858,729,154,813,61,8.94
1,-1,0,1.0,-1.0,0.17334318161010742,1704.325379732403,96,1702,-89,1858,729,154,813,61,5.74
1,0,0,1.0,-0.0,0.18072128295898438,1703.3267449318114,96,1701,-89,1858,729,154,813,61,8.95
1,0,0,1.0,-0.0,0.18874216079711914,1702.3281117340453,96,1700,-89,1858,729,154,813,61,8.95
4,-1,0,4.0,-1.0,0.19681620597839355,1698.2814843246688,96,1696,-88,1858,729,154,813,61,19.65
6,-2,0,6.0,-2.0,0.20626235008239746,1692.1867509231952,96,1690,-86,1858,729,154,813,61,26.78
9,-2,0,9.0,-2.0,0.2126932144165039,1683.09744221777,96,1681,-84,1858,729,154,813,61,37.66
13,-2,0,13.0,-2.0,0.22072625160217285,1670.0143711956493,96,1668,-82,1858,729,154,813,61,50.54
15,-3,0,15.0,-3.0,0.22888922691345215,1654.8867030706363,96,1653,-79,1858,729,154,813,61,55.66
22,-2,0,22.0,-2.0,0.23670721054077148,1632.81658492312,96,1631,-77,1858,729,154,813,61,74.26
30,-2,0,30.0,-2.0,0.24706530570983887,1602.7557518224667,96,1601,-75,1858,729,154,813,61,90.98
36,-1,0,36.0,-1.0,0.2536792755126953,1566.748543959751,96,1565,-74,1858,729,154,813,61,100.45
41,-1,0,41.0,-1.0,0.2610812187194824,1525.7473578545041,96,1524,-73,1858,729,154,813,61,106.69
46,-1,0,46.0,-1.0,0.2692723274230957,1479.7526820384546,96,1478,-72,1858,729,154,813,61,111.8
48,-2,0,48.0,-2.0,0.27718234062194824,1431.7122615944868,96,1430,-70,1858,729,154,813,61,113.45
48,0,0,48.0,-0.0,0.28597116470336914,1383.7716574637595,96,1382,-70,1858,729,154,813,61,109.71
47,-1,0,47.0,-1.0,0.29280924797058105,1336.7819567902613,96,1335,-69,1858,729,154,813,61,107.11
45,-2,0,45.0,-2.0,0.3011462688446045,1291.7387506767768,96,1290,-67,1858,729,154,813,61,103.86
46,-3,0,46.0,-3.0,0.3088831901550293,1245.6452143367308,96,1244,-64,1858,729,154,813,61,102.78
46,-2,0,46.0,-2.0,0.3178713321685791,1199.603267751468,96,1198,-62,1858,729,154,813,61,101.0
43,-3,0,43.0,-3.0,0.3295583724975586,1156.5059446453356,96,1155,-59,1858,729,154,813,61,94.99
41,-3,0,41.0,-3.0,0.3341343402862549,1115.4066523021995,96,1114,-56,1858,729,154,813,61,90.54
41,-4,0,41.0,-4.0,0.3448803424835205,1074.259279689964,96,1073,-52,1858,729,154,813,61,87.98
40,-3,0,40.0,-3.0,0.3501312732696533,1034.1614960923657,96,1033,-49,1858,729,154,813,61,85.5
40,-4,0,40.0,-4.0,0.3577401638031006,994.019114504344,96,993,-45,1858,729,154,813,61,82.96
40,-4,0,40.0,-4.0,0.3647122383117676,953.8815440084791,96,953,-41,1858,729,154,813,61,81.0
41,-4,0,41.0,-4.0,0.3727543354034424,912.7502396603355,96,912,-37,1858,729,154,813,61,80.1
39,-3,0,39.0,-3.0,0.3828012943267822,873.6618338922675,96,873,-34,1858,729,154,813,61,76.35
40,-4,0,40.0,-4.0,0.3986513614654541,833.5400410298236,96,833,-30,1858,729,154,813,61,74.82
38,-3,0,38.0,-3.0,0.3988351821899414,795.4583584324198,96,795,-27,1858,729,154,813,61,71.08
41,-3,0,41.0,-3.0,0.40474438667297363,754.3818661659359,96,754,-24,1858,729,154,813,61,72.02
41,-5,0,41.0,-5.0,0.41298818588256836,713.2531107538193,96,713,-19,1858,729,154,813,61,68.72
37,-5,0,37.0,-5.0,0.42131638526916504,676.1449548728439,96,676,-14,1858,729,154,813,61,62.5
30,-3,0,30.0,-3.0,0.4301621913909912,646.0936464631114,96,646,-11,1858,729,154,813,61,53.95
29,-1,0,29.0,-1.0,0.4367682933807373,617.0810319560957,96,617,-10,1858,729,154,813,61,52.97
26,0,0,26.0,-0.0,0.44516921043395996,591.0845963142671,96,591,-10,1858,729,154,813,61,48.36
26,0,0,26.0,-0.0,0.4534122943878174,565.0884886458049,96,565,-10,1858,729,154,813,61,47.07
26,0,0,26.0,-0.0,0.461470365524292,539.0927563972641,96,539,-10,1858,729,154,813,61,45.75
25,0,0,25.0,-0.0,0.47053027153015137,514.0972670613996,96,514,-10,1858,729,154,813,61,43.38
25,0,0,25.0,-0.0,0.4767293930053711,489.10223880084624,96,489,-10,1858,729,154,813,61,42.08
25,0,0,25.0,-0.0,0.48638224601745605,464.1077461107496,96,464,-10,1858,729,154,813,61,40.73
25,0,0,25.0,-0.0,0.49403834342956543,439.11388044560834,96,439,-10,1858,729,154,813,61,39.35
24,0,0,24.0,-0.0,0.5007083415985107,415.12046444375636,96,415,-10,1858,729,154,813,61,37.05
25,0,0,25.0,-0.0,0.5088803768157959,390.1281840626232,96,390,-10,1858,729,154,813,61,36.51
23,0,0,23.0,-0.0,0.5169012546539307,367.1362145035545,96,367,-10,1858,729,154,813,61,33.39
23,0,0,23.0,-0.0,0.5247352123260498,344.14531814336806,96,344,-10,1858,729,154,813,61,32.03
23,0,0,23.0,-0.0,0.5327262878417969,321.155725466634,96,321,-10,1858,729,154,813,61,30.62
24,1,0,24.0,1.0,0.5424842834472656,297.2036338943385,96,297,-11,1858,729,154,813,61,28.82
23,1,0,23.0,1.0,0.5501813888549805,274.2626478396211,96,274,-12,1858,729,154,813,61,26.51
23,1,0,23.0,1.0,0.5567083358764648,251.3364279208249,96,251,-13,1858,729,154,813,61,24.92
23,2,0,23.0,2.0,0.5646932125091553,228.49288829195538,96,228,-15,1858,729,154,813,61,22.72
20,1,0,20.0,1.0,0.5740673542022705,208.61447696648477,96,208,-16,1858,729,154,813,61,19.85
18,2,0,18.0,2.0,0.5825982093811035,190.85072700935672,96,190,-18,1858,729,154,813,61,16.8
17,1,0,17.0,1.0,0.5896413326263428,174.04022523543227,96,173,-19,1858,729,154,813,61,15.52
14,1,0,14.0,1.0,0.5967302322387695,160.25292509030842,96,159,-20,1858,729,154,813,61,12.79
14,1,0,14.0,1.0,0.6075193881988525,146.5127980757995,96,145,-21,1858,729,154,813,61,11.91
12,1,0,12.0,1.0,0.6147933006286621,134.80726983364065,96,133,-22,1858,729,154,813,61,10.03
10,1,0,10.0,1.0,0.6247272491455078,125.13193037750197,96,123,-23,1858,729,154,813,61,8.32
10,0,0,10.0,-0.0,0.6328892707824707,115.31695452100702,96,113,-23,1858,729,154,813,61,8.46
9,0,0,9.0,-0.0,0.6370532512664795,106.51291001564083,96,104,-23,1858,729,154,813,61,7.49
7,0,0,7.0,-0.0,0.6454472541809082,99.68951800465283,96,97,-23,1858,729,154,813,61,6.22
6,0,0,6.0,-0.0,0.6621863842010498,93.86160024205851,96,91,-23,1858,729,154,813,61,5.49
5,-1,0,5.0,-1.0,0.6623163223266602,88.76936408468859,96,86,-22,1858,729,154,813,61,7.03
3,-2,0,3.0,-2.0,0.67189621925354,85.37564055396598,96,83,-20,1858,729,154,813,61,3.72
2,-1,0,2.0,-1.0,0.6803953647613525,83.19855767980596,96,81,-19,1858,729,154,813,61,3.74
2,-1,0,2.0,-1.0,0.6885871887207031,81.02468759581859,96,79,-18,1858,729,154,813,61,3.67
2,0,0,2.0,-0.0,0.6927351951599121,79.07591289387686,96,77,-18,1858,729,154,813,61,3.61
4,-2,0,4.0,-2.0,0.70320725440979,74.73285756613352,96,73,-16,1858,729,154,813,61,4.35
5,0,0,5.0,-0.0,0.7139523029327393,69.85699678629192,96,68,-16,1858,729,154,813,61,4.5
4,0,0,4.0,-0.0,0.7169501781463623,65.96969000988257,96,64,-16,1858,729,154,813,61,3.98
6,0,0,6.0,-0.0,0.7247893810272217,60.166435825965294,96,58,-16,1858,729,154,813,61,4.27
5,-1,0,5.0,-1.0,0.7327473163604736,55.08175741568164,96,53,-15,1858,729,154,813,61,5.56
7,0,0,7.0,-0.0,0.7409043312072754,48.38388161361178,96,46,-15,1858,729,154,813,61,3.81
7,0,0,7.0,-0.0,0.7506093978881836,41.78516483155236,96,39,-15,1858,729,154,813,61,3.27
8,0,0,8.0,-0.0,0.761594295501709,34.438350715445125,96,31,-15,1858,729,154,813,61,2.74
7,0,0,7.0,-0.0,0.7671892642974854,28.30194339616981,96,24,-15,1858,729,154,813,61,1.89
6,0,0,6.0,-0.0,0.7727162837982178,23.430749027719962,96,18,-15,1858,729,154,813,61,1.13
4,0,0,4.0,-0.0,0.7843873500823975,20.518284528683193,96,14,-15,1858,729,154,813,61,0.58
2,0,0,2.0,-0.0,0.7960503101348877,19.209372712298546,96,12,-15,1858,729,154,813,61,0.46
2,0,0,2.0,-0.0,0.7967572212219238,18.027756377319946,96,10,-15,1858,729,154,813,61,0.27
2,0,0,2.0,-0.0,0.8050003051757812,17.0,96,8,-15,1858,729,154,813,61,0.07
1,0,0,1.0,-0.0,0.8219473361968994,16.55294535724685,96,7,-15,1858,729,154,813,61,0.21
0,0,1,-0.0,-0.0,0.8567533493041992,16.55294535724685,96,7,-15,1858,729,154,813,61,31.85
0,0,0,-0.0,-0.0,0.08504700660705566,1709.190744182755,97,-1582,-647,269,97,1851,744,27,274.77
-2,1,0,-2.0,1.0,0.10002613067626953,1707.7189464311743,97,-1580,-648,269,97,1851,744,27,14.84
-3,1,0,-3.0,1.0,0.10802102088928223,1705.3240161330045,97,-1577,-649,269,97,1851,744,27,23.06
-4,2,0,-4.0,2.0,0.1171410083770752,1702.3894971480527,97,-1573,-651,269,97,1851,744,27,27.2
-6,1,0,-6.0,1.0,0.12421011924743652,1697.230980155618,97,-1567,-652,269,97,1851,744,27,44.41
-8,1,0,-8.0,1.0,0.13202810287475586,1690.2337116505516,97,-1559,-653,269,97,1851,744,27,56.5
-11,0,0,-11.0,-0.0,0.14107704162597656,1680.0931521793666,97,-1548,-653,269,97,1851,744,27,74.54
-13,0,0,-13.0,-0.0,0.14798808097839355,1668.1228971511662,97,-1535,-653,269,97,1851,744,27,83.27
-14,-2,0,-14.0,-2.0,0.15783405303955078,1654.461241613112,97,-1521,-651,269,97,1851,744,27,91.09
-16,-2,0,-16.0,-2.0,0.164031982421875,1638.9710186577431,97,-1505,-649,269,97,1851,744,27,98.03
-20,-2,0,-20.0,-2.0,0.17203998565673828,1619.8252992221105,97,-1485,-647,269,97,1851,744,27,110.4
-20,-3,0,-20.0,-3.0,0.18000006675720215,1600.3002843216643,97,-1465,-644,269,97,1851,744,27,111.15
-22,-4,0,-22.0,-4.0,0.18981599807739258,1578.5591531520129,97,-1443,-640,269,97,1851,744,27,117.27
-22,-5,0,-22.0,-5.0,0.1960310935974121,1556.4273192153883,97,-1421,-635,269,97,1851,744,27,117.78
-24,-6,0,-24.0,-6.0,0.20507311820983887,1532.0737580155858,97,-1397,-629,269,97,1851,744,27,122.94
-27,-8,0,-27.0,-8.0,0.2119910717010498,1504.1745244485428,97,-1370,-621,269,97,1851,744,27,130.58
-30,-9,0,-30.0,-9.0,0.22204804420471191,1473.140862239589,97,-1340,-612,269,97,1851,744,27,135.71
-33,-10,0,-33.0,-10.0,0.2284071445465088,1438.9763722869116,97,-1307,-602,269,97,1851,744,27,139.83
-35,-12,0,-35.0,-12.0,0.23770809173583984,1402.1711735733265,97,-1272,-590,269,97,1851,744,27,142.65
-38,-12,0,-38.0,-12.0,0.24399304389953613,1362.6591650152286,97,-1234,-578,269,97,1851,744,27,144.23
-39,-13,0,-39.0,-13.0,0.2529330253601074,1321.8358445737504,97,-1195,-565,269,97,1851,744,27,143.82
-43,-15,0,-43.0,-15.0,0.26025915145874023,1276.5594384908209,97,-1152,-550,269,97,1851,744,27,146.81
-43,-16,0,-43.0,-16.0,0.26892709732055664,1230.868392639928,97,-1109,-534,269,97,1851,744,27,144.59
-43,-16,0,-43.0,-16.0,0.2763209342956543,1185.191967573186,97,-1066,-518,269,97,1851,744,27,141.53
-44,-17,0,-44.0,-17.0,0.2840240001678467,1138.1937444916837,97,-1022,-501,269,97,1851,744,27,139.91
-44,-18,0,-44.0,-18.0,0.29241108894348145,1090.7671612218621,97,-978,-483,269,97,1851,744,27,137.31
-42,-17,0,-42.0,-17.0,0.3001289367675781,1045.5869165210513,97,-936,-466,269,97,1851,744,27,131.66
-39,-15,0,-39.0,-15.0,0.3081369400024414,1003.9970119477448,97,-897,-451,269,97,1851,744,27,124.46
-35,-15,0,-35.0,-15.0,0.3164520263671875,965.9917183910015,97,-862,-436,269,97,1851,744,27,118.08
-33,-15,0,-33.0,-15.0,0.3271009922027588,929.7752416578966,97,-829,-421,269,97,1851,744,27,113.72
-30,-14,0,-30.0,-14.0,0.33202409744262695,896.688351658479,97,-799,-407,269,97,1851,744,27,107.49
-31,-14,0,-31.0,-14.0,0.3411710262298584,862.7125824977865,97,-768,-393,269,97,1851,744,27,105.92
-29,-14,0,-29.0,-14.0,0.34896302223205566,830.5191147709967,97,-739,-379,269,97,1851,744,27,101.97
-28,-14,0,-28.0,-14.0,0.35711193084716797,799.2158657083829,97,-711,-365,269,97,1851,744,27,99.16
-29,-14,0,-29.0,-14.0,0.3643910884857178,767.0234676983489,97,-682,-351,269,97,1851,744,27,97.28
-27,-13,0,-27.0,-13.0,0.3719980716705322,737.0678394829067,97,-655,-338,269,97,1851,744,27,91.99
-27,-13,0,-27.0,-13.0,0.38067197799682617,707.1131451189407,97,-628,-325,269,97,1851,744,27,89.7
-23,-11,0,-23.0,-11.0,0.3883531093597412,681.6311319181365,97,-605,-314,269,97,1851,744,27,81.31
-24,-11,0,-24.0,-11.0,0.39599108695983887,655.2633058549823,97,-581,-303,269,97,1851,744,27,80.22
-24,-12,0,-24.0,-12.0,0.40703511238098145,628.4345630214812,97,-557,-291,269,97,1851,744,27,79.91
-23,-12,0,-23.0,-12.0,0.41247105598449707,602.4923236025502,97,-534,-279,269,97,1851,744,27,77.88
-22,-11,0,-22.0,-11.0,0.4227640628814697,577.8996452672384,97,-512,-268,269,97,1851,744,27,72.85
-21,-11,0,-21.0,-11.0,0.4280540943145752,554.193107138658,97,-491,-257,269,97,1851,744,27,71.03
-21,-11,0,-21.0,-11.0,0.4370429515838623,530.4865691042517,97,-470,-246,269,97,1851,744,27,69.19
-19,-11,0,-19.0,-11.0,0.44402098655700684,508.55284877778433,97,-451,-235,269,97,1851,744,27,62.82
-17,-9,0,-17.0,-9.0,0.4547770023345947,489.31789258109086,97,-434,-226,269,97,1851,744,27,58.81
-15,-8,0,-15.0,-8.0,0.4607579708099365,472.3187483045745,97,-419,-218,269,97,1851,744,27,53.67
-15,-8,0,-15.0,-8.0,0.46845197677612305,455.31966792573326,97,-404,-210,269,97,1851,744,27,52.47
-13,-6,0,-13.0,-6.0,0.4760570526123047,441.0181402164768,97,-391,-204,269,97,1851,744,27,45.39
-14,-7,0,-14.0,-7.0,0.4840681552886963,425.36807590603223,97,-377,-197,269,97,1851,744,27,47.73
-14,-5,0,-14.0,-5.0,0.49348998069763184,410.6494855713325,97,-363,-192,269,97,1851,744,27,42.8
-13,-6,0,-13.0,-6.0,0.5016241073608398,396.35337768208814,97,-350,-186,269,97,1851,744,27,42.29
-13,-5,0,-13.0,-5.0,0.5097081661224365,382.5310444918164,97,-337,-181,269,97,1851,744,27,39.54
-12,-4,0,-12.0,-4.0,0.5160319805145264,370.0729657783719,97,-325,-177,269,97,1851,744,27,35.88
-13,-6,0,-13.0,-6.0,0.5252881050109863,355.78785814021256,97,-312,-171,269,97,1851,744,27,39.23
-11,-5,0,-11.0,-5.0,0.5329811573028564,343.7397271192261,97,-301,-166,269,97,1851,744,27,34.55
-10,-5,0,-10.0,-5.0,0.5403621196746826,332.5687898766209,97,-291,-161,269,97,1851,744,27,33.03
-9,-6,0,-9.0,-6.0,0.5484280586242676,321.79030439091855,97,-282,-155,269,97,1851,744,27,30.84
-9,-6,0,-9.0,-6.0,0.556023120880127,311.01446911679204,97,-273,-149,269,97,1851,744,27,30.13
-8,-7,0,-8.0,-7.0,0.5676569938659668,300.647634283059,97,-265,-142,269,97,1851,744,27,27.54
-7,-6,0,-7.0,-6.0,0.5720131397247314,291.6504757410829,97,-258,-136,269,97,1851,744,27,24.63
-7,-6,0,-7.0,-6.0,0.5803689956665039,282.66764936936096,97,-251,-130,269,97,1851,744,27,24.05
-6,-5,0,-6.0,-5.0,0.588386058807373,275.04545078950133,97,-245,-125,269,97,1851,744,27,21.22
-8,-6,0,-8.0,-6.0,0.5982749462127686,265.1980392084376,97,-237,-119,269,97,1851,744,27,24.84
-6,-5,0,-6.0,-5.0,0.6054270267486572,257.59852484049674,97,-231,-114,269,97,1851,744,27,20.21
-7,-4,0,-7.0,-4.0,0.6163949966430664,249.55159787106152,97,-224,-110,269,97,1851,744,27,22.28
-7,-5,0,-7.0,-5.0,0.6200599670410156,241.0684550081159,97,-217,-105,269,97,1851,744,27,21.27
-7,-5,0,-7.0,-5.0,0.6289200782775879,232.59406699226014,97,-210,-100,269,97,1851,744,27,20.72
-5,-4,0,-5.0,-4.0,0.6365461349487305,226.3647499059869,97,-205,-96,269,97,1851,744,27,16.26
-4,-3,0,-4.0,-3.0,0.6440160274505615,221.472345903501,97,-201,-93,269,97,1851,744,27,13.79
-4,-3,0,-4.0,-3.0,0.6519980430603027,216.5848563496534,97,-197,-90,269,97,1851,744,27,13.57
-5,-5,0,-5.0,-5.0,0.6602239608764648,209.97380789041284,97,-192,-85,269,97,1851,744,27,15.5
-6,-4,0,-6.0,-4.0,0.6680619716644287,202.87188075236054,97,-186,-81,269,97,1851,744,27,16.92
-6,-4,0,-6.0,-4.0,0.6779370307922363,195.77793542685038,97,-180,-77,269,97,1851,744,27,16.48
-5,-3,0,-5.0,-3.0,0.6878690719604492,190.0026315607234,97,-175,-74,269,97,1851,744,27,14.54
-6,-4,0,-6.0,-4.0,0.6920111179351807,182.92348127017482,97,-169,-70,269,97,1851,744,27,15.68
-6,-3,0,-6.0,-3.0,0.7001259326934814,176.23280057923384,97,-163,-67,269,97,1851,744,27,16.05
-6,-3,0,-6.0,-3.0,0.7081160545349121,169.54350474140847,97,-157,-64,269,97,1851,744,27,15.64
-5,-2,0,-5.0,-2.0,0.7173900604248047,164.1584600317632,97,-152,-62,269,97,1851,744,27,15.69
-5,-3,0,-5.0,-3.0,0.724372148513794,158.39823231336896,97,-147,-59,269,97,1851,744,27,12.86
-4,-2,0,-4.0,-2.0,0.7343311309814453,153.9415473483361,97,-143,-57,269,97,1851,744,27,11.65
-4,-3,0,-4.0,-3.0,0.7399930953979492,149.12075643584967,97,-139,-54,269,97,1851,744,27,10.41
-4,-2,0,-4.0,-2.0,0.7495801448822021,144.66858677681205,97,-135,-52,269,97,1851,744,27,11.11
-4,-3,0,-4.0,-3.0,0.7600729465484619,139.86421987055874,97,-131,-49,269,97,1851,744,27,9.93
-5,-2,0,-5.0,-2.0,0.7656950950622559,134.48048185517482,97,-126,-47,269,97,1851,744,27,13.46
-5,-2,0,-5.0,-2.0,0.7720770835876465,129.0968628588627,97,-121,-45,269,97,1851,744,27,13.17
-4,-2,0,-4.0,-2.0,0.7800159454345703,124.65151423067431,97,-117,-43,269,97,1851,744,27,10.1
-4,-2,0,-4.0,-2.0,0.7954280376434326,120.20815280171308,97,-113,-41,269,97,1851,744,27,9.86
-5,-2,0,-5.0,-2.0,0.8008260726928711,114.82595525402782,97,-108,-39,269,97,1851,744,27,12.14
-5,-3,0,-5.0,-3.0,0.8128540515899658,109.11003620199197,97,-103,-36,269,97,1851,744,27,9.97
-6,-2,0,-6.0,-2.0,0.8132779598236084,102.7861858422619,97,-97,-34,269,97,1851,744,27,13.21
-5,-3,0,-5.0,-3.0,0.8200170993804932,97.082439194738,97,-92,-31,269,97,1851,744,27,9.23
-5,-3,0,-5.0,-3.0,0.8297200202941895,91.39474820797966,97,-87,-28,269,97,1851,744,27,8.82
-4,-3,0,-4.0,-3.0,0.84067702293396,86.68333173107735,97,-83,-25,269,97,1851,744,27,7.11
-4,-3,0,-4.0,-3.0,0.8465900421142578,82.00609733428362,97,-79,-22,269,97,1851,744,27,6.77
-4,-2,0,-4.0,-2.0,0.8524320125579834,77.62087348130012,97,-75,-20,269,97,1851,744,27,7.16
-3,-3,0,-3.0,-3.0,0.8609189987182617,73.97972695272672,97,-72,-17,269,97,1851,744,27,4.95
-3,-2,0,-3.0,-2.0,0.8683450222015381,70.61161377563892,97,-69,-15,269,97,1851,744,27,5.17
-4,-2,0,-4.0,-2.0,0.8778350353240967,66.2872536767062,97,-65,-13,269,97,1851,744,27,6.2
-4,-2,0,-4.0,-2.0,0.8848781585693359,61.98386886924694,97,-61,-11,269,97,1851,744,27,5.88
-3,-2,0,-3.0,-2.0,0.892009973526001,58.69412236331676,97,-58,-9,269,97,1851,744,27,4.43
-3,-1,0,-3.0,-1.0,0.9007799625396729,55.57877292636101,97,-55,-8,269,97,1851,744,27,5.44
-2,-1,0,-2.0,-1.0,0.9080531597137451,53.46026561849464,97,-53,-7,269,97,1851,744,27,3.83
-2,-1,0,-2.0,-1.0,0.9163310527801514,51.35172830587107,97,-51,-6,269,97,1851,744,27,3.7
-3,0,0,-3.0,-0.0,0.924199104309082,48.373546489791295,97,-48,-6,269,97,1851,744,27,5.55
-2,-2,0,-2.0,-2.0,0.9324951171875,46.17358552246078,97,-46,-4,269,97,1851,744,27,2.55
-4,-1,0,-4.0,-1.0,0.9422450065612793,42.1070065428546,97,-42,-3,269,97,1851,744,27,5.42
-3,-1,0,-3.0,-1.0,0.9480199813842773,39.05124837953327,97,-39,-2,269,97,1851,744,27,4.14
-3,-1,0,-3.0,-1.0,0.961435079574585,36.013886210738214,97,-36,-1,269,97,1851,744,27,3.88
-3,-1,0,-3.0,-1.0,0.9747469425201416,33.0,97,-33,0,269,97,1851,744,27,3.6
-4,-1,0,-4.0,-1.0,0.9754190444946289,29.017236257093817,97,-29,1,269,97,1851,744,27,3.97
-4,-1,0,-4.0,-1.0,0.9817819595336914,25.079872407968907,97,-25,2,269,97,1851,744,27,3.48
-3,-1,0,-3.0,-1.0,0.988055944442749,22.20360331117452,97,-22,3,269,97,1851,744,27,2.47
-2,0,0,-2.0,-0.0,0.9960031509399414,20.223748416156685,97,-20,3,269,97,1851,744,27,3.72
-2,0,0,-2.0,-0.0,1.0040669441223145,18.24828759089466,97,-18,3,269,97,1851,744,27,3.48
-2,-1,0,-2.0,-1.0,1.0120470523834229,16.492422502470642,97,-16,4,269,97,1851,744,27,1.2
-1,0,0,-1.0,-0.0,1.0201420783996582,15.524174696260024,97,-15,4,269,97,1851,744,27,2.58
0,0,1,-0.0,-0.0,1.0381309986114502,15.524174696260024,97,-15,4,269,97,1851,744,27,31.54
0,0,0,-0.0,-0.0,0.0813148021697998,1564.483620879426,98,1453,580,1737,673,284,93,73,262.46
1,0,0,1.0,-0.0,0.125288724899292,1563.5549238833921,98,1452,580,1737,673,284,93,73,5.34
4,4,0,4.0,4.0,0.13405990600585938,1558.358110319961,98,1448,576,1737,673,284,93,73,18.96
4,3,0,4.0,3.0,0.14130473136901855,1553.533070134009,98,1444,573,1737,673,284,93,73,18.39
6,4,0,6.0,4.0,0.1492917537689209,1546.4814903515658,98,1438,569,1737,673,284,93,73,25.27
7,4,0,7.0,4.0,0.15727782249450684,1538.5012187190493,98,1431,565,1737,673,284,93,73,28.37
9,5,0,9.0,5.0,0.16611576080322266,1528.294474242448,98,1422,560,1737,673,284,93,73,34.46
11,5,0,11.0,5.0,0.1732628345489502,1516.2275554810367,98,1411,555,1737,673,284,93,73,40.26
14,8,0,14.0,8.0,0.1812899112701416,1500.2726418888,98,1397,547,1737,673,284,93,73,48.16
17,8,0,17.0,8.0,0.19112277030944824,1481.526577554382,98,1380,539,1737,673,284,93,73,55.0
20,9,0,20.0,9.0,0.19742083549499512,1459.6232390586279,98,1360,530,1737,673,284,93,73,61.4
24,10,0,24.0,10.0,0.2059488296508789,1433.6303568214507,98,1336,520,1737,673,284,93,73,69.35
28,11,0,28.0,11.0,0.21327590942382812,1403.5472916863187,98,1308,509,1737,673,284,93,73,76.75
31,11,0,31.0,11.0,0.222700834274292,1370.6688148491596,98,1277,498,1737,673,284,93,73,78.92
37,14,0,37.0,14.0,0.22928071022033691,1331.1108143201302,98,1240,484,1737,673,284,93,73,88.17
36,13,0,36.0,13.0,0.23725676536560059,1292.8484056531918,98,1204,471,1737,673,284,93,73,84.37
40,15,0,40.0,15.0,0.245924711227417,1250.1327929464132,98,1164,456,1737,673,284,93,73,89.09
39,15,0,39.0,15.0,0.2549269199371338,1208.3484596754365,98,1125,441,1737,673,284,93,73,86.86
39,17,0,39.0,17.0,0.2654078006744385,1165.8353228479568,98,1086,424,1737,673,284,93,73,84.7
40,17,0,40.0,17.0,0.2725508213043213,1122.3925338311903,98,1046,407,1737,673,284,93,73,84.28
38,18,0,38.0,18.0,0.2800288200378418,1080.4559222846622,98,1008,389,1737,673,284,93,73,79.86
37,16,0,37.0,16.0,0.28557586669921875,1040.1778694050358,98,971,373,1737,673,284,93,73,76.99
37,18,0,37.0,18.0,0.2932868003845215,999.1901720893776,98,934,355,1737,673,284,93,73,75.17
39,16,0,39.0,16.0,0.30132174491882324,957.0506778640304,98,895,339,1737,673,284,93,73,75.95
39,16,0,39.0,16.0,0.3094959259033203,914.912564128398,98,856,323,1737,673,284,93,73,74.01
39,17,0,39.0,17.0,0.31746888160705566,872.4247818580121,98,817,306,1737,673,284,93,73,71.73
38,16,0,38.0,16.0,0.3253598213195801,831.2286087473169,98,779,290,1737,673,284,93,73,68.76
41,17,0,41.0,17.0,0.3339097499847412,786.8754666400523,98,738,273,1737,673,284,93,73,69.65
38,15,0,38.0,15.0,0.34127092361450195,746.0321708880924,98,700,258,1737,673,284,93,73,64.89
36,15,0,36.0,15.0,0.3492717742919922,707.0678892440244,98,664,243,1737,673,284,93,73,60.49
36,16,0,36.0,16.0,0.3583087921142578,667.7671749943988,98,628,227,1737,673,284,93,73,58.2
35,14,0,35.0,14.0,0.36556291580200195,630.093643833994,98,593,213,1737,673,284,93,73,55.6
33,14,0,33.0,14.0,0.37551188468933105,594.3071596405347,98,560,199,1737,673,284,93,73,51.46
31,12,0,31.0,12.0,0.38134288787841797,561.0793170310237,98,529,187,1737,673,284,93,73,48.27
30,13,0,30.0,13.0,0.3909187316894531,528.4666498465159,98,499,174,1737,673,284,93,73,44.99
29,12,0,29.0,12.0,0.39760780334472656,497.135796337379,98,470,162,1737,673,284,93,73,42.48
27,11,0,27.0,11.0,0.40611886978149414,468.0277769534625,98,443,151,1737,673,284,93,73,39.12
28,12,0,28.0,12.0,0.41469383239746094,437.6596851436056,98,415,139,1737,673,284,93,73,38.12
25,9,0,25.0,9.0,0.42142391204833984,411.0960958218893,98,390,130,1737,673,284,93,73,35.06
24,8,0,24.0,8.0,0.429304838180542,385.7978745405423,98,366,122,1737,673,284,93,73,34.39
23,9,0,23.0,9.0,0.43726277351379395,361.13432404023854,98,343,113,1737,673,284,93,73,30.07
21,7,0,21.0,7.0,0.44610071182250977,338.9985250705377,98,322,106,1737,673,284,93,73,29.13
20,6,0,20.0,6.0,0.46311283111572266,318.1257612957492,98,302,100,1737,673,284,93,73,25.75
20,5,0,20.0,5.0,0.46325182914733887,297.57184006555457,98,282,95,1737,673,284,93,73,23.3
20,6,0,20.0,6.0,0.47173476219177246,276.70381276737044,98,262,89,1737,673,284,93,73,23.44
19,5,0,19.0,5.0,0.4815177917480469,257.1089263327899,98,243,84,1737,673,284,93,73,20.7
18,6,0,18.0,6.0,0.48528289794921875,238.1365154695936,98,225,78,1737,673,284,93,73,21.28
19,5,0,19.0,5.0,0.49329686164855957,218.55205329623422,98,206,73,1737,673,284,93,73,18.57
19,6,0,19.0,6.0,0.5021178722381592,198.64037857394453,98,187,67,1737,673,284,93,73,18.63
17,5,0,17.0,5.0,0.5098867416381836,180.95303258028034,98,170,62,1737,673,284,93,73,15.87
15,5,0,15.0,5.0,0.5174837112426758,165.14841809717706,98,155,57,1737,673,284,93,73,14.95
14,5,0,14.0,5.0,0.5255098342895508,150.28306624500314,98,141,52,1737,673,284,93,73,14.78
13,3,0,13.0,3.0,0.5372447967529297,137.05838172107534,98,128,49,1737,673,284,93,73,10.48
13,4,0,13.0,4.0,0.5431077480316162,123.4908903522847,98,115,45,1737,673,284,93,73,10.82
14,2,0,14.0,2.0,0.5526878833770752,109.77249200050075,98,101,43,1737,673,284,93,73,8.5
13,3,0,13.0,3.0,0.5676577091217041,96.66436778875658,98,88,40,1737,673,284,93,73,7.99
11,2,0,11.0,2.0,0.5684447288513184,85.86617494683223,98,77,38,1737,673,284,93,73,6.25
10,1,0,10.0,1.0,0.5777597427368164,76.53757247260981,98,67,37,1737,673,284,93,73,4.85
8,1,0,8.0,1.0,0.5832407474517822,69.1158447825099,98,59,36,1737,673,284,93,73,3.95
6,0,0,6.0,-0.0,0.5893197059631348,64.07027391856539,98,53,36,1737,673,284,93,73,2.65
3,1,0,3.0,1.0,0.5979447364807129,61.032778078668514,98,50,35,1737,673,284,93,73,3.16
0,0,1,-0.0,-0.0,0.6873118877410889,61.032778078668514,98,50,35,1737,673,284,93,73,45.42
2,2,1,2.0,2.0,0.08164739608764648,1485.151170756701,99,-1393,-515,296,125,1687,638,23,6.07
0,0,0,-0.0,-0.0,0.09664130210876465,1485.151170756701,99,-1393,-515,296,125,1687,638,23,255.39
4,3,0,4.0,3.0,0.09720730781555176,1489.943958677641,99,-1397,-518,296,125,1687,638,23,4.7
4,3,0,4.0,3.0,0.09732627868652344,1494.7381041506903,99,-1401,-521,296,125,1687,638,23,4.71
4,2,0,4.0,2.0,0.1051943302154541,1499.184444956657,99,-1405,-523,296,125,1687,638,23,6.19
1,1,0,1.0,1.0,0.11323022842407227,1500.4705928474573,99,-1406,-524,296,125,1687,638,23,10.13
-4,0,0,-4.0,-0.0,0.21716833114624023,1496.7230872810107,99,-1402,-524,296,125,1687,638,23,37.18
-8,-1,0,-8.0,-1.0,0.22558832168579102,1488.8804518832262,99,-1394,-523,296,125,1687,638,23,66.07
-13,-4,0,-13.0,-4.0,0.23376226425170898,1475.3040364616372,99,-1381,-519,296,125,1687,638,23,96.38
-16,-5,0,-16.0,-5.0,0.2411332130432129,1458.568133478858,99,-1365,-514,296,125,1687,638,23,108.18
-23,-7,0,-23.0,-7.0,0.25039219856262207,1434.5776381918129,99,-1342,-507,296,125,1687,638,23,128.86
-29,-10,0,-29.0,-10.0,0.2574121952056885,1403.915239606722,99,-1313,-497,296,125,1687,638,23,142.88
-31,-10,0,-31.0,-10.0,0.26515626907348633,1371.383607893867,99,-1282,-487,296,125,1687,638,23,143.98
-34,-12,0,-34.0,-12.0,0.27368831634521484,1335.338533855741,99,-1248,-475,296,125,1687,638,23,148.46
-37,-12,0,-37.0,-12.0,0.2811312675476074,1296.4914191771575,99,-1211,-463,296,125,1687,638,23,149.41
-35,-13,0,-35.0,-13.0,0.2891542911529541,1259.1568607604058,99,-1176,-450,296,125,1687,638,23,146.41
-41,-15,0,-41.0,-15.0,0.29732823371887207,1215.5040106885704,99,-1135,-435,296,125,1687,638,23,151.36
-41,-16,0,-41.0,-16.0,0.30608129501342773,1171.4934912324525,99,-1094,-419,296,125,1687,638,23,149.29
-42,-15,0,-42.0,-15.0,0.3137662410736084,1126.9072721391055,99,-1052,-404,296,125,1687,638,23,145.84
-44,-17,0,-44.0,-17.0,0.3212583065032959,1079.7374680912023,99,-1008,-387,296,125,1687,638,23,146.3
-45,-16,0,-45.0,-16.0,0.33097028732299805,1031.9932170319726,99,-963,-371,296,125,1687,638,23,141.81
-47,-16,0,-47.0,-16.0,0.3372652530670166,982.3853622687993,99,-916,-355,296,125,1687,638,23,139.04
-46,-18,0,-46.0,-18.0,0.34548139572143555,932.9892818248236,99,-870,-337,296,125,1687,638,23,136.59
-47,-17,0,-47.0,-17.0,0.3535752296447754,883.0226497661314,99,-823,-320,296,125,1687,638,23,131.59
-42,-15,0,-42.0,-15.0,0.3625633716583252,838.4426038793591,99,-781,-305,296,125,1687,638,23,122.99
-39,-15,0,-39.0,-15.0,0.36940526962280273,796.6580194788728,99,-742,-290,296,125,1687,638,23,118.06
-35,-13,0,-35.0,-13.0,0.3771543502807617,759.3273338949415,99,-707,-277,296,125,1687,638,23,109.62
-31,-13,0,-31.0,-13.0,0.38510632514953613,725.7217097483029,99,-676,-264,296,125,1687,638,23,102.32
-29,-11,0,-29.0,-11.0,0.39395642280578613,694.7071325385972,99,-647,-253,296,125,1687,638,23,97.3
-25,-11,0,-25.0,-11.0,0.4017772674560547,667.418908932014,99,-622,-242,296,125,1687,638,23,88.83
-24,-9,0,-24.0,-9.0,0.4091353416442871,641.7889061054266,99,-598,-233,296,125,1687,638,23,85.53
-21,-9,0,-21.0,-9.0,0.41971540451049805,618.9547640983144,99,-577,-224,296,125,1687,638,23,78.55
-19,-8,0,-19.0,-8.0,0.4254152774810791,598.3477249894078,99,-558,-216,296,125,1687,638,23,73.43
-18,-7,0,-18.0,-7.0,0.43439531326293945,579.0345412840239,99,-540,-209,296,125,1687,638,23,71.2
-17,-7,0,-17.0,-7.0,0.4411044120788574,560.6540823003076,99,-523,-202,296,125,1687,638,23,66.92
-16,-6,0,-16.0,-6.0,0.4495372772216797,543.566923202654,99,-507,-196,296,125,1687,638,23,63.83
-15,-6,0,-15.0,-6.0,0.4590423107147217,527.412551993219,99,-492,-190,296,125,1687,638,23,60.76
-16,-5,0,-16.0,-5.0,0.46724724769592285,510.68679246677215,99,-476,-185,296,125,1687,638,23,59.01
-15,-6,0,-15.0,-6.0,0.47313833236694336,494.5321020924729,99,-461,-179,296,125,1687,638,23,58.55
-15,-4,0,-15.0,-4.0,0.4857902526855469,479.10437276234495,99,-446,-175,296,125,1687,638,23,53.63
-15,-5,0,-15.0,-5.0,0.48925328254699707,463.31522746398053,99,-431,-170,296,125,1687,638,23,54.08
-14,-5,0,-14.0,-5.0,0.49718236923217773,448.45735583219056,99,-417,-165,296,125,1687,638,23,51.77
-15,-5,0,-15.0,-5.0,0.5053234100341797,432.67077553262135,99,-402,-160,296,125,1687,638,23,51.73
-16,-6,0,-16.0,-6.0,0.5142014026641846,415.5863327877855,99,-386,-154,296,125,1687,638,23,53.63
-15,-7,0,-15.0,-7.0,0.5223643779754639,399.06139878469827,99,-371,-147,296,125,1687,638,23,50.29
-16,-6,0,-16.0,-6.0,0.5295124053955078,381.97643906398207,99,-355,-141,296,125,1687,638,23,50.93
-17,-7,0,-17.0,-7.0,0.5394413471221924,363.59317925395686,99,-338,-134,296,125,1687,638,23,51.53
-19,-8,0,-19.0,-8.0,0.5451433658599854,342.9825068425502,99,-319,-126,296,125,1687,638,23,52.0
-16,-7,0,-16.0,-7.0,0.5541253089904785,325.53033652794943,99,-303,-119,296,125,1687,638,23,45.84
-15,-6,0,-15.0,-6.0,0.5612044334411621,309.3751767676263,99,-288,-113,296,125,1687,638,23,44.07
-14,-6,0,-14.0,-6.0,0.569129228591919,294.15132160165456,99,-274,-107,296,125,1687,638,23,40.18
-14,-6,0,-14.0,-6.0,0.577134370803833,278.9283062007153,99,-260,-101,296,125,1687,638,23,38.78
-12,-5,0,-12.0,-5.0,0.5851292610168457,265.9323222175146,99,-248,-96,296,125,1687,638,23,34.88
-12,-5,0,-12.0,-5.0,0.5939934253692627,252.93675098727746,99,-236,-91,296,125,1687,638,23,33.74
-10,-5,0,-10.0,-5.0,0.6012053489685059,241.8098426450007,99,-226,-86,296,125,1687,638,23,28.62
-10,-4,0,-10.0,-4.0,0.6091172695159912,231.0411218809327,99,-216,-82,296,125,1687,638,23,29.16
-10,-4,0,-10.0,-4.0,0.6183032989501953,220.27255843613383,99,-206,-78,296,125,1687,638,23,28.29
-9,-4,0,-9.0,-4.0,0.6251082420349121,210.440015206234,99,-197,-74,296,125,1687,638,23,24.98
-9,-3,0,-9.0,-3.0,0.6332452297210693,200.9601950635996,99,-188,-71,296,125,1687,638,23,24.23
-9,-3,0,-9.0,-3.0,0.6457712650299072,191.48106956041372,99,-179,-68,296,125,1687,638,23,23.47
-9,-3,0,-9.0,-3.0,0.6491093635559082,182.00274723201295,99,-170,-65,296,125,1687,638,23,22.69
-9,-2,0,-9.0,-2.0,0.6582112312316895,172.88724649319857,99,-161,-63,296,125,1687,638,23,19.94
-11,-3,0,-11.0,-3.0,0.6694092750549316,161.55494421403512,99,-150,-60,296,125,1687,638,23,22.03
-10,-3,0,-10.0,-3.0,0.6731102466583252,151.15885683611134,99,-140,-57,296,125,1687,638,23,20.34
-10,-3,0,-10.0,-3.0,0.6829493045806885,140.7693148381422,99,-130,-54,296,125,1687,638,23,19.34
-10,-2,0,-10.0,-2.0,0.6891543865203857,130.78226179417453,99,-120,-52,296,125,1687,638,23,17.08
-7,-2,0,-7.0,-2.0,0.6971592903137207,123.5677951571525,99,-113,-50,296,125,1687,638,23,14.17
-6,-2,0,-6.0,-2.0,0.7052292823791504,117.27318534089538,99,-107,-48,296,125,1687,638,23,13.13
-5,-2,0,-5.0,-2.0,0.7139222621917725,111.89280584559492,99,-102,-46,296,125,1687,638,23,12.76
-6,-2,0,-6.0,-2.0,0.7217214107513428,105.60303025955268,99,-96,-44,296,125,1687,638,23,12.27
