dx,dy,button,rx,ry,time,distance,targetID,directionX,directionY,targetX,targetY,initMouseX,initMouseY,targetSize
0,2,0,-0.0,2.0,0.06068706512451172,608.9868635693219,1,583,176,1543,778,960,600,20
-1,3,0,-1.0,3.0,0.06883907318115234,609.0853798934925,1,584,173,1543,778,960,600,20
-2,3,0,-2.0,3.0,0.07659411430358887,610.1606345873191,1,586,170,1543,778,960,600,20
-1,2,0,-1.0,2.0,0.0845639705657959,610.5677685564478,1,587,168,1543,778,960,600,20
-1,1,0,-1.0,1.0,0.09276390075683594,611.2552658259887,1,588,167,1543,778,960,600,20
-1,1,0,-1.0,1.0,0.10089397430419922,611.9452589897237,1,589,166,1543,778,960,600,20
-1,2,0,-1.0,2.0,0.1086571216583252,612.3691697007615,1,590,164,1543,778,960,600,20
-2,3,0,-2.0,3.0,0.11652493476867676,613.5022412347,1,592,161,1543,778,960,600,20
-4,2,0,-4.0,2.0,0.12460494041442871,616.8443888048265,1,596,159,1543,778,960,600,20
-4,3,0,-4.0,3.0,0.1325700283050537,619.9483849482955,1,600,156,1543,778,960,600,20
-5,3,0,-5.0,3.0,0.14072108268737793,624.0464726284414,1,605,153,1543,778,960,600,20
-7,3,0,-7.0,3.0,0.14858293533325195,630.1142753501146,1,612,150,1543,778,960,600,20
-7,3,0,-7.0,3.0,0.15673398971557617,636.2153723386444,1,619,147,1543,778,960,600,20
-8,3,0,-8.0,3.0,0.16477108001708984,643.3234023413107,1,627,144,1543,778,960,600,20
-8,4,0,-8.0,4.0,0.1726210117340088,650.2499519415592,1,635,140,1543,778,960,600,20
-6,2,0,-6.0,2.0,0.1806929111480713,655.6866629724902,1,641,138,1543,778,960,600,20
-3,1,0,-3.0,1.0,0.18865394592285156,658.4109658868084,1,644,137,1543,778,960,600,20
0,1,0,-0.0,1.0,0.19663095474243164,658.2036159122798,1,644,136,1543,778,960,600,20
2,0,0,2.0,-0.0,0.2288351058959961,656.2469047546053,1,642,136,1543,778,960,600,20
4,0,0,4.0,-0.0,0.2366180419921875,652.3342701407001,1,638,136,1543,778,960,600,20
5,0,0,5.0,-0.0,0.24453091621398926,647.4449783572346,1,633,136,1543,778,960,600,20
5,0,0,5.0,-0.0,0.25255894660949707,642.5573904329481,1,628,136,1543,778,960,600,20
6,0,0,6.0,-0.0,0.26059603691101074,636.6945892655285,1,622,136,1543,778,960,600,20
9,0,0,9.0,-0.0,0.26853489875793457,627.9052476289714,1,613,136,1543,778,960,600,20
13,1,0,13.0,1.0,0.27654504776000977,615.0,1,600,135,1543,778,960,600,20
17,2,0,17.0,2.0,0.28461503982543945,597.9782604744089,1,583,133,1543,778,960,600,20
19,2,0,19.0,2.0,0.2926499843597412,579.0138167608783,1,564,131,1543,778,960,600,20
21,2,0,21.0,2.0,0.3006861209869385,558.11289180595,1,543,129,1543,778,960,600,20
20,3,0,20.0,3.0,0.3085660934448242,537.9637534258233,1,523,126,1543,778,960,600,20
23,4,0,23.0,4.0,0.31676697731018066,514.6688255567847,1,500,122,1543,778,960,600,20
24,5,0,24.0,5.0,0.3245820999145508,490.1683384307885,1,476,117,1543,778,960,600,20
25,5,0,25.0,5.0,0.3325800895690918,464.69882719886436,1,451,112,1543,778,960,600,20
25,4,0,25.0,4.0,0.3404579162597656,439.4769618535197,1,426,108,1543,778,960,600,20
26,6,0,26.0,6.0,0.34856510162353516,412.8001937984041,1,400,102,1543,778,960,600,20
25,6,0,25.0,6.0,0.356564998626709,387.09301207849256,1,375,96,1543,778,960,600,20
23,6,0,23.0,6.0,0.3645749092102051,363.3235472688221,1,352,90,1543,778,960,600,20
22,6,0,22.0,6.0,0.37273597717285156,340.52312696790506,1,330,84,1543,778,960,600,20
20,5,0,20.0,5.0,0.3806469440460205,319.90779921721196,1,310,79,1543,778,960,600,20
17,5,0,17.0,5.0,0.3885769844055176,302.2002647252315,1,293,74,1543,778,960,600,20
15,5,0,15.0,5.0,0.39650893211364746,286.4349838968697,1,278,69,1543,778,960,600,20
12,3,0,12.0,3.0,0.40463900566101074,274.0656855573131,1,266,66,1543,778,960,600,20
10,4,0,10.0,4.0,0.4125220775604248,263.4008352302627,1,256,62,1543,778,960,600,20
7,2,0,7.0,2.0,0.4205169677734375,256.12692166189794,1,249,60,1543,778,960,600,20
6,2,0,6.0,2.0,0.4285619258880615,249.8259394058191,1,243,58,1543,778,960,600,20
3,2,0,3.0,2.0,0.4365079402923584,246.4467488119898,1,240,56,1543,778,960,600,20
3,1,0,3.0,1.0,0.4446220397949219,243.29817097545143,1,237,55,1543,778,960,600,20
2,1,0,2.0,1.0,0.4524350166320801,241.12444919584576,1,235,54,1543,778,960,600,20
2,1,0,2.0,1.0,0.46070098876953125,238.9518780005715,1,233,53,1543,778,960,600,20
2,1,0,2.0,1.0,0.46858906745910645,236.78048906107108,1,231,52,1543,778,960,600,20
2,1,0,2.0,1.0,0.4765200614929199,234.61031520374377,1,229,51,1543,778,960,600,20
2,1,0,2.0,1.0,0.484515905380249,232.44139046219803,1,227,50,1543,778,960,600,20
3,1,0,3.0,1.0,0.49252796173095703,229.2967509582288,1,224,49,1543,778,960,600,20
4,1,0,4.0,1.0,0.5005369186401367,225.1754871206011,1,220,48,1543,778,960,600,20
4,1,0,4.0,1.0,0.508599042892456,221.05429197371402,1,216,47,1543,778,960,600,20
7,2,0,7.0,2.0,0.5165400505065918,213.78961621182634,1,209,45,1543,778,960,600,20
7,2,0,7.0,2.0,0.5245380401611328,206.52602741543257,1,202,43,1543,778,960,600,20
9,2,0,9.0,2.0,0.5325911045074463,197.3068675946177,1,193,41,1543,778,960,600,20
7,2,0,7.0,2.0,0.5405170917510986,190.04473157654226,1,186,39,1543,778,960,600,20
6,2,0,6.0,2.0,0.5486159324645996,183.76343488300387,1,180,37,1543,778,960,600,20
5,2,0,5.0,2.0,0.5565259456634521,178.46568297574746,1,175,35,1543,778,960,600,20
3,2,0,3.0,2.0,0.5646231174468994,175.13708916160505,1,172,33,1543,778,960,600,20
5,1,0,5.0,1.0,0.572624921798706,170.03823099526764,1,167,32,1543,778,960,600,20
5,3,0,5.0,3.0,0.5806190967559814,164.57521077003062,1,162,29,1543,778,960,600,20
6,2,0,6.0,2.0,0.5885219573974609,158.31929762350515,1,156,27,1543,778,960,600,20
7,2,0,7.0,2.0,0.5964889526367188,151.08275877809487,1,149,25,1543,778,960,600,20
8,2,0,8.0,2.0,0.6044669151306152,142.86357128393507,1,141,23,1543,778,960,600,20
6,2,0,6.0,2.0,0.6125550270080566,136.6235704408284,1,135,21,1543,778,960,600,20
5,0,0,5.0,-0.0,0.6205999851226807,131.68523075880606,1,130,21,1543,778,960,600,20
4,1,0,4.0,1.0,0.6286759376525879,127.57742747053649,1,126,20,1543,778,960,600,20
5,0,0,5.0,-0.0,0.6367359161376953,122.64175471673585,1,121,20,1543,778,960,600,20
3,0,0,3.0,-0.0,0.6445519924163818,119.68291440301745,1,118,20,1543,778,960,600,20
4,0,0,4.0,-0.0,0.652493953704834,115.7410903698423,1,114,20,1543,778,960,600,20
4,1,0,4.0,1.0,0.6605339050292969,111.6288493177279,1,110,19,1543,778,960,600,20
4,0,0,4.0,-0.0,0.6684229373931885,107.68936809174804,1,106,19,1543,778,960,600,20
4,0,0,4.0,-0.0,0.6765480041503906,103.75451797391764,1,102,19,1543,778,960,600,20
3,0,0,3.0,-0.0,0.6845860481262207,100.80674580602232,1,99,19,1543,778,960,600,20
2,0,0,2.0,-0.0,0.6926469802856445,98.84331034521254,1,97,19,1543,778,960,600,20
2,0,0,2.0,-0.0,0.7004969120025635,96.88137075826292,1,95,19,1543,778,960,600,20
2,0,0,2.0,-0.0,0.7085320949554443,94.92101980067429,1,93,19,1543,778,960,600,20
3,1,0,3.0,1.0,0.716594934463501,91.78235124467012,1,90,18,1543,778,960,600,20
2,0,0,2.0,-0.0,0.7245140075683594,89.82204629154248,1,88,18,1543,778,960,600,20
2,0,0,2.0,-0.0,0.7327980995178223,87.86353054595519,1,86,18,1543,778,960,600,20
2,1,0,2.0,1.0,0.7405729293823242,85.70297544426332,1,84,17,1543,778,960,600,20
2,0,0,2.0,-0.0,0.7484409809112549,83.74365647617735,1,82,17,1543,778,960,600,20
3,1,0,3.0,1.0,0.7566571235656738,80.60397012554654,1,79,16,1543,778,960,600,20
2,0,0,2.0,-0.0,0.7645080089569092,78.64477096412705,1,77,16,1543,778,960,600,20
4,1,0,4.0,1.0,0.7725169658660889,74.52516353554684,1,73,15,1543,778,960,600,20
4,1,0,4.0,1.0,0.7805829048156738,70.40596565632774,1,69,14,1543,778,960,600,20
5,2,0,5.0,2.0,0.7886550426483154,65.11528238439882,1,64,12,1543,778,960,600,20
4,1,0,4.0,1.0,0.7965400218963623,61.0,1,60,11,1543,778,960,600,20
4,1,0,4.0,1.0,0.8046150207519531,56.88585061331157,1,56,10,1543,778,960,600,20
3,1,0,3.0,1.0,0.8125591278076172,53.75872022286245,1,53,9,1543,778,960,600,20
3,1,0,3.0,1.0,0.8205790519714355,50.635955604688654,1,50,8,1543,778,960,600,20
4,1,0,4.0,1.0,0.828495979309082,46.52956049652737,1,46,7,1543,778,960,600,20
4,1,0,4.0,1.0,0.8366401195526123,42.42640687119285,1,42,6,1543,778,960,600,20
5,1,0,5.0,1.0,0.8445110321044922,37.33630940518894,1,37,5,1543,778,960,600,20
6,1,0,6.0,1.0,0.8525290489196777,31.25699921617557,1,31,4,1543,778,960,600,20
5,2,0,5.0,2.0,0.8605251312255859,26.076809620810597,1,26,2,1543,778,960,600,20
4,1,0,4.0,1.0,0.868675947189331,22.02271554554524,1,22,1,1543,778,960,600,20
4,1,0,4.0,1.0,0.8765361309051514,18.0,1,18,0,1543,778,960,600,20
3,1,0,3.0,1.0,0.8845460414886475,15.033296378372908,1,15,-1,1543,778,960,600,20
3,1,0,3.0,1.0,0.8926270008087158,12.165525060596439,1,12,-2,1543,778,960,600,20
3,1,0,3.0,1.0,0.9005920886993408,9.486832980505138,1,9,-3,1543,778,960,600,20
2,1,0,2.0,1.0,0.9085500240325928,8.06225774829855,1,7,-4,1543,778,960,600,20
2,0,0,2.0,-0.0,0.9166131019592285,6.4031242374328485,1,5,-4,1543,778,960,600,20
2,0,0,2.0,-0.0,0.9246780872344971,5.0,1,3,-4,1543,778,960,600,20
2,0,0,2.0,-0.0,0.932528018951416,4.123105625617661,1,1,-4,1543,778,960,600,20
1,0,0,1.0,-0.0,0.940648078918457,4.0,1,0,-4,1543,778,960,600,20
0,1,0,-0.0,1.0,0.9485599994659424,5.0,1,0,-5,1543,778,960,600,20
0,0,1,-0.0,-0.0,1.0116689205169678,5.0,1,0,-5,1543,778,960,600,20
0,0,0,-0.0,-0.0,0.08572530746459961,216.8155898453799,2,175,-128,1718,655,1543,783,59
-2,1,0,-2.0,1.0,0.12877440452575684,219.02054698132775,2,177,-129,1718,655,1543,783,59
-2,1,0,-2.0,1.0,0.13677239418029785,221.22612865572637,2,179,-130,1718,655,1543,783,59
-3,1,0,-3.0,1.0,0.14470839500427246,224.24317157942625,2,182,-131,1718,655,1543,783,59
-2,1,0,-2.0,1.0,0.15276646614074707,226.45087767549057,2,184,-132,1718,655,1543,783,59
-3,1,0,-3.0,1.0,0.16080927848815918,229.4733099948663,2,187,-133,1718,655,1543,783,59
-2,0,0,-2.0,-0.0,0.16862940788269043,231.10603626906848,2,189,-133,1718,655,1543,783,59
-3,0,0,-3.0,-0.0,0.1767892837524414,233.5658365429328,2,192,-133,1718,655,1543,783,59
-2,0,0,-2.0,-0.0,0.18476629257202148,235.2126697267815,2,194,-133,1718,655,1543,783,59
-1,0,0,-1.0,-0.0,0.19277644157409668,236.03813251252433,2,195,-133,1718,655,1543,783,59
-1,0,0,-1.0,-0.0,0.20071148872375488,236.86494041964082,2,196,-133,1718,655,1543,783,59
0,-2,0,-0.0,-2.0,0.20871829986572266,235.74774654278247,2,196,-131,1718,655,1543,783,59
2,-4,0,2.0,-4.0,0.2167353630065918,231.87280996270349,2,194,-127,1718,655,1543,783,59
3,-6,0,3.0,-6.0,0.22477149963378906,226.101747007846,2,191,-121,1718,655,1543,783,59
5,-6,0,5.0,-6.0,0.2326962947845459,218.68013169924697,2,186,-115,1718,655,1543,783,59
7,-7,0,7.0,-7.0,0.2407674789428711,209.05740838343903,2,179,-108,1718,655,1543,783,59
8,-8,0,8.0,-8.0,0.24868345260620117,198.09341230843594,2,171,-100,1718,655,1543,783,59
9,-11,0,9.0,-11.0,0.25677943229675293,184.83776670366908,2,162,-89,1718,655,1543,783,59
12,-9,0,12.0,-9.0,0.2648143768310547,170.0,2,150,-80,1718,655,1543,783,59
12,-7,0,12.0,-7.0,0.27266550064086914,156.11854470241516,2,138,-73,1718,655,1543,783,59
13,-7,0,13.0,-7.0,0.2807323932647705,141.35416513141735,2,125,-66,1718,655,1543,783,59
13,-6,0,13.0,-6.0,0.28860044479370117,127.05904139414872,2,112,-60,1718,655,1543,783,59
11,-6,0,11.0,-6.0,0.2966923713684082,114.5294721894762,2,101,-54,1718,655,1543,783,59
9,-4,0,9.0,-4.0,0.3045773506164551,104.70912090166739,2,92,-50,1718,655,1543,783,59
9,-4,0,9.0,-4.0,0.3127474784851074,94.89467845985885,2,83,-46,1718,655,1543,783,59
7,-4,0,7.0,-4.0,0.3207814693450928,86.83317338436964,2,76,-42,1718,655,1543,783,59
6,-3,0,6.0,-3.0,0.3286454677581787,80.1311425102625,2,70,-39,1718,655,1543,783,59
5,-2,0,5.0,-2.0,0.33672428131103516,74.79304780526061,2,65,-37,1718,655,1543,783,59
2,-1,0,2.0,-1.0,0.3447895050048828,72.56031973468694,2,63,-36,1718,655,1543,783,59
2,-2,0,2.0,-2.0,0.35268449783325195,69.83552104767315,2,61,-34,1718,655,1543,783,59
2,0,0,2.0,-0.0,0.3607313632965088,68.09552114493287,2,59,-34,1718,655,1543,783,59
0,-1,0,-0.0,-1.0,0.3687453269958496,67.60177512462228,2,59,-33,1718,655,1543,783,59
1,-1,0,1.0,-1.0,0.3768134117126465,66.24198064671678,2,58,-32,1718,655,1543,783,59
1,0,0,1.0,-0.0,0.3927023410797119,65.36818798161687,2,57,-32,1718,655,1543,783,59
1,-1,0,1.0,-1.0,0.40089941024780273,64.00781202322104,2,56,-31,1718,655,1543,783,59
0,0,1,-0.0,-0.0,0.45366835594177246,64.00781202322104,2,56,-31,1718,655,1543,783,59
0,0,0,-0.0,-0.0,0.5346384048461914,64.00781202322104,2,56,-31,1718,655,1543,783,59
1,-1,0,1.0,-1.0,0.584679365158081,62.64982043070834,2,55,-30,1718,655,1543,783,59
2,-1,0,2.0,-1.0,0.5926892757415771,60.41522986797286,2,53,-29,1718,655,1543,783,59
2,-1,0,2.0,-1.0,0.6006712913513184,58.180752831155424,2,51,-28,1718,655,1543,783,59
3,-3,0,3.0,-3.0,0.6087102890014648,54.120236510939236,2,48,-25,1718,655,1543,783,59
1,-2,0,1.0,-2.0,0.6167232990264893,52.32590180780452,2,47,-23,1718,655,1543,783,59
2,-3,0,2.0,-3.0,0.6248064041137695,49.24428900898052,2,45,-20,1718,655,1543,783,59
1,-1,0,1.0,-1.0,0.6327154636383057,47.92702786528704,2,44,-19,1718,655,1543,783,59
1,-1,0,1.0,-1.0,0.640735387802124,46.61544808322666,2,43,-18,1718,655,1543,783,59
1,0,0,1.0,-0.0,0.648693323135376,45.69463863518345,2,42,-18,1718,655,1543,783,59
0,-1,0,-0.0,-1.0,0.6568484306335449,45.31004303683677,2,42,-17,1718,655,1543,783,59
0,0,1,-0.0,-0.0,0.6787083148956299,45.31004303683677,2,42,-17,1718,655,1543,783,59
0,0,0,-0.0,-0.0,0.08484172821044922,825.4919745218605,3,-821,86,855,758,1676,672,55
0,1,0,-0.0,1.0,0.10996770858764648,825.3883934245744,3,-821,85,855,758,1676,672,55
-2,2,0,-2.0,2.0,0.11786174774169922,823.1949951256993,3,-819,83,855,758,1676,672,55
-3,2,0,-3.0,2.0,0.1258246898651123,820.0103657881405,3,-816,81,855,758,1676,672,55
-1,1,0,-1.0,1.0,0.13424253463745117,818.91696770796,3,-815,80,855,758,1676,672,55
-1,1,0,-1.0,1.0,0.141709566116333,817.8245533120169,3,-814,79,855,758,1676,672,55
-1,0,0,-1.0,-0.0,0.14978957176208496,816.8292355198852,3,-813,79,855,758,1676,672,55
-1,1,0,-1.0,1.0,0.1900496482849121,815.7377029413315,3,-812,78,855,758,1676,672,55
-3,2,0,-3.0,2.0,0.19779658317565918,812.561997634642,3,-809,76,855,758,1676,672,55
-5,3,0,-5.0,3.0,0.20579862594604492,807.3072525377188,3,-804,73,855,758,1676,672,55
-9,4,0,-9.0,4.0,0.2140045166015625,797.9887217248123,3,-795,69,855,758,1676,672,55
-10,4,0,-10.0,4.0,0.22193574905395508,787.6864858558893,3,-785,65,855,758,1676,672,55
-12,4,0,-12.0,4.0,0.22995471954345703,775.4031209635411,3,-773,61,855,758,1676,672,55
-17,4,0,-17.0,4.0,0.23779654502868652,758.1457643487827,3,-756,57,855,758,1676,672,55
-28,6,0,-28.0,6.0,0.24588871002197266,729.784214682669,3,-728,51,855,758,1676,672,55
-32,6,0,-32.0,6.0,0.253767728805542,697.4532242380129,3,-696,45,855,758,1676,672,55
-32,5,0,-32.0,5.0,0.2618556022644043,665.203728191597,3,-664,40,855,758,1676,672,55
-30,4,0,-30.0,4.0,0.2697715759277344,635.0212594866412,3,-634,36,855,758,1676,672,55
-28,3,0,-28.0,3.0,0.2778055667877197,606.8978497243173,3,-606,33,855,758,1676,672,55
-29,1,0,-29.0,1.0,0.2859225273132324,577.8866670896639,3,-577,32,855,758,1676,672,55
-29,0,0,-29.0,-0.0,0.2938406467437744,548.9335114565333,3,-548,32,855,758,1676,672,55
-30,-3,0,-30.0,-3.0,0.30194568634033203,519.1810859420824,3,-518,35,855,758,1676,672,55
-29,-3,0,-29.0,-3.0,0.30989551544189453,490.47426028284093,3,-489,38,855,758,1676,672,55
-25,-3,0,-25.0,-3.0,0.31792163848876953,465.8079003194343,3,-464,41,855,758,1676,672,55
-22,-4,0,-22.0,-4.0,0.3259315490722656,444.2848185567452,3,-442,45,855,758,1676,672,55
-19,-3,0,-19.0,-3.0,0.333911657333374,425.7146931925183,3,-423,48,855,758,1676,672,55
-16,-3,0,-16.0,-3.0,0.3419046401977539,410.18288603987367,3,-407,51,855,758,1676,672,55
-14,-2,0,-14.0,-2.0,0.3499126434326172,396.5576881110742,3,-393,53,855,758,1676,672,55
-13,-3,0,-13.0,-3.0,0.35793161392211914,384.1041525419896,3,-380,56,855,758,1676,672,55
-11,-2,0,-11.0,-2.0,0.3658576011657715,373.5304539123952,3,-369,58,855,758,1676,672,55
-8,-1,0,-8.0,-1.0,0.37384772300720215,365.78955698598065,3,-361,59,855,758,1676,672,55
-7,-1,0,-7.0,-1.0,0.38192272186279297,359.0487432090523,3,-354,60,855,758,1676,672,55
-5,0,0,-5.0,-0.0,0.38980674743652344,354.1200361459374,3,-349,60,855,758,1676,672,55
-6,0,0,-6.0,-0.0,0.39787864685058594,348.20827101032506,3,-343,60,855,758,1676,672,55
-5,0,0,-5.0,-0.0,0.40590357780456543,343.28413887041154,3,-338,60,855,758,1676,672,55
-5,1,0,-5.0,1.0,0.41388654708862305,338.18633916821653,3,-333,59,855,758,1676,672,55
-4,1,0,-4.0,1.0,0.42188572883605957,334.07334524023315,3,-329,58,855,758,1676,672,55
-3,1,0,-3.0,1.0,0.42981672286987305,330.94561486745823,3,-326,57,855,758,1676,672,55
-4,2,0,-4.0,2.0,0.4379005432128906,326.663435358168,3,-322,55,855,758,1676,672,55
-6,3,0,-6.0,3.0,0.44587159156799316,320.24990241996954,3,-316,52,855,758,1676,672,55
-7,2,0,-7.0,2.0,0.45381975173950195,313.0191687421075,3,-309,50,855,758,1676,672,55
-7,2,0,-7.0,2.0,0.4617617130279541,305.7907781474124,3,-302,48,855,758,1676,672,55
-11,4,0,-11.0,4.0,0.4700136184692383,294.3076621496627,3,-291,44,855,758,1676,672,55
-10,3,0,-10.0,3.0,0.4778916835784912,283.9753510430087,3,-281,41,855,758,1676,672,55
-11,3,0,-11.0,3.0,0.48592567443847656,272.66096163550804,3,-270,38,855,758,1676,672,55
-11,3,0,-11.0,3.0,0.49389171600341797,261.3541658363226,3,-259,35,855,758,1676,672,55
-11,3,0,-11.0,3.0,0.5021085739135742,250.05599372940455,3,-248,32,855,758,1676,672,55
-8,2,0,-8.0,2.0,0.5098955631256104,241.8677324489565,3,-240,30,855,758,1676,672,55
-8,2,0,-8.0,2.0,0.5178165435791016,233.68354670365648,3,-232,28,855,758,1676,672,55
-8,2,0,-8.0,2.0,0.5258536338806152,225.50388023269133,3,-224,26,855,758,1676,672,55
-8,2,0,-8.0,2.0,0.5338935852050781,217.329243315298,3,-216,24,855,758,1676,672,55
-7,2,0,-7.0,2.0,0.5418176651000977,210.1547049199708,3,-209,22,855,758,1676,672,55
-5,1,0,-5.0,1.0,0.5498716831207275,205.0780339285512,3,-204,21,855,758,1676,672,55
-5,1,0,-5.0,1.0,0.5578577518463135,200.0024999843752,3,-199,20,855,758,1676,672,55
-6,2,0,-6.0,2.0,0.5658257007598877,193.83756085960223,3,-193,18,855,758,1676,672,55
-5,1,0,-5.0,1.0,0.5739116668701172,188.76705220985997,3,-188,17,855,758,1676,672,55
-5,2,0,-5.0,2.0,0.5821256637573242,183.61372497719228,3,-183,15,855,758,1676,672,55
-5,0,0,-5.0,-0.0,0.5899736881256104,178.63090438107287,3,-178,15,855,758,1676,672,55
-4,1,0,-4.0,1.0,0.597740650177002,174.56230979223437,3,-174,14,855,758,1676,672,55
-6,2,0,-6.0,2.0,0.605954647064209,168.4280261714184,3,-168,12,855,758,1676,672,55
-5,0,0,-5.0,-0.0,0.613783597946167,163.44112089679268,3,-163,12,855,758,1676,672,55
-4,0,0,-4.0,-0.0,0.621910572052002,159.45218719101973,3,-159,12,855,758,1676,672,55
-5,1,0,-5.0,1.0,0.6298565864562988,154.39235732380018,3,-154,11,855,758,1676,672,55
-7,0,0,-7.0,-0.0,0.6379396915435791,147.41099009232656,3,-147,11,855,758,1676,672,55
-9,1,0,-9.0,1.0,0.6458675861358643,138.36184445142382,3,-138,10,855,758,1676,672,55
-7,1,0,-7.0,1.0,0.6537747383117676,131.30879635424276,3,-131,9,855,758,1676,672,55
-6,0,0,-6.0,-0.0,0.6618516445159912,125.32358118087753,3,-125,9,855,758,1676,672,55
-6,1,0,-6.0,1.0,0.6699776649475098,119.26860441876563,3,-119,8,855,758,1676,672,55
-9,1,0,-9.0,1.0,0.6779017448425293,110.22250223978767,3,-110,7,855,758,1676,672,55
-11,1,0,-11.0,1.0,0.6858506202697754,99.18165152889924,3,-99,6,855,758,1676,672,55
-10,2,0,-10.0,2.0,0.6938357353210449,89.08984229416954,3,-89,4,855,758,1676,672,55
-7,1,0,-7.0,1.0,0.7019336223602295,82.05485969764375,3,-82,3,855,758,1676,672,55
-5,0,0,-5.0,-0.0,0.7098546028137207,77.05841939723393,3,-77,3,855,758,1676,672,55
-6,1,0,-6.0,1.0,0.7178916931152344,71.02816342831905,3,-71,2,855,758,1676,672,55
-7,0,0,-7.0,-0.0,0.7259275913238525,64.03124237432849,3,-64,2,855,758,1676,672,55
-6,1,0,-6.0,1.0,0.7338266372680664,58.008620049092706,3,-58,1,855,758,1676,672,55
-4,1,0,-4.0,1.0,0.7417445182800293,54.0,3,-54,0,855,758,1676,672,55
-4,0,0,-4.0,-0.0,0.7501776218414307,50.0,3,-50,0,855,758,1676,672,55
-3,1,0,-3.0,1.0,0.7577915191650391,47.01063709417264,3,-47,-1,855,758,1676,672,55
-2,0,0,-2.0,-0.0,0.7659876346588135,45.0111097397076,3,-45,-1,855,758,1676,672,55
-1,1,0,-1.0,1.0,0.7738685607910156,44.04543109109048,3,-44,-2,855,758,1676,672,55
-2,0,0,-2.0,-0.0,0.7818586826324463,42.04759208325728,3,-42,-2,855,758,1676,672,55
-2,0,0,-2.0,-0.0,0.7899975776672363,40.049968789001575,3,-40,-2,855,758,1676,672,55
-1,1,0,-1.0,1.0,0.7977855205535889,39.11521443121589,3,-39,-3,855,758,1676,672,55
-1,0,0,-1.0,-0.0,0.8058946132659912,38.118237105091836,3,-38,-3,855,758,1676,672,55
-2,0,0,-2.0,-0.0,0.813889741897583,36.124783736376884,3,-36,-3,855,758,1676,672,55
-1,1,0,-1.0,1.0,0.8220505714416504,35.22782990761707,3,-35,-4,855,758,1676,672,55
-1,0,0,-1.0,-0.0,0.8298707008361816,34.23448553724738,3,-34,-4,855,758,1676,672,55
-1,0,0,-1.0,-0.0,0.8378956317901611,33.24154027718932,3,-33,-4,855,758,1676,672,55
0,0,1,-0.0,-0.0,0.847848653793335,33.24154027718932,3,-33,-4,855,758,1676,672,55
0,0,0,-0.0,-0.0,0.10349607467651367,762.94298607432,4,661,381,1549,1143,888,762,19
2,0,0,2.0,-0.0,0.15364408493041992,761.2108774840254,4,659,381,1549,1143,888,762,19
2,0,0,2.0,-0.0,0.1616230010986328,759.480085321531,4,657,381,1549,1143,888,762,19
2,0,0,2.0,-0.0,0.16938519477844238,757.7506186074677,4,655,381,1549,1143,888,762,19
4,0,0,4.0,-0.0,0.17764711380004883,754.2956979858761,4,651,381,1549,1143,888,762,19
5,0,0,5.0,-0.0,0.1855180263519287,749.9846665099227,4,646,381,1549,1143,888,762,19
8,0,0,8.0,-0.0,0.1935100555419922,743.1049723962288,4,638,381,1549,1143,888,762,19
11,1,0,11.0,1.0,0.20165419578552246,733.1636924998401,4,627,380,1549,1143,888,762,19
14,4,0,14.0,4.0,0.20954608917236328,719.1279441100867,4,613,376,1549,1143,888,762,19
19,7,0,19.0,7.0,0.21754097938537598,699.2832044315093,4,594,369,1549,1143,888,762,19
20,8,0,20.0,8.0,0.2253870964050293,678.083328212691,4,574,361,1549,1143,888,762,19
22,8,0,22.0,8.0,0.23362016677856445,655.2198104453191,4,552,353,1549,1143,888,762,19
23,10,0,23.0,10.0,0.24148106575012207,630.4680800801893,4,529,343,1549,1143,888,762,19
24,9,0,24.0,9.0,0.24950098991394043,605.4593297654269,4,505,334,1549,1143,888,762,19
27,11,0,27.0,11.0,0.2575349807739258,576.8994713119436,4,478,323,1549,1143,888,762,19
32,13,0,32.0,13.0,0.2655661106109619,543.1537535541847,4,446,310,1549,1143,888,762,19
36,14,0,36.0,14.0,0.2736032009124756,505.6836956042779,4,410,296,1549,1143,888,762,19
37,15,0,37.0,15.0,0.28148603439331055,467.00107066258425,4,373,281,1549,1143,888,762,19
36,13,0,36.0,13.0,0.2895519733428955,430.57287420365907,4,337,268,1549,1143,888,762,19
30,15,0,30.0,15.0,0.2975771427154541,397.81654063148255,4,307,253,1549,1143,888,762,19
27,15,0,27.0,15.0,0.3055281639099121,367.48333295538725,4,280,238,1549,1143,888,762,19
22,13,0,22.0,13.0,0.313554048538208,342.32878932394806,4,258,225,1549,1143,888,762,19
20,11,0,20.0,11.0,0.321505069732666,320.0624938976762,4,238,214,1549,1143,888,762,19
19,13,0,19.0,13.0,0.3296680450439453,297.2574641619618,4,219,201,1549,1143,888,762,19
18,13,0,18.0,13.0,0.3375091552734375,275.2180953353177,4,201,188,1549,1143,888,762,19
16,11,0,16.0,11.0,0.3454411029815674,256.03515383634334,4,185,177,1549,1143,888,762,19
15,11,0,15.0,11.0,0.3534049987792969,237.60471375795558,4,170,166,1549,1143,888,762,19
13,10,0,13.0,10.0,0.3615241050720215,221.32555207205516,4,157,156,1549,1143,888,762,19
12,9,0,12.0,9.0,0.36950206756591797,206.48002324680226,4,145,147,1549,1143,888,762,19
9,8,0,9.0,8.0,0.3774709701538086,194.4659353203023,4,136,139,1549,1143,888,762,19
8,7,0,8.0,7.0,0.385483980178833,183.86951895297926,4,128,132,1549,1143,888,762,19
6,6,0,6.0,6.0,0.39360713958740234,175.38529014715002,4,122,126,1549,1143,888,762,19
5,5,0,5.0,5.0,0.4016590118408203,168.31518053936787,4,117,121,1549,1143,888,762,19
4,5,0,4.0,5.0,0.4095451831817627,161.94134740701648,4,113,116,1549,1143,888,762,19
4,4,0,4.0,4.0,0.41758012771606445,156.28499608087785,4,109,112,1549,1143,888,762,19
4,3,0,4.0,3.0,0.4255971908569336,151.34728276384746,4,105,109,1549,1143,888,762,19
3,2,0,3.0,2.0,0.43352818489074707,147.82760229402356,4,102,107,1549,1143,888,762,19
0,2,0,-0.0,2.0,0.4414041042327881,146.38647478507022,4,102,105,1549,1143,888,762,19
1,1,0,1.0,1.0,0.4496431350708008,144.97241116847025,4,101,104,1549,1143,888,762,19
1,3,0,1.0,3.0,0.45754408836364746,142.13022197970423,4,100,101,1549,1143,888,762,19
2,3,0,2.0,3.0,0.4656801223754883,138.59292911256333,4,98,98,1549,1143,888,762,19
2,3,0,2.0,3.0,0.47351717948913574,135.05924625881784,4,96,95,1549,1143,888,762,19
2,4,0,2.0,4.0,0.4816720485687256,130.83195328359201,4,94,91,1549,1143,888,762,19
3,4,0,3.0,4.0,0.48955416679382324,125.89678312014172,4,91,87,1549,1143,888,762,19
3,4,0,3.0,4.0,0.49767518043518066,120.96693763173474,4,88,83,1549,1143,888,762,19
4,4,0,4.0,4.0,0.5055830478668213,115.31261856362468,4,84,79,1549,1143,888,762,19
3,3,0,3.0,3.0,0.5134420394897461,111.07204868912791,4,81,76,1549,1143,888,762,19
4,4,0,4.0,4.0,0.5215821266174316,105.41821474489122,4,77,72,1549,1143,888,762,19
4,3,0,4.0,3.0,0.5295791625976562,100.44899203078147,4,73,69,1549,1143,888,762,19
3,4,0,3.0,4.0,0.5376851558685303,95.524865872714,4,70,65,1549,1143,888,762,19
4,3,0,4.0,3.0,0.5455291271209717,90.55385138137417,4,66,62,1549,1143,888,762,19
3,4,0,3.0,4.0,0.5535249710083008,85.63293758829018,4,63,58,1549,1143,888,762,19
4,3,0,4.0,3.0,0.5615851879119873,80.65977932030313,4,59,55,1549,1143,888,762,19
5,4,0,5.0,4.0,0.569573163986206,74.27651041883968,4,54,51,1549,1143,888,762,19
6,4,0,6.0,4.0,0.5775861740112305,67.17886572427373,4,48,47,1549,1143,888,762,19
6,4,0,6.0,4.0,0.5855400562286377,60.108235708594876,4,42,43,1549,1143,888,762,19
6,4,0,6.0,4.0,0.5936250686645508,53.075418038862395,4,36,39,1549,1143,888,762,19
7,3,0,7.0,3.0,0.6016011238098145,46.22769732530488,4,29,36,1549,1143,888,762,19
7,5,0,7.0,5.0,0.6095271110534668,38.01315561749642,4,22,31,1549,1143,888,762,19
8,6,0,8.0,6.0,0.6175720691680908,28.653097563788805,4,14,25,1549,1143,888,762,19
8,5,0,8.0,5.0,0.6255321502685547,20.8806130178211,4,6,20,1549,1143,888,762,19
6,5,0,6.0,5.0,0.6335461139678955,15.0,4,0,15,1549,1143,888,762,19
8,5,0,8.0,5.0,0.6416311264038086,12.806248474865697,4,-8,10,1549,1143,888,762,19
6,4,0,6.0,4.0,0.6494381427764893,15.231546211727817,4,-14,6,1549,1143,888,762,19
5,4,0,5.0,4.0,0.6576180458068848,19.1049731745428,4,-19,2,1549,1143,888,762,19
5,3,0,5.0,3.0,0.6655130386352539,24.020824298928627,4,-24,-1,1549,1143,888,762,19
3,3,0,3.0,3.0,0.6735241413116455,27.294688127912362,4,-27,-4,1549,1143,888,762,19
3,2,0,3.0,2.0,0.6814529895782471,30.59411708155671,4,-30,-6,1549,1143,888,762,19
1,2,0,1.0,2.0,0.6895420551300049,32.01562118716424,4,-31,-8,1549,1143,888,762,19
1,1,0,1.0,1.0,0.6975951194763184,33.24154027718932,4,-32,-9,1549,1143,888,762,19
-1,0,0,-1.0,-0.0,0.7535240650177002,32.28002478313795,4,-31,-9,1549,1143,888,762,19
-1,0,0,-1.0,-0.0,0.7615971565246582,31.32091952673165,4,-30,-9,1549,1143,888,762,19
-1,0,0,-1.0,-0.0,0.7695419788360596,30.364452901377952,4,-29,-9,1549,1143,888,762,19
-1,0,0,-1.0,-0.0,0.77754807472229,29.410882339705484,4,-28,-9,1549,1143,888,762,19
-1,0,0,-1.0,-0.0,0.7855281829833984,28.460498941515414,4,-27,-9,1549,1143,888,762,19
-1,0,0,-1.0,-0.0,0.7935299873352051,27.51363298439521,4,-26,-9,1549,1143,888,762,19
-1,0,0,-1.0,-0.0,0.8015940189361572,26.570660511172846,4,-25,-9,1549,1143,888,762,19
-1,0,0,-1.0,-0.0,0.8097140789031982,25.632011235952593,4,-24,-9,1549,1143,888,762,19
-2,0,0,-2.0,-0.0,0.8175179958343506,23.769728648009426,4,-22,-9,1549,1143,888,762,19
-2,0,0,-2.0,-0.0,0.8255290985107422,21.93171219946131,4,-20,-9,1549,1143,888,762,19
-1,0,0,-1.0,-0.0,0.8335421085357666,21.02379604162864,4,-19,-9,1549,1143,888,762,19
-2,0,0,-2.0,-0.0,0.8416919708251953,19.235384061671343,4,-17,-9,1549,1143,888,762,19
-1,-1,0,-1.0,-1.0,0.8495521545410156,17.88854381999832,4,-16,-8,1549,1143,888,762,19
-1,0,0,-1.0,-0.0,0.8575930595397949,17.0,4,-15,-8,1549,1143,888,762,19
-1,-1,0,-1.0,-1.0,0.8655300140380859,15.652475842498529,4,-14,-7,1549,1143,888,762,19
-1,-1,0,-1.0,-1.0,0.8735439777374268,14.317821063276353,4,-13,-6,1549,1143,888,762,19
-1,-1,0,-1.0,-1.0,0.8813741207122803,13.0,4,-12,-5,1549,1143,888,762,19
-1,-1,0,-1.0,-1.0,0.8894681930541992,11.704699910719626,4,-11,-4,1549,1143,888,762,19
-2,-2,0,-2.0,-2.0,0.89754319190979,9.219544457292887,4,-9,-2,1549,1143,888,762,19
-2,-2,0,-2.0,-2.0,0.9055161476135254,7.0,4,-7,0,1549,1143,888,762,19
-1,0,0,-1.0,-0.0,0.9135360717773438,6.0,4,-6,0,1549,1143,888,762,19
0,0,1,-0.0,-0.0,0.953510046005249,6.0,4,-6,0,1549,1143,888,762,19
0,0,0,-0.0,-0.0,0.07568025588989258,759.0052700739304,5,-592,-475,963,668,1555,1143,39
-1,0,0,-1.0,-0.0,0.13117027282714844,758.225560107281,5,-591,-475,963,668,1555,1143,39
-1,-1,0,-1.0,-1.0,0.15264534950256348,756.819661478215,5,-590,-474,963,668,1555,1143,39
-2,-1,0,-2.0,-1.0,0.1606612205505371,754.6343485423918,5,-588,-473,963,668,1555,1143,39
-3,-3,0,-3.0,-3.0,0.16893625259399414,750.4165509901817,5,-585,-470,963,668,1555,1143,39
-5,-4,0,-5.0,-4.0,0.1766831874847412,744.0134407388082,5,-580,-466,963,668,1555,1143,39
-9,-6,0,-9.0,-6.0,0.18471932411193848,733.2400698270656,5,-571,-460,963,668,1555,1143,39
-13,-8,0,-13.0,-8.0,0.19270014762878418,718.1002715498721,5,-558,-452,963,668,1555,1143,39
-18,-10,0,-18.0,-10.0,0.20071816444396973,697.8280590517983,5,-540,-442,963,668,1555,1143,39
-24,-13,0,-24.0,-13.0,0.20870018005371094,671.0417274655877,5,-516,-429,963,668,1555,1143,39
-31,-16,0,-31.0,-16.0,0.2166433334350586,637.0196229316645,5,-485,-413,963,668,1555,1143,39
-34,-17,0,-34.0,-17.0,0.22476720809936523,600.1808060909646,5,-451,-396,963,668,1555,1143,39
-33,-17,0,-33.0,-17.0,0.2326052188873291,564.2384247815811,5,-418,-379,963,668,1555,1143,39
-30,-13,0,-30.0,-13.0,0.2407093048095703,533.3854141237834,5,-388,-366,963,668,1555,1143,39
-26,-13,0,-26.0,-13.0,0.2485802173614502,505.6213998635738,5,-362,-353,963,668,1555,1143,39
-24,-11,0,-24.0,-11.0,0.25672125816345215,480.8409300381988,5,-338,-342,963,668,1555,1143,39
-21,-12,0,-21.0,-12.0,0.26463818550109863,457.5904282215702,5,-317,-330,963,668,1555,1143,39
-21,-13,0,-21.0,-13.0,0.27263426780700684,433.7107330929222,5,-296,-317,963,668,1555,1143,39
-19,-13,0,-19.0,-13.0,0.2806582450866699,411.2724158024703,5,-277,-304,963,668,1555,1143,39
-18,-13,0,-18.0,-13.0,0.28865623474121094,389.56642565806413,5,-259,-291,963,668,1555,1143,39
-15,-14,0,-15.0,-14.0,0.2966623306274414,369.14089451048363,5,-244,-277,963,668,1555,1143,39
-15,-15,0,-15.0,-15.0,0.30463218688964844,347.9727000786125,5,-229,-262,963,668,1555,1143,39
-13,-15,0,-13.0,-15.0,0.31261324882507324,328.12345237730267,5,-216,-247,963,668,1555,1143,39
-12,-17,0,-12.0,-17.0,0.3205993175506592,307.4345458792814,5,-204,-230,963,668,1555,1143,39
-10,-15,0,-10.0,-15.0,0.32861828804016113,289.5876378576958,5,-194,-215,963,668,1555,1143,39
-8,-13,0,-8.0,-13.0,0.33669614791870117,274.5906043549196,5,-186,-202,963,668,1555,1143,39
-6,-10,0,-6.0,-10.0,0.3446652889251709,263.1805463935357,5,-180,-192,963,668,1555,1143,39
-5,-11,0,-5.0,-11.0,0.3527183532714844,251.76576415390556,5,-175,-181,963,668,1555,1143,39
-5,-10,0,-5.0,-10.0,0.360795259475708,241.12444919584576,5,-170,-171,963,668,1555,1143,39
-3,-7,0,-3.0,-7.0,0.3686702251434326,234.06195760951843,5,-167,-164,963,668,1555,1143,39
-3,-8,0,-3.0,-8.0,0.3767211437225342,226.34486961272174,5,-164,-156,963,668,1555,1143,39
-3,-7,0,-3.0,-7.0,0.3847362995147705,219.36727194365162,5,-161,-149,963,668,1555,1143,39
-4,-7,0,-4.0,-7.0,0.39255714416503906,211.69081227110448,5,-157,-142,963,668,1555,1143,39
-6,-8,0,-6.0,-8.0,0.4006681442260742,201.8836298465034,5,-151,-134,963,668,1555,1143,39
-6,-7,0,-6.0,-7.0,0.4086742401123047,192.753728887407,5,-145,-127,963,668,1555,1143,39
-6,-7,0,-6.0,-7.0,0.41674327850341797,183.6327857437228,5,-139,-120,963,668,1555,1143,39
-6,-7,0,-6.0,-7.0,0.4246561527252197,174.52220489095365,5,-133,-113,963,668,1555,1143,39
-7,-6,0,-7.0,-6.0,0.4326913356781006,165.3027525481654,5,-126,-107,963,668,1555,1143,39
-8,-7,0,-8.0,-7.0,0.440737247467041,154.67385040788247,5,-118,-100,963,668,1555,1143,39
-7,-5,0,-7.0,-5.0,0.44859933853149414,146.102703602637,5,-111,-95,963,668,1555,1143,39
-5,-4,0,-5.0,-4.0,0.45663022994995117,139.70325694127536,5,-106,-91,963,668,1555,1143,39
-5,-4,0,-5.0,-4.0,0.46463823318481445,133.30416347586447,5,-101,-87,963,668,1555,1143,39
-6,-5,0,-6.0,-5.0,0.47269415855407715,125.49501982150527,5,-95,-82,963,668,1555,1143,39
-6,-4,0,-6.0,-4.0,0.48072123527526855,118.3427226321923,5,-89,-78,963,668,1555,1143,39
-7,-5,0,-7.0,-5.0,0.48874521255493164,109.78615577567146,5,-82,-73,963,668,1555,1143,39
-7,-5,0,-7.0,-5.0,0.4968142509460449,101.23734488813898,5,-75,-68,963,668,1555,1143,39
-7,-5,0,-7.0,-5.0,0.5046651363372803,92.69843580125827,5,-68,-63,963,668,1555,1143,39
-7,-4,0,-7.0,-4.0,0.512836217880249,84.86459803710851,5,-61,-59,963,668,1555,1143,39
