dx,dy,button,rx,ry,time,distance,targetID,directionX,directionY,targetX,targetY,initMouseX,initMouseY,targetSize
1,0,0,1.0,-0.0,0.12438845634460449,512.3719352189383,1,507,74,1471,681,963,607,20
1,0,0,1.0,-0.0,0.13241839408874512,511.38244005831876,1,506,74,1471,681,963,607,20
3,-1,0,3.0,-1.0,0.14039039611816406,508.56071417285074,1,503,75,1471,681,963,607,20
3,-2,0,3.0,-2.0,0.14850640296936035,505.8942577258611,1,500,77,1471,681,963,607,20
2,-1,0,2.0,-1.0,0.15654754638671875,504.07142351059736,1,498,78,1471,681,963,607,20
3,-1,0,3.0,-1.0,0.16436052322387695,501.2644012893794,1,495,79,1471,681,963,607,20
3,-2,0,3.0,-2.0,0.17241740226745605,498.62310415783986,1,492,81,1471,681,963,607,20
5,-2,0,5.0,-2.0,0.18036746978759766,494.02226670464967,1,487,83,1471,681,963,607,20
5,-3,0,5.0,-3.0,0.18839240074157715,489.61209135396155,1,482,86,1471,681,963,607,20
9,-3,0,9.0,-3.0,0.19642353057861328,481.3003220443552,1,473,89,1471,681,963,607,20
8,-2,0,8.0,-2.0,0.20456933975219727,473.82064117131915,1,465,91,1471,681,963,607,20
9,-2,0,9.0,-2.0,0.2126624584197998,465.3869357856965,1,456,93,1471,681,963,607,20
10,-1,0,10.0,-1.0,0.22046256065368652,455.79820096178526,1,446,94,1471,681,963,607,20
13,-1,0,13.0,-1.0,0.2283644676208496,443.29899616398865,1,433,95,1471,681,963,607,20
16,-1,0,16.0,-1.0,0.23636150360107422,427.907700328003,1,417,96,1471,681,963,607,20
21,0,0,21.0,-0.0,0.24429941177368164,407.47024431239146,1,396,96,1471,681,963,607,20
24,0,0,24.0,-0.0,0.2525653839111328,384.1874542459709,1,372,96,1471,681,963,607,20
27,1,0,27.0,1.0,0.26033639907836914,357.8407467016578,1,345,95,1471,681,963,607,20
29,2,0,29.0,2.0,0.2685885429382324,329.40097146183405,1,316,93,1471,681,963,607,20
29,4,0,29.0,4.0,0.2771303653717041,300.48294460751015,1,287,89,1471,681,963,607,20
29,5,0,29.0,5.0,0.28559446334838867,271.3300573102803,1,258,84,1471,681,963,607,20
26,4,0,26.0,4.0,0.2928354740142822,245.40578640284747,1,232,80,1471,681,963,607,20
20,5,0,20.0,5.0,0.30068039894104004,224.87552112224222,1,212,75,1471,681,963,607,20
18,5,0,18.0,5.0,0.30841946601867676,206.24257562394823,1,194,70,1471,681,963,607,20
13,5,0,13.0,5.0,0.31640148162841797,192.31744590650115,1,181,65,1471,681,963,607,20
10,5,0,10.0,5.0,0.3245055675506592,181.22085972646747,1,171,60,1471,681,963,607,20
8,5,0,8.0,5.0,0.3323554992675781,172.02906731131225,1,163,55,1471,681,963,607,20
6,5,0,6.0,5.0,0.34073448181152344,164.76953601925328,1,157,50,1471,681,963,607,20
6,5,0,6.0,5.0,0.3491544723510742,157.56268593801008,1,151,45,1471,681,963,607,20
3,4,0,3.0,4.0,0.35644054412841797,153.57408635573907,1,148,41,1471,681,963,607,20
2,4,0,2.0,4.0,0.3644275665283203,150.6154042586614,1,146,37,1471,681,963,607,20
2,4,0,2.0,4.0,0.3726084232330322,147.73286702694156,1,144,33,1471,681,963,607,20
0,4,0,-0.0,4.0,0.38039541244506836,146.8911161370898,1,144,29,1471,681,963,607,20
1,4,0,1.0,4.0,0.38833141326904297,145.16886718577092,1,143,25,1471,681,963,607,20
1,4,0,1.0,4.0,0.39649343490600586,143.54441821262157,1,142,21,1471,681,963,607,20
1,4,0,1.0,4.0,0.4044835567474365,142.0211251891774,1,141,17,1471,681,963,607,20
2,4,0,2.0,4.0,0.4124484062194824,139.60659010233005,1,139,13,1471,681,963,607,20
2,4,0,2.0,4.0,0.42021656036376953,137.2953021774598,1,137,9,1471,681,963,607,20
3,4,0,3.0,4.0,0.4282665252685547,134.09325113517085,1,134,5,1471,681,963,607,20
3,4,0,3.0,4.0,0.4365065097808838,131.00381673829202,1,131,1,1471,681,963,607,20
3,4,0,3.0,4.0,0.4444553852081299,128.03515142334936,1,128,-3,1471,681,963,607,20
2,2,0,2.0,2.0,0.45245957374572754,126.09916732476864,1,126,-5,1471,681,963,607,20
1,2,0,1.0,2.0,0.46049952507019043,125.19584657647394,1,125,-7,1471,681,963,607,20
1,0,0,1.0,-0.0,0.46835756301879883,124.19742348374221,1,124,-7,1471,681,963,607,20
1,-1,0,1.0,-1.0,0.5162644386291504,123.14625451064275,1,123,-6,1471,681,963,607,20
2,-1,0,2.0,-1.0,0.5243244171142578,121.10326172320876,1,121,-5,1471,681,963,607,20
1,-1,0,1.0,-1.0,0.5323803424835205,120.06664815842908,1,120,-4,1471,681,963,607,20
3,-1,0,3.0,-1.0,0.5404994487762451,117.03845521878696,1,117,-3,1471,681,963,607,20
2,-2,0,2.0,-2.0,0.5484263896942139,115.00434774390054,1,115,-1,1471,681,963,607,20
2,-1,0,2.0,-1.0,0.5563194751739502,113.0,1,113,0,1471,681,963,607,20
3,-2,0,3.0,-2.0,0.564429521560669,110.01818031580054,1,110,2,1471,681,963,607,20
4,-1,0,4.0,-1.0,0.5724484920501709,106.04244433244644,1,106,3,1471,681,963,607,20
3,-2,0,3.0,-2.0,0.5805103778839111,103.12128781197411,1,103,5,1471,681,963,607,20
2,-1,0,2.0,-1.0,0.5884454250335693,101.17806086301516,1,101,6,1471,681,963,607,20
2,-1,0,2.0,-1.0,0.5963764190673828,99.24716620639605,1,99,7,1471,681,963,607,20
4,0,0,4.0,-0.0,0.604393482208252,95.25754563287887,1,95,7,1471,681,963,607,20
4,-1,0,4.0,-1.0,0.6124775409698486,91.35097153287424,1,91,8,1471,681,963,607,20
6,0,0,6.0,-0.0,0.6203763484954834,85.37564055396598,1,85,8,1471,681,963,607,20
7,0,0,7.0,-0.0,0.6283564567565918,78.40918313565064,1,78,8,1471,681,963,607,20
8,0,0,8.0,-0.0,0.6365435123443604,70.45565981523414,1,70,8,1471,681,963,607,20
7,0,0,7.0,-0.0,0.6445164680480957,63.50590523722971,1,63,8,1471,681,963,607,20
7,0,0,7.0,-0.0,0.652632474899292,56.568542494923804,1,56,8,1471,681,963,607,20
6,0,0,6.0,-0.0,0.66058349609375,50.635955604688654,1,50,8,1471,681,963,607,20
5,1,0,5.0,1.0,0.6684575080871582,45.5411901469428,1,45,7,1471,681,963,607,20
4,0,0,4.0,-0.0,0.6763863563537598,41.593268686170845,1,41,7,1471,681,963,607,20
4,0,0,4.0,-0.0,0.6844544410705566,37.656340767525464,1,37,7,1471,681,963,607,20
3,0,0,3.0,-0.0,0.6924073696136475,34.713109915419565,1,34,7,1471,681,963,607,20
2,0,0,2.0,-0.0,0.7003684043884277,32.7566787083184,1,32,7,1471,681,963,607,20
2,0,0,2.0,-0.0,0.7087504863739014,30.805843601498726,1,30,7,1471,681,963,607,20
1,0,0,1.0,-0.0,0.7165155410766602,29.832867780352597,1,29,7,1471,681,963,607,20
1,0,0,1.0,-0.0,0.7245264053344727,28.861739379323623,1,28,7,1471,681,963,607,20
1,0,0,1.0,-0.0,0.7324683666229248,27.892651361962706,1,27,7,1471,681,963,607,20
2,0,0,2.0,-0.0,0.7401833534240723,25.96150997149434,1,25,7,1471,681,963,607,20
1,0,0,1.0,-0.0,0.7483704090118408,25.0,1,24,7,1471,681,963,607,20
1,0,0,1.0,-0.0,0.7563424110412598,24.041630560342615,1,23,7,1471,681,963,607,20
2,0,0,2.0,-0.0,0.764350414276123,22.135943621178654,1,21,7,1471,681,963,607,20
3,0,0,3.0,-0.0,0.7724564075469971,19.313207915827967,1,18,7,1471,681,963,607,20
2,0,0,2.0,-0.0,0.7806143760681152,17.46424919657298,1,16,7,1471,681,963,607,20
3,0,0,3.0,-0.0,0.7885854244232178,14.7648230602334,1,13,7,1471,681,963,607,20
3,0,0,3.0,-0.0,0.796553373336792,12.206555615733702,1,10,7,1471,681,963,607,20
3,0,0,3.0,-0.0,0.8044173717498779,9.899494936611665,1,7,7,1471,681,963,607,20
2,1,0,2.0,1.0,0.8124334812164307,7.810249675906654,1,5,6,1471,681,963,607,20
2,0,0,2.0,-0.0,0.8204355239868164,6.708203932499369,1,3,6,1471,681,963,607,20
2,0,0,2.0,-0.0,0.8283443450927734,6.082762530298219,1,1,6,1471,681,963,607,20
2,0,0,2.0,-0.0,0.8365044593811035,6.082762530298219,1,-1,6,1471,681,963,607,20
1,0,0,1.0,-0.0,0.8444154262542725,6.324555320336759,1,-2,6,1471,681,963,607,20
3,1,0,3.0,1.0,0.8525614738464355,7.0710678118654755,1,-5,5,1471,681,963,607,20
1,0,0,1.0,-0.0,0.8605613708496094,7.810249675906654,1,-6,5,1471,681,963,607,20
1,0,0,1.0,-0.0,0.868558406829834,8.602325267042627,1,-7,5,1471,681,963,607,20
1,0,0,1.0,-0.0,0.8764054775238037,9.433981132056603,1,-8,5,1471,681,963,607,20
1,0,0,1.0,-0.0,0.8843765258789062,10.295630140987,1,-9,5,1471,681,963,607,20
0,0,1,-0.0,-0.0,-0.0008261203765869141,985.4998731608239,2,-913,-371,567,305,1480,676,38
0,1,1,-0.0,1.0,0.004746913909912109,985.8767671468884,2,-913,-372,567,305,1480,676,38
0,0,0,-0.0,-0.0,0.09095191955566406,985.8767671468884,2,-913,-372,567,305,1480,676,38
0,1,0,-0.0,1.0,0.12078499794006348,986.2545310415562,2,-913,-373,567,305,1480,676,38
-1,0,0,-1.0,-0.0,0.12865090370178223,985.3288791058546,2,-912,-373,567,305,1480,676,38
-1,0,0,-1.0,-0.0,0.14475798606872559,984.4033726069816,2,-911,-373,567,305,1480,676,38
0,1,0,-0.0,1.0,0.15271496772766113,984.7827171513521,2,-911,-374,567,305,1480,676,38
-1,0,0,-1.0,-0.0,0.16073203086853027,983.8577132898843,2,-910,-374,567,305,1480,676,38
-1,0,0,-1.0,-0.0,0.16872596740722656,982.9328563030132,2,-909,-374,567,305,1480,676,38
-2,0,0,-2.0,-0.0,0.1768200397491455,981.0835846144813,2,-907,-374,567,305,1480,676,38
-3,0,0,-3.0,-0.0,0.18464899063110352,978.3107890644976,2,-904,-374,567,305,1480,676,38
-4,-1,0,-4.0,-1.0,0.19270992279052734,974.2325184472134,2,-900,-373,567,305,1480,676,38
-8,-1,0,-8.0,-1.0,0.20070099830627441,966.4615874415289,2,-892,-372,567,305,1480,676,38
-11,-2,0,-11.0,-2.0,0.20866799354553223,955.5422544293895,2,-881,-370,567,305,1480,676,38
-12,-4,0,-12.0,-4.0,0.21668004989624023,942.930008006957,2,-869,-366,567,305,1480,676,38
-13,-3,0,-13.0,-3.0,0.22469687461853027,929.7876101562119,2,-856,-363,567,305,1480,676,38
-15,-5,0,-15.0,-5.0,0.23277688026428223,914.0268048585884,2,-841,-358,567,305,1480,676,38
-19,-8,0,-19.0,-8.0,0.24068093299865723,893.411439371581,2,-822,-350,567,305,1480,676,38
-25,-9,0,-25.0,-9.0,0.24865293502807617,866.8852288509707,2,-797,-341,567,305,1480,676,38
-36,-14,0,-36.0,-14.0,0.25676894187927246,828.2813531644908,2,-761,-327,567,305,1480,676,38
-45,-17,0,-45.0,-17.0,0.26472997665405273,780.228171754904,2,-716,-310,567,305,1480,676,38
-50,-19,0,-50.0,-19.0,0.27271389961242676,726.799146945014,2,-666,-291,567,305,1480,676,38
-50,-18,0,-50.0,-18.0,0.2807128429412842,673.7840900466558,2,-616,-273,567,305,1480,676,38
-50,-16,0,-50.0,-16.0,0.2887420654296875,621.6148325128672,2,-566,-257,567,305,1480,676,38
-47,-14,0,-47.0,-14.0,0.29674696922302246,573.0706762695156,2,-519,-243,567,305,1480,676,38
-39,-11,0,-39.0,-11.0,0.3047769069671631,533.1266266094764,2,-480,-232,567,305,1480,676,38
-31,-9,0,-31.0,-9.0,0.3126099109649658,501.32823578968697,2,-449,-223,567,305,1480,676,38
-24,-7,0,-24.0,-7.0,0.3206138610839844,476.7399710534035,2,-425,-216,567,305,1480,676,38
-19,-7,0,-19.0,-7.0,0.32869386672973633,456.6366170162003,2,-406,-209,567,305,1480,676,38
-13,-7,0,-13.0,-7.0,0.3365590572357178,441.87441654841257,2,-393,-202,567,305,1480,676,38
-9,-6,0,-9.0,-6.0,0.344541072845459,431.1287510709533,2,-384,-196,567,305,1480,676,38
-5,-4,0,-5.0,-4.0,0.3525679111480713,424.8588000736245,2,-379,-192,567,305,1480,676,38
-3,-3,0,-3.0,-3.0,0.36062002182006836,420.82894387149753,2,-376,-189,567,305,1480,676,38
-2,-3,0,-2.0,-3.0,0.368574857711792,417.6984558266885,2,-374,-186,567,305,1480,676,38
-2,-4,0,-2.0,-4.0,0.3765840530395508,414.13524361010377,2,-372,-182,567,305,1480,676,38
-1,-5,0,-1.0,-5.0,0.3845250606536865,411.0596063833079,2,-371,-177,567,305,1480,676,38
-2,-5,0,-2.0,-5.0,0.39255690574645996,407.1179190357506,2,-369,-172,567,305,1480,676,38
-2,-3,0,-2.0,-3.0,0.4005758762359619,404.04207701673846,2,-367,-169,567,305,1480,676,38
-2,-3,0,-2.0,-3.0,0.408642053604126,400.9750615686716,2,-365,-166,567,305,1480,676,38
-2,-4,0,-2.0,-4.0,0.4166290760040283,397.5084904753608,2,-363,-162,567,305,1480,676,38
-3,-4,0,-3.0,-4.0,0.4246039390563965,393.14628320766303,2,-360,-158,567,305,1480,676,38
-5,-6,0,-5.0,-6.0,0.4326629638671875,386.17224136387637,2,-355,-152,567,305,1480,676,38
-7,-6,0,-7.0,-6.0,0.44080185890197754,377.385744298854,2,-348,-146,567,305,1480,676,38
-7,-8,0,-7.0,-8.0,0.44858789443969727,367.8654645383282,2,-341,-138,567,305,1480,676,38
-8,-8,0,-8.0,-8.0,0.4566478729248047,357.4758733117523,2,-333,-130,567,305,1480,676,38
-7,-7,0,-7.0,-7.0,0.46476006507873535,348.4322028745334,2,-326,-123,567,305,1480,676,38
-6,-6,0,-6.0,-6.0,0.4726829528808594,340.71835876571134,2,-320,-117,567,305,1480,676,38
-6,-6,0,-6.0,-6.0,0.4806859493255615,333.0420393884232,2,-314,-111,567,305,1480,676,38
-4,-5,0,-4.0,-5.0,0.48874807357788086,327.621733100843,2,-310,-106,567,305,1480,676,38
-5,-6,0,-5.0,-6.0,0.49662184715270996,320.97507691408066,2,-305,-100,567,305,1480,676,38
-6,-6,0,-6.0,-6.0,0.5047149658203125,313.4278226322609,2,-299,-94,567,305,1480,676,38
-5,-6,0,-5.0,-6.0,0.5127148628234863,306.88760157425713,2,-294,-88,567,305,1480,676,38
-6,-5,0,-6.0,-5.0,0.5208120346069336,299.7215374309961,2,-288,-83,567,305,1480,676,38
-5,-5,0,-5.0,-5.0,0.5287208557128906,293.5523803344132,2,-283,-78,567,305,1480,676,38
-7,-5,0,-7.0,-5.0,0.5366079807281494,285.49080545614777,2,-276,-73,567,305,1480,676,38
-8,-5,0,-8.0,-5.0,0.5447268486022949,276.4923145405673,2,-268,-68,567,305,1480,676,38
-11,-6,0,-11.0,-6.0,0.5527338981628418,264.372842780797,2,-257,-62,567,305,1480,676,38
-13,-6,0,-13.0,-6.0,0.5607559680938721,250.3437636531016,2,-244,-56,567,305,1480,676,38
-13,-5,0,-13.0,-5.0,0.5686779022216797,236.56288804459587,2,-231,-51,567,305,1480,676,38
-11,-5,0,-11.0,-5.0,0.5767359733581543,224.75764725588314,2,-220,-46,567,305,1480,676,38
-12,-4,0,-12.0,-4.0,0.5847458839416504,212.19802072592478,2,-208,-42,567,305,1480,676,38
-12,-4,0,-12.0,-4.0,0.5926699638366699,199.64969321288726,2,-196,-38,567,305,1480,676,38
-12,-3,0,-12.0,-3.0,0.6007399559020996,187.29922583929704,2,-184,-35,567,305,1480,676,38
-12,-4,0,-12.0,-4.0,0.6086418628692627,174.77127910500627,2,-172,-31,567,305,1480,676,38
-10,-2,0,-10.0,-2.0,0.6167218685150146,164.57521077003062,2,-162,-29,567,305,1480,676,38
-10,-1,0,-10.0,-1.0,0.6246709823608398,154.55743269089325,2,-152,-28,567,305,1480,676,38
-9,-3,0,-9.0,-3.0,0.6326789855957031,145.16886718577092,2,-143,-25,567,305,1480,676,38
-6,-1,0,-6.0,-1.0,0.6405520439147949,139.08630414242805,2,-137,-24,567,305,1480,676,38
-4,-1,0,-4.0,-1.0,0.6485700607299805,134.97407158413796,2,-133,-23,567,305,1480,676,38
-4,-2,0,-4.0,-2.0,0.6566109657287598,130.6981254647518,2,-129,-21,567,305,1480,676,38
-3,-1,0,-3.0,-1.0,0.6648719310760498,127.57742747053649,2,-126,-20,567,305,1480,676,38
-4,-2,0,-4.0,-2.0,0.6727180480957031,123.32072007574396,2,-122,-18,567,305,1480,676,38
-4,-2,0,-4.0,-2.0,0.6807060241699219,119.07980517283357,2,-118,-16,567,305,1480,676,38
-3,-2,0,-3.0,-2.0,0.6887478828430176,115.84903970253703,2,-115,-14,567,305,1480,676,38
-5,-2,0,-5.0,-2.0,0.6966619491577148,110.65260954898443,2,-110,-12,567,305,1480,676,38
-4,-3,0,-4.0,-3.0,0.7047510147094727,106.38138934982942,2,-106,-9,567,305,1480,676,38
-5,-2,0,-5.0,-2.0,0.7126960754394531,101.24228365658294,2,-101,-7,567,305,1480,676,38
-6,-3,0,-6.0,-3.0,0.7206859588623047,95.08417323613851,2,-95,-4,567,305,1480,676,38
-5,-1,0,-5.0,-1.0,0.7286808490753174,90.0499861188218,2,-90,-3,567,305,1480,676,38
-4,-2,0,-4.0,-2.0,0.7366719245910645,86.00581375697809,2,-86,-1,567,305,1480,676,38
-5,-1,0,-5.0,-1.0,0.7446420192718506,81.0,2,-81,0,567,305,1480,676,38
-5,-1,0,-5.0,-1.0,0.7526450157165527,76.00657866263946,2,-76,1,567,305,1480,676,38
-4,-1,0,-4.0,-1.0,0.7606420516967773,72.02777242147643,2,-72,2,567,305,1480,676,38
-4,-1,0,-4.0,-1.0,0.7686610221862793,68.06614430096654,2,-68,3,567,305,1480,676,38
-4,-1,0,-4.0,-1.0,0.7768368721008301,64.1248781675256,2,-64,4,567,305,1480,676,38
-3,0,0,-3.0,-0.0,0.7847189903259277,61.1310068623117,2,-61,4,567,305,1480,676,38
-5,0,0,-5.0,-0.0,0.7927348613739014,56.142675390472796,2,-56,4,567,305,1480,676,38
-6,0,0,-6.0,-0.0,0.8007409572601318,50.15974481593781,2,-50,4,567,305,1480,676,38
-5,0,0,-5.0,-0.0,0.8086850643157959,45.17742799230607,2,-45,4,567,305,1480,676,38
-6,0,0,-6.0,-0.0,0.8167600631713867,39.20459156782532,2,-39,4,567,305,1480,676,38
-5,0,0,-5.0,-0.0,0.8246638774871826,34.23448553724738,2,-34,4,567,305,1480,676,38
-5,1,0,-5.0,1.0,0.8327338695526123,29.154759474226502,2,-29,3,567,305,1480,676,38
-3,0,0,-3.0,-0.0,0.8405749797821045,26.1725046566048,2,-26,3,567,305,1480,676,38
-3,1,0,-3.0,1.0,0.848844051361084,23.08679276123039,2,-23,2,567,305,1480,676,38
-4,1,0,-4.0,1.0,0.8566620349884033,19.026297590440446,2,-19,1,567,305,1480,676,38
-2,0,0,-2.0,-0.0,0.8646819591522217,17.029386365926403,2,-17,1,567,305,1480,676,38
-1,1,0,-1.0,1.0,0.8726909160614014,16.0,2,-16,0,567,305,1480,676,38
-1,0,0,-1.0,-0.0,0.8807320594787598,15.0,2,-15,0,567,305,1480,676,38
-1,0,0,-1.0,-0.0,0.8888869285583496,14.0,2,-14,0,567,305,1480,676,38
0,0,1,-0.0,-0.0,0.9056448936462402,14.0,2,-14,0,567,305,1480,676,38
0,0,0,-0.0,-0.0,0.08393144607543945,430.5542939049615,3,416,111,997,416,581,305,24
0,1,0,-0.0,1.0,0.15016531944274902,430.2975714549177,3,416,110,997,416,581,305,24
1,2,0,1.0,2.0,0.15816831588745117,428.8228072292797,3,415,108,997,416,581,305,24
1,2,0,1.0,2.0,0.16607046127319336,427.35465365431554,3,414,106,997,416,581,305,24
2,3,0,2.0,3.0,0.1741952896118164,424.679879438619,3,412,103,997,416,581,305,24
3,3,0,3.0,3.0,0.18204331398010254,421.04750325824284,3,409,100,997,416,581,305,24
5,3,0,5.0,3.0,0.19009828567504883,415.4816482108446,3,404,97,997,416,581,305,24
6,5,0,6.0,5.0,0.19815635681152344,408.4947980084936,3,398,92,997,416,581,305,24
11,5,0,11.0,5.0,0.20609450340270996,396.65854333418815,3,387,87,997,416,581,305,24
15,5,0,15.0,5.0,0.21407437324523926,380.93043984433695,3,372,82,997,416,581,305,24
20,7,0,20.0,7.0,0.2221083641052246,359.9013753794225,3,352,75,997,416,581,305,24
21,6,0,21.0,6.0,0.23007631301879883,338.11536492741646,3,331,69,997,416,581,305,24
21,6,0,21.0,6.0,0.2380683422088623,316.33684578309874,3,310,63,997,416,581,305,24
20,5,0,20.0,5.0,0.24603939056396484,295.7431317883815,3,290,58,997,416,581,305,24
18,4,0,18.0,4.0,0.2540614604949951,277.308492477241,3,272,54,997,416,581,305,24
17,5,0,17.0,5.0,0.262073278427124,259.66516901579234,3,255,49,997,416,581,305,24
15,3,0,15.0,3.0,0.26998138427734375,244.36857408431223,3,240,46,997,416,581,305,24
12,4,0,12.0,4.0,0.2780263423919678,231.8361490363399,3,228,42,997,416,581,305,24
12,3,0,12.0,3.0,0.285994291305542,219.49259668608414,3,216,39,997,416,581,305,24
12,3,0,12.0,3.0,0.29395031929016113,207.15211801958483,3,204,36,997,416,581,305,24
15,4,0,15.0,4.0,0.3020603656768799,191.68985366993215,3,189,32,997,416,581,305,24
16,3,0,16.0,3.0,0.31003332138061523,175.41379649275024,3,173,29,997,416,581,305,24
17,4,0,17.0,4.0,0.31807637214660645,157.99050604387594,3,156,25,997,416,581,305,24
18,2,0,18.0,2.0,0.3261744976043701,139.90353819685905,3,138,23,997,416,581,305,24
16,4,0,16.0,4.0,0.3341033458709717,123.47064428438041,3,122,19,997,416,581,305,24
14,3,0,14.0,3.0,0.3421053886413574,109.17875251164945,3,108,16,997,416,581,305,24
15,3,0,15.0,3.0,0.35008740425109863,93.90420650854784,3,93,13,997,416,581,305,24
14,2,0,14.0,2.0,0.35808634757995605,79.76214641043707,3,79,11,997,416,581,305,24
13,2,0,13.0,2.0,0.3660924434661865,66.61080993352356,3,66,9,997,416,581,305,24
9,2,0,9.0,2.0,0.3742713928222656,57.42821606144492,3,57,7,997,416,581,305,24
8,2,0,8.0,2.0,0.3820784091949463,49.25444142409901,3,49,5,997,416,581,305,24
5,1,0,5.0,1.0,0.39008450508117676,44.181444068749045,3,44,4,997,416,581,305,24
4,2,0,4.0,2.0,0.39806151390075684,40.049968789001575,3,40,2,997,416,581,305,24
2,0,0,2.0,-0.0,0.4060323238372803,38.05259518088089,3,38,2,997,416,581,305,24
1,1,0,1.0,1.0,0.4141254425048828,37.013511046643494,3,37,1,997,416,581,305,24
1,0,0,1.0,-0.0,0.49408936500549316,36.013886210738214,3,36,1,997,416,581,305,24
0,-1,0,-0.0,-1.0,0.518160343170166,36.05551275463989,3,36,2,997,416,581,305,24
1,0,0,1.0,-0.0,0.5500283241271973,35.05709628591621,3,35,2,997,416,581,305,24
1,0,0,1.0,-0.0,0.5661654472351074,34.058772731852805,3,34,2,997,416,581,305,24
1,0,0,1.0,-0.0,0.5820474624633789,33.06055050963308,3,33,2,997,416,581,305,24
1,0,0,1.0,-0.0,0.5900974273681641,32.0624390837628,3,32,2,997,416,581,305,24
2,0,0,2.0,-0.0,0.5980794429779053,30.066592756745816,3,30,2,997,416,581,305,24
2,0,0,2.0,-0.0,0.606189489364624,28.071337695236398,3,28,2,997,416,581,305,24
3,0,0,3.0,-0.0,0.6141033172607422,25.079872407968907,3,25,2,997,416,581,305,24
3,0,0,3.0,-0.0,0.622077465057373,22.090722034374522,3,22,2,997,416,581,305,24
4,0,0,4.0,-0.0,0.6299474239349365,18.110770276274835,3,18,2,997,416,581,305,24
4,0,0,4.0,-0.0,0.6381983757019043,14.142135623730951,3,14,2,997,416,581,305,24
3,0,0,3.0,-0.0,0.6461403369903564,11.180339887498949,3,11,2,997,416,581,305,24
4,0,0,4.0,-0.0,0.6540954113006592,7.280109889280518,3,7,2,997,416,581,305,24
2,0,0,2.0,-0.0,0.6620433330535889,5.385164807134504,3,5,2,997,416,581,305,24
4,0,0,4.0,-0.0,0.6701564788818359,2.23606797749979,3,1,2,997,416,581,305,24
3,0,0,3.0,-0.0,0.6781854629516602,2.8284271247461903,3,-2,2,997,416,581,305,24
3,0,0,3.0,-0.0,0.686063289642334,5.385164807134504,3,-5,2,997,416,581,305,24
1,0,0,1.0,-0.0,0.6940293312072754,6.324555320336759,3,-6,2,997,416,581,305,24
1,0,0,1.0,-0.0,0.710118293762207,7.280109889280518,3,-7,2,997,416,581,305,24
0,0,1,-0.0,-0.0,0.7169954776763916,7.280109889280518,3,-7,2,997,416,581,305,24
0,0,0,-0.0,-0.0,0.0962820053100586,756.6372975210778,4,-660,370,344,784,1004,414,43
0,1,0,-0.0,1.0,0.09937310218811035,756.1487948810076,4,-660,369,344,784,1004,414,43
-1,1,0,-1.0,1.0,0.12335801124572754,754.7880497199197,4,-659,368,344,784,1004,414,43
0,1,0,-0.0,1.0,0.19535207748413086,754.3010009273486,4,-659,367,344,784,1004,414,43
-2,2,0,-2.0,2.0,0.20335006713867188,751.581000292051,4,-657,365,344,784,1004,414,43
-3,5,0,-3.0,5.0,0.21134400367736816,746.5360004715111,4,-654,360,344,784,1004,414,43
-4,5,0,-4.0,5.0,0.21934223175048828,740.6247362868729,4,-650,355,344,784,1004,414,43
-6,7,0,-6.0,7.0,0.22727704048156738,732.0109288801636,4,-644,348,344,784,1004,414,43
-8,7,0,-8.0,7.0,0.23534107208251953,721.648806553437,4,-636,341,344,784,1004,414,43
-8,7,0,-8.0,7.0,0.24331021308898926,711.2945943840709,4,-628,334,344,784,1004,414,43
-8,10,0,-8.0,10.0,0.2514021396636963,699.5541437229859,4,-620,324,344,784,1004,414,43
-10,10,0,-10.0,10.0,0.259350061416626,686.0728824257668,4,-610,314,344,784,1004,414,43
-9,11,0,-9.0,11.0,0.2674062252044678,673.0601756158211,4,-601,303,344,784,1004,414,43
-11,13,0,-11.0,13.0,0.2754960060119629,657.4191965557441,4,-590,290,344,784,1004,414,43
-13,14,0,-13.0,14.0,0.2833850383758545,639.6131643423234,4,-577,276,344,784,1004,414,43
-14,18,0,-14.0,18.0,0.29144716262817383,619.3004117550706,4,-563,258,344,784,1004,414,43
-16,18,0,-16.0,18.0,0.29937100410461426,597.3349144324313,4,-547,240,344,784,1004,414,43
-21,19,0,-21.0,19.0,0.30737900733947754,570.5409713596387,4,-526,221,344,784,1004,414,43
-22,17,0,-22.0,17.0,0.31557703018188477,543.7205164420412,4,-504,204,344,784,1004,414,43
-23,16,0,-23.0,16.0,0.3233931064605713,516.4348942509598,4,-481,188,344,784,1004,414,43
-21,14,0,-21.0,14.0,0.33144211769104004,491.8089059787348,4,-460,174,344,784,1004,414,43
-20,13,0,-20.0,13.0,0.33937501907348633,468.53068202626815,4,-440,161,344,784,1004,414,43
-19,11,0,-19.0,11.0,0.37042713165283203,446.92393088757285,4,-421,150,344,784,1004,414,43
-18,10,0,-18.0,10.0,0.37075304985046387,426.62512818632706,4,-403,140,344,784,1004,414,43
-13,9,0,-13.0,9.0,0.37086915969848633,411.41341737964746,4,-390,131,344,784,1004,414,43
-13,8,0,-13.0,8.0,0.37137818336486816,396.5576881110742,4,-377,123,344,784,1004,414,43
-12,7,0,-12.0,7.0,0.379439115524292,382.9895559933717,4,-365,116,344,784,1004,414,43
-9,6,0,-9.0,6.0,0.38733506202697754,372.6070316030013,4,-356,110,344,784,1004,414,43
-10,6,0,-10.0,6.0,0.3954281806945801,361.292125571538,4,-346,104,344,784,1004,414,43
-11,7,0,-11.0,7.0,0.40338921546936035,348.7606629194296,4,-335,97,344,784,1004,414,43
-9,5,0,-9.0,5.0,0.41134023666381836,338.73293314940605,4,-326,92,344,784,1004,414,43
-6,4,0,-6.0,4.0,0.419389009475708,331.87949620306466,4,-320,88,344,784,1004,414,43
-7,5,0,-7.0,5.0,0.4272952079772949,323.81785003300854,4,-313,83,344,784,1004,414,43
-8,5,0,-8.0,5.0,0.43535518646240234,314.8158191705112,4,-305,78,344,784,1004,414,43
-8,4,0,-8.0,4.0,0.4433140754699707,306.08005488760614,4,-297,74,344,784,1004,414,43
-9,3,0,-9.0,3.0,0.4513680934906006,296.6226559115133,4,-288,71,344,784,1004,414,43
-9,3,0,-9.0,3.0,0.45931315422058105,287.1671986839723,4,-279,68,344,784,1004,414,43
-9,3,0,-9.0,3.0,0.467318058013916,277.71388153997634,4,-270,65,344,784,1004,414,43
-11,3,0,-11.0,3.0,0.4753410816192627,266.3174797117155,4,-259,62,344,784,1004,414,43
-13,3,0,-13.0,3.0,0.48345208168029785,252.97628347337226,4,-246,59,344,784,1004,414,43
-11,2,0,-11.0,2.0,0.4913051128387451,241.81397809059757,4,-235,57,344,784,1004,414,43
-9,2,0,-9.0,2.0,0.4994192123413086,232.59621665022843,4,-226,55,344,784,1004,414,43
-8,2,0,-8.0,2.0,0.5074231624603271,224.35017272112808,4,-218,53,344,784,1004,414,43
-9,2,0,-9.0,2.0,0.5153770446777344,215.13251730038394,4,-209,51,344,784,1004,414,43
-9,2,0,-9.0,2.0,0.523341178894043,205.91503102007877,4,-200,49,344,784,1004,414,43
-9,2,0,-9.0,2.0,0.5313551425933838,196.69773765857096,4,-191,47,344,784,1004,414,43
-8,2,0,-8.0,2.0,0.5393772125244141,188.45158529447292,4,-183,45,344,784,1004,414,43
-7,2,0,-7.0,2.0,0.5473291873931885,181.1767093199344,4,-176,43,344,784,1004,414,43
-6,3,0,-6.0,3.0,0.5553381443023682,174.64249196572982,4,-170,40,344,784,1004,414,43
-5,2,0,-5.0,2.0,0.563345193862915,169.31922513406445,4,-165,38,344,784,1004,414,43
-6,3,0,-6.0,3.0,0.5713741779327393,162.8066337714775,4,-159,35,344,784,1004,414,43
-7,3,0,-7.0,3.0,0.5793631076812744,155.3319027115808,4,-152,32,344,784,1004,414,43
-5,3,0,-5.0,3.0,0.587360143661499,149.83324063771698,4,-147,29,344,784,1004,414,43
-6,3,0,-6.0,3.0,0.5954411029815674,143.37712509323097,4,-141,26,344,784,1004,414,43
-5,3,0,-5.0,3.0,0.603391170501709,137.93114224133723,4,-136,23,344,784,1004,414,43
-6,2,0,-6.0,2.0,0.6113581657409668,131.68523075880606,4,-130,21,344,784,1004,414,43
-5,3,0,-5.0,3.0,0.619448184967041,126.28935030318273,4,-125,18,344,784,1004,414,43
-8,3,0,-8.0,3.0,0.6272871494293213,117.957619508025,4,-117,15,344,784,1004,414,43
-7,4,0,-7.0,4.0,0.6353862285614014,110.54863183232979,4,-110,11,344,784,1004,414,43
-5,2,0,-5.0,2.0,0.6433942317962646,105.38500842150178,4,-105,9,344,784,1004,414,43
-4,2,0,-4.0,2.0,0.6513230800628662,101.24228365658294,4,-101,7,344,784,1004,414,43
-6,3,0,-6.0,3.0,0.6593601703643799,95.08417323613851,4,-95,4,344,784,1004,414,43
-6,1,0,-6.0,1.0,0.667356014251709,89.05054744357274,4,-89,3,344,784,1004,414,43
-5,2,0,-5.0,2.0,0.6753590106964111,84.00595217006948,4,-84,1,344,784,1004,414,43
-6,1,0,-6.0,1.0,0.6833992004394531,78.0,4,-78,0,344,784,1004,414,43
-6,2,0,-6.0,2.0,0.6912841796875,72.02777242147643,4,-72,-2,344,784,1004,414,43
-5,1,0,-5.0,1.0,0.6994030475616455,67.06713054842886,4,-67,-3,344,784,1004,414,43
-5,0,0,-5.0,-0.0,0.7072751522064209,62.07253821135398,4,-62,-3,344,784,1004,414,43
-4,2,0,-4.0,2.0,0.7153501510620117,58.215118311311535,4,-58,-5,344,784,1004,414,43
-4,0,0,-4.0,-0.0,0.7232890129089355,54.230987451824994,4,-54,-5,344,784,1004,414,43
-3,1,0,-3.0,1.0,0.7312300205230713,51.35172830587107,4,-51,-6,344,784,1004,414,43
-4,0,0,-4.0,-0.0,0.7392511367797852,47.38143096192854,4,-47,-6,344,784,1004,414,43
-3,0,0,-3.0,-0.0,0.7472941875457764,44.40720662234904,4,-44,-6,344,784,1004,414,43
-2,0,0,-2.0,-0.0,0.7553892135620117,42.42640687119285,4,-42,-6,344,784,1004,414,43
-3,0,0,-3.0,-0.0,0.7633821964263916,39.45883931389772,4,-39,-6,344,784,1004,414,43
-2,0,0,-2.0,-0.0,0.7712302207946777,37.48332962798263,4,-37,-6,344,784,1004,414,43
-2,0,0,-2.0,-0.0,0.7793030738830566,35.510561809129406,4,-35,-6,344,784,1004,414,43
-1,0,0,-1.0,-0.0,0.7873270511627197,34.52535300326414,4,-34,-6,344,784,1004,414,43
-1,0,0,-1.0,-0.0,0.7953622341156006,33.54101966249684,4,-33,-6,344,784,1004,414,43
-1,0,0,-1.0,-0.0,0.8194332122802734,32.55764119219941,4,-32,-6,344,784,1004,414,43
-1,0,0,-1.0,-0.0,0.827362060546875,31.575306807693888,4,-31,-6,344,784,1004,414,43
0,0,1,-0.0,-0.0,0.8323352336883545,31.575306807693888,4,-31,-6,344,784,1004,414,43
-1,0,1,-1.0,-0.0,0.01810908317565918,474.97789422245745,5,450,152,824,942,375,790,44
0,0,0,-0.0,-0.0,0.07887887954711914,474.97789422245745,5,450,152,824,942,375,790,44
2,0,0,2.0,-0.0,0.13008403778076172,473.0835021431206,5,448,152,824,942,375,790,44
3,-1,0,3.0,-1.0,0.1380000114440918,470.567742200844,5,445,153,824,942,375,790,44
4,-2,0,4.0,-2.0,0.14600086212158203,467.4462535949989,5,441,155,824,942,375,790,44
5,-2,0,5.0,-2.0,0.1539309024810791,463.4058696218683,5,436,157,824,942,375,790,44
5,-3,0,5.0,-3.0,0.16210389137268066,459.7401439944091,5,431,160,824,942,375,790,44
7,-2,0,7.0,-2.0,0.16991305351257324,453.894260814124,5,424,162,824,942,375,790,44
9,-3,0,9.0,-3.0,0.17795205116271973,446.59825346725216,5,415,165,824,942,375,790,44
11,-2,0,11.0,-2.0,0.18599987030029297,437.1555787131167,5,404,167,824,942,375,790,44
16,-1,0,16.0,-1.0,0.1939408779144287,422.80964984257395,5,388,168,824,942,375,790,44
19,0,0,19.0,-0.0,0.20201492309570312,405.4442008464297,5,369,168,824,942,375,790,44
19,0,0,19.0,-0.0,0.21003007888793945,388.23188946813735,5,350,168,824,942,375,790,44
18,1,0,18.0,1.0,0.21793007850646973,371.63557418524937,5,332,167,824,942,375,790,44
16,2,0,16.0,2.0,0.2259540557861328,356.4842212496929,5,316,165,824,942,375,790,44
15,2,0,15.0,2.0,0.23432087898254395,342.3010371003862,5,301,163,824,942,375,790,44
14,2,0,14.0,2.0,0.24207592010498047,329.07445965920846,5,287,161,824,942,375,790,44
13,2,0,13.0,2.0,0.25,316.7917296900284,5,274,159,824,942,375,790,44
14,3,0,14.0,3.0,0.2580909729003906,303.2094985319556,5,260,156,824,942,375,790,44
12,4,0,12.0,4.0,0.26593995094299316,290.8745434031655,5,248,152,824,942,375,790,44
12,4,0,12.0,4.0,0.2739379405975342,278.5677655436824,5,236,148,824,942,375,790,44
12,4,0,12.0,4.0,0.28203487396240234,266.2930716334918,5,224,144,824,942,375,790,44
11,4,0,11.0,4.0,0.29005885124206543,254.89017242726328,5,213,140,824,942,375,790,44
10,4,0,10.0,4.0,0.29796695709228516,244.3460660620506,5,203,136,824,942,375,790,44
8,4,0,8.0,4.0,0.30597805976867676,235.47611343828487,5,195,132,824,942,375,790,44
6,3,0,6.0,3.0,0.3139810562133789,228.82744590629858,5,189,129,824,942,375,790,44
5,3,0,5.0,3.0,0.32207489013671875,223.00672635595546,5,184,126,824,942,375,790,44
6,4,0,6.0,4.0,0.3299729824066162,215.79620015190258,5,178,122,824,942,375,790,44
6,4,0,6.0,4.0,0.33811402320861816,208.58571379651102,5,172,118,824,942,375,790,44
6,4,0,6.0,4.0,0.34598207473754883,201.37527157027003,5,166,114,824,942,375,790,44
7,4,0,7.0,4.0,0.3539419174194336,193.3416664870767,5,159,110,824,942,375,790,44
11,9,0,11.0,9.0,0.3620738983154297,179.17868176767013,5,148,101,824,942,375,790,44
11,7,0,11.0,7.0,0.3701629638671875,166.14752480852673,5,137,94,824,942,375,790,44
9,7,0,9.0,7.0,0.37828898429870605,154.76756766196203,5,128,87,824,942,375,790,44
6,4,0,6.0,4.0,0.3859078884124756,147.5567687366459,5,122,83,824,942,375,790,44
4,3,0,4.0,3.0,0.3939690589904785,142.56226709757388,5,118,80,824,942,375,790,44
3,2,0,3.0,2.0,0.40186190605163574,138.95682782792647,5,115,78,824,942,375,790,44
4,1,0,4.0,1.0,0.4099600315093994,135.09256086106296,5,111,77,824,942,375,790,44
1,2,0,1.0,2.0,0.4179809093475342,133.13526955694348,5,110,75,824,942,375,790,44
1,1,0,1.0,1.0,0.4260110855102539,131.7459676802292,5,109,74,824,942,375,790,44
1,0,0,1.0,-0.0,0.4580209255218506,130.91982279242512,5,108,74,824,942,375,790,44
1,0,0,1.0,-0.0,0.4659700393676758,130.09611831257686,5,107,74,824,942,375,790,44
1,2,0,1.0,2.0,0.4739699363708496,128.14054783713078,5,106,72,824,942,375,790,44
1,1,0,1.0,1.0,0.4819059371948242,126.75172582651489,5,105,71,824,942,375,790,44
3,0,0,3.0,-0.0,0.4898998737335205,124.27791436936813,5,102,71,824,942,375,790,44
1,1,0,1.0,1.0,0.4980309009552002,122.88612614937456,5,101,70,824,942,375,790,44
2,1,0,2.0,1.0,0.5059249401092529,120.6731121667126,5,99,69,824,942,375,790,44
2,2,0,2.0,2.0,0.5139520168304443,117.88977903109328,5,97,67,824,942,375,790,44
3,0,0,3.0,-0.0,0.5219788551330566,115.43396380615195,5,94,67,824,942,375,790,44
2,2,0,2.0,2.0,0.5299489498138428,112.6454615153225,5,92,65,824,942,375,790,44
2,1,0,2.0,1.0,0.5379350185394287,110.43550153822818,5,90,64,824,942,375,790,44
3,1,0,3.0,1.0,0.5459089279174805,107.41508273980894,5,87,63,824,942,375,790,44
2,2,0,2.0,2.0,0.5538439750671387,104.62313319720452,5,85,61,824,942,375,790,44
2,1,0,2.0,1.0,0.5618460178375244,102.41581909060729,5,83,60,824,942,375,790,44
2,2,0,2.0,2.0,0.5699269771575928,99.62429422585637,5,81,58,824,942,375,790,44
3,1,0,3.0,1.0,0.5779240131378174,96.60745312862771,5,78,57,824,942,375,790,44
4,2,0,4.0,2.0,0.5858979225158691,92.20086767487604,5,74,55,824,942,375,790,44
3,1,0,3.0,1.0,0.5939459800720215,89.20201791439474,5,71,54,824,942,375,790,44
4,1,0,4.0,1.0,0.601938009262085,85.42833253669417,5,67,53,824,942,375,790,44
3,2,0,3.0,2.0,0.609889030456543,81.83520025025906,5,64,51,824,942,375,790,44
5,2,0,5.0,2.0,0.6178810596466064,76.69419795525604,5,59,49,824,942,375,790,44
4,1,0,4.0,1.0,0.6258468627929688,73.0,5,55,48,824,942,375,790,44
5,2,0,5.0,2.0,0.6339020729064941,67.94115100585212,5,50,46,824,942,375,790,44
3,1,0,3.0,1.0,0.6418418884277344,65.06919393998976,5,47,45,824,942,375,790,44
3,1,0,3.0,1.0,0.6499860286712646,62.22539674441618,5,44,44,824,942,375,790,44
3,1,0,3.0,1.0,0.6578428745269775,59.413803110051795,5,41,43,824,942,375,790,44
2,1,0,2.0,1.0,0.6660048961639404,57.3149195236284,5,39,42,824,942,375,790,44
2,1,0,2.0,1.0,0.6739258766174316,55.226805085936306,5,37,41,824,942,375,790,44
2,1,0,2.0,1.0,0.6818509101867676,53.150729063673246,5,35,40,824,942,375,790,44
2,1,0,2.0,1.0,0.6899409294128418,51.088159097779204,5,33,39,824,942,375,790,44
2,1,0,2.0,1.0,0.6978628635406494,49.040799340956916,5,31,38,824,942,375,790,44
2,0,0,2.0,-0.0,0.7058398723602295,47.80167361086848,5,29,38,824,942,375,790,44
1,1,0,1.0,1.0,0.7139019966125488,46.400431032480725,5,28,37,824,942,375,790,44
2,1,0,2.0,1.0,0.7218830585479736,44.40720662234904,5,26,36,824,942,375,790,44
1,0,0,1.0,-0.0,0.730057954788208,43.829214001622255,5,25,36,824,942,375,790,44
2,1,0,2.0,1.0,0.7380740642547607,41.88078318274385,5,23,35,824,942,375,790,44
1,1,0,1.0,1.0,0.7459828853607178,40.496913462633174,5,22,34,824,942,375,790,44
2,0,0,2.0,-0.0,0.7539958953857422,39.44616584663204,5,20,34,824,942,375,790,44
1,0,0,1.0,-0.0,0.762078046798706,38.948684188300895,5,19,34,824,942,375,790,44
1,1,0,1.0,1.0,0.7780730724334717,37.589892258425,5,18,33,824,942,375,790,44
1,1,0,1.0,1.0,0.7940099239349365,36.235341863986875,5,17,32,824,942,375,790,44
0,0,1,-0.0,-0.0,0.8148250579833984,36.235341863986875,5,17,32,824,942,375,790,44
1,0,1,1.0,-0.0,0.8191790580749512,35.77708763999664,5,16,32,824,942,375,790,44
0,0,0,-0.0,-0.0,0.09536170959472656,1091.1484775226513,6,862,-669,1670,241,808,910,3
2,0,0,2.0,-0.0,0.21752285957336426,1089.5691809150992,6,860,-669,1670,241,808,910,3
2,0,0,2.0,-0.0,0.22554683685302734,1087.9912683473153,6,858,-669,1670,241,808,910,3
5,-1,0,5.0,-1.0,0.23352766036987305,1083.43573874965,6,853,-668,1670,241,808,910,3
5,-1,0,5.0,-1.0,0.24137473106384277,1078.8850726560268,6,848,-667,1670,241,808,910,3
8,-3,0,8.0,-3.0,0.249525785446167,1070.745534662648,6,840,-664,1670,241,808,910,3
9,-3,0,9.0,-3.0,0.2574188709259033,1061.8295531769681,6,831,-661,1670,241,808,910,3
15,-3,0,15.0,-3.0,0.2655618190765381,1048.2461542977394,6,816,-658,1670,241,808,910,3
18,-5,0,18.0,-5.0,0.27350664138793945,1031.1222042027803,6,798,-653,1670,241,808,910,3
23,-6,0,23.0,-6.0,0.2814936637878418,1009.5711961025829,6,775,-647,1670,241,808,910,3
26,-8,0,26.0,-8.0,0.2895176410675049,984.5415176619014,6,749,-639,1670,241,808,910,3
27,-12,0,27.0,-12.0,0.2974526882171631,956.2494444442831,6,722,-627,1670,241,808,910,3
34,-18,0,34.0,-18.0,0.3055098056793213,918.8171744150193,6,688,-609,1670,241,808,910,3
41,-24,0,41.0,-24.0,0.31350064277648926,872.257989358653,6,647,-585,1670,241,808,910,3
37,-25,0,37.0,-25.0,0.32142066955566406,828.0700453464067,6,610,-560,1670,241,808,910,3
38,-28,0,38.0,-28.0,0.3295106887817383,781.1581145965265,6,572,-532,1670,241,808,910,3
35,-29,0,35.0,-29.0,0.33734869956970215,735.7839356767719,6,537,-503,1670,241,808,910,3
35,-28,0,35.0,-28.0,0.3454737663269043,691.1070828750057,6,502,-475,1670,241,808,910,3
35,-26,0,35.0,-26.0,0.35340285301208496,647.8348554994552,6,467,-449,1670,241,808,910,3
33,-25,0,33.0,-25.0,0.361419677734375,606.7388235476612,6,434,-424,1670,241,808,910,3
30,-24,0,30.0,-24.0,0.3694138526916504,568.5208879188169,6,404,-400,1670,241,808,910,3
28,-24,0,28.0,-24.0,0.3774068355560303,531.7442994522837,6,376,-376,1670,241,808,910,3
25,-25,0,25.0,-25.0,0.38535165786743164,496.38896039295633,6,351,-351,1670,241,808,910,3
23,-23,0,23.0,-23.0,0.393352746963501,463.86204845837517,6,328,-328,1670,241,808,910,3
18,-21,0,18.0,-21.0,0.40154266357421875,436.2900411423575,6,310,-307,1670,241,808,910,3
18,-21,0,18.0,-21.0,0.4093437194824219,408.72973955903916,6,292,-286,1670,241,808,910,3
16,-19,0,16.0,-19.0,0.4173886775970459,384.0117185711915,6,276,-267,1670,241,808,910,3
17,-18,0,17.0,-18.0,0.4254448413848877,359.2798352259698,6,259,-249,1670,241,808,910,3
16,-16,0,16.0,-16.0,0.4333326816558838,336.6570955735227,6,243,-233,1670,241,808,910,3
17,-14,0,17.0,-14.0,0.44132280349731445,314.701445818096,6,226,-219,1670,241,808,910,3
16,-12,0,16.0,-12.0,0.44941067695617676,294.8711583047755,6,210,-207,1670,241,808,910,3
17,-11,0,17.0,-11.0,0.45734572410583496,275.0727176584403,6,193,-196,1670,241,808,910,3
16,-10,0,16.0,-10.0,0.46532464027404785,256.7586415293554,6,177,-186,1670,241,808,910,3
14,-10,0,14.0,-10.0,0.47336769104003906,239.88538930080756,6,163,-176,1670,241,808,910,3
16,-9,0,16.0,-9.0,0.4813258647918701,222.48145990171855,6,147,-167,1670,241,808,910,3
15,-9,0,15.0,-9.0,0.48941683769226074,205.8834621818858,6,132,-158,1670,241,808,910,3
13,-9,0,13.0,-9.0,0.49732184410095215,190.68822721919673,6,119,-149,1670,241,808,910,3
13,-9,0,13.0,-9.0,0.505314826965332,175.60182231400674,6,106,-140,1670,241,808,910,3
13,-8,0,13.0,-8.0,0.5133428573608398,161.47135968957468,6,93,-132,1670,241,808,910,3
13,-8,0,13.0,-8.0,0.5213286876678467,147.56693396557372,6,80,-124,1670,241,808,910,3
12,-6,0,12.0,-6.0,0.5293307304382324,136.19104228986575,6,68,-118,1670,241,808,910,3
11,-6,0,11.0,-6.0,0.5373766422271729,125.67020331009256,6,57,-112,1670,241,808,910,3
8,-5,0,8.0,-5.0,0.5454027652740479,117.6860229593982,6,49,-107,1670,241,808,910,3
6,-4,0,6.0,-4.0,0.5533707141876221,111.61541112229978,6,43,-103,1670,241,808,910,3
4,-4,0,4.0,-4.0,0.5615746974945068,106.4048871058092,6,39,-99,1670,241,808,910,3
2,-2,0,2.0,-2.0,0.5695116519927979,103.81714694596457,6,37,-97,1670,241,808,910,3
2,-2,0,2.0,-2.0,0.577434778213501,101.24228365658294,6,35,-95,1670,241,808,910,3
1,-2,0,1.0,-2.0,0.5854146480560303,99.02019995940222,6,34,-93,1670,241,808,910,3
1,-1,0,1.0,-1.0,0.5933268070220947,97.73944955850733,6,33,-92,1670,241,808,910,3
1,-1,0,1.0,-1.0,0.6013967990875244,96.46242791885346,6,32,-91,1670,241,808,910,3
1,-1,0,1.0,-1.0,0.6093747615814209,95.1892851112981,6,31,-90,1670,241,808,910,3
1,-1,0,1.0,-1.0,0.6174867153167725,93.92017887546851,6,30,-89,1670,241,808,910,3
0,-1,0,-0.0,-1.0,0.625396728515625,92.97311439335567,6,30,-88,1670,241,808,910,3
1,0,0,1.0,-0.0,0.6333918571472168,92.65527507918802,6,29,-88,1670,241,808,910,3
1,-1,0,1.0,-1.0,0.6413757801055908,91.39474820797966,6,28,-87,1670,241,808,910,3
1,-1,0,1.0,-1.0,0.6494207382202148,90.13878188659973,6,27,-86,1670,241,808,910,3
1,-1,0,1.0,-1.0,0.657463788986206,88.88756943465155,6,26,-85,1670,241,808,910,3
1,-1,0,1.0,-1.0,0.6654708385467529,87.64131445842195,6,25,-84,1670,241,808,910,3
0,-2,0,-0.0,-2.0,0.6733746528625488,85.72630868059116,6,25,-82,1670,241,808,910,3
0,-2,0,-0.0,-2.0,0.6813247203826904,83.81527307120105,6,25,-80,1670,241,808,910,3
1,-2,0,1.0,-2.0,0.6898398399353027,81.60882305241266,6,24,-78,1670,241,808,910,3
1,-3,0,1.0,-3.0,0.6993467807769775,78.44743462982075,6,23,-75,1670,241,808,910,3
2,-3,0,2.0,-3.0,0.7053377628326416,75.0,6,21,-72,1670,241,808,910,3
1,-3,0,1.0,-3.0,0.7133538722991943,71.84010022264724,6,20,-69,1670,241,808,910,3
1,-3,0,1.0,-3.0,0.7214248180389404,68.6804193347711,6,19,-66,1670,241,808,910,3
1,-4,0,1.0,-4.0,0.729421854019165,64.5600495662759,6,18,-62,1670,241,808,910,3
1,-2,0,1.0,-2.0,0.7373247146606445,62.36184731067546,6,17,-60,1670,241,808,910,3
2,-5,0,2.0,-5.0,0.7454006671905518,57.0087712549569,6,15,-55,1670,241,808,910,3
1,-4,0,1.0,-4.0,0.7533266544342041,52.88667128870941,6,14,-51,1670,241,808,910,3
1,-4,0,1.0,-4.0,0.7613036632537842,48.76474136094644,6,13,-47,1670,241,808,910,3
1,-3,0,1.0,-3.0,0.7693178653717041,45.60701700396552,6,12,-44,1670,241,808,910,3
1,-1,0,1.0,-1.0,0.7773356437683105,44.384682042344295,6,11,-43,1670,241,808,910,3
0,-1,0,-0.0,-1.0,0.7855696678161621,43.41658669218482,6,11,-42,1670,241,808,910,3
1,0,0,1.0,-0.0,0.7933237552642822,43.174066289845804,6,10,-42,1670,241,808,910,3
0,-1,0,-0.0,-1.0,0.809924840927124,42.20189569201838,6,10,-41,1670,241,808,910,3
0,-1,0,-0.0,-1.0,0.8202667236328125,41.23105625617661,6,10,-40,1670,241,808,910,3
1,-1,0,1.0,-1.0,0.8254058361053467,40.024992192379,6,9,-39,1670,241,808,910,3
0,-1,0,-0.0,-1.0,0.8336226940155029,39.05124837953327,6,9,-38,1670,241,808,910,3
0,-1,0,-0.0,-1.0,0.8432998657226562,38.07886552931954,6,9,-37,1670,241,808,910,3
1,-1,0,1.0,-1.0,0.8493757247924805,36.87817782917155,6,8,-36,1670,241,808,910,3
0,-1,0,-0.0,-1.0,0.8653538227081299,35.90264614203248,6,8,-35,1670,241,808,910,3
0,-1,0,-0.0,-1.0,0.8733487129211426,34.92849839314596,6,8,-34,1670,241,808,910,3
0,-1,0,-0.0,-1.0,0.8816277980804443,33.95585369269929,6,8,-33,1670,241,808,910,3
0,-1,0,-0.0,-1.0,0.8893086910247803,32.984845004941285,6,8,-32,1670,241,808,910,3
1,-1,0,1.0,-1.0,0.8973307609558105,31.78049716414141,6,7,-31,1670,241,808,910,3
0,-1,0,-0.0,-1.0,0.9053857326507568,30.805843601498726,6,7,-30,1670,241,808,910,3
0,-1,0,-0.0,-1.0,0.9133257865905762,29.832867780352597,6,7,-29,1670,241,808,910,3
0,-2,0,-0.0,-2.0,0.9216856956481934,27.892651361962706,6,7,-27,1670,241,808,910,3
0,-1,0,-0.0,-1.0,0.9293217658996582,26.92582403567252,6,7,-26,1670,241,808,910,3
0,-1,0,-0.0,-1.0,0.9373087882995605,25.96150997149434,6,7,-25,1670,241,808,910,3
1,-2,0,1.0,-2.0,0.9453127384185791,23.769728648009426,6,6,-23,1670,241,808,910,3
0,-2,0,-0.0,-2.0,0.9535486698150635,21.840329667841555,6,6,-21,1670,241,808,910,3
1,-2,0,1.0,-2.0,0.9637987613677979,19.6468827043885,6,5,-19,1670,241,808,910,3
0,-2,0,-0.0,-2.0,0.9700558185577393,17.72004514666935,6,5,-17,1670,241,808,910,3
1,-1,0,1.0,-1.0,0.9773457050323486,16.492422502470642,6,4,-16,1670,241,808,910,3
0,-1,0,-0.0,-1.0,0.985980749130249,15.524174696260024,6,4,-15,1670,241,808,910,3
0,-1,0,-0.0,-1.0,0.993344783782959,14.560219778561036,6,4,-14,1670,241,808,910,3
0,-1,0,-0.0,-1.0,1.0016307830810547,13.601470508735444,6,4,-13,1670,241,808,910,3
0,-1,0,-0.0,-1.0,1.0093326568603516,12.649110640673518,6,4,-12,1670,241,808,910,3
0,-1,0,-0.0,-1.0,1.0253796577453613,11.704699910719626,6,4,-11,1670,241,808,910,3
0,-1,0,-0.0,-1.0,1.0333607196807861,10.770329614269007,6,4,-10,1670,241,808,910,3
0,-1,0,-0.0,-1.0,1.0426888465881348,9.848857801796104,6,4,-9,1670,241,808,910,3
0,-1,0,-0.0,-1.0,1.0495946407318115,8.94427190999916,6,4,-8,1670,241,808,910,3
0,-1,0,-0.0,-1.0,1.073333740234375,8.06225774829855,6,4,-7,1670,241,808,910,3
0,-1,0,-0.0,-1.0,1.0973248481750488,7.211102550927978,6,4,-6,1670,241,808,910,3
0,-1,0,-0.0,-1.0,1.1933138370513916,6.4031242374328485,6,4,-5,1670,241,808,910,3
0,-1,0,-0.0,-1.0,1.2015948295593262,5.656854249492381,6,4,-4,1670,241,808,910,3
0,-2,0,-0.0,-2.0,1.2093336582183838,4.47213595499958,6,4,-2,1670,241,808,910,3
0,-1,0,-0.0,-1.0,1.2173218727111816,4.123105625617661,6,4,-1,1670,241,808,910,3
0,-1,0,-0.0,-1.0,1.225348711013794,4.0,6,4,0,1670,241,808,910,3
0,-1,0,-0.0,-1.0,1.2333858013153076,4.123105625617661,6,4,1,1670,241,808,910,3
0,-1,0,-0.0,-1.0,1.241600751876831,4.47213595499958,6,4,2,1670,241,808,910,3
0,-1,0,-0.0,-1.0,1.2573456764221191,5.0,6,4,3,1670,241,808,910,3
0,-1,0,-0.0,-1.0,1.265758752822876,5.656854249492381,6,4,4,1670,241,808,910,3
0,0,1,-0.0,-0.0,1.3143527507781982,5.656854249492381,6,4,4,1670,241,808,910,3
0,0,0,-0.0,-0.0,1.4273476600646973,5.656854249492381,6,4,4,1670,241,808,910,3
1,0,0,1.0,-0.0,1.5293116569519043,5.0,6,3,4,1670,241,808,910,3
1,0,0,1.0,-0.0,1.5373308658599854,4.47213595499958,6,2,4,1670,241,808,910,3
1,0,0,1.0,-0.0,1.5534508228302002,4.123105625617661,6,1,4,1670,241,808,910,3
1,0,0,1.0,-0.0,1.5693647861480713,4.0,6,0,4,1670,241,808,910,3
0,0,1,-0.0,-0.0,1.6063127517700195,4.0,6,0,4,1670,241,808,910,3
1,2,1,1.0,2.0,1.6653938293457031,2.23606797749979,6,-1,2,1670,241,808,910,3
0,2,1,-0.0,2.0,1.6733088493347168,1.0,6,-1,0,1670,241,808,910,3
0,1,1,-0.0,1.0,1.6813318729400635,1.4142135623730951,6,-1,-1,1670,241,808,910,3
1,1,1,1.0,1.0,1.6894068717956543,2.8284271247461903,6,-2,-2,1670,241,808,910,3
0,1,1,-0.0,1.0,1.6973297595977783,3.605551275463989,6,-2,-3,1670,241,808,910,3
0,0,0,-0.0,-0.0,1.7043516635894775,3.605551275463989,6,-2,-3,1670,241,808,910,3
0,1,0,-0.0,1.0,1.7104697227478027,4.47213595499958,6,-2,-4,1670,241,808,910,3
1,0,0,1.0,-0.0,1.7137408256530762,5.0,6,-3,-4,1670,241,808,910,3
0,0,1,-0.0,-0.0,1.8083527088165283,5.0,6,-3,-4,1670,241,808,910,3
0,0,0,-0.0,-0.0,1.9333088397979736,5.0,6,-3,-4,1670,241,808,910,3
-1,0,0,-1.0,-0.0,2.065321683883667,4.47213595499958,6,-2,-4,1670,241,808,910,3
-1,-1,0,-1.0,-1.0,2.089338779449463,3.1622776601683795,6,-1,-3,1670,241,808,910,3
-1,-1,0,-1.0,-1.0,2.1053617000579834,2.0,6,0,-2,1670,241,808,910,3
-1,-1,0,-1.0,-1.0,2.129316806793213,1.4142135623730951,6,1,-1,1670,241,808,910,3
0,0,1,-0.0,-0.0,2.19635272026062,1.4142135623730951,6,1,-1,1670,241,808,910,3
0,0,0,-0.0,-0.0,0.08929443359375,864.6964785403026,7,90,860,1759,1102,1669,242,56
0,2,0,-0.0,2.0,0.25928330421447754,862.7073663763397,7,90,858,1759,1102,1669,242,56
-1,3,0,-1.0,3.0,0.26773738861083984,859.8290527773529,7,91,855,1759,1102,1669,242,56
-1,5,0,-1.0,5.0,0.2755773067474365,854.9643267411805,7,92,850,1759,1102,1669,242,56
-1,5,0,-1.0,5.0,0.2853415012359619,850.1023467794922,7,93,845,1759,1102,1669,242,56
0,8,0,-0.0,8.0,0.2913033962249756,842.1508178467798,7,93,837,1759,1102,1669,242,56
1,8,0,1.0,8.0,0.29932236671447754,834.0893237537572,7,92,829,1759,1102,1669,242,56
1,10,0,1.0,10.0,0.30811047554016113,824.040047570505,7,91,819,1759,1102,1669,242,56
1,12,0,1.0,12.0,0.31526947021484375,812.0030788118971,7,90,807,1759,1102,1669,242,56
1,14,0,1.0,14.0,0.3232533931732178,797.9786964574931,7,89,793,1759,1102,1669,242,56
0,19,0,-0.0,19.0,0.3325204849243164,779.1001219355571,7,89,774,1759,1102,1669,242,56
1,24,0,1.0,24.0,0.33936333656311035,755.145019185057,7,88,750,1759,1102,1669,242,56
0,25,0,-0.0,25.0,0.3473474979400635,730.3211622293304,7,88,725,1759,1102,1669,242,56
0,27,0,-0.0,27.0,0.35527849197387695,703.5254082120986,7,88,698,1759,1102,1669,242,56
1,29,0,1.0,29.0,0.36348843574523926,674.6332336907218,7,87,669,1759,1102,1669,242,56
5,27,0,5.0,27.0,0.37128138542175293,647.2155745962855,7,82,642,1759,1102,1669,242,56
9,30,0,9.0,30.0,0.3794534206390381,616.3383810862341,7,73,612,1759,1102,1669,242,56
9,30,0,9.0,30.0,0.3872694969177246,585.5083261577072,7,64,582,1759,1102,1669,242,56
8,29,0,8.0,29.0,0.3953564167022705,555.8282108709489,7,56,553,1759,1102,1669,242,56
8,27,0,8.0,27.0,0.405834436416626,528.1855734493323,7,48,526,1759,1102,1669,242,56
8,25,0,8.0,25.0,0.4114084243774414,502.5942697643896,7,40,501,1759,1102,1669,242,56
7,24,0,7.0,24.0,0.42018938064575195,478.1401468189008,7,33,477,1759,1102,1669,242,56
6,23,0,6.0,23.0,0.4290134906768799,454.80215478821117,7,27,454,1759,1102,1669,242,56
6,22,0,6.0,22.0,0.43555331230163574,432.5101154886438,7,21,432,1759,1102,1669,242,56
7,20,0,7.0,20.0,0.443279504776001,412.23779545306127,7,14,412,1759,1102,1669,242,56
5,17,0,5.0,17.0,0.4512763023376465,395.102518341759,7,9,395,1759,1102,1669,242,56
5,17,0,5.0,17.0,0.45926642417907715,378.02116342871597,7,4,378,1759,1102,1669,242,56
5,16,0,5.0,16.0,0.4673283100128174,362.0013812128346,7,-1,362,1759,1102,1669,242,56
5,16,0,5.0,16.0,0.47528743743896484,346.0520192109851,7,-6,346,1759,1102,1669,242,56
3,13,0,3.0,13.0,0.4851253032684326,333.12159941979144,7,-9,333,1759,1102,1669,242,56
3,12,0,3.0,12.0,0.49127840995788574,321.22422075553396,7,-12,321,1759,1102,1669,242,56
3,11,0,3.0,11.0,0.4992983341217041,310.3626910567699,7,-15,310,1759,1102,1669,242,56
2,10,0,2.0,10.0,0.5080094337463379,300.48128061494947,7,-17,300,1759,1102,1669,242,56
2,9,0,2.0,9.0,0.5153164863586426,291.61961525247233,7,-19,291,1759,1102,1669,242,56
3,9,0,3.0,9.0,0.5232913494110107,282.85685425670704,7,-22,282,1759,1102,1669,242,56
1,6,0,1.0,6.0,0.5312643051147461,276.9566753122228,7,-23,276,1759,1102,1669,242,56
1,8,0,1.0,8.0,0.5393414497375488,269.0724809414742,7,-24,268,1759,1102,1669,242,56
1,7,0,1.0,7.0,0.5494763851165771,262.1945842308723,7,-25,261,1759,1102,1669,242,56
0,5,0,-0.0,5.0,0.5554194450378418,257.21780653757236,7,-25,256,1759,1102,1669,242,56
0,7,0,-0.0,7.0,0.5634562969207764,250.25187311986298,7,-25,249,1759,1102,1669,242,56
0,8,0,-0.0,8.0,0.5712573528289795,242.29321080046796,7,-25,241,1759,1102,1669,242,56
-1,7,0,-1.0,7.0,0.579310417175293,235.2275494069519,7,-24,234,1759,1102,1669,242,56
-2,6,0,-2.0,6.0,0.5873863697052002,229.0589443789524,7,-22,228,1759,1102,1669,242,56
-2,7,0,-2.0,7.0,0.5963914394378662,221.90313201935658,7,-20,221,1759,1102,1669,242,56
-1,6,0,-1.0,6.0,0.6032824516296387,215.83790213954546,7,-19,215,1759,1102,1669,242,56
-1,6,0,-1.0,6.0,0.6112854480743408,209.77368757782756,7,-18,209,1759,1102,1669,242,56
-2,6,0,-2.0,6.0,0.6196794509887695,203.62956563328422,7,-16,203,1759,1102,1669,242,56
-2,6,0,-2.0,6.0,0.6272892951965332,197.4968354176846,7,-14,197,1759,1102,1669,242,56
-2,6,0,-2.0,6.0,0.6352825164794922,191.3765920900464,7,-12,191,1759,1102,1669,242,56
-2,5,0,-2.0,5.0,0.6432623863220215,186.26862323000083,7,-10,186,1759,1102,1669,242,56
-3,8,0,-3.0,8.0,0.6512575149536133,178.13758727455584,7,-7,178,1759,1102,1669,242,56
-3,7,0,-3.0,7.0,0.6617875099182129,171.04677722775136,7,-4,171,1759,1102,1669,242,56
-3,8,0,-3.0,8.0,0.6672923564910889,163.00306745579974,7,-1,163,1759,1102,1669,242,56
-4,8,0,-4.0,8.0,0.6752984523773193,155.0290295396317,7,3,155,1759,1102,1669,242,56
-2,7,0,-2.0,7.0,0.6845223903656006,148.08443537387717,7,5,148,1759,1102,1669,242,56
-3,9,0,-3.0,9.0,0.6912813186645508,139.2300254973761,7,8,139,1759,1102,1669,242,56
-3,8,0,-3.0,8.0,0.6994283199310303,131.4610208388783,7,11,131,1759,1102,1669,242,56
-2,9,0,-2.0,9.0,0.7072713375091553,122.6906679417795,7,13,122,1759,1102,1669,242,56
-1,7,0,-1.0,7.0,0.7152764797210693,115.84903970253703,7,14,115,1759,1102,1669,242,56
-1,8,0,-1.0,8.0,0.7233383655548096,108.04628637764465,7,15,107,1759,1102,1669,242,56
-2,7,0,-2.0,7.0,0.731271505355835,101.43470806385751,7,17,100,1759,1102,1669,242,56
-1,7,0,-1.0,7.0,0.739281415939331,94.72592042308166,7,18,93,1759,1102,1669,242,56
-1,7,0,-1.0,7.0,0.747307300567627,88.07383266328314,7,19,86,1759,1102,1669,242,56
0,6,0,-0.0,6.0,0.7552893161773682,82.22530024268686,7,19,80,1759,1102,1669,242,56
-1,7,0,-1.0,7.0,0.7636075019836426,75.69015788066504,7,20,73,1759,1102,1669,242,56
-1,6,0,-1.0,6.0,0.7713475227355957,70.21395872616783,7,21,67,1759,1102,1669,242,56
0,5,0,-0.0,5.0,0.7792553901672363,65.45991139621256,7,21,62,1759,1102,1669,242,56
-1,7,0,-1.0,7.0,0.7877182960510254,59.23681287847955,7,22,55,1759,1102,1669,242,56
0,5,0,-0.0,5.0,0.7956664562225342,54.62600113499065,7,22,50,1759,1102,1669,242,56
-1,6,0,-1.0,6.0,0.8032863140106201,49.64876634922564,7,23,44,1759,1102,1669,242,56
0,7,0,-0.0,7.0,0.8112905025482178,43.56604182158393,7,23,37,1759,1102,1669,242,56
0,7,0,-0.0,7.0,0.8193233013153076,37.8021163428716,7,23,30,1759,1102,1669,242,56
-1,6,0,-1.0,6.0,0.8272724151611328,33.94112549695428,7,24,24,1759,1102,1669,242,56
0,7,0,-0.0,7.0,0.8352804183959961,29.410882339705484,7,24,17,1759,1102,1669,242,56
-1,8,0,-1.0,8.0,0.8434054851531982,26.570660511172846,7,25,9,1759,1102,1669,242,56
0,8,0,-0.0,8.0,0.852264404296875,25.019992006393608,7,25,1,1759,1102,1669,242,56
-1,7,0,-1.0,7.0,0.8593034744262695,26.68332812825267,7,26,-6,1759,1102,1669,242,56
0,7,0,-0.0,7.0,0.8673074245452881,29.068883707497267,7,26,-13,1759,1102,1669,242,56
0,7,0,-0.0,7.0,0.8764784336090088,32.802438933713454,7,26,-20,1759,1102,1669,242,56
0,8,0,-0.0,8.0,0.8832874298095703,38.2099463490856,7,26,-28,1759,1102,1669,242,56
0,6,0,-0.0,6.0,0.8915784358978271,42.80186911806539,7,26,-34,1759,1102,1669,242,56
1,4,0,1.0,4.0,0.9006803035736084,45.48626166217664,7,25,-38,1759,1102,1669,242,56
0,3,0,-0.0,3.0,0.9078383445739746,48.02082881417188,7,25,-41,1759,1102,1669,242,56
0,2,0,-0.0,2.0,0.9153194427490234,49.73932046178355,7,25,-43,1759,1102,1669,242,56
0,1,0,-0.0,1.0,0.9232513904571533,50.60632371551998,7,25,-44,1759,1102,1669,242,56
0,0,1,-0.0,-0.0,0.9592974185943604,50.60632371551998,7,25,-44,1759,1102,1669,242,56
1,0,1,1.0,-0.0,0.015332937240600586,1499.7869848748521,8,-1065,-1056,670,90,1734,1146,68
1,0,1,1.0,-0.0,0.07132887840270996,1500.497250913843,8,-1066,-1056,670,90,1734,1146,68
0,0,0,-0.0,-0.0,0.07741904258728027,1500.497250913843,8,-1066,-1056,670,90,1734,1146,68
0,-1,0,-0.0,-1.0,0.08222603797912598,1499.793652473566,8,-1066,-1055,670,90,1734,1146,68
0,-1,0,-0.0,-1.0,0.1273658275604248,1499.0903908704104,8,-1066,-1054,670,90,1734,1146,68
0,-1,0,-0.0,-1.0,0.13928794860839844,1498.387466578655,8,-1066,-1053,670,90,1734,1146,68
0,-1,0,-0.0,-1.0,0.14336395263671875,1497.6848800732416,8,-1066,-1052,670,90,1734,1146,68
0,-1,0,-0.0,-1.0,0.1513688564300537,1496.982631829775,8,-1066,-1051,670,90,1734,1146,68
0,-1,0,-0.0,-1.0,0.1593489646911621,1496.2807223245243,8,-1066,-1050,670,90,1734,1146,68
-1,-1,0,-1.0,-1.0,0.16767382621765137,1494.8665492277228,8,-1065,-1049,670,90,1734,1146,68
-1,-2,0,-1.0,-2.0,0.17536187171936035,1492.7508164459332,8,-1064,-1047,670,90,1734,1146,68
-2,-1,0,-2.0,-1.0,0.18528199195861816,1490.6240303980076,8,-1062,-1046,670,90,1734,1146,68
-3,-3,0,-3.0,-3.0,0.1914069652557373,1486.3815122639276,8,-1059,-1043,670,90,1734,1146,68
-6,-4,0,-6.0,-4.0,0.20154595375061035,1479.3005103764415,8,-1053,-1039,670,90,1734,1146,68
-11,-6,0,-11.0,-6.0,0.20736098289489746,1467.2603722584481,8,-1042,-1033,670,90,1734,1146,68
-18,-9,0,-18.0,-9.0,0.21541690826416016,1448.1546878700494,8,-1024,-1024,670,90,1734,1146,68
-30,-17,0,-30.0,-17.0,0.22455096244812012,1414.9505291705432,8,-994,-1007,670,90,1734,1146,68
-41,-23,0,-41.0,-23.0,0.23134899139404297,1369.8412316761385,8,-953,-984,670,90,1734,1146,68
-47,-23,0,-47.0,-23.0,0.23933696746826172,1320.741079848734,8,-906,-961,670,90,1734,1146,68
-45,-22,0,-45.0,-22.0,0.24732398986816406,1273.98665613106,8,-861,-939,670,90,1734,1146,68
-38,-21,0,-38.0,-21.0,0.255389928817749,1232.90429474473,8,-823,-918,670,90,1734,1146,68
-37,-22,0,-37.0,-22.0,0.26334190368652344,1191.894290614734,8,-786,-896,670,90,1734,1146,68
-39,-23,0,-39.0,-23.0,0.2713279724121094,1148.9725845293265,8,-747,-873,670,90,1734,1146,68
-42,-25,0,-42.0,-25.0,0.27936387062072754,1102.7823901386892,8,-705,-848,670,90,1734,1146,68
-42,-26,0,-42.0,-26.0,0.2873218059539795,1056.0553962742674,8,-663,-822,670,90,1734,1146,68
-42,-28,0,-42.0,-28.0,0.2953219413757324,1008.0064483920726,8,-621,-794,670,90,1734,1146,68
-42,-30,0,-42.0,-30.0,0.30341196060180664,958.6120174502299,8,-579,-764,670,90,1734,1146,68
-40,-31,0,-40.0,-31.0,0.31154489517211914,909.8406453879712,8,-539,-733,670,90,1734,1146,68
-38,-30,0,-38.0,-30.0,0.31931185722351074,863.2554662439155,8,-501,-703,670,90,1734,1146,68
-29,-29,0,-29.0,-29.0,0.3273580074310303,822.8365572821859,8,-472,-674,670,90,1734,1146,68
-25,-29,0,-25.0,-29.0,0.3353729248046875,784.750915896248,8,-447,-645,670,90,1734,1146,68
-23,-31,0,-23.0,-31.0,0.3444039821624756,746.1715620418671,8,-424,-614,670,90,1734,1146,68
-22,-29,0,-22.0,-29.0,0.35137200355529785,709.809129273497,8,-402,-585,670,90,1734,1146,68
-21,-25,0,-21.0,-25.0,0.3593590259552002,677.3189795067018,8,-381,-560,670,90,1734,1146,68
-19,-24,0,-19.0,-24.0,0.3673110008239746,646.7920840579297,8,-362,-536,670,90,1734,1146,68
-17,-20,0,-17.0,-20.0,0.3753228187561035,620.7100772502408,8,-345,-516,670,90,1734,1146,68
-15,-19,0,-15.0,-19.0,0.38332581520080566,596.5810925599302,8,-330,-497,670,90,1734,1146,68
-11,-18,0,-11.0,-18.0,0.3948218822479248,575.5015204150203,8,-319,-479,670,90,1734,1146,68
-8,-17,0,-8.0,-17.0,0.39934396743774414,556.9245909456683,8,-311,-462,670,90,1734,1146,68
-7,-16,0,-7.0,-16.0,0.4073159694671631,539.751794809429,8,-304,-446,670,90,1734,1146,68
-5,-16,0,-5.0,-16.0,0.4153330326080322,523.7375296844785,8,-299,-430,670,90,1734,1146,68
-4,-15,0,-4.0,-15.0,0.4233579635620117,509.1659847240387,8,-295,-415,670,90,1734,1146,68
-4,-15,0,-4.0,-15.0,0.43132781982421875,494.65240320855617,8,-291,-400,670,90,1734,1146,68
-3,-14,0,-3.0,-14.0,0.4393198490142822,481.60149501429083,8,-288,-386,670,90,1734,1146,68
-3,-14,0,-3.0,-14.0,0.44745397567749023,468.62458322200723,8,-285,-372,670,90,1734,1146,68
-2,-14,0,-2.0,-14.0,0.4553489685058594,456.34745534515696,8,-283,-358,670,90,1734,1146,68
-2,-13,0,-2.0,-13.0,0.4653918743133545,444.95617761752675,8,-281,-345,670,90,1734,1146,68
-3,-12,0,-3.0,-12.0,0.47144198417663574,433.78911927340914,8,-278,-333,670,90,1734,1146,68
-4,-11,0,-4.0,-11.0,0.4795658588409424,422.8001892147164,8,-274,-322,670,90,1734,1146,68
-6,-12,0,-6.0,-12.0,0.4892609119415283,409.78530964396464,8,-268,-310,670,90,1734,1146,68
-8,-14,0,-8.0,-14.0,0.4953579902648926,393.97461847179954,8,-260,-296,670,90,1734,1146,68
-7,-11,0,-7.0,-11.0,0.5037899017333984,381.09578848368295,8,-253,-285,670,90,1734,1146,68
-5,-9,0,-5.0,-9.0,0.5113129615783691,371.0525569242179,8,-248,-276,670,90,1734,1146,68
-5,-8,0,-5.0,-8.0,0.5193250179290771,361.763735053695,8,-243,-268,670,90,1734,1146,68
-4,-9,0,-4.0,-9.0,0.5283420085906982,352.42304124446804,8,-239,-259,670,90,1734,1146,68
-5,-7,0,-5.0,-7.0,0.5373389720916748,343.8895171417704,8,-234,-252,670,90,1734,1146,68
-2,-6,0,-2.0,-6.0,0.5437028408050537,338.1419820134731,8,-232,-246,670,90,1734,1146,68
-3,-5,0,-3.0,-5.0,0.5513520240783691,332.4484922510553,8,-229,-241,670,90,1734,1146,68
-2,-4,0,-2.0,-4.0,0.5593109130859375,328.17373447611556,8,-227,-237,670,90,1734,1146,68
-3,-5,0,-3.0,-5.0,0.5673809051513672,322.49030993194197,8,-224,-232,670,90,1734,1146,68
-3,-6,0,-3.0,-6.0,0.5753688812255859,316.09650425147066,8,-221,-226,670,90,1734,1146,68
-4,-5,0,-4.0,-5.0,0.5833289623260498,309.7256850827842,8,-217,-221,670,90,1734,1146,68
-5,-6,0,-5.0,-6.0,0.5913119316101074,301.9420474196994,8,-212,-215,670,90,1734,1146,68
-4,-4,0,-4.0,-4.0,0.599370002746582,296.2853354454115,8,-208,-211,670,90,1734,1146,68
-3,-4,0,-3.0,-4.0,0.6076529026031494,291.3314263858261,8,-205,-207,670,90,1734,1146,68
-4,-5,0,-4.0,-5.0,0.6153209209442139,284.96491012052695,8,-201,-202,670,90,1734,1146,68
-5,-7,0,-5.0,-7.0,0.6233518123626709,276.4796556710819,8,-196,-195,670,90,1734,1146,68
-6,-5,0,-6.0,-5.0,0.6313679218292236,268.70057685088807,8,-190,-190,670,90,1734,1146,68
-5,-6,0,-5.0,-6.0,0.6393439769744873,260.9233603953467,8,-185,-184,670,90,1734,1146,68
-8,-5,0,-8.0,-5.0,0.6475179195404053,251.7339865810733,8,-177,-179,670,90,1734,1146,68
-8,-7,0,-8.0,-7.0,0.655383825302124,241.13274352522097,8,-169,-172,670,90,1734,1146,68
-9,-6,0,-9.0,-6.0,0.6633219718933105,230.5558500667463,8,-160,-166,670,90,1734,1146,68
-9,-6,0,-9.0,-6.0,0.6727678775787354,220.00227271553356,8,-151,-160,670,90,1734,1146,68
-10,-6,0,-10.0,-6.0,0.6795220375061035,208.79894635749483,8,-141,-154,670,90,1734,1146,68
-10,-6,0,-10.0,-6.0,0.6873209476470947,197.6486782146544,8,-131,-148,670,90,1734,1146,68
-10,-5,0,-10.0,-5.0,0.6953179836273193,187.32325002519042,8,-121,-143,670,90,1734,1146,68
-9,-5,0,-9.0,-5.0,0.7044119834899902,177.73013250431114,8,-112,-138,670,90,1734,1146,68
-9,-6,0,-9.0,-6.0,0.712277889251709,167.4305826305338,8,-103,-132,670,90,1734,1146,68
-8,-4,0,-8.0,-4.0,0.719336986541748,159.40200751558933,8,-95,-128,670,90,1734,1146,68
-5,-4,0,-5.0,-4.0,0.7280218601226807,153.21879780235844,8,-90,-124,670,90,1734,1146,68
-4,-3,0,-4.0,-3.0,0.735313892364502,148.44864431849825,8,-86,-121,670,90,1734,1146,68
-3,-3,0,-3.0,-3.0,0.7433319091796875,144.26711336961034,8,-83,-118,670,90,1734,1146,68
-4,-4,0,-4.0,-4.0,0.7515928745269775,138.69751259485514,8,-79,-114,670,90,1734,1146,68
-4,-4,0,-4.0,-4.0,0.7593038082122803,133.13526955694348,8,-75,-110,670,90,1734,1146,68
-4,-4,0,-4.0,-4.0,0.7674930095672607,127.58134659894448,8,-71,-106,670,90,1734,1146,68
-3,-3,0,-3.0,-3.0,0.7753558158874512,123.42204017111368,8,-68,-103,670,90,1734,1146,68
-4,-5,0,-4.0,-5.0,0.7851948738098145,117.04699910719626,8,-64,-98,670,90,1734,1146,68
-4,-4,0,-4.0,-4.0,0.7913248538970947,111.51681487560519,8,-60,-94,670,90,1734,1146,68
-5,-5,0,-5.0,-5.0,0.7993838787078857,104.62313319720452,8,-55,-89,670,90,1734,1146,68
-5,-5,0,-5.0,-5.0,0.8073508739471436,97.75479527879949,8,-50,-84,670,90,1734,1146,68
-5,-4,0,-5.0,-4.0,0.815377950668335,91.7877987534291,8,-45,-80,670,90,1734,1146,68
-6,-5,0,-6.0,-5.0,0.823793888092041,84.53401682163222,8,-39,-75,670,90,1734,1146,68
-5,-3,0,-5.0,-3.0,0.8314239978790283,79.62411694957753,8,-34,-72,670,90,1734,1146,68
-4,-4,0,-4.0,-4.0,0.8393208980560303,74.32361670424818,8,-30,-68,670,90,1734,1146,68
-4,-4,0,-4.0,-4.0,0.8473429679870605,69.07966415668217,8,-26,-64,670,90,1734,1146,68
-3,-3,0,-3.0,-3.0,0.8556900024414062,65.19202405202648,8,-23,-61,670,90,1734,1146,68
-2,-3,0,-2.0,-3.0,0.8633489608764648,61.68468205316454,8,-21,-58,670,90,1734,1146,68
-3,-3,0,-3.0,-3.0,0.8713529109954834,57.87054518492115,8,-18,-55,670,90,1734,1146,68
-3,-3,0,-3.0,-3.0,0.879349946975708,54.120236510939236,8,-15,-52,670,90,1734,1146,68
-3,-3,0,-3.0,-3.0,0.8888928890228271,50.44799302251776,8,-12,-49,670,90,1734,1146,68
-3,-4,0,-3.0,-4.0,0.8953979015350342,45.89117562233506,8,-9,-45,670,90,1734,1146,68
-4,-3,0,-4.0,-3.0,0.9046189785003662,42.2965719651132,8,-5,-42,670,90,1734,1146,68
-3,-3,0,-3.0,-3.0,0.9113650321960449,39.05124837953327,8,-2,-39,670,90,1734,1146,68
-3,-2,0,-3.0,-2.0,0.9193618297576904,37.013511046643494,8,1,-37,670,90,1734,1146,68
-1,-2,0,-1.0,-2.0,0.9276788234710693,35.05709628591621,8,2,-35,670,90,1734,1146,68
-1,-1,0,-1.0,-1.0,0.9353668689727783,34.132096331752024,8,3,-34,670,90,1734,1146,68
-1,-1,0,-1.0,-1.0,0.943497896194458,33.24154027718932,8,4,-33,670,90,1734,1146,68
0,0,1,-0.0,-0.0,0.9713308811187744,33.24154027718932,8,4,-33,670,90,1734,1146,68
0,0,0,-0.0,-0.0,0.07641315460205078,1317.0003796506667,9,953,909,1619,1032,666,123,68
1,5,0,1.0,5.0,0.1654801368713379,1312.829006382781,9,952,904,1619,1032,666,123,68
4,7,0,4.0,7.0,0.17337918281555176,1305.1103401628538,9,948,897,1619,1032,666,123,68
5,7,0,5.0,7.0,0.18144822120666504,1296.6684233064366,9,943,890,1619,1032,666,123,68
7,9,0,7.0,9.0,0.18938016891479492,1285.4014936975918,9,936,881,1619,1032,666,123,68
11,12,0,11.0,12.0,0.19939017295837402,1269.167443641697,9,925,869,1619,1032,666,123,68
14,12,0,14.0,12.0,0.20547032356262207,1250.7477763322229,9,911,857,1619,1032,666,123,68
18,13,0,18.0,13.0,0.21341228485107422,1228.7330873708904,9,893,844,1619,1032,666,123,68
24,15,0,24.0,15.0,0.22254419326782227,1201.0004163196613,9,869,829,1619,1032,666,123,68
35,20,0,35.0,20.0,0.22939729690551758,1161.9109260179973,9,834,809,1619,1032,666,123,68
38,20,0,38.0,20.0,0.23744916915893555,1120.77517816911,9,796,789,1619,1032,666,123,68
39,24,0,39.0,24.0,0.24538826942443848,1076.2313877600857,9,757,765,1619,1032,666,123,68
37,28,0,37.0,28.0,0.25339221954345703,1030.3247060999752,9,720,737,1619,1032,666,123,68
35,29,0,35.0,29.0,0.2613961696624756,985.1340010374223,9,685,708,1619,1032,666,123,68
36,30,0,36.0,30.0,0.2694411277770996,938.5547400125365,9,649,678,1619,1032,666,123,68
36,31,0,36.0,31.0,0.2798032760620117,891.2788564753457,9,613,647,1619,1032,666,123,68
32,29,0,32.0,29.0,0.28553128242492676,848.224616478442,9,581,618,1619,1032,666,123,68
31,30,0,31.0,30.0,0.2941131591796875,805.1360133542655,9,550,588,1619,1032,666,123,68
28,30,0,28.0,30.0,0.3039243221282959,764.0994699644805,9,522,558,1619,1032,666,123,68
24,28,0,24.0,28.0,0.3096332550048828,727.2578634844728,9,498,530,1619,1032,666,123,68
22,25,0,22.0,25.0,0.31740522384643555,693.974783403547,9,476,505,1619,1032,666,123,68
22,26,0,22.0,26.0,0.3274803161621094,659.9674234384603,9,454,479,1619,1032,666,123,68
22,24,0,22.0,24.0,0.3337862491607666,627.4145360126748,9,432,455,1619,1032,666,123,68
21,23,0,21.0,23.0,0.3421041965484619,596.2759428318402,9,411,432,1619,1032,666,123,68
19,21,0,19.0,21.0,0.3510322570800781,567.9656679765072,9,392,411,1619,1032,666,123,68
18,19,0,18.0,19.0,0.35741233825683594,541.7933185265392,9,374,392,1619,1032,666,123,68
18,17,0,18.0,17.0,0.36540913581848145,517.069627806546,9,356,375,1619,1032,666,123,68
17,16,0,17.0,16.0,0.37337422370910645,493.76310109201154,9,339,359,1619,1032,666,123,68
18,16,0,18.0,16.0,0.3817291259765625,469.77654262425665,9,321,343,1619,1032,666,123,68
18,14,0,18.0,14.0,0.3893611431121826,447.2694937059759,9,303,329,1619,1032,666,123,68
18,15,0,18.0,15.0,0.39764833450317383,424.0530627173915,9,285,314,1619,1032,666,123,68
18,15,0,18.0,15.0,0.40543317794799805,400.8615721168593,9,267,299,1619,1032,666,123,68
16,13,0,16.0,13.0,0.4134502410888672,380.5220098759072,9,251,286,1619,1032,666,123,68
14,13,0,14.0,13.0,0.4213871955871582,361.52178357603844,9,237,273,1619,1032,666,123,68
13,12,0,13.0,12.0,0.4293642044067383,343.94330928221297,9,224,261,1619,1032,666,123,68
11,11,0,11.0,11.0,0.4373762607574463,328.4341638745884,9,213,250,1619,1032,666,123,68
10,12,0,10.0,12.0,0.4454531669616699,312.8146416010606,9,203,238,1619,1032,666,123,68
14,12,0,14.0,12.0,0.4534151554107666,294.61330587738223,9,189,226,1619,1032,666,123,68
14,12,0,14.0,12.0,0.461367130279541,276.4434842784326,9,175,214,1619,1032,666,123,68
14,13,0,14.0,13.0,0.46971631050109863,257.53058070838887,9,161,201,1619,1032,666,123,68
13,11,0,13.0,11.0,0.4774012565612793,240.84019598065436,9,148,190,1619,1032,666,123,68
11,10,0,11.0,10.0,0.48541927337646484,226.2056586383285,9,137,180,1619,1032,666,123,68
10,10,0,10.0,10.0,0.4936063289642334,212.20037700249262,9,127,170,1619,1032,666,123,68
9,7,0,9.0,7.0,0.5020482540130615,201.22872558360052,9,118,163,1619,1032,666,123,68
7,8,0,7.0,8.0,0.509425163269043,190.64626930522402,9,111,155,1619,1032,666,123,68
7,8,0,7.0,8.0,0.5174531936645508,180.06943105369106,9,104,147,1619,1032,666,123,68
7,8,0,7.0,8.0,0.5259473323822021,169.49926253526885,9,97,139,1619,1032,666,123,68
5,6,0,5.0,6.0,0.5333912372589111,161.7188919081503,9,92,133,1619,1032,666,123,68
6,6,0,6.0,6.0,0.5414752960205078,153.37861650177967,9,86,127,1619,1032,666,123,68
5,4,0,5.0,4.0,0.5498483180999756,147.27525250360293,9,81,123,1619,1032,666,123,68
4,5,0,4.0,5.0,0.5595042705535889,140.90067423543437,9,77,118,1619,1032,666,123,68
4,4,0,4.0,4.0,0.565662145614624,135.36986370680884,9,73,114,1619,1032,666,123,68
3,4,0,3.0,4.0,0.5755631923675537,130.38404810405297,9,70,110,1619,1032,666,123,68
2,3,0,2.0,3.0,0.5830953121185303,126.77933585565118,9,68,107,1619,1032,666,123,68
4,6,0,4.0,6.0,0.5894181728363037,119.57006314291216,9,64,101,1619,1032,666,123,68
4,5,0,4.0,5.0,0.5974462032318115,113.20777358467925,9,60,96,1619,1032,666,123,68
6,7,0,6.0,7.0,0.607255220413208,104.10091258005379,9,54,89,1619,1032,666,123,68
7,7,0,7.0,7.0,0.6138231754302979,94.51454914456292,9,47,82,1619,1032,666,123,68
9,7,0,9.0,7.0,0.6214323043823242,84.07734534343957,9,38,75,1619,1032,666,123,68
10,7,0,10.0,7.0,0.6308491230010986,73.53910524340094,9,28,68,1619,1032,666,123,68
9,6,0,9.0,6.0,0.6374192237854004,64.8459713474939,9,19,62,1619,1032,666,123,68
8,6,0,8.0,6.0,0.6454081535339355,57.0701322935211,9,11,56,1619,1032,666,123,68
6,4,0,6.0,4.0,0.6541011333465576,52.23983154643591,9,5,52,1619,1032,666,123,68
4,3,0,4.0,3.0,0.6615042686462402,49.01020301937138,9,1,49,1619,1032,666,123,68
3,3,0,3.0,3.0,0.6694481372833252,46.04345773288535,9,-2,46,1619,1032,666,123,68
4,3,0,4.0,3.0,0.6823623180389404,43.41658669218482,9,-6,43,1619,1032,666,123,68
5,5,0,5.0,5.0,0.6853821277618408,39.56008088970496,9,-11,38,1619,1032,666,123,68
6,4,0,6.0,4.0,0.6933722496032715,38.01315561749642,9,-17,34,1619,1032,666,123,68
6,5,0,6.0,5.0,0.7014081478118896,37.013511046643494,9,-23,29,1619,1032,666,123,68
6,6,0,6.0,6.0,0.7148892879486084,37.013511046643494,9,-29,23,1619,1032,666,123,68
4,4,0,4.0,4.0,0.7181551456451416,38.07886552931954,9,-33,19,1619,1032,666,123,68
3,3,0,3.0,3.0,0.7254061698913574,39.395431207184416,9,-36,16,1619,1032,666,123,68
3,2,0,3.0,2.0,0.7333862781524658,41.43669871020132,9,-39,14,1619,1032,666,123,68
1,1,0,1.0,1.0,0.7414071559906006,42.05948168962618,9,-40,13,1619,1032,666,123,68
0,1,0,-0.0,1.0,0.7493972778320312,41.7612260356422,9,-40,12,1619,1032,666,123,68
0,0,1,-0.0,-0.0,0.7894072532653809,41.7612260356422,9,-40,12,1619,1032,666,123,68
0,0,0,-0.0,-0.0,0.09719204902648926,1077.6288786033901,10,-1072,-110,587,910,1659,1020,13
-4,2,0,-4.0,2.0,0.18722295761108398,1073.856601227557,10,-1068,-112,587,910,1659,1020,13
-7,1,0,-7.0,1.0,0.19518494606018066,1067.0004686034586,10,-1061,-113,587,910,1659,1020,13
-8,1,0,-8.0,1.0,0.20426607131958008,1059.1529634571202,10,-1053,-114,587,910,1659,1020,13
-12,3,0,-12.0,3.0,0.2111520767211914,1047.5542945356103,10,-1041,-117,587,910,1659,1020,13
-18,3,0,-18.0,3.0,0.21921896934509277,1030.0140775737,10,-1023,-120,587,910,1659,1020,13
-26,6,0,-26.0,6.0,0.2272651195526123,1004.9303458449248,10,-997,-126,587,910,1659,1020,13
-26,5,0,-26.0,5.0,0.23513507843017578,979.7969177334659,10,-971,-131,587,910,1659,1020,13
-26,6,0,-26.0,6.0,0.2432711124420166,954.8790499325032,10,-945,-137,587,910,1659,1020,13
-23,4,0,-23.0,4.0,0.2511739730834961,932.7191431508201,10,-922,-141,587,910,1659,1020,13
-21,4,0,-21.0,4.0,0.26233506202697754,912.593008958539,10,-901,-145,587,910,1659,1020,13
-19,3,0,-19.0,3.0,0.26718997955322266,894.3310349082157,10,-882,-148,587,910,1659,1020,13
-18,3,0,-18.0,3.0,0.27529191970825195,877.0957758420684,10,-864,-151,587,910,1659,1020,13
-19,4,0,-19.0,4.0,0.2845919132232666,859.0983645660141,10,-845,-155,587,910,1659,1020,13
-19,2,0,-19.0,2.0,0.2912271022796631,840.7883205658842,10,-826,-157,587,910,1659,1020,13
-18,2,0,-18.0,2.0,0.2991669178009033,823.4955980453083,10,-808,-159,587,910,1659,1020,13
-17,3,0,-17.0,3.0,0.30715298652648926,807.4187265601412,10,-791,-162,587,910,1659,1020,13
-16,2,0,-16.0,2.0,0.31517910957336426,792.1622308593107,10,-775,-164,587,910,1659,1020,13
-14,2,0,-14.0,2.0,0.32318592071533203,778.8947297292491,10,-761,-166,587,910,1659,1020,13
-13,3,0,-13.0,3.0,0.33115696907043457,766.8539626291306,10,-748,-169,587,910,1659,1020,13
-12,3,0,-12.0,3.0,0.339277982711792,755.8306688670419,10,-736,-172,587,910,1659,1020,13
-13,2,0,-13.0,2.0,0.34719300270080566,743.6430595386472,10,-723,-174,587,910,1659,1020,13
-14,3,0,-14.0,3.0,0.3551640510559082,730.7598784826655,10,-709,-177,587,910,1659,1020,13
-16,2,0,-16.0,2.0,0.3631880283355713,715.7443677738582,10,-693,-179,587,910,1659,1020,13
-16,1,0,-16.0,1.0,0.37115907669067383,700.5205207558163,10,-677,-180,587,910,1659,1020,13
-17,2,0,-17.0,2.0,0.3792099952697754,684.6342089028271,10,-660,-182,587,910,1659,1020,13
-16,2,0,-16.0,2.0,0.3871650695800781,669.7701098138077,10,-644,-184,587,910,1659,1020,13
-12,2,0,-12.0,2.0,0.3966970443725586,658.8019429236681,10,-632,-186,587,910,1659,1020,13
-9,2,0,-9.0,2.0,0.4031801223754883,650.7480311149624,10,-623,-188,587,910,1659,1020,13
-6,3,0,-6.0,3.0,0.41177892684936523,645.886987018627,10,-617,-191,587,910,1659,1020,13
-4,1,0,-4.0,1.0,0.4191620349884033,642.3651609481947,10,-613,-192,587,910,1659,1020,13
-1,1,0,-1.0,1.0,0.4271540641784668,641.7109941398854,10,-612,-193,587,910,1659,1020,13
0,1,0,-0.0,1.0,0.4432051181793213,642.0124609382593,10,-612,-194,587,910,1659,1020,13
1,-1,0,1.0,-1.0,0.49115800857543945,642.6647648657892,10,-613,-193,587,910,1659,1020,13
3,-3,0,3.0,-3.0,0.4995720386505127,644.6363315854917,10,-616,-190,587,910,1659,1020,13
5,-4,0,5.0,-4.0,0.5074360370635986,648.2568935229305,10,-621,-186,587,910,1659,1020,13
8,-5,0,8.0,-5.0,0.5191559791564941,654.5242547071881,10,-629,-181,587,910,1659,1020,13
10,-8,0,10.0,-8.0,0.5233159065246582,662.0045317065435,10,-639,-173,587,910,1659,1020,13
10,-10,0,10.0,-10.0,0.5312390327453613,669.1561850569716,10,-649,-163,587,910,1659,1020,13
10,-15,0,10.0,-15.0,0.539154052734375,675.4146874328393,10,-659,-148,587,910,1659,1020,13
11,-16,0,11.0,-16.0,0.5471899509429932,682.8791986874398,10,-670,-132,587,910,1659,1020,13
14,-15,0,14.0,-15.0,0.5551559925079346,693.9344349432445,10,-684,-117,587,910,1659,1020,13
15,-17,0,15.0,-17.0,0.563154935836792,706.1168458548486,10,-699,-100,587,910,1659,1020,13
13,-17,0,13.0,-17.0,0.571458101272583,716.8214561520881,10,-712,-83,587,910,1659,1020,13
12,-21,0,12.0,-21.0,0.5791900157928467,726.6498469001422,10,-724,-62,587,910,1659,1020,13
9,-20,0,9.0,-20.0,0.5871570110321045,734.2022882012831,10,-733,-42,587,910,1659,1020,13
6,-22,0,6.0,-22.0,0.5952839851379395,739.2705864566776,10,-739,-20,587,910,1659,1020,13
4,-24,0,4.0,-24.0,0.6031670570373535,743.0107670821467,10,-743,4,587,910,1659,1020,13
1,-24,0,1.0,-24.0,0.6111710071563721,744.5266952903704,10,-744,28,587,910,1659,1020,13
-2,-25,0,-2.0,-25.0,0.6192469596862793,743.8904489237646,10,-742,53,587,910,1659,1020,13
-3,-26,0,-3.0,-26.0,0.627173900604248,743.2106027230774,10,-739,79,587,910,1659,1020,13
-4,-25,0,-4.0,-25.0,0.637653112411499,742.3213589814051,10,-735,104,587,910,1659,1020,13
-3,-22,0,-3.0,-22.0,0.6435260772705078,742.7651041883968,10,-732,126,587,910,1659,1020,13
-3,-20,0,-3.0,-20.0,0.65118408203125,743.4762941748714,10,-729,146,587,910,1659,1020,13
-1,-18,0,-1.0,-18.0,0.6604158878326416,746.243927948496,10,-728,164,587,910,1659,1020,13
0,-14,0,-0.0,-14.0,0.667186975479126,749.4451280781002,10,-728,178,587,910,1659,1020,13
-1,-13,0,-1.0,-13.0,0.6751549243927002,751.6714707902648,10,-727,191,587,910,1659,1020,13
-2,-11,0,-2.0,-11.0,0.6834919452667236,752.6147753000866,10,-725,202,587,910,1659,1020,13
-3,-13,0,-3.0,-13.0,0.6912169456481934,753.3319321520893,10,-722,215,587,910,1659,1020,13
-4,-13,0,-4.0,-13.0,0.6992208957672119,753.3312684337482,10,-718,228,587,910,1659,1020,13
-5,-13,0,-5.0,-13.0,0.7071700096130371,752.6287265312161,10,-713,241,587,910,1659,1020,13
-6,-13,0,-6.0,-13.0,0.7151939868927002,751.2423044530972,10,-707,254,587,910,1659,1020,13
-9,-13,0,-9.0,-13.0,0.7231669425964355,747.3238922983795,10,-698,267,587,910,1659,1020,13
-10,-15,0,-10.0,-15.0,0.7311639785766602,743.55093974791,10,-688,282,587,910,1659,1020,13
-14,-15,0,-14.0,-15.0,0.7391490936279297,736.5358103989242,10,-674,297,587,910,1659,1020,13
-14,-15,0,-14.0,-15.0,0.7480928897857666,730.0301363642462,10,-660,312,587,910,1659,1020,13
-11,-9,0,-11.0,-9.0,0.760577917098999,724.0455786758179,10,-649,321,587,910,1659,1020,13
-7,-7,0,-7.0,-7.0,0.7631731033325195,720.9355033565763,10,-642,328,587,910,1659,1020,13
-6,-5,0,-6.0,-5.0,0.7721750736236572,717.9031968169525,10,-636,333,587,910,1659,1020,13
-6,-2,0,-6.0,-2.0,0.7792189121246338,713.5299573248484,10,-630,335,587,910,1659,1020,13
-7,-3,0,-7.0,-3.0,0.7871730327606201,708.7827593840019,10,-623,338,587,910,1659,1020,13
-9,-3,0,-9.0,-3.0,0.799293041229248,702.3368137866618,10,-614,341,587,910,1659,1020,13
-10,-1,0,-10.0,-1.0,0.8032419681549072,694.1037386443038,10,-604,342,587,910,1659,1020,13
-12,1,0,-12.0,1.0,0.8111639022827148,683.187382787475,10,-592,341,587,910,1659,1020,13
-13,4,0,-13.0,4.0,0.8191781044006348,669.93283245412,10,-579,337,587,910,1659,1020,13
-14,6,0,-14.0,6.0,0.8271710872650146,654.8175318361597,10,-565,331,587,910,1659,1020,13
-12,11,0,-12.0,11.0,0.8351550102233887,638.9123570568971,10,-553,320,587,910,1659,1020,13
-8,16,0,-8.0,16.0,0.843174934387207,624.0520811598981,10,-545,304,587,910,1659,1020,13
0,19,0,-0.0,19.0,0.8511819839477539,615.0203248673981,10,-545,285,587,910,1659,1020,13
7,23,0,7.0,23.0,0.8592410087585449,611.0220945268674,10,-552,262,587,910,1659,1020,13
15,25,0,15.0,25.0,0.8689329624176025,614.5388514976088,10,-567,237,587,910,1659,1020,13
18,25,0,18.0,25.0,0.8757729530334473,622.2290575021389,10,-585,212,587,910,1659,1020,13
19,24,0,19.0,24.0,0.8831789493560791,632.5820104935011,10,-604,188,587,910,1659,1020,13
19,21,0,19.0,21.0,0.8911519050598145,644.9945736205848,10,-623,167,587,910,1659,1020,13
15,19,0,15.0,19.0,0.8994090557098389,654.9412187364603,10,-638,148,587,910,1659,1020,13
13,16,0,13.0,16.0,0.9071450233459473,664.2476947645358,10,-651,132,587,910,1659,1020,13
9,15,0,9.0,15.0,0.9151709079742432,670.290235644232,10,-660,117,587,910,1659,1020,13
6,12,0,6.0,12.0,0.923414945602417,674.2262231625228,10,-666,105,587,910,1659,1020,13
2,8,0,2.0,8.0,0.9311459064483643,675.0059258999139,10,-668,97,587,910,1659,1020,13
0,6,0,-0.0,6.0,0.9397420883178711,674.1698599017906,10,-668,91,587,910,1659,1020,13
-1,4,0,-1.0,4.0,0.947396993637085,672.6499832751057,10,-667,87,587,910,1659,1020,13
-4,3,0,-4.0,3.0,0.9551630020141602,668.3000822983639,10,-663,84,587,910,1659,1020,13
-4,2,0,-4.0,2.0,0.963184118270874,664.0820732409511,10,-659,82,587,910,1659,1020,13
-7,1,0,-7.0,1.0,0.9713759422302246,657.0121764472863,10,-652,81,587,910,1659,1020,13
-8,0,0,-8.0,-0.0,0.983098030090332,649.0739557246154,10,-644,81,587,910,1659,1020,13
-8,-2,0,-8.0,-2.0,0.9872419834136963,641.3930152410455,10,-636,83,587,910,1659,1020,13
-7,-5,0,-7.0,-5.0,0.9951870441436768,635.1259717567847,10,-629,88,587,910,1659,1020,13
-7,-8,0,-7.0,-8.0,1.0031828880310059,629.3647591023825,10,-622,96,587,910,1659,1020,13
-8,-13,0,-8.0,-13.0,1.0129449367523193,623.6000320718401,10,-614,109,587,910,1659,1020,13
-8,-17,0,-8.0,-17.0,1.0193989276885986,618.9604187668223,10,-606,126,587,910,1659,1020,13
-7,-20,0,-7.0,-20.0,1.0271859169006348,616.5362925246169,10,-599,146,587,910,1659,1020,13
-8,-22,0,-8.0,-22.0,1.0361599922180176,614.414355301046,10,-591,168,587,910,1659,1020,13
-9,-23,0,-9.0,-23.0,1.0431840419769287,612.5397946256227,10,-582,191,587,910,1659,1020,13
-9,-23,0,-9.0,-23.0,1.0511600971221924,611.657583947097,10,-573,214,587,910,1659,1020,13
-11,-21,0,-11.0,-21.0,1.059196949005127,609.1543318404623,10,-562,235,587,910,1659,1020,13
-13,-21,0,-13.0,-21.0,1.0671429634094238,605.7532500944588,10,-549,256,587,910,1659,1020,13
-16,-20,0,-16.0,-20.0,1.0751969814300537,600.2207927088165,10,-533,276,587,910,1659,1020,13
-19,-22,0,-19.0,-22.0,1.0831871032714844,594.1380311005179,10,-514,298,587,910,1659,1020,13
-22,-20,0,-22.0,-20.0,1.0911619663238525,585.8224987144143,10,-492,318,587,910,1659,1020,13
-24,-20,0,-24.0,-20.0,1.0994799137115479,577.2936860905374,10,-468,338,587,910,1659,1020,13
-23,-16,0,-23.0,-16.0,1.1072111129760742,568.6308116871614,10,-445,354,587,910,1659,1020,13
-20,-12,0,-20.0,-12.0,1.115135908126831,560.87520893689,10,-425,366,587,910,1659,1020,13
-16,-9,0,-16.0,-9.0,1.1231839656829834,554.892782436391,10,-409,375,587,910,1659,1020,13
-11,-7,0,-11.0,-7.0,1.131181001663208,551.6593151574621,10,-398,382,587,910,1659,1020,13
-8,-4,0,-8.0,-4.0,1.1391749382019043,548.7221519129695,10,-390,386,587,910,1659,1020,13
-6,-4,0,-6.0,-4.0,1.1473801136016846,547.3170927350981,10,-384,390,587,910,1659,1020,13
-6,-4,0,-6.0,-4.0,1.1551859378814697,546.0036629913759,10,-378,394,587,910,1659,1020,13
-7,-4,0,-7.0,-4.0,1.1660680770874023,544.1001746002293,10,-371,398,587,910,1659,1020,13
-8,-4,0,-8.0,-4.0,1.1713590621948242,541.6391787897179,10,-363,402,587,910,1659,1020,13
-11,-4,0,-11.0,-4.0,1.1792829036712646,537.3453265824502,10,-352,406,587,910,1659,1020,13
-13,-3,0,-13.0,-3.0,1.1888110637664795,531.2268818499305,10,-339,409,587,910,1659,1020,13
-15,-2,0,-15.0,-2.0,1.1951980590820312,523.3516981915699,10,-324,411,587,910,1659,1020,13
-14,0,0,-14.0,-0.0,1.203766107559204,514.8019036483839,10,-310,411,587,910,1659,1020,13
-16,0,0,-16.0,-0.0,1.2112300395965576,505.3286059585386,10,-294,411,587,910,1659,1020,13
-15,3,0,-15.0,3.0,1.2191669940948486,494.2721922180126,10,-279,408,587,910,1659,1020,13
-15,5,0,-15.0,5.0,1.227173089981079,481.7727680141334,10,-264,403,587,910,1659,1020,13
-12,5,0,-12.0,5.0,1.235192060470581,471.07111989592397,10,-252,398,587,910,1659,1020,13
-13,6,0,-13.0,6.0,1.2508139610290527,459.1132757827854,10,-239,392,587,910,1659,1020,13
-11,7,0,-11.0,7.0,1.2511930465698242,447.4472035894291,10,-228,385,587,910,1659,1020,13
-9,7,0,-9.0,7.0,1.259148120880127,436.85810053151124,10,-219,378,587,910,1659,1020,13
-8,7,0,-8.0,7.0,1.2672209739685059,426.8044048507466,10,-211,371,587,910,1659,1020,13
-7,9,0,-7.0,9.0,1.2756719589233398,415.5237658666469,10,-204,362,587,910,1659,1020,13
-7,9,0,-7.0,9.0,1.285309076309204,404.2499226963439,10,-197,353,587,910,1659,1020,13
-5,10,0,-5.0,10.0,1.291438102722168,393.0814165029937,10,-192,343,587,910,1659,1020,13
-4,10,0,-4.0,10.0,1.2991809844970703,382.4042363782075,10,-188,333,587,910,1659,1020,13
0,13,0,-0.0,13.0,1.3071351051330566,371.1387880564358,10,-188,320,587,910,1659,1020,13
0,14,0,-0.0,14.0,1.3152010440826416,359.13785653979727,10,-188,306,587,910,1659,1020,13
1,12,0,1.0,12.0,1.3231730461120605,349.509656518958,10,-189,294,587,910,1659,1020,13
6,12,0,6.0,12.0,1.3311560153961182,342.8541964159109,10,-195,282,587,910,1659,1020,13
9,12,0,9.0,12.0,1.3391749858856201,338.4021276528858,10,-204,270,587,910,1659,1020,13
15,12,0,15.0,12.0,1.347588062286377,338.4154251803543,10,-219,258,587,910,1659,1020,13
20,11,0,20.0,11.0,1.3551619052886963,343.70045097439134,10,-239,247,587,910,1659,1020,13
23,11,0,23.0,11.0,1.3631501197814941,352.61877431583247,10,-262,236,587,910,1659,1020,13
26,8,0,26.0,8.0,1.3717350959777832,367.3254687603352,10,-288,228,587,910,1659,1020,13
24,7,0,24.0,7.0,1.379378080368042,382.3414704161713,10,-312,221,587,910,1659,1020,13
23,6,0,23.0,6.0,1.3902950286865234,398.05778474990285,10,-335,215,587,910,1659,1020,13
21,5,0,21.0,5.0,1.3955230712890625,413.32311815334015,10,-356,210,587,910,1659,1020,13
20,5,0,20.0,5.0,1.4035649299621582,428.2534296418419,10,-376,205,587,910,1659,1020,13
18,3,0,18.0,3.0,1.4149000644683838,442.76404551408643,10,-394,202,587,910,1659,1020,13
17,3,0,17.0,3.0,1.419558048248291,456.64209179618996,10,-411,199,587,910,1659,1020,13
15,3,0,15.0,3.0,1.4271619319915771,468.9264334626488,10,-426,196,587,910,1659,1020,13
10,2,0,10.0,2.0,1.435148000717163,477.2127408190188,10,-436,194,587,910,1659,1020,13
5,1,0,5.0,1.0,1.4431838989257812,481.3834230631545,10,-441,193,587,910,1659,1020,13
2,0,0,2.0,-0.0,1.4516689777374268,483.2163076718334,10,-443,193,587,910,1659,1020,13
-1,-1,0,-1.0,-1.0,1.4591729640960693,482.7007354458868,10,-442,194,587,910,1659,1020,13
-5,-3,0,-5.0,-3.0,1.4671850204467773,479.35164545456604,10,-437,197,587,910,1659,1020,13
-11,-4,0,-11.0,-4.0,1.4763789176940918,471.03821501020485,10,-426,201,587,910,1659,1020,13
-14,-6,0,-14.0,-6.0,1.484640121459961,461.07808449328843,10,-412,207,587,910,1659,1020,13
-18,-7,0,-18.0,-7.0,1.491163969039917,448.36592198783353,10,-394,214,587,910,1659,1020,13
-24,-8,0,-24.0,-8.0,1.4991710186004639,431.49044021855224,10,-370,222,587,910,1659,1020,13
-26,-6,0,-26.0,-6.0,1.5071349143981934,412.6984371184364,10,-344,228,587,910,1659,1020,13
-25,-5,0,-25.0,-5.0,1.5151910781860352,395.03164430207363,10,-319,233,587,910,1659,1020,13
-23,-3,0,-23.0,-3.0,1.5235350131988525,378.565714242587,10,-296,236,587,910,1659,1020,13
-18,-1,0,-18.0,-1.0,1.5313549041748047,365.3121952522253,10,-278,237,587,910,1659,1020,13
-15,0,0,-15.0,-0.0,1.5420711040496826,354.0310720826634,10,-263,237,587,910,1659,1020,13
-15,0,0,-15.0,-0.0,1.5471711158752441,343.0349836386954,10,-248,237,587,910,1659,1020,13
-15,2,0,-15.0,2.0,1.5557219982147217,330.9289954053588,10,-233,235,587,910,1659,1020,13
-17,3,0,-17.0,3.0,1.5632100105285645,316.9858040985432,10,-216,232,587,910,1659,1020,13
-16,4,0,-16.0,4.0,1.5712549686431885,303.2886413962778,10,-200,228,587,910,1659,1020,13
-17,5,0,-17.0,5.0,1.579179048538208,288.47530223573733,10,-183,223,587,910,1659,1020,13
-18,7,0,-18.0,7.0,1.5876998901367188,271.810595819957,10,-165,216,587,910,1659,1020,13
-15,8,0,-15.0,8.0,1.5952329635620117,256.44492586128507,10,-150,208,587,910,1659,1020,13
-12,8,0,-12.0,8.0,1.6035130023956299,242.98971171636055,10,-138,200,587,910,1659,1020,13
-9,8,0,-9.0,8.0,1.611151933670044,231.3114783144148,10,-129,192,587,910,1659,1020,13
-7,8,0,-7.0,8.0,1.6192529201507568,220.77137495608437,10,-122,184,587,910,1659,1020,13
-7,9,0,-7.0,9.0,1.6273400783538818,209.40391591371923,10,-115,175,587,910,1659,1020,13
-7,10,0,-7.0,10.0,1.6374459266662598,197.20294115453754,10,-108,165,587,910,1659,1020,13
-6,10,0,-6.0,10.0,1.6431739330291748,185.5505322007997,10,-102,155,587,910,1659,1020,13
-5,11,0,-5.0,11.0,1.6526679992675781,173.62315513778685,10,-97,144,587,910,1659,1020,13
-5,11,0,-5.0,11.0,1.6591660976409912,161.7188919081503,10,-92,133,587,910,1659,1020,13
-2,14,0,-2.0,14.0,1.667189121246338,149.20120642943877,10,-90,119,587,910,1659,1020,13
-1,12,0,-1.0,12.0,1.6752259731292725,139.17614738165446,10,-89,107,587,910,1659,1020,13
-2,11,0,-2.0,11.0,1.6851470470428467,129.5569372901351,10,-87,96,587,910,1659,1020,13
-1,11,0,-1.0,11.0,1.6911671161651611,120.91732712891069,10,-86,85,587,910,1659,1020,13
0,8,0,-0.0,8.0,1.6993041038513184,115.43396380615195,10,-86,77,587,910,1659,1020,13
0,8,0,-0.0,8.0,1.7072629928588867,110.25878649794764,10,-86,69,587,910,1659,1020,13
-1,8,0,-1.0,8.0,1.7151648998260498,104.62313319720452,10,-85,61,587,910,1659,1020,13
-1,8,0,-1.0,8.0,1.7237191200256348,99.32270636667126,10,-84,53,587,910,1659,1020,13
-3,7,0,-3.0,7.0,1.7318110466003418,93.15041599477696,10,-81,46,587,910,1659,1020,13
-3,6,0,-3.0,6.0,1.7412090301513672,87.65842800324451,10,-78,40,587,910,1659,1020,13
-2,6,0,-2.0,6.0,1.7472610473632812,83.2586331859946,10,-76,34,587,910,1659,1020,13
-2,5,0,-2.0,5.0,1.7552919387817383,79.47955712005447,10,-74,29,587,910,1659,1020,13
-2,5,0,-2.0,5.0,1.7640550136566162,75.8946638440411,10,-72,24,587,910,1659,1020,13
-4,5,0,-4.0,5.0,1.7711639404296875,70.60453243241541,10,-68,19,587,910,1659,1020,13
-4,5,0,-4.0,5.0,1.779270887374878,65.5133574166368,10,-64,14,587,910,1659,1020,13
-5,7,0,-5.0,7.0,1.787153959274292,59.413803110051795,10,-59,7,587,910,1659,1020,13
-5,6,0,-5.0,6.0,1.795166015625,54.00925846556311,10,-54,1,587,910,1659,1020,13
-4,4,0,-4.0,4.0,1.8031859397888184,50.08991914547278,10,-50,-3,587,910,1659,1020,13
-4,5,0,-4.0,5.0,1.8112499713897705,46.69047011971501,10,-46,-8,587,910,1659,1020,13
-4,4,0,-4.0,4.0,1.8191509246826172,43.68065933568311,10,-42,-12,587,910,1659,1020,13
-4,5,0,-4.0,5.0,1.827186107635498,41.6293165929973,10,-38,-17,587,910,1659,1020,13
-6,4,0,-6.0,4.0,1.835400104522705,38.27531841800928,10,-32,-21,587,910,1659,1020,13
-4,4,0,-4.0,4.0,1.843148946762085,37.53664875824692,10,-28,-25,587,910,1659,1020,13
-4,4,0,-4.0,4.0,1.8511888980865479,37.64306044943742,10,-24,-29,587,910,1659,1020,13
-4,3,0,-4.0,3.0,1.8592040538787842,37.73592452822641,10,-20,-32,587,910,1659,1020,13
-3,3,0,-3.0,3.0,1.869020938873291,38.91015291668744,10,-17,-35,587,910,1659,1020,13
-2,2,0,-2.0,2.0,1.8751780986785889,39.92492955535426,10,-15,-37,587,910,1659,1020,13
-2,2,0,-2.0,2.0,1.8831961154937744,41.10960958218893,10,-13,-39,587,910,1659,1020,13
-2,1,0,-2.0,1.0,1.8929579257965088,41.48493702538308,10,-11,-40,587,910,1659,1020,13
-1,0,0,-1.0,-0.0,1.8992021083831787,41.23105625617661,10,-10,-40,587,910,1659,1020,13
-2,0,0,-2.0,-0.0,1.9071729183197021,40.792156108742276,10,-8,-40,587,910,1659,1020,13
-2,0,0,-2.0,-0.0,1.9159340858459473,40.44749683231337,10,-6,-40,587,910,1659,1020,13
-2,-1,0,-2.0,-1.0,1.9231619834899902,39.20459156782532,10,-4,-39,587,910,1659,1020,13
-3,0,0,-3.0,-0.0,1.93117094039917,39.01281840626232,10,-1,-39,587,910,1659,1020,13
-2,0,0,-2.0,-0.0,1.9395248889923096,39.01281840626232,10,1,-39,587,910,1659,1020,13
-2,-2,0,-2.0,-2.0,1.9509780406951904,37.12142238654117,10,3,-37,587,910,1659,1020,13
-2,-1,0,-2.0,-1.0,1.9552218914031982,36.345563690772494,10,5,-36,587,910,1659,1020,13
-2,-3,0,-2.0,-3.0,1.9631810188293457,33.734255586866,10,7,-33,587,910,1659,1020,13
-1,-3,0,-1.0,-3.0,1.9711511135101318,31.04834939252005,10,8,-30,587,910,1659,1020,13
-2,-3,0,-2.0,-3.0,1.9794731140136719,28.792360097775937,10,10,-27,587,910,1659,1020,13
-1,-4,0,-1.0,-4.0,1.988537073135376,25.495097567963924,10,11,-23,587,910,1659,1020,13
0,-3,0,-0.0,-3.0,1.9951579570770264,22.825424421026653,10,11,-20,587,910,1659,1020,13
-1,-2,0,-1.0,-2.0,2.0031700134277344,21.633307652783937,10,12,-18,587,910,1659,1020,13
0,-2,0,-0.0,-2.0,2.0111780166625977,20.0,10,12,-16,587,910,1659,1020,13
0,-2,0,-0.0,-2.0,2.0191490650177,18.439088914585774,10,12,-14,587,910,1659,1020,13
0,-1,0,-0.0,-1.0,2.027172088623047,17.69180601295413,10,12,-13,587,910,1659,1020,13
1,-2,0,1.0,-2.0,2.035623073577881,15.556349186104045,10,11,-11,587,910,1659,1020,13
1,-1,0,1.0,-1.0,2.0431530475616455,14.142135623730951,10,10,-10,587,910,1659,1020,13
1,-1,0,1.0,-1.0,2.051208972930908,12.727922061357855,10,9,-9,587,910,1659,1020,13
2,-1,0,2.0,-1.0,2.0593879222869873,10.63014581273465,10,7,-8,587,910,1659,1020,13
2,-2,0,2.0,-2.0,2.067150115966797,7.810249675906654,10,5,-6,587,910,1659,1020,13
2,-1,0,2.0,-1.0,2.075162887573242,5.830951894845301,10,3,-5,587,910,1659,1020,13
1,-1,0,1.0,-1.0,2.0836949348449707,4.47213595499958,10,2,-4,587,910,1659,1020,13
1,-1,0,1.0,-1.0,2.0911641120910645,3.1622776601683795,10,1,-3,587,910,1659,1020,13
2,-2,0,2.0,-2.0,2.1001899242401123,1.4142135623730951,10,-1,-1,587,910,1659,1020,13
0,-1,0,-0.0,-1.0,2.115138053894043,1.0,10,-1,0,587,910,1659,1020,13
1,0,0,1.0,-0.0,2.1311750411987305,2.0,10,-2,0,587,910,1659,1020,13
0,-1,0,-0.0,-1.0,2.1406679153442383,2.23606797749979,10,-2,1,587,910,1659,1020,13
1,-1,0,1.0,-1.0,2.1472480297088623,3.605551275463989,10,-3,2,587,910,1659,1020,13
0,-1,0,-0.0,-1.0,2.1551499366760254,4.242640687119285,10,-3,3,587,910,1659,1020,13
1,-1,0,1.0,-1.0,2.1631579399108887,5.656854249492381,10,-4,4,587,910,1659,1020,13
0,-1,0,-0.0,-1.0,2.1711668968200684,6.4031242374328485,10,-4,5,587,910,1659,1020,13
1,-1,0,1.0,-1.0,2.179171085357666,7.810249675906654,10,-5,6,587,910,1659,1020,13
0,0,1,-0.0,-0.0,-0.004671335220336914,832.1568361793346,11,806,-207,1398,697,592,904,75
