dx,dy,button,rx,ry,time,distance,targetID,directionX,directionY,targetX,targetY,initMouseX,initMouseY,targetSize
0,0,0,-0.0,-0.0,0.18355321884155273,539.7381194714443,1,-64,546,900,1146,964,600,20
1,0,0,1.0,-0.0,0.20274114608764648,539.8554355464717,1,-65,546,900,1146,964,600,20
2,0,0,2.0,-0.0,0.2104203701019287,540.0954462636462,1,-67,546,900,1146,964,600,20
1,0,0,1.0,-0.0,0.21843528747558594,540.2181385596081,1,-68,546,900,1146,964,600,20
1,0,0,1.0,-0.0,0.2747502326965332,540.3426205555953,1,-69,546,900,1146,964,600,20
1,0,0,1.0,-0.0,0.28255724906921387,540.46889103745,1,-70,546,900,1146,964,600,20
2,0,0,2.0,-0.0,0.29088425636291504,540.7267925205746,1,-72,546,900,1146,964,600,20
4,0,0,4.0,-0.0,0.29856014251708984,541.2640020897428,1,-76,546,900,1146,964,600,20
5,-1,0,5.0,-1.0,0.30663418769836426,542.9647366695276,1,-81,547,900,1146,964,600,20
4,-1,0,4.0,-1.0,0.3145711421966553,544.5529731233978,1,-85,548,900,1146,964,600,20
5,-1,0,5.0,-1.0,0.32269930839538574,546.3281405789213,1,-90,549,900,1146,964,600,20
1,-1,0,1.0,-1.0,0.3308732509613037,547.4773538001342,1,-91,550,900,1146,964,600,20
0,2,0,-0.0,2.0,0.3546721935272217,545.5042754110899,1,-91,548,900,1146,964,600,20
-2,5,0,-2.0,5.0,0.3625352382659912,540.2453997990351,1,-89,543,900,1146,964,600,20
-5,7,0,-5.0,7.0,0.37058424949645996,532.5421642600693,1,-84,536,900,1146,964,600,20
-5,10,0,-5.0,10.0,0.37868237495422363,521.8994265836353,1,-79,526,900,1146,964,600,20
-5,10,0,-5.0,10.0,0.3865542411804199,511.27919582503966,1,-74,516,900,1146,964,600,20
-3,11,0,-3.0,11.0,0.39481329917907715,499.9666655772708,1,-71,505,900,1146,964,600,20
-3,11,0,-3.0,11.0,0.40256333351135254,488.6581995716104,1,-68,494,900,1146,964,600,20
-2,13,0,-2.0,13.0,0.41078925132751465,475.5069515465252,1,-66,481,900,1146,964,600,20
-3,15,0,-3.0,15.0,0.41854333877563477,460.2393007820593,1,-63,466,900,1146,964,600,20
-3,16,0,-3.0,16.0,0.4266383647918701,443.9823785126467,1,-60,450,900,1146,964,600,20
-4,17,0,-4.0,17.0,0.43466615676879883,426.6062299143245,1,-56,433,900,1146,964,600,20
-5,18,0,-5.0,18.0,0.44254326820373535,408.1219917679528,1,-51,415,900,1146,964,600,20
-6,17,0,-6.0,17.0,0.45058321952819824,390.5358910260103,1,-45,398,900,1146,964,600,20
-5,18,0,-5.0,18.0,0.4601633548736572,372.099463490856,1,-40,380,900,1146,964,600,20
-6,17,0,-6.0,17.0,0.46671223640441895,354.58880948268285,1,-34,363,900,1146,964,600,20
-4,17,0,-4.0,17.0,0.4744303226470947,337.29814281104353,1,-30,346,900,1146,964,600,20
-4,16,0,-4.0,16.0,0.48261117935180664,321.02265783477725,1,-26,330,900,1146,964,600,20
-3,15,0,-3.0,15.0,0.4907402992248535,305.83856635946154,1,-23,315,900,1146,964,600,20
-3,13,0,-3.0,13.0,0.498563289642334,292.66152712229547,1,-20,302,900,1146,964,600,20
-2,11,0,-2.0,11.0,0.5077393054962158,281.556169545424,1,-18,291,900,1146,964,600,20
-1,11,0,-1.0,11.0,0.5145771503448486,270.515596714336,1,-17,280,900,1146,964,600,20
0,9,0,-0.0,9.0,0.522698163986206,261.53268679847736,1,-17,271,900,1146,964,600,20
0,9,0,-0.0,9.0,0.5305113792419434,252.55094743687368,1,-17,262,900,1146,964,600,20
1,8,0,1.0,8.0,0.538729190826416,244.6369965264278,1,-18,254,900,1146,964,600,20
2,8,0,2.0,8.0,0.5466811656951904,236.81166909204273,1,-20,246,900,1146,964,600,20
2,7,0,2.0,7.0,0.554786205291748,230.01041644062033,1,-22,239,900,1146,964,600,20
2,6,0,2.0,6.0,0.5626821517944336,224.23279018958897,1,-24,233,900,1146,964,600,20
3,6,0,3.0,6.0,0.570547342300415,218.60008748904713,1,-27,227,900,1146,964,600,20
3,5,0,3.0,5.0,0.5784652233123779,214.01785643113362,1,-30,222,900,1146,964,600,20
4,4,0,4.0,4.0,0.5864682197570801,210.6354459283458,1,-34,218,900,1146,964,600,20
3,5,0,3.0,5.0,0.5945563316345215,206.18973148602595,1,-37,213,900,1146,964,600,20
2,3,0,2.0,3.0,0.6026341915130615,203.59073013593076,1,-39,210,900,1146,964,600,20
2,3,0,2.0,3.0,0.6106362342834473,201.0213259365034,1,-41,207,900,1146,964,600,20
1,4,0,1.0,4.0,0.6189053058624268,197.29930052945187,1,-42,203,900,1146,964,600,20
1,3,0,1.0,3.0,0.6266143321990967,194.57028132160352,1,-43,200,900,1146,964,600,20
1,3,0,1.0,3.0,0.6353821754455566,191.8539075668341,1,-44,197,900,1146,964,600,20
0,4,0,-0.0,4.0,0.6425762176513672,187.9520143873257,1,-44,193,900,1146,964,600,20
1,5,0,1.0,5.0,0.6507372856140137,183.31063085097003,1,-45,188,900,1146,964,600,20
0,5,0,-0.0,5.0,0.6585302352905273,178.45158529447292,1,-45,183,900,1146,964,600,20
1,5,0,1.0,5.0,0.6674141883850098,173.84776310850236,1,-46,178,900,1146,964,600,20
0,4,0,-0.0,4.0,0.6747102737426758,169.97777640586628,1,-46,174,900,1146,964,600,20
0,4,0,-0.0,4.0,0.6826331615447998,166.11359970201053,1,-46,170,900,1146,964,600,20
-1,5,0,-1.0,5.0,0.6904692649841309,161.0263137648707,1,-45,165,900,1146,964,600,20
-1,4,0,-1.0,4.0,0.6985721588134766,156.90416411821485,1,-44,161,900,1146,964,600,20
-2,6,0,-2.0,6.0,0.7064402103424072,150.58953888718904,1,-42,155,900,1146,964,600,20
-2,5,0,-2.0,5.0,0.7145483493804932,145.24174696260025,1,-40,150,900,1146,964,600,20
-2,7,0,-2.0,7.0,0.7235813140869141,137.96283317103658,1,-38,143,900,1146,964,600,20
-1,7,0,-1.0,7.0,0.7306642532348633,130.9432509913121,1,-37,136,900,1146,964,600,20
-2,6,0,-2.0,6.0,0.7388203144073486,124.6291201783626,1,-35,130,900,1146,964,600,20
-1,6,0,-1.0,6.0,0.7467243671417236,118.57682528356344,1,-34,124,900,1146,964,600,20
-2,7,0,-2.0,7.0,0.7545702457427979,111.29715577869086,1,-32,117,900,1146,964,600,20
-1,7,0,-1.0,7.0,0.7625572681427002,104.28473213863697,1,-31,110,900,1146,964,600,20
-1,6,0,-1.0,6.0,0.7707033157348633,98.24047302187847,1,-30,104,900,1146,964,600,20
-1,6,0,-1.0,6.0,0.7786242961883545,92.20078277586722,1,-29,98,900,1146,964,600,20
-1,5,0,-1.0,5.0,0.7866513729095459,87.12363255150623,1,-28,93,900,1146,964,600,20
-1,5,0,-1.0,5.0,0.794647216796875,82.04890004774636,1,-27,88,900,1146,964,600,20
-1,4,0,-1.0,4.0,0.8027322292327881,77.93179174792243,1,-26,84,900,1146,964,600,20
-1,6,0,-1.0,6.0,0.8105542659759521,71.9084855189009,1,-25,78,900,1146,964,600,20
-1,5,0,-1.0,5.0,0.8186533451080322,66.84399781375251,1,-24,73,900,1146,964,600,20
-2,7,0,-2.0,7.0,0.8265511989593506,59.57010852370435,1,-22,66,900,1146,964,600,20
-1,5,0,-1.0,5.0,0.8347213268280029,54.513564465157245,1,-21,61,900,1146,964,600,20
-1,5,0,-1.0,5.0,0.8426141738891602,49.464274989274024,1,-20,56,900,1146,964,600,20
-1,5,0,-1.0,5.0,0.8506312370300293,44.42425929675111,1,-19,51,900,1146,964,600,20
0,4,0,-0.0,4.0,0.858558177947998,40.695167422546305,1,-19,47,900,1146,964,600,20
-1,5,0,-1.0,5.0,0.866591215133667,35.69463863518345,1,-18,42,900,1146,964,600,20
-1,5,0,-1.0,5.0,0.8745152950286865,30.718546143004666,1,-17,37,900,1146,964,600,20
-2,5,0,-2.0,5.0,0.8825583457946777,25.341194094144583,1,-15,32,900,1146,964,600,20
-1,4,0,-1.0,4.0,0.89052414894104,21.304951684997057,1,-14,28,900,1146,964,600,20
-2,4,0,-2.0,4.0,0.8985261917114258,16.832815729997478,1,-12,24,900,1146,964,600,20
0,3,0,-0.0,3.0,0.9065523147583008,14.186773244895647,1,-12,21,900,1146,964,600,20
-1,2,0,-1.0,2.0,0.9148712158203125,11.95449840010015,1,-11,19,900,1146,964,600,20
-1,2,0,-1.0,2.0,0.922626256942749,9.72308292331602,1,-10,17,900,1146,964,600,20
-1,3,0,-1.0,3.0,0.9306902885437012,6.643316977093239,1,-9,14,900,1146,964,600,20
-1,1,0,-1.0,1.0,0.9385523796081543,5.264337522473747,1,-8,13,900,1146,964,600,20
-1,2,0,-1.0,2.0,0.9465131759643555,3.0384048104052983,1,-7,11,900,1146,964,600,20
0,2,0,-0.0,2.0,0.9545483589172363,1.4017542509913792,1,-7,9,900,1146,964,600,20
-1,0,0,-1.0,-0.0,0.9706552028656006,0.8166538263919687,1,-6,9,900,1146,964,600,20
0,1,0,-0.0,1.0,0.9796772003173828,0.0,1,-6,8,900,1146,964,600,20
0,1,0,-0.0,1.0,1.0826823711395264,-0.7804555427071129,1,-6,7,900,1146,964,600,20
0,0,1,-0.0,-0.0,1.0857253074645996,-0.7804555427071129,1,-6,7,900,1146,964,600,20
0,0,0,-0.0,-0.0,0.08825135231018066,815.052815264406,2,825,-213,1731,926,906,1139,75
0,-1,0,-0.0,-1.0,0.12427234649658203,814.8033810686595,2,825,-212,1731,926,906,1139,75
1,-2,0,1.0,-2.0,0.13235926628112793,813.338756026091,2,824,-210,1731,926,906,1139,75
1,-3,0,1.0,-3.0,0.14023232460021973,811.6330184479036,2,823,-207,1731,926,906,1139,75
1,-4,0,1.0,-4.0,0.1482832431793213,809.695340721797,2,822,-203,1731,926,906,1139,75
1,-4,0,1.0,-4.0,0.15620136260986328,807.7733423824404,2,821,-199,1731,926,906,1139,75
0,-6,0,-0.0,-6.0,0.16411542892456055,806.3801041049047,2,821,-193,1731,926,906,1139,75
3,-6,0,3.0,-6.0,0.1722862720489502,802.1024967189646,2,818,-187,1731,926,906,1139,75
4,-7,0,4.0,-7.0,0.18025541305541992,796.6642009826259,2,814,-180,1731,926,906,1139,75
6,-6,0,6.0,-6.0,0.18829631805419922,789.5228369500749,2,808,-174,1731,926,906,1139,75
9,-7,0,9.0,-7.0,0.1961524486541748,779.2658880536414,2,799,-167,1731,926,906,1139,75
14,-8,0,14.0,-8.0,0.2042224407196045,763.9406969308027,2,785,-159,1731,926,906,1139,75
19,-9,0,19.0,-9.0,0.21225333213806152,743.5485250770768,2,766,-150,1731,926,906,1139,75
23,-9,0,23.0,-9.0,0.22022342681884766,719.2605371166738,2,743,-141,1731,926,906,1139,75
28,-10,0,28.0,-10.0,0.22821640968322754,689.9016439656743,2,715,-131,1731,926,906,1139,75
33,-13,0,33.0,-13.0,0.23620939254760742,655.1329352082589,2,682,-118,1731,926,906,1139,75
35,-10,0,35.0,-10.0,0.24420833587646484,618.9519799497521,2,647,-108,1731,926,906,1139,75
40,-8,0,40.0,-8.0,0.2522432804107666,578.1820868653443,2,607,-100,1731,926,906,1139,75
39,-6,0,39.0,-6.0,0.2602224349975586,538.72562909775,2,568,-94,1731,926,906,1139,75
38,-4,0,38.0,-4.0,0.2682323455810547,500.5872022286245,2,530,-90,1731,926,906,1139,75
35,-3,0,35.0,-3.0,0.27622342109680176,465.5873058484466,2,495,-87,1731,926,906,1139,75
31,-2,0,31.0,-2.0,0.2842824459075928,434.7213160331002,2,464,-85,1731,926,906,1139,75
27,-3,0,27.0,-3.0,0.2921624183654785,407.6268098079557,2,437,-82,1731,926,906,1139,75
25,-2,0,25.0,-2.0,0.30019044876098633,382.69512744371957,2,412,-80,1731,926,906,1139,75
22,-2,0,22.0,-2.0,0.3080873489379883,360.7235220602372,2,390,-78,1731,926,906,1139,75
20,-2,0,20.0,-2.0,0.31612133979797363,340.72476752259706,2,370,-76,1731,926,906,1139,75
20,-2,0,20.0,-2.0,0.32417726516723633,320.7373338079211,2,350,-74,1731,926,906,1139,75
19,-2,0,19.0,-2.0,0.33220338821411133,301.74031351464504,2,331,-72,1731,926,906,1139,75
18,-3,0,18.0,-3.0,0.34018445014953613,283.5152102475014,2,313,-69,1731,926,906,1139,75
17,-4,0,17.0,-4.0,0.34811925888061523,266.0528006800135,2,296,-65,1731,926,906,1139,75
15,-2,0,15.0,-2.0,0.35611724853515625,250.97569341873282,2,281,-63,1731,926,906,1139,75
14,-1,0,14.0,-1.0,0.3641014099121094,237.10399486326355,2,267,-62,1731,926,906,1139,75
13,-1,0,13.0,-1.0,0.3721654415130615,224.22212769977966,2,254,-61,1731,926,906,1139,75
12,-1,0,12.0,-1.0,0.3800923824310303,212.32709439609647,2,242,-60,1731,926,906,1139,75
14,-1,0,14.0,-1.0,0.3881072998046875,198.51008470976353,2,228,-59,1731,926,906,1139,75
15,0,0,15.0,-0.0,0.39609432220458984,184.02036105300343,2,213,-59,1731,926,906,1139,75
13,-1,0,13.0,-1.0,0.40415143966674805,171.24024587000469,2,200,-58,1731,926,906,1139,75
13,0,0,13.0,-0.0,0.41271042823791504,158.78815081613087,2,187,-58,1731,926,906,1139,75
9,-1,0,9.0,-1.0,0.42032837867736816,149.90371852908652,2,178,-57,1731,926,906,1139,75
7,-1,0,7.0,-1.0,0.4282233715057373,142.93609976877903,2,171,-56,1731,926,906,1139,75
4,0,0,4.0,-0.0,0.4362354278564453,139.13914953808538,2,167,-56,1731,926,906,1139,75
2,-1,0,2.0,-1.0,0.44425535202026367,136.92527130926086,2,165,-55,1731,926,906,1139,75
1,0,0,1.0,-0.0,0.45238423347473145,135.97687706742772,2,164,-55,1731,926,906,1139,75
1,0,0,1.0,-0.0,0.4601154327392578,135.02906731131225,2,163,-55,1731,926,906,1139,75
1,-1,0,1.0,-1.0,0.47623133659362793,133.7629936490925,2,162,-54,1731,926,906,1139,75
1,-1,0,1.0,-1.0,0.4842643737792969,132.49926253526885,2,161,-53,1731,926,906,1139,75
2,-2,0,2.0,-2.0,0.4925053119659424,129.97904060090895,2,159,-51,1731,926,906,1139,75
2,-2,0,2.0,-2.0,0.5004472732543945,127.46884203398528,2,157,-49,1731,926,906,1139,75
3,-3,0,3.0,-3.0,0.5083963871002197,123.72336482291553,2,154,-46,1731,926,906,1139,75
4,-4,0,4.0,-4.0,0.5163593292236328,118.76905982896602,2,150,-42,1731,926,906,1139,75
5,-3,0,5.0,-3.0,0.5242824554443359,113.15325504297269,2,145,-39,1731,926,906,1139,75
5,-3,0,5.0,-3.0,0.5322062969207764,107.55448799674122,2,140,-36,1731,926,906,1139,75
5,-2,0,5.0,-2.0,0.5402014255523682,102.21566003866087,2,135,-34,1731,926,906,1139,75
5,-3,0,5.0,-3.0,0.5484054088592529,96.64505228402584,2,130,-31,1731,926,906,1139,75
6,-1,0,6.0,-1.0,0.5562283992767334,90.57742747053649,2,124,-30,1731,926,906,1139,75
8,-2,0,8.0,-2.0,0.5643002986907959,82.33147112141039,2,116,-28,1731,926,906,1139,75
10,-1,0,10.0,-1.0,0.5723834037780762,72.38464243210744,2,106,-27,1731,926,906,1139,75
10,-2,0,10.0,-2.0,0.580268383026123,62.20181449953424,2,96,-25,1731,926,906,1139,75
9,0,0,9.0,-0.0,0.5882554054260254,53.52071586106685,2,87,-25,1731,926,906,1139,75
11,-1,0,11.0,-1.0,0.5961942672729492,42.6994353806851,2,76,-24,1731,926,906,1139,75
10,-1,0,10.0,-1.0,0.6041922569274902,32.89277502002621,2,66,-23,1731,926,906,1139,75
8,-1,0,8.0,-1.0,0.6122283935546875,25.032249677083293,2,58,-22,1731,926,906,1139,75
7,-1,0,7.0,-1.0,0.6202874183654785,18.154328932550705,2,51,-21,1731,926,906,1139,75
6,-1,0,6.0,-1.0,0.628474235534668,12.244289008980523,2,45,-20,1731,926,906,1139,75
4,0,0,4.0,-0.0,0.6363644599914551,8.617978911828175,2,41,-20,1731,926,906,1139,75
2,-1,0,2.0,-1.0,0.6442933082580566,6.382023926967726,2,39,-19,1731,926,906,1139,75
0,-1,0,-0.0,-1.0,0.6522574424743652,5.953463189829058,2,39,-18,1731,926,906,1139,75
0,0,1,-0.0,-0.0,0.6782574653625488,5.953463189829058,2,39,-18,1731,926,906,1139,75
0,0,0,-0.0,-0.0,0.05867290496826172,1025.831717154271,3,-925,-475,767,469,1692,944,29
-3,0,0,-3.0,-0.0,0.09382796287536621,1023.1639214704685,3,-922,-475,767,469,1692,944,29
-3,0,0,-3.0,-0.0,0.10178399085998535,1020.4979458655296,3,-919,-475,767,469,1692,944,29
-5,0,0,-5.0,-0.0,0.10979604721069336,1016.0587361893495,3,-914,-475,767,469,1692,944,29
-6,0,0,-6.0,-0.0,0.11777997016906738,1010.7385032289944,3,-908,-475,767,469,1692,944,29
-4,-1,0,-4.0,-1.0,0.1256880760192871,1006.7311105281351,3,-904,-474,767,469,1692,944,29
-4,-1,0,-4.0,-1.0,0.13404488563537598,1002.724643155658,3,-900,-473,767,469,1692,944,29
-4,0,0,-4.0,-0.0,0.14185190200805664,999.1855703670478,3,-896,-473,767,469,1692,944,29
-7,-1,0,-7.0,-1.0,0.14970707893371582,992.531171896827,3,-889,-472,767,469,1692,944,29
-9,-1,0,-9.0,-1.0,0.15790987014770508,984.1187304123694,3,-880,-471,767,469,1692,944,29
-10,-1,0,-10.0,-1.0,0.16567087173461914,974.8377015466189,3,-870,-470,767,469,1692,944,29
-11,-1,0,-11.0,-1.0,0.17374706268310547,964.694027773747,3,-859,-469,767,469,1692,944,29
-11,-3,0,-11.0,-3.0,0.18178701400756836,953.6052914282766,3,-848,-466,767,469,1692,944,29
-14,-3,0,-14.0,-3.0,0.18971586227416992,939.8998899255623,3,-834,-463,767,469,1692,944,29
-18,-7,0,-18.0,-7.0,0.1976780891418457,920.7684205192214,3,-816,-456,767,469,1692,944,29
-21,-9,0,-21.0,-9.0,0.20579195022583008,898.0493407705528,3,-795,-447,767,469,1692,944,29
-25,-13,0,-25.0,-13.0,0.21370196342468262,869.8868705892174,3,-770,-434,767,469,1692,944,29
-28,-15,0,-28.0,-15.0,0.22200894355773926,838.1296849658507,3,-742,-419,767,469,1692,944,29
-31,-20,0,-31.0,-20.0,0.22988009452819824,801.3048509606698,3,-711,-399,767,469,1692,944,29
-34,-20,0,-34.0,-20.0,0.2378990650177002,761.8672566876372,3,-677,-379,767,469,1692,944,29
-38,-22,0,-38.0,-22.0,0.24572491645812988,717.9631138247337,3,-639,-357,767,469,1692,944,29
-38,-23,0,-38.0,-23.0,0.25372886657714844,673.5732688230397,3,-601,-334,767,469,1692,944,29
-40,-21,0,-40.0,-21.0,0.26187992095947266,628.4095267039554,3,-561,-313,767,469,1692,944,29
-39,-19,0,-39.0,-19.0,0.26973986625671387,585.0993239855976,3,-522,-294,767,469,1692,944,29
-36,-17,0,-36.0,-17.0,0.2778348922729492,545.396996774205,3,-486,-277,767,469,1692,944,29
-33,-14,0,-33.0,-14.0,0.2858240604400635,509.81103462985584,3,-453,-263,767,469,1692,944,29
-30,-13,0,-30.0,-13.0,0.29361987113952637,477.35425102465535,3,-423,-250,767,469,1692,944,29
-29,-11,0,-29.0,-11.0,0.30171704292297363,446.82209148433844,3,-394,-239,767,469,1692,944,29
-26,-10,0,-26.0,-10.0,0.30979394912719727,419.4339626748232,3,-368,-229,767,469,1692,944,29
-26,-11,0,-26.0,-11.0,0.317720890045166,391.5712021334848,3,-342,-218,767,469,1692,944,29
-21,-9,0,-21.0,-9.0,0.3259119987487793,369.04307851728635,3,-321,-209,767,469,1692,944,29
-19,-8,0,-19.0,-8.0,0.3337719440460205,348.7740343519641,3,-302,-201,767,469,1692,944,29
-15,-8,0,-15.0,-8.0,0.34185004234313965,331.85835250865347,3,-287,-193,767,469,1692,944,29
-10,-6,0,-10.0,-6.0,0.34996795654296875,320.21250724651225,3,-277,-187,767,469,1692,944,29
-8,-5,0,-8.0,-5.0,0.35782408714294434,310.7845439672276,3,-269,-182,767,469,1692,944,29
-7,-5,0,-7.0,-5.0,0.3657200336456299,302.18507238641104,3,-262,-177,767,469,1692,944,29
-5,-4,0,-5.0,-4.0,0.37383103370666504,295.8031633150314,3,-257,-173,767,469,1692,944,29
-7,-4,0,-7.0,-4.0,0.3818180561065674,287.7631521574495,3,-250,-169,767,469,1692,944,29
-7,-4,0,-7.0,-4.0,0.3898189067840576,279.7243605831835,3,-243,-165,767,469,1692,944,29
-7,-3,0,-7.0,-3.0,0.3978290557861328,272.2516375499012,3,-236,-162,767,469,1692,944,29
-6,-3,0,-6.0,-3.0,0.40575098991394043,265.60865508778517,3,-230,-159,767,469,1692,944,29
-6,-4,0,-6.0,-4.0,0.41384387016296387,258.3986049890858,3,-224,-155,767,469,1692,944,29
-6,-4,0,-6.0,-4.0,0.42181897163391113,251.18861212352238,3,-218,-151,767,469,1692,944,29
-6,-4,0,-6.0,-4.0,0.42990994453430176,243.97868128975307,3,-212,-147,767,469,1692,944,29
-8,-5,0,-8.0,-5.0,0.4377779960632324,234.55582873873627,3,-204,-142,767,469,1692,944,29
-9,-6,0,-9.0,-6.0,0.4457888603210449,223.7414562082095,3,-195,-136,767,469,1692,944,29
-10,-5,0,-10.0,-5.0,0.4538240432739258,212.68480319597958,3,-185,-131,767,469,1692,944,29
-8,-5,0,-8.0,-5.0,0.46182894706726074,203.26711670199887,3,-177,-126,767,469,1692,944,29
-6,-4,0,-6.0,-4.0,0.46993207931518555,196.05951537600004,3,-171,-122,767,469,1692,944,29
-6,-3,0,-6.0,-3.0,0.4778618812561035,189.43549346168678,3,-165,-119,767,469,1692,944,29
-6,-4,0,-6.0,-4.0,0.48583197593688965,182.22945752358385,3,-159,-115,767,469,1692,944,29
-4,-3,0,-4.0,-3.0,0.4936809539794922,177.23022773609824,3,-155,-112,767,469,1692,944,29
-4,-2,0,-4.0,-2.0,0.5017490386962891,172.81809334215998,3,-151,-110,767,469,1692,944,29
-3,-3,0,-3.0,-3.0,0.5098409652709961,168.62803727796015,3,-148,-107,767,469,1692,944,29
-3,-3,0,-3.0,-3.0,0.5178530216217041,164.44046626256053,3,-145,-104,767,469,1692,944,29
-2,-4,0,-2.0,-4.0,0.5260748863220215,160.49641830135081,3,-143,-100,767,469,1692,944,29
-4,-4,0,-4.0,-4.0,0.5340268611907959,154.92897915988246,3,-139,-96,767,469,1692,944,29
-3,-4,0,-3.0,-4.0,0.5418598651885986,150.19500601419034,3,-136,-92,767,469,1692,944,29
-4,-4,0,-4.0,-4.0,0.5499510765075684,144.64425612041552,3,-132,-88,767,469,1692,944,29
-4,-5,0,-4.0,-5.0,0.557887077331543,138.55490814785344,3,-128,-83,767,469,1692,944,29
-5,-6,0,-5.0,-6.0,0.5657250881195068,131.11374848717816,3,-123,-77,767,469,1692,944,29
-6,-6,0,-6.0,-6.0,0.573854923248291,122.8575902169843,3,-117,-71,767,469,1692,944,29
-5,-4,0,-5.0,-4.0,0.5819029808044434,116.51053597315428,3,-112,-67,767,469,1692,944,29
-5,-5,0,-5.0,-5.0,0.5900180339813232,109.664869708418,3,-107,-62,767,469,1692,944,29
-5,-3,0,-5.0,-3.0,0.5976660251617432,103.83462988442744,3,-102,-59,767,469,1692,944,29
-5,-4,0,-5.0,-4.0,0.6057770252227783,97.50784725749125,3,-97,-55,767,469,1692,944,29
-5,-3,0,-5.0,-3.0,0.6138360500335693,91.67875850898325,3,-92,-52,767,469,1692,944,29
-5,-4,0,-5.0,-4.0,0.6220870018005371,85.36297097007517,3,-87,-48,767,469,1692,944,29
-6,-4,0,-6.0,-4.0,0.6298930644989014,78.17917335276988,3,-81,-44,767,469,1692,944,29
-7,-4,0,-7.0,-4.0,0.6378898620605469,70.11896337925236,3,-74,-40,767,469,1692,944,29
-8,-5,0,-8.0,-5.0,0.6457080841064453,60.70609078247904,3,-66,-35,767,469,1692,944,29
-7,-3,0,-7.0,-3.0,0.6537148952484131,53.11929677819934,3,-59,-32,767,469,1692,944,29
-7,-5,0,-7.0,-5.0,0.6617538928985596,44.59180830116101,3,-52,-27,767,469,1692,944,29
-7,-5,0,-7.0,-5.0,0.6698689460754395,36.08991914547278,3,-45,-22,767,469,1692,944,29
-6,-4,0,-6.0,-4.0,0.6777670383453369,28.95346318982906,3,-39,-18,767,469,1692,944,29
-6,-4,0,-6.0,-4.0,0.685805082321167,21.84689665786984,3,-33,-14,767,469,1692,944,29
-5,-4,0,-5.0,-4.0,0.693681001663208,15.732137494637012,3,-28,-10,767,469,1692,944,29
-5,-4,0,-5.0,-4.0,0.7019388675689697,9.769728648009426,3,-23,-6,767,469,1692,944,29
-5,-3,0,-5.0,-3.0,0.7097718715667725,4.248287590894659,3,-18,-3,767,469,1692,944,29
-4,-2,0,-4.0,-2.0,0.7177319526672363,0.035668847618198996,3,-14,-1,767,469,1692,944,29
-4,-2,0,-4.0,-2.0,0.7258930206298828,-3.95012437887911,3,-10,1,767,469,1692,944,29
-3,-1,0,-3.0,-1.0,0.7338578701019287,-6.719890110719482,3,-7,2,767,469,1692,944,29
-3,-1,0,-3.0,-1.0,0.7417960166931152,-9.0,3,-4,3,767,469,1692,944,29
-2,-1,0,-2.0,-1.0,0.7498469352722168,-9.52786404500042,3,-2,4,767,469,1692,944,29
-3,0,0,-3.0,-0.0,0.7584528923034668,-9.876894374382339,3,1,4,767,469,1692,944,29
-2,-1,0,-2.0,-1.0,0.7659509181976318,-8.1690481051547,3,3,5,767,469,1692,944,29
-3,0,0,-3.0,-0.0,0.7738749980926514,-6.189750324093346,3,6,5,767,469,1692,944,29
-2,0,0,-2.0,-0.0,0.7819650173187256,-4.566018867943397,3,8,5,767,469,1692,944,29
-2,-1,0,-2.0,-1.0,0.7899699211120605,-2.3380962103093985,3,10,6,767,469,1692,944,29
-1,0,0,-1.0,-0.0,0.7977359294891357,-1.4700359138583323,3,11,6,767,469,1692,944,29
0,0,1,-0.0,-0.0,0.8122479915618896,-1.4700359138583323,3,11,6,767,469,1692,944,29
0,0,0,-0.0,-0.0,0.06770443916320801,992.6924147695105,4,993,58,1749,521,756,463,4
2,1,0,2.0,1.0,0.21657347679138184,990.63789973988,4,991,57,1749,521,756,463,4
8,4,0,8.0,4.0,0.22466754913330078,982.427752554752,4,983,53,1749,521,756,463,4
12,3,0,12.0,3.0,0.23247838020324707,970.2864804161375,4,971,50,1749,521,756,463,4
12,3,0,12.0,3.0,0.24051547050476074,958.1510297864602,4,959,47,1749,521,756,463,4
17,2,0,17.0,2.0,0.24859857559204102,941.0742282556554,4,942,45,1749,521,756,463,4
21,3,0,21.0,3.0,0.25656652450561523,919.9571573560238,4,921,42,1749,521,756,463,4
23,1,0,23.0,1.0,0.2645604610443115,896.9354815558233,4,898,41,1749,521,756,463,4
24,3,0,24.0,3.0,0.2725515365600586,872.8256969248217,4,874,38,1749,521,756,463,4
27,3,0,27.0,3.0,0.28049445152282715,845.7228320624613,4,847,35,1749,521,756,463,4
30,7,0,30.0,7.0,0.28856849670410156,815.4796633556091,4,817,28,1749,521,756,463,4
33,7,0,33.0,7.0,0.2964794635772705,782.2811995706642,4,784,21,1749,521,756,463,4
35,7,0,35.0,7.0,0.30466651916503906,747.1308296953209,4,749,14,1749,521,756,463,4
36,7,0,36.0,7.0,0.3125324249267578,711.0343610233662,4,713,7,1749,521,756,463,4
37,8,0,37.0,8.0,0.32047152519226074,674.0007396445658,4,676,-1,1749,521,756,463,4
38,7,0,38.0,7.0,0.3285095691680908,636.0501547684163,4,638,-8,1749,521,756,463,4
37,7,0,37.0,7.0,0.33650851249694824,599.187158878165,4,601,-15,1749,521,756,463,4
36,5,0,36.0,5.0,0.34462451934814453,563.3538714822779,4,565,-20,1749,521,756,463,4
36,6,0,36.0,6.0,0.3526005744934082,527.6385559983337,4,529,-26,1749,521,756,463,4
38,5,0,38.0,5.0,0.3607363700866699,489.97764176840394,4,491,-31,1749,521,756,463,4
37,5,0,37.0,5.0,0.36861348152160645,453.42507616511415,4,454,-36,1749,521,756,463,4
40,4,0,40.0,4.0,0.376678466796875,413.9278783635451,4,414,-40,1749,521,756,463,4
38,4,0,38.0,4.0,0.3845803737640381,376.565714242587,4,376,-44,1749,521,756,463,4
35,4,0,35.0,4.0,0.3925974369049072,342.3617284194049,4,341,-48,1749,521,756,463,4
32,2,0,32.0,2.0,0.4005875587463379,311.0191687421075,4,309,-50,1749,521,756,463,4
28,3,0,28.0,3.0,0.40873146057128906,283.9545418418809,4,281,-53,1749,521,756,463,4
24,1,0,24.0,1.0,0.4166405200958252,260.6118809193522,4,257,-54,1749,521,756,463,4
18,2,0,18.0,2.0,0.4246854782104492,243.47301277329856,4,239,-56,1749,521,756,463,4
15,1,0,15.0,1.0,0.4326605796813965,229.1384866265244,4,224,-57,1749,521,756,463,4
14,1,0,14.0,1.0,0.4406914710998535,215.86234185833953,4,210,-58,1749,521,756,463,4
11,1,0,11.0,1.0,0.4487135410308838,205.56203891848818,4,199,-59,1749,521,756,463,4
9,0,0,9.0,-0.0,0.4565775394439697,196.94974239742055,4,190,-59,1749,521,756,463,4
8,0,0,8.0,-0.0,0.46478939056396484,189.3243319601561,4,182,-59,1749,521,756,463,4
7,0,0,7.0,-0.0,0.4727504253387451,182.67809832245945,4,175,-59,1749,521,756,463,4
5,-2,0,5.0,-2.0,0.4805874824523926,177.30142219179413,4,170,-57,1749,521,756,463,4
4,-2,0,4.0,-2.0,0.4886023998260498,172.8742405273001,4,166,-55,1749,521,756,463,4
1,-1,0,1.0,-1.0,0.4967315196990967,171.61163555476344,4,165,-54,1749,521,756,463,4
1,-1,0,1.0,-1.0,0.5046985149383545,170.35138525698017,4,164,-53,1749,521,756,463,4
0,-1,0,-0.0,-1.0,0.512751579284668,170.04650534085255,4,164,-52,1749,521,756,463,4
1,-1,0,1.0,-1.0,0.5206034183502197,168.79227148791014,4,163,-51,1749,521,756,463,4
1,-1,0,1.0,-1.0,0.52862548828125,167.54055562018192,4,162,-50,1749,521,756,463,4
2,-1,0,2.0,-1.0,0.5365943908691406,165.3349933516597,4,160,-49,1749,521,756,463,4
3,-1,0,3.0,-1.0,0.5446414947509766,162.17368851311102,4,157,-48,1749,521,756,463,4
3,-2,0,3.0,-2.0,0.5526154041290283,158.72336482291553,4,154,-46,1749,521,756,463,4
3,-2,0,3.0,-2.0,0.560692548751831,155.2800050864699,4,151,-44,1749,521,756,463,4
4,-3,0,4.0,-3.0,0.5687713623046875,150.6106156202772,4,147,-41,1749,521,756,463,4
5,-2,0,5.0,-2.0,0.5765533447265625,145.2582765076381,4,142,-39,1749,521,756,463,4
3,-2,0,3.0,-2.0,0.5847184658050537,141.8401890988746,4,139,-37,1749,521,756,463,4
3,-2,0,3.0,-2.0,0.5926873683929443,138.4314779527724,4,136,-35,1749,521,756,463,4
3,-2,0,3.0,-2.0,0.6005945205688477,135.03284277865654,4,133,-33,1749,521,756,463,4
3,-2,0,3.0,-2.0,0.6086573600769043,131.64505228402584,4,130,-31,1749,521,756,463,4
2,-2,0,2.0,-2.0,0.6166355609893799,129.24404748406687,4,128,-29,1749,521,756,463,4
3,-2,0,3.0,-2.0,0.6246623992919922,125.88275880665071,4,125,-27,1749,521,756,463,4
3,-2,0,3.0,-2.0,0.6326663494110107,122.53513560437472,4,122,-25,1749,521,756,463,4
4,-2,0,4.0,-2.0,0.6405525207519531,118.22063050907694,4,118,-23,1749,521,756,463,4
5,-3,0,5.0,-3.0,0.6485633850097656,112.75626344561765,4,113,-20,1749,521,756,463,4
5,-2,0,5.0,-2.0,0.6565144062042236,107.48972554536796,4,108,-18,1749,521,756,463,4
5,-1,0,5.0,-1.0,0.6646254062652588,102.39348638684312,4,103,-17,1749,521,756,463,4
5,-2,0,5.0,-2.0,0.6725695133209229,97.14131328563285,4,98,-15,1749,521,756,463,4
6,-1,0,6.0,-1.0,0.6806104183197021,91.05912099305473,4,92,-14,1749,521,756,463,4
5,-1,0,5.0,-1.0,0.6885695457458496,85.96590248499699,4,87,-13,1749,521,756,463,4
5,-2,0,5.0,-2.0,0.69661545753479,80.73451516749222,4,82,-11,1749,521,756,463,4
5,-1,0,5.0,-1.0,0.7045285701751709,75.64663547121665,4,77,-10,1749,521,756,463,4
4,-1,0,4.0,-1.0,0.7125544548034668,71.55270219373317,4,73,-9,1749,521,756,463,4
4,0,0,4.0,-0.0,0.7205655574798584,67.58448102845921,4,69,-9,1749,521,756,463,4
4,-1,0,4.0,-1.0,0.7286674976348877,63.49045732013177,4,65,-8,1749,521,756,463,4
2,-1,0,2.0,-1.0,0.7365524768829346,61.387695966961914,4,63,-7,1749,521,756,463,4
2,-1,0,2.0,-1.0,0.7446994781494141,59.29437168288782,4,61,-6,1749,521,756,463,4
2,0,0,2.0,-0.0,0.7526094913482666,57.30430001273095,4,59,-6,1749,521,756,463,4
2,-1,0,2.0,-1.0,0.7607345581054688,55.21887800367987,4,57,-5,1749,521,756,463,4
1,-1,0,1.0,-1.0,0.768580436706543,54.142675390472796,4,56,-4,1749,521,756,463,4
1,-1,0,1.0,-1.0,0.7767055034637451,53.08175741568164,4,55,-3,1749,521,756,463,4
2,-1,0,2.0,-1.0,0.7846405506134033,51.03772242470448,4,53,-2,1749,521,756,463,4
2,-1,0,2.0,-1.0,0.7925825119018555,49.0098029794274,4,51,-1,1749,521,756,463,4
1,-1,0,1.0,-1.0,0.8005585670471191,48.0,4,50,0,1749,521,756,463,4
2,0,0,2.0,-0.0,0.8085105419158936,46.0,4,48,0,1749,521,756,463,4
1,-1,0,1.0,-1.0,0.8166375160217285,45.01063709417264,4,47,1,1749,521,756,463,4
1,0,0,1.0,-0.0,0.8246374130249023,44.010868281309364,4,46,1,1749,521,756,463,4
2,-1,0,2.0,-1.0,0.8326103687286377,42.04543109109048,4,44,2,1749,521,756,463,4
2,0,0,2.0,-0.0,0.8485794067382812,40.04759208325728,4,42,2,1749,521,756,463,4
1,-1,0,1.0,-1.0,0.8568224906921387,39.10960958218893,4,41,3,1749,521,756,463,4
2,0,0,2.0,-0.0,0.8646664619445801,37.11521443121589,4,39,3,1749,521,756,463,4
2,0,0,2.0,-0.0,0.8726613521575928,35.12142238654117,4,37,3,1749,521,756,463,4
2,0,0,2.0,-0.0,0.8806865215301514,33.12833614050059,4,35,3,1749,521,756,463,4
3,0,0,3.0,-0.0,0.8887064456939697,30.140317359976393,4,32,3,1749,521,756,463,4
2,0,0,2.0,-0.0,0.8966073989868164,28.14962686336267,4,30,3,1749,521,756,463,4
2,0,0,2.0,-0.0,0.9045803546905518,26.160255680657446,4,28,3,1749,521,756,463,4
1,0,0,1.0,-0.0,0.9124655723571777,25.16615541441225,4,27,3,1749,521,756,463,4
2,0,0,2.0,-0.0,0.9204983711242676,23.179356624028344,4,25,3,1749,521,756,463,4
2,0,0,2.0,-0.0,0.9286065101623535,21.194827009486403,4,23,3,1749,521,756,463,4
1,0,0,1.0,-0.0,0.9365603923797607,20.20360331117452,4,22,3,1749,521,756,463,4
2,0,0,2.0,-0.0,0.9446265697479248,18.223748416156685,4,20,3,1749,521,756,463,4
2,0,0,2.0,-0.0,0.9527573585510254,16.24828759089466,4,18,3,1749,521,756,463,4
1,0,0,1.0,-0.0,0.9604804515838623,15.262676501632068,4,17,3,1749,521,756,463,4
2,0,0,2.0,-0.0,0.9685604572296143,13.297058540778355,4,15,3,1749,521,756,463,4
1,0,0,1.0,-0.0,0.9765264987945557,12.317821063276353,4,14,3,1749,521,756,463,4
2,0,0,2.0,-0.0,0.9845783710479736,10.36931687685298,4,12,3,1749,521,756,463,4
1,1,0,1.0,1.0,0.9924983978271484,9.180339887498949,4,11,2,1749,521,756,463,4
1,0,0,1.0,-0.0,1.0005135536193848,8.198039027185569,4,10,2,1749,521,756,463,4
1,0,0,1.0,-0.0,1.0085265636444092,7.219544457292887,4,9,2,1749,521,756,463,4
2,0,0,2.0,-0.0,1.0164463520050049,5.280109889280518,4,7,2,1749,521,756,463,4
2,0,0,2.0,-0.0,1.0245234966278076,3.3851648071345037,4,5,2,1749,521,756,463,4
2,0,0,2.0,-0.0,1.0324513912200928,1.6055512754639891,4,3,2,1749,521,756,463,4
1,0,0,1.0,-0.0,1.040543556213379,0.8284271247461903,4,2,2,1749,521,756,463,4
2,0,0,2.0,-0.0,1.0485475063323975,0.0,4,0,2,1749,521,756,463,4
1,0,0,1.0,-0.0,1.0645055770874023,0.2360679774997898,4,-1,2,1749,521,756,463,4
1,0,0,1.0,-0.0,1.0965054035186768,0.8284271247461903,4,-2,2,1749,521,756,463,4
0,0,1,-0.0,-0.0,1.1685824394226074,0.8284271247461903,4,-2,2,1749,521,756,463,4
0,0,0,-0.0,-0.0,0.08935213088989258,1508.1532602978043,5,-1512,-235,239,284,1751,519,45
-1,1,0,-1.0,1.0,0.18048405647277832,1507.319129547525,5,-1511,-236,239,284,1751,519,45
-2,0,0,-2.0,-0.0,0.1885221004486084,1505.343117966621,5,-1509,-236,239,284,1751,519,45
-2,0,0,-2.0,-0.0,0.19645905494689941,1503.3671689137668,5,-1507,-236,239,284,1751,519,45
-4,1,0,-4.0,1.0,0.20439815521240234,1499.5708987753412,5,-1503,-237,239,284,1751,519,45
-7,0,0,-7.0,-0.0,0.21234512329101562,1492.656726786634,5,-1496,-237,239,284,1751,519,45
-8,2,0,-8.0,2.0,0.2203371524810791,1485.0716638567656,5,-1488,-239,239,284,1751,519,45
-10,2,0,-10.0,2.0,0.22844314575195312,1475.519615898236,5,-1478,-241,239,284,1751,519,45
-13,2,0,-13.0,2.0,0.2364211082458496,1463.0164982248514,5,-1465,-243,239,284,1751,519,45
-12,1,0,-12.0,1.0,0.2444441318511963,1451.3448340425944,5,-1453,-244,239,284,1751,519,45
-13,1,0,-13.0,1.0,0.2523772716522217,1438.6933285258751,5,-1440,-245,239,284,1751,519,45
-14,0,0,-14.0,-0.0,0.26037025451660156,1424.8935689953148,5,-1426,-245,239,284,1751,519,45
-16,0,0,-16.0,-0.0,0.2682621479034424,1409.127178136171,5,-1410,-245,239,284,1751,519,45
-20,-3,0,-20.0,-3.0,0.2763831615447998,1388.9089268978348,5,-1390,-242,239,284,1751,519,45
-27,-4,0,-27.0,-4.0,0.28440308570861816,1361.6231423332006,5,-1363,-238,239,284,1751,519,45
-39,-7,0,-39.0,-7.0,0.29237914085388184,1322.000372023758,5,-1324,-231,239,284,1751,519,45
-50,-9,0,-50.0,-9.0,0.3003251552581787,1271.1975873778918,5,-1274,-222,239,284,1751,519,45
-58,-11,0,-58.0,-11.0,0.3084242343902588,1212.17057167962,5,-1216,-211,239,284,1751,519,45
-68,-14,0,-68.0,-14.0,0.31643128395080566,1142.7802367828876,5,-1148,-197,239,284,1751,519,45
-70,-13,0,-70.0,-13.0,0.3243231773376465,1071.590416929483,5,-1078,-184,239,284,1751,519,45
-73,-11,0,-73.0,-11.0,0.3323061466217041,997.7813491136225,5,-1005,-173,239,284,1751,519,45
-75,-13,0,-75.0,-13.0,0.34029126167297363,921.6630754670864,5,-930,-160,239,284,1751,519,45
-72,-12,0,-72.0,-12.0,0.34819817543029785,848.6710056042983,5,-858,-148,239,284,1751,519,45
-67,-11,0,-67.0,-11.0,0.35617613792419434,780.7764321403563,5,-791,-137,239,284,1751,519,45
-60,-11,0,-60.0,-11.0,0.3641800880432129,719.779616867436,5,-731,-126,239,284,1751,519,45
-54,-9,0,-54.0,-9.0,0.37227511405944824,665.0356613742841,5,-677,-117,239,284,1751,519,45
-44,-9,0,-44.0,-9.0,0.3801562786102295,620.1471793911423,5,-633,-108,239,284,1751,519,45
-36,-8,0,-36.0,-8.0,0.38820505142211914,583.3172721804657,5,-597,-100,239,284,1751,519,45
-30,-8,0,-30.0,-8.0,0.396212100982666,552.4153549479679,5,-567,-92,239,284,1751,519,45
-23,-7,0,-23.0,-7.0,0.4042541980743408,528.600581183856,5,-544,-85,239,284,1751,519,45
-19,-5,0,-19.0,-5.0,0.4122931957244873,509.06026023418474,5,-525,-80,239,284,1751,519,45
-14,-6,0,-14.0,-6.0,0.4201831817626953,494.33032062818086,5,-511,-74,239,284,1751,519,45
-13,-5,0,-13.0,-5.0,0.4283430576324463,480.7573967630909,5,-498,-69,239,284,1751,519,45
-9,-4,0,-9.0,-4.0,0.43634510040283203,471.30112507473564,5,-489,-65,239,284,1751,519,45
-6,-3,0,-6.0,-3.0,0.4442901611328125,464.96303761168565,5,-483,-62,239,284,1751,519,45
-4,-3,0,-4.0,-3.0,0.45240020751953125,460.6199332808375,5,-479,-59,239,284,1751,519,45
-3,-3,0,-3.0,-3.0,0.46042823791503906,457.2827975214633,5,-476,-56,239,284,1751,519,45
-3,-3,0,-3.0,-3.0,0.46822404861450195,453.96008235985505,5,-473,-53,239,284,1751,519,45
-4,-5,0,-4.0,-5.0,0.47626614570617676,449.4498912928075,5,-469,-48,239,284,1751,519,45
-5,-4,0,-5.0,-4.0,0.48430323600769043,444.0815379308646,5,-464,-44,239,284,1751,519,45
-8,-5,0,-8.0,-5.0,0.492307186126709,435.6647244435603,5,-456,-39,239,284,1751,519,45
-10,-5,0,-10.0,-5.0,0.5003421306610107,425.29408670359146,5,-446,-34,239,284,1751,519,45
-13,-5,0,-13.0,-5.0,0.5090281963348389,411.9700450491946,5,-433,-29,239,284,1751,519,45
-15,-4,0,-15.0,-4.0,0.5163650512695312,396.74694028732915,5,-418,-25,239,284,1751,519,45
-14,-3,0,-14.0,-3.0,0.524334192276001,382.5985664828782,5,-404,-22,239,284,1751,519,45
-13,-3,0,-13.0,-3.0,0.5322742462158203,369.4613646325778,5,-391,-19,239,284,1751,519,45
-14,-2,0,-14.0,-2.0,0.5404262542724609,355.3830944809266,5,-377,-17,239,284,1751,519,45
-13,-2,0,-13.0,-2.0,0.5483500957489014,342.3089348341597,5,-364,-15,239,284,1751,519,45
-11,-2,0,-11.0,-2.0,0.5564100742340088,331.2392956623031,5,-353,-13,239,284,1751,519,45
-11,-1,0,-11.0,-1.0,0.5643510818481445,320.21046155838076,5,-342,-12,239,284,1751,519,45
-10,0,0,-10.0,-0.0,0.5722272396087646,310.2167966855379,5,-332,-12,239,284,1751,519,45
-10,0,0,-10.0,-0.0,0.5805041790008545,300.2235249015813,5,-322,-12,239,284,1751,519,45
-10,0,0,-10.0,-0.0,0.5885522365570068,290.23068395018447,5,-312,-12,239,284,1751,519,45
-11,0,0,-11.0,-0.0,0.596447229385376,279.23910768690047,5,-301,-12,239,284,1751,519,45
-13,0,0,-13.0,-0.0,0.6044571399688721,266.2498915871435,5,-288,-12,239,284,1751,519,45
-14,1,0,-14.0,1.0,0.6123611927032471,252.30822080280421,5,-274,-13,239,284,1751,519,45
-15,2,0,-15.0,2.0,0.620307207107544,237.43399931389104,5,-259,-15,239,284,1751,519,45
-15,2,0,-15.0,2.0,0.6283812522888184,222.59149617270018,5,-244,-17,239,284,1751,519,45
-15,1,0,-15.0,1.0,0.6365101337432861,207.7063342618135,5,-229,-18,239,284,1751,519,45
-15,1,0,-15.0,1.0,0.6444170475006104,192.84180226389836,5,-214,-19,239,284,1751,519,45
-14,0,0,-14.0,-0.0,0.6523520946502686,178.90047287151916,5,-200,-19,239,284,1751,519,45
-15,0,0,-15.0,-0.0,0.6604211330413818,163.9731163367437,5,-185,-19,239,284,1751,519,45
-13,-1,0,-13.0,-1.0,0.6687922477722168,150.9392957080605,5,-172,-18,239,284,1751,519,45
-11,-1,0,-11.0,-1.0,0.6767141819000244,139.89502771858065,5,-161,-17,239,284,1751,519,45
-11,-3,0,-11.0,-3.0,0.6844501495361328,128.65191668213185,5,-150,-14,239,284,1751,519,45
-11,-2,0,-11.0,-2.0,0.6923282146453857,117.51702405083043,5,-139,-12,239,284,1751,519,45
-10,-1,0,-10.0,-1.0,0.7003202438354492,107.46814279968643,5,-129,-11,239,284,1751,519,45
-10,-3,0,-10.0,-3.0,0.7083771228790283,97.26860441876563,5,-119,-8,239,284,1751,519,45
-10,-2,0,-10.0,-2.0,0.7164421081542969,87.16501271011697,5,-109,-6,239,284,1751,519,45
-9,-1,0,-9.0,-1.0,0.7243492603302002,78.12492197250393,5,-100,-5,239,284,1751,519,45
-9,-3,0,-9.0,-3.0,0.732525110244751,69.02197536858887,5,-91,-2,239,284,1751,519,45
-9,-2,0,-9.0,-2.0,0.7411482334136963,60.0,5,-82,0,239,284,1751,519,45
-9,-2,0,-9.0,-2.0,0.7483642101287842,51.02739212103907,5,-73,2,239,284,1751,519,45
-8,-1,0,-8.0,-1.0,0.7564561367034912,43.06919393998976,5,-65,3,239,284,1751,519,45
-6,-1,0,-6.0,-1.0,0.7644140720367432,37.135437767890075,5,-59,4,239,284,1751,519,45
-4,-1,0,-4.0,-1.0,0.7724151611328125,33.226805085936306,5,-55,5,239,284,1751,519,45
-2,0,0,-2.0,-0.0,0.7803530693054199,31.235326616824658,5,-53,5,239,284,1751,519,45
-2,0,0,-2.0,-0.0,0.7883610725402832,29.24451190127583,5,-51,5,239,284,1751,519,45
-2,-1,0,-2.0,-1.0,0.7963571548461914,27.365980188789933,5,-49,6,239,284,1751,519,45
-2,0,0,-2.0,-0.0,0.804450273513794,25.381430961928537,5,-47,6,239,284,1751,519,45
-2,-1,0,-2.0,-1.0,0.8123452663421631,23.541190146942803,5,-45,7,239,284,1751,519,45
-3,0,0,-3.0,-0.0,0.8205161094665527,20.579337712087536,5,-42,7,239,284,1751,519,45
-3,-1,0,-3.0,-1.0,0.828423261642456,17.812058474788763,5,-39,8,239,284,1751,519,45
-4,0,0,-4.0,-0.0,0.8364171981811523,13.90264614203248,5,-35,8,239,284,1751,519,45
-4,-1,0,-4.0,-1.0,0.844534158706665,10.280024783137947,5,-31,9,239,284,1751,519,45
-3,0,0,-3.0,-0.0,0.8523941040039062,7.410882339705484,5,-28,9,239,284,1751,519,45
-2,0,0,-2.0,-0.0,0.8605411052703857,5.513632984395208,5,-26,9,239,284,1751,519,45
-1,0,0,-1.0,-0.0,0.8683061599731445,4.570660511172846,5,-25,9,239,284,1751,519,45
-1,0,0,-1.0,-0.0,0.8765010833740234,3.632011235952593,5,-24,9,239,284,1751,519,45
0,0,1,-0.0,-0.0,0.8803162574768066,3.632011235952593,5,-24,9,239,284,1751,519,45
0,0,0,-0.0,-0.0,0.06632161140441895,1054.24309995375,6,933,493,1196,768,263,275,3
2,1,0,2.0,1.0,0.1543745994567871,1052.0075973135235,6,931,492,1196,768,263,275,3
5,1,0,5.0,1.0,0.16237759590148926,1047.120699156352,6,926,491,1196,768,263,275,3
7,2,0,7.0,2.0,0.17019963264465332,1040.000480307286,6,919,489,1196,768,263,275,3
7,4,0,7.0,4.0,0.17833161354064941,1031.941915114301,6,912,485,1196,768,263,275,3
11,4,0,11.0,4.0,0.18626761436462402,1020.3530241792013,6,901,481,1196,768,263,275,3
11,6,0,11.0,6.0,0.19440269470214844,1007.8235722860563,6,890,475,1196,768,263,275,3
13,6,0,13.0,6.0,0.20315170288085938,993.5300397675276,6,877,469,1196,768,263,275,3
17,10,0,17.0,10.0,0.21104764938354492,973.8235737814305,6,860,459,1196,768,263,275,3
19,12,0,19.0,12.0,0.21827268600463867,951.412725660467,6,841,447,1196,768,263,275,3
25,12,0,25.0,12.0,0.22636961936950684,923.7058991917376,6,816,435,1196,768,263,275,3
32,17,0,32.0,17.0,0.23439860343933105,887.4705960244266,6,784,418,1196,768,263,275,3
38,18,0,38.0,18.0,0.24230360984802246,845.4726811894168,6,746,400,1196,768,263,275,3
41,19,0,41.0,19.0,0.2504606246948242,800.3650853387612,6,705,381,1196,768,263,275,3
38,18,0,38.0,18.0,0.2583436965942383,758.3800102715372,6,667,363,1196,768,263,275,3
35,18,0,35.0,18.0,0.2663075923919678,719.0340269737258,6,632,345,1196,768,263,275,3
34,18,0,34.0,18.0,0.27417850494384766,680.5665778190712,6,598,327,1196,768,263,275,3
32,17,0,32.0,17.0,0.2826406955718994,644.3340220382,6,566,310,1196,768,263,275,3
32,16,0,32.0,16.0,0.2904086112976074,608.5834643426608,6,534,294,1196,768,263,275,3
31,16,0,31.0,16.0,0.2984046936035156,573.7112318373463,6,503,278,1196,768,263,275,3
30,15,0,30.0,15.0,0.3064846992492676,540.2005173685627,6,473,263,1196,768,263,275,3
31,16,0,31.0,16.0,0.31439757347106934,505.3328944479116,6,442,247,1196,768,263,275,3
28,15,0,28.0,15.0,0.3224306106567383,473.5734927279441,6,414,232,1196,768,263,275,3
29,17,0,29.0,17.0,0.3304576873779297,439.9648512069868,6,385,215,1196,768,263,275,3
28,15,0,28.0,15.0,0.338336706161499,408.20532743355136,6,357,200,1196,768,263,275,3
25,15,0,25.0,15.0,0.3465306758880615,379.06446821559103,6,332,185,1196,768,263,275,3
23,14,0,23.0,14.0,0.35451555252075195,352.1600203873592,6,309,171,1196,768,263,275,3
19,11,0,19.0,11.0,0.36257266998291016,330.2099032335839,6,290,160,1196,768,263,275,3
18,12,0,18.0,12.0,0.37027955055236816,308.6578757273905,6,272,148,1196,768,263,275,3
17,12,0,17.0,12.0,0.3783395290374756,288.0,6,255,136,1196,768,263,275,3
16,11,0,16.0,11.0,0.3863246440887451,268.7146640433182,6,239,125,1196,768,263,275,3
15,11,0,15.0,11.0,0.39437150955200195,250.34040662018512,6,224,114,1196,768,263,275,3
15,9,0,15.0,9.0,0.40244054794311523,232.89313799254566,6,209,105,1196,768,263,275,3
15,8,0,15.0,8.0,0.4103055000305176,215.8985938174796,6,194,97,1196,768,263,275,3
13,7,0,13.0,7.0,0.41835451126098633,201.1410398706804,6,181,90,1196,768,263,275,3
13,6,0,13.0,6.0,0.42641448974609375,186.82971010998233,6,168,84,1196,768,263,275,3
12,6,0,12.0,6.0,0.434356689453125,173.41330224498358,6,156,78,1196,768,263,275,3
10,5,0,10.0,5.0,0.4425675868988037,162.23296235748464,6,146,73,1196,768,263,275,3
7,4,0,7.0,4.0,0.45032763481140137,154.18376203714098,6,139,69,1196,768,263,275,3
6,4,0,6.0,4.0,0.4583466053009033,147.03377992877165,6,133,65,1196,768,263,275,3
5,2,0,5.0,2.0,0.4662795066833496,141.6639407839276,6,128,63,1196,768,263,275,3
4,3,0,4.0,3.0,0.4743344783782959,136.7534028617805,6,124,60,1196,768,263,275,3
3,2,0,3.0,2.0,0.4824676513671875,133.18271125595876,6,121,58,1196,768,263,275,3
3,1,0,3.0,1.0,0.49138569831848145,130.04579352272242,6,118,57,1196,768,263,275,3
1,0,0,1.0,-0.0,0.49854063987731934,129.14607178090316,6,117,57,1196,768,263,275,3
1,1,0,1.0,1.0,0.5063827037811279,127.80993750483694,6,116,56,1196,768,263,275,3
1,0,0,1.0,-0.0,0.5144586563110352,126.91012469699183,6,115,56,1196,768,263,275,3
2,2,0,2.0,2.0,0.522364616394043,124.23977004130916,6,113,54,1196,768,263,275,3
2,0,0,2.0,-0.0,0.5303375720977783,122.4382436686459,6,111,54,1196,768,263,275,3
3,1,0,3.0,1.0,0.5383436679840088,119.30378215168466,6,108,53,1196,768,263,275,3
3,2,0,3.0,2.0,0.5462636947631836,115.73045875006231,6,105,51,1196,768,263,275,3
5,1,0,5.0,1.0,0.5543785095214844,110.80339887498948,6,100,50,1196,768,263,275,3
5,2,0,5.0,2.0,0.5624024868011475,105.4377752492037,6,95,48,1196,768,263,275,3
5,2,0,5.0,2.0,0.5702974796295166,100.07423014794622,6,90,46,1196,768,263,275,3
3,2,0,3.0,2.0,0.5784566402435303,96.49358953285082,6,87,44,1196,768,263,275,3
2,2,0,2.0,2.0,0.5862236022949219,93.81033698917012,6,85,42,1196,768,263,275,3
2,1,0,2.0,1.0,0.5941824913024902,91.57429448826494,6,83,41,1196,768,263,275,3
1,1,0,1.0,1.0,0.6022086143493652,90.23595782365635,6,82,40,1196,768,263,275,3
2,2,0,2.0,2.0,0.6101725101470947,87.56635930193812,6,80,38,1196,768,263,275,3
3,2,0,3.0,2.0,0.6183974742889404,84.0,6,77,36,1196,768,263,275,3
4,3,0,4.0,3.0,0.626422643661499,79.11242100947892,6,73,33,1196,768,263,275,3
3,2,0,3.0,2.0,0.634326696395874,75.55716818169282,6,70,31,1196,768,263,275,3
4,3,0,4.0,3.0,0.6424045562744141,70.69379331573968,6,66,28,1196,768,263,275,3
2,3,0,2.0,3.0,0.6502125263214111,67.70953354520753,6,64,25,1196,768,263,275,3
4,2,0,4.0,2.0,0.6584436893463135,63.25729530566937,6,60,23,1196,768,263,275,3
3,3,0,3.0,3.0,0.6663916110992432,59.40695324215582,6,57,20,1196,768,263,275,3
4,2,0,4.0,2.0,0.6747725009918213,54.97320787662612,6,53,18,1196,768,263,275,3
5,2,0,5.0,2.0,0.6822855472564697,49.59644256269407,6,48,16,1196,768,263,275,3
4,1,0,4.0,1.0,0.690340518951416,45.486557196677836,6,44,15,1196,768,263,275,3
2,1,0,2.0,1.0,0.6984724998474121,43.27188724235731,6,42,14,1196,768,263,275,3
3,2,0,3.0,2.0,0.7065176963806152,39.80441152620633,6,39,12,1196,768,263,275,3
3,1,0,3.0,1.0,0.7146005630493164,36.64306044943742,6,36,11,1196,768,263,275,3
3,2,0,3.0,2.0,0.7224586009979248,33.20526275297414,6,33,9,1196,768,263,275,3
3,1,0,3.0,1.0,0.7302896976470947,30.04834939252005,6,30,8,1196,768,263,275,3
3,1,0,3.0,1.0,0.7382566928863525,26.892651361962706,6,27,7,1196,768,263,275,3
2,1,0,2.0,1.0,0.7462666034698486,24.709920264364882,6,25,6,1196,768,263,275,3
2,1,0,2.0,1.0,0.7544426918029785,22.53720459187964,6,23,5,1196,768,263,275,3
2,1,0,2.0,1.0,0.7624366283416748,20.37755832643195,6,21,4,1196,768,263,275,3
2,0,0,2.0,-0.0,0.770439624786377,18.4164878389476,6,19,4,1196,768,263,275,3
2,1,0,2.0,1.0,0.7783305644989014,16.26267650163207,6,17,3,1196,768,263,275,3
3,1,0,3.0,1.0,0.7864174842834473,13.142135623730951,6,14,2,1196,768,263,275,3
3,0,0,3.0,-0.0,0.7944145202636719,10.180339887498949,6,11,2,1196,768,263,275,3
2,1,0,2.0,1.0,0.8023726940155029,8.055385138137417,6,9,1,1196,768,263,275,3
2,0,0,2.0,-0.0,0.8102185726165771,6.0710678118654755,6,7,1,1196,768,263,275,3
2,1,0,2.0,1.0,0.8184247016906738,4.0,6,5,0,1196,768,263,275,3
2,0,0,2.0,-0.0,0.8265156745910645,2.0,6,3,0,1196,768,263,275,3
2,1,0,2.0,1.0,0.8343756198883057,0.41421356237309515,6,1,-1,1196,768,263,275,3
2,0,0,2.0,-0.0,0.8423366546630859,0.41421356237309515,6,-1,-1,1196,768,263,275,3
1,0,0,1.0,-0.0,0.8503086566925049,1.2360679774997898,6,-2,-1,1196,768,263,275,3
1,0,0,1.0,-0.0,0.8583145141601562,2.1622776601683795,6,-3,-1,1196,768,263,275,3
2,0,0,2.0,-0.0,0.8664236068725586,4.0990195135927845,6,-5,-1,1196,768,263,275,3
1,0,0,1.0,-0.0,0.8824925422668457,5.082762530298219,6,-6,-1,1196,768,263,275,3
1,0,0,1.0,-0.0,0.890467643737793,6.0710678118654755,6,-7,-1,1196,768,263,275,3
0,0,1,-0.0,-0.0,1.0602996349334717,6.0710678118654755,6,-7,-1,1196,768,263,275,3
-1,0,1,-1.0,-0.0,1.0984046459197998,5.082762530298219,6,-6,-1,1196,768,263,275,3
-1,0,1,-1.0,-0.0,1.1143887042999268,4.0990195135927845,6,-5,-1,1196,768,263,275,3
0,0,0,-0.0,-0.0,1.1176645755767822,4.0990195135927845,6,-5,-1,1196,768,263,275,3
-2,0,0,-2.0,-0.0,1.1224136352539062,2.1622776601683795,6,-3,-1,1196,768,263,275,3
-1,0,0,-1.0,-0.0,1.1303765773773193,1.2360679774997898,6,-2,-1,1196,768,263,275,3
-1,0,0,-1.0,-0.0,1.138432502746582,0.41421356237309515,6,-1,-1,1196,768,263,275,3
-1,0,0,-1.0,-0.0,1.1465635299682617,0.0,6,0,-1,1196,768,263,275,3
0,0,1,-0.0,-0.0,1.2595436573028564,0.0,6,0,-1,1196,768,263,275,3
0,0,0,-0.0,-0.0,0.10413765907287598,503.8732514205917,7,-296,-409,900,360,1196,769,3
0,0,1,-0.0,-0.0,0.15513157844543457,503.8732514205917,7,-296,-409,900,360,1196,769,3
0,0,0,-0.0,-0.0,0.1940906047821045,503.8732514205917,7,-296,-409,900,360,1196,769,3
-1,0,0,-1.0,-0.0,0.25308775901794434,503.28761634606894,7,-295,-409,900,360,1196,769,3
-4,-2,0,-4.0,-2.0,0.2610616683959961,499.3298911718148,7,-291,-407,900,360,1196,769,3
-4,-6,0,-4.0,-6.0,0.26921772956848145,492.1227027829889,7,-287,-401,900,360,1196,769,3
-3,-7,0,-3.0,-7.0,0.2774977684020996,484.6871420986971,7,-284,-394,900,360,1196,769,3
-5,-9,0,-5.0,-9.0,0.2852165699005127,474.46398391465993,7,-279,-385,900,360,1196,769,3
-5,-13,0,-5.0,-13.0,0.2931375503540039,461.01731569282117,7,-274,-372,900,360,1196,769,3
-6,-17,0,-6.0,-17.0,0.30125856399536133,443.8022032319534,7,-268,-355,900,360,1196,769,3
-9,-19,0,-9.0,-19.0,0.309262752532959,423.2369620860493,7,-259,-336,900,360,1196,769,3
-11,-22,0,-11.0,-22.0,0.3172156810760498,399.12498047485116,7,-248,-314,900,360,1196,769,3
-16,-27,0,-16.0,-27.0,0.32503676414489746,368.04335788630584,7,-232,-287,900,360,1196,769,3
-17,-27,0,-17.0,-27.0,0.33310770988464355,336.37960815674677,7,-215,-260,900,360,1196,769,3
-18,-22,0,-18.0,-22.0,0.34113574028015137,307.9546892345219,7,-197,-238,900,360,1196,769,3
-16,-18,0,-16.0,-18.0,0.349820613861084,283.8876971720611,7,-181,-220,900,360,1196,769,3
-15,-17,0,-15.0,-17.0,0.35732364654541016,261.23081436017395,7,-166,-203,900,360,1196,769,3
-14,-15,0,-14.0,-15.0,0.3654296398162842,240.76021178018522,7,-152,-188,900,360,1196,769,3
-13,-15,0,-13.0,-15.0,0.37331557273864746,220.92341021172146,7,-139,-173,900,360,1196,769,3
-11,-13,0,-11.0,-13.0,0.38120555877685547,203.89997559785115,7,-128,-160,900,360,1196,769,3
-9,-11,0,-9.0,-11.0,0.38921070098876953,189.68822721919673,7,-119,-149,900,360,1196,769,3
-7,-9,0,-7.0,-9.0,0.39708662033081055,178.28747864811976,7,-112,-140,900,360,1196,769,3
-7,-9,0,-7.0,-9.0,0.4050867557525635,166.88686666919483,7,-105,-131,900,360,1196,769,3
-7,-8,0,-7.0,-8.0,0.4133126735687256,156.26728839781018,7,-98,-123,900,360,1196,769,3
-6,-6,0,-6.0,-6.0,0.42118167877197266,147.8388390172404,7,-92,-117,900,360,1196,769,3
-5,-6,0,-5.0,-6.0,0.42920875549316406,140.0319112825179,7,-87,-111,900,360,1196,769,3
-5,-4,0,-5.0,-4.0,0.43729376792907715,133.80726983364065,7,-82,-107,900,360,1196,769,3
-4,-4,0,-4.0,-4.0,0.44515562057495117,128.20139318134306,7,-78,-103,900,360,1196,769,3
-3,-3,0,-3.0,-3.0,0.4531726837158203,124.0,7,-75,-100,900,360,1196,769,3
-2,-2,0,-2.0,-2.0,0.46120357513427734,121.20065466273084,7,-73,-98,900,360,1196,769,3
-1,-1,0,-1.0,-1.0,0.4691646099090576,119.80149005703531,7,-72,-97,900,360,1196,769,3
-2,-2,0,-2.0,-2.0,0.4771425724029541,117.00423721205946,7,-70,-95,900,360,1196,769,3
-2,-2,0,-2.0,-2.0,0.48510074615478516,114.20850663036997,7,-68,-93,900,360,1196,769,3
-2,-2,0,-2.0,-2.0,0.4933485984802246,111.4144118874444,7,-66,-91,900,360,1196,769,3
-3,-1,0,-3.0,-1.0,0.5013637542724609,108.85900054160332,7,-63,-90,900,360,1196,769,3
-3,-2,0,-3.0,-2.0,0.5094037055969238,105.50821564555478,7,-60,-88,900,360,1196,769,3
-4,-3,0,-4.0,-3.0,0.5172176361083984,100.78899744078434,7,-56,-85,900,360,1196,769,3
-3,-2,0,-3.0,-2.0,0.5251495838165283,97.47842403288143,7,-53,-83,900,360,1196,769,3
-3,-2,0,-3.0,-2.0,0.5332136154174805,94.1892851112981,7,-50,-81,900,360,1196,769,3
-2,-2,0,-2.0,-2.0,0.5411367416381836,91.43916918709297,7,-48,-79,900,360,1196,769,3
-3,-2,0,-3.0,-2.0,0.5491657257080078,88.1852005660132,7,-45,-77,900,360,1196,769,3
-1,-3,0,-1.0,-3.0,0.5572607517242432,85.09297300012354,7,-44,-74,900,360,1196,769,3
-3,-3,0,-3.0,-3.0,0.5657696723937988,80.98780397107853,7,-41,-71,900,360,1196,769,3
-2,-2,0,-2.0,-2.0,0.5732636451721191,78.25906888173743,7,-39,-69,900,360,1196,769,3
-3,-3,0,-3.0,-3.0,0.581122636795044,74.17978451685,7,-36,-66,900,360,1196,769,3
-1,-2,0,-1.0,-2.0,0.5893557071685791,71.94518489934754,7,-35,-64,900,360,1196,769,3
-2,-2,0,-2.0,-2.0,0.5971846580505371,69.2353187506115,7,-33,-62,900,360,1196,769,3
-1,-2,0,-1.0,-2.0,0.6050477027893066,67.0,7,-32,-60,900,360,1196,769,3
-1,-3,0,-1.0,-3.0,0.6130845546722412,63.88451279003334,7,-31,-57,900,360,1196,769,3
-1,-3,0,-1.0,-3.0,0.6210696697235107,60.773780845922005,7,-30,-54,900,360,1196,769,3
-1,-3,0,-1.0,-3.0,0.6291427612304688,57.66856057549052,7,-29,-51,900,360,1196,769,3
-1,-3,0,-1.0,-3.0,0.6376047134399414,54.569775957799216,7,-28,-48,900,360,1196,769,3
-2,-3,0,-2.0,-3.0,0.6452085971832275,50.97114584074513,7,-26,-45,900,360,1196,769,3
-1,-3,0,-1.0,-3.0,0.6532456874847412,47.877397639399746,7,-25,-42,900,360,1196,769,3
-3,-5,0,-3.0,-5.0,0.6612205505371094,42.04648650006177,7,-22,-37,900,360,1196,769,3
-3,-4,0,-3.0,-4.0,0.6691596508026123,37.07886552931954,7,-19,-33,900,360,1196,769,3
-2,-3,0,-2.0,-3.0,0.6770827770233154,33.48187929913333,7,-17,-30,900,360,1196,769,3
-2,-3,0,-2.0,-3.0,0.6850996017456055,29.886890422961002,7,-15,-27,900,360,1196,769,3
-2,-3,0,-2.0,-3.0,0.6932365894317627,26.294688127912362,7,-13,-24,900,360,1196,769,3
-3,-4,0,-3.0,-4.0,0.7010846138000488,21.360679774997898,7,-10,-20,900,360,1196,769,3
-2,-3,0,-2.0,-3.0,0.7097525596618652,17.788294228055936,7,-8,-17,900,360,1196,769,3
-2,-3,0,-2.0,-3.0,0.7174997329711914,14.231546211727817,7,-6,-14,900,360,1196,769,3
-1,-3,0,-1.0,-3.0,0.725327730178833,11.083045973594572,7,-5,-11,900,360,1196,769,3
-1,-1,0,-1.0,-1.0,0.7333157062530518,9.770329614269007,7,-4,-10,900,360,1196,769,3
-1,-1,0,-1.0,-1.0,0.7411956787109375,8.486832980505138,7,-3,-9,900,360,1196,769,3
-1,-1,0,-1.0,-1.0,0.7491755485534668,7.246211251235321,7,-2,-8,900,360,1196,769,3
-1,0,0,-1.0,-0.0,0.7649507522583008,7.062257748298549,7,-1,-8,900,360,1196,769,3
0,-1,0,-0.0,-1.0,0.7730605602264404,6.0710678118654755,7,-1,-7,900,360,1196,769,3
-1,0,0,-1.0,-0.0,0.7813255786895752,6.0,7,0,-7,900,360,1196,769,3
-1,-1,0,-1.0,-1.0,0.797142744064331,5.082762530298219,7,1,-6,900,360,1196,769,3
-1,0,0,-1.0,-0.0,0.8052115440368652,5.324555320336759,7,2,-6,900,360,1196,769,3
-1,0,0,-1.0,-0.0,0.813281774520874,5.708203932499369,7,3,-6,900,360,1196,769,3
-1,-1,0,-1.0,-1.0,0.8216805458068848,5.4031242374328485,7,4,-5,900,360,1196,769,3
-1,0,0,-1.0,-0.0,0.8290936946868896,6.0710678118654755,7,5,-5,900,360,1196,769,3
0,-1,0,-0.0,-1.0,0.8370826244354248,5.4031242374328485,7,5,-4,900,360,1196,769,3
0,-1,0,-0.0,-1.0,0.9011626243591309,4.830951894845301,7,5,-3,900,360,1196,769,3
0,-1,0,-0.0,-1.0,0.9092457294464111,4.385164807134504,7,5,-2,900,360,1196,769,3
1,0,0,1.0,-0.0,0.9572017192840576,3.4721359549995796,7,4,-2,900,360,1196,769,3
2,-1,0,2.0,-1.0,0.9651217460632324,1.2360679774997898,7,2,-1,900,360,1196,769,3
1,-1,0,1.0,-1.0,0.9730887413024902,0.0,7,1,0,900,360,1196,769,3
1,0,0,1.0,-0.0,0.981008768081665,-1.0,7,0,0,900,360,1196,769,3
1,-1,0,1.0,-1.0,0.9890806674957275,0.41421356237309515,7,-1,1,900,360,1196,769,3
0,0,1,-0.0,-0.0,1.0121057033538818,0.41421356237309515,7,-1,1,900,360,1196,769,3
0,0,0,-0.0,-0.0,0.16681694984436035,821.40195793822,8,495,663,1396,1022,901,359,12
2,3,0,2.0,3.0,0.2770090103149414,817.8015537737228,8,493,660,1396,1022,901,359,12
7,8,0,7.0,8.0,0.284804105758667,807.203541556479,8,486,652,1396,1022,901,359,12
6,10,0,6.0,10.0,0.29386305809020996,795.6008982030896,8,480,642,1396,1022,901,359,12
8,12,0,8.0,12.0,0.3008410930633545,781.2001016260097,8,472,630,1396,1022,901,359,12
12,16,0,12.0,16.0,0.3087320327758789,761.2001042752796,8,460,614,1396,1022,901,359,12
19,23,0,19.0,23.0,0.3169069290161133,731.4021969047827,8,441,591,1396,1022,901,359,12
23,25,0,23.0,25.0,0.32498788833618164,697.6192152009494,8,418,566,1396,1022,901,359,12
25,26,0,25.0,26.0,0.3327360153198242,661.8689991308175,8,393,540,1396,1022,901,359,12
26,30,0,26.0,30.0,0.34085798263549805,622.322369488784,8,367,510,1396,1022,901,359,12
24,27,0,24.0,27.0,0.3488459587097168,586.4002025657993,8,343,483,1396,1022,901,359,12
21,27,0,21.0,27.0,0.35681796073913574,552.2293435497636,8,322,456,1396,1022,901,359,12
21,27,0,21.0,27.0,0.3647940158843994,518.0629733152305,8,301,429,1396,1022,901,359,12
20,27,0,20.0,27.0,0.3735959529876709,484.47426028284093,8,281,402,1396,1022,901,359,12
18,28,0,18.0,28.0,0.3808460235595703,451.21439172449504,8,263,374,1396,1022,901,359,12
17,27,0,17.0,27.0,0.38892602920532227,419.3527947480773,8,246,347,1396,1022,901,359,12
16,25,0,16.0,25.0,0.39698290824890137,389.7069622839608,8,230,322,1396,1022,901,359,12
13,22,0,13.0,22.0,0.40485095977783203,364.25531731495767,8,217,300,1396,1022,901,359,12
13,18,0,13.0,18.0,0.4129219055175781,342.0517202945562,8,204,282,1396,1022,901,359,12
10,16,0,10.0,16.0,0.4209609031677246,323.2294033041399,8,194,266,1396,1022,901,359,12
10,16,0,10.0,16.0,0.4290189743041992,304.4126286090822,8,184,250,1396,1022,901,359,12
9,15,0,9.0,15.0,0.43679094314575195,287.00170647967224,8,175,235,1396,1022,901,359,12
7,13,0,7.0,13.0,0.4454488754272461,272.40258619488435,8,168,222,1396,1022,901,359,12
7,11,0,7.0,11.0,0.45287299156188965,259.409118155349,8,161,211,1396,1022,901,359,12
5,10,0,5.0,10.0,0.46085500717163086,248.4346674492295,8,156,201,1396,1022,901,359,12
6,11,0,6.0,11.0,0.4688889980316162,236.0743687382041,8,150,190,1396,1022,901,359,12
7,12,0,7.0,12.0,0.47696590423583984,222.32652057962954,8,143,178,1396,1022,901,359,12
8,11,0,8.0,11.0,0.4848320484161377,208.74170531128786,8,135,167,1396,1022,901,359,12
8,12,0,8.0,12.0,0.49294400215148926,194.38463014912097,8,127,155,1396,1022,901,359,12
9,11,0,9.0,11.0,0.5007789134979248,180.17196351760379,8,118,144,1396,1022,901,359,12
9,11,0,9.0,11.0,0.5088028907775879,165.95929750961417,8,109,133,1396,1022,901,359,12
7,8,0,7.0,8.0,0.5169270038604736,155.33505508723144,8,102,125,1396,1022,901,359,12
7,7,0,7.0,7.0,0.5249590873718262,145.48927354766738,8,95,118,1396,1022,901,359,12
6,7,0,6.0,7.0,0.5328490734100342,136.27438279606065,8,89,111,1396,1022,901,359,12
6,5,0,6.0,5.0,0.5408709049224854,128.6291201783626,8,83,106,1396,1022,901,359,12
4,5,0,4.0,5.0,0.5488309860229492,122.22636234409833,8,79,101,1396,1022,901,359,12
5,5,0,5.0,5.0,0.556830883026123,115.21056059601408,8,74,96,1396,1022,901,359,12
3,3,0,3.0,3.0,0.5649640560150146,111.00427342623003,8,71,93,1396,1022,901,359,12
2,2,0,2.0,2.0,0.5727150440216064,108.20157617125956,8,69,91,1396,1022,901,359,12
2,2,0,2.0,2.0,0.5808188915252686,105.40017953306898,8,67,89,1396,1022,901,359,12
1,1,0,1.0,1.0,0.5889379978179932,104.0,8,66,88,1396,1022,901,359,12
1,1,0,1.0,1.0,0.5967979431152344,102.60018416190647,8,65,87,1396,1022,901,359,12
1,1,0,1.0,1.0,0.6048400402069092,101.20074626605917,8,64,86,1396,1022,901,359,12
1,1,0,1.0,1.0,0.6127729415893555,99.80170130957252,8,63,85,1396,1022,901,359,12
0,1,0,-0.0,1.0,0.6206851005554199,99.0,8,63,84,1396,1022,901,359,12
1,1,0,1.0,1.0,0.6288049221038818,97.60019305001319,8,62,83,1396,1022,901,359,12
2,3,0,2.0,3.0,0.6368350982666016,94.0,8,60,80,1396,1022,901,359,12
2,2,0,2.0,2.0,0.6448519229888916,91.20082304178294,8,58,78,1396,1022,901,359,12
2,2,0,2.0,2.0,0.65305495262146,88.40338976964757,8,56,76,1396,1022,901,359,12
2,3,0,2.0,3.0,0.6608719825744629,84.80198235721508,8,54,73,1396,1022,901,359,12
3,2,0,3.0,2.0,0.6689159870147705,81.41853350405736,8,51,71,1396,1022,901,359,12
2,3,0,2.0,3.0,0.6768600940704346,77.81527307120105,8,49,68,1396,1022,901,359,12
2,1,0,2.0,1.0,0.684798002243042,75.8413098624405,8,47,67,1396,1022,901,359,12
1,2,0,1.0,2.0,0.6928069591522217,73.63039620647382,8,46,65,1396,1022,901,359,12
1,1,0,1.0,1.0,0.7007529735565186,72.2368199762746,8,45,64,1396,1022,901,359,12
1,2,0,1.0,2.0,0.7087650299072266,70.02631123499285,8,44,62,1396,1022,901,359,12
1,2,0,1.0,2.0,0.7170319557189941,67.81734213584231,8,43,60,1396,1022,901,359,12
1,4,0,1.0,4.0,0.7251460552215576,64.0,8,42,56,1396,1022,901,359,12
2,3,0,2.0,3.0,0.7329280376434326,60.40030120413611,8,40,53,1396,1022,901,359,12
3,3,0,3.0,3.0,0.7408928871154785,56.20128616033595,8,37,50,1396,1022,901,359,12
3,4,0,3.0,4.0,0.7488470077514648,51.201398584300364,8,34,46,1396,1022,901,359,12
3,4,0,3.0,4.0,0.7569179534912109,46.20153254455275,8,31,42,1396,1022,901,359,12
3,3,0,3.0,3.0,0.7647559642791748,42.010415536631214,8,28,39,1396,1022,901,359,12
4,3,0,4.0,3.0,0.7728939056396484,37.266615305567875,8,24,36,1396,1022,901,359,12
3,3,0,3.0,3.0,0.7807719707489014,33.11521443121589,8,21,33,1396,1022,901,359,12
3,2,0,3.0,2.0,0.7888948917388916,29.84689665786984,8,18,31,1396,1022,901,359,12
1,1,0,1.0,1.0,0.7978560924530029,28.481879299133332,8,17,30,1396,1022,901,359,12
2,2,0,2.0,2.0,0.8050448894500732,25.76476034853718,8,15,28,1396,1022,901,359,12
1,1,0,1.0,1.0,0.8129560947418213,24.4138126514911,8,14,27,1396,1022,901,359,12
1,2,0,1.0,2.0,0.8208808898925781,22.178005607210743,8,13,25,1396,1022,901,359,12
0,1,0,-0.0,1.0,0.8287909030914307,21.294688127912362,8,13,24,1396,1022,901,359,12
1,1,0,1.0,1.0,0.8367979526519775,19.942243542145693,8,12,23,1396,1022,901,359,12
2,1,0,2.0,1.0,0.844959020614624,18.166091947189145,8,10,22,1396,1022,901,359,12
0,1,0,-0.0,1.0,0.8528180122375488,17.259406699226016,8,10,21,1396,1022,901,359,12
2,1,0,2.0,1.0,0.8609039783477783,15.540659228538015,8,8,20,1396,1022,901,359,12
0,1,0,-0.0,1.0,0.869499921798706,14.615528128088304,8,8,19,1396,1022,901,359,12
1,0,0,1.0,-0.0,0.8769299983978271,14.248456731316587,8,7,19,1396,1022,901,359,12
0,1,0,-0.0,1.0,0.8928039073944092,13.313207915827967,8,7,18,1396,1022,901,359,12
1,0,0,1.0,-0.0,0.9008650779724121,12.973665961010276,8,6,18,1396,1022,901,359,12
0,1,0,-0.0,1.0,0.9087390899658203,12.027756377319946,8,6,17,1396,1022,901,359,12
0,1,0,-0.0,1.0,0.9169409275054932,11.08800749063506,8,6,16,1396,1022,901,359,12
0,1,0,-0.0,1.0,0.9247279167175293,10.15549442140351,8,6,15,1396,1022,901,359,12
1,0,0,1.0,-0.0,0.9328398704528809,9.811388300841896,8,5,15,1396,1022,901,359,12
0,1,0,-0.0,1.0,0.9415640830993652,8.866068747318506,8,5,14,1396,1022,901,359,12
0,1,0,-0.0,1.0,0.9489130973815918,7.928388277184119,8,5,13,1396,1022,901,359,12
0,1,0,-0.0,1.0,0.9728500843048096,7.0,8,5,12,1396,1022,901,359,12
0,0,1,-0.0,-0.0,1.0069210529327393,7.0,8,5,12,1396,1022,901,359,12
1,0,1,1.0,-0.0,1.0528419017791748,6.649110640673518,8,4,12,1396,1022,901,359,12
0,0,0,-0.0,-0.0,1.0998759269714355,6.649110640673518,8,4,12,1396,1022,901,359,12
0,1,0,-0.0,1.0,1.108942985534668,5.704699910719626,8,4,11,1396,1022,901,359,12
1,2,0,1.0,2.0,1.1168320178985596,3.486832980505138,8,3,9,1396,1022,901,359,12
0,1,0,-0.0,1.0,1.1248149871826172,2.5440037453175304,8,3,8,1396,1022,901,359,12
1,1,0,1.0,1.0,1.1409969329833984,1.280109889280518,8,2,7,1396,1022,901,359,12
0,0,1,-0.0,-0.0,1.2301878929138184,1.280109889280518,8,2,7,1396,1022,901,359,12
1,0,1,1.0,-0.0,1.2369699478149414,1.0710678118654755,8,1,7,1396,1022,901,359,12
2,1,1,2.0,1.0,0.005716800689697266,595.2943828211702,9,-409,-457,988,559,1395,1015,36
0,0,0,-0.0,-0.0,0.08271980285644531,595.2943828211702,9,-409,-457,988,559,1395,1015,36
-2,0,0,-2.0,-0.0,0.18981194496154785,593.9624171466742,9,-407,-457,988,559,1395,1015,36
-2,0,0,-2.0,-0.0,0.19780588150024414,592.6340966569096,9,-405,-457,988,559,1395,1015,36
-2,-3,0,-2.0,-3.0,0.20575881004333496,589.062599737457,9,-403,-454,988,559,1395,1015,36
-4,-6,0,-4.0,-6.0,0.21467185020446777,581.9208281098432,9,-399,-448,988,559,1395,1015,36
-5,-7,0,-5.0,-7.0,0.22195887565612793,573.3687512880605,9,-394,-441,988,559,1395,1015,36
-6,-10,0,-6.0,-10.0,0.2298579216003418,561.9180976655238,9,-388,-431,988,559,1395,1015,36
-10,-13,0,-10.0,-13.0,0.23772883415222168,545.5672098339293,9,-378,-418,988,559,1395,1015,36
-16,-19,0,-16.0,-19.0,0.24585580825805664,520.7439094783346,9,-362,-399,988,559,1395,1015,36
-21,-23,0,-21.0,-23.0,0.2537219524383545,489.59925137848654,9,-341,-376,988,559,1395,1015,36
-25,-26,0,-25.0,-26.0,0.26180481910705566,453.5463922033547,9,-316,-350,988,559,1395,1015,36
-27,-24,0,-27.0,-24.0,0.26973986625671387,417.65697515361785,9,-289,-326,988,559,1395,1015,36
-27,-23,0,-27.0,-23.0,0.2781257629394531,382.56584976755073,9,-262,-303,988,559,1395,1015,36
-24,-21,0,-24.0,-21.0,0.28675174713134766,351.0094849729475,9,-238,-282,988,559,1395,1015,36
-22,-20,0,-22.0,-20.0,0.29393887519836426,321.5585369269929,9,-216,-262,988,559,1395,1015,36
-19,-18,0,-19.0,-18.0,0.3018617630004883,295.6000637755037,9,-197,-244,988,559,1395,1015,36
-15,-16,0,-15.0,-16.0,0.30991482734680176,273.73275441746335,9,-182,-228,988,559,1395,1015,36
-12,-16,0,-12.0,-16.0,0.31795287132263184,253.74252519618642,9,-170,-212,988,559,1395,1015,36
-12,-15,0,-12.0,-15.0,0.32581281661987305,234.53316613862822,9,-158,-197,988,559,1395,1015,36
-9,-13,0,-9.0,-13.0,0.3338007926940918,218.76359517459605,9,-149,-184,988,559,1395,1015,36
-5,-9,0,-5.0,-9.0,0.3417799472808838,208.62965384079817,9,-144,-175,988,559,1395,1015,36
-5,-7,0,-5.0,-7.0,0.3497319221496582,200.04815981796315,9,-139,-168,988,559,1395,1015,36
-4,-6,0,-4.0,-6.0,0.3577847480773926,192.87674124947966,9,-135,-162,988,559,1395,1015,36
-2,-6,0,-2.0,-6.0,0.36667585372924805,187.0,9,-133,-156,988,559,1395,1015,36
-3,-5,0,-3.0,-5.0,0.3737797737121582,181.25109786397664,9,-130,-151,988,559,1395,1015,36
-1,-4,0,-1.0,-4.0,0.38181376457214355,177.57607215607945,9,-129,-147,988,559,1395,1015,36
-2,-3,0,-2.0,-3.0,0.3898959159851074,174.00260414900626,9,-127,-144,988,559,1395,1015,36
0,-3,0,-0.0,-3.0,0.39777278900146484,171.76301009416983,9,-127,-141,988,559,1395,1015,36
-1,-2,0,-1.0,-2.0,0.4057278633117676,169.608635195718,9,-126,-139,988,559,1395,1015,36
-1,-3,0,-1.0,-3.0,0.41375088691711426,166.7187050625897,9,-125,-136,988,559,1395,1015,36
-1,-2,0,-1.0,-2.0,0.42175984382629395,164.5705343148231,9,-124,-134,988,559,1395,1015,36
-1,-3,0,-1.0,-3.0,0.4299437999725342,161.6941846582688,9,-123,-131,988,559,1395,1015,36
-2,-4,0,-2.0,-4.0,0.4383847713470459,157.41379649275024,9,-121,-127,988,559,1395,1015,36
-1,-3,0,-1.0,-3.0,0.44640684127807617,154.55723688098394,9,-120,-124,988,559,1395,1015,36
-2,-3,0,-2.0,-3.0,0.4537167549133301,151.01183390520322,9,-118,-121,988,559,1395,1015,36
-1,-3,0,-1.0,-3.0,0.4619877338409424,148.1715980545412,9,-117,-118,988,559,1395,1015,36
-2,-3,0,-2.0,-3.0,0.46988773345947266,144.63455967290594,9,-115,-115,988,559,1395,1015,36
-2,-4,0,-2.0,-4.0,0.4777567386627197,140.39823231336896,9,-113,-111,988,559,1395,1015,36
-3,-5,0,-3.0,-5.0,0.48570990562438965,134.7612516314265,9,-110,-106,988,559,1395,1015,36
-4,-6,0,-4.0,-6.0,0.49384593963623047,127.72576985557495,9,-106,-100,988,559,1395,1015,36
-5,-8,0,-5.0,-8.0,0.5018527507781982,118.61991070118586,9,-101,-92,988,559,1395,1015,36
-6,-9,0,-6.0,-9.0,0.5098497867584229,108.15070352558483,9,-95,-83,988,559,1395,1015,36
-7,-11,0,-7.0,-11.0,0.5178818702697754,95.70136322841516,9,-88,-72,988,559,1395,1015,36
-7,-11,0,-7.0,-11.0,0.5259919166564941,83.40019723846694,9,-81,-61,988,559,1395,1015,36
-7,-9,0,-7.0,-9.0,0.5337648391723633,72.44335243676011,9,-74,-52,988,559,1395,1015,36
-6,-9,0,-6.0,-9.0,0.5418288707733154,62.45495634204272,9,-68,-43,988,559,1395,1015,36
-7,-8,0,-7.0,-8.0,0.5497348308563232,52.327803890068964,9,-61,-35,988,559,1395,1015,36
-5,-6,0,-5.0,-6.0,0.5579788684844971,45.06346010171025,9,-56,-29,988,559,1395,1015,36
-4,-5,0,-4.0,-5.0,0.5666487216949463,39.271284253105414,9,-52,-24,988,559,1395,1015,36
-3,-3,0,-3.0,-3.0,0.5738887786865234,35.31041174104736,9,-49,-21,988,559,1395,1015,36
-2,-3,0,-2.0,-3.0,0.581751823425293,32.32891812864648,9,-47,-18,988,559,1395,1015,36
-2,-3,0,-2.0,-3.0,0.5897257328033447,29.434164902525687,9,-45,-15,988,559,1395,1015,36
-2,-2,0,-2.0,-2.0,0.5978667736053467,26.922154890432402,9,-43,-13,988,559,1395,1015,36
-2,-3,0,-2.0,-3.0,0.6058647632598877,24.201895692018383,9,-41,-10,988,559,1395,1015,36
-2,-3,0,-2.0,-3.0,0.6138458251953125,21.6232255123179,9,-39,-7,988,559,1395,1015,36
-2,-2,0,-2.0,-2.0,0.6217527389526367,19.336309405188942,9,-37,-5,988,559,1395,1015,36
-2,-3,0,-2.0,-3.0,0.6298038959503174,17.05709628591621,9,-35,-2,988,559,1395,1015,36
-3,-3,0,-3.0,-3.0,0.6377208232879639,14.015621187164243,9,-32,1,988,559,1395,1015,36
-2,-2,0,-2.0,-2.0,0.6458508968353271,12.14962686336267,9,-30,3,988,559,1395,1015,36
-1,-1,0,-1.0,-1.0,0.6538667678833008,11.274562336608895,9,-29,4,988,559,1395,1015,36
-1,-1,0,-1.0,-1.0,0.6618208885192871,10.442925306655784,9,-28,5,988,559,1395,1015,36
-1,0,0,-1.0,-0.0,0.685675859451294,9.459060435491963,9,-27,5,988,559,1395,1015,36
0,0,1,-0.0,-0.0,0.7576618194580078,9.459060435491963,9,-27,5,988,559,1395,1015,36
0,0,0,-0.0,-0.0,0.07477927207946777,503.8415321517467,10,-191,491,824,1045,1015,554,46
-2,1,0,-2.0,1.0,0.22303128242492676,502.1866334932754,10,-189,490,824,1045,1015,554,46
-6,7,0,-6.0,7.0,0.2310342788696289,493.5055662817198,10,-183,483,824,1045,1015,554,46
-9,8,0,-9.0,8.0,0.23868417739868164,482.8665832015394,10,-174,475,824,1045,1015,554,46
-9,10,0,-9.0,10.0,0.2467491626739502,470.4065261019558,10,-165,465,824,1045,1015,554,46
-12,12,0,-12.0,12.0,0.25475525856018066,455.1401468189008,10,-153,453,824,1045,1015,554,46
-13,15,0,-13.0,15.0,0.2627112865447998,436.83040351851463,10,-140,438,824,1045,1015,554,46
-12,17,0,-12.0,17.0,0.2710740566253662,417.028408173836,10,-128,421,824,1045,1015,554,46
-10,17,0,-10.0,17.0,0.2787442207336426,397.880030412468,10,-118,404,824,1045,1015,554,46
-9,17,0,-9.0,17.0,0.2869112491607666,379.0572098594925,10,-109,387,824,1045,1015,554,46
-9,21,0,-9.0,21.0,0.295579195022583,356.41533970043963,10,-100,366,824,1045,1015,554,46
-8,23,0,-8.0,23.0,0.3028991222381592,332.12392203285884,10,-92,343,824,1045,1015,554,46
-8,23,0,-8.0,23.0,0.31093311309814453,307.84135170803546,10,-84,320,824,1045,1015,554,46
-8,24,0,-8.0,24.0,0.31868720054626465,282.60104711862493,10,-76,296,824,1045,1015,554,46
-6,23,0,-6.0,23.0,0.3267502784729004,258.83150994876354,10,-70,273,824,1045,1015,554,46
-5,23,0,-5.0,23.0,0.3347160816192627,235.3118270617898,10,-65,250,824,1045,1015,554,46
-5,25,0,-5.0,25.0,0.3427262306213379,209.86262044390037,10,-60,225,824,1045,1015,554,46
-4,25,0,-4.0,25.0,0.3506622314453125,184.69207977195472,10,-56,200,824,1045,1015,554,46
-4,21,0,-4.0,21.0,0.35871410369873047,163.40010729610646,10,-52,179,824,1045,1015,554,46
-4,16,0,-4.0,16.0,0.36660313606262207,146.92056967889437,10,-48,163,824,1045,1015,554,46
-4,13,0,-4.0,13.0,0.3746771812438965,133.32018423735306,10,-44,150,824,1045,1015,554,46
-1,9,0,-1.0,9.0,0.38269925117492676,124.41099009232656,10,-43,141,824,1045,1015,554,46
-1,6,0,-1.0,6.0,0.3908090591430664,118.38246001537814,10,-42,135,824,1045,1015,554,46
0,3,0,-0.0,3.0,0.39867424964904785,115.52075656738234,10,-42,132,824,1045,1015,554,46
0,2,0,-0.0,2.0,0.40678906440734863,113.61625086350452,10,-42,130,824,1045,1015,554,46
0,1,0,-0.0,1.0,0.4227011203765869,112.66502865514016,10,-42,129,824,1045,1015,554,46
0,1,0,-0.0,1.0,0.46278810501098633,111.71451295239129,10,-42,128,824,1045,1015,554,46
1,0,0,1.0,-0.0,0.4707622528076172,112.02962637880623,10,-43,128,824,1045,1015,554,46
1,2,0,1.0,2.0,0.4787430763244629,110.46160496562297,10,-44,126,824,1045,1015,554,46
1,2,0,1.0,2.0,0.4867720603942871,108.91285001848757,10,-45,124,824,1045,1015,554,46
1,2,0,1.0,2.0,0.49479007720947266,107.38404810405297,10,-46,122,824,1045,1015,554,46
0,2,0,-0.0,2.0,0.502866268157959,105.51459061133875,10,-46,120,824,1045,1015,554,46
1,3,0,1.0,3.0,0.5110101699829102,103.08727136392476,10,-47,117,824,1045,1015,554,46
0,2,0,-0.0,2.0,0.5187780857086182,101.23365083583433,10,-47,115,824,1045,1015,554,46
0,4,0,-0.0,4.0,0.5268170833587646,97.5404496424333,10,-47,111,824,1045,1015,554,46
0,4,0,-0.0,4.0,0.534743070602417,93.86744627996283,10,-47,107,824,1045,1015,554,46
-1,6,0,-1.0,6.0,0.5428330898284912,87.98198051936178,10,-46,101,824,1045,1015,554,46
-1,6,0,-1.0,6.0,0.550774097442627,82.11898020814318,10,-45,95,824,1045,1015,554,46
-2,7,0,-2.0,7.0,0.5590882301330566,74.94386147176351,10,-43,88,824,1045,1015,554,46
-2,6,0,-2.0,6.0,0.5667061805725098,68.67878707749138,10,-41,82,824,1045,1015,554,46
-3,6,0,-3.0,6.0,0.5756571292877197,61.970583144992005,10,-38,76,824,1045,1015,554,46
-3,6,0,-3.0,6.0,0.5829200744628906,55.26237921249263,10,-35,70,824,1045,1015,554,46
-4,6,0,-4.0,6.0,0.5907912254333496,48.11258679024411,10,-31,64,824,1045,1015,554,46
-3,6,0,-3.0,6.0,0.5988352298736572,41.40496875241847,10,-28,58,824,1045,1015,554,46
-3,5,0,-3.0,5.0,0.6066820621490479,35.60034129593445,10,-25,53,824,1045,1015,554,46
-3,4,0,-3.0,4.0,0.6146912574768066,30.712196007983138,10,-22,49,824,1045,1015,554,46
-2,3,0,-2.0,3.0,0.6227202415466309,27.159744815937813,10,-20,46,824,1045,1015,554,46
-1,2,0,-1.0,2.0,0.6306941509246826,24.927027865287037,10,-19,44,824,1045,1015,554,46
-2,2,0,-2.0,2.0,0.6389832496643066,22.310043036836767,10,-17,42,824,1045,1015,554,46
-1,2,0,-1.0,2.0,0.6473002433776855,20.08131845707603,10,-16,40,824,1045,1015,554,46
-1,1,0,-1.0,1.0,0.6548922061920166,18.785164831552358,10,-15,39,824,1045,1015,554,46
-1,1,0,-1.0,1.0,0.6627662181854248,17.496913462633174,10,-14,38,824,1045,1015,554,46
-1,1,0,-1.0,1.0,0.6710541248321533,16.217343102255157,10,-13,37,824,1045,1015,554,46
0,0,1,-0.0,-0.0,0.7017862796783447,16.217343102255157,10,-13,37,824,1045,1015,554,46
0,0,0,-0.0,-0.0,0.06637072563171387,584.0032257980598,11,548,-290,1385,718,837,1008,73
-1,1,0,-1.0,1.0,0.111602783203125,585.3549710109351,11,549,-291,1385,718,837,1008,73
0,1,0,-0.0,1.0,0.11948680877685547,585.8239300638083,11,549,-292,1385,718,837,1008,73
-1,2,0,-1.0,2.0,0.12772369384765625,587.6473362406032,11,550,-294,1385,718,837,1008,73
0,1,0,-0.0,1.0,0.1354846954345703,588.1193796061776,11,550,-295,1385,718,837,1008,73
-1,2,0,-1.0,2.0,0.14366674423217773,589.9472821252601,11,551,-297,1385,718,837,1008,73
-1,1,0,-1.0,1.0,0.15152478218078613,591.3021600472933,11,552,-298,1385,718,837,1008,73
0,1,0,-0.0,1.0,0.15956878662109375,591.7778269419844,11,552,-299,1385,718,837,1008,73
-1,1,0,-1.0,1.0,0.1674637794494629,593.1335311362764,11,553,-300,1385,718,837,1008,73
1,0,0,1.0,-0.0,0.20795679092407227,592.2547254100044,11,552,-300,1385,718,837,1008,73
4,-2,0,4.0,-2.0,0.2155458927154541,587.7852194465656,11,548,-298,1385,718,837,1008,73
5,-5,0,5.0,-5.0,0.22358489036560059,581.0072933118377,11,543,-293,1385,718,837,1008,73
8,-5,0,8.0,-5.0,0.23149967193603516,571.5927912673093,11,535,-288,1385,718,837,1008,73
12,-6,0,12.0,-6.0,0.2395188808441162,558.1826318565699,11,523,-282,1385,718,837,1008,73
14,-7,0,14.0,-7.0,0.24753069877624512,542.5378120745437,11,509,-275,1385,718,837,1008,73
18,-9,0,18.0,-9.0,0.2554206848144531,522.4236742832453,11,491,-266,1385,718,837,1008,73
22,-13,0,22.0,-13.0,0.26351380348205566,496.88835603717223,11,469,-253,1385,718,837,1008,73
28,-15,0,28.0,-15.0,0.27217578887939453,465.12373721467236,11,441,-238,1385,718,837,1008,73
33,-15,0,33.0,-15.0,0.279451847076416,428.9655901246887,11,408,-223,1385,718,837,1008,73
36,-14,0,36.0,-14.0,0.2875807285308838,390.69075452838206,11,372,-209,1385,718,837,1008,73
35,-10,0,35.0,-10.0,0.2955188751220703,355.3693907295255,11,337,-199,1385,718,837,1008,73
31,-11,0,31.0,-11.0,0.30344676971435547,323.13785653979727,11,306,-188,1385,718,837,1008,73
28,-15,0,28.0,-15.0,0.31151390075683594,291.43396280776983,11,278,-173,1385,718,837,1008,73
26,-15,0,26.0,-15.0,0.3195228576660156,261.43570733857763,11,252,-158,1385,718,837,1008,73
22,-12,0,22.0,-12.0,0.3276197910308838,236.42613677839358,11,230,-146,1385,718,837,1008,73
19,-11,0,19.0,-11.0,0.33553290367126465,214.49151682242655,11,211,-135,1385,718,837,1008,73
15,-10,0,15.0,-10.0,0.3441498279571533,196.46720198772127,11,196,-125,1385,718,837,1008,73
13,-11,0,13.0,-11.0,0.3517436981201172,179.60380330597138,11,183,-114,1385,718,837,1008,73
12,-9,0,12.0,-9.0,0.35962867736816406,164.66389809828772,11,171,-105,1385,718,837,1008,73
9,-8,0,9.0,-8.0,0.3676917552947998,152.8200201249857,11,162,-97,1385,718,837,1008,73
9,-7,0,9.0,-7.0,0.3756277561187744,141.50774630984418,11,153,-90,1385,718,837,1008,73
9,-6,0,9.0,-6.0,0.3835427761077881,130.70932787339765,11,144,-84,1385,718,837,1008,73
10,-4,0,10.0,-4.0,0.39148688316345215,120.06408939919524,11,134,-80,1385,718,837,1008,73
8,-2,0,8.0,-2.0,0.39954185485839844,112.18906842274163,11,126,-78,1385,718,837,1008,73
6,-3,0,6.0,-3.0,0.4074208736419678,105.50971698084905,11,120,-75,1385,718,837,1008,73
6,-3,0,6.0,-3.0,0.4155547618865967,98.8332303254654,11,114,-72,1385,718,837,1008,73
4,-2,0,4.0,-2.0,0.4235358238220215,94.38404810405297,11,110,-70,1385,718,837,1008,73
3,-2,0,3.0,-2.0,0.4315028190612793,90.77933585565118,11,107,-68,1385,718,837,1008,73
1,-1,0,1.0,-1.0,0.43941187858581543,89.39936203984452,11,106,-67,1385,718,837,1008,73
1,-1,0,1.0,-1.0,0.44762086868286133,88.02015965156633,11,105,-66,1385,718,837,1008,73
0,-1,0,-0.0,-1.0,0.4556307792663574,87.4908903522847,11,105,-65,1385,718,837,1008,73
1,-4,0,1.0,-4.0,0.4635326862335205,84.56948204251356,11,104,-61,1385,718,837,1008,73
1,-3,0,1.0,-3.0,0.47149085998535156,82.20744477400736,11,103,-58,1385,718,837,1008,73
2,-4,0,2.0,-4.0,0.47944068908691406,78.5294721894762,11,101,-54,1385,718,837,1008,73
2,-4,0,2.0,-4.0,0.48758387565612793,74.90987332063814,11,99,-50,1385,718,837,1008,73
2,-3,0,2.0,-3.0,0.49562788009643555,71.78682665335315,11,97,-47,1385,718,837,1008,73
3,-3,0,3.0,-3.0,0.5035789012908936,67.78824596263297,11,94,-44,1385,718,837,1008,73
2,-3,0,2.0,-3.0,0.5114877223968506,64.72239075796404,11,92,-41,1385,718,837,1008,73
2,-2,0,2.0,-2.0,0.519554853439331,62.086696345630884,11,90,-39,1385,718,837,1008,73
2,-1,0,2.0,-1.0,0.5275027751922607,59.854055730574075,11,88,-38,1385,718,837,1008,73
0,-1,0,-0.0,-1.0,0.5354647636413574,59.462034338264544,11,88,-37,1385,718,837,1008,73
1,-1,0,1.0,-1.0,0.5760467052459717,58.15412895885129,11,87,-36,1385,718,837,1008,73
3,-2,0,3.0,-2.0,0.5915117263793945,54.620086073673534,11,84,-34,1385,718,837,1008,73
3,-3,0,3.0,-3.0,0.5995357036590576,50.729464428186105,11,81,-31,1385,718,837,1008,73
5,-2,0,5.0,-2.0,0.6074666976928711,45.344944526380985,11,76,-29,1385,718,837,1008,73
6,-2,0,6.0,-2.0,0.6154477596282959,39.026661927610775,11,70,-27,1385,718,837,1008,73
6,-3,0,6.0,-3.0,0.6234948635101318,32.35202996254024,11,64,-24,1385,718,837,1008,73
8,-4,0,8.0,-4.0,0.6314117908477783,23.464274989274024,11,56,-20,1385,718,837,1008,73
9,-3,0,9.0,-3.0,0.6393847465515137,13.979995998399197,11,47,-17,1385,718,837,1008,73
10,-4,0,10.0,-4.0,0.6476728916168213,3.217343102255157,11,37,-13,1385,718,837,1008,73
10,-3,0,10.0,-3.0,0.6556758880615234,-7.207639902224063,11,27,-10,1385,718,837,1008,73
8,-3,0,8.0,-3.0,0.6634407043457031,-15.751543268683413,11,19,-7,1385,718,837,1008,73
8,-3,0,8.0,-3.0,0.6717157363891602,-24.295300089280374,11,11,-4,1385,718,837,1008,73
4,-2,0,4.0,-2.0,0.6794357299804688,-28.719890110719483,11,7,-2,1385,718,837,1008,73
2,0,0,2.0,-0.0,0.6874988079071045,-30.614835192865495,11,5,-2,1385,718,837,1008,73
0,0,1,-0.0,-0.0,0.7265536785125732,-30.614835192865495,11,5,-2,1385,718,837,1008,73
0,0,0,-0.0,-0.0,0.062358856201171875,348.5798207997897,12,-171,340,1209,1060,1380,720,65
-1,0,0,-1.0,-0.0,0.12732481956481934,348.13155617496426,12,-170,340,1209,1060,1380,720,65
-1,0,0,-1.0,-0.0,0.13530302047729492,347.68539608470587,12,-169,340,1209,1060,1380,720,65
-1,0,0,-1.0,-0.0,0.14341998100280762,347.2413479566805,12,-168,340,1209,1060,1380,720,65
-1,0,0,-1.0,-0.0,0.15137195587158203,346.79941921813975,12,-167,340,1209,1060,1380,720,65
-2,0,0,-2.0,-0.0,0.16004586219787598,345.9219496139381,12,-165,340,1209,1060,1380,720,65
-2,0,0,-2.0,-0.0,0.16806387901306152,345.05304666585045,12,-163,340,1209,1060,1380,720,65
-4,1,0,-4.0,1.0,0.17533302307128906,342.43557523290974,12,-159,339,1209,1060,1380,720,65
-6,2,0,-6.0,2.0,0.1833329200744629,338.1053903957628,12,-153,337,1209,1060,1380,720,65
-9,2,0,-9.0,2.0,0.1912379264831543,332.63817682738596,12,-144,335,1209,1060,1380,720,65
-13,5,0,-13.0,5.0,0.199293851852417,323.0507006048573,12,-131,330,1209,1060,1380,720,65
-16,8,0,-16.0,8.0,0.20725584030151367,309.91958118832565,12,-115,322,1209,1060,1380,720,65
-19,12,0,-19.0,12.0,0.2152538299560547,292.5242671973854,12,-96,310,1209,1060,1380,720,65
-18,17,0,-18.0,17.0,0.22330093383789062,271.20455141702604,12,-78,293,1209,1060,1380,720,65
-15,19,0,-15.0,19.0,0.23125290870666504,249.1494264621573,12,-63,274,1209,1060,1380,720,65
-12,21,0,-12.0,21.0,0.2393639087677002,226.08913189051566,12,-51,253,1209,1060,1380,720,65
-9,20,0,-9.0,20.0,0.24811601638793945,204.75514777930383,12,-42,233,1209,1060,1380,720,65
-4,17,0,-4.0,17.0,0.2552759647369385,187.31712199461307,12,-38,216,1209,1060,1380,720,65
0,15,0,-0.0,15.0,0.26331186294555664,172.56050449683585,12,-38,201,1209,1060,1380,720,65
2,14,0,2.0,14.0,0.2712678909301758,159.23022773609824,12,-40,187,1209,1060,1380,720,65
3,14,0,3.0,14.0,0.27933192253112793,146.2638493918495,12,-43,173,1209,1060,1380,720,65
3,13,0,3.0,13.0,0.28723597526550293,134.48123017325406,12,-46,160,1209,1060,1380,720,65
2,12,0,2.0,12.0,0.2952079772949219,123.58920271021378,12,-48,148,1209,1060,1380,720,65
2,13,0,2.0,13.0,0.30329179763793945,111.96180048887967,12,-50,135,1209,1060,1380,720,65
2,11,0,2.0,11.0,0.3112649917602539,102.46189051177288,12,-52,124,1209,1060,1380,720,65
3,11,0,3.0,11.0,0.3192458152770996,93.67418191498204,12,-55,113,1209,1060,1380,720,65
1,8,0,1.0,8.0,0.32727599143981934,87.0,12,-56,105,1209,1060,1380,720,65
0,7,0,-0.0,7.0,0.33522987365722656,80.8716084761797,12,-56,98,1209,1060,1380,720,65
0,5,0,-0.0,5.0,0.34342193603515625,76.55873986004075,12,-56,93,1209,1060,1380,720,65
-1,4,0,-1.0,4.0,0.35125184059143066,72.62313319720452,12,-55,89,1209,1060,1380,720,65
-2,5,0,-2.0,5.0,0.35933780670166016,67.32270636667126,12,-53,84,1209,1060,1380,720,65
-3,6,0,-3.0,6.0,0.36729884147644043,60.64987857520376,12,-50,78,1209,1060,1380,720,65
-3,5,0,-3.0,5.0,0.37613797187805176,54.82165628459296,12,-47,73,1209,1060,1380,720,65
-3,4,0,-3.0,4.0,0.38346099853515625,49.835200250259064,12,-44,69,1209,1060,1380,720,65
-2,3,0,-2.0,3.0,0.3914768695831299,46.23042886243178,12,-42,66,1209,1060,1380,720,65
-1,4,0,-1.0,4.0,0.3993840217590332,42.330343736592525,12,-41,62,1209,1060,1380,720,65
-2,4,0,-2.0,4.0,0.40732288360595703,37.89277502002621,12,-39,58,1209,1060,1380,720,65
-2,5,0,-2.0,5.0,0.4152209758758545,32.63745044476924,12,-37,53,1209,1060,1380,720,65
-2,4,0,-2.0,4.0,0.4232819080352783,28.21627686929839,12,-35,49,1209,1060,1380,720,65
-1,4,0,-1.0,4.0,0.4312608242034912,24.400354608814297,12,-34,45,1209,1060,1380,720,65
-2,5,0,-2.0,5.0,0.43923497200012207,19.22499389946279,12,-32,40,1209,1060,1380,720,65
-2,4,0,-2.0,4.0,0.4472208023071289,14.861498055439924,12,-30,36,1209,1060,1380,720,65
-2,4,0,-2.0,4.0,0.4552798271179199,10.5205832509386,12,-28,32,1209,1060,1380,720,65
-1,3,0,-1.0,3.0,0.4635629653930664,7.623225512317902,12,-27,29,1209,1060,1380,720,65
-2,3,0,-2.0,3.0,0.47136783599853516,4.069377593742864,12,-25,26,1209,1060,1380,720,65
-1,2,0,-1.0,2.0,0.4793558120727539,1.9411254969542782,12,-24,24,1209,1060,1380,720,65
-1,2,0,-1.0,2.0,0.48743581771850586,-0.17233907432090234,12,-23,22,1209,1060,1380,720,65
-1,3,0,-1.0,3.0,0.49526190757751465,-2.9311162925027325,12,-22,19,1209,1060,1380,720,65
0,0,1,-0.0,-0.0,0.5021858215332031,-2.9311162925027325,12,-22,19,1209,1060,1380,720,65
-1,2,1,-1.0,2.0,0.505281925201416,-4.981487827787408,12,-21,17,1209,1060,1380,720,65
0,1,1,-0.0,1.0,0.0002532005310058594,634.1228762683738,13,635,-144,1865,900,1230,1043,35
0,0,0,-0.0,-0.0,0.08011031150817871,634.1228762683738,13,635,-144,1865,900,1230,1043,35
0,-2,0,-0.0,-2.0,0.1281874179840088,633.6834868044524,13,635,-142,1865,900,1230,1043,35
2,-3,0,2.0,-3.0,0.1363222599029541,631.0817849623611,13,633,-139,1865,900,1230,1043,35
2,-4,0,2.0,-4.0,0.1442112922668457,628.2797842796565,13,631,-135,1865,900,1230,1043,35
2,-4,0,2.0,-4.0,0.15219831466674805,625.4966925984911,13,629,-131,1865,900,1230,1043,35
3,-4,0,3.0,-4.0,0.1601712703704834,621.7526907966807,13,626,-127,1865,900,1230,1043,35
3,-4,0,3.0,-4.0,0.16817641258239746,618.0259837203514,13,623,-123,1865,900,1230,1043,35
3,-6,0,3.0,-6.0,0.1762223243713379,613.9429451226157,13,620,-117,1865,900,1230,1043,35
4,-8,0,4.0,-8.0,0.18423724174499512,608.5693406809512,13,616,-109,1865,900,1230,1043,35
7,-10,0,7.0,-10.0,0.19251227378845215,599.9943273645229,13,609,-99,1865,900,1230,1043,35
10,-10,0,10.0,-10.0,0.2001934051513672,588.5757590921222,13,599,-89,1865,900,1230,1043,35
14,-13,0,14.0,-13.0,0.20810937881469727,572.9160957288757,13,585,-76,1865,900,1230,1043,35
17,-12,0,17.0,-12.0,0.2161881923675537,554.59426169268,13,568,-64,1865,900,1230,1043,35
19,-12,0,19.0,-12.0,0.22417926788330078,534.457160620841,13,549,-52,1865,900,1230,1043,35
20,-9,0,20.0,-9.0,0.2321913242340088,513.7447597480356,13,529,-43,1865,900,1230,1043,35
24,-7,0,24.0,-7.0,0.24013924598693848,489.2815422272473,13,505,-36,1865,900,1230,1043,35
25,-6,0,25.0,-6.0,0.24812722206115723,463.9365862564419,13,480,-30,1865,900,1230,1043,35
26,-5,0,26.0,-5.0,0.2561314105987549,437.6878049827156,13,454,-25,1865,900,1230,1043,35
25,-4,0,25.0,-4.0,0.2642662525177002,412.51367847834604,13,429,-21,1865,900,1230,1043,35
27,-4,0,27.0,-4.0,0.27228522300720215,385.35929217553803,13,402,-17,1865,900,1230,1043,35
26,-4,0,26.0,-4.0,0.2801642417907715,359.22466692124266,13,376,-13,1865,900,1230,1043,35
25,-2,0,25.0,-2.0,0.2880713939666748,334.17232237179513,13,351,-11,1865,900,1230,1043,35
22,-2,0,22.0,-2.0,0.2962522506713867,312.1230772826482,13,329,-9,1865,900,1230,1043,35
20,-1,0,20.0,-1.0,0.304241418838501,292.1035425225664,13,309,-8,1865,900,1230,1043,35
17,-1,0,17.0,-1.0,0.3126823902130127,275.083892058429,13,292,-7,1865,900,1230,1043,35
18,-2,0,18.0,-2.0,0.3201563358306885,257.0456166407337,13,274,-5,1865,900,1230,1043,35
16,-2,0,16.0,-2.0,0.328174352645874,241.01744127093423,13,258,-3,1865,900,1230,1043,35
18,-4,0,18.0,-4.0,0.33629536628723145,223.00208332429116,13,240,1,1865,900,1230,1043,35
18,-3,0,18.0,-3.0,0.3441894054412842,205.03603311174518,13,222,4,1865,900,1230,1043,35
16,-2,0,16.0,-2.0,0.3522613048553467,189.08736011701444,13,206,6,1865,900,1230,1043,35
17,-2,0,17.0,-2.0,0.360302209854126,172.16923639957952,13,189,8,1865,900,1230,1043,35
18,-2,0,18.0,-2.0,0.3682122230529785,154.29214809792072,13,171,10,1865,900,1230,1043,35
17,-2,0,17.0,-2.0,0.37621426582336426,137.46682491719702,13,154,12,1865,900,1230,1043,35
18,-2,0,18.0,-2.0,0.3840913772583008,119.7186892857008,13,136,14,1865,900,1230,1043,35
16,-2,0,16.0,-2.0,0.3923354148864746,104.06196760337245,13,120,16,1865,900,1230,1043,35
16,-1,0,16.0,-1.0,0.4002852439880371,88.38026380684383,13,104,17,1865,900,1230,1043,35
15,-2,0,15.0,-2.0,0.40827131271362305,74.00549433962765,13,89,19,1865,900,1230,1043,35
17,-1,0,17.0,-1.0,0.4162862300872803,57.72616676907762,13,72,20,1865,900,1230,1043,35
14,0,0,14.0,-0.0,0.42420434951782227,44.35144660071187,13,58,20,1865,900,1230,1043,35
15,0,0,15.0,-0.0,0.43226027488708496,30.423622805517503,13,43,20,1865,900,1230,1043,35
12,0,0,12.0,-0.0,0.44018030166625977,19.89173349139343,13,31,20,1865,900,1230,1043,35
8,-1,0,8.0,-1.0,0.4481782913208008,14.144823004794873,13,23,21,1865,900,1230,1043,35
8,0,0,8.0,-0.0,0.4561803340911865,8.80697580112788,13,15,21,1865,900,1230,1043,35
5,0,0,5.0,-0.0,0.46417737007141113,6.259406699226016,13,10,21,1865,900,1230,1043,35
4,0,0,4.0,-0.0,0.4721982479095459,4.840329667841555,13,6,21,1865,900,1230,1043,35
3,0,0,3.0,-0.0,0.48026442527770996,4.2132034355964265,13,3,21,1865,900,1230,1043,35
3,0,0,3.0,-0.0,0.48824238777160645,4.0,13,0,21,1865,900,1230,1043,35
3,0,0,3.0,-0.0,0.49620723724365234,4.2132034355964265,13,-3,21,1865,900,1230,1043,35
3,0,0,3.0,-0.0,0.5042133331298828,4.840329667841555,13,-6,21,1865,900,1230,1043,35
3,0,0,3.0,-0.0,0.5122044086456299,5.847319317591726,13,-9,21,1865,900,1230,1043,35
1,0,0,1.0,-0.0,0.5202023983001709,6.259406699226016,13,-10,21,1865,900,1230,1043,35
1,0,0,1.0,-0.0,0.5281612873077393,6.7065391822593945,13,-11,21,1865,900,1230,1043,35
2,1,0,2.0,1.0,0.5361242294311523,6.853720883753127,13,-13,20,1865,900,1230,1043,35
2,0,0,2.0,-0.0,0.5441272258758545,8.0,13,-15,20,1865,900,1230,1043,35
2,1,0,2.0,1.0,0.5521392822265625,8.495097567963924,13,-17,19,1865,900,1230,1043,35
2,2,0,2.0,2.0,0.5601491928100586,8.495097567963924,13,-19,17,1865,900,1230,1043,35
2,1,0,2.0,1.0,0.568204402923584,9.40075756488817,13,-21,16,1865,900,1230,1043,35
2,1,0,2.0,1.0,0.576209306716919,10.459060435491963,13,-23,15,1865,900,1230,1043,35
2,1,0,2.0,1.0,0.584200382232666,11.653097563788805,13,-25,14,1865,900,1230,1043,35
2,1,0,2.0,1.0,0.5920782089233398,12.966648127543394,13,-27,13,1865,900,1230,1043,35
1,1,0,1.0,1.0,0.6000633239746094,13.463092423455635,13,-28,12,1865,900,1230,1043,35
0,0,1,-0.0,-0.0,0.6500382423400879,13.463092423455635,13,-28,12,1865,900,1230,1043,35
0,0,0,-0.0,-0.0,0.07715487480163574,1380.8541739581005,14,-1397,-72,496,816,1893,888,36
0,1,0,-0.0,1.0,0.12113475799560547,1380.9060011308836,14,-1397,-73,496,816,1893,888,36
-1,0,0,-1.0,-0.0,0.12920093536376953,1379.9073645989565,14,-1396,-73,496,816,1893,888,36
-4,1,0,-4.0,1.0,0.13710880279541016,1375.9655662892108,14,-1392,-74,496,816,1893,888,36
-3,1,0,-3.0,1.0,0.14511585235595703,1373.0233642897592,14,-1389,-75,496,816,1893,888,36
-2,1,0,-2.0,1.0,0.1531367301940918,1371.0806312090021,14,-1387,-76,496,816,1893,888,36
-2,0,0,-2.0,-0.0,0.16119074821472168,1369.0836312205547,14,-1385,-76,496,816,1893,888,36
-1,1,0,-1.0,1.0,0.16908693313598633,1368.14032478678,14,-1384,-77,496,816,1893,888,36
-3,0,0,-3.0,-0.0,0.1770937442779541,1365.1449670949173,14,-1381,-77,496,816,1893,888,36
-1,1,0,-1.0,1.0,0.18575191497802734,1364.2025900713686,14,-1380,-78,496,816,1893,888,36
-3,0,0,-3.0,-0.0,0.19311189651489258,1361.2073810707366,14,-1377,-78,496,816,1893,888,36
-3,1,0,-3.0,1.0,0.2010498046875,1358.2692323815133,14,-1374,-79,496,816,1893,888,36
-6,0,0,-6.0,-0.0,0.2090919017791748,1352.2791686368146,14,-1368,-79,496,816,1893,888,36
-8,1,0,-8.0,1.0,0.21707987785339355,1344.3509092741122,14,-1360,-80,496,816,1893,888,36
-10,0,0,-10.0,-0.0,0.22519278526306152,1334.368293032634,14,-1350,-80,496,816,1893,888,36
-14,0,0,-14.0,-0.0,0.23312091827392578,1320.393066329918,14,-1336,-80,496,816,1893,888,36
-19,0,0,-19.0,-0.0,0.24110984802246094,1301.4275273769301,14,-1317,-80,496,816,1893,888,36
-26,-1,0,-26.0,-1.0,0.2491168975830078,1275.4148599733962,14,-1291,-79,496,816,1893,888,36
-30,-2,0,-30.0,-2.0,0.25719285011291504,1245.3487246204033,14,-1261,-77,496,816,1893,888,36
-32,-2,0,-32.0,-2.0,0.26517796516418457,1213.2863192612838,14,-1229,-75,496,816,1893,888,36
-38,-2,0,-38.0,-2.0,0.27307987213134766,1175.235098377516,14,-1191,-73,496,816,1893,888,36
-43,-3,0,-43.0,-3.0,0.28417181968688965,1132.132166318289,14,-1148,-70,496,816,1893,888,36
-47,-4,0,-47.0,-4.0,0.28907084465026855,1084.9764276719607,14,-1101,-66,496,816,1893,888,36
-51,-3,0,-51.0,-3.0,0.29726076126098633,1033.8883020549283,14,-1050,-63,496,816,1893,888,36
-54,-2,0,-54.0,-2.0,0.3052208423614502,979.8662234989217,14,-996,-61,496,816,1893,888,36
-55,-1,0,-55.0,-1.0,0.31328678131103516,924.910918379886,14,-941,-60,496,816,1893,888,36
-55,0,0,-55.0,-0.0,0.32105493545532227,870.0292787965947,14,-886,-60,496,816,1893,888,36
-52,0,0,-52.0,-0.0,0.32911086082458496,818.1554879327169,14,-834,-60,496,816,1893,888,36
-47,0,0,-47.0,-0.0,0.33716678619384766,771.2838526157748,14,-787,-60,496,816,1893,888,36
-41,2,0,-41.0,2.0,0.34510374069213867,730.5719738275004,14,-746,-62,496,816,1893,888,36
-36,0,0,-36.0,-0.0,0.35308074951171875,694.7019012181742,14,-710,-62,496,816,1893,888,36
-30,0,0,-30.0,-0.0,0.36109495162963867,664.8206206610928,14,-680,-62,496,816,1893,888,36
-28,0,0,-28.0,-0.0,0.3691537380218506,636.9412187364603,14,-652,-62,496,816,1893,888,36
-24,-2,0,-24.0,-2.0,0.3827378749847412,612.8597308435529,14,-628,-60,496,816,1893,888,36
-23,-2,0,-23.0,-2.0,0.3850879669189453,589.7738066090049,14,-605,-58,496,816,1893,888,36
-20,-2,0,-20.0,-2.0,0.39307284355163574,569.6742294843292,14,-585,-56,496,816,1893,888,36
-18,-2,0,-18.0,-2.0,0.4011569023132324,551.5656239626826,14,-567,-54,496,816,1893,888,36
-17,-3,0,-17.0,-3.0,0.4091007709503174,534.359484393995,14,-550,-51,496,816,1893,888,36
-15,-3,0,-15.0,-3.0,0.4186539649963379,519.1489551325591,14,-535,-48,496,816,1893,888,36
-14,-2,0,-14.0,-2.0,0.4250929355621338,505.02676795743446,14,-521,-46,496,816,1893,888,36
-13,-2,0,-13.0,-2.0,0.4331967830657959,491.9019513592785,14,-508,-44,496,816,1893,888,36
-13,-2,0,-13.0,-2.0,0.4410579204559326,478.7786227284745,14,-495,-42,496,816,1893,888,36
-14,-2,0,-14.0,-2.0,0.4490678310394287,464.6603360542484,14,-481,-40,496,816,1893,888,36
-13,-2,0,-13.0,-2.0,0.45705389976501465,451.5402006218424,14,-468,-38,496,816,1893,888,36
-13,-3,0,-13.0,-3.0,0.46512293815612793,438.3441683641854,14,-455,-35,496,816,1893,888,36
-14,-4,0,-14.0,-4.0,0.4732367992401123,424.08822648878584,14,-441,-31,496,816,1893,888,36
-14,-3,0,-14.0,-3.0,0.4811089038848877,409.9170480361819,14,-427,-28,496,816,1893,888,36
-15,-3,0,-15.0,-3.0,0.4892847537994385,394.7577982303908,14,-412,-25,496,816,1893,888,36
-17,-3,0,-17.0,-3.0,0.49707484245300293,377.6121838366458,14,-395,-22,496,816,1893,888,36
-18,-2,0,-18.0,-2.0,0.5050687789916992,359.530131247825,14,-377,-20,496,816,1893,888,36
-18,-1,0,-18.0,-1.0,0.5132098197937012,341.50243392778304,14,-359,-19,496,816,1893,888,36
-18,-1,0,-18.0,-1.0,0.5210497379302979,323.4747428434496,14,-341,-18,496,816,1893,888,36
-16,-1,0,-16.0,-1.0,0.5292317867279053,307.44431167251946,14,-325,-17,496,816,1893,888,36
-13,-1,0,-13.0,-1.0,0.5370547771453857,294.40998703626616,14,-312,-16,496,816,1893,888,36
-12,-1,0,-12.0,-1.0,0.5452268123626709,282.3747659175118,14,-300,-15,496,816,1893,888,36
-9,0,0,-9.0,-0.0,0.553231954574585,273.3863414781139,14,-291,-15,496,816,1893,888,36
-10,0,0,-10.0,-0.0,0.5611777305603027,263.40007107319644,14,-281,-15,496,816,1893,888,36
-9,0,0,-9.0,-0.0,0.569084882736206,254.4132889563209,14,-272,-15,496,816,1893,888,36
-8,0,0,-8.0,-0.0,0.5771429538726807,246.42579299304373,14,-264,-15,496,816,1893,888,36
-8,0,0,-8.0,-0.0,0.5852289199829102,238.43907658545334,14,-256,-15,496,816,1893,888,36
-9,0,0,-9.0,-0.0,0.5937807559967041,229.45504642257754,14,-247,-15,496,816,1893,888,36
-8,0,0,-8.0,-0.0,0.6010787487030029,221.47024867402632,14,-239,-15,496,816,1893,888,36
-10,1,0,-10.0,1.0,0.6092038154602051,211.55827146935917,14,-229,-16,496,816,1893,888,36
-10,1,0,-10.0,1.0,0.6172418594360352,201.65882636488797,14,-219,-17,496,816,1893,888,36
-10,2,0,-10.0,2.0,0.6252298355102539,191.86185932655795,14,-209,-19,496,816,1893,888,36
-11,0,0,-11.0,-0.0,0.6347107887268066,180.90952717253137,14,-198,-19,496,816,1893,888,36
-10,1,0,-10.0,1.0,0.6412928104400635,171.06083676954358,14,-188,-20,496,816,1893,888,36
-11,0,0,-11.0,-0.0,0.6492118835449219,160.12635964393365,14,-177,-20,496,816,1893,888,36
-12,0,0,-12.0,-0.0,0.6572508811950684,148.20770138594662,14,-165,-20,496,816,1893,888,36
-11,0,0,-11.0,-0.0,0.6653988361358643,137.2932709424333,14,-154,-20,496,816,1893,888,36
-11,1,0,-11.0,1.0,0.673184871673584,126.53373308677806,14,-143,-21,496,816,1893,888,36
-13,0,0,-13.0,-0.0,0.6811258792877197,113.68523075880606,14,-130,-21,496,816,1893,888,36
-12,0,0,-12.0,-0.0,0.6891357898712158,101.85407794480753,14,-118,-21,496,816,1893,888,36
-12,0,0,-12.0,-0.0,0.6972417831420898,90.06016842481785,14,-106,-21,496,816,1893,888,36
-11,0,0,-11.0,-0.0,0.7052409648895264,79.29337079164233,14,-95,-21,496,816,1893,888,36
-11,1,0,-11.0,1.0,0.7131528854370117,68.83317338436964,14,-84,-22,496,816,1893,888,36
-10,0,0,-10.0,-0.0,0.7212767601013184,59.20103626247513,14,-74,-22,496,816,1893,888,36
-8,0,0,-8.0,-0.0,0.7291748523712158,51.57010852370435,14,-66,-22,496,816,1893,888,36
-8,0,0,-8.0,-0.0,0.7371387481689453,44.03224967708329,14,-58,-22,496,816,1893,888,36
-7,0,0,-7.0,-0.0,0.7450909614562988,37.54277630799526,14,-51,-22,496,816,1893,888,36
-8,0,0,-8.0,-0.0,0.7533528804779053,30.301138702933287,14,-43,-22,496,816,1893,888,36
-8,0,0,-8.0,-0.0,0.7612948417663574,23.340053217188775,14,-35,-22,496,816,1893,888,36
-7,-1,0,-7.0,-1.0,0.7692008018493652,17.0,14,-28,-21,496,816,1893,888,36
-6,0,0,-6.0,-0.0,0.7771737575531006,12.4138126514911,14,-22,-21,496,816,1893,888,36
-5,-1,0,-5.0,-1.0,0.7852358818054199,8.248809496813376,14,-17,-20,496,816,1893,888,36
-4,0,0,-4.0,-0.0,0.7931327819824219,5.853720883753127,14,-13,-20,496,816,1893,888,36
-4,-1,0,-4.0,-1.0,0.8010938167572021,3.023796041628639,14,-9,-19,496,816,1893,888,36
-2,0,0,-2.0,-0.0,0.8092019557952881,2.248456731316587,14,-7,-19,496,816,1893,888,36
0,-1,0,-0.0,-1.0,0.8331067562103271,1.3132079158279666,14,-7,-18,496,816,1893,888,36
0,0,1,-0.0,-0.0,0.8710827827453613,1.3132079158279666,14,-7,-18,496,816,1893,888,36
-1,0,1,-1.0,-0.0,0.03204083442687988,1166.0344090127528,15,1083,-461,1585,373,503,834,23
-1,0,1,-1.0,-0.0,0.04107785224914551,1166.9545831652424,15,1084,-461,1585,373,503,834,23
0,0,0,-0.0,-0.0,0.07007575035095215,1166.9545831652424,15,1084,-461,1585,373,503,834,23
0,-1,0,-0.0,-1.0,0.1358797550201416,1166.5635863935331,15,1084,-460,1585,373,503,834,23
3,-5,0,3.0,-5.0,0.1439356803894043,1161.8537845784529,15,1081,-455,1585,373,503,834,23
5,-4,0,5.0,-4.0,0.15202569961547852,1155.6949044201745,15,1076,-451,1585,373,503,834,23
5,-5,0,5.0,-5.0,0.16009783744812012,1149.153869105301,15,1071,-446,1585,373,503,834,23
7,-5,0,7.0,-5.0,0.16804170608520508,1140.771244648867,15,1064,-441,1585,373,503,834,23
7,-5,0,7.0,-5.0,0.17614483833312988,1132.3918838263633,15,1057,-436,1585,373,503,834,23
8,-6,0,8.0,-6.0,0.1840198040008545,1122.711162510099,15,1049,-430,1585,373,503,834,23
11,-8,0,11.0,-8.0,0.19202589988708496,1109.5034582722178,15,1038,-422,1585,373,503,834,23
14,-9,0,14.0,-9.0,0.20015382766723633,1093.1489935692555,15,1024,-413,1585,373,503,834,23
19,-11,0,19.0,-11.0,0.20807170867919922,1071.4181262340353,15,1005,-402,1585,373,503,834,23
20,-12,0,20.0,-12.0,0.21599888801574707,1048.3984141955282,15,985,-390,1585,373,503,834,23
23,-12,0,23.0,-12.0,0.22403573989868164,1022.5995356036108,15,962,-378,1585,373,503,834,23
26,-12,0,26.0,-12.0,0.23208069801330566,994.0134327460504,15,936,-366,1585,373,503,834,23
27,-12,0,27.0,-12.0,0.23999381065368652,964.4983341861738,15,909,-354,1585,373,503,834,23
31,-17,0,31.0,-17.0,0.24791383743286133,929.4536139544576,15,878,-337,1585,373,503,834,23
33,-18,0,33.0,-18.0,0.25608372688293457,892.2087244928495,15,845,-319,1585,373,503,834,23
37,-17,0,37.0,-17.0,0.26407670974731445,851.5937630194181,15,808,-302,1585,373,503,834,23
38,-18,0,38.0,-18.0,0.2720067501068115,809.7045753497418,15,770,-284,1585,373,503,834,23
39,-14,0,39.0,-14.0,0.2800917625427246,768.2695297520621,15,731,-270,1585,373,503,834,23
39,-12,0,39.0,-12.0,0.28798675537109375,727.5309742996566,15,692,-258,1585,373,503,834,23
39,-12,0,39.0,-12.0,0.29587769508361816,686.8001146460209,15,653,-246,1585,373,503,834,23
37,-11,0,37.0,-11.0,0.30402684211730957,648.3034202853797,15,616,-235,1585,373,503,834,23
34,-11,0,34.0,-11.0,0.3120238780975342,612.6184731067545,15,582,-224,1585,373,503,834,23
32,-10,0,32.0,-10.0,0.3199748992919922,579.1660783203318,15,550,-214,1585,373,503,834,23
30,-10,0,30.0,-10.0,0.3280167579650879,547.5839238646239,15,520,-204,1585,373,503,834,23
27,-7,0,27.0,-7.0,0.3360288143157959,519.9030043237653,15,493,-197,1585,373,503,834,23
26,-7,0,26.0,-7.0,0.34412169456481934,493.1715977720284,15,467,-190,1585,373,503,834,23
24,-7,0,24.0,-7.0,0.35201382637023926,468.30992061504423,15,443,-183,1585,373,503,834,23
23,-6,0,23.0,-6.0,0.3600637912750244,444.77296979965803,15,420,-177,1585,373,503,834,23
23,-8,0,23.0,-8.0,0.36804986000061035,420.47421707443885,15,397,-169,1585,373,503,834,23
21,-7,0,21.0,-7.0,0.3760647773742676,398.41421567893804,15,376,-162,1585,373,503,834,23
18,-8,0,18.0,-8.0,0.38400888442993164,378.71784665319086,15,358,-154,1585,373,503,834,23
17,-7,0,17.0,-7.0,0.3921077251434326,360.33542788158525,15,341,-147,1585,373,503,834,23
15,-5,0,15.0,-5.0,0.4000227451324463,344.58402663786796,15,326,-142,1585,373,503,834,23
10,-6,0,10.0,-6.0,0.4081246852874756,333.02325502791234,15,316,-136,1585,373,503,834,23
9,-5,0,9.0,-5.0,0.4159677028656006,322.7813655673426,15,307,-131,1585,373,503,834,23
9,-5,0,9.0,-5.0,0.42389988899230957,312.5428874198906,15,298,-126,1585,373,503,834,23
6,-5,0,6.0,-5.0,0.43207573890686035,305.07752213657966,15,292,-121,1585,373,503,834,23
5,-4,0,5.0,-4.0,0.43999767303466797,298.932250661334,15,287,-117,1585,373,503,834,23
8,-5,0,8.0,-5.0,0.44797682762145996,289.6409819036653,15,279,-112,1585,373,503,834,23
8,-6,0,8.0,-6.0,0.4561188220977783,279.9931270666027,15,271,-106,1585,373,503,834,23
9,-4,0,9.0,-4.0,0.46404290199279785,270.15476165272395,15,262,-102,1585,373,503,834,23
9,-6,0,9.0,-6.0,0.47203874588012695,259.60118255469615,15,253,-96,1585,373,503,834,23
8,-5,0,8.0,-5.0,0.4801177978515625,250.35416583632258,15,245,-91,1585,373,503,834,23
7,-3,0,7.0,-3.0,0.48800086975097656,242.74790639530408,15,238,-88,1585,373,503,834,23
7,-3,0,7.0,-3.0,0.4959867000579834,235.1422353030865,15,231,-85,1585,373,503,834,23
6,-4,0,6.0,-4.0,0.5039598941802979,228.1359446005556,15,225,-81,1585,373,503,834,23
5,-4,0,5.0,-4.0,0.512028694152832,222.085821104588,15,220,-77,1585,373,503,834,23
5,-3,0,5.0,-3.0,0.5200607776641846,216.37853900489378,15,215,-74,1585,373,503,834,23
6,-3,0,6.0,-3.0,0.5280797481536865,209.7306050369998,15,209,-71,1585,373,503,834,23
6,-4,0,6.0,-4.0,0.5360887050628662,202.77090541044166,15,203,-67,1585,373,503,834,23
5,-2,0,5.0,-2.0,0.543900728225708,197.39625716408634,15,198,-65,1585,373,503,834,23
6,-4,0,6.0,-4.0,0.5521237850189209,190.45719148245863,15,192,-61,1585,373,503,834,23
5,-2,0,5.0,-2.0,0.5600237846374512,185.08671551127577,15,187,-59,1585,373,503,834,23
6,-4,0,6.0,-4.0,0.5680198669433594,178.1718795170149,15,181,-55,1585,373,503,834,23
6,-4,0,6.0,-4.0,0.5760717391967773,171.28000438885226,15,175,-51,1585,373,503,834,23
7,-3,0,7.0,-3.0,0.5840747356414795,163.72263734273244,15,168,-48,1585,373,503,834,23
6,-4,0,6.0,-4.0,0.5920517444610596,156.86899654194636,15,162,-44,1585,373,503,834,23
7,-5,0,7.0,-5.0,0.6000308990478516,148.8311609167624,15,155,-39,1585,373,503,834,23
7,-3,0,7.0,-3.0,0.6080307960510254,141.31546211727817,15,148,-36,1585,373,503,834,23
6,-4,0,6.0,-4.0,0.6160306930541992,134.5609837834301,15,142,-32,1585,373,503,834,23
5,-3,0,5.0,-3.0,0.6241137981414795,129.03570973148243,15,137,-29,1585,373,503,834,23
4,-2,0,4.0,-2.0,0.6320548057556152,124.71293232407882,15,133,-27,1585,373,503,834,23
5,-2,0,5.0,-2.0,0.6401338577270508,119.41855696180662,15,128,-25,1585,373,503,834,23
4,-3,0,4.0,-3.0,0.6479747295379639,114.93649193144932,15,124,-22,1585,373,503,834,23
5,-2,0,5.0,-2.0,0.655958890914917,109.66896867049125,15,119,-20,1585,373,503,834,23
7,-3,0,7.0,-3.0,0.66408371925354,102.28283188550682,15,112,-17,1585,373,503,834,23
8,-3,0,8.0,-3.0,0.6719827651977539,93.93807697875924,15,104,-14,1585,373,503,834,23
7,-3,0,7.0,-3.0,0.680142879486084,86.62171889492625,15,97,-11,1585,373,503,834,23
6,-2,0,6.0,-2.0,0.688025712966919,80.44397191723465,15,91,-9,1585,373,503,834,23
6,-1,0,6.0,-1.0,0.6960136890411377,74.37564055396598,15,85,-8,1585,373,503,834,23
5,-1,0,5.0,-1.0,0.7040417194366455,69.30566605165541,15,80,-7,1585,373,503,834,23
6,-1,0,6.0,-1.0,0.7120108604431152,63.24284477308234,15,74,-6,1585,373,503,834,23
5,-1,0,5.0,-1.0,0.7200348377227783,58.18092222571191,15,69,-5,1585,373,503,834,23
5,-1,0,5.0,-1.0,0.7280168533325195,53.124878167525594,15,64,-4,1585,373,503,834,23
8,-2,0,8.0,-2.0,0.735954761505127,45.0357029044876,15,56,-2,1585,373,503,834,23
6,-2,0,6.0,-2.0,0.7440168857574463,39.0,15,50,0,1585,373,503,834,23
7,-2,0,7.0,-2.0,0.752025842666626,32.04648650006177,15,43,2,1585,373,503,834,23
6,-1,0,6.0,-1.0,0.7600088119506836,26.12142238654117,15,37,3,1585,373,503,834,23
6,-1,0,6.0,-1.0,0.7681148052215576,20.25699921617557,15,31,4,1585,373,503,834,23
4,-1,0,4.0,-1.0,0.7761218547821045,16.459060435491963,15,27,5,1585,373,503,834,23
3,0,0,3.0,-0.0,0.7840268611907959,13.515301344262525,15,24,5,1585,373,503,834,23
2,-1,0,2.0,-1.0,0.7919998168945312,11.803508501982758,15,22,6,1585,373,503,834,23
1,0,0,1.0,-0.0,0.8001198768615723,10.840329667841555,15,21,6,1585,373,503,834,23
1,0,0,1.0,-0.0,0.8161578178405762,9.880613017821101,15,20,6,1585,373,503,834,23
1,0,0,1.0,-0.0,0.8240118026733398,8.924858845171276,15,19,6,1585,373,503,834,23
1,-1,0,1.0,-1.0,0.8320586681365967,8.313207915827967,15,18,7,1585,373,503,834,23
1,0,0,1.0,-0.0,0.8400406837463379,7.384776310850235,15,17,7,1585,373,503,834,23
2,0,0,2.0,-0.0,0.8480837345123291,5.552945357246848,15,15,7,1585,373,503,834,23
1,0,0,1.0,-0.0,0.8560137748718262,4.652475842498529,15,14,7,1585,373,503,834,23
1,-1,0,1.0,-1.0,0.8640668392181396,4.264337522473747,15,13,8,1585,373,503,834,23
1,0,0,1.0,-0.0,0.8719847202301025,3.4222051018559565,15,12,8,1585,373,503,834,23
1,0,0,1.0,-0.0,0.880011796951294,2.601470508735444,15,11,8,1585,373,503,834,23
1,0,0,1.0,-0.0,0.8880007266998291,1.806248474865697,15,10,8,1585,373,503,834,23
1,0,0,1.0,-0.0,0.9122278690338135,1.0415945787922958,15,9,8,1585,373,503,834,23
1,0,0,1.0,-0.0,0.9280266761779785,0.31370849898476116,15,8,8,1585,373,503,834,23
1,0,0,1.0,-0.0,0.9360277652740479,-0.36985418726535,15,7,8,1585,373,503,834,23
2,0,0,2.0,-0.0,0.9440128803253174,-1.5660188679433968,15,5,8,1585,373,503,834,23
2,0,0,2.0,-0.0,0.9521548748016357,-2.4559962546824696,15,3,8,1585,373,503,834,23
1,0,0,1.0,-0.0,0.9600608348846436,-2.753788748764679,15,2,8,1585,373,503,834,23
2,0,0,2.0,-0.0,0.9681508541107178,-3.0,15,0,8,1585,373,503,834,23
0,0,1,-0.0,-0.0,0.972517728805542,-3.0,15,0,8,1585,373,503,834,23
2,-1,1,2.0,-1.0,0.9760646820068359,-1.780455542707113,15,-2,9,1585,373,503,834,23
1,0,1,1.0,-0.0,0.005823850631713867,839.6617494683223,16,-844,-158,744,206,1587,364,38
1,0,1,1.0,-0.0,0.021614789962768555,840.6446940451619,16,-845,-158,744,206,1587,364,38
0,0,0,-0.0,-0.0,0.08168292045593262,840.6446940451619,16,-845,-158,744,206,1587,364,38
-1,0,0,-1.0,-0.0,0.12569689750671387,839.6617494683223,16,-844,-158,744,206,1587,364,38
-3,1,0,-3.0,1.0,0.1337299346923828,836.8983584515162,16,-841,-159,744,206,1587,364,38
-4,1,0,-4.0,1.0,0.1417689323425293,833.1555022412283,16,-837,-160,744,206,1587,364,38
-3,2,0,-3.0,2.0,0.1497819423675537,830.5881355103778,16,-834,-162,744,206,1587,364,38
-5,3,0,-5.0,3.0,0.1577167510986328,826.2609064661633,16,-829,-165,744,206,1587,364,38
-5,3,0,-5.0,3.0,0.1657118797302246,821.9518416651455,16,-824,-168,744,206,1587,364,38
-7,4,0,-7.0,4.0,0.17376375198364258,815.9089770747468,16,-817,-172,744,206,1587,364,38
-8,6,0,-8.0,6.0,0.18158578872680664,809.3507711108863,16,-809,-178,744,206,1587,364,38
-11,7,0,-11.0,7.0,0.18971991539001465,800.1635978240244,16,-798,-185,744,206,1587,364,38
-12,8,0,-12.0,8.0,0.1976938247680664,790.3485034272936,16,-786,-193,744,206,1587,364,38
-14,6,0,-14.0,6.0,0.20567893981933594,778.2358496705978,16,-772,-199,744,206,1587,364,38
-16,7,0,-16.0,7.0,0.21369290351867676,764.5636540830617,16,-756,-206,744,206,1587,364,38
-21,7,0,-21.0,7.0,0.22170686721801758,746.2411384655167,16,-735,-213,744,206,1587,364,38
-25,4,0,-25.0,4.0,0.22964692115783691,723.4210395725595,16,-710,-217,744,206,1587,364,38
-26,2,0,-26.0,2.0,0.2377328872680664,699.2040100138679,16,-684,-219,744,206,1587,364,38
-24,2,0,-24.0,2.0,0.24567389488220215,677.0179595384016,16,-660,-221,744,206,1587,364,38
-23,-1,0,-23.0,-1.0,0.2536289691925049,654.9206184707514,16,-637,-220,744,206,1587,364,38
-26,-5,0,-26.0,-5.0,0.2617068290710449,628.7237065292577,16,-611,-215,744,206,1587,364,38
-27,-8,0,-27.0,-8.0,0.26977086067199707,600.6006778563109,16,-584,-207,744,206,1587,364,38
-29,-10,0,-29.0,-10.0,0.27768898010253906,569.9261413793754,16,-555,-197,744,206,1587,364,38
-32,-14,0,-32.0,-14.0,0.285693883895874,535.0920501144192,16,-523,-183,744,206,1587,364,38
-32,-15,0,-32.0,-15.0,0.2936828136444092,499.946047292009,16,-491,-168,744,206,1587,364,38
-35,-18,0,-35.0,-18.0,0.30170583724975586,461.0374985352707,16,-456,-150,744,206,1587,364,38
-36,-19,0,-36.0,-19.0,0.3097679615020752,420.95567958602373,16,-420,-131,744,206,1587,364,38
-35,-19,0,-35.0,-19.0,0.317706823348999,381.96009776535124,16,-385,-112,744,206,1587,364,38
-33,-17,0,-33.0,-17.0,0.32565879821777344,345.59429507330475,16,-352,-95,744,206,1587,364,38
-32,-16,0,-32.0,-16.0,0.33367276191711426,310.607342151233,16,-320,-79,744,206,1587,364,38
-28,-15,0,-28.0,-15.0,0.34169483184814453,279.9314302645341,16,-292,-64,744,206,1587,364,38
-27,-13,0,-27.0,-13.0,0.349639892578125,250.8629281690985,16,-265,-51,744,206,1587,364,38
-22,-12,0,-22.0,-12.0,0.35775089263916016,227.1097316239242,16,-243,-39,744,206,1587,364,38
-19,-10,0,-19.0,-10.0,0.36566591262817383,206.86943130932968,16,-224,-29,744,206,1587,364,38
-15,-9,0,-15.0,-9.0,0.37368083000183105,190.95475703112803,16,-209,-20,744,206,1587,364,38
-13,-7,0,-13.0,-7.0,0.381727933883667,177.4306493396588,16,-196,-13,744,206,1587,364,38
-11,-6,0,-11.0,-6.0,0.38965797424316406,166.13238506539042,16,-185,-7,744,206,1587,364,38
-9,-3,0,-9.0,-3.0,0.3976888656616211,157.0454486773231,16,-176,-4,744,206,1587,364,38
-9,-3,0,-9.0,-3.0,0.4055459499359131,148.0029939851379,16,-167,-1,744,206,1587,364,38
-6,-1,0,-6.0,-1.0,0.41359782218933105,142.0,16,-161,0,744,206,1587,364,38
-4,0,0,-4.0,-0.0,0.4218099117279053,138.0,16,-157,0,744,206,1587,364,38
-4,0,0,-4.0,-0.0,0.4299437999725342,134.0,16,-153,0,744,206,1587,364,38
-4,0,0,-4.0,-0.0,0.43773579597473145,130.0,16,-149,0,744,206,1587,364,38
-3,0,0,-3.0,-0.0,0.4456357955932617,127.0,16,-146,0,744,206,1587,364,38
-3,1,0,-3.0,1.0,0.45360398292541504,124.00349646075091,16,-143,-1,744,206,1587,364,38
-3,0,0,-3.0,-0.0,0.46159791946411133,121.00357138301865,16,-140,-1,744,206,1587,364,38
-2,1,0,-2.0,1.0,0.46973276138305664,119.01449199268893,16,-138,-2,744,206,1587,364,38
-1,1,0,-1.0,1.0,0.47772979736328125,118.03284277865654,16,-137,-3,744,206,1587,364,38
-2,1,0,-2.0,1.0,0.4856879711151123,116.05924625881784,16,-135,-4,744,206,1587,364,38
-3,2,0,-3.0,2.0,0.49362778663635254,113.13629327327143,16,-132,-6,744,206,1587,364,38
-4,3,0,-4.0,3.0,0.5237588882446289,109.31601614763451,16,-128,-9,744,206,1587,364,38
-4,2,0,-4.0,2.0,0.5238058567047119,105.4869471069156,16,-124,-11,744,206,1587,364,38
-4,3,0,-4.0,3.0,0.523831844329834,101.81390648431164,16,-120,-14,744,206,1587,364,38
-5,3,0,-5.0,3.0,0.5257248878479004,97.2497311824849,16,-115,-17,744,206,1587,364,38
-5,2,0,-5.0,2.0,0.5338759422302246,92.6288493177279,16,-110,-19,744,206,1587,364,38
-4,2,0,-4.0,2.0,0.5416238307952881,89.06016842481785,16,-106,-21,744,206,1587,364,38
-4,1,0,-4.0,1.0,0.5500569343566895,85.34557968596465,16,-102,-22,744,206,1587,364,38
-4,1,0,-4.0,1.0,0.557668924331665,81.66280345788111,16,-98,-23,744,206,1587,364,38
-5,1,0,-5.0,1.0,0.5657069683074951,77.04686356149273,16,-93,-24,744,206,1587,364,38
-5,0,0,-5.0,-0.0,0.5736908912658691,72.21403400793103,16,-88,-24,744,206,1587,364,38
-4,1,0,-4.0,1.0,0.581683874130249,68.64131445842195,16,-84,-25,744,206,1587,364,38
-5,1,0,-5.0,1.0,0.5897448062896729,64.16850365372699,16,-79,-26,744,206,1587,364,38
-4,0,0,-4.0,-0.0,0.5978789329528809,60.378838489864535,16,-75,-26,744,206,1587,364,38
-5,0,0,-5.0,-0.0,0.6056487560272217,55.672618810377884,16,-70,-26,744,206,1587,364,38
-4,0,0,-4.0,-0.0,0.6138098239898682,51.9365914038728,16,-66,-26,744,206,1587,364,38
-4,0,0,-4.0,-0.0,0.621600866317749,48.23094525588644,16,-62,-26,744,206,1587,364,38
-4,1,0,-4.0,1.0,0.6295907497406006,44.97655820689325,16,-58,-27,744,206,1587,364,38
-5,0,0,-5.0,-0.0,0.6377217769622803,40.481089431852205,16,-53,-27,744,206,1587,364,38
-4,0,0,-4.0,-0.0,0.6457698345184326,36.94640292279746,16,-49,-27,744,206,1587,364,38
-2,0,0,-2.0,-0.0,0.6536378860473633,35.20332093147061,16,-47,-27,744,206,1587,364,38
-2,0,0,-2.0,-0.0,0.6616778373718262,33.478567053607705,16,-45,-27,744,206,1587,364,38
-1,0,0,-1.0,-0.0,0.6696767807006836,32.62363799656123,16,-44,-27,744,206,1587,364,38
-1,0,0,-1.0,-0.0,0.677656888961792,31.774009099144415,16,-43,-27,744,206,1587,364,38
-1,0,0,-1.0,-0.0,0.6857728958129883,30.929950931279713,16,-42,-27,744,206,1587,364,38
-2,0,0,-2.0,-0.0,0.6937928199768066,29.25971404805462,16,-40,-27,744,206,1587,364,38
-1,0,0,-1.0,-0.0,0.7017598152160645,28.434164902525687,16,-39,-27,744,206,1587,364,38
-1,0,0,-1.0,-0.0,0.7098097801208496,27.61544808322666,16,-38,-27,744,206,1587,364,38
-2,0,0,-2.0,-0.0,0.7176787853240967,26.0,16,-36,-27,744,206,1587,364,38
-1,0,0,-1.0,-0.0,0.725700855255127,25.204072210600685,16,-35,-27,744,206,1587,364,38
-1,0,0,-1.0,-0.0,0.7337119579315186,24.416586692184822,16,-34,-27,744,206,1587,364,38
-1,0,0,-1.0,-0.0,0.7416908740997314,23.638011210655684,16,-33,-27,744,206,1587,364,38
-1,0,0,-1.0,-0.0,0.7496957778930664,22.86884283091664,16,-32,-27,744,206,1587,364,38
-1,0,0,-1.0,-0.0,0.7577998638153076,22.10960958218893,16,-31,-27,744,206,1587,364,38
-1,0,0,-1.0,-0.0,0.7657778263092041,21.36087214122113,16,-30,-27,744,206,1587,364,38
0,0,1,-0.0,-0.0,0.774622917175293,21.36087214122113,16,-30,-27,744,206,1587,364,38
-1,0,1,-1.0,-0.0,0.8376648426055908,20.6232255123179,16,-29,-27,744,206,1587,364,38
0,0,0,-0.0,-0.0,0.8745408058166504,20.6232255123179,16,-29,-27,744,206,1587,364,38
-1,0,0,-1.0,-0.0,0.9258017539978027,19.897300677553446,16,-28,-27,744,206,1587,364,38
-3,0,0,-3.0,-0.0,0.9336109161376953,17.796738985948195,16,-25,-27,744,206,1587,364,38
-1,0,0,-1.0,-0.0,0.9417829513549805,17.124783736376884,16,-24,-27,744,206,1587,364,38
-1,0,0,-1.0,-0.0,0.9497029781341553,16.4682957019364,16,-23,-27,744,206,1587,364,38
-1,0,0,-1.0,-0.0,0.9575319290161133,15.828149534535996,16,-22,-27,744,206,1587,364,38
-1,0,0,-1.0,-0.0,0.9655578136444092,15.205262752974143,16,-21,-27,744,206,1587,364,38
-2,0,0,-2.0,-0.0,0.9736039638519287,14.015148038438355,16,-19,-27,744,206,1587,364,38
-2,0,0,-2.0,-0.0,0.9817037582397461,12.906112267087632,16,-17,-27,744,206,1587,364,38
-2,0,0,-2.0,-0.0,0.989750862121582,11.886890422961002,16,-15,-27,744,206,1587,364,38
-1,0,0,-1.0,-0.0,0.9977209568023682,11.4138126514911,16,-14,-27,744,206,1587,364,38
-2,-1,0,-2.0,-1.0,1.0056769847869873,9.635642126552707,16,-12,-26,744,206,1587,364,38
-2,0,0,-2.0,-0.0,1.0136818885803223,8.856776554368238,16,-10,-26,744,206,1587,364,38
-2,0,0,-2.0,-0.0,1.0217719078063965,8.202941017470888,16,-8,-26,744,206,1587,364,38
0,0,1,-0.0,-0.0,1.0618088245391846,8.202941017470888,16,-8,-26,744,206,1587,364,38
0,0,0,-0.0,-0.0,0.0945594310760498,1162.9630578330225,17,1127,291,1879,523,752,232,3
-2,3,0,-2.0,3.0,0.1445162296295166,1164.1544961935306,17,1129,288,1879,523,752,232,3
-3,7,0,-3.0,7.0,0.15254831314086914,1165.3554346767542,17,1132,281,1879,523,752,232,3
-3,10,0,-3.0,10.0,0.1605222225189209,1165.904451958257,17,1135,271,1879,523,752,232,3
-3,9,0,-3.0,9.0,0.1685163974761963,1166.7705254030006,17,1138,262,1879,523,752,232,3
-2,9,0,-2.0,9.0,0.17640233039855957,1166.7366997743968,17,1140,253,1879,523,752,232,3
0,10,0,-0.0,10.0,0.18442034721374512,1164.6109985754254,17,1140,243,1879,523,752,232,3
0,8,0,-0.0,8.0,0.19251537322998047,1162.9695013186556,17,1140,235,1879,523,752,232,3
3,9,0,3.0,9.0,0.2006053924560547,1158.243287666571,17,1137,226,1879,523,752,232,3
3,8,0,3.0,8.0,0.20855236053466797,1153.7640451624738,17,1134,218,1879,523,752,232,3
3,10,0,3.0,10.0,0.21661829948425293,1148.9673908420186,17,1131,208,1879,523,752,232,3
6,13,0,6.0,13.0,0.22462224960327148,1140.774934039104,17,1125,195,1879,523,752,232,3
7,13,0,7.0,13.0,0.23255038261413574,1131.7170873611822,17,1118,182,1879,523,752,232,3
9,14,0,9.0,14.0,0.24053430557250977,1120.6527983293226,17,1109,168,1879,523,752,232,3
10,10,0,10.0,10.0,0.2484893798828125,1109.2995091415648,17,1099,158,1879,523,752,232,3
12,9,0,12.0,9.0,0.25644731521606445,1096.164527315753,17,1087,149,1879,523,752,232,3
12,6,0,12.0,6.0,0.26441526412963867,1083.4694555403578,17,1075,143,1879,523,752,232,3
13,4,0,13.0,4.0,0.2726104259490967,1070.0578882581465,17,1062,139,1879,523,752,232,3
14,2,0,14.0,2.0,0.28053832054138184,1055.9167422271255,17,1048,137,1879,523,752,232,3
18,1,0,18.0,1.0,0.2884562015533447,1037.9398442643346,17,1030,136,1879,523,752,232,3
21,0,0,21.0,-0.0,0.29654741287231445,1017.1242556780581,17,1009,136,1879,523,752,232,3
25,-1,0,25.0,-1.0,0.3045463562011719,992.4913185327791,17,984,137,1879,523,752,232,3
29,-2,0,29.0,-2.0,0.3126213550567627,964.0626922640829,17,955,139,1879,523,752,232,3
33,-2,0,33.0,-2.0,0.3206183910369873,931.7191431508201,17,922,141,1879,523,752,232,3
33,-1,0,33.0,-1.0,0.32843542098999023,899.2694041230103,17,889,142,1879,523,752,232,3
33,0,0,33.0,-0.0,0.3366692066192627,866.6981041814025,17,856,142,1879,523,752,232,3
31,0,0,31.0,-0.0,0.344468355178833,836.1314114283372,17,825,142,1879,523,752,232,3
32,2,0,32.0,2.0,0.35248732566833496,804.2633109734977,17,793,140,1879,523,752,232,3
32,4,0,32.0,4.0,0.36055827140808105,772.0569189910922,17,761,136,1879,523,752,232,3
33,4,0,33.0,4.0,0.36842823028564453,738.870258896788,17,728,132,1879,523,752,232,3
36,6,0,36.0,6.0,0.37656331062316895,702.3775657497188,17,692,126,1879,523,752,232,3
37,7,0,37.0,7.0,0.3845484256744385,664.72216426975,17,655,119,1879,523,752,232,3
40,7,0,40.0,7.0,0.39255237579345703,624.1151893851245,17,615,112,1879,523,752,232,3
37,7,0,37.0,7.0,0.4005403518676758,586.4597858577215,17,578,105,1879,523,752,232,3
39,8,0,39.0,8.0,0.40851736068725586,546.6586528121326,17,539,97,1879,523,752,232,3
36,8,0,36.0,8.0,0.41646337509155273,509.8130773580489,17,503,89,1879,523,752,232,3
34,8,0,34.0,8.0,0.42450428009033203,474.9432739308331,17,469,81,1879,523,752,232,3
32,7,0,32.0,7.0,0.4324793815612793,442.22116375462036,17,437,74,1879,523,752,232,3
29,9,0,29.0,9.0,0.4405522346496582,412.1452529074974,17,408,65,1879,523,752,232,3
27,7,0,27.0,7.0,0.44854140281677246,384.3894134508627,17,381,58,1879,523,752,232,3
26,8,0,26.0,8.0,0.45660924911499023,357.50383540486706,17,355,50,1879,523,752,232,3
24,8,0,24.0,8.0,0.4646143913269043,332.65401241405743,17,331,42,1879,523,752,232,3
22,8,0,22.0,8.0,0.4724712371826172,309.8649224341659,17,309,34,1879,523,752,232,3
20,7,0,20.0,7.0,0.4804353713989258,289.25850547399983,17,289,27,1879,523,752,232,3
17,6,0,17.0,6.0,0.48857736587524414,271.8094573140748,17,272,21,1879,523,752,232,3
15,6,0,15.0,6.0,0.4965822696685791,256.4373710244882,17,257,15,1879,523,752,232,3
12,5,0,12.0,5.0,0.504568338394165,244.20399670478457,17,245,10,1879,523,752,232,3
12,4,0,12.0,4.0,0.5124762058258057,232.0772404161333,17,233,6,1879,523,752,232,3
12,5,0,12.0,5.0,0.5206232070922852,220.00226243185838,17,221,1,1879,523,752,232,3
12,5,0,12.0,5.0,0.5285592079162598,208.03827400741713,17,209,-4,1879,523,752,232,3
13,5,0,13.0,5.0,0.536609411239624,195.2065238466856,17,196,-9,1879,523,752,232,3
12,5,0,12.0,5.0,0.544567346572876,183.53184007102948,17,184,-14,1879,523,752,232,3
11,5,0,11.0,5.0,0.5523993968963623,173.04022523543227,17,173,-19,1879,523,752,232,3
8,3,0,8.0,3.0,0.560462236404419,165.4602054546371,17,165,-22,1879,523,752,232,3
5,2,0,5.0,2.0,0.56858229637146,160.78998732925348,17,160,-24,1879,523,752,232,3
3,1,0,3.0,1.0,0.5765342712402344,157.97798589741913,17,157,-25,1879,523,752,232,3
2,0,0,2.0,-0.0,0.5844593048095703,156.00318468107582,17,155,-25,1879,523,752,232,3
2,1,0,2.0,1.0,0.5924582481384277,154.1934276958918,17,153,-26,1879,523,752,232,3
2,1,0,2.0,1.0,0.6005442142486572,152.39491516996253,17,151,-27,1879,523,752,232,3
1,0,0,1.0,-0.0,0.6085422039031982,151.41062955056645,17,150,-27,1879,523,752,232,3
2,0,0,2.0,-0.0,0.6165924072265625,149.44268011438774,17,148,-27,1879,523,752,232,3
2,0,0,2.0,-0.0,0.6245832443237305,147.47558721890948,17,146,-27,1879,523,752,232,3
1,0,0,1.0,-0.0,0.6324372291564941,146.49237268414933,17,145,-27,1879,523,752,232,3
2,-1,0,2.0,-1.0,0.6404192447662354,144.34441853748632,17,143,-26,1879,523,752,232,3
2,-1,0,2.0,-1.0,0.6485493183135986,142.19916200872126,17,141,-25,1879,523,752,232,3
4,-2,0,4.0,-2.0,0.6565172672271729,137.91724155050014,17,137,-23,1879,523,752,232,3
2,-2,0,2.0,-2.0,0.6645634174346924,135.6235704408284,17,135,-21,1879,523,752,232,3
2,-2,0,2.0,-2.0,0.6725313663482666,133.35028842544403,17,133,-19,1879,523,752,232,3
3,-2,0,3.0,-2.0,0.6805503368377686,130.10682667199293,17,130,-17,1879,523,752,232,3
4,-1,0,4.0,-1.0,0.6884093284606934,126.01181047445942,17,126,-16,1879,523,752,232,3
4,-3,0,4.0,-3.0,0.6964402198791504,121.6906679417795,17,122,-13,1879,523,752,232,3
5,-2,0,5.0,-2.0,0.7045013904571533,116.51595636338071,17,117,-11,1879,523,752,232,3
6,-2,0,6.0,-2.0,0.712571382522583,110.36426715962351,17,111,-9,1879,523,752,232,3
7,-2,0,7.0,-2.0,0.7205734252929688,103.23531071570709,17,104,-7,1879,523,752,232,3
7,-2,0,7.0,-2.0,0.7285642623901367,96.12878049270464,17,97,-5,1879,523,752,232,3
6,-1,0,6.0,-1.0,0.7365512847900391,90.08786966440702,17,91,-4,1879,523,752,232,3
3,-1,0,3.0,-1.0,0.7445483207702637,87.05112151472007,17,88,-3,1879,523,752,232,3
3,0,0,3.0,-0.0,0.7525172233581543,84.05292469985967,17,85,-3,1879,523,752,232,3
3,-1,0,3.0,-1.0,0.7605624198913574,81.02438661763951,17,82,-2,1879,523,752,232,3
5,-1,0,5.0,-1.0,0.7684943675994873,76.00649323271382,17,77,-1,1879,523,752,232,3
4,0,0,4.0,-0.0,0.7764892578125,72.00684899377592,17,73,-1,1879,523,752,232,3
5,-1,0,5.0,-1.0,0.7844023704528809,67.0,17,68,0,1879,523,752,232,3
4,0,0,4.0,-0.0,0.7924973964691162,63.0,17,64,0,1879,523,752,232,3
4,-1,0,4.0,-1.0,0.8005893230438232,59.00833275470999,17,60,1,1879,523,752,232,3
3,0,0,3.0,-0.0,0.8085613250732422,56.0087712549569,17,57,1,1879,523,752,232,3
3,0,0,3.0,-0.0,0.8165743350982666,53.00925846556311,17,54,1,1879,523,752,232,3
2,0,0,2.0,-0.0,0.8245563507080078,51.009614495783374,17,52,1,1879,523,752,232,3
1,0,0,1.0,-0.0,0.8324522972106934,50.0098029794274,17,51,1,1879,523,752,232,3
2,0,0,2.0,-0.0,0.8406062126159668,48.01020301937138,17,49,1,1879,523,752,232,3
1,0,0,1.0,-0.0,0.8485162258148193,47.010415536631214,17,48,1,1879,523,752,232,3
1,0,0,1.0,-0.0,0.8564822673797607,46.01063709417264,17,47,1,1879,523,752,232,3
1,0,0,1.0,-0.0,0.8644154071807861,45.010868281309364,17,46,1,1879,523,752,232,3
1,0,0,1.0,-0.0,0.872488260269165,44.0111097397076,17,45,1,1879,523,752,232,3
2,0,0,2.0,-0.0,0.880547285079956,42.01162633521314,17,43,1,1879,523,752,232,3
1,0,0,1.0,-0.0,0.888566255569458,41.01190307520001,17,42,1,1879,523,752,232,3
2,0,0,2.0,-0.0,0.8965613842010498,39.01249804748511,17,40,1,1879,523,752,232,3
1,0,0,1.0,-0.0,0.9125332832336426,38.01281840626232,17,39,1,1879,523,752,232,3
1,0,0,1.0,-0.0,0.9203963279724121,37.01315561749642,17,38,1,1879,523,752,232,3
2,0,0,2.0,-0.0,0.9284074306488037,35.013886210738214,17,36,1,1879,523,752,232,3
1,0,0,1.0,-0.0,0.9364943504333496,34.014282800023196,17,35,1,1879,523,752,232,3
1,0,0,1.0,-0.0,0.9445772171020508,33.0147027033899,17,34,1,1879,523,752,232,3
1,0,0,1.0,-0.0,0.9525752067565918,32.015148038438355,17,33,1,1879,523,752,232,3
1,0,0,1.0,-0.0,0.9605362415313721,31.015621187164243,17,32,1,1879,523,752,232,3
1,1,0,1.0,1.0,0.9685664176940918,30.0,17,31,0,1879,523,752,232,3
2,0,0,2.0,-0.0,0.9845082759857178,28.0,17,29,0,1879,523,752,232,3
1,0,0,1.0,-0.0,0.9925363063812256,27.0,17,28,0,1879,523,752,232,3
1,0,0,1.0,-0.0,1.0006492137908936,26.0,17,27,0,1879,523,752,232,3
1,0,0,1.0,-0.0,1.0165643692016602,25.0,17,26,0,1879,523,752,232,3
1,0,0,1.0,-0.0,1.0245392322540283,24.0,17,25,0,1879,523,752,232,3
1,0,0,1.0,-0.0,1.0327033996582031,23.0,17,24,0,1879,523,752,232,3
1,0,0,1.0,-0.0,1.040607213973999,22.0,17,23,0,1879,523,752,232,3
1,0,0,1.0,-0.0,1.048584222793579,21.0,17,22,0,1879,523,752,232,3
1,0,0,1.0,-0.0,1.0565013885498047,20.0,17,21,0,1879,523,752,232,3
1,0,0,1.0,-0.0,1.0644752979278564,19.0,17,20,0,1879,523,752,232,3
1,0,0,1.0,-0.0,1.072533369064331,18.0,17,19,0,1879,523,752,232,3
1,0,0,1.0,-0.0,1.080503225326538,17.0,17,18,0,1879,523,752,232,3
1,0,0,1.0,-0.0,1.0887093544006348,16.0,17,17,0,1879,523,752,232,3
1,0,0,1.0,-0.0,1.0965332984924316,15.0,17,16,0,1879,523,752,232,3
2,0,0,2.0,-0.0,1.1045982837677002,13.0,17,14,0,1879,523,752,232,3
0,-1,0,-0.0,-1.0,1.1125683784484863,13.035668847618199,17,14,1,1879,523,752,232,3
1,0,0,1.0,-0.0,1.1206324100494385,12.038404810405298,17,13,1,1879,523,752,232,3
1,0,0,1.0,-0.0,1.1286404132843018,11.041594578792296,17,12,1,1879,523,752,232,3
1,0,0,1.0,-0.0,1.152496337890625,10.045361017187261,17,11,1,1879,523,752,232,3
1,0,0,1.0,-0.0,1.1686244010925293,9.04987562112089,17,10,1,1879,523,752,232,3
1,0,0,1.0,-0.0,1.1925482749938965,8.055385138137417,17,9,1,1879,523,752,232,3
1,0,0,1.0,-0.0,1.2406094074249268,7.062257748298549,17,8,1,1879,523,752,232,3
1,0,0,1.0,-0.0,1.280564308166504,6.0710678118654755,17,7,1,1879,523,752,232,3
1,0,0,1.0,-0.0,1.3285644054412842,5.082762530298219,17,6,1,1879,523,752,232,3
0,0,1,-0.0,-0.0,1.3354144096374512,5.082762530298219,17,6,1,1879,523,752,232,3
1,0,1,1.0,-0.0,1.3604283332824707,4.0990195135927845,17,5,1,1879,523,752,232,3
1,0,1,1.0,-0.0,1.3845124244689941,3.1231056256176606,17,4,1,1879,523,752,232,3
1,0,1,1.0,-0.0,1.4006292819976807,2.1622776601683795,17,3,1,1879,523,752,232,3
1,0,1,1.0,-0.0,1.4086003303527832,1.2360679774997898,17,2,1,1879,523,752,232,3
1,0,1,1.0,-0.0,1.4244964122772217,0.41421356237309515,17,1,1,1879,523,752,232,3
0,0,0,-0.0,-0.0,1.4434893131256104,0.41421356237309515,17,1,1,1879,523,752,232,3
1,0,0,1.0,-0.0,1.456465244293213,0.0,17,0,1,1879,523,752,232,3
1,0,0,1.0,-0.0,1.4885563850402832,0.41421356237309515,17,-1,1,1879,523,752,232,3
1,0,0,1.0,-0.0,1.5047023296356201,1.2360679774997898,17,-2,1,1879,523,752,232,3
1,0,0,1.0,-0.0,1.5284574031829834,2.1622776601683795,17,-3,1,1879,523,752,232,3
0,0,1,-0.0,-0.0,1.573573350906372,2.1622776601683795,17,-3,1,1879,523,752,232,3
1,0,1,1.0,-0.0,0.0056095123291015625,1538.8391165111013,18,-1496,420,387,942,1882,522,31
0,0,0,-0.0,-0.0,0.10858440399169922,1538.8391165111013,18,-1496,420,387,942,1882,522,31
-1,1,0,-1.0,1.0,0.21354341506958008,1537.6061960458615,18,-1495,419,387,942,1882,522,31
-3,0,0,-3.0,-0.0,0.22150635719299316,1534.717716230927,18,-1492,419,387,942,1882,522,31
-5,2,0,-5.0,2.0,0.22960638999938965,1529.3632992272253,18,-1487,417,387,942,1882,522,31
-6,3,0,-6.0,3.0,0.2375943660736084,1522.7766417786427,18,-1481,414,387,942,1882,522,31
-9,4,0,-9.0,4.0,0.2457585334777832,1513.032722162716,18,-1472,410,387,942,1882,522,31
-12,3,0,-12.0,3.0,0.25359153747558594,1500.6678396007485,18,-1460,407,387,942,1882,522,31
-13,4,0,-13.0,4.0,0.2615795135498047,1487.0712366595667,18,-1447,403,387,942,1882,522,31
-15,5,0,-15.0,5.0,0.26958751678466797,1471.2799197997663,18,-1432,398,387,942,1882,522,31
-15,5,0,-15.0,5.0,0.2776973247528076,1455.4890343011743,18,-1417,393,387,942,1882,522,31
-16,5,0,-16.0,5.0,0.28568053245544434,1438.734845148867,18,-1401,388,387,942,1882,522,31
-18,6,0,-18.0,6.0,0.29363036155700684,1419.7867437358068,18,-1383,382,387,942,1882,522,31
-24,7,0,-24.0,7.0,0.30159831047058105,1394.789345966269,18,-1359,375,387,942,1882,522,31
-36,11,0,-36.0,11.0,0.3095254898071289,1357.160704873886,18,-1323,364,387,942,1882,522,31
-41,11,0,-41.0,11.0,0.31762242317199707,1314.7116228716661,18,-1282,353,387,942,1882,522,31
-52,13,0,-52.0,13.0,0.3255174160003662,1261.1269529321917,18,-1230,340,387,942,1882,522,31
-55,14,0,-55.0,14.0,0.3335545063018799,1204.3855009798992,18,-1175,326,387,942,1882,522,31
-60,14,0,-60.0,14.0,0.3415415287017822,1142.829434761442,18,-1115,312,387,942,1882,522,31
-64,13,0,-64.0,13.0,0.34949445724487305,1077.7039855331361,18,-1051,299,387,942,1882,522,31
-64,12,0,-64.0,12.0,0.35750436782836914,1012.88034323067,18,-987,287,387,942,1882,522,31
-61,13,0,-61.0,13.0,0.3655834197998047,950.6873199954528,18,-926,274,387,942,1882,522,31
-58,14,0,-58.0,14.0,0.37360644340515137,891.1037468193143,18,-868,260,387,942,1882,522,31
-48,14,0,-48.0,14.0,0.3815925121307373,841.1051337306651,18,-820,246,387,942,1882,522,31
-40,12,0,-40.0,12.0,0.38953447341918945,799.343907695023,18,-780,234,387,942,1882,522,31
-33,13,0,-33.0,13.0,0.3975954055786133,764.0057766152958,18,-747,221,387,942,1882,522,31
-29,12,0,-29.0,12.0,0.4056243896484375,732.8001069804684,18,-718,209,387,942,1882,522,31
-25,12,0,-25.0,12.0,0.4135885238647461,705.4567995376267,18,-693,197,387,942,1882,522,31
-20,10,0,-20.0,10.0,0.42151951789855957,683.4969577600177,18,-673,187,387,942,1882,522,31
-16,10,0,-16.0,10.0,0.4295773506164551,665.424867270443,18,-657,177,387,942,1882,522,31
-15,11,0,-15.0,11.0,0.4375624656677246,648.1138665417878,18,-642,166,387,942,1882,522,31
-15,11,0,-15.0,11.0,0.445636510848999,630.874600832081,18,-627,155,387,942,1882,522,31
-13,10,0,-13.0,10.0,0.4536154270172119,615.8890552228656,18,-614,145,387,942,1882,522,31
-14,10,0,-14.0,10.0,0.4616074562072754,600.0,18,-600,135,387,942,1882,522,31
-12,8,0,-12.0,8.0,0.4696063995361328,586.5588084302316,18,-588,127,387,942,1882,522,31
-11,8,0,-11.0,8.0,0.4776034355163574,574.1434460299122,18,-577,119,387,942,1882,522,31
-9,5,0,-9.0,5.0,0.485790491104126,564.3271959782313,18,-568,114,387,942,1882,522,31
-9,4,0,-9.0,4.0,0.4935493469238281,554.72010671908,18,-559,110,387,942,1882,522,31
-11,4,0,-11.0,4.0,0.5015294551849365,543.1576838134542,18,-548,106,387,942,1882,522,31
-13,2,0,-13.0,2.0,0.5095624923706055,530.0146787014089,18,-535,104,387,942,1882,522,31
-15,3,0,-15.0,3.0,0.5176563262939453,514.717849425522,18,-520,101,387,942,1882,522,31
-19,2,0,-19.0,2.0,0.5255835056304932,495.687771539519,18,-501,99,387,942,1882,522,31
-20,1,0,-20.0,1.0,0.5336174964904785,475.881859514079,18,-481,98,387,942,1882,522,31
-20,2,0,-20.0,2.0,0.5416343212127686,455.8895836605435,18,-461,96,387,942,1882,522,31
-19,2,0,-19.0,2.0,0.5496125221252441,436.88494110780016,18,-442,94,387,942,1882,522,31
-16,2,0,-16.0,2.0,0.5576493740081787,420.82106419951754,18,-426,92,387,942,1882,522,31
-15,3,0,-15.0,3.0,0.5655984878540039,405.52586127371524,18,-411,89,387,942,1882,522,31
-13,3,0,-13.0,3.0,0.5735394954681396,392.18546143004664,18,-398,86,387,942,1882,522,31
-11,2,0,-11.0,2.0,0.5815873146057129,381.01136347332255,18,-387,84,387,942,1882,522,31
-11,2,0,-11.0,2.0,0.5895864963531494,369.83762809787714,18,-376,82,387,942,1882,522,31
-11,2,0,-11.0,2.0,0.5976123809814453,358.6642878306676,18,-365,80,387,942,1882,522,31
-9,2,0,-9.0,2.0,0.6056053638458252,349.44478319767455,18,-356,78,387,942,1882,522,31
-9,2,0,-9.0,2.0,0.613619327545166,340.225280631883,18,-347,76,387,942,1882,522,31
-9,2,0,-9.0,2.0,0.6215925216674805,331.0057802985378,18,-338,74,387,942,1882,522,31
-11,3,0,-11.0,3.0,0.629535436630249,319.619186538967,18,-327,71,387,942,1882,522,31
-14,4,0,-14.0,4.0,0.6376023292541504,305.09061217099134,18,-313,67,387,942,1882,522,31
-15,4,0,-15.0,4.0,0.6454484462738037,289.58660508958695,18,-298,63,387,942,1882,522,31
-15,4,0,-15.0,4.0,0.6535854339599609,274.0847626562147,18,-283,59,387,942,1882,522,31
-16,5,0,-16.0,5.0,0.661670446395874,257.40594707164524,18,-267,54,387,942,1882,522,31
-14,5,0,-14.0,5.0,0.6696093082427979,242.70137756713683,18,-253,49,387,942,1882,522,31
-13,4,0,-13.0,4.0,0.6776413917541504,229.1823089414956,18,-240,45,387,942,1882,522,31
-14,4,0,-14.0,4.0,0.6855893135070801,214.68892006363737,18,-226,41,387,942,1882,522,31
-13,5,0,-13.0,5.0,0.6936655044555664,201.0208323287363,18,-213,36,387,942,1882,522,31
-13,3,0,-13.0,3.0,0.7015924453735352,187.70421801235415,18,-200,33,387,942,1882,522,31
-10,3,0,-10.0,3.0,0.7095274925231934,177.35384061671346,18,-190,30,387,942,1882,522,31
-10,4,0,-10.0,4.0,0.7175943851470947,166.86808406094787,18,-180,26,387,942,1882,522,31
-8,3,0,-8.0,3.0,0.7255523204803467,158.53097706173386,18,-172,23,387,942,1882,522,31
-8,3,0,-8.0,3.0,0.7335515022277832,150.21501142450705,18,-164,20,387,942,1882,522,31
-8,4,0,-8.0,4.0,0.7415063381195068,141.81836627130127,18,-156,16,387,942,1882,522,31
-8,2,0,-8.0,2.0,0.7496054172515869,133.66068747318505,18,-148,14,387,942,1882,522,31
-8,3,0,-8.0,3.0,0.7576043605804443,125.43147795277241,18,-140,11,387,942,1882,522,31
-10,2,0,-10.0,2.0,0.7655093669891357,115.31116606031887,18,-130,9,387,942,1882,522,31
-11,2,0,-11.0,2.0,0.7737233638763428,104.20570456148481,18,-119,7,387,942,1882,522,31
-9,1,0,-9.0,1.0,0.7814714908599854,95.16351483136329,18,-110,6,387,942,1882,522,31
-9,1,0,-9.0,1.0,0.7894995212554932,86.1236866416568,18,-101,5,387,942,1882,522,31
-8,1,0,-8.0,1.0,0.7975454330444336,78.08598175880189,18,-93,4,387,942,1882,522,31
-9,0,0,-9.0,-0.0,0.8056294918060303,69.09518416651456,18,-84,4,387,942,1882,522,31
-8,0,0,-8.0,-0.0,0.8135185241699219,61.105190361761785,18,-76,4,387,942,1882,522,31
-7,1,0,-7.0,1.0,0.8215463161468506,54.06518659932803,18,-69,3,387,942,1882,522,31
-7,0,0,-7.0,-0.0,0.8295643329620361,47.07253821135398,18,-62,3,387,942,1882,522,31
-7,0,0,-7.0,-0.0,0.8377804756164551,40.08175741568164,18,-55,3,387,942,1882,522,31
-8,1,0,-8.0,1.0,0.8456354141235352,32.042533945356304,18,-47,2,387,942,1882,522,31
-8,1,0,-8.0,1.0,0.8535523414611816,24.01281840626232,18,-39,1,387,942,1882,522,31
-7,0,0,-7.0,-0.0,0.8615214824676514,17.015621187164243,18,-32,1,387,942,1882,522,31
-8,1,0,-8.0,1.0,0.8695244789123535,9.0,18,-24,0,387,942,1882,522,31
-7,0,0,-7.0,-0.0,0.8775374889373779,2.0,18,-17,0,387,942,1882,522,31
-6,1,0,-6.0,1.0,0.8855705261230469,-3.954638982812739,18,-11,-1,387,942,1882,522,31
-7,0,0,-7.0,-0.0,0.8936154842376709,-10.876894374382339,18,-4,-1,387,942,1882,522,31
-6,0,0,-6.0,-0.0,0.9015963077545166,-12.76393202250021,18,2,-1,387,942,1882,522,31
-5,1,0,-5.0,1.0,0.9096863269805908,-7.719890110719482,18,7,-2,387,942,1882,522,31
-4,0,0,-4.0,-0.0,0.9176235198974609,-3.819660112501051,18,11,-2,387,942,1882,522,31
-3,0,0,-3.0,-0.0,0.9258544445037842,-0.857864376269049,18,14,-2,387,942,1882,522,31
-2,1,0,-2.0,1.0,0.9335734844207764,1.278820596099706,18,16,-3,387,942,1882,522,31
-2,0,0,-2.0,-0.0,0.9414563179016113,3.248287590894659,18,18,-3,387,942,1882,522,31
-1,0,0,-1.0,-0.0,0.9494993686676025,4.235384061671343,18,19,-3,387,942,1882,522,31
-2,1,0,-2.0,1.0,0.9576573371887207,6.377558326431949,18,21,-4,387,942,1882,522,31
-1,0,0,-1.0,-0.0,0.9656314849853516,7.360679774997898,18,22,-4,387,942,1882,522,31
0,0,1,-0.0,-0.0,1.008568525314331,7.360679774997898,18,22,-4,387,942,1882,522,31
0,0,0,-0.0,-0.0,0.05801796913146973,1247.5073385307812,19,1275,80,1640,1026,365,946,61
2,-1,0,2.0,-1.0,0.07798314094543457,1245.5743804263238,19,1273,81,1640,1026,365,946,61
3,-2,0,3.0,-2.0,0.08598518371582031,1242.7093148083736,19,1270,83,1640,1026,365,946,61
4,-3,0,4.0,-3.0,0.09403300285339355,1238.9176490221894,19,1266,86,1640,1026,365,946,61
3,-2,0,3.0,-2.0,0.10204815864562988,1236.0620048007127,19,1263,88,1640,1026,365,946,61
4,-2,0,4.0,-2.0,0.11005711555480957,1232.2127395966181,19,1259,90,1640,1026,365,946,61
3,-3,0,3.0,-3.0,0.11805200576782227,1229.4383668921635,19,1256,93,1640,1026,365,946,61
3,-2,0,3.0,-2.0,0.12625598907470703,1226.5961960789155,19,1253,95,1640,1026,365,946,61
4,-4,0,4.0,-4.0,0.1340491771697998,1222.917395521349,19,1249,99,1640,1026,365,946,61
6,-3,0,6.0,-3.0,0.14208102226257324,1217.1780145592688,19,1243,102,1640,1026,365,946,61
7,-4,0,7.0,-4.0,0.14996004104614258,1210.5369805048135,19,1236,106,1640,1026,365,946,61
8,-4,0,8.0,-4.0,0.15815114974975586,1202.91686662159,19,1228,110,1640,1026,365,946,61
7,-3,0,7.0,-3.0,0.16613101959228516,1196.2177620634925,19,1221,113,1640,1026,365,946,61
9,-4,0,9.0,-4.0,0.1740400791168213,1187.6341815175854,19,1212,117,1640,1026,365,946,61
12,-5,0,12.0,-5.0,0.18205904960632324,1176.1857236760845,19,1200,122,1640,1026,365,946,61
15,-5,0,15.0,-5.0,0.19005417823791504,1161.7860546255774,19,1185,127,1640,1026,365,946,61
19,-6,0,19.0,-6.0,0.19811010360717773,1143.5608207502498,19,1166,133,1640,1026,365,946,61
20,-5,0,20.0,-5.0,0.20597314834594727,1124.2789957371658,19,1146,138,1640,1026,365,946,61
22,-3,0,22.0,-3.0,0.21407198905944824,1102.809339650764,19,1124,141,1640,1026,365,946,61
21,-3,0,21.0,-3.0,0.22214603424072266,1082.3601035635897,19,1103,144,1640,1026,365,946,61
21,-2,0,21.0,-2.0,0.23015117645263672,1061.8058435454539,19,1082,146,1640,1026,365,946,61
20,-1,0,20.0,-1.0,0.23815298080444336,1042.125459076502,19,1062,147,1640,1026,365,946,61
20,-1,0,20.0,-1.0,0.24608111381530762,1022.4580751744936,19,1042,148,1640,1026,365,946,61
22,0,0,22.0,-0.0,0.2540590763092041,1000.6813280544088,19,1020,148,1640,1026,365,946,61
24,1,0,24.0,1.0,0.2620861530303955,976.78945167299,19,996,147,1640,1026,365,946,61
26,1,0,26.0,1.0,0.2700619697570801,950.9260930365753,19,970,146,1640,1026,365,946,61
29,2,0,29.0,2.0,0.2781400680541992,921.9543056260632,19,941,144,1640,1026,365,946,61
33,3,0,33.0,3.0,0.2860291004180908,888.8824734426051,19,908,141,1640,1026,365,946,61
35,3,0,35.0,3.0,0.29407215118408203,853.8399176321468,19,873,138,1640,1026,365,946,61
34,3,0,34.0,3.0,0.30208301544189453,819.7917391926095,19,839,135,1640,1026,365,946,61
31,4,0,31.0,4.0,0.31005406379699707,788.5505482253371,19,808,131,1640,1026,365,946,61
30,6,0,30.0,6.0,0.31798505783081055,757.9777915652191,19,778,125,1640,1026,365,946,61
26,6,0,26.0,6.0,0.3260509967803955,731.3573405438474,19,752,119,1640,1026,365,946,61
27,6,0,27.0,6.0,0.3340730667114258,703.7533645578737,19,725,113,1640,1026,365,946,61
27,6,0,27.0,6.0,0.342041015625,676.1536659962901,19,698,107,1640,1026,365,946,61
26,5,0,26.0,5.0,0.35005998611450195,649.6969913130409,19,672,102,1640,1026,365,946,61
28,4,0,28.0,4.0,0.358428955078125,621.4138469513831,19,644,98,1640,1026,365,946,61
27,4,0,27.0,4.0,0.365955114364624,594.1193796061776,19,617,94,1640,1026,365,946,61
27,4,0,27.0,4.0,0.3742079734802246,566.8249324550709,19,590,90,1640,1026,365,946,61
24,3,0,24.0,3.0,0.38196897506713867,542.647360947381,19,566,87,1640,1026,365,946,61
23,3,0,23.0,3.0,0.3900570869445801,519.4588246629587,19,543,84,1640,1026,365,946,61
21,4,0,21.0,4.0,0.3980550765991211,498.0946884792537,19,522,80,1640,1026,365,946,61
22,3,0,22.0,3.0,0.40610218048095703,475.8942577258611,19,500,77,1640,1026,365,946,61
22,4,0,22.0,4.0,0.4141240119934082,453.54213880488226,19,478,73,1640,1026,365,946,61
23,2,0,23.0,2.0,0.42206907272338867,430.5062431715774,19,455,71,1640,1026,365,946,61
25,4,0,25.0,4.0,0.4306039810180664,405.1884649206594,19,430,67,1640,1026,365,946,61
23,3,0,23.0,3.0,0.43824005126953125,382.0012135904456,19,407,64,1640,1026,365,946,61
21,2,0,21.0,2.0,0.4461209774017334,360.9475668168303,19,386,62,1640,1026,365,946,61
21,3,0,21.0,3.0,0.4539921283721924,339.73774489494576,19,365,59,1640,1026,365,946,61
19,3,0,19.0,3.0,0.46193599700927734,320.5024964247758,19,346,56,1640,1026,365,946,61
18,3,0,18.0,3.0,0.47011804580688477,302.2544205875973,19,328,53,1640,1026,365,946,61
16,2,0,16.0,2.0,0.47810816764831543,286.1407914205315,19,312,51,1640,1026,365,946,61
16,3,0,16.0,3.0,0.4860110282897949,269.866637023861,19,296,48,1640,1026,365,946,61
14,2,0,14.0,2.0,0.4941291809082031,255.72714256787015,19,282,46,1640,1026,365,946,61
15,2,0,15.0,2.0,0.5020601749420166,240.60118255469615,19,267,44,1640,1026,365,946,61
14,3,0,14.0,3.0,0.5101561546325684,226.30060475933334,19,253,41,1640,1026,365,946,61
14,2,0,14.0,2.0,0.518092155456543,212.16110340019515,19,239,39,1640,1026,365,946,61
13,2,0,13.0,2.0,0.5259389877319336,199.0087334579186,19,226,37,1640,1026,365,946,61
14,2,0,14.0,2.0,0.5340590476989746,184.8697279748825,19,212,35,1640,1026,365,946,61
15,1,0,15.0,1.0,0.542086124420166,169.9124808509964,19,197,34,1640,1026,365,946,61
16,1,0,16.0,1.0,0.5501160621643066,153.98369492974098,19,181,33,1640,1026,365,946,61
16,0,0,16.0,-0.0,0.5580651760101318,138.2676439485619,19,165,33,1640,1026,365,946,61
14,0,0,14.0,-0.0,0.5660641193389893,124.56390264224049,19,151,33,1640,1026,365,946,61
12,1,0,12.0,1.0,0.5740721225738525,112.63590010933433,19,139,32,1640,1026,365,946,61
7,1,0,7.0,1.0,0.5819711685180664,105.5912976558599,19,132,31,1640,1026,365,946,61
3,0,0,3.0,-0.0,0.5900650024414062,102.67252918370102,19,129,31,1640,1026,365,946,61
1,0,0,1.0,-0.0,0.5980720520019531,101.70041761513136,19,128,31,1640,1026,365,946,61
1,0,0,1.0,-0.0,0.6059920787811279,100.728726758888,19,127,31,1640,1026,365,946,61
2,0,0,2.0,-0.0,0.6142091751098633,98.7866452703851,19,125,31,1640,1026,365,946,61
2,0,0,2.0,-0.0,0.6219570636749268,96.84636376341263,19,123,31,1640,1026,365,946,61
3,0,0,3.0,-0.0,0.6300780773162842,93.9395013706284,19,120,31,1640,1026,365,946,61
1,0,0,1.0,-0.0,0.638059139251709,92.97154142320898,19,119,31,1640,1026,365,946,61
2,0,0,2.0,-0.0,0.6461169719696045,91.03718436910205,19,117,31,1640,1026,365,946,61
1,0,0,1.0,-0.0,0.6539561748504639,90.07081243999309,19,116,31,1640,1026,365,946,61
1,0,0,1.0,-0.0,0.6619641780853271,89.10499569707393,19,115,31,1640,1026,365,946,61
0,1,0,-0.0,1.0,0.6699361801147461,88.84864324004712,19,115,30,1640,1026,365,946,61
1,0,0,1.0,-0.0,0.6781370639801025,87.881296226331,19,114,30,1640,1026,365,946,61
1,0,0,1.0,-0.0,0.6940481662750244,86.91449867317569,19,113,30,1640,1026,365,946,61
1,0,0,1.0,-0.0,0.7020561695098877,85.94826432508596,19,112,30,1640,1026,365,946,61
3,1,0,3.0,1.0,0.7101070880889893,82.79184367674819,19,109,29,1640,1026,365,946,61
4,1,0,4.0,1.0,0.7180891036987305,78.66922287382016,19,105,28,1640,1026,365,946,61
5,1,0,5.0,1.0,0.7259790897369385,73.58088626768937,19,100,27,1640,1026,365,946,61
6,1,0,6.0,1.0,0.7339441776275635,67.52948272189288,19,94,26,1640,1026,365,946,61
7,3,0,7.0,3.0,0.7420830726623535,59.98888820293314,19,87,23,1640,1026,365,946,61
7,1,0,7.0,1.0,0.7500090599060059,52.969874050766165,19,80,22,1640,1026,365,946,61
8,2,0,8.0,2.0,0.7580051422119141,44.72616676907762,19,72,20,1640,1026,365,946,61
6,2,0,6.0,2.0,0.7660479545593262,38.410525505948286,19,66,18,1640,1026,365,946,61
6,2,0,6.0,2.0,0.7740061283111572,32.0966987850401,19,60,16,1640,1026,365,946,61
6,1,0,6.0,1.0,0.782067060470581,26.044625076808217,19,54,15,1640,1026,365,946,61
6,2,0,6.0,2.0,0.7904951572418213,19.729267036625423,19,48,13,1640,1026,365,946,61
5,1,0,5.0,1.0,0.7979850769042969,14.643028571099428,19,43,12,1640,1026,365,946,61
4,0,0,4.0,-0.0,0.8059370517730713,10.80441152620633,19,39,12,1640,1026,365,946,61
2,1,0,2.0,1.0,0.8140051364898682,8.600518131237564,19,37,11,1640,1026,365,946,61
1,0,0,1.0,-0.0,0.8220391273498535,7.643060449437421,19,36,11,1640,1026,365,946,61
0,0,1,-0.0,-0.0,0.8400521278381348,7.643060449437421,19,36,11,1640,1026,365,946,61
0,0,0,-0.0,-0.0,0.0943448543548584,581.2391910493724,20,121,-592,1725,423,1604,1015,47
0,-2,0,-0.0,-2.0,0.21646475791931152,579.2798352925324,20,121,-590,1725,423,1604,1015,47
-1,-9,0,-1.0,-9.0,0.2244277000427246,570.6707841893518,20,122,-581,1725,423,1604,1015,47
-3,-19,0,-3.0,-19.0,0.23245668411254883,552.73344526786,20,125,-562,1725,423,1604,1015,47
-7,-23,0,-7.0,-23.0,0.24050569534301758,531.9279232476953,20,132,-539,1725,423,1604,1015,47
-9,-25,0,-9.0,-25.0,0.2483818531036377,509.98874284547514,20,141,-514,1725,423,1604,1015,47
-11,-26,0,-11.0,-26.0,0.25629091262817383,488.1242510388252,20,152,-488,1725,423,1604,1015,47
-9,-26,0,-9.0,-26.0,0.264589786529541,466.24942514018346,20,161,-462,1725,423,1604,1015,47
-6,-27,0,-6.0,-27.0,0.2723429203033447,442.9549334431389,20,167,-435,1725,423,1604,1015,47
0,-25,0,-0.0,-25.0,0.2804727554321289,419.7064490155977,20,167,-410,1725,423,1604,1015,47
6,-22,0,6.0,-22.0,0.2884197235107422,397.0773738253466,20,161,-388,1725,423,1604,1015,47
10,-18,0,10.0,-18.0,0.29647088050842285,376.62607522532863,20,151,-370,1725,423,1604,1015,47
10,-16,0,10.0,-16.0,0.3044106960296631,358.0472411657116,20,141,-354,1725,423,1604,1015,47
14,-17,0,14.0,-17.0,0.3126258850097656,337.1360853899537,20,127,-337,1725,423,1604,1015,47
15,-18,0,15.0,-18.0,0.3203258514404297,315.09022464425084,20,112,-319,1725,423,1604,1015,47
17,-17,0,17.0,-17.0,0.3283407688140869,293.58963975468305,20,95,-302,1725,423,1604,1015,47
16,-15,0,16.0,-15.0,0.3363518714904785,274.6743186773088,20,79,-287,1725,423,1604,1015,47
15,-13,0,15.0,-13.0,0.34442973136901855,258.37519435799595,20,64,-274,1725,423,1604,1015,47
13,-14,0,13.0,-14.0,0.3525118827819824,241.95471311150516,20,51,-260,1725,423,1604,1015,47
14,-13,0,14.0,-13.0,0.3604257106781006,226.75588081164375,20,37,-247,1725,423,1604,1015,47
12,-14,0,12.0,-14.0,0.36843180656433105,211.33736364481018,20,25,-233,1725,423,1604,1015,47
11,-14,0,11.0,-14.0,0.3764626979827881,196.44703233354514,20,14,-219,1725,423,1604,1015,47
10,-16,0,10.0,-16.0,0.3845837116241455,180.03940504246953,20,4,-203,1725,423,1604,1015,47
10,-18,0,10.0,-18.0,0.39246082305908203,162.09727172489605,20,-6,-185,1725,423,1604,1015,47
8,-18,0,8.0,-18.0,0.4002847671508789,144.5857989210303,20,-14,-167,1725,423,1604,1015,47
7,-17,0,7.0,-17.0,0.4085397720336914,128.46286673637206,20,-21,-150,1725,423,1604,1015,47
6,-16,0,6.0,-16.0,0.41634488105773926,113.69308687713507,20,-27,-134,1725,423,1604,1015,47
7,-12,0,7.0,-12.0,0.4244687557220459,103.64912159190051,20,-34,-122,1725,423,1604,1015,47
5,-9,0,5.0,-9.0,0.43248987197875977,96.54078801814885,20,-39,-113,1725,423,1604,1015,47
2,-6,0,2.0,-6.0,0.4404308795928955,91.58621208504974,20,-41,-107,1725,423,1604,1015,47
1,-5,0,1.0,-5.0,0.44844770431518555,87.30865786510141,20,-42,-102,1725,423,1604,1015,47
1,-4,0,1.0,-4.0,0.45635080337524414,84.01868995647442,20,-43,-98,1725,423,1604,1015,47
0,-4,0,-0.0,-4.0,0.46436381340026855,80.36827366266692,20,-43,-94,1725,423,1604,1015,47
1,-3,0,1.0,-3.0,0.4723038673400879,78.07917688624102,20,-44,-91,1725,423,1604,1015,47
0,-3,0,-0.0,-3.0,0.4805169105529785,75.38699100999075,20,-44,-88,1725,423,1604,1015,47
0,-3,0,-0.0,-3.0,0.4884037971496582,72.71311299921238,20,-44,-85,1725,423,1604,1015,47
0,-2,0,-0.0,-2.0,0.49652981758117676,70.94147114027967,20,-44,-83,1725,423,1604,1015,47
-1,-2,0,-1.0,-2.0,0.5044317245483398,68.706052144883,20,-43,-81,1725,423,1604,1015,47
0,-1,0,-0.0,-1.0,0.5124537944793701,67.82400563727631,20,-43,-80,1725,423,1604,1015,47
-1,-1,0,-1.0,-1.0,0.5205397605895996,66.47066558375433,20,-42,-79,1725,423,1604,1015,47
-1,-1,0,-1.0,-1.0,0.5284998416900635,65.11923740024082,20,-41,-78,1725,423,1604,1015,47
-1,0,0,-1.0,-0.0,0.5365927219390869,64.65842800324451,20,-40,-78,1725,423,1604,1015,47
-2,-2,0,-2.0,-2.0,0.5444416999816895,61.970583144992005,20,-38,-76,1725,423,1604,1015,47
-2,-1,0,-2.0,-1.0,0.5524368286132812,60.192547743172284,20,-36,-75,1725,423,1604,1015,47
-4,-3,0,-4.0,-3.0,0.5604007244110107,55.79086241436883,20,-32,-72,1725,423,1604,1015,47
-4,-3,0,-4.0,-3.0,0.5684418678283691,51.46475676452586,20,-28,-69,1725,423,1604,1015,47
-2,-4,0,-2.0,-4.0,0.576448917388916,47.00714249274856,20,-26,-65,1725,423,1604,1015,47
-2,-2,0,-2.0,-2.0,0.5845227241516113,44.4166151627327,20,-24,-63,1725,423,1604,1015,47
-3,-4,0,-3.0,-4.0,0.592451810836792,39.625873247404705,20,-21,-59,1725,423,1604,1015,47
-4,-5,0,-4.0,-5.0,0.6004207134246826,33.61271941887264,20,-17,-54,1725,423,1604,1015,47
-3,-4,0,-3.0,-4.0,0.6083927154541016,28.92301994298868,20,-14,-50,1725,423,1604,1015,47
-4,-4,0,-4.0,-4.0,0.6164298057556152,24.07440918375928,20,-10,-46,1725,423,1604,1015,47
-3,-5,0,-3.0,-5.0,0.6244497299194336,18.593268686170845,20,-7,-41,1725,423,1604,1015,47
-3,-4,0,-3.0,-4.0,0.6323187351226807,14.21558813185679,20,-4,-37,1725,423,1604,1015,47
-1,-4,0,-1.0,-4.0,0.6403558254241943,10.136083051561783,20,-3,-33,1725,423,1604,1015,47
-2,-2,0,-2.0,-2.0,0.6483488082885742,8.016124838541646,20,-1,-31,1725,423,1604,1015,47
-1,-2,0,-1.0,-2.0,0.6564288139343262,6.0,20,0,-29,1725,423,1604,1015,47
0,0,1,-0.0,-0.0,0.6863248348236084,6.0,20,0,-29,1725,423,1604,1015,47
0,0,0,-0.0,-0.0,0.08603620529174805,287.7303852676205,21,-129,265,1596,717,1725,452,14
-1,0,0,-1.0,-0.0,0.1340172290802002,287.2940706164499,21,-128,265,1596,717,1725,452,14
-4,0,0,-4.0,-0.0,0.14200925827026367,285.5764857263823,21,-124,265,1596,717,1725,452,14
-6,2,0,-6.0,2.0,0.14995622634887695,281.2585644868162,21,-118,263,1596,717,1725,452,14
-7,2,0,-7.0,2.0,0.15796232223510742,276.6229891951638,21,-111,261,1596,717,1725,452,14
-6,2,0,-6.0,2.0,0.16590332984924316,272.47450688747983,21,-105,259,1596,717,1725,452,14
-6,1,0,-6.0,1.0,0.174072265625,269.34217919094436,21,-99,258,1596,717,1725,452,14
-7,2,0,-7.0,2.0,0.18195533752441406,265.02941017470886,21,-92,256,1596,717,1725,452,14
-10,3,0,-10.0,3.0,0.18990635871887207,258.9567634033773,21,-82,253,1596,717,1725,452,14
-11,3,0,-11.0,3.0,0.1979084014892578,252.88651369395836,21,-71,250,1596,717,1725,452,14
-13,5,0,-13.0,5.0,0.20586538314819336,244.7717220022932,21,-58,245,1596,717,1725,452,14
-14,8,0,-14.0,8.0,0.21389436721801758,234.04978738841484,21,-44,237,1596,717,1725,452,14
-17,12,0,-17.0,12.0,0.22185635566711426,219.6142096162551,21,-27,225,1596,717,1725,452,14
-19,14,0,-19.0,14.0,0.2298872470855713,204.15160430363773,21,-8,211,1596,717,1725,452,14
-19,16,0,-19.0,16.0,0.23798727989196777,188.31000998412753,21,11,195,1596,717,1725,452,14
-17,17,0,-17.0,17.0,0.2459723949432373,173.18878988438766,21,28,178,1596,717,1725,452,14
-16,18,0,-16.0,18.0,0.2539513111114502,158.93974810153233,21,44,160,1596,717,1725,452,14
-11,15,0,-11.0,15.0,0.26195740699768066,148.08062419270823,21,55,145,1596,717,1725,452,14
-6,11,0,-6.0,11.0,0.2699863910675049,140.2311108427835,21,61,134,1596,717,1725,452,14
-2,8,0,-2.0,8.0,0.27805423736572266,133.87228258248675,21,63,126,1596,717,1725,452,14
0,6,0,-0.0,6.0,0.28583526611328125,128.5322839769182,21,63,120,1596,717,1725,452,14
0,4,0,-0.0,4.0,0.2939271926879883,125.00378782444085,21,63,116,1596,717,1725,452,14
1,3,0,1.0,3.0,0.302051305770874,121.89142717807107,21,62,113,1596,717,1725,452,14
2,3,0,2.0,3.0,0.30991339683532715,118.29964086141668,21,60,110,1596,717,1725,452,14
2,3,0,2.0,3.0,0.31798219680786133,114.70866854912184,21,58,107,1596,717,1725,452,14
2,2,0,2.0,2.0,0.3259751796722412,112.0,21,56,105,1596,717,1725,452,14
2,2,0,2.0,2.0,0.33396029472351074,109.29703349613007,21,54,103,1596,717,1725,452,14
2,1,0,2.0,1.0,0.3419373035430908,107.49017425089369,21,52,102,1596,717,1725,452,14
3,1,0,3.0,1.0,0.35018134117126465,105.25862995778988,21,49,101,1596,717,1725,452,14
4,1,0,4.0,1.0,0.35795021057128906,102.65856099730654,21,45,100,1596,717,1725,452,14
5,2,0,5.0,2.0,0.3658742904663086,98.84894897919393,21,40,98,1596,717,1725,452,14
6,2,0,6.0,2.0,0.3741002082824707,94.84301645179212,21,34,96,1596,717,1725,452,14
5,1,0,5.0,1.0,0.3819422721862793,92.32774033471213,21,29,95,1596,717,1725,452,14
4,2,0,4.0,2.0,0.3900022506713867,89.30160954002794,21,25,93,1596,717,1725,452,14
5,2,0,5.0,2.0,0.3981282711029053,86.17188417113823,21,20,91,1596,717,1725,452,14
4,1,0,4.0,1.0,0.4059932231903076,84.41115905621152,21,16,90,1596,717,1725,452,14
4,1,0,4.0,1.0,0.41400718688964844,82.80534505250787,21,12,89,1596,717,1725,452,14
4,2,0,4.0,2.0,0.4220702648162842,80.36704184073076,21,8,87,1596,717,1725,452,14
4,1,0,4.0,1.0,0.430408239364624,79.09297300012354,21,4,86,1596,717,1725,452,14
4,3,0,4.0,3.0,0.43793821334838867,76.0,21,0,83,1596,717,1725,452,14
1,2,0,1.0,2.0,0.44593119621276855,74.00617260431454,21,-1,81,1596,717,1725,452,14
1,2,0,1.0,2.0,0.45391225814819336,72.02531240052139,21,-2,79,1596,717,1725,452,14
1,2,0,1.0,2.0,0.46190834045410156,70.05841939723393,21,-3,77,1596,717,1725,452,14
0,3,0,-0.0,3.0,0.4698362350463867,67.06078584514209,21,-3,74,1596,717,1725,452,14
0,4,0,-0.0,4.0,0.47799229621887207,63.064256222413434,21,-3,70,1596,717,1725,452,14
0,3,0,-0.0,3.0,0.4859652519226074,60.067130548428864,21,-3,67,1596,717,1725,452,14
0,5,0,-0.0,5.0,0.4939613342285156,55.07253821135398,21,-3,62,1596,717,1725,452,14
0,4,0,-0.0,4.0,0.5020463466644287,51.077534382926416,21,-3,58,1596,717,1725,452,14
0,4,0,-0.0,4.0,0.5099432468414307,47.08326913195984,21,-3,54,1596,717,1725,452,14
-1,5,0,-1.0,5.0,0.5179202556610107,42.040799340956916,21,-2,49,1596,717,1725,452,14
0,5,0,-0.0,5.0,0.5259602069854736,37.04543109109048,21,-2,44,1596,717,1725,452,14
0,6,0,-0.0,6.0,0.5340323448181152,31.052595180880893,21,-2,38,1596,717,1725,452,14
-1,4,0,-1.0,4.0,0.5419423580169678,27.0147027033899,21,-1,34,1596,717,1725,452,14
0,5,0,-0.0,5.0,0.5499842166900635,22.017236257093817,21,-1,29,1596,717,1725,452,14
-1,4,0,-1.0,4.0,0.5578403472900391,18.0,21,0,25,1596,717,1725,452,14
-1,5,0,-1.0,5.0,0.5660324096679688,13.024984394500787,21,1,20,1596,717,1725,452,14
-1,6,0,-1.0,6.0,0.5738372802734375,7.142135623730951,21,2,14,1596,717,1725,452,14
0,5,0,-0.0,5.0,0.5819573402404785,2.219544457292887,21,2,9,1596,717,1725,452,14
-1,3,0,-1.0,3.0,0.5899572372436523,-0.2917960675006306,21,3,6,1596,717,1725,452,14
0,3,0,-0.0,3.0,0.5978753566741943,-2.7573593128807152,21,3,3,1596,717,1725,452,14
0,1,0,-0.0,1.0,0.6059832572937012,-3.394448724536011,21,3,2,1596,717,1725,452,14
0,0,1,-0.0,-0.0,0.6879034042358398,-3.394448724536011,21,3,2,1596,717,1725,452,14
0,0,0,-0.0,-0.0,0.09072184562683105,218.43844490407443,22,181,141,1774,856,1593,715,22
-1,0,0,-1.0,-0.0,0.16070103645324707,219.2281477143922,22,182,141,1774,856,1593,715,22
-3,-1,0,-3.0,-1.0,0.16878986358642578,222.21449354617735,22,185,142,1774,856,1593,715,22
-2,-2,0,-2.0,-2.0,0.1767749786376953,225.01906702637396,22,187,144,1774,856,1593,715,22
-2,-2,0,-2.0,-2.0,0.1847670078277588,227.8242031285774,22,189,146,1774,856,1593,715,22
-1,-1,0,-1.0,-1.0,0.19281291961669922,229.22697600394508,22,190,147,1774,856,1593,715,22
0,-1,0,-0.0,-1.0,0.20085501670837402,229.84019598065436,22,190,148,1774,856,1593,715,22
0,-1,0,-0.0,-1.0,0.20879602432250977,230.4560001325293,22,190,149,1774,856,1593,715,22
0,-1,0,-0.0,-1.0,0.2168290615081787,231.0743687382041,22,190,150,1774,856,1593,715,22
2,-1,0,2.0,-1.0,0.22481799125671387,230.13274352522097,22,188,151,1774,856,1593,715,22
3,-1,0,3.0,-1.0,0.23271799087524414,228.4347510283334,22,185,152,1774,856,1593,715,22
5,-2,0,5.0,-2.0,0.2407970428466797,225.88815926508443,22,180,154,1774,856,1593,715,22
7,-1,0,7.0,-1.0,0.24868297576904297,221.28000344411913,22,173,155,1774,856,1593,715,22
7,-1,0,7.0,-1.0,0.25685691833496094,216.7981562699751,22,166,156,1774,856,1593,715,22
8,0,0,8.0,-0.0,0.2648780345916748,211.03603311174518,22,158,156,1774,856,1593,715,22
12,0,0,12.0,-0.0,0.27278995513916016,202.66328650472454,22,146,156,1774,856,1593,715,22
17,3,0,17.0,3.0,0.28082990646362305,189.124960961895,22,129,153,1774,856,1593,715,22
20,4,0,20.0,4.0,0.2888040542602539,173.6131089603336,22,109,149,1774,856,1593,715,22
21,6,0,21.0,6.0,0.29686594009399414,156.90771274721124,22,88,143,1774,856,1593,715,22
20,6,0,20.0,6.0,0.30478787422180176,141.9477034806342,22,68,137,1774,856,1593,715,22
18,7,0,18.0,7.0,0.31279492378234863,128.2838827718412,22,50,130,1774,856,1593,715,22
18,9,0,18.0,9.0,0.32099485397338867,114.15989773086265,22,32,121,1774,856,1593,715,22
15,9,0,15.0,9.0,0.3289499282836914,102.28283188550682,22,17,112,1774,856,1593,715,22
14,10,0,14.0,10.0,0.33684396743774414,91.04410811016969,22,3,102,1774,856,1593,715,22
11,10,0,11.0,10.0,0.34482789039611816,81.34717104492157,22,-8,92,1774,856,1593,715,22
10,10,0,10.0,10.0,0.3527998924255371,72.95236744726142,22,-18,82,1774,856,1593,715,22
8,11,0,8.0,11.0,0.36081695556640625,64.61084578286372,22,-26,71,1774,856,1593,715,22
6,7,0,6.0,7.0,0.36879491806030273,60.554175279993274,22,-32,64,1774,856,1593,715,22
3,7,0,3.0,7.0,0.3767108917236328,55.88796603276258,22,-35,57,1774,856,1593,715,22
2,4,0,2.0,4.0,0.38478589057922363,53.63745044476924,22,-37,53,1774,856,1593,715,22
1,4,0,1.0,4.0,0.3928508758544922,51.00806399170998,22,-38,49,1774,856,1593,715,22
0,2,0,-0.0,2.0,0.4008059501647949,49.440052945046304,22,-38,47,1774,856,1593,715,22
0,2,0,-0.0,2.0,0.4088020324707031,47.89821729050889,22,-38,45,1774,856,1593,715,22
0,2,0,-0.0,2.0,0.4168670177459717,46.38466694161429,22,-38,43,1774,856,1593,715,22
-1,3,0,-1.0,3.0,0.42479395866394043,43.48853090330111,22,-37,40,1774,856,1593,715,22
-1,3,0,-1.0,3.0,0.43283700942993164,40.62363799656123,22,-36,37,1774,856,1593,715,22
-1,2,0,-1.0,2.0,0.4407808780670166,38.49747468305833,22,-35,35,1774,856,1593,715,22
-1,3,0,-1.0,3.0,0.4486989974975586,35.69047011971501,22,-34,32,1774,856,1593,715,22
-1,4,0,-1.0,4.0,0.4568760395050049,32.278170016764804,22,-33,28,1774,856,1593,715,22
0,4,0,-0.0,4.0,0.46480703353881836,29.80441152620633,22,-33,24,1774,856,1593,715,22
-1,2,0,-1.0,2.0,0.472944974899292,27.8329756778952,22,-32,22,1774,856,1593,715,22
0,3,0,-0.0,3.0,0.4807889461517334,26.21558813185679,22,-32,19,1774,856,1593,715,22
-1,2,0,-1.0,2.0,0.48881006240844727,24.355339059327378,22,-31,17,1774,856,1593,715,22
0,1,0,-0.0,1.0,0.4967939853668213,23.88552708502482,22,-31,16,1774,856,1593,715,22
0,1,0,-0.0,1.0,0.5046870708465576,23.438350715445125,22,-31,15,1774,856,1593,715,22
-1,2,0,-1.0,2.0,0.5127880573272705,21.695565448543633,22,-30,13,1774,856,1593,715,22
-1,1,0,-1.0,1.0,0.5207729339599609,20.38470965295043,22,-29,12,1774,856,1593,715,22
0,3,0,-0.0,3.0,0.5288369655609131,19.364452901377952,22,-29,9,1774,856,1593,715,22
-1,3,0,-1.0,3.0,0.5367898941040039,17.635642126552707,22,-28,6,1774,856,1593,715,22
0,2,0,-0.0,2.0,0.5447800159454346,17.284271247461902,22,-28,4,1774,856,1593,715,22
-1,2,0,-1.0,2.0,0.5527958869934082,16.073972741361768,22,-27,2,1774,856,1593,715,22
0,2,0,-0.0,2.0,0.5607879161834717,16.0,22,-27,0,1774,856,1593,715,22
0,1,0,-0.0,1.0,0.5689129829406738,16.018512172212592,22,-27,-1,1774,856,1593,715,22
0,2,0,-0.0,2.0,0.5767898559570312,16.16615541441225,22,-27,-3,1774,856,1593,715,22
-1,1,0,-1.0,1.0,0.5928158760070801,15.30589287593181,22,-26,-4,1774,856,1593,715,22
-1,1,0,-1.0,1.0,0.616736888885498,14.495097567963924,22,-25,-5,1774,856,1593,715,22
-2,0,0,-2.0,-0.0,0.6247570514678955,12.53720459187964,22,-23,-5,1774,856,1593,715,22
-2,1,0,-2.0,1.0,0.632781982421875,10.840329667841555,22,-21,-6,1774,856,1593,715,22
-3,1,0,-3.0,1.0,0.6408798694610596,8.313207915827967,22,-18,-7,1774,856,1593,715,22
-3,1,0,-3.0,1.0,0.6488358974456787,6.0,22,-15,-8,1774,856,1593,715,22
-3,1,0,-3.0,1.0,0.656764030456543,4.0,22,-12,-9,1774,856,1593,715,22
-3,0,0,-3.0,-0.0,0.6648280620574951,1.7279220613578552,22,-9,-9,1774,856,1593,715,22
-3,1,0,-3.0,1.0,0.6729559898376465,0.6619037896906015,22,-6,-10,1774,856,1593,715,22
-4,1,0,-4.0,1.0,0.6807608604431152,0.18033988749894903,22,-2,-11,1774,856,1593,715,22
-3,0,0,-3.0,-0.0,0.6888079643249512,0.045361017187261155,22,1,-11,1774,856,1593,715,22
-3,1,0,-3.0,1.0,0.6968069076538086,1.649110640673518,22,4,-12,1774,856,1593,715,22
-2,0,0,-2.0,-0.0,0.7048499584197998,2.416407864998739,22,6,-12,1774,856,1593,715,22
-2,1,0,-2.0,1.0,0.7128698825836182,4.264337522473747,22,8,-13,1774,856,1593,715,22
0,0,1,-0.0,-0.0,0.7177369594573975,4.264337522473747,22,8,-13,1774,856,1593,715,22
0,0,0,-0.0,-0.0,0.09924912452697754,234.04780421266383,23,-249,32,1517,901,1766,869,35
-1,0,0,-1.0,-0.0,0.19930720329284668,233.05599372940455,23,-248,32,1517,901,1766,869,35
-4,0,0,-4.0,-0.0,0.2073230743408203,229.0894146443524,23,-244,32,1517,901,1766,869,35
-6,0,0,-6.0,-0.0,0.21530508995056152,223.14162487998618,23,-238,32,1517,901,1766,869,35
-7,0,0,-7.0,-0.0,0.22328901290893555,216.20591759215716,23,-231,32,1517,901,1766,869,35
-8,0,0,-8.0,-0.0,0.23121309280395508,208.28426487440262,23,-223,32,1517,901,1766,869,35
-12,0,0,-12.0,-0.0,0.2392280101776123,196.41274563624359,23,-211,32,1517,901,1766,869,35
-14,0,0,-14.0,-0.0,0.2471921443939209,182.58206332233365,23,-197,32,1517,901,1766,869,35
-14,1,0,-14.0,1.0,0.25539302825927734,168.60711193270586,23,-183,31,1517,901,1766,869,35
-14,2,0,-14.0,2.0,0.2634241580963135,154.47011401407536,23,-169,29,1517,901,1766,869,35
-12,1,0,-12.0,1.0,0.27130818367004395,142.47727110782904,23,-157,28,1517,901,1766,869,35
-12,1,0,-12.0,1.0,0.2793562412261963,130.49237268414933,23,-145,27,1517,901,1766,869,35
-10,2,0,-10.0,2.0,0.28734707832336426,120.2953021774598,23,-135,25,1517,901,1766,869,35
-9,1,0,-9.0,1.0,0.2952430248260498,111.26534995859171,23,-126,24,1517,901,1766,869,35
-9,2,0,-9.0,2.0,0.30314207077026367,102.05040949110591,23,-117,22,1517,901,1766,869,35
-8,1,0,-8.0,1.0,0.3112621307373047,94.00450441310929,23,-109,21,1517,901,1766,869,35
-8,2,0,-8.0,2.0,0.3192291259765625,85.77159140540736,23,-101,19,1517,901,1766,869,35
-6,1,0,-6.0,1.0,0.32733607292175293,79.6902270139025,23,-95,18,1517,901,1766,869,35
-7,1,0,-7.0,1.0,0.3353540897369385,72.62700485902673,23,-88,17,1517,901,1766,869,35
-7,1,0,-7.0,1.0,0.3432731628417969,65.56512580987206,23,-81,16,1517,901,1766,869,35
-6,2,0,-6.0,2.0,0.3512420654296875,59.2954782408499,23,-75,14,1517,901,1766,869,35
-5,2,0,-5.0,2.0,0.35921716690063477,54.02112361825881,23,-70,12,1517,901,1766,869,35
-6,2,0,-6.0,2.0,0.3674290180206299,47.77653896280658,23,-64,10,1517,901,1766,869,35
-7,2,0,-7.0,2.0,0.37515807151794434,40.55866572463264,23,-57,8,1517,901,1766,869,35
-7,1,0,-7.0,1.0,0.3832690715789795,33.48762224545735,23,-50,7,1517,901,1766,869,35
-6,2,0,-6.0,2.0,0.3912942409515381,27.28317965096906,23,-44,5,1517,901,1766,869,35
-6,2,0,-6.0,2.0,0.39925312995910645,21.118237105091836,23,-38,3,1517,901,1766,869,35
-7,1,0,-7.0,1.0,0.40737104415893555,14.064449134018133,23,-31,2,1517,901,1766,869,35
-7,1,0,-7.0,1.0,0.4152412414550781,7.020824298928627,23,-24,1,1517,901,1766,869,35
-6,1,0,-6.0,1.0,0.42330312728881836,1.0,23,-18,0,1517,901,1766,869,35
-6,1,0,-6.0,1.0,0.43135905265808105,-4.958405421207704,23,-12,-1,1517,901,1766,869,35
-4,1,0,-4.0,1.0,0.4392971992492676,-8.753788748764679,23,-8,-2,1517,901,1766,869,35
-4,1,0,-4.0,1.0,0.44747304916381836,-12.0,23,-4,-3,1517,901,1766,869,35
-4,2,0,-4.0,2.0,0.45516014099121094,-12.0,23,0,-5,1517,901,1766,869,35
-3,0,0,-3.0,-0.0,0.4632530212402344,-11.1690481051547,23,3,-5,1517,901,1766,869,35
-4,1,0,-4.0,1.0,0.47129321098327637,-7.780455542707113,23,7,-6,1517,901,1766,869,35
-1,0,0,-1.0,-0.0,0.4792170524597168,-7.0,23,8,-6,1517,901,1766,869,35
-1,0,0,-1.0,-0.0,0.48733019828796387,-6.183346173608031,23,9,-6,1517,901,1766,869,35
0,0,1,-0.0,-0.0,0.5091860294342041,-6.183346173608031,23,9,-6,1517,901,1766,869,35
0,0,0,-0.0,-0.0,0.07951092720031738,707.7129312790149,24,-618,-361,890,546,1508,907,17
-1,0,0,-1.0,-0.0,0.17670583724975586,706.849634538621,24,-617,-361,890,546,1508,907,17
-3,-2,0,-3.0,-2.0,0.18471002578735352,703.2503075570512,24,-614,-359,890,546,1508,907,17
-4,-5,0,-4.0,-5.0,0.1925978660583496,697.2772504483609,24,-610,-354,890,546,1508,907,17
-6,-5,0,-6.0,-5.0,0.200577974319458,689.5793861633241,24,-604,-349,890,546,1508,907,17
-10,-7,0,-10.0,-7.0,0.20867586135864258,677.4195795277517,24,-594,-342,890,546,1508,907,17
-13,-10,0,-13.0,-10.0,0.21664786338806152,661.1673931087796,24,-581,-332,890,546,1508,907,17
-17,-11,0,-17.0,-11.0,0.22466087341308594,640.9506915012881,24,-564,-321,890,546,1508,907,17
-20,-13,0,-20.0,-13.0,0.2325119972229004,617.1399843235114,24,-544,-308,890,546,1508,907,17
-22,-12,0,-22.0,-12.0,0.2406299114227295,592.0833275470999,24,-522,-296,890,546,1508,907,17
-23,-11,0,-23.0,-11.0,0.24854588508605957,566.652938737809,24,-499,-285,890,546,1508,907,17
-24,-10,0,-24.0,-10.0,0.2567470073699951,540.8624600025037,24,-475,-275,890,546,1508,907,17
-23,-10,0,-23.0,-10.0,0.26465296745300293,515.9551507524284,24,-452,-265,890,546,1508,907,17
-25,-10,0,-25.0,-10.0,0.27273988723754883,489.3469613861132,24,-427,-255,890,546,1508,907,17
-24,-9,0,-24.0,-9.0,0.28064990043640137,464.1493407810711,24,-403,-246,890,546,1508,907,17
-25,-10,0,-25.0,-10.0,0.28865694999694824,437.6231591827337,24,-378,-236,890,546,1508,907,17
-25,-10,0,-25.0,-10.0,0.29665589332580566,411.1479452412954,24,-353,-226,890,546,1508,907,17
-25,-11,0,-25.0,-11.0,0.3046879768371582,384.1849053699033,24,-328,-215,890,546,1508,907,17
-25,-11,0,-25.0,-11.0,0.31266093254089355,357.2738698565776,24,-303,-204,890,546,1508,907,17
-25,-12,0,-25.0,-12.0,0.3207418918609619,329.8579583197649,24,-278,-192,890,546,1508,907,17
-24,-11,0,-24.0,-11.0,0.32849597930908203,303.8926097232828,24,-254,-181,890,546,1508,907,17
-23,-10,0,-23.0,-10.0,0.33653688430786133,279.4056366879397,24,-231,-171,890,546,1508,907,17
-23,-11,0,-23.0,-11.0,0.34458184242248535,254.41951146970763,24,-208,-160,890,546,1508,907,17
-21,-10,0,-21.0,-10.0,0.3525509834289551,231.7269279826528,24,-187,-150,890,546,1508,907,17
-18,-9,0,-18.0,-9.0,0.360684871673584,212.0954338463204,24,-169,-141,890,546,1508,907,17
-16,-7,0,-16.0,-7.0,0.368602991104126,195.38387350033435,24,-153,-134,890,546,1508,907,17
-12,-7,0,-12.0,-7.0,0.3766438961029053,181.76301009416983,24,-141,-127,890,546,1508,907,17
-7,-5,0,-7.0,-5.0,0.3845820426940918,173.2181006411887,24,-134,-122,890,546,1508,907,17
-5,-3,0,-5.0,-3.0,0.39256787300109863,167.50498568416796,24,-129,-119,890,546,1508,907,17
-2,-3,0,-2.0,-3.0,0.40064382553100586,164.00290695217916,24,-127,-116,890,546,1508,907,17
-2,-2,0,-2.0,-2.0,0.40871381759643555,161.17742166140255,24,-125,-114,890,546,1508,907,17
-2,-3,0,-2.0,-3.0,0.41658496856689453,157.6804152578089,24,-123,-111,890,546,1508,907,17
-2,-2,0,-2.0,-2.0,0.42463183403015137,154.85576440519384,24,-121,-109,890,546,1508,907,17
-3,-5,0,-3.0,-5.0,0.4326789379119873,149.2895419282541,24,-118,-104,890,546,1508,907,17
-4,-5,0,-4.0,-5.0,0.4407470226287842,142.98675438593943,24,-114,-99,890,546,1508,907,17
-4,-5,0,-4.0,-5.0,0.4487278461456299,136.69277798148738,24,-110,-94,890,546,1508,907,17
-5,-7,0,-5.0,-7.0,0.4566679000854492,128.35981812836215,24,-105,-87,890,546,1508,907,17
-6,-8,0,-6.0,-8.0,0.4645729064941406,118.65701717630967,24,-99,-79,890,546,1508,907,17
-6,-8,0,-6.0,-8.0,0.4725799560546875,109.00427342623003,24,-93,-71,890,546,1508,907,17
-6,-7,0,-6.0,-7.0,0.48055601119995117,100.00462953040486,24,-87,-64,890,546,1508,907,17
-5,-6,0,-5.0,-6.0,0.48853397369384766,92.43903623591775,24,-82,-58,890,546,1508,907,17
-5,-6,0,-5.0,-6.0,0.49657487869262695,84.91393867445294,24,-77,-52,890,546,1508,907,17
-5,-4,0,-5.0,-4.0,0.5046219825744629,78.53323061113575,24,-72,-48,890,546,1508,907,17
-3,-4,0,-3.0,-4.0,0.5126128196716309,73.83520025025906,24,-69,-44,890,546,1508,907,17
-3,-3,0,-3.0,-3.0,0.5207438468933105,69.69813382572325,24,-66,-41,890,546,1508,907,17
-2,-2,0,-2.0,-2.0,0.528702974319458,66.94664769020693,24,-64,-39,890,546,1508,907,17
-2,-2,0,-2.0,-2.0,0.5366618633270264,64.20110802473879,24,-62,-37,890,546,1508,907,17
-2,-2,0,-2.0,-2.0,0.5445840358734131,61.462219947249025,24,-60,-35,890,546,1508,907,17
-2,-2,0,-2.0,-2.0,0.5526440143585205,58.730802482811484,24,-58,-33,890,546,1508,907,17
-2,-2,0,-2.0,-2.0,0.560621976852417,56.007812023221035,24,-56,-31,890,546,1508,907,17
-4,-2,0,-4.0,-2.0,0.5686688423156738,51.53990258641679,24,-52,-29,890,546,1508,907,17
-4,-4,0,-4.0,-4.0,0.5766489505767822,46.120236510939236,24,-48,-25,890,546,1508,907,17
-5,-3,0,-5.0,-3.0,0.5846428871154785,40.30113870293329,24,-43,-22,890,546,1508,907,17
-4,-3,0,-4.0,-3.0,0.5926699638366699,35.382023926967726,24,-39,-19,890,546,1508,907,17
-2,-2,0,-2.0,-2.0,0.6007609367370605,32.718546143004666,24,-37,-17,890,546,1508,907,17
-2,-1,0,-2.0,-1.0,0.6085610389709473,30.483762809787713,24,-35,-16,890,546,1508,907,17
-2,-2,0,-2.0,-2.0,0.6165289878845215,27.84689665786984,24,-33,-14,890,546,1508,907,17
-3,-2,0,-3.0,-2.0,0.62453293800354,24.31098884280702,24,-30,-12,890,546,1508,907,17
-2,-1,0,-2.0,-1.0,0.6327018737792969,22.083217912982647,24,-28,-11,890,546,1508,907,17
-2,-2,0,-2.0,-2.0,0.6406009197235107,19.51363298439521,24,-26,-9,890,546,1508,907,17
-2,-2,0,-2.0,-2.0,0.6486740112304688,17.0,24,-24,-7,890,546,1508,907,17
-3,-3,0,-3.0,-3.0,0.6568019390106201,13.377558326431949,24,-21,-4,890,546,1508,907,17
-3,-2,0,-3.0,-2.0,0.6646449565887451,10.110770276274835,24,-18,-2,890,546,1508,907,17
-2,-2,0,-2.0,-2.0,0.6726529598236084,8.0,24,-16,0,890,546,1508,907,17
-3,-2,0,-3.0,-2.0,0.6806058883666992,5.152946437965905,24,-13,2,890,546,1508,907,17
-1,-1,0,-1.0,-1.0,0.6886529922485352,4.369316876852981,24,-12,3,890,546,1508,907,17
-2,-1,0,-2.0,-1.0,0.696617841720581,2.7703296142690075,24,-10,4,890,546,1508,907,17
-1,-1,0,-1.0,-1.0,0.7046048641204834,2.295630140987001,24,-9,5,890,546,1508,907,17
-1,-1,0,-1.0,-1.0,0.712695837020874,2.0,24,-8,6,890,546,1508,907,17
-1,-1,0,-1.0,-1.0,0.7207198143005371,1.8994949366116654,24,-7,7,890,546,1508,907,17
-2,-1,0,-2.0,-1.0,0.7287888526916504,1.4339811320566032,24,-5,8,890,546,1508,907,17
-1,-1,0,-1.0,-1.0,0.7366459369659424,1.848857801796104,24,-4,9,890,546,1508,907,17
-2,-1,0,-2.0,-1.0,0.7447178363800049,2.198039027185569,24,-2,10,890,546,1508,907,17
-1,0,0,-1.0,-0.0,0.7526359558105469,2.04987562112089,24,-1,10,890,546,1508,907,17
0,-1,0,-0.0,-1.0,0.7766129970550537,3.045361017187261,24,-1,11,890,546,1508,907,17
0,0,1,-0.0,-0.0,0.7916369438171387,3.045361017187261,24,-1,11,890,546,1508,907,17
-1,0,1,-1.0,-0.0,0.002183198928833008,753.5113562834516,25,778,-74,1668,461,891,535,57
0,0,0,-0.0,-0.0,0.08806920051574707,753.5113562834516,25,778,-74,1668,461,891,535,57
2,-1,0,2.0,-1.0,0.20215225219726562,751.4260709008905,25,776,-73,1668,461,891,535,57
5,-2,0,5.0,-2.0,0.2100691795349121,746.2622294804261,25,771,-71,1668,461,891,535,57
8,-1,0,8.0,-1.0,0.21819639205932617,738.2042808546556,25,763,-70,1668,461,891,535,57
8,-2,0,8.0,-2.0,0.22617435455322266,730.0560665280636,25,755,-68,1668,461,891,535,57
8,0,0,8.0,-0.0,0.2341902256011963,722.088661426101,25,747,-68,1668,461,891,535,57
10,0,0,10.0,-0.0,0.24215030670166016,712.13039391718,25,737,-68,1668,461,891,535,57
15,0,0,15.0,-0.0,0.2501683235168457,697.1951461503311,25,722,-68,1668,461,891,535,57
21,-1,0,21.0,-1.0,0.2582833766937256,676.1945753838211,25,701,-67,1668,461,891,535,57
25,-1,0,25.0,-1.0,0.26604318618774414,651.2142519117219,25,676,-66,1668,461,891,535,57
33,-2,0,33.0,-2.0,0.2740793228149414,618.1772202732003,25,643,-64,1668,461,891,535,57
37,-2,0,37.0,-2.0,0.2820422649383545,581.1633606841435,25,606,-62,1668,461,891,535,57
37,-3,0,37.0,-3.0,0.2902853488922119,544.0506970540285,25,569,-59,1668,461,891,535,57
34,-3,0,34.0,-3.0,0.2982301712036133,509.9228569228119,25,535,-56,1668,461,891,535,57
31,-1,0,31.0,-1.0,0.3061642646789551,478.9921103922624,25,504,-55,1668,461,891,535,57
29,-2,0,29.0,-2.0,0.3142251968383789,449.9476958831374,25,475,-53,1668,461,891,535,57
29,-1,0,29.0,-1.0,0.32219529151916504,421.02115763068446,25,446,-52,1668,461,891,535,57
27,-2,0,27.0,-2.0,0.33024024963378906,393.97274793521916,25,419,-50,1668,461,891,535,57
29,-3,0,29.0,-3.0,0.33817529678344727,364.82184256988563,25,390,-47,1668,461,891,535,57
26,-3,0,26.0,-3.0,0.3461623191833496,338.6496965769916,25,364,-44,1668,461,891,535,57
23,-2,0,23.0,-2.0,0.35418224334716797,315.57677453518306,25,341,-42,1668,461,891,535,57
19,-3,0,19.0,-3.0,0.36212730407714844,296.35320254315354,25,322,-39,1668,461,891,535,57
16,-2,0,16.0,-2.0,0.37024521827697754,280.22881111278355,25,306,-37,1668,461,891,535,57
13,-2,0,13.0,-2.0,0.3782052993774414,267.0830391601659,25,293,-35,1668,461,891,535,57
11,-3,0,11.0,-3.0,0.3862452507019043,255.8097954616789,25,282,-32,1668,461,891,535,57
12,-2,0,12.0,-2.0,0.3940873146057129,243.66155414412248,25,270,-30,1668,461,891,535,57
13,-4,0,13.0,-4.0,0.40209126472473145,230.3118270617898,25,257,-26,1668,461,891,535,57
12,-2,0,12.0,-2.0,0.4102003574371338,218.17270360460358,25,245,-24,1668,461,891,535,57
12,-4,0,12.0,-4.0,0.41815638542175293,205.8567937862828,25,233,-20,1668,461,891,535,57
12,-4,0,12.0,-4.0,0.4261453151702881,193.5784285529618,25,221,-16,1668,461,891,535,57
14,-3,0,14.0,-3.0,0.43419337272644043,179.40781084616847,25,207,-13,1668,461,891,535,57
14,-4,0,14.0,-4.0,0.4421842098236084,165.2097306038182,25,193,-9,1668,461,891,535,57
14,-3,0,14.0,-3.0,0.4501783847808838,151.10053042914194,25,179,-6,1668,461,891,535,57
12,-4,0,12.0,-4.0,0.45819640159606934,139.01197561851666,25,167,-2,1668,461,891,535,57
12,-3,0,12.0,-3.0,0.4661881923675537,127.00322577288512,25,155,1,1668,461,891,535,57
12,-3,0,12.0,-3.0,0.47414231300354004,115.05593311708537,25,143,4,1668,461,891,535,57
13,-3,0,13.0,-3.0,0.4821443557739258,102.18832512940628,25,130,7,1668,461,891,535,57
11,-2,0,11.0,-2.0,0.4902822971343994,91.33985084622823,25,119,9,1668,461,891,535,57
9,-2,0,9.0,-2.0,0.49821925163269043,82.54863183232979,25,110,11,1668,461,891,535,57
9,-2,0,9.0,-2.0,0.506141185760498,73.83319694480774,25,101,13,1668,461,891,535,57
7,-1,0,7.0,-1.0,0.5141863822937012,67.03683496413377,25,94,14,1668,461,891,535,57
6,0,0,6.0,-0.0,0.5221831798553467,61.10667763978185,25,88,14,1668,461,891,535,57
5,-1,0,5.0,-1.0,0.5301423072814941,56.34453153583817,25,83,15,1668,461,891,535,57
4,0,0,4.0,-0.0,0.5380992889404297,52.4114419718985,25,79,15,1668,461,891,535,57
3,-1,0,3.0,-1.0,0.5460522174835205,49.6659513557904,25,76,16,1668,461,891,535,57
2,0,0,2.0,-0.0,0.5541303157806396,47.7099729229908,25,74,16,1668,461,891,535,57
1,0,0,1.0,-0.0,0.562136173248291,46.73285756613352,25,73,16,1668,461,891,535,57
2,-1,0,2.0,-1.0,0.5702424049377441,45.00684899377592,25,71,17,1668,461,891,535,57
2,0,0,2.0,-0.0,0.5781881809234619,43.06335201775947,25,69,17,1668,461,891,535,57
2,0,0,2.0,-0.0,0.586205244064331,41.12307863514182,25,67,17,1668,461,891,535,57
3,0,0,3.0,-0.0,0.5941452980041504,38.21933252457322,25,64,17,1668,461,891,535,57
3,0,0,3.0,-0.0,0.6021773815155029,35.324560795950255,25,61,17,1668,461,891,535,57
3,-1,0,3.0,-1.0,0.6100783348083496,32.728905802755904,25,58,18,1668,461,891,535,57
3,0,0,3.0,-0.0,0.6181004047393799,29.87054518492115,25,55,18,1668,461,891,535,57
3,0,0,3.0,-0.0,0.6260843276977539,27.027265968790417,25,52,18,1668,461,891,535,57
3,0,0,3.0,-0.0,0.6341993808746338,24.201532544552748,25,49,18,1668,461,891,535,57
3,0,0,3.0,-0.0,0.6423392295837402,21.396356140913873,25,46,18,1668,461,891,535,57
3,0,0,3.0,-0.0,0.6501672267913818,18.61544808322666,25,43,18,1668,461,891,535,57
4,0,0,4.0,-0.0,0.658137321472168,14.953463189829058,25,39,18,1668,461,891,535,57
2,0,0,2.0,-0.0,0.6661522388458252,13.146081222881968,25,37,18,1668,461,891,535,57
1,0,0,1.0,-0.0,0.6742393970489502,12.249223594996216,25,36,18,1668,461,891,535,57
1,0,0,1.0,-0.0,0.6821432113647461,11.357337308308857,25,35,18,1668,461,891,535,57
2,0,0,2.0,-0.0,0.6900403499603271,9.589892258425003,25,33,18,1668,461,891,535,57
1,0,0,1.0,-0.0,0.6981382369995117,8.715119501371639,25,32,18,1668,461,891,535,57
1,0,0,1.0,-0.0,0.7060742378234863,7.846896657869841,25,31,18,1668,461,891,535,57
0,0,1,-0.0,-0.0,0.7131402492523193,7.846896657869841,25,31,18,1668,461,891,535,57
1,0,1,1.0,-0.0,0.7141892910003662,6.985711369071801,25,30,18,1668,461,891,535,57
2,0,1,2.0,-0.0,0.0030975341796875,1368.0981407453226,26,-1390,-176,250,267,1638,443,66
1,0,1,1.0,-0.0,0.01108860969543457,1369.0902253421496,26,-1391,-176,250,267,1638,443,66
1,0,1,1.0,-0.0,0.019103527069091797,1370.0823211772001,26,-1392,-176,250,267,1638,443,66
1,0,1,1.0,-0.0,0.027129411697387695,1371.0744282266521,26,-1393,-176,250,267,1638,443,66
0,0,0,-0.0,-0.0,0.07895946502685547,1371.0744282266521,26,-1393,-176,250,267,1638,443,66
-1,0,0,-1.0,-0.0,0.1392354965209961,1370.0823211772001,26,-1392,-176,250,267,1638,443,66
-5,2,0,-5.0,2.0,0.1470654010772705,1365.375128497357,26,-1387,-178,250,267,1638,443,66
-6,3,0,-6.0,3.0,0.1551494598388672,1359.8108270687733,26,-1381,-181,250,267,1638,443,66
-7,4,0,-7.0,4.0,0.16299748420715332,1353.3985718400031,26,-1374,-185,250,267,1638,443,66
-7,3,0,-7.0,3.0,0.17102861404418945,1346.8670225786252,26,-1367,-188,250,267,1638,443,66
-6,4,0,-6.0,4.0,0.17909455299377441,1341.4762638910865,26,-1361,-192,250,267,1638,443,66
-8,4,0,-8.0,4.0,0.18696141242980957,1334.122891330549,26,-1353,-196,250,267,1638,443,66
-8,3,0,-8.0,3.0,0.19506239891052246,1326.641864609942,26,-1345,-199,250,267,1638,443,66
-9,2,0,-9.0,2.0,0.20311260223388672,1318.0355287704317,26,-1336,-201,250,267,1638,443,66
-11,2,0,-11.0,2.0,0.21111345291137695,1307.4603686793578,26,-1325,-203,250,267,1638,443,66
-12,1,0,-12.0,1.0,0.21923255920410156,1295.7531749726884,26,-1313,-204,250,267,1638,443,66
-15,1,0,-15.0,1.0,0.2270655632019043,1281.0886575874551,26,-1298,-205,250,267,1638,443,66
-16,0,0,-16.0,-0.0,0.2350015640258789,1265.2869482514257,26,-1282,-205,250,267,1638,443,66
-22,-1,0,-22.0,-1.0,0.24304556846618652,1243.4074584551752,26,-1260,-204,250,267,1638,443,66
-26,-4,0,-26.0,-4.0,0.2510263919830322,1217.1023958060396,26,-1234,-200,250,267,1638,443,66
-29,-4,0,-29.0,-4.0,0.25907444953918457,1187.8361888476275,26,-1205,-196,250,267,1638,443,66
-31,-7,0,-31.0,-7.0,0.26706838607788086,1156.1160582550385,26,-1174,-189,250,267,1638,443,66
-34,-9,0,-34.0,-9.0,0.27519845962524414,1121.1230437002807,26,-1140,-180,250,267,1638,443,66
-38,-10,0,-38.0,-10.0,0.28310441970825195,1082.0354254462052,26,-1102,-170,250,267,1638,443,66
-37,-10,0,-37.0,-10.0,0.29105544090270996,1043.9517166521441,26,-1065,-160,250,267,1638,443,66
-39,-11,0,-39.0,-11.0,0.2990865707397461,1003.7627501024524,26,-1026,-149,250,267,1638,443,66
-39,-11,0,-39.0,-11.0,0.30707645416259766,963.6007224560898,26,-987,-138,250,267,1638,443,66
-40,-10,0,-40.0,-10.0,0.31499552726745605,922.6113226620957,26,-947,-128,250,267,1638,443,66
-42,-10,0,-42.0,-10.0,0.32305049896240234,879.6603968618338,26,-905,-118,250,267,1638,443,66
-39,-9,0,-39.0,-9.0,0.33113861083984375,839.8327445736669,26,-866,-109,250,267,1638,443,66
-36,-6,0,-36.0,-6.0,0.33916544914245605,803.3665464376251,26,-830,-103,250,267,1638,443,66
-35,-6,0,-35.0,-6.0,0.34715747833251953,767.8957485216163,26,-795,-97,250,267,1638,443,66
-33,-4,0,-33.0,-4.0,0.35508251190185547,734.6542190335438,26,-762,-93,250,267,1638,443,66
-33,-4,0,-33.0,-4.0,0.36315441131591797,701.4126905221614,26,-729,-89,250,267,1638,443,66
-34,-4,0,-34.0,-4.0,0.3710935115814209,667.1785486574121,26,-695,-85,250,267,1638,443,66
-36,-3,0,-36.0,-3.0,0.3792273998260498,631.0820732409511,26,-659,-82,250,267,1638,443,66
-34,-3,0,-34.0,-3.0,0.3869895935058594,596.9730152950998,26,-625,-79,250,267,1638,443,66
-34,-4,0,-34.0,-4.0,0.39495158195495605,562.7398761204423,26,-591,-75,250,267,1638,443,66
-33,-4,0,-33.0,-4.0,0.4030604362487793,529.4988888877915,26,-558,-71,250,267,1638,443,66
-30,-5,0,-30.0,-5.0,0.4110424518585205,499.1090113877043,26,-528,-66,250,267,1638,443,66
-27,-4,0,-27.0,-4.0,0.41905760765075684,471.8217507199942,26,-501,-62,250,267,1638,443,66
-26,-5,0,-26.0,-5.0,0.4271235466003418,445.40777585653854,26,-475,-57,250,267,1638,443,66
-23,-5,0,-23.0,-5.0,0.4350724220275879,421.9813182977956,26,-452,-52,250,267,1638,443,66
-23,-6,0,-23.0,-6.0,0.44310760498046875,398.45915218013397,26,-429,-46,250,267,1638,443,66
-22,-4,0,-22.0,-4.0,0.45116138458251953,376.16133737194673,26,-407,-42,250,267,1638,443,66
-23,-2,0,-23.0,-2.0,0.45914649963378906,353.07771238443695,26,-384,-40,250,267,1638,443,66
-23,-2,0,-23.0,-2.0,0.4671614170074463,329.9944903163132,26,-361,-38,250,267,1638,443,66
-22,-1,0,-22.0,-1.0,0.4750094413757324,308.0131962256006,26,-339,-37,250,267,1638,443,66
-20,-1,0,-20.0,-1.0,0.48304152488708496,288.024921150991,26,-319,-36,250,267,1638,443,66
-20,-2,0,-20.0,-2.0,0.4911503791809082,267.9269014229203,26,-299,-34,250,267,1638,443,66
-20,-1,0,-20.0,-1.0,0.49904751777648926,247.94483444263574,26,-279,-33,250,267,1638,443,66
-17,-1,0,-17.0,-1.0,0.5071465969085693,230.9469643697385,26,-262,-32,250,267,1638,443,66
-15,-1,0,-15.0,-1.0,0.5150885581970215,215.93774322107123,26,-247,-31,250,267,1638,443,66
-14,0,0,-14.0,-0.0,0.5230884552001953,202.05318547086316,26,-233,-31,250,267,1638,443,66
-14,0,0,-14.0,-0.0,0.5310115814208984,188.18318200080222,26,-219,-31,250,267,1638,443,66
-14,0,0,-14.0,-0.0,0.5390925407409668,174.3306537876153,26,-205,-31,250,267,1638,443,66
-11,1,0,-11.0,1.0,0.5470385551452637,163.6214637317096,26,-194,-32,250,267,1638,443,66
-10,1,0,-10.0,1.0,0.5550565719604492,153.93581786270923,26,-184,-33,250,267,1638,443,66
-10,1,0,-10.0,1.0,0.5630784034729004,144.29072169744248,26,-174,-34,250,267,1638,443,66
-10,1,0,-10.0,1.0,0.5711064338684082,134.69317219254933,26,-164,-35,250,267,1638,443,66
-9,2,0,-9.0,2.0,0.5791563987731934,126.35494971917251,26,-155,-37,250,267,1638,443,66
-9,0,0,-9.0,-0.0,0.587092399597168,117.61540425866141,26,-146,-37,250,267,1638,443,66
-8,1,0,-8.0,1.0,0.5951464176177979,110.13629868066312,26,-138,-38,250,267,1638,443,66
-7,1,0,-7.0,1.0,0.6031653881072998,103.6821129482567,26,-131,-39,250,267,1638,443,66
-6,0,0,-6.0,-0.0,0.6110174655914307,97.9427355755179,26,-125,-39,250,267,1638,443,66
-6,0,0,-6.0,-0.0,0.6189744472503662,92.22779244241272,26,-119,-39,250,267,1638,443,66
-4,0,0,-4.0,-0.0,0.6270735263824463,88.43310915891102,26,-115,-39,250,267,1638,443,66
-5,0,0,-5.0,-0.0,0.6350345611572266,83.70903992407786,26,-110,-39,250,267,1638,443,66
-4,-1,0,-4.0,-1.0,0.6431574821472168,79.60550608207397,26,-106,-38,250,267,1638,443,66
-4,0,0,-4.0,-0.0,0.6511476039886475,75.84851859350222,26,-102,-38,250,267,1638,443,66
-6,-2,0,-6.0,-2.0,0.6590485572814941,69.52804494381037,26,-96,-36,250,267,1638,443,66
-6,-1,0,-6.0,-1.0,0.6671714782714844,63.566039579139826,26,-90,-35,250,267,1638,443,66
-6,-1,0,-6.0,-1.0,0.6750245094299316,57.620086073673534,26,-84,-34,250,267,1638,443,66
-6,-2,0,-6.0,-2.0,0.6830625534057617,51.308955633431964,26,-78,-32,250,267,1638,443,66
-5,-1,0,-5.0,-1.0,0.6910364627838135,46.30952023559341,26,-73,-31,250,267,1638,443,66
-6,-1,0,-6.0,-1.0,0.6989655494689941,40.40980860893181,26,-67,-30,250,267,1638,443,66
-6,-3,0,-6.0,-3.0,0.7069785594940186,33.70832032063167,26,-61,-27,250,267,1638,443,66
-7,-2,0,-7.0,-2.0,0.7150135040283203,26.506302187247357,26,-54,-25,250,267,1638,443,66
-6,-1,0,-6.0,-1.0,0.7231636047363281,20.665631459994955,26,-48,-24,250,267,1638,443,66
-4,-1,0,-4.0,-1.0,0.7310464382171631,16.64876634922564,26,-44,-23,250,267,1638,443,66
-1,-1,0,-1.0,-1.0,0.7390484809875488,15.301138702933287,26,-43,-22,250,267,1638,443,66
0,0,1,-0.0,-0.0,0.7549574375152588,15.301138702933287,26,-43,-22,250,267,1638,443,66
0,0,0,-0.0,-0.0,0.07304930686950684,858.5999074716583,27,-67,862,226,1151,293,289,12
1,0,0,1.0,-0.0,0.17420339584350586,858.6779747397293,27,-68,862,226,1151,293,289,12
5,1,0,5.0,1.0,0.18217039108276367,858.0891157745248,27,-73,861,226,1151,293,289,12
6,1,0,6.0,1.0,0.19012141227722168,857.6208658896564,27,-79,860,226,1151,293,289,12
4,1,0,4.0,1.0,0.1981053352355957,857.0005793740813,27,-83,859,226,1151,293,289,12
5,3,0,5.0,3.0,0.2059924602508545,854.5114758095908,27,-88,856,226,1151,293,289,12
4,5,0,4.0,5.0,0.2139883041381836,849.9585270327062,27,-92,851,226,1151,293,289,12
5,6,0,5.0,6.0,0.22209739685058594,844.5492343186254,27,-97,845,226,1151,293,289,12
7,10,0,7.0,10.0,0.23020029067993164,835.451721728585,27,-104,835,226,1151,293,289,12
9,13,0,9.0,13.0,0.2381763458251953,823.7306791965692,27,-113,822,226,1151,293,289,12
12,15,0,12.0,15.0,0.24606633186340332,810.6235362760493,27,-125,807,226,1151,293,289,12
10,17,0,10.0,17.0,0.2541234493255615,795.4518076590757,27,-135,790,226,1151,293,289,12
7,17,0,7.0,17.0,0.26216745376586914,779.9344756403043,27,-142,773,226,1151,293,289,12
4,17,0,4.0,17.0,0.2701132297515869,763.9688305379641,27,-146,756,226,1151,293,289,12
2,19,0,2.0,19.0,0.2781093120574951,745.7133762279344,27,-148,737,226,1151,293,289,12
0,20,0,-0.0,20.0,0.2862093448638916,726.1154280576253,27,-148,717,226,1151,293,289,12
0,21,0,-0.0,21.0,0.2939932346343994,705.5616628233986,27,-148,696,226,1151,293,289,12
-2,21,0,-2.0,21.0,0.30196237564086914,684.609151401862,27,-146,675,226,1151,293,289,12
-3,20,0,-3.0,20.0,0.30998826026916504,664.428221363033,27,-143,655,226,1151,293,289,12
-3,20,0,-3.0,20.0,0.31797337532043457,644.2499519415592,27,-140,635,226,1151,293,289,12
-4,20,0,-4.0,20.0,0.3262794017791748,623.8579204868349,27,-136,615,226,1151,293,289,12
-5,20,0,-5.0,20.0,0.3340754508972168,603.250359047904,27,-131,595,226,1151,293,289,12
-6,21,0,-6.0,21.0,0.3420553207397461,581.4529768415512,27,-125,574,226,1151,293,289,12
-9,21,0,-9.0,21.0,0.3501002788543701,559.0353971212777,27,-116,553,226,1151,293,289,12
-9,20,0,-9.0,20.0,0.3581063747406006,537.6340681009607,27,-107,533,226,1151,293,289,12
-8,19,0,-8.0,19.0,0.3659672737121582,517.4472275215526,27,-99,514,226,1151,293,289,12
-9,20,0,-9.0,20.0,0.37410426139831543,496.1314568915196,27,-90,494,226,1151,293,289,12
-7,20,0,-7.0,20.0,0.38223743438720703,475.21201148766016,27,-83,474,226,1151,293,289,12
-7,20,0,-7.0,20.0,0.3900763988494873,454.3172818828335,27,-76,454,226,1151,293,289,12
-6,19,0,-6.0,19.0,0.3981194496154785,434.5961870012041,27,-70,435,226,1151,293,289,12
-5,21,0,-5.0,21.0,0.40604138374328613,413.07159292894096,27,-65,414,226,1151,293,289,12
-4,20,0,-4.0,20.0,0.41416430473327637,392.6941183413671,27,-61,394,226,1151,293,289,12
-4,18,0,-4.0,18.0,0.4221053123474121,374.2959373961284,27,-57,376,226,1151,293,289,12
-4,18,0,-4.0,18.0,0.430145263671875,355.9019204149102,27,-53,358,226,1151,293,289,12
-5,16,0,-5.0,16.0,0.4380612373352051,339.3519943477958,27,-48,342,226,1151,293,289,12
-4,14,0,-4.0,14.0,0.4460413455963135,324.9380606699689,27,-44,328,226,1151,293,289,12
-5,17,0,-5.0,17.0,0.45398831367492676,307.43579884882325,27,-39,311,226,1151,293,289,12
-5,15,0,-5.0,15.0,0.46230244636535645,291.9463038871266,27,-34,296,226,1151,293,289,12
-5,16,0,-5.0,16.0,0.4700932502746582,275.4977797425763,27,-29,280,226,1151,293,289,12
-6,14,0,-6.0,14.0,0.4780714511871338,260.9925092582187,27,-23,266,226,1151,293,289,12
-5,14,0,-5.0,14.0,0.48610544204711914,246.6420392571276,27,-18,252,226,1151,293,289,12
-4,15,0,-4.0,15.0,0.4940674304962158,231.41314201197878,27,-14,237,226,1151,293,289,12
-5,14,0,-5.0,14.0,0.5021722316741943,217.1815404552984,27,-9,223,226,1151,293,289,12
-3,12,0,-3.0,12.0,0.5101244449615479,205.0852908186641,27,-6,211,226,1151,293,289,12
-3,11,0,-3.0,11.0,0.51800537109375,194.02249873451737,27,-3,200,226,1151,293,289,12
-3,9,0,-3.0,9.0,0.5259523391723633,185.0,27,0,191,226,1151,293,289,12
-1,8,0,-1.0,8.0,0.5341262817382812,177.0027322200409,27,1,183,226,1151,293,289,12
-2,5,0,-2.0,5.0,0.5421032905578613,172.02527910383964,27,3,178,226,1151,293,289,12
-1,4,0,-1.0,4.0,0.550147294998169,168.04597093871493,27,4,174,226,1151,293,289,12
-1,5,0,-1.0,5.0,0.5581293106079102,163.07394831847986,27,5,169,226,1151,293,289,12
-2,4,0,-2.0,4.0,0.5660943984985352,159.14841809717706,27,7,165,226,1151,293,289,12
0,6,0,-0.0,6.0,0.5741312503814697,153.15401345866212,27,7,159,226,1151,293,289,12
0,6,0,-0.0,6.0,0.5820143222808838,147.16004700965587,27,7,153,226,1151,293,289,12
0,5,0,-0.0,5.0,0.5900764465332031,142.16544806398016,27,7,148,226,1151,293,289,12
2,4,0,2.0,4.0,0.597980260848999,138.08677940741129,27,5,144,226,1151,293,289,12
0,5,0,-0.0,5.0,0.6060903072357178,133.0898989862312,27,5,139,226,1151,293,289,12
1,4,0,1.0,4.0,0.614173412322998,129.05924625881784,27,4,135,226,1151,293,289,12
1,5,0,1.0,5.0,0.6221263408660889,124.034610777285,27,3,130,226,1151,293,289,12
0,5,0,-0.0,5.0,0.6301052570343018,119.03599481749245,27,3,125,226,1151,293,289,12
0,4,0,-0.0,4.0,0.638087272644043,115.03718436910205,27,3,121,226,1151,293,289,12
0,5,0,-0.0,5.0,0.6461844444274902,110.03878661895772,27,3,116,226,1151,293,289,12
0,5,0,-0.0,5.0,0.6539843082427979,105.04053313993049,27,3,111,226,1151,293,289,12
1,3,0,1.0,3.0,0.6619644165039062,102.01851693112621,27,2,108,226,1151,293,289,12
0,3,0,-0.0,3.0,0.6699934005737305,99.01904589168576,27,2,105,226,1151,293,289,12
0,4,0,-0.0,4.0,0.6781144142150879,95.01980003939822,27,2,101,226,1151,293,289,12
0,3,0,-0.0,3.0,0.6861002445220947,92.02040603874276,27,2,98,226,1151,293,289,12
0,3,0,-0.0,3.0,0.6941914558410645,89.02105029939419,27,2,95,226,1151,293,289,12
1,4,0,1.0,4.0,0.7020454406738281,85.00549433962765,27,1,91,226,1151,293,289,12
0,3,0,-0.0,3.0,0.7100954055786133,82.0056816347672,27,1,88,226,1151,293,289,12
0,4,0,-0.0,4.0,0.7181313037872314,78.00595217006948,27,1,84,226,1151,293,289,12
-1,4,0,-1.0,4.0,0.7261064052581787,74.02499609497022,27,2,80,226,1151,293,289,12
-1,4,0,-1.0,4.0,0.7341642379760742,70.05918747922567,27,3,76,226,1151,293,289,12
0,3,0,-0.0,3.0,0.7421002388000488,67.06161783043132,27,3,73,226,1151,293,289,12
0,4,0,-0.0,4.0,0.7499964237213135,63.06518659932803,27,3,69,226,1151,293,289,12
0,3,0,-0.0,3.0,0.7580263614654541,60.06814663663572,27,3,66,226,1151,293,289,12
1,3,0,1.0,3.0,0.7661283016204834,57.0317380372777,27,2,63,226,1151,293,289,12
1,3,0,1.0,3.0,0.7741162776947021,54.00833275470999,27,1,60,226,1151,293,289,12
0,2,0,-0.0,2.0,0.7820823192596436,52.008620049092706,27,1,58,226,1151,293,289,12
1,1,0,1.0,1.0,0.7899713516235352,51.0,27,0,57,226,1151,293,289,12
1,2,0,1.0,2.0,0.7980034351348877,49.00909015790027,27,-1,55,226,1151,293,289,12
1,2,0,1.0,2.0,0.8060033321380615,47.03772242470448,27,-2,53,226,1151,293,289,12
0,2,0,-0.0,2.0,0.8141734600067139,45.03920062069938,27,-2,51,226,1151,293,289,12
1,3,0,1.0,3.0,0.82218337059021,42.093658625644196,27,-3,48,226,1151,293,289,12
0,3,0,-0.0,3.0,0.8300862312316895,39.09988913511872,27,-3,45,226,1151,293,289,12
0,2,0,-0.0,2.0,0.8380782604217529,37.104524124504614,27,-3,43,226,1151,293,289,12
0,3,0,-0.0,3.0,0.8461043834686279,34.11234224026316,27,-3,40,226,1151,293,289,12
1,2,0,1.0,2.0,0.854128360748291,32.2099463490856,27,-4,38,226,1151,293,289,12
1,2,0,1.0,2.0,0.8620662689208984,30.345563690772494,27,-5,36,226,1151,293,289,12
1,2,0,1.0,2.0,0.8701353073120117,28.525353003264136,27,-6,34,226,1151,293,289,12
0,2,0,-0.0,2.0,0.8780064582824707,26.557641192199412,27,-6,32,226,1151,293,289,12
1,1,0,1.0,1.0,0.8861982822418213,25.78049716414141,27,-7,31,226,1151,293,289,12
0,1,0,-0.0,1.0,0.9020154476165771,24.805843601498726,27,-7,30,226,1151,293,289,12
0,2,0,-0.0,2.0,0.9262194633483887,22.861739379323623,27,-7,28,226,1151,293,289,12
0,1,0,-0.0,1.0,0.9340493679046631,21.892651361962706,27,-7,27,226,1151,293,289,12
0,1,0,-0.0,1.0,0.942068338394165,20.92582403567252,27,-7,26,226,1151,293,289,12
0,1,0,-0.0,1.0,0.9500293731689453,19.96150997149434,27,-7,25,226,1151,293,289,12
0,2,0,-0.0,2.0,1.0140173435211182,18.041630560342615,27,-7,23,226,1151,293,289,12
0,2,0,-0.0,2.0,1.022045373916626,16.135943621178654,27,-7,21,226,1151,293,289,12
-1,3,0,-1.0,3.0,1.0300133228302002,12.973665961010276,27,-6,18,226,1151,293,289,12
0,2,0,-0.0,2.0,1.0380873680114746,11.08800749063506,27,-6,16,226,1151,293,289,12
-1,2,0,-1.0,2.0,1.0461082458496094,8.866068747318506,27,-5,14,226,1151,293,289,12
0,1,0,-0.0,1.0,1.054072380065918,7.928388277184119,27,-5,13,226,1151,293,289,12
0,1,0,-0.0,1.0,1.0620143413543701,7.0,27,-5,12,226,1151,293,289,12
0,1,0,-0.0,1.0,1.0700984001159668,6.083045973594572,27,-5,11,226,1151,293,289,12
0,1,0,-0.0,1.0,1.0782523155212402,5.180339887498949,27,-5,10,226,1151,293,289,12
0,1,0,-0.0,1.0,1.0861873626708984,4.295630140987001,27,-5,9,226,1151,293,289,12
0,1,0,-0.0,1.0,1.093975305557251,3.433981132056603,27,-5,8,226,1151,293,289,12
0,1,0,-0.0,1.0,1.1101083755493164,2.6023252670426267,27,-5,7,226,1151,293,289,12
0,0,1,-0.0,-0.0,1.1690433025360107,2.6023252670426267,27,-5,7,226,1151,293,289,12
0,2,1,-0.0,2.0,1.1740074157714844,1.0710678118654755,27,-5,5,226,1151,293,289,12
0,1,1,-0.0,1.0,1.1820883750915527,0.40312423743284853,27,-5,4,226,1151,293,289,12
0,1,1,-0.0,1.0,1.1901164054870605,-0.16904810515469926,27,-5,3,226,1151,293,289,12
0,2,1,-0.0,2.0,1.198115348815918,-0.9009804864072155,27,-5,1,226,1151,293,289,12
0,2,1,-0.0,2.0,1.2062273025512695,-0.9009804864072155,27,-5,-1,226,1151,293,289,12
0,0,0,-0.0,-0.0,1.2440712451934814,-0.9009804864072155,27,-5,-1,226,1151,293,289,12
1,-3,0,1.0,-3.0,1.3500263690948486,0.32455532033675905,27,-6,2,226,1151,293,289,12
2,-3,0,2.0,-3.0,1.3579883575439453,3.433981132056603,27,-8,5,226,1151,293,289,12
3,-2,0,3.0,-2.0,1.3660924434661865,7.038404810405298,27,-11,7,226,1151,293,289,12
2,-2,0,2.0,-2.0,1.3741273880004883,9.811388300841896,27,-13,9,226,1151,293,289,12
2,-3,0,2.0,-3.0,1.382157325744629,13.209372712298546,27,-15,12,226,1151,293,289,12
2,-2,0,2.0,-2.0,1.39009428024292,16.02271554554524,27,-17,14,226,1151,293,289,12
1,0,0,1.0,-0.0,1.3980894088745117,16.80350850198276,27,-18,14,226,1151,293,289,12
0,0,1,-0.0,-0.0,1.4849803447723389,16.80350850198276,27,-18,14,226,1151,293,289,12
0,1,1,-0.0,1.0,1.5019984245300293,16.20360331117452,27,-18,13,226,1151,293,289,12
-1,3,1,-1.0,3.0,1.5099983215332031,13.72308292331602,27,-17,10,226,1151,293,289,12
-1,2,1,-1.0,2.0,1.5181152820587158,11.888543819998318,27,-16,8,226,1151,293,289,12
-1,1,1,-1.0,1.0,1.5260953903198242,10.552945357246848,27,-15,7,226,1151,293,289,12
-1,1,1,-1.0,1.0,1.5340874195098877,9.231546211727817,27,-14,6,226,1151,293,289,12
0,1,1,-0.0,1.0,1.558126449584961,8.866068747318506,27,-14,5,226,1151,293,289,12
0,0,0,-0.0,-0.0,1.5620534420013428,8.866068747318506,27,-14,5,226,1151,293,289,12
-1,0,0,-1.0,-0.0,1.566145420074463,7.928388277184119,27,-13,5,226,1151,293,289,12
-1,0,0,-1.0,-0.0,1.6300504207611084,7.0,27,-12,5,226,1151,293,289,12
0,1,0,-0.0,1.0,1.6382043361663818,6.649110640673518,27,-12,4,226,1151,293,289,12
-1,0,0,-1.0,-0.0,1.6460623741149902,5.704699910719626,27,-11,4,226,1151,293,289,12
-1,0,0,-1.0,-0.0,1.6622083187103271,4.7703296142690075,27,-10,4,226,1151,293,289,12
0,1,0,-0.0,1.0,1.6701314449310303,4.440306508910551,27,-10,3,226,1151,293,289,12
-1,0,0,-1.0,-0.0,1.6781792640686035,3.486832980505138,27,-9,3,226,1151,293,289,12
-1,1,0,-1.0,1.0,1.6861612796783447,2.246211251235321,27,-8,2,226,1151,293,289,12
0,0,1,-0.0,-0.0,1.7020244598388672,2.246211251235321,27,-8,2,226,1151,293,289,12
-1,1,1,-1.0,1.0,0.015324115753173828,838.3407861429957,28,697,-473,930,677,234,1149,8
-1,1,1,-1.0,1.0,0.023243188858032227,839.7298145733621,28,698,-474,930,677,234,1149,8
0,1,1,-0.0,1.0,0.03126716613769531,840.2920110956873,28,698,-475,930,677,234,1149,8
-1,0,1,-1.0,-0.0,0.04734206199645996,841.1189265422944,28,699,-475,930,677,234,1149,8
0,0,0,-0.0,-0.0,0.06719517707824707,841.1189265422944,28,699,-475,930,677,234,1149,8
0,0,1,-0.0,-0.0,0.14330029487609863,841.1189265422944,28,699,-475,930,677,234,1149,8
0,0,0,-0.0,-0.0,0.2193012237548828,841.1189265422944,28,699,-475,930,677,234,1149,8
4,-1,0,4.0,-1.0,0.22343707084655762,837.2496656760109,28,695,-474,930,677,234,1149,8
6,-2,0,6.0,-2.0,0.2313830852508545,831.1676478408392,28,689,-472,930,677,234,1149,8
7,-4,0,7.0,-4.0,0.23937416076660156,823.1323956900733,28,682,-468,930,677,234,1149,8
12,-5,0,12.0,-5.0,0.24728918075561523,810.4132857462481,28,670,-463,930,677,234,1149,8
14,-5,0,14.0,-5.0,0.25543212890625,796.0624975587845,28,656,-458,930,677,234,1149,8
16,-8,0,16.0,-8.0,0.2633540630340576,778.368199762746,28,640,-450,930,677,234,1149,8
19,-10,0,19.0,-10.0,0.2713620662689209,757.0788395429215,28,621,-440,930,677,234,1149,8
22,-12,0,22.0,-12.0,0.2793881893157959,732.1963053425357,28,599,-428,930,677,234,1149,8
25,-14,0,25.0,-14.0,0.2873711585998535,703.7231096975709,28,574,-414,930,677,234,1149,8
26,-21,0,26.0,-21.0,0.29526805877685547,670.353764725904,28,548,-393,930,677,234,1149,8
30,-29,0,30.0,-29.0,0.3032400608062744,629.1034670573207,28,518,-364,930,677,234,1149,8
29,-28,0,29.0,-28.0,0.3115720748901367,589.3102055417554,28,489,-336,930,677,234,1149,8
26,-23,0,26.0,-23.0,0.31935620307922363,554.8720783864586,28,463,-313,930,677,234,1149,8
24,-21,0,24.0,-21.0,0.32726526260375977,523.2428283058955,28,439,-292,930,677,234,1149,8
20,-19,0,20.0,-19.0,0.33533525466918945,496.08999190145767,28,419,-273,930,677,234,1149,8
19,-17,0,19.0,-17.0,0.34334325790405273,470.90630654898655,28,400,-256,930,677,234,1149,8
17,-15,0,17.0,-15.0,0.3513801097869873,448.5151931151041,28,383,-241,930,677,234,1149,8
16,-15,0,16.0,-15.0,0.3593320846557617,427.00464034624963,28,367,-226,930,677,234,1149,8
15,-14,0,15.0,-14.0,0.3672142028808594,406.9111826173632,28,352,-212,930,677,234,1149,8
16,-14,0,16.0,-14.0,0.37532615661621094,386.0,28,336,-198,930,677,234,1149,8
17,-15,0,17.0,-15.0,0.3832662105560303,363.76351096866586,28,319,-183,930,677,234,1149,8
17,-13,0,17.0,-13.0,0.39136219024658203,342.56024007378574,28,302,-170,930,677,234,1149,8
18,-11,0,18.0,-11.0,0.3993961811065674,321.4796460610095,28,284,-159,930,677,234,1149,8
19,-10,0,19.0,-10.0,0.40734410285949707,300.0164469235176,28,265,-149,930,677,234,1149,8
18,-8,0,18.0,-8.0,0.41533923149108887,280.41167345944154,28,247,-141,930,677,234,1149,8
16,-5,0,16.0,-5.0,0.42333507537841797,264.06156009394556,28,231,-136,930,677,234,1149,8
14,-4,0,14.0,-4.0,0.4313232898712158,249.99409441953566,28,217,-132,930,677,234,1149,8
12,-5,0,12.0,-5.0,0.43944621086120605,237.1514047232568,28,205,-127,930,677,234,1149,8
9,-4,0,9.0,-4.0,0.44719719886779785,227.39792566053828,28,196,-123,930,677,234,1149,8
9,-5,0,9.0,-5.0,0.455322265625,217.11761576138613,28,187,-118,930,677,234,1149,8
8,-6,0,8.0,-6.0,0.4632272720336914,207.15160430363773,28,179,-112,930,677,234,1149,8
7,-6,0,7.0,-6.0,0.47145509719848633,198.03960007879644,28,172,-106,930,677,234,1149,8
7,-7,0,7.0,-7.0,0.47934913635253906,188.42141252989492,28,165,-99,930,677,234,1149,8
6,-7,0,6.0,-7.0,0.48734521865844727,179.69812192834198,28,159,-92,930,677,234,1149,8
6,-7,0,6.0,-7.0,0.4953012466430664,171.025712396779,28,153,-85,930,677,234,1149,8
6,-5,0,6.0,-5.0,0.5033862590789795,163.35889578985635,28,147,-80,930,677,234,1149,8
6,-5,0,6.0,-5.0,0.5113692283630371,155.70597985047397,28,141,-75,930,677,234,1149,8
5,-4,0,5.0,-4.0,0.5193872451782227,149.4177303964571,28,136,-71,930,677,234,1149,8
4,-4,0,4.0,-4.0,0.5272231101989746,144.03040228277433,28,132,-67,930,677,234,1149,8
5,-4,0,5.0,-4.0,0.5352542400360107,137.76741515595182,28,127,-63,930,677,234,1149,8
4,-4,0,4.0,-4.0,0.5432672500610352,132.41847382227965,28,123,-59,930,677,234,1149,8
4,-3,0,4.0,-3.0,0.5513222217559814,127.51805959639154,28,119,-56,930,677,234,1149,8
3,-4,0,3.0,-4.0,0.559319257736206,123.12198865656563,28,116,-52,930,677,234,1149,8
3,-2,0,3.0,-2.0,0.5672791004180908,119.5677951571525,28,113,-50,930,677,234,1149,8
2,-2,0,2.0,-2.0,0.5753321647644043,116.93386622447825,28,111,-48,930,677,234,1149,8
2,-2,0,2.0,-2.0,0.5834851264953613,114.30891766895681,28,109,-46,930,677,234,1149,8
3,-2,0,3.0,-2.0,0.5913102626800537,110.76933388322858,28,106,-44,930,677,234,1149,8
2,-1,0,2.0,-1.0,0.5993611812591553,108.53888216967503,28,104,-43,930,677,234,1149,8
2,-2,0,2.0,-2.0,0.6073012351989746,105.9317970379817,28,102,-41,930,677,234,1149,8
3,-2,0,3.0,-2.0,0.6153092384338379,102.4048871058092,28,99,-39,930,677,234,1149,8
4,-2,0,4.0,-2.0,0.6233181953430176,97.95096860746347,28,95,-37,930,677,234,1149,8
3,-2,0,3.0,-2.0,0.6313502788543701,94.43271813782245,28,92,-35,930,677,234,1149,8
4,-2,0,4.0,-2.0,0.639390230178833,89.98404119849285,28,88,-33,930,677,234,1149,8
3,-2,0,3.0,-2.0,0.6473531723022461,86.47651629014017,28,85,-31,930,677,234,1149,8
3,-2,0,3.0,-2.0,0.6554572582244873,82.97700845625813,28,82,-29,930,677,234,1149,8
3,-1,0,3.0,-1.0,0.6632411479949951,79.81527307120105,28,79,-28,930,677,234,1149,8
2,-1,0,2.0,-1.0,0.6712281703948975,77.59656855530139,28,77,-27,930,677,234,1149,8
2,-1,0,2.0,-1.0,0.6792821884155273,75.37883848986453,28,75,-26,930,677,234,1149,8
2,0,0,2.0,-0.0,0.687265157699585,73.4919350642375,28,73,-26,930,677,234,1149,8
2,-1,0,2.0,-1.0,0.6953682899475098,71.27283706623525,28,71,-25,930,677,234,1149,8
2,0,0,2.0,-0.0,0.7034401893615723,69.38937252763509,28,69,-25,930,677,234,1149,8
3,-1,0,3.0,-1.0,0.7113392353057861,66.22819946431775,28,66,-24,930,677,234,1149,8
4,-1,0,4.0,-1.0,0.7193362712860107,62.12866246946176,28,62,-23,930,677,234,1149,8
4,-1,0,4.0,-1.0,0.7273640632629395,58.03224967708329,28,58,-22,930,677,234,1149,8
3,-2,0,3.0,-2.0,0.7352461814880371,54.52349955359813,28,55,-20,930,677,234,1149,8
2,-1,0,2.0,-1.0,0.7433161735534668,52.302753041036986,28,53,-19,930,677,234,1149,8
4,-1,0,4.0,-1.0,0.7513570785522461,48.20153254455275,28,49,-18,930,677,234,1149,8
3,-1,0,3.0,-1.0,0.7593550682067871,45.040799340956916,28,46,-17,930,677,234,1149,8
3,-1,0,3.0,-1.0,0.76735520362854,41.880278987817846,28,43,-16,930,677,234,1149,8
3,-1,0,3.0,-1.0,0.7753431797027588,38.720018726587654,28,40,-15,930,677,234,1149,8
3,-1,0,3.0,-1.0,0.783405065536499,35.56008088970496,28,37,-14,930,677,234,1149,8
3,0,0,3.0,-0.0,0.7913050651550293,32.76955262170047,28,34,-14,930,677,234,1149,8
2,-1,0,2.0,-1.0,0.7992181777954102,30.539832078341085,28,32,-13,930,677,234,1149,8
4,-2,0,4.0,-2.0,0.8074052333831787,26.083217912982647,28,28,-11,930,677,234,1149,8
4,-1,0,4.0,-1.0,0.8153731822967529,22.0,28,24,-10,930,677,234,1149,8
3,-1,0,3.0,-1.0,0.8234272003173828,18.847319317591726,28,21,-9,930,677,234,1149,8
3,-1,0,3.0,-1.0,0.8313601016998291,15.697715603592208,28,18,-8,930,677,234,1149,8
2,-1,0,2.0,-1.0,0.8393430709838867,13.464249196572979,28,16,-7,930,677,234,1149,8
1,0,0,1.0,-0.0,0.847332239151001,12.552945357246848,28,15,-7,930,677,234,1149,8
1,0,0,1.0,-0.0,0.8553681373596191,11.652475842498529,28,14,-7,930,677,234,1149,8
1,-1,0,1.0,-1.0,0.8712191581726074,10.317821063276353,28,13,-6,930,677,234,1149,8
1,0,0,1.0,-0.0,0.8792672157287598,9.416407864998739,28,12,-6,930,677,234,1149,8
2,-1,0,2.0,-1.0,0.8872451782226562,7.180339887498949,28,10,-5,930,677,234,1149,8
1,0,0,1.0,-0.0,0.8952832221984863,6.295630140987001,28,9,-5,930,677,234,1149,8
1,-1,0,1.0,-1.0,0.9032840728759766,4.944271909999159,28,8,-4,930,677,234,1149,8
2,0,0,2.0,-0.0,0.9113430976867676,3.2111025509279782,28,6,-4,930,677,234,1149,8
1,-1,0,1.0,-1.0,0.9193980693817139,1.8309518948453007,28,5,-3,930,677,234,1149,8
1,0,0,1.0,-0.0,0.9432871341705322,1.0,28,4,-3,930,677,234,1149,8
0,-1,0,-0.0,-1.0,1.0634002685546875,0.4721359549995796,28,4,-2,930,677,234,1149,8
1,-1,0,1.0,-1.0,1.079411268234253,-0.8377223398316205,28,3,-1,930,677,234,1149,8
1,-2,0,1.0,-2.0,1.0873291492462158,-1.7639320225002102,28,2,1,930,677,234,1149,8
1,0,0,1.0,-0.0,1.0953421592712402,-2.585786437626905,28,1,1,930,677,234,1149,8
0,0,1,-0.0,-0.0,1.113354206085205,-2.585786437626905,28,1,1,930,677,234,1149,8
0,0,0,-0.0,-0.0,0.0937201976776123,233.91839611047115,29,-61,-231,868,445,929,676,11
0,-3,0,-0.0,-3.0,0.2356860637664795,231.01906702637396,29,-61,-228,868,445,929,676,11
0,-5,0,-0.0,-5.0,0.24361515045166016,226.19256043393784,29,-61,-223,868,445,929,676,11
0,-4,0,-0.0,-4.0,0.2516341209411621,222.3367546174617,29,-61,-219,868,445,929,676,11
-1,-6,0,-1.0,-6.0,0.25955915451049805,216.28940327092033,29,-60,-213,868,445,929,676,11
-2,-5,0,-2.0,-5.0,0.2675302028656006,210.93517545782115,29,-58,-208,868,445,929,676,11
-2,-7,0,-2.0,-7.0,0.27555203437805176,203.65521800328887,29,-56,-201,868,445,929,676,11
-4,-8,0,-4.0,-8.0,0.28359103202819824,194.88246546408217,29,-52,-193,868,445,929,676,11
-4,-9,0,-4.0,-9.0,0.2916381359100342,185.1578291840754,29,-48,-184,868,445,929,676,11
-5,-13,0,-5.0,-13.0,0.2996070384979248,171.32356620712955,29,-43,-171,868,445,929,676,11
-5,-12,0,-5.0,-12.0,0.3076162338256836,158.47782724271815,29,-38,-159,868,445,929,676,11
-4,-13,0,-4.0,-13.0,0.31564807891845703,144.90663761154806,29,-34,-146,868,445,929,676,11
-3,-11,0,-3.0,-11.0,0.323559045791626,133.51353724455961,29,-31,-135,868,445,929,676,11
-2,-8,0,-2.0,-8.0,0.3316080570220947,125.26895255585654,29,-29,-127,868,445,929,676,11
-3,-8,0,-3.0,-8.0,0.3395240306854248,116.80722474467596,29,-26,-119,868,445,929,676,11
-2,-7,0,-2.0,-7.0,0.3475022315979004,109.54256850621083,29,-24,-112,868,445,929,676,11
-2,-7,0,-2.0,-7.0,0.3555140495300293,102.28000745712129,29,-22,-105,868,445,929,676,11
-3,-7,0,-3.0,-7.0,0.36363911628723145,94.82484660644363,29,-19,-98,868,445,929,676,11
-2,-6,0,-2.0,-6.0,0.37163710594177246,88.55746896961247,29,-17,-92,868,445,929,676,11
-3,-6,0,-3.0,-6.0,0.3796050548553467,82.13208364316786,29,-14,-86,868,445,929,676,11
-4,-6,0,-4.0,-6.0,0.38767313957214355,75.62257748298549,29,-10,-80,868,445,929,676,11
-4,-5,0,-4.0,-5.0,0.39567112922668457,70.23961722390672,29,-6,-75,868,445,929,676,11
-3,-5,0,-3.0,-5.0,0.4038200378417969,65.06425622241343,29,-3,-70,868,445,929,676,11
-3,-4,0,-3.0,-4.0,0.4114680290222168,61.0,29,0,-66,868,445,929,676,11
-2,-4,0,-2.0,-4.0,0.41957521438598633,57.03224967708329,29,2,-62,868,445,929,676,11
-2,-3,0,-2.0,-3.0,0.4275240898132324,54.135437767890075,29,4,-59,868,445,929,676,11
-1,-3,0,-1.0,-3.0,0.435589075088501,51.22277118748239,29,5,-56,868,445,929,676,11
-1,-3,0,-1.0,-3.0,0.4435431957244873,48.33854141237835,29,6,-53,868,445,929,676,11
-1,-3,0,-1.0,-3.0,0.4516000747680664,45.48762224545735,29,7,-50,868,445,929,676,11
-2,-2,0,-2.0,-2.0,0.45969223976135254,43.83646178829912,29,9,-48,868,445,929,676,11
-2,-3,0,-2.0,-3.0,0.46784305572509766,41.32493928760188,29,11,-45,868,445,929,676,11
-2,-4,0,-2.0,-4.0,0.47574400901794434,38.01162633521314,29,13,-41,868,445,929,676,11
-1,-3,0,-1.0,-3.0,0.4835090637207031,35.496913462633174,29,14,-38,868,445,929,676,11
-1,-3,0,-1.0,-3.0,0.49151015281677246,33.07886552931954,29,15,-35,868,445,929,676,11
-1,-2,0,-1.0,-2.0,0.4996821880340576,31.674241641784498,29,16,-33,868,445,929,676,11
-1,-2,0,-1.0,-2.0,0.5074992179870605,30.355339059327378,29,17,-31,868,445,929,676,11
-1,-1,0,-1.0,-1.0,0.5155701637268066,29.9857113690718,29,18,-30,868,445,929,676,11
0,-2,0,-0.0,-2.0,0.5235931873321533,28.286633954186478,29,18,-28,868,445,929,676,11
0,-1,0,-0.0,-1.0,0.5316050052642822,27.449961479175904,29,18,-27,868,445,929,676,11
0,-1,0,-0.0,-1.0,0.5395560264587402,26.622776601683793,29,18,-26,868,445,929,676,11
-1,0,0,-1.0,-0.0,0.555692195892334,27.202484376209235,29,19,-26,868,445,929,676,11
0,-1,0,-0.0,-1.0,0.5635192394256592,26.400636936215164,29,19,-25,868,445,929,676,11
0,-1,0,-0.0,-1.0,0.5716001987457275,25.610455730027933,29,19,-24,868,445,929,676,11
0,-1,0,-0.0,-1.0,0.5796201229095459,24.832867780352597,29,19,-23,868,445,929,676,11
0,-1,0,-0.0,-1.0,0.5956001281738281,24.068883707497267,29,19,-22,868,445,929,676,11
0,-1,0,-0.0,-1.0,0.6037530899047852,23.319604517012593,29,19,-21,868,445,929,676,11
1,0,0,1.0,-0.0,0.6116290092468262,22.65863337187866,29,18,-21,868,445,929,676,11
0,-1,0,-0.0,-1.0,0.6196281909942627,21.90724809414742,29,18,-20,868,445,929,676,11
1,-1,0,1.0,-1.0,0.6276290416717529,20.495097567963924,29,17,-19,868,445,929,676,11
0,-1,0,-0.0,-1.0,0.6356251239776611,19.758836806279895,29,17,-18,868,445,929,676,11
1,-1,0,1.0,-1.0,0.6435260772705078,18.345235059857504,29,16,-17,868,445,929,676,11
0,-1,0,-0.0,-1.0,0.6515381336212158,17.627416997969522,29,16,-16,868,445,929,676,11
1,-1,0,1.0,-1.0,0.6596250534057617,16.213203435596427,29,15,-15,868,445,929,676,11
1,0,0,1.0,-0.0,0.6675891876220703,15.518284528683193,29,14,-15,868,445,929,676,11
1,-2,0,1.0,-2.0,0.6756100654602051,13.384776310850235,29,13,-13,868,445,929,676,11
0,-1,0,-0.0,-1.0,0.6836042404174805,12.691806012954132,29,13,-12,868,445,929,676,11
1,-1,0,1.0,-1.0,0.6914691925048828,11.278820596099706,29,12,-11,868,445,929,676,11
0,-1,0,-0.0,-1.0,0.6996200084686279,10.620499351813308,29,12,-10,868,445,929,676,11
1,-1,0,1.0,-1.0,0.7076640129089355,9.212670403551895,29,11,-9,868,445,929,676,11
0,-1,0,-0.0,-1.0,0.7156572341918945,8.601470508735444,29,11,-8,868,445,929,676,11
1,0,0,1.0,-0.0,0.7236700057983398,7.806248474865697,29,10,-8,868,445,929,676,11
0,-1,0,-0.0,-1.0,0.7315351963043213,7.206555615733702,29,10,-7,868,445,929,676,11
0,-1,0,-0.0,-1.0,0.7716341018676758,6.6619037896906015,29,10,-6,868,445,929,676,11
0,0,1,-0.0,-0.0,0.8016281127929688,6.6619037896906015,29,10,-6,868,445,929,676,11
0,0,0,-0.0,-0.0,0.8835132122039795,6.6619037896906015,29,10,-6,868,445,929,676,11
1,0,0,1.0,-0.0,1.0516760349273682,5.816653826391969,29,9,-6,868,445,929,676,11
2,0,0,2.0,-0.0,1.0595650672912598,4.219544457292887,29,7,-6,868,445,929,676,11
2,-1,0,2.0,-1.0,1.067568063735962,2.0710678118654755,29,5,-5,868,445,929,676,11
1,0,0,1.0,-0.0,1.0755832195281982,1.4031242374328485,29,4,-5,868,445,929,676,11
1,0,0,1.0,-0.0,1.0835130214691162,0.8309518948453007,29,3,-5,868,445,929,676,11
1,0,0,1.0,-0.0,1.0916061401367188,0.38516480713450374,29,2,-5,868,445,929,676,11
0,0,1,-0.0,-0.0,1.131580114364624,0.38516480713450374,29,2,-5,868,445,929,676,11
0,0,0,-0.0,-0.0,0.06270003318786621,202.63429389192913,30,-206,-26,660,424,866,450,11
-3,2,0,-3.0,2.0,0.23868918418884277,199.92193635626225,30,-203,-28,660,424,866,450,11
-3,2,0,-3.0,2.0,0.2466740608215332,197.23748416156684,30,-200,-30,660,424,866,450,11
-4,0,0,-4.0,-0.0,0.25473523139953613,193.2826265712657,30,-196,-30,660,424,866,450,11
-5,0,0,-5.0,-0.0,0.26276707649230957,188.3416664870767,30,-191,-30,660,424,866,450,11
-5,-1,0,-5.0,-1.0,0.27077603340148926,183.2471779336944,30,-186,-29,660,424,866,450,11
-6,-2,0,-6.0,-2.0,0.27878308296203613,177.01373574541017,30,-180,-27,660,424,866,450,11
-6,-2,0,-6.0,-2.0,0.28679704666137695,170.78680269007683,30,-174,-25,660,424,866,450,11
-6,-3,0,-6.0,-3.0,0.2948012351989746,164.43435306926398,30,-168,-22,660,424,866,450,11
-7,-4,0,-7.0,-4.0,0.3027770519256592,157.00308639035245,30,-161,-18,660,424,866,450,11
-7,-4,0,-7.0,-4.0,0.3106400966644287,149.63505424062166,30,-154,-14,660,424,866,450,11
-8,-4,0,-8.0,-4.0,0.3186800479888916,141.34206503941374,30,-146,-10,660,424,866,450,11
-8,-4,0,-8.0,-4.0,0.3267040252685547,133.13037319865606,30,-138,-6,660,424,866,450,11
-6,-3,0,-6.0,-3.0,0.3347291946411133,127.03408650799233,30,-132,-3,660,424,866,450,11
-6,-3,0,-6.0,-3.0,0.34293413162231445,121.0,30,-126,0,660,424,866,450,11
-6,-2,0,-6.0,-2.0,0.350750207901001,115.01666550941998,30,-120,2,660,424,866,450,11
-7,-1,0,-7.0,-1.0,0.3588120937347412,108.03981599418853,30,-113,3,660,424,866,450,11
-6,0,0,-6.0,-0.0,0.3667771816253662,102.0420478129973,30,-107,3,660,424,866,450,11
-6,0,0,-6.0,-0.0,0.3748021125793457,96.04454463255303,30,-101,3,660,424,866,450,11
-7,0,0,-7.0,-0.0,0.38297605514526367,89.04786015641186,30,-94,3,660,424,866,450,11
-7,0,0,-7.0,-0.0,0.3908052444458008,82.05170877128145,30,-87,3,660,424,866,450,11
-6,0,0,-6.0,-0.0,0.398773193359375,76.05553651663777,30,-81,3,660,424,866,450,11
-7,0,0,-7.0,-0.0,0.4066650867462158,69.06078584514209,30,-74,3,660,424,866,450,11
-6,1,0,-6.0,1.0,0.4147500991821289,63.0294054067798,30,-68,2,660,424,866,450,11
-6,0,0,-6.0,-0.0,0.4227871894836426,57.03224967708329,30,-62,2,660,424,866,450,11
-5,0,0,-5.0,-0.0,0.43065524101257324,52.0350769263968,30,-57,2,660,424,866,450,11
-4,0,0,-4.0,-0.0,0.43874025344848633,48.03772242470448,30,-53,2,660,424,866,450,11
-4,0,0,-4.0,-0.0,0.4467630386352539,44.040799340956916,30,-49,2,660,424,866,450,11
-5,0,0,-5.0,-0.0,0.45472025871276855,39.04543109109048,30,-44,2,660,424,866,450,11
-3,0,0,-3.0,-0.0,0.46273303031921387,36.048751503547585,30,-41,2,660,424,866,450,11
-3,0,0,-3.0,-0.0,0.4707911014556885,33.05259518088089,30,-38,2,660,424,866,450,11
-2,0,0,-2.0,-0.0,0.4786832332611084,31.055512754639892,30,-36,2,660,424,866,450,11
-1,-1,0,-1.0,-1.0,0.48679018020629883,30.128336140500593,30,-35,3,660,424,866,450,11
-1,0,0,-1.0,-0.0,0.5028021335601807,29.132096331752024,30,-34,3,660,424,866,450,11
-1,0,0,-1.0,-0.0,0.5348281860351562,28.136083051561783,30,-33,3,660,424,866,450,11
-1,0,0,-1.0,-0.0,0.5429301261901855,27.140317359976393,30,-32,3,660,424,866,450,11
-1,-1,0,-1.0,-1.0,0.5508232116699219,26.25699921617557,30,-31,4,660,424,866,450,11
-2,0,0,-2.0,-0.0,0.5587751865386963,24.274562336608895,30,-29,4,660,424,866,450,11
-1,0,0,-1.0,-0.0,0.5668160915374756,23.284271247461902,30,-28,4,660,424,866,450,11
-2,0,0,-2.0,-0.0,0.5747861862182617,21.30589287593181,30,-26,4,660,424,866,450,11
-2,0,0,-2.0,-0.0,0.5826852321624756,19.331050121192877,30,-24,4,660,424,866,450,11
-3,-1,0,-3.0,-1.0,0.5908091068267822,16.587033144922902,30,-21,5,660,424,866,450,11
-3,0,0,-3.0,-0.0,0.5987241268157959,13.681541692269406,30,-18,5,660,424,866,450,11
-3,0,0,-3.0,-0.0,0.6067891120910645,10.811388300841896,30,-15,5,660,424,866,450,11
-2,0,0,-2.0,-0.0,0.6147582530975342,8.92838827718412,30,-13,5,660,424,866,450,11
-2,0,0,-2.0,-0.0,0.6227951049804688,7.083045973594572,30,-11,5,660,424,866,450,11
-3,0,0,-3.0,-0.0,0.6307780742645264,4.433981132056603,30,-8,5,660,424,866,450,11
-2,0,0,-2.0,-0.0,0.6387851238250732,2.810249675906654,30,-6,5,660,424,866,450,11
-2,0,0,-2.0,-0.0,0.6468071937561035,1.4031242374328485,30,-4,5,660,424,866,450,11
-2,0,0,-2.0,-0.0,0.654717206954956,0.38516480713450374,30,-2,5,660,424,866,450,11
-2,0,0,-2.0,-0.0,0.6628742218017578,0.0,30,0,5,660,424,866,450,11
-2,0,0,-2.0,-0.0,0.6706981658935547,0.38516480713450374,30,2,5,660,424,866,450,11
-1,0,0,-1.0,-0.0,0.6788051128387451,0.8309518948453007,30,3,5,660,424,866,450,11
-2,1,0,-2.0,1.0,0.6868581771850586,1.4031242374328485,30,5,4,660,424,866,450,11
-1,0,0,-1.0,-0.0,0.6948192119598389,2.2111025509279782,30,6,4,660,424,866,450,11
-1,1,0,-1.0,1.0,0.702733039855957,2.6157731058639087,30,7,3,660,424,866,450,11
0,0,1,-0.0,-0.0,0.7077200412750244,2.6157731058639087,30,7,3,660,424,866,450,11
-1,1,1,-1.0,1.0,0.0007812976837158203,599.7046980236371,31,-509,-332,143,90,653,421,17
-1,1,1,-1.0,1.0,0.008751392364501953,599.4150146316767,31,-508,-333,143,90,653,421,17
0,1,1,-0.0,1.0,0.017331361770629883,599.963814712685,31,-508,-334,143,90,653,421,17
0,0,0,-0.0,-0.0,0.11675524711608887,599.963814712685,31,-508,-334,143,90,653,421,17
1,0,0,1.0,-0.0,0.17681431770324707,600.7996386332699,31,-509,-334,143,90,653,421,17
3,0,0,3.0,-0.0,0.1846942901611328,603.310068623117,31,-512,-334,143,90,653,421,17
1,0,0,1.0,-0.0,0.19287538528442383,604.1478579559026,31,-513,-334,143,90,653,421,17
2,0,0,2.0,-0.0,0.20075535774230957,605.8248935975145,31,-515,-334,143,90,653,421,17
2,0,0,2.0,-0.0,0.20882320404052734,607.5038586394077,31,-517,-334,143,90,653,421,17
2,0,0,2.0,-0.0,0.21684527397155762,609.184737335589,31,-519,-334,143,90,653,421,17
-1,-2,0,-1.0,-2.0,0.28890538215637207,607.262545585216,31,-518,-332,143,90,653,421,17
-5,-6,0,-5.0,-6.0,0.29684925079345703,599.8198746339248,31,-513,-326,143,90,653,421,17
-8,-8,0,-8.0,-8.0,0.3047971725463867,588.7822048285287,31,-505,-318,143,90,653,421,17
-12,-9,0,-12.0,-9.0,0.31275224685668945,573.8333094624267,31,-493,-309,143,90,653,421,17
-15,-12,0,-15.0,-12.0,0.32082033157348633,554.7548311654019,31,-478,-297,143,90,653,421,17
-21,-15,0,-21.0,-15.0,0.3287172317504883,529.0037243818706,31,-457,-282,143,90,653,421,17
-26,-17,0,-26.0,-17.0,0.33696937561035156,497.9505904730224,31,-431,-265,143,90,653,421,17
-31,-19,0,-31.0,-19.0,0.3449223041534424,461.5913116743111,31,-400,-246,143,90,653,421,17
-36,-24,0,-36.0,-24.0,0.35289525985717773,418.35665821000146,31,-364,-222,143,90,653,421,17
-39,-26,0,-39.0,-26.0,0.3608522415161133,371.5273376187808,31,-325,-196,143,90,653,421,17
-37,-24,0,-37.0,-24.0,0.36890721321105957,327.4519339637201,31,-288,-172,143,90,653,421,17
-37,-23,0,-37.0,-23.0,0.376995325088501,283.8938163099726,31,-251,-149,143,90,653,421,17
-35,-22,0,-35.0,-22.0,0.38475632667541504,242.56935167733502,31,-216,-127,143,90,653,421,17
-33,-19,0,-33.0,-19.0,0.3928203582763672,204.49235280357738,31,-183,-108,143,90,653,421,17
-31,-17,0,-31.0,-17.0,0.4008822441101074,169.15812146215595,31,-152,-91,143,90,653,421,17
-29,-11,0,-29.0,-11.0,0.4089012145996094,138.72763884149435,31,-123,-80,143,90,653,421,17
-28,-8,0,-28.0,-8.0,0.41704726219177246,111.20151005754919,31,-95,-72,143,90,653,421,17
-27,-3,0,-27.0,-3.0,0.4248082637786865,88.87620966986684,31,-68,-69,143,90,653,421,17
-23,-2,0,-23.0,-2.0,0.4329252243041992,72.7093550959243,31,-45,-67,143,90,653,421,17
-17,-1,0,-17.0,-1.0,0.44086337089538574,63.69379331573968,31,-28,-66,143,90,653,421,17
-10,0,0,-10.0,-0.0,0.44904017448425293,60.410525505948286,31,-18,-66,143,90,653,421,17
-3,0,0,-3.0,-0.0,0.4569113254547119,59.683085036070864,31,-15,-66,143,90,653,421,17
1,0,0,1.0,-0.0,0.49686217308044434,59.911707385398586,31,-16,-66,143,90,653,421,17
3,0,0,3.0,-0.0,0.5049262046813965,60.6804193347711,31,-19,-66,143,90,653,421,17
4,1,0,4.0,1.0,0.5128543376922607,62.837842993699354,31,-23,-67,143,90,653,421,17
5,1,0,5.0,1.0,0.5208501815795898,65.53910524340094,31,-28,-68,143,90,653,421,17
4,1,0,4.0,1.0,0.5288121700286865,68.05918747922567,31,-32,-69,143,90,653,421,17
4,1,0,4.0,1.0,0.5368473529815674,70.71467461661771,31,-36,-70,143,90,653,421,17
5,1,0,5.0,1.0,0.544701337814331,73.98780397107853,31,-41,-71,143,90,653,421,17
5,0,0,5.0,-0.0,0.5528073310852051,76.59905436823747,31,-46,-71,143,90,653,421,17
3,1,0,3.0,1.0,0.5607962608337402,79.09190547921202,31,-49,-72,143,90,653,421,17
3,0,0,3.0,-0.0,0.5688672065734863,80.81441324469807,31,-52,-72,143,90,653,421,17
2,0,0,2.0,-0.0,0.5768551826477051,82.0,31,-54,-72,143,90,653,421,17
3,0,0,3.0,-0.0,0.5848643779754639,83.8313671900838,31,-57,-72,143,90,653,421,17
3,0,0,3.0,-0.0,0.5928232669830322,85.72299611087985,31,-60,-72,143,90,653,421,17
1,-1,0,1.0,-1.0,0.6008412837982178,85.60555539069249,31,-61,-71,143,90,653,421,17
0,-1,0,-0.0,-1.0,0.608823299407959,84.84934033152847,31,-61,-70,143,90,653,421,17
0,-3,0,-0.0,-3.0,0.6168653964996338,82.60905032059435,31,-61,-67,143,90,653,421,17
0,-2,0,-0.0,-2.0,0.6248123645782471,81.1403387922662,31,-61,-65,143,90,653,421,17
-1,-3,0,-1.0,-3.0,0.6327512264251709,78.27861844049197,31,-60,-62,143,90,653,421,17
-3,-5,0,-3.0,-5.0,0.6408061981201172,72.61017305526642,31,-57,-57,143,90,653,421,17
-3,-5,0,-3.0,-5.0,0.648815393447876,66.96665925596525,31,-54,-52,143,90,653,421,17
-3,-4,0,-3.0,-4.0,0.6569302082061768,62.03570517957252,31,-51,-48,143,90,653,421,17
-3,-4,0,-3.0,-4.0,0.6649463176727295,57.115282384398824,31,-48,-44,143,90,653,421,17
-3,-3,0,-3.0,-3.0,0.6727073192596436,52.876925020897694,31,-45,-41,143,90,653,421,17
-3,-3,0,-3.0,-3.0,0.6807582378387451,48.639209034025185,31,-42,-38,143,90,653,421,17
-3,-2,0,-3.0,-2.0,0.6887123584747314,45.075418038862395,31,-39,-36,143,90,653,421,17
-2,-2,0,-2.0,-2.0,0.6967132091522217,42.24937810560445,31,-37,-34,143,90,653,421,17
-3,-1,0,-3.0,-1.0,0.7049543857574463,39.38143096192854,31,-34,-33,143,90,653,421,17
-4,-1,0,-4.0,-1.0,0.7129263877868652,35.86342439892262,31,-30,-32,143,90,653,421,17
-3,-2,0,-3.0,-2.0,0.7208442687988281,32.36087214122113,31,-27,-30,143,90,653,421,17
-3,-1,0,-3.0,-1.0,0.7288303375244141,29.64306044943742,31,-24,-29,143,90,653,421,17
-3,0,0,-3.0,-0.0,0.7372732162475586,27.805027579936315,31,-21,-29,143,90,653,421,17
-2,-1,0,-2.0,-1.0,0.7448782920837402,25.837848631377263,31,-19,-28,143,90,653,421,17
-3,-1,0,-3.0,-1.0,0.7527832984924316,23.38470965295043,31,-16,-27,143,90,653,421,17
-2,-1,0,-2.0,-1.0,0.7607693672180176,21.5296461204668,31,-14,-26,143,90,653,421,17
-1,0,0,-1.0,-0.0,0.7688322067260742,21.068883707497267,31,-13,-26,143,90,653,421,17
0,-1,0,-0.0,-1.0,0.7769272327423096,20.178005607210743,31,-13,-25,143,90,653,421,17
-1,0,0,-1.0,-0.0,0.7848432064056396,19.730849247724095,31,-12,-25,143,90,653,421,17
0,-1,0,-0.0,-1.0,0.8088881969451904,18.832815729997478,31,-12,-24,143,90,653,421,17
-1,-1,0,-1.0,-1.0,0.8168632984161377,17.495097567963924,31,-11,-23,143,90,653,421,17
-1,0,0,-1.0,-0.0,0.8248963356018066,17.079872407968907,31,-10,-23,143,90,653,421,17
0,-1,0,-0.0,-1.0,0.8328573703765869,16.166091947189145,31,-10,-22,143,90,653,421,17
-1,-1,0,-1.0,-1.0,0.8489522933959961,14.847319317591726,31,-9,-21,143,90,653,421,17
0,-1,0,-0.0,-1.0,0.8568763732910156,13.931712199461309,31,-9,-20,143,90,653,421,17
-1,0,0,-1.0,-0.0,0.8648402690887451,13.540659228538015,31,-8,-20,143,90,653,421,17
-1,-1,0,-1.0,-1.0,0.8727803230285645,12.248456731316587,31,-7,-19,143,90,653,421,17
0,-1,0,-0.0,-1.0,0.880805253982544,11.313207915827967,31,-7,-18,143,90,653,421,17
-1,0,0,-1.0,-0.0,0.9050161838531494,10.973665961010276,31,-6,-18,143,90,653,421,17
-2,-1,0,-2.0,-1.0,0.912933349609375,9.464249196572979,31,-4,-17,143,90,653,421,17
-1,0,0,-1.0,-0.0,0.9208922386169434,9.262676501632068,31,-3,-17,143,90,653,421,17
0,0,1,-0.0,-0.0,0.9428622722625732,9.262676501632068,31,-3,-17,143,90,653,421,17
0,0,0,-0.0,-0.0,1.011831283569336,9.262676501632068,31,-3,-17,143,90,653,421,17
-1,0,0,-1.0,-0.0,1.0887463092803955,9.11724276862369,31,-2,-17,143,90,653,421,17
0,-1,0,-0.0,-1.0,1.1368541717529297,8.124515496597098,31,-2,-16,143,90,653,421,17
-1,-2,0,-1.0,-2.0,1.1608493328094482,6.035668847618199,31,-1,-14,143,90,653,421,17
0,-2,0,-0.0,-2.0,1.1687991619110107,4.041594578792296,31,-1,-12,143,90,653,421,17
-1,-2,0,-1.0,-2.0,1.1769473552703857,2.0,31,0,-10,143,90,653,421,17
0,-1,0,-0.0,-1.0,1.1849243640899658,1.0,31,0,-9,143,90,653,421,17
0,-1,0,-0.0,-1.0,1.1928303241729736,0.0,31,0,-8,143,90,653,421,17
0,0,1,-0.0,-0.0,1.205705165863037,0.0,31,0,-8,143,90,653,421,17
0,0,0,-0.0,-0.0,0.12325239181518555,721.720377561352,32,644,372,787,470,143,98,45
1,4,0,1.0,4.0,0.20936918258666992,718.8596358285421,32,643,368,787,470,143,98,45
6,7,0,6.0,7.0,0.2173473834991455,710.1816714450041,32,637,361,787,470,143,98,45
7,7,0,7.0,7.0,0.2253282070159912,700.6451411308319,32,630,354,787,470,143,98,45
11,10,0,11.0,10.0,0.23334527015686035,686.1645289055361,32,619,344,787,470,143,98,45
15,13,0,15.0,13.0,0.24124932289123535,666.7503176042825,32,604,331,787,470,143,98,45
18,15,0,18.0,15.0,0.2492372989654541,643.771732653167,32,586,316,787,470,143,98,45
21,16,0,21.0,16.0,0.25727319717407227,617.7069641640616,32,565,300,787,470,143,98,45
24,17,0,24.0,17.0,0.2655763626098633,588.5489333378612,32,541,283,787,470,143,98,45
26,21,0,26.0,21.0,0.27337217330932617,555.8139839083163,32,515,262,787,470,143,98,45
30,24,0,30.0,24.0,0.2812511920928955,518.2490166580593,32,485,238,787,470,143,98,45
31,24,0,31.0,24.0,0.28939318656921387,479.90835816909845,32,454,214,787,470,143,98,45
34,24,0,34.0,24.0,0.29732322692871094,438.9772228646444,32,420,190,787,470,143,98,45
32,22,0,32.0,22.0,0.30538439750671387,400.80964984257395,32,388,168,787,470,143,98,45
32,20,0,32.0,20.0,0.31345224380493164,363.5385843206877,32,356,148,787,470,143,98,45
29,18,0,29.0,18.0,0.3213672637939453,329.8934497827432,32,327,130,787,470,143,98,45
26,16,0,26.0,16.0,0.32930541038513184,299.86487848163864,32,301,114,787,470,143,98,45
24,14,0,24.0,14.0,0.3372802734375,272.4978777512666,32,277,100,787,470,143,98,45
20,10,0,20.0,10.0,0.3453702926635742,250.30313990110358,32,257,90,787,470,143,98,45
16,9,0,16.0,9.0,0.3533313274383545,232.24791051255465,32,241,81,787,470,143,98,45
13,7,0,13.0,7.0,0.36139535903930664,217.70815588961506,32,228,74,787,470,143,98,45
10,5,0,10.0,5.0,0.3693532943725586,206.65913495856665,32,218,69,787,470,143,98,45
8,4,0,8.0,4.0,0.3773622512817383,197.82947936980608,32,210,65,787,470,143,98,45
6,4,0,6.0,4.0,0.38518738746643066,190.92486937884922,32,204,61,787,470,143,98,45
4,2,0,4.0,2.0,0.39330220222473145,186.5209821576716,32,200,59,787,470,143,98,45
3,1,0,3.0,1.0,0.4013702869415283,183.36065835500236,32,197,58,787,470,143,98,45
1,0,0,1.0,-0.0,0.40935420989990234,182.40156555173445,32,196,58,787,470,143,98,45
1,0,0,1.0,-0.0,0.42527127265930176,181.44286667268528,32,195,58,787,470,143,98,45
2,0,0,2.0,-0.0,0.4333312511444092,179.52667317256046,32,193,58,787,470,143,98,45
2,1,0,2.0,1.0,0.44138336181640625,177.32385707686876,32,191,57,787,470,143,98,45
3,0,0,3.0,-0.0,0.4493532180786133,174.45101170520857,32,188,57,787,470,143,98,45
4,0,0,4.0,-0.0,0.45742130279541016,170.62658175859323,32,184,57,787,470,143,98,45
4,0,0,4.0,-0.0,0.4652743339538574,166.80942773071476,32,180,57,787,470,143,98,45
5,0,0,5.0,-0.0,0.47329139709472656,162.04890654388578,32,175,57,787,470,143,98,45
5,0,0,5.0,-0.0,0.4812633991241455,157.30142219179413,32,170,57,787,470,143,98,45
4,0,0,4.0,-0.0,0.4893972873687744,153.5135322418189,32,166,57,787,470,143,98,45
6,1,0,6.0,1.0,0.4973583221435547,147.51696080333673,32,160,56,787,470,143,98,45
7,0,0,7.0,-0.0,0.5053882598876953,140.92636373527768,32,153,56,787,470,143,98,45
8,0,0,8.0,-0.0,0.5133552551269531,133.43809056984713,32,145,56,787,470,143,98,45
9,0,0,9.0,-0.0,0.5212812423706055,125.07821048680188,32,136,56,787,470,143,98,45
9,0,0,9.0,-0.0,0.5294241905212402,116.7984149765407,32,127,56,787,470,143,98,45
8,0,0,8.0,-0.0,0.5373601913452148,109.51805959639154,32,119,56,787,470,143,98,45
6,1,0,6.0,1.0,0.5451972484588623,103.67418191498204,32,113,55,787,470,143,98,45
5,1,0,5.0,1.0,0.5534312725067139,98.74767078498864,32,108,54,787,470,143,98,45
4,1,0,4.0,1.0,0.5612742900848389,94.72617529928752,32,104,53,787,470,143,98,45
6,2,0,6.0,2.0,0.5693583488464355,88.47624178980746,32,98,51,787,470,143,98,45
5,1,0,5.0,1.0,0.5772361755371094,83.58882516630251,32,93,50,787,470,143,98,45
5,2,0,5.0,2.0,0.5852823257446289,78.23971268913334,32,88,48,787,470,143,98,45
5,3,0,5.0,3.0,0.5933032035827637,72.41398201537736,32,83,45,787,470,143,98,45
6,3,0,6.0,3.0,0.6013803482055664,65.70974860299168,32,77,42,787,470,143,98,45
6,3,0,6.0,3.0,0.6092722415924072,59.00617260431454,32,71,39,787,470,143,98,45
5,3,0,5.0,3.0,0.6172552108764648,53.179784516850006,32,66,36,787,470,143,98,45
5,3,0,5.0,3.0,0.6252453327178955,47.35416353759881,32,61,33,787,470,143,98,45
4,2,0,4.0,2.0,0.6332273483276367,42.88451279003334,32,57,31,787,470,143,98,45
5,2,0,5.0,2.0,0.6412923336029053,37.53990258641679,32,52,29,787,470,143,98,45
3,2,0,3.0,2.0,0.6494534015655518,33.94640292279746,32,49,27,787,470,143,98,45
3,1,0,3.0,1.0,0.6573433876037598,30.839379254491625,32,46,26,787,470,143,98,45
4,1,0,4.0,1.0,0.6653232574462891,26.877397639399746,32,42,25,787,470,143,98,45
3,2,0,3.0,2.0,0.673539400100708,23.276925690687087,32,39,23,787,470,143,98,45
3,1,0,3.0,1.0,0.6816582679748535,20.190046219457976,32,36,22,787,470,143,98,45
3,1,0,3.0,1.0,0.6892812252044678,17.11521443121589,32,33,21,787,470,143,98,45
2,1,0,2.0,1.0,0.6973302364349365,14.891733491393431,32,31,20,787,470,143,98,45
2,0,0,2.0,-0.0,0.705207347869873,13.227829907617071,32,29,20,787,470,143,98,45
1,1,0,1.0,1.0,0.7133252620697021,11.837848631377263,32,28,19,787,470,143,98,45
2,0,0,2.0,-0.0,0.7213382720947266,10.202484376209235,32,26,19,787,470,143,98,45
2,1,0,2.0,1.0,0.7293343544006348,8.0,32,24,18,787,470,143,98,45
1,0,0,1.0,-0.0,0.737403392791748,7.2061637330204675,32,23,18,787,470,143,98,45
1,0,0,1.0,-0.0,0.7535572052001953,6.42534080710379,32,22,18,787,470,143,98,45
0,0,1,-0.0,-0.0,0.7585813999176025,6.42534080710379,32,22,18,787,470,143,98,45
1,1,1,1.0,1.0,0.761317253112793,5.018512172212592,32,21,17,787,470,143,98,45
0,0,0,-0.0,-0.0,0.8312742710113525,5.018512172212592,32,21,17,787,470,143,98,45
0,1,0,-0.0,1.0,0.9453732967376709,4.4007575648881705,32,21,16,787,470,143,98,45
0,1,0,-0.0,1.0,0.9533753395080566,3.80697580112788,32,21,15,787,470,143,98,45
-1,3,0,-1.0,3.0,0.9613673686981201,3.0599281722833354,32,22,12,787,470,143,98,45
-1,4,0,-1.0,4.0,0.9693572521209717,2.351591323771842,32,23,8,787,470,143,98,45
0,3,0,-0.0,3.0,0.9772942066192627,1.5372045918796395,32,23,5,787,470,143,98,45
0,4,0,-0.0,4.0,0.985220193862915,1.0217288664426754,32,23,1,787,470,143,98,45
0,3,0,-0.0,3.0,0.9931972026824951,1.0867927612303916,32,23,-2,787,470,143,98,45
0,4,0,-0.0,4.0,1.0013961791992188,1.7697286480094263,32,23,-6,787,470,143,98,45
1,4,0,1.0,4.0,1.0093343257904053,2.1660919471891447,32,22,-10,787,470,143,98,45
1,3,0,1.0,3.0,1.0172882080078125,2.6981780704569367,32,21,-13,787,470,143,98,45
1,3,0,1.0,3.0,1.0253663063049316,3.612496949731394,32,20,-16,787,470,143,98,45
1,2,0,1.0,2.0,1.0333402156829834,4.172504656604801,32,19,-18,787,470,143,98,45
0,0,1,-0.0,-0.0,1.0402112007141113,4.172504656604801,32,19,-18,787,470,143,98,45
2,2,1,2.0,2.0,1.0413122177124023,4.248809496813376,32,17,-20,787,470,143,98,45
0,1,1,-0.0,1.0,1.0492281913757324,5.018512172212592,32,17,-21,787,470,143,98,45
1,1,1,1.0,1.0,1.0573253631591797,5.202941017470888,32,16,-22,787,470,143,98,45
0,0,0,-0.0,-0.0,1.1242563724517822,5.202941017470888,32,16,-22,787,470,143,98,45
0,0,1,-0.0,-0.0,1.2462172508239746,5.202941017470888,32,16,-22,787,470,143,98,45
0,0,0,-0.0,-0.0,0.09131836891174316,412.24594477354026,33,141,-416,912,76,771,492,55
0,0,1,-0.0,-0.0,0.2034304141998291,412.24594477354026,33,141,-416,912,76,771,492,55
0,0,0,-0.0,-0.0,0.23531842231750488,412.24594477354026,33,141,-416,912,76,771,492,55
1,-1,0,1.0,-1.0,0.26252031326293945,410.97830996523106,33,140,-415,912,76,771,492,55
3,-6,0,3.0,-6.0,0.27040743827819824,404.335136523794,33,137,-409,912,76,771,492,55
3,-8,0,3.0,-8.0,0.2784082889556885,395.7966414246925,33,134,-401,912,76,771,492,55
4,-10,0,4.0,-10.0,0.2864654064178467,385.0449004659565,33,130,-391,912,76,771,492,55
4,-12,0,4.0,-12.0,0.29468536376953125,372.39579366838603,33,126,-379,912,76,771,492,55
4,-15,0,4.0,-15.0,0.3024113178253174,356.9010289124008,33,122,-364,912,76,771,492,55
4,-17,0,4.0,-17.0,0.3103945255279541,339.51466546374377,33,118,-347,912,76,771,492,55
4,-20,0,4.0,-20.0,0.3183634281158447,319.30189141845585,33,114,-327,912,76,771,492,55
4,-21,0,4.0,-21.0,0.3263723850250244,298.17072438951203,33,110,-306,912,76,771,492,55
4,-24,0,4.0,-24.0,0.3344132900238037,274.2640038238887,33,106,-282,912,76,771,492,55
3,-26,0,3.0,-26.0,0.34249138832092285,248.94383486499567,33,103,-256,912,76,771,492,55
4,-24,0,4.0,-24.0,0.3505094051361084,225.23996511258878,33,99,-232,912,76,771,492,55
5,-17,0,5.0,-17.0,0.3584144115447998,207.65080438813757,33,94,-215,912,76,771,492,55
5,-14,0,5.0,-14.0,0.366396427154541,192.8226557932553,33,89,-201,912,76,771,492,55
5,-10,0,5.0,-10.0,0.37439537048339844,181.65521800328887,33,84,-191,912,76,771,492,55
4,-10,0,4.0,-10.0,0.38247251510620117,170.89138435010253,33,80,-181,912,76,771,492,55
3,-7,0,3.0,-7.0,0.39041948318481445,163.2761151589973,33,77,-174,912,76,771,492,55
4,-8,0,4.0,-8.0,0.398531436920166,154.34221791960084,33,73,-166,912,76,771,492,55
4,-9,0,4.0,-9.0,0.4064183235168457,144.49344010777787,33,69,-157,912,76,771,492,55
5,-9,0,5.0,-9.0,0.41439151763916016,134.24515496597098,33,64,-148,912,76,771,492,55
3,-8,0,3.0,-8.0,0.42239832878112793,125.7121475194426,33,61,-140,912,76,771,492,55
4,-8,0,4.0,-8.0,0.430328369140625,116.7810835958611,33,57,-132,912,76,771,492,55
4,-6,0,4.0,-6.0,0.43831849098205566,109.69308687713507,33,53,-126,912,76,771,492,55
3,-6,0,3.0,-6.0,0.44644737243652344,103.0,33,50,-120,912,76,771,492,55
2,-4,0,2.0,-4.0,0.454418420791626,98.53883861180172,33,48,-116,912,76,771,492,55
2,-4,0,2.0,-4.0,0.4623982906341553,94.07848694132248,33,46,-112,912,76,771,492,55
3,-5,0,3.0,-5.0,0.47045350074768066,88.31695452100702,33,43,-107,912,76,771,492,55
3,-3,0,3.0,-3.0,0.4783973693847656,84.42710621747295,33,40,-104,912,76,771,492,55
2,-2,0,2.0,-2.0,0.4865114688873291,81.84851859350222,33,38,-102,912,76,771,492,55
3,-4,0,3.0,-4.0,0.49439334869384766,77.06248123122954,33,35,-98,912,76,771,492,55
3,-3,0,3.0,-3.0,0.5022704601287842,73.24470060806208,33,32,-95,912,76,771,492,55
2,-2,0,2.0,-2.0,0.5104584693908691,70.71898484941399,33,30,-93,912,76,771,492,55
3,-4,0,3.0,-4.0,0.5183534622192383,66.00537618869137,33,27,-89,912,76,771,492,55
3,-3,0,3.0,-3.0,0.5263004302978516,62.28605714219886,33,24,-86,912,76,771,492,55
2,-5,0,2.0,-5.0,0.534386396408081,56.93449827097318,33,22,-81,912,76,771,492,55
3,-5,0,3.0,-5.0,0.5423893928527832,51.33900688673555,33,19,-76,912,76,771,492,55
3,-4,0,3.0,-4.0,0.5505073070526123,46.7563556583431,33,16,-72,912,76,771,492,55
2,-4,0,2.0,-4.0,0.5585024356842041,42.42621983083913,33,14,-68,912,76,771,492,55
2,-3,0,2.0,-3.0,0.5664653778076172,39.09841147864296,33,12,-65,912,76,771,492,55
3,-5,0,3.0,-5.0,0.5744915008544922,33.67124524847005,33,9,-60,912,76,771,492,55
2,-5,0,2.0,-5.0,0.5823323726654053,28.443665102516448,33,7,-55,912,76,771,492,55
3,-5,0,3.0,-5.0,0.590367317199707,23.159744815937813,33,4,-50,912,76,771,492,55
2,-4,0,2.0,-4.0,0.5984513759613037,19.04345773288535,33,2,-46,912,76,771,492,55
2,-5,0,2.0,-5.0,0.6064274311065674,14.0,33,0,-41,912,76,771,492,55
1,-6,0,1.0,-6.0,0.614410400390625,8.014282800023196,33,-1,-35,912,76,771,492,55
1,-4,0,1.0,-4.0,0.6223983764648438,4.064449134018133,33,-2,-31,912,76,771,492,55
1,-3,0,1.0,-3.0,0.6304395198822021,1.1602556806574462,33,-3,-28,912,76,771,492,55
0,-1,0,-0.0,-1.0,0.6382784843444824,0.16615541441224835,33,-3,-27,912,76,771,492,55
0,0,1,-0.0,-0.0,0.6532793045043945,0.16615541441224835,33,-3,-27,912,76,771,492,55
0,0,0,-0.0,-0.0,0.07973241806030273,1057.4732672259563,34,-446,994,469,1097,915,103,64
-2,0,0,-2.0,-0.0,0.1157834529876709,1056.6560522038171,34,-444,994,469,1097,915,103,64
-2,0,0,-2.0,-0.0,0.12398052215576172,1055.8419002777932,34,-442,994,469,1097,915,103,64
-1,0,0,-1.0,-0.0,0.13182640075683594,1055.4359751268119,34,-441,994,469,1097,915,103,64
-1,1,0,-1.0,1.0,0.13974452018737793,1054.1164762584167,34,-440,993,469,1097,915,103,64
-1,0,0,-1.0,-0.0,0.14783453941345215,1053.7117481173352,34,-439,993,469,1097,915,103,64
-3,1,0,-3.0,1.0,0.1557464599609375,1051.5866370530784,34,-436,992,469,1097,915,103,64
-2,1,0,-2.0,1.0,0.16382050514221191,1049.8673671019012,34,-434,991,469,1097,915,103,64
-2,1,0,-2.0,1.0,0.17181158065795898,1048.1499895847799,34,-432,990,469,1097,915,103,64
-3,5,0,-3.0,5.0,0.17981648445129395,1042.3677210340973,34,-429,985,469,1097,915,103,64
-5,7,0,-5.0,7.0,0.18781042098999023,1033.95497090637,34,-424,978,469,1097,915,103,64
-7,11,0,-7.0,11.0,0.1959073543548584,1021.080243856089,34,-417,967,469,1097,915,103,64
-6,13,0,-6.0,13.0,0.2039015293121338,1006.7670576216788,34,-411,954,469,1097,915,103,64
-8,18,0,-8.0,18.0,0.21183252334594727,987.0706550578326,34,-403,936,469,1097,915,103,64
-8,19,0,-8.0,19.0,0.21979546546936035,966.4558077351245,34,-395,917,469,1097,915,103,64
-9,25,0,-9.0,25.0,0.22784948348999023,939.9362118987027,34,-386,892,469,1097,915,103,64
-10,27,0,-10.0,27.0,0.23596453666687012,911.1866199220598,34,-376,865,469,1097,915,103,64
-9,27,0,-9.0,27.0,0.24386835098266602,882.8404232433107,34,-367,838,469,1097,915,103,64
-10,30,0,-10.0,30.0,0.25180554389953613,851.3532702152634,34,-357,808,469,1097,915,103,64
-12,28,0,-12.0,28.0,0.2598385810852051,820.8921385497699,34,-345,780,469,1097,915,103,64
-11,28,0,-11.0,28.0,0.26783156394958496,790.8365572821859,34,-334,752,469,1097,915,103,64
-12,26,0,-12.0,26.0,0.2758195400238037,762.2040040191185,34,-322,726,469,1097,915,103,64
-12,26,0,-12.0,26.0,0.283738374710083,733.5716818169283,34,-310,700,469,1097,915,103,64
-11,26,0,-11.0,26.0,0.29180335998535156,705.3445598904219,34,-299,674,469,1097,915,103,64
-14,26,0,-14.0,26.0,0.2997124195098877,675.9046545969309,34,-285,648,469,1097,915,103,64
-12,27,0,-12.0,27.0,0.3077504634857178,646.3583123983962,34,-273,621,469,1097,915,103,64
-11,25,0,-11.0,25.0,0.31586241722106934,619.0453133231204,34,-262,596,469,1097,915,103,64
-10,24,0,-10.0,24.0,0.323744535446167,593.0503979680359,34,-252,572,469,1097,915,103,64
-9,22,0,-9.0,22.0,0.33179140090942383,569.2894477703729,34,-243,550,469,1097,915,103,64
-8,20,0,-8.0,20.0,0.33984851837158203,547.7628825649327,34,-235,530,469,1097,915,103,64
-8,19,0,-8.0,19.0,0.34778642654418945,527.1511423577707,34,-227,511,469,1097,915,103,64
-8,19,0,-8.0,19.0,0.35582756996154785,506.5396921304873,34,-219,492,469,1097,915,103,64
-8,19,0,-8.0,19.0,0.36390137672424316,485.9285665031424,34,-211,473,469,1097,915,103,64
-7,16,0,-7.0,16.0,0.3717503547668457,468.46478397585577,34,-204,457,469,1097,915,103,64
-8,17,0,-8.0,17.0,0.37985849380493164,449.6803919613087,34,-196,440,469,1097,915,103,64
-8,16,0,-8.0,16.0,0.38783955574035645,431.8103060519462,34,-188,424,469,1097,915,103,64
-8,17,0,-8.0,17.0,0.3958463668823242,413.02696547512716,34,-180,407,469,1097,915,103,64
-8,16,0,-8.0,16.0,0.40378355979919434,395.15922090012293,34,-172,391,469,1097,915,103,64
-7,18,0,-7.0,18.0,0.4118003845214844,375.8651738013433,34,-165,373,469,1097,915,103,64
-6,14,0,-6.0,14.0,0.41988539695739746,360.63469026564627,34,-159,359,469,1097,915,103,64
-6,12,0,-6.0,12.0,0.4278604984283447,347.23343734433547,34,-153,347,469,1097,915,103,64
-5,12,0,-5.0,12.0,0.4357423782348633,334.23626254099963,34,-148,335,469,1097,915,103,64
-6,13,0,-6.0,13.0,0.44380855560302734,319.9204455555261,34,-142,322,469,1097,915,103,64
-7,12,0,-7.0,12.0,0.45182156562805176,306.11980125393427,34,-135,310,469,1097,915,103,64
-10,14,0,-10.0,14.0,0.45992040634155273,289.3113754600045,34,-125,296,469,1097,915,103,64
-9,13,0,-9.0,13.0,0.46778440475463867,273.8512710452582,34,-116,283,469,1097,915,103,64
-7,14,0,-7.0,14.0,0.47617554664611816,258.2447243275922,34,-109,269,469,1097,915,103,64
-7,13,0,-7.0,13.0,0.4838755130767822,243.5721321178903,34,-102,256,469,1097,915,103,64
-7,13,0,-7.0,13.0,0.49194955825805664,228.90994615000784,34,-95,243,469,1097,915,103,64
-4,11,0,-4.0,11.0,0.49981236457824707,217.2087478400387,34,-91,232,469,1097,915,103,64
-5,10,0,-5.0,10.0,0.507927417755127,206.0756182392477,34,-86,222,469,1097,915,103,64
-4,10,0,-4.0,10.0,0.5157325267791748,195.30596120647607,34,-82,212,469,1097,915,103,64
-5,11,0,-5.0,11.0,0.523735523223877,183.24404753674375,34,-77,201,469,1097,915,103,64
-6,11,0,-6.0,11.0,0.5318045616149902,170.8324431643025,34,-71,190,469,1097,915,103,64
-6,10,0,-6.0,10.0,0.5398104190826416,159.3765920900464,34,-65,180,469,1097,915,103,64
-5,11,0,-5.0,11.0,0.5478785037994385,147.3348822733603,34,-60,169,469,1097,915,103,64
-6,11,0,-6.0,11.0,0.5557184219360352,134.97305171793442,34,-54,158,469,1097,915,103,64
-6,11,0,-6.0,11.0,0.5638153553009033,122.63828762631846,34,-48,147,469,1097,915,103,64
-5,9,0,-5.0,9.0,0.5718615055084229,112.5441109142811,34,-43,138,469,1097,915,103,64
-6,9,0,-6.0,9.0,0.5797865390777588,102.20134127496641,34,-37,129,469,1097,915,103,64
-6,10,0,-6.0,10.0,0.5878405570983887,90.97154142320898,34,-31,119,469,1097,915,103,64
-6,8,0,-6.0,8.0,0.5958805084228516,81.78049041905207,34,-25,111,469,1097,915,103,64
-6,6,0,-6.0,6.0,0.6038675308227539,74.70520137275409,34,-19,105,469,1097,915,103,64
-6,6,0,-6.0,6.0,0.6117925643920898,67.84988733093293,34,-13,99,469,1097,915,103,64
-6,6,0,-6.0,6.0,0.6198194026947021,61.263068789312314,34,-7,93,469,1097,915,103,64
-5,5,0,-5.0,5.0,0.6278464794158936,56.02272433866155,34,-2,88,469,1097,915,103,64
-5,6,0,-5.0,6.0,0.6356704235076904,50.05485969764375,34,3,82,469,1097,915,103,64
-3,4,0,-3.0,4.0,0.6436805725097656,46.23042886243178,34,6,78,469,1097,915,103,64
-2,4,0,-2.0,4.0,0.6517693996429443,42.43117626371358,34,8,74,469,1097,915,103,64
-2,4,0,-2.0,4.0,0.6598305702209473,38.710678118654755,34,10,70,469,1097,915,103,64
-1,4,0,-1.0,4.0,0.6677765846252441,34.91038783328041,34,11,66,469,1097,915,103,64
-3,5,0,-3.0,5.0,0.6758174896240234,30.5859409132754,34,14,61,469,1097,915,103,64
-1,4,0,-1.0,4.0,0.6838085651397705,26.9406481131655,34,15,57,469,1097,915,103,64
-2,3,0,-2.0,3.0,0.6918144226074219,24.612719418872643,34,17,54,469,1097,915,103,64
-2,3,0,-2.0,3.0,0.6998224258422852,22.42425929675111,34,19,51,469,1097,915,103,64
0,3,0,-0.0,3.0,0.7078895568847656,19.62363799656123,34,19,48,469,1097,915,103,64
-1,3,0,-1.0,3.0,0.7158124446868896,17.244289008980523,34,20,45,469,1097,915,103,64
-1,2,0,-1.0,2.0,0.7236883640289307,15.853944456021594,34,21,43,469,1097,915,103,64
-1,1,0,-1.0,1.0,0.7317144870758057,15.413078364518789,34,22,42,469,1097,915,103,64
0,2,0,-0.0,2.0,0.7397565841674805,13.650848842053307,34,22,40,469,1097,915,103,64
0,0,1,-0.0,-0.0,0.7437074184417725,13.650848842053307,34,22,40,469,1097,915,103,64
-1,1,1,-1.0,1.0,0.7477054595947266,13.276925690687087,34,23,39,469,1097,915,103,64
0,1,1,-0.0,1.0,0.7557394504547119,12.418464629025621,34,23,38,469,1097,915,103,64
0,0,0,-0.0,-0.0,0.8156945705413818,12.418464629025621,34,23,38,469,1097,915,103,64
0,-1,0,-0.0,-1.0,0.8997554779052734,13.276925690687087,34,23,39,469,1097,915,103,64
3,-1,0,3.0,-1.0,0.9077684879302979,12.721359549995796,34,20,40,469,1097,915,103,64
1,-1,0,1.0,-1.0,0.9157145023345947,13.188494110780013,34,19,41,469,1097,915,103,64
1,-1,0,1.0,-1.0,0.9237315654754639,13.694638635183452,34,18,42,469,1097,915,103,64
1,0,0,1.0,-0.0,0.9876935482025146,13.310043036836767,34,17,42,469,1097,915,103,64
1,1,0,1.0,1.0,1.011732578277588,12.011362169330773,34,16,41,469,1097,915,103,64
0,0,1,-0.0,-0.0,1.012796401977539,12.011362169330773,34,16,41,469,1097,915,103,64
0,2,1,-0.0,2.0,1.019716501235962,10.154477816715982,34,16,39,469,1097,915,103,64
1,2,1,1.0,2.0,1.0277435779571533,7.924929555354261,34,15,37,469,1097,915,103,64
1,2,1,1.0,2.0,1.0359225273132324,5.696153649941529,34,14,35,469,1097,915,103,64
0,1,1,-0.0,1.0,1.0438454151153564,4.76955262170047,34,14,34,469,1097,915,103,64
1,2,1,1.0,2.0,1.051849365234375,2.5398320783410853,34,13,32,469,1097,915,103,64
0,1,1,-0.0,1.0,1.0598344802856445,1.6154726279432197,34,13,31,469,1097,915,103,64
1,1,1,1.0,1.0,1.0677883625030518,0.31098884280702066,34,12,30,469,1097,915,103,64
0,1,1,-0.0,1.0,1.0757343769073486,-0.6152903470495694,34,12,29,469,1097,915,103,64
0,0,0,-0.0,-0.0,1.0827555656433105,-0.6152903470495694,34,12,29,469,1097,915,103,64
0,1,0,-0.0,1.0,1.0837523937225342,-1.5369075765443654,34,12,28,469,1097,915,103,64
1,1,0,1.0,1.0,1.0917654037475586,-2.845240525773498,34,11,27,469,1097,915,103,64
1,2,0,1.0,2.0,1.099851369857788,-5.07417596432748,34,10,25,469,1097,915,103,64
0,1,0,-0.0,1.0,1.1078484058380127,-6.0,34,10,24,469,1097,915,103,64
1,1,0,1.0,1.0,1.115788459777832,-7.301821929543063,34,9,23,469,1097,915,103,64
0,1,0,-0.0,1.0,1.123760461807251,-8.230271351990574,34,9,22,469,1097,915,103,64
0,1,0,-0.0,1.0,1.131845474243164,-9.152680682408274,34,9,21,469,1097,915,103,64
1,1,0,1.0,1.0,1.1397595405578613,-10.459340771461985,34,8,20,469,1097,915,103,64
0,1,0,-0.0,1.0,1.15596342086792,-11.384471871911696,34,8,19,469,1097,915,103,64
0,0,1,-0.0,-0.0,1.1832923889160156,-11.384471871911696,34,8,19,469,1097,915,103,64
1,1,1,1.0,1.0,0.010996580123901367,1502.2606334656382,35,1182,-964,1644,115,461,1078,46
0,0,0,-0.0,-0.0,0.09797453880310059,1502.2606334656382,35,1182,-964,1644,115,461,1078,46
0,1,0,-0.0,1.0,0.18702960014343262,1502.8928533812589,35,1182,-965,1644,115,461,1078,46
1,1,0,1.0,1.0,0.19527554512023926,1502.751290348463,35,1181,-966,1644,115,461,1078,46
0,1,0,-0.0,1.0,0.2032015323638916,1503.3846173229078,35,1181,-967,1644,115,461,1078,46
1,0,0,1.0,-0.0,0.21123147010803223,1502.6110251305868,35,1180,-967,1644,115,461,1078,46
0,1,0,-0.0,1.0,0.21904754638671875,1503.2450655120888,35,1180,-968,1644,115,461,1078,46
1,0,0,1.0,-0.0,0.22701454162597656,1502.4720580856274,35,1179,-968,1644,115,461,1078,46
0,1,0,-0.0,1.0,0.23502349853515625,1503.106811465043,35,1179,-969,1644,115,461,1078,46
1,0,0,1.0,-0.0,0.25098466873168945,1502.3343895683988,35,1178,-969,1644,115,461,1078,46
1,0,0,1.0,-0.0,0.26706457138061523,1501.5622322489824,35,1177,-969,1644,115,461,1078,46
5,-3,0,5.0,-3.0,0.2749476432800293,1495.7955754478612,35,1172,-966,1644,115,461,1078,46
10,-5,0,10.0,-5.0,0.2830164432525635,1484.9008588100214,35,1162,-961,1644,115,461,1078,46
14,-7,0,14.0,-7.0,0.29107666015625,1469.6553520488244,35,1148,-954,1644,115,461,1078,46
21,-9,0,21.0,-9.0,0.29898548126220703,1447.7664668464536,35,1127,-945,1644,115,461,1078,46
23,-9,0,23.0,-9.0,0.3080594539642334,1424.3810831982018,35,1104,-936,1644,115,461,1078,46
30,-12,0,30.0,-12.0,0.31510066986083984,1393.775211527926,35,1074,-924,1644,115,461,1078,46
33,-14,0,33.0,-14.0,0.32297348976135254,1359.6716891583483,35,1041,-910,1644,115,461,1078,46
38,-18,0,38.0,-18.0,0.3309755325317383,1319.2641319799916,35,1003,-892,1644,115,461,1078,46
43,-24,0,43.0,-24.0,0.33905458450317383,1271.227182530177,35,960,-868,1644,115,461,1078,46
47,-31,0,47.0,-31.0,0.34695959091186523,1215.6032455956185,35,913,-837,1644,115,461,1078,46
49,-34,0,49.0,-34.0,0.3551504611968994,1156.5359256928125,35,864,-803,1644,115,461,1078,46
52,-33,0,52.0,-33.0,0.36300158500671387,1096.0370860699836,35,812,-770,1644,115,461,1078,46
50,-36,0,50.0,-36.0,0.37102365493774414,1035.0170130957251,35,762,-734,1644,115,461,1078,46
50,-40,0,50.0,-40.0,0.3792095184326172,971.2736041955453,35,712,-694,1644,115,461,1078,46
47,-45,0,47.0,-45.0,0.3869495391845703,906.2071889519581,35,665,-649,1644,115,461,1078,46
42,-45,0,42.0,-45.0,0.39526963233947754,844.7240344717899,35,623,-604,1644,115,461,1078,46
38,-43,0,38.0,-43.0,0.40305566787719727,787.5220539874285,35,585,-561,1644,115,461,1078,46
34,-40,0,34.0,-40.0,0.41094064712524414,735.31523787934,35,551,-521,1644,115,461,1078,46
27,-35,0,27.0,-35.0,0.41893553733825684,691.6831465761593,35,524,-486,1644,115,461,1078,46
24,-30,0,24.0,-30.0,0.42707252502441406,653.7096866456102,35,500,-456,1644,115,461,1078,46
20,-24,0,20.0,-24.0,0.4349355697631836,622.7739542595381,35,480,-432,1644,115,461,1078,46
18,-19,0,18.0,-19.0,0.4430735111236572,596.6878246343073,35,462,-413,1644,115,461,1078,46
14,-15,0,14.0,-15.0,0.45111656188964844,576.256205641627,35,448,-398,1644,115,461,1078,46
10,-12,0,10.0,-12.0,0.45913147926330566,560.8150392033422,35,438,-386,1644,115,461,1078,46
9,-9,0,9.0,-9.0,0.46719861030578613,548.1129485487087,35,429,-377,1644,115,461,1078,46
7,-9,0,7.0,-9.0,0.4749624729156494,536.9178511174653,35,422,-368,1644,115,461,1078,46
6,-7,0,6.0,-7.0,0.4829554557800293,527.7966957054118,35,416,-361,1644,115,461,1078,46
7,-7,0,7.0,-7.0,0.49094462394714355,517.922360417833,35,409,-354,1644,115,461,1078,46
8,-8,0,8.0,-8.0,0.49894046783447266,506.6385559983337,35,401,-346,1644,115,461,1078,46
8,-9,0,8.0,-9.0,0.5069324970245361,494.7045489465976,35,393,-337,1644,115,461,1078,46
8,-7,0,8.0,-7.0,0.5150325298309326,484.0749451511088,35,385,-330,1644,115,461,1078,46
8,-7,0,8.0,-7.0,0.5232155323028564,473.445364566938,35,377,-323,1644,115,461,1078,46
8,-7,0,8.0,-7.0,0.5311696529388428,462.8158087176662,35,369,-316,1644,115,461,1078,46
9,-6,0,9.0,-6.0,0.5391795635223389,452.0789408087881,35,360,-310,1644,115,461,1078,46
9,-4,0,9.0,-4.0,0.5470454692840576,442.65759952995506,35,351,-306,1644,115,461,1078,46
7,-4,0,7.0,-4.0,0.5549626350402832,434.75539319597317,35,344,-302,1644,115,461,1078,46
7,-3,0,7.0,-3.0,0.5631124973297119,427.52191955553064,35,337,-299,1644,115,461,1078,46
6,-4,0,6.0,-4.0,0.5712554454803467,420.3801980242239,35,331,-295,1644,115,461,1078,46
5,-3,0,5.0,-3.0,0.5791716575622559,414.65283044897586,35,326,-292,1644,115,461,1078,46
6,-3,0,6.0,-3.0,0.5869615077972412,408.1855748978623,35,320,-289,1644,115,461,1078,46
8,-6,0,8.0,-6.0,0.5950026512145996,398.2279667828336,35,312,-283,1644,115,461,1078,46
9,-6,0,9.0,-6.0,0.6030175685882568,387.5337988521773,35,303,-277,1644,115,461,1078,46
9,-7,0,9.0,-7.0,0.6109664440155029,376.1691370835175,35,294,-270,1644,115,461,1078,46
9,-7,0,9.0,-7.0,0.6189415454864502,364.806652856807,35,285,-263,1644,115,461,1078,46
10,-8,0,10.0,-8.0,0.6270275115966797,352.0333318519835,35,275,-255,1644,115,461,1078,46
9,-7,0,9.0,-7.0,0.635244607925415,340.6756796927724,35,266,-248,1644,115,461,1078,46
11,-9,0,11.0,-9.0,0.6431336402893066,326.4939198326632,35,255,-239,1644,115,461,1078,46
12,-9,0,12.0,-9.0,0.6510086059570312,311.5878061137315,35,243,-230,1644,115,461,1078,46
11,-7,0,11.0,-7.0,0.6590454578399658,298.7965195585558,35,232,-223,1644,115,461,1078,46
9,-7,0,9.0,-7.0,0.6670286655426025,287.4593371119638,35,223,-216,1644,115,461,1078,46
8,-7,0,8.0,-7.0,0.6750504970550537,276.84329240454923,35,215,-209,1644,115,461,1078,46
9,-6,0,9.0,-6.0,0.6829726696014404,266.21445330411825,35,206,-203,1644,115,461,1078,46
9,-7,0,9.0,-7.0,0.690976619720459,254.89386463180506,35,197,-196,1644,115,461,1078,46
8,-6,0,8.0,-6.0,0.6993346214294434,244.9944029266283,35,189,-190,1644,115,461,1078,46
8,-8,0,8.0,-8.0,0.7070364952087402,233.6807355451515,35,181,-182,1644,115,461,1078,46
9,-7,0,9.0,-7.0,0.7152044773101807,222.3752228730521,35,172,-175,1644,115,461,1078,46
7,-8,0,7.0,-8.0,0.7230165004730225,211.76371099469355,35,165,-167,1644,115,461,1078,46
7,-7,0,7.0,-7.0,0.7312936782836914,201.86440358580546,35,158,-160,1644,115,461,1078,46
7,-6,0,7.0,-6.0,0.7389664649963379,192.67800073257357,35,151,-154,1644,115,461,1078,46
6,-8,0,6.0,-8.0,0.7470705509185791,182.7692882818036,35,145,-146,1644,115,461,1078,46
6,-7,0,6.0,-7.0,0.7549655437469482,173.5756851698602,35,139,-139,1644,115,461,1078,46
6,-7,0,6.0,-7.0,0.7629725933074951,164.3846311734236,35,133,-132,1644,115,461,1078,46
5,-8,0,5.0,-8.0,0.7710206508636475,155.2133552795637,35,128,-124,1644,115,461,1078,46
7,-8,0,7.0,-8.0,0.7797555923461914,144.621597653763,35,121,-116,1644,115,461,1078,46
7,-7,0,7.0,-7.0,0.7870705127716064,134.7244432546839,35,114,-109,1644,115,461,1078,46
7,-8,0,7.0,-8.0,0.7950656414031982,124.13938969562162,35,107,-101,1644,115,461,1078,46
8,-7,0,8.0,-7.0,0.8029406070709229,113.517398158623,35,99,-94,1644,115,461,1078,46
7,-7,0,7.0,-7.0,0.8110175132751465,103.62148316932637,35,92,-87,1644,115,461,1078,46
7,-8,0,7.0,-8.0,0.8190186023712158,93.04309544302927,35,85,-79,1644,115,461,1078,46
8,-7,0,8.0,-7.0,0.8270175457000732,82.41821474489122,35,77,-72,1644,115,461,1078,46
8,-7,0,8.0,-7.0,0.8349335193634033,71.79451460923254,35,69,-65,1644,115,461,1078,46
7,-6,0,7.0,-6.0,0.8430144786834717,62.58621384311844,35,62,-59,1644,115,461,1078,46
7,-5,0,7.0,-5.0,0.8512105941772461,54.077882690172544,35,55,-54,1644,115,461,1078,46
6,-5,0,6.0,-5.0,0.8595786094665527,46.29646455628166,35,49,-49,1644,115,461,1078,46
6,-4,0,6.0,-4.0,0.8670775890350342,39.24146527838174,35,43,-45,1644,115,461,1078,46
6,-4,0,6.0,-4.0,0.8750276565551758,32.226805085936306,35,37,-41,1644,115,461,1078,46
6,-4,0,6.0,-4.0,0.8830525875091553,25.270073544588683,35,31,-37,1644,115,461,1078,46
5,-3,0,5.0,-3.0,0.8909115791320801,19.80186911806539,35,26,-34,1644,115,461,1078,46
4,-3,0,4.0,-3.0,0.8990216255187988,15.013155617496423,35,22,-31,1644,115,461,1078,46
4,-2,0,4.0,-2.0,0.9070334434509277,11.132096331752024,35,18,-29,1644,115,461,1078,46
2,-1,0,2.0,-1.0,0.9149465560913086,9.249030993194197,35,16,-28,1644,115,461,1078,46
2,-2,0,2.0,-2.0,0.9229495525360107,6.529646120466801,35,14,-26,1644,115,461,1078,46
1,-1,0,1.0,-1.0,0.9310746192932129,5.178005607210743,35,13,-25,1644,115,461,1078,46
2,-2,0,2.0,-2.0,0.9391825199127197,2.4950975679639242,35,11,-23,1644,115,461,1078,46
1,-1,0,1.0,-1.0,0.9472146034240723,1.1660919471891447,35,10,-22,1644,115,461,1078,46
1,-1,0,1.0,-1.0,0.9550635814666748,-0.15268068240827404,35,9,-21,1644,115,461,1078,46
2,-2,0,2.0,-2.0,0.9630095958709717,-2.751543268683413,35,7,-19,1644,115,461,1078,46
1,-1,0,1.0,-1.0,0.9710996150970459,-4.026334038989724,35,6,-18,1644,115,461,1078,46
2,-2,0,2.0,-2.0,0.9790575504302979,-6.507577497529358,35,4,-16,1644,115,461,1078,46
1,-1,0,1.0,-1.0,0.9869594573974609,-7.702941459221645,35,3,-15,1644,115,461,1078,46
2,-2,0,2.0,-2.0,0.9950885772705078,-9.961595189594702,35,1,-13,1644,115,461,1078,46
2,-2,0,2.0,-2.0,1.0030765533447266,-11.954638982812739,35,-1,-11,1644,115,461,1078,46
2,-2,0,2.0,-2.0,1.0110275745391846,-13.513167019494862,35,-3,-9,1644,115,461,1078,46
2,-1,0,2.0,-1.0,1.019047498703003,-13.566018867943397,35,-5,-8,1644,115,461,1078,46
1,-2,0,1.0,-2.0,1.0269834995269775,-14.51471862576143,35,-6,-6,1644,115,461,1078,46
2,-1,0,2.0,-1.0,1.0349805355072021,-13.566018867943397,35,-8,-5,1644,115,461,1078,46
1,-1,0,1.0,-1.0,1.0429365634918213,-13.151142198203896,35,-9,-4,1644,115,461,1078,46
0,0,1,-0.0,-0.0,1.0548806190490723,-13.151142198203896,35,-9,-4,1644,115,461,1078,46
0,0,0,-0.0,-0.0,0.085845947265625,675.4709897697018,36,157,658,1810,777,1653,119,2
-5,4,0,-5.0,4.0,0.1997058391571045,672.7655378542302,36,162,654,1810,777,1653,119,2
-8,10,0,-8.0,10.0,0.20759081840515137,665.060057352188,36,170,644,1810,777,1653,119,2
-11,14,0,-11.0,14.0,0.2156059741973877,654.4853163877891,36,181,630,1810,777,1653,119,2
-10,18,0,-10.0,18.0,0.22354698181152344,640.1123146532127,36,191,612,1810,777,1653,119,2
-9,26,0,-9.0,26.0,0.23152780532836914,618.18979319753,36,200,586,1810,777,1653,119,2
-8,30,0,-8.0,30.0,0.23970293998718262,592.6328831862332,36,208,556,1810,777,1653,119,2
-2,32,0,-2.0,32.0,0.2474839687347412,563.5139502262101,36,210,524,1810,777,1653,119,2
1,30,0,1.0,30.0,0.2556478977203369,535.392580112738,36,209,494,1810,777,1653,119,2
6,26,0,6.0,26.0,0.2635838985443115,509.13037549238334,36,203,468,1810,777,1653,119,2
11,22,0,11.0,22.0,0.27160191535949707,484.5718278483627,36,192,446,1810,777,1653,119,2
11,15,0,11.0,15.0,0.27968788146972656,466.463367548731,36,181,431,1810,777,1653,119,2
12,9,0,12.0,9.0,0.28774595260620117,453.5822257853908,36,169,422,1810,777,1653,119,2
12,6,0,12.0,6.0,0.2957608699798584,443.6403040661069,36,157,416,1810,777,1653,119,2
10,6,0,10.0,6.0,0.3036458492279053,434.5559665530941,36,147,410,1810,777,1653,119,2
7,4,0,7.0,4.0,0.31165194511413574,428.4601262049831,36,140,406,1810,777,1653,119,2
8,4,0,8.0,4.0,0.31957387924194336,422.1170050943356,36,132,402,1810,777,1653,119,2
7,4,0,7.0,4.0,0.3275587558746338,416.16783193338387,36,125,398,1810,777,1653,119,2
7,5,0,7.0,5.0,0.33553290367126465,409.33279176785277,36,118,393,1810,777,1653,119,2
6,5,0,6.0,5.0,0.3435969352722168,402.84155308734637,36,112,388,1810,777,1653,119,2
8,7,0,8.0,7.0,0.35167980194091797,393.93923583255184,36,104,381,1810,777,1653,119,2
7,8,0,7.0,8.0,0.3596217632293701,384.40627913929995,36,97,373,1810,777,1653,119,2
9,10,0,9.0,10.0,0.36760997772216797,372.51439061969216,36,88,363,1810,777,1653,119,2
7,9,0,7.0,9.0,0.37581396102905273,362.1487298614715,36,81,354,1810,777,1653,119,2
9,12,0,9.0,12.0,0.38364481925964355,348.4967811010568,36,72,342,1810,777,1653,119,2
9,13,0,9.0,13.0,0.3916358947753906,333.9776111921512,36,63,329,1810,777,1653,119,2
9,14,0,9.0,14.0,0.3995487689971924,318.59505628216465,36,54,315,1810,777,1653,119,2
10,14,0,10.0,14.0,0.40752482414245605,303.19894805866767,36,44,301,1810,777,1653,119,2
9,16,0,9.0,16.0,0.4157118797302246,286.14108030722457,36,35,285,1810,777,1653,119,2
11,17,0,11.0,17.0,0.4235098361968994,268.0724809414742,36,24,268,1810,777,1653,119,2
10,16,0,10.0,16.0,0.4316718578338623,251.38858928247924,36,14,252,1810,777,1653,119,2
9,16,0,9.0,16.0,0.43981194496154785,235.05296015936761,36,5,236,1810,777,1653,119,2
9,15,0,9.0,15.0,0.44774293899536133,220.03619613086,36,-4,221,1810,777,1653,119,2
9,15,0,9.0,15.0,0.4556748867034912,205.4097865896867,36,-13,206,1810,777,1653,119,2
7,16,0,7.0,16.0,0.4636497497558594,190.049731745428,36,-20,190,1810,777,1653,119,2
6,15,0,6.0,15.0,0.47230076789855957,175.92088627406318,36,-26,175,1810,777,1653,119,2
4,12,0,4.0,12.0,0.47947096824645996,164.73774464496614,36,-30,163,1810,777,1653,119,2
3,12,0,3.0,12.0,0.48752880096435547,153.5639026422405,36,-33,151,1810,777,1653,119,2
2,11,0,2.0,11.0,0.495574951171875,143.30869689661813,36,-35,140,1810,777,1653,119,2
2,12,0,2.0,12.0,0.5035707950592041,132.24038426843418,36,-37,128,1810,777,1653,119,2
2,11,0,2.0,11.0,0.5115718841552734,122.3288287465668,36,-39,117,1810,777,1653,119,2
2,11,0,2.0,11.0,0.5196647644042969,112.65298060323803,36,-41,106,1810,777,1653,119,2
2,10,0,2.0,10.0,0.5275259017944336,104.19030373565806,36,-43,96,1810,777,1653,119,2
2,9,0,2.0,9.0,0.5356478691101074,96.94896630388705,36,-45,87,1810,777,1653,119,2
1,6,0,1.0,6.0,0.5436279773712158,92.15041599477696,36,-46,81,1810,777,1653,119,2
1,7,0,1.0,7.0,0.5515749454498291,86.66413177577246,36,-47,74,1810,777,1653,119,2
1,5,0,1.0,5.0,0.5595228672027588,83.0535543567314,36,-48,69,1810,777,1653,119,2
1,5,0,1.0,5.0,0.5675969123840332,79.60397012554654,36,-49,64,1810,777,1653,119,2
0,5,0,-0.0,5.0,0.5755839347839355,75.69419795525604,36,-49,59,1810,777,1653,119,2
0,3,0,-0.0,3.0,0.5835719108581543,73.41102068914255,36,-49,56,1810,777,1653,119,2
-1,4,0,-1.0,4.0,0.5915279388427734,69.76722405181653,36,-48,52,1810,777,1653,119,2
-2,4,0,-2.0,4.0,0.5995438098907471,65.48308055437865,36,-46,48,1810,777,1653,119,2
-2,4,0,-2.0,4.0,0.6075258255004883,61.22539674441618,36,-44,44,1810,777,1653,119,2
-1,3,0,-1.0,3.0,0.6155447959899902,58.413803110051795,36,-43,41,1810,777,1653,119,2
-1,3,0,-1.0,3.0,0.6235818862915039,55.639209034025185,36,-42,38,1810,777,1653,119,2
-2,3,0,-2.0,3.0,0.6315219402313232,52.150729063673246,36,-40,35,1810,777,1653,119,2
-1,2,0,-1.0,2.0,0.639610767364502,50.088159097779204,36,-39,33,1810,777,1653,119,2
-1,3,0,-1.0,3.0,0.6475338935852051,47.41487374764082,36,-38,30,1810,777,1653,119,2
-2,2,0,-2.0,2.0,0.655519962310791,44.60701700396552,36,-36,28,1810,777,1653,119,2
-2,3,0,-2.0,3.0,0.6635527610778809,41.20189569201838,36,-34,25,1810,777,1653,119,2
-3,3,0,-3.0,3.0,0.6716299057006836,37.01315561749642,36,-31,22,1810,777,1653,119,2
-2,4,0,-2.0,4.0,0.6795549392700195,33.132096331752024,36,-29,18,1810,777,1653,119,2
-2,3,0,-2.0,3.0,0.6875748634338379,29.886890422961002,36,-27,15,1810,777,1653,119,2
-1,3,0,-1.0,3.0,0.6956708431243896,27.635642126552707,36,-26,12,1810,777,1653,119,2
-2,2,0,-2.0,2.0,0.7035589218139648,25.0,36,-24,10,1810,777,1653,119,2
-2,3,0,-2.0,3.0,0.711493968963623,22.08679276123039,36,-22,7,1810,777,1653,119,2
-2,2,0,-2.0,2.0,0.7196118831634521,19.615528128088304,36,-20,5,1810,777,1653,119,2
-2,2,0,-2.0,2.0,0.7275888919830322,17.24828759089466,36,-18,3,1810,777,1653,119,2
-1,2,0,-1.0,2.0,0.735508918762207,16.029386365926403,36,-17,1,1810,777,1653,119,2
-2,3,0,-2.0,3.0,0.7435557842254639,14.132745950421556,36,-15,-2,1810,777,1653,119,2
-2,2,0,-2.0,2.0,0.7515509128570557,12.601470508735444,36,-13,-4,1810,777,1653,119,2
-2,3,0,-2.0,3.0,0.7595019340515137,12.038404810405298,36,-11,-7,1810,777,1653,119,2
-1,1,0,-1.0,1.0,0.7676358222961426,11.806248474865697,36,-10,-8,1810,777,1653,119,2
-1,1,0,-1.0,1.0,0.7755677700042725,11.727922061357855,36,-9,-9,1810,777,1653,119,2
-1,1,0,-1.0,1.0,0.7836449146270752,11.806248474865697,36,-8,-10,1810,777,1653,119,2
-1,0,0,-1.0,-0.0,0.8475189208984375,11.206555615733702,36,-7,-10,1810,777,1653,119,2
-1,0,0,-1.0,-0.0,0.8555247783660889,10.661903789690601,36,-6,-10,1810,777,1653,119,2
-1,0,0,-1.0,-0.0,0.8635199069976807,10.180339887498949,36,-5,-10,1810,777,1653,119,2
-1,0,0,-1.0,-0.0,0.8794538974761963,9.770329614269007,36,-4,-10,1810,777,1653,119,2
-1,0,0,-1.0,-0.0,0.9435579776763916,9.44030650891055,36,-3,-10,1810,777,1653,119,2
0,-1,0,-0.0,-1.0,0.9835667610168457,8.486832980505138,36,-3,-9,1810,777,1653,119,2
0,-1,0,-0.0,-1.0,0.991553783416748,7.54400374531753,36,-3,-8,1810,777,1653,119,2
0,-1,0,-0.0,-1.0,1.0075738430023193,6.615773105863909,36,-3,-7,1810,777,1653,119,2
0,-1,0,-0.0,-1.0,1.015622854232788,5.708203932499369,36,-3,-6,1810,777,1653,119,2
-1,0,0,-1.0,-0.0,1.0316047668457031,5.324555320336759,36,-2,-6,1810,777,1653,119,2
-1,0,0,-1.0,-0.0,1.0395088195800781,5.082762530298219,36,-1,-6,1810,777,1653,119,2
0,-1,0,-0.0,-1.0,1.0476367473602295,4.0990195135927845,36,-1,-5,1810,777,1653,119,2
0,0,1,-0.0,-0.0,1.085507869720459,4.0990195135927845,36,-1,-5,1810,777,1653,119,2
-1,0,1,-1.0,-0.0,1.1436598300933838,4.0,36,0,-5,1810,777,1653,119,2
0,0,0,-0.0,-0.0,1.148467779159546,4.0,36,0,-5,1810,777,1653,119,2
0,-1,0,-0.0,-1.0,1.151582956314087,3.0,36,0,-4,1810,777,1653,119,2
-1,0,0,-1.0,-0.0,1.159700870513916,3.1231056256176606,36,1,-4,1810,777,1653,119,2
0,-2,0,-0.0,-2.0,1.1677217483520508,1.2360679774997898,36,1,-2,1810,777,1653,119,2
0,-1,0,-0.0,-1.0,1.1836347579956055,0.41421356237309515,36,1,-1,1810,777,1653,119,2
0,-1,0,-0.0,-1.0,1.1997239589691162,0.0,36,1,0,1810,777,1653,119,2
0,0,1,-0.0,-0.0,1.2664508819580078,0.0,36,1,0,1810,777,1653,119,2
0,0,0,-0.0,-0.0,0.06136584281921387,813.2754289922217,37,-820,-201,989,576,1809,777,63
0,0,1,-0.0,-0.0,0.16521573066711426,813.2754289922217,37,-820,-201,989,576,1809,777,63
0,0,0,-0.0,-0.0,0.21527361869812012,813.2754289922217,37,-820,-201,989,576,1809,777,63
-5,0,0,-5.0,-0.0,0.2634456157684326,808.4200378832995,37,-815,-201,989,576,1809,777,63
-6,-2,0,-6.0,-2.0,0.27136874198913574,802.1158382842088,37,-809,-199,989,576,1809,777,63
-7,-2,0,-7.0,-2.0,0.27932262420654297,794.8407836865409,37,-802,-197,989,576,1809,777,63
-8,-3,0,-8.0,-3.0,0.28725767135620117,786.3567152718573,37,-794,-194,989,576,1809,777,63
-11,-4,0,-11.0,-4.0,0.2953007221221924,774.7226569980517,37,-783,-190,989,576,1809,777,63
-15,-4,0,-15.0,-4.0,0.3031926155090332,759.2025056907881,37,-768,-186,989,576,1809,777,63
-19,-4,0,-19.0,-4.0,0.31134676933288574,739.7950440940834,37,-749,-182,989,576,1809,777,63
-20,-6,0,-20.0,-6.0,0.3191506862640381,718.9446646253309,37,-729,-176,989,576,1809,777,63
-22,-5,0,-22.0,-5.0,0.3272256851196289,696.3857298572746,37,-707,-171,989,576,1809,777,63
-26,-6,0,-26.0,-6.0,0.3354208469390869,669.7039317714722,37,-681,-165,989,576,1809,777,63
-32,-8,0,-32.0,-8.0,0.34314966201782227,636.720001198107,37,-649,-157,989,576,1809,777,63
-36,-10,0,-36.0,-10.0,0.3511996269226074,599.3792509275667,37,-613,-147,989,576,1809,777,63
-40,-11,0,-40.0,-11.0,0.35933375358581543,557.9185003037347,37,-573,-136,989,576,1809,777,63
-43,-11,0,-43.0,-11.0,0.3672006130218506,513.5410911951457,37,-530,-125,989,576,1809,777,63
-46,-13,0,-46.0,-13.0,0.3751506805419922,465.78969393496885,37,-484,-112,989,576,1809,777,63
-45,-13,0,-45.0,-13.0,0.3834187984466553,419.0244437805573,37,-439,-99,989,576,1809,777,63
-41,-12,0,-41.0,-12.0,0.39139580726623535,376.3978399550003,37,-398,-87,989,576,1809,777,63
-33,-9,0,-33.0,-9.0,0.3993096351623535,342.2412088716893,37,-365,-78,989,576,1809,777,63
-30,-8,0,-30.0,-8.0,0.40725183486938477,311.23529917295207,37,-335,-70,989,576,1809,777,63
-25,-7,0,-25.0,-7.0,0.4151618480682373,285.33684578309874,37,-310,-63,989,576,1809,777,63
-22,-7,0,-22.0,-7.0,0.42314767837524414,262.393933134276,37,-288,-56,989,576,1809,777,63
-18,-6,0,-18.0,-6.0,0.431262731552124,243.5906043549196,37,-270,-50,989,576,1809,777,63
-15,-5,0,-15.0,-5.0,0.4391956329345703,227.940147524481,37,-255,-45,989,576,1809,777,63
-12,-4,0,-12.0,-4.0,0.4471766948699951,215.43457549621561,37,-243,-41,989,576,1809,777,63
-9,-2,0,-9.0,-2.0,0.4557967185974121,206.22773868163057,37,-234,-39,989,576,1809,777,63
-7,-2,0,-7.0,-2.0,0.4634368419647217,198.9956521328175,37,-227,-37,989,576,1809,777,63
-5,-1,0,-5.0,-1.0,0.47138381004333496,193.89997776789573,37,-222,-36,989,576,1809,777,63
-4,-1,0,-4.0,-1.0,0.4792778491973877,189.79175709251467,37,-218,-35,989,576,1809,777,63
-5,0,0,-5.0,-0.0,0.4871706962585449,184.8564337702261,37,-213,-35,989,576,1809,777,63
-5,-1,0,-5.0,-1.0,0.49517178535461426,179.76052761368766,37,-208,-34,989,576,1809,777,63
-6,-1,0,-6.0,-1.0,0.5031487941741943,173.67779557147864,37,-202,-33,989,576,1809,777,63
-7,0,0,-7.0,-0.0,0.5112907886505127,166.7725966861941,37,-195,-33,989,576,1809,777,63
-7,-1,0,-7.0,-1.0,0.519230842590332,159.70395905696347,37,-188,-32,989,576,1809,777,63
-8,0,0,-8.0,-0.0,0.5271406173706055,151.82231811242303,37,-180,-32,989,576,1809,777,63
-9,0,0,-9.0,-0.0,0.5352268218994141,142.9683879329805,37,-171,-32,989,576,1809,777,63
-8,-1,0,-8.0,-1.0,0.5432286262512207,134.92166826548,37,-163,-31,989,576,1809,777,63
-8,0,0,-8.0,-0.0,0.5511398315429688,127.06960492137634,37,-155,-31,989,576,1809,777,63
-8,0,0,-8.0,-0.0,0.5591716766357422,119.23315213360866,37,-147,-31,989,576,1809,777,63
-9,0,0,-9.0,-0.0,0.5672106742858887,110.43903280212291,37,-138,-31,989,576,1809,777,63
-7,0,0,-7.0,-0.0,0.5752596855163574,103.61797799699713,37,-131,-31,989,576,1809,777,63
-8,0,0,-8.0,-0.0,0.583223819732666,95.84636376341263,37,-123,-31,989,576,1809,777,63
-7,1,0,-7.0,1.0,0.5912327766418457,89.33287165193059,37,-116,-32,989,576,1809,777,63
-7,0,0,-7.0,-0.0,0.5992326736450195,82.6001760562016,37,-109,-32,989,576,1809,777,63
-7,1,0,-7.0,1.0,0.6073377132415771,76.20541031123382,37,-102,-33,989,576,1809,777,63
-6,0,0,-6.0,-0.0,0.6154036521911621,70.51354589413178,37,-96,-33,989,576,1809,777,63
-7,0,0,-7.0,-0.0,0.6236617565155029,63.92101980067429,37,-89,-33,989,576,1809,777,63
-6,0,0,-6.0,-0.0,0.63124680519104,58.31965069345043,37,-83,-33,989,576,1809,777,63
-6,0,0,-6.0,-0.0,0.6392216682434082,52.773504164502995,37,-77,-33,989,576,1809,777,63
-5,0,0,-5.0,-0.0,0.6472108364105225,48.202272694664515,37,-72,-33,989,576,1809,777,63
-6,0,0,-6.0,-0.0,0.6552016735076904,42.79024325749306,37,-66,-33,989,576,1809,777,63
-6,0,0,-6.0,-0.0,0.6632497310638428,37.47627326307996,37,-60,-33,989,576,1809,777,63
-6,-1,0,-6.0,-1.0,0.6719937324523926,31.76941930590086,37,-54,-32,989,576,1809,777,63
-6,0,0,-6.0,-0.0,0.6798968315124512,26.688820407423826,37,-48,-32,989,576,1809,777,63
-6,-1,0,-6.0,-1.0,0.6871747970581055,21.201532544552748,37,-42,-31,989,576,1809,777,63
-4,-2,0,-4.0,-2.0,0.6952447891235352,16.801673610868477,37,-38,-29,989,576,1809,777,63
-3,0,0,-3.0,-0.0,0.7032737731933594,14.453272709454048,37,-35,-29,989,576,1809,777,63
-3,0,0,-3.0,-0.0,0.7113087177276611,12.185645763378368,37,-32,-29,989,576,1809,777,63
-1,0,0,-1.0,-0.0,0.7192628383636475,11.449970553582247,37,-31,-29,989,576,1809,777,63
0,-1,0,-0.0,-1.0,0.7272336483001709,10.773197148410844,37,-31,-28,989,576,1809,777,63
0,0,1,-0.0,-0.0,0.7451567649841309,10.773197148410844,37,-31,-28,989,576,1809,777,63
0,0,0,-0.0,-0.0,0.09604072570800781,627.5152980371573,38,-509,-397,511,207,1020,604,36
-1,0,0,-1.0,-0.0,0.11898469924926758,626.7270740398607,38,-508,-397,511,207,1020,604,36
-1,1,0,-1.0,1.0,0.1270456314086914,626.5564366290977,38,-507,-398,511,207,1020,604,36
-2,4,0,-2.0,4.0,0.1351306438446045,627.4680472339433,38,-505,-402,511,207,1020,604,36
-3,2,0,-3.0,2.0,0.14316678047180176,626.3756668279769,38,-502,-404,511,207,1020,604,36
-3,3,0,-3.0,3.0,0.15109562873840332,625.9332263519254,38,-499,-407,511,207,1020,604,36
-4,1,0,-4.0,1.0,0.15899658203125,623.4740836542035,38,-495,-408,511,207,1020,604,36
-5,1,0,-5.0,1.0,0.16706156730651855,620.2640519408875,38,-490,-409,511,207,1020,604,36
-8,1,0,-8.0,1.0,0.17515063285827637,614.7906446843222,38,-482,-410,511,207,1020,604,36
-10,1,0,-10.0,1.0,0.1829535961151123,607.8634036273411,38,-472,-411,511,207,1020,604,36
-13,1,0,-13.0,1.0,0.19104266166687012,598.7860244849911,38,-459,-412,511,207,1020,604,36
-17,-1,0,-17.0,-1.0,0.19899678230285645,585.5602703955919,38,-442,-411,511,207,1020,604,36
-20,-2,0,-20.0,-2.0,0.2072467803955078,569.6776327205248,38,-422,-409,511,207,1020,604,36
-20,-5,0,-20.0,-5.0,0.2151927947998047,551.9298202410539,38,-402,-404,511,207,1020,604,36
-21,-6,0,-21.0,-6.0,0.22304463386535645,532.9673311549425,38,-381,-398,511,207,1020,604,36
-18,-7,0,-18.0,-7.0,0.23110461235046387,515.5260068637704,38,-363,-391,511,207,1020,604,36
-17,-8,0,-17.0,-8.0,0.23907756805419922,498.1443596514448,38,-346,-383,511,207,1020,604,36
-16,-10,0,-16.0,-10.0,0.24710965156555176,480.0250997690779,38,-330,-373,511,207,1020,604,36
-14,-12,0,-14.0,-12.0,0.2549717426300049,461.76765209838817,38,-316,-361,511,207,1020,604,36
-15,-15,0,-15.0,-15.0,0.2630796432495117,440.6033144232606,38,-301,-346,511,207,1020,604,36
-16,-15,0,-16.0,-15.0,0.2710127830505371,418.790567663726,38,-285,-331,511,207,1020,604,36
-16,-17,0,-16.0,-17.0,0.2790665626525879,395.4694668291723,38,-269,-314,511,207,1020,604,36
-17,-17,0,-17.0,-17.0,0.2871246337890625,371.50353015088325,38,-252,-297,511,207,1020,604,36
-18,-21,0,-18.0,-21.0,0.29509758949279785,343.84527079955046,38,-234,-276,511,207,1020,604,36
-19,-20,0,-19.0,-20.0,0.30310773849487305,316.3067453701765,38,-215,-256,511,207,1020,604,36
-17,-20,0,-17.0,-20.0,0.31110358238220215,290.05843601498725,38,-198,-236,511,207,1020,604,36
-16,-17,0,-16.0,-17.0,0.3189725875854492,266.7542800380707,38,-182,-219,511,207,1020,604,36
-16,-16,0,-16.0,-16.0,0.32698869705200195,244.23081436017395,38,-166,-203,511,207,1020,604,36
-17,-14,0,-17.0,-14.0,0.3351256847381592,222.66989840858787,38,-149,-189,511,207,1020,604,36
-17,-13,0,-17.0,-13.0,0.34300756454467773,202.0,38,-132,-176,511,207,1020,604,36
-17,-13,0,-17.0,-13.0,0.3511385917663574,181.48433522459854,38,-115,-163,511,207,1020,604,36
-16,-11,0,-16.0,-11.0,0.359027624130249,163.39735389470266,38,-99,-152,511,207,1020,604,36
-12,-9,0,-12.0,-9.0,0.36702466011047363,149.38578195294843,38,-87,-143,511,207,1020,604,36
-10,-9,0,-10.0,-9.0,0.37486767768859863,136.5477272560163,38,-77,-134,511,207,1020,604,36
-8,-8,0,-8.0,-8.0,0.3829636573791504,125.65583872575453,38,-69,-126,511,207,1020,604,36
-9,-8,0,-9.0,-8.0,0.3911275863647461,114.3782459469833,38,-60,-118,511,207,1020,604,36
-7,-6,0,-7.0,-6.0,0.39896464347839355,105.90722335683259,38,-53,-112,511,207,1020,604,36
-7,-7,0,-7.0,-7.0,0.4070136547088623,96.63420083029322,38,-46,-105,511,207,1020,604,36
-9,-7,0,-9.0,-7.0,0.41504478454589844,86.75208828467335,38,-37,-98,511,207,1020,604,36
-8,-8,0,-8.0,-8.0,0.42324161529541016,76.5568612000208,38,-29,-90,511,207,1020,604,36
-9,-7,0,-9.0,-7.0,0.4314756393432617,67.37564055396598,38,-20,-83,511,207,1020,604,36
-8,-7,0,-8.0,-7.0,0.4390425682067871,58.941536246685374,38,-12,-76,511,207,1020,604,36
-8,-6,0,-8.0,-6.0,0.4470555782318115,52.11419257183242,38,-4,-70,511,207,1020,604,36
-8,-7,0,-8.0,-7.0,0.4549877643585205,45.12685640834652,38,4,-63,511,207,1020,604,36
-5,-6,0,-5.0,-6.0,0.4629547595977783,39.706152185014034,38,9,-57,511,207,1020,604,36
-7,-6,0,-7.0,-6.0,0.47095561027526855,35.45091205957107,38,16,-51,511,207,1020,604,36
-4,-4,0,-4.0,-4.0,0.47908973693847656,33.07837115648854,38,20,-47,511,207,1020,604,36
-4,-3,0,-4.0,-3.0,0.4878675937652588,32.11985634456667,38,24,-44,511,207,1020,604,36
-4,-4,0,-4.0,-4.0,0.49509668350219727,30.82622246293481,38,28,-40,511,207,1020,604,36
-2,-2,0,-2.0,-2.0,0.503199577331543,30.41487374764082,38,30,-38,511,207,1020,604,36
0,-1,0,-0.0,-1.0,0.5111186504364014,29.634021455258214,38,30,-37,511,207,1020,604,36
-1,0,0,-1.0,-0.0,0.526958703994751,30.270073544588683,38,31,-37,511,207,1020,604,36
0,-1,0,-0.0,-1.0,0.542954683303833,29.507894080878813,38,31,-36,511,207,1020,604,36
0,-1,0,-0.0,-1.0,0.5591416358947754,28.75467891024384,38,31,-35,511,207,1020,604,36
0,-2,0,-0.0,-2.0,0.5670986175537109,27.276925690687087,38,31,-33,511,207,1020,604,36
1,-1,0,1.0,-1.0,0.5750346183776855,25.863424398922618,38,30,-32,511,207,1020,604,36
0,-1,0,-0.0,-1.0,0.5833835601806641,25.139309220245984,38,30,-31,511,207,1020,604,36
1,-1,0,1.0,-1.0,0.5909626483917236,23.725292090050132,38,29,-30,511,207,1020,604,36
1,-2,0,1.0,-2.0,0.5989665985107422,21.59797974644666,38,28,-28,511,207,1020,604,36
2,-2,0,2.0,-2.0,0.6068887710571289,18.76955262170047,38,26,-26,511,207,1020,604,36
3,-4,0,3.0,-4.0,0.6149387359619141,13.827660925679098,38,23,-22,511,207,1020,604,36
3,-3,0,3.0,-3.0,0.6228947639465332,9.586228448267445,38,20,-19,511,207,1020,604,36
4,-4,0,4.0,-4.0,0.6313507556915283,3.931712199461309,38,16,-15,511,207,1020,604,36
2,-3,0,2.0,-3.0,0.6392436027526855,0.43908891458577415,38,14,-12,511,207,1020,604,36
3,-3,0,3.0,-3.0,0.6471226215362549,-3.787329596448105,38,11,-9,511,207,1020,604,36
2,-2,0,2.0,-2.0,0.6550617218017578,-6.598245749008621,38,9,-7,511,207,1020,604,36
1,-2,0,1.0,-2.0,0.6630675792694092,-8.566018867943397,38,8,-5,511,207,1020,604,36
0,0,1,-0.0,-0.0,0.6851105690002441,-8.566018867943397,38,8,-5,511,207,1020,604,36
0,0,0,-0.0,-0.0,0.09785580635070801,1523.825708101284,39,1313,789,1816,1001,503,212,17
1,1,0,1.0,1.0,0.1520688533782959,1522.4535275531891,39,1312,788,1816,1001,503,212,17
2,3,0,2.0,3.0,0.1600017547607422,1519.195141427578,39,1310,785,1816,1001,503,212,17
2,5,0,2.0,5.0,0.16811370849609375,1514.9129981715962,39,1308,780,1816,1001,503,212,17
3,5,0,3.0,5.0,0.17604279518127441,1509.7779811289925,39,1305,775,1816,1001,503,212,17
2,6,0,2.0,6.0,0.18423175811767578,1505.0003304692302,39,1303,769,1816,1001,503,212,17
3,8,0,3.0,8.0,0.19346165657043457,1498.3601826920412,39,1300,761,1816,1001,503,212,17
5,10,0,5.0,10.0,0.19990777969360352,1489.005678011944,39,1295,751,1816,1001,503,212,17
9,16,0,9.0,16.0,0.20798683166503906,1473.2228056575418,39,1286,735,1816,1001,503,212,17
11,18,0,11.0,18.0,0.2160167694091797,1454.776127778957,39,1275,717,1816,1001,503,212,17
15,20,0,15.0,20.0,0.22393178939819336,1431.9336790283087,39,1260,697,1816,1001,503,212,17
17,21,0,17.0,21.0,0.23196172714233398,1406.9293268569988,39,1243,676,1816,1001,503,212,17
21,22,0,21.0,22.0,0.24009084701538086,1378.0014430006918,39,1222,654,1816,1001,503,212,17
26,20,0,26.0,20.0,0.24795174598693848,1345.6513583637407,39,1196,634,1816,1001,503,212,17
27,19,0,27.0,19.0,0.2560298442840576,1312.9034786841921,39,1169,615,1816,1001,503,212,17
30,19,0,30.0,19.0,0.2640566825866699,1277.5104044697578,39,1139,596,1816,1001,503,212,17
33,20,0,33.0,20.0,0.2723557949066162,1239.0012028863484,39,1106,576,1816,1001,503,212,17
34,20,0,34.0,20.0,0.2799186706542969,1199.6092083120268,39,1072,556,1816,1001,503,212,17
39,21,0,39.0,21.0,0.28801870346069336,1155.3202482549677,39,1033,535,1816,1001,503,212,17
43,21,0,43.0,21.0,0.2959456443786621,1107.4801656685788,39,990,514,1816,1001,503,212,17
44,23,0,44.0,23.0,0.30394482612609863,1057.8316002070871,39,946,491,1816,1001,503,212,17
48,24,0,48.0,24.0,0.31198883056640625,1004.1724161426254,39,898,467,1816,1001,503,212,17
45,23,0,45.0,23.0,0.3200197219848633,953.6366257583994,39,853,444,1816,1001,503,212,17
45,20,0,45.0,20.0,0.32812070846557617,904.4910958469677,39,808,424,1816,1001,503,212,17
43,19,0,43.0,19.0,0.3359527587890625,857.5922827752105,39,765,405,1816,1001,503,212,17
40,18,0,40.0,18.0,0.34395384788513184,813.8235820417908,39,725,387,1816,1001,503,212,17
39,19,0,39.0,19.0,0.35198068618774414,770.4728640100437,39,686,368,1816,1001,503,212,17
37,19,0,37.0,19.0,0.35994672775268555,728.8866941396079,39,649,349,1816,1001,503,212,17
35,18,0,35.0,18.0,0.3679337501525879,689.5363789796199,39,614,331,1816,1001,503,212,17
36,21,0,36.0,21.0,0.37613677978515625,647.8841361094198,39,578,310,1816,1001,503,212,17
35,21,0,35.0,21.0,0.3841266632080078,607.1178748825301,39,543,289,1816,1001,503,212,17
34,20,0,34.0,20.0,0.3919987678527832,567.7099964391795,39,509,269,1816,1001,503,212,17
33,18,0,33.0,18.0,0.39991283416748047,530.123591751932,39,476,251,1816,1001,503,212,17
33,17,0,33.0,17.0,0.40789365768432617,493.0039920000638,39,443,234,1816,1001,503,212,17
33,14,0,33.0,14.0,0.4160187244415283,457.29560496527364,39,410,220,1816,1001,503,212,17
33,13,0,33.0,13.0,0.42409181594848633,422.09068811124007,39,377,207,1816,1001,503,212,17
29,12,0,29.0,12.0,0.432053804397583,390.909764232464,39,348,195,1816,1001,503,212,17
27,10,0,27.0,10.0,0.44008469581604004,362.49426446302783,39,321,185,1816,1001,503,212,17
25,9,0,25.0,9.0,0.44805264472961426,336.37189200049414,39,296,176,1816,1001,503,212,17
22,9,0,22.0,9.0,0.4559907913208008,312.8815981012311,39,274,167,1816,1001,503,212,17
19,8,0,19.0,8.0,0.46390485763549805,292.5095672353877,39,255,159,1816,1001,503,212,17
16,7,0,16.0,7.0,0.4719388484954834,275.24018076537095,39,239,152,1816,1001,503,212,17
14,7,0,14.0,7.0,0.48009777069091797,259.67517628648346,39,225,145,1816,1001,503,212,17
11,6,0,11.0,6.0,0.4880826473236084,247.180328395431,39,214,139,1816,1001,503,212,17
9,6,0,9.0,6.0,0.4960768222808838,236.36448187083164,39,205,133,1816,1001,503,212,17
7,4,0,7.0,4.0,0.5039758682250977,228.31546711969574,39,198,129,1816,1001,503,212,17
5,3,0,5.0,3.0,0.5120558738708496,222.4886114323222,39,193,126,1816,1001,503,212,17
4,2,0,4.0,2.0,0.5200138092041016,218.04645540242387,39,189,124,1816,1001,503,212,17
2,2,0,2.0,2.0,0.5279836654663086,215.2778538055219,39,187,122,1816,1001,503,212,17
1,1,0,1.0,1.0,0.5440728664398193,213.89411889457548,39,186,121,1816,1001,503,212,17
1,1,0,1.0,1.0,0.5520317554473877,212.51077071199947,39,185,120,1816,1001,503,212,17
2,1,0,2.0,1.0,0.5601346492767334,210.28879952943075,39,183,119,1816,1001,503,212,17
1,2,0,1.0,2.0,0.5681107044219971,208.3631207022121,39,182,117,1816,1001,503,212,17
2,0,0,2.0,-0.0,0.5760197639465332,206.68348795377813,39,180,117,1816,1001,503,212,17
1,1,0,1.0,1.0,0.5838067531585693,205.30025785263365,39,179,116,1816,1001,503,212,17
1,1,0,1.0,1.0,0.5920207500457764,203.91743675309024,39,178,115,1816,1001,503,212,17
2,1,0,2.0,1.0,0.599989652633667,201.69501663129716,39,176,114,1816,1001,503,212,17
2,2,0,2.0,2.0,0.6079747676849365,198.92993983471797,39,174,112,1816,1001,503,212,17
2,1,0,2.0,1.0,0.6159586906433105,196.70710783946902,39,172,111,1816,1001,503,212,17
2,1,0,2.0,1.0,0.6241278648376465,194.48456731316588,39,170,110,1816,1001,503,212,17
2,1,0,2.0,1.0,0.6322078704833984,192.26232796010336,39,168,109,1816,1001,503,212,17
3,2,0,3.0,2.0,0.640082836151123,188.65706191235543,39,165,107,1816,1001,503,212,17
2,2,0,2.0,2.0,0.6479008197784424,185.89172236070317,39,163,105,1816,1001,503,212,17
2,3,0,2.0,3.0,0.6560966968536377,182.59118552545917,39,161,102,1816,1001,503,212,17
3,3,0,3.0,3.0,0.6639697551727295,178.45374761586316,39,158,99,1816,1001,503,212,17
4,4,0,4.0,4.0,0.6718988418579102,172.9447429465692,39,154,95,1816,1001,503,212,17
5,4,0,5.0,4.0,0.6800298690795898,166.59095051004218,39,149,91,1816,1001,503,212,17
7,4,0,7.0,4.0,0.6879496574401855,158.5322791533221,39,142,87,1816,1001,503,212,17
7,4,0,7.0,4.0,0.6961398124694824,150.47397262642215,39,135,83,1816,1001,503,212,17
6,3,0,6.0,3.0,0.7039906978607178,143.7926216915697,39,129,80,1816,1001,503,212,17
7,4,0,7.0,4.0,0.7119677066802979,135.7358688706476,39,122,76,1816,1001,503,212,17
7,4,0,7.0,4.0,0.7201566696166992,127.67977004697494,39,115,72,1816,1001,503,212,17
7,5,0,7.0,5.0,0.727907657623291,119.09445306542689,39,108,67,1816,1001,503,212,17
7,5,0,7.0,5.0,0.7359206676483154,110.51160280748886,39,101,62,1816,1001,503,212,17
8,5,0,8.0,5.0,0.7439558506011963,101.07795377618706,39,93,57,1816,1001,503,212,17
8,4,0,8.0,4.0,0.7519388198852539,92.16985574512923,39,85,53,1816,1001,503,212,17
9,5,0,9.0,5.0,0.7598297595977783,81.88882021697692,39,76,48,1816,1001,503,212,17
8,4,0,8.0,4.0,0.7679576873779297,72.99382692526635,39,68,44,1816,1001,503,212,17
7,4,0,7.0,4.0,0.7759478092193604,64.94518489934754,39,61,40,1816,1001,503,212,17
7,3,0,7.0,3.0,0.7839498519897461,57.45991139621256,39,54,37,1816,1001,503,212,17
7,3,0,7.0,3.0,0.7919998168945312,50.008620049092706,39,47,34,1816,1001,503,212,17
6,3,0,6.0,3.0,0.8000006675720215,43.40038910358559,39,41,31,1816,1001,503,212,17
6,2,0,6.0,2.0,0.8078856468200684,37.45327270945405,39,35,29,1816,1001,503,212,17
5,3,0,5.0,3.0,0.8160247802734375,31.698866482558415,39,30,26,1816,1001,503,212,17
5,2,0,5.0,2.0,0.8239188194274902,26.655446902326915,39,25,24,1816,1001,503,212,17
4,3,0,4.0,3.0,0.832000732421875,21.698484809834994,39,21,21,1816,1001,503,212,17
4,2,0,4.0,2.0,0.8400578498840332,17.495097567963924,39,17,19,1816,1001,503,212,17
4,2,0,4.0,2.0,0.8482317924499512,13.400934559032695,39,13,17,1816,1001,503,212,17
4,2,0,4.0,2.0,0.8559587001800537,9.4928556845359,39,9,15,1816,1001,503,212,17
3,2,0,3.0,2.0,0.8639707565307617,6.317821063276353,39,6,13,1816,1001,503,212,17
3,1,0,3.0,1.0,0.8719058036804199,4.369316876852981,39,3,12,1816,1001,503,212,17
3,1,0,3.0,1.0,0.8798646926879883,3.0,39,0,11,1816,1001,503,212,17
2,1,0,2.0,1.0,0.8880176544189453,2.198039027185569,39,-2,10,1816,1001,503,212,17
3,1,0,3.0,1.0,0.8959448337554932,2.295630140987001,39,-5,9,1816,1001,503,212,17
2,1,0,2.0,1.0,0.90382981300354,2.63014581273465,39,-7,8,1816,1001,503,212,17
1,1,0,1.0,1.0,0.9119977951049805,2.63014581273465,39,-8,7,1816,1001,503,212,17
1,1,0,1.0,1.0,0.9198637008666992,2.8166538263919687,39,-9,6,1816,1001,503,212,17
1,0,0,1.0,-0.0,0.927912712097168,3.6619037896906015,39,-10,6,1816,1001,503,212,17
1,0,0,1.0,-0.0,0.944063663482666,4.529964086141668,39,-11,6,1816,1001,503,212,17
0,1,0,-0.0,1.0,0.9599356651306152,4.083045973594572,39,-11,5,1816,1001,503,212,17
1,1,0,1.0,1.0,0.9679207801818848,4.649110640673518,39,-12,4,1816,1001,503,212,17
1,1,0,1.0,1.0,0.9759528636932373,5.341664064126334,39,-13,3,1816,1001,503,212,17
1,0,0,1.0,-0.0,0.9839897155761719,6.317821063276353,39,-14,3,1816,1001,503,212,17
0,1,0,-0.0,1.0,0.9919087886810303,6.142135623730951,39,-14,2,1816,1001,503,212,17
0,1,0,-0.0,1.0,0.9999217987060547,6.035668847618199,39,-14,1,1816,1001,503,212,17
1,0,0,1.0,-0.0,1.0080077648162842,7.033296378372908,39,-15,1,1816,1001,503,212,17
0,1,0,-0.0,1.0,1.0159146785736084,7.0,39,-15,0,1816,1001,503,212,17
0,0,1,-0.0,-0.0,1.0709826946258545,7.0,39,-15,0,1816,1001,503,212,17
0,0,0,-0.0,-0.0,0.07576394081115723,1191.8778533824361,40,-921,-806,910,195,1831,1001,64
-1,0,0,-1.0,-0.0,0.14974403381347656,1191.1255045987718,40,-920,-806,910,195,1831,1001,64
-1,0,0,-1.0,-0.0,0.15768909454345703,1190.373510838647,40,-919,-806,910,195,1831,1001,64
-1,0,0,-1.0,-0.0,0.1657719612121582,1189.6218727576877,40,-918,-806,910,195,1831,1001,64
-1,0,0,-1.0,-0.0,0.17364788055419922,1188.870591012823,40,-917,-806,910,195,1831,1001,64
-2,1,0,-2.0,1.0,0.1817018985748291,1188.0303274919029,40,-915,-807,910,195,1831,1001,64
-2,0,0,-2.0,-0.0,0.1897869110107422,1186.531082902689,40,-913,-807,910,195,1831,1001,64
-2,0,0,-2.0,-0.0,0.19775390625,1185.0332780988365,40,-911,-807,910,195,1831,1001,64
-4,0,0,-4.0,-0.0,0.20570707321166992,1182.042009157838,40,-907,-807,910,195,1831,1001,64
-6,0,0,-6.0,-0.0,0.21375489234924316,1177.5660378830087,40,-901,-807,910,195,1831,1001,64
-8,-2,0,-8.0,-2.0,0.22188997268676758,1170.2786698598625,40,-893,-805,910,195,1831,1001,64
-8,-5,0,-8.0,-5.0,0.2297980785369873,1160.9899412819875,40,-885,-800,910,195,1831,1001,64
-11,-6,0,-11.0,-6.0,0.23789095878601074,1148.8098915574851,40,-874,-794,910,195,1831,1001,64
-14,-9,0,-14.0,-9.0,0.24583005905151367,1132.398986602101,40,-860,-785,910,195,1831,1001,64
-19,-11,0,-19.0,-11.0,0.25379109382629395,1110.9597543220846,40,-841,-774,910,195,1831,1001,64
-25,-16,0,-25.0,-16.0,0.26175403594970703,1081.7414421668973,40,-816,-758,910,195,1831,1001,64
-31,-21,0,-31.0,-21.0,0.26976609230041504,1044.751596237498,40,-785,-737,910,195,1831,1001,64
-34,-25,0,-34.0,-25.0,0.27788591384887695,1002.8647254593229,40,-751,-712,910,195,1831,1001,64
-39,-30,0,-39.0,-30.0,0.2858710289001465,953.935089141268,40,-712,-682,910,195,1831,1001,64
-42,-31,0,-42.0,-31.0,0.2937469482421875,902.1846712508186,40,-670,-651,910,195,1831,1001,64
-43,-32,0,-43.0,-32.0,0.30176496505737305,849.0732092170321,40,-627,-619,910,195,1831,1001,64
-42,-30,0,-42.0,-30.0,0.3099830150604248,798.1481795438691,40,-585,-589,910,195,1831,1001,64
-41,-27,0,-41.0,-27.0,0.3177170753479004,750.1636657375489,40,-544,-562,910,195,1831,1001,64
-41,-27,0,-41.0,-27.0,0.32581496238708496,702.3255408876911,40,-503,-535,910,195,1831,1001,64
-41,-25,0,-41.0,-25.0,0.3337290287017822,656.1453334870477,40,-462,-510,910,195,1831,1001,64
-41,-26,0,-41.0,-26.0,0.3418118953704834,609.4803192616279,40,-421,-484,910,195,1831,1001,64
-39,-27,0,-39.0,-27.0,0.3497469425201416,563.628239760339,40,-382,-457,910,195,1831,1001,64
-39,-27,0,-39.0,-27.0,0.35802292823791504,518.0445436507847,40,-343,-430,910,195,1831,1001,64
-37,-27,0,-37.0,-27.0,0.36594200134277344,474.0088932024812,40,-306,-403,910,195,1831,1001,64
-36,-26,0,-36.0,-26.0,0.3739759922027588,431.7121952245811,40,-270,-377,910,195,1831,1001,64
-32,-25,0,-32.0,-25.0,0.3818049430847168,392.9094021082612,40,-238,-352,910,195,1831,1001,64
-28,-25,0,-28.0,-25.0,0.38978099822998047,356.6244974265004,40,-210,-327,910,195,1831,1001,64
-25,-24,0,-25.0,-24.0,0.39777708053588867,323.0126758300329,40,-185,-303,910,195,1831,1001,64
-20,-23,0,-20.0,-23.0,0.4057478904724121,293.0,40,-165,-280,910,195,1831,1001,64
-16,-20,0,-16.0,-20.0,0.4137709140777588,267.6681497923995,40,-149,-260,910,195,1831,1001,64
-12,-17,0,-12.0,-17.0,0.4217829704284668,246.95877831679718,40,-137,-243,910,195,1831,1001,64
-10,-15,0,-10.0,-15.0,0.4297330379486084,228.98467387952115,40,-127,-228,910,195,1831,1001,64
-6,-9,0,-6.0,-9.0,0.43774986267089844,218.2039168358481,40,-121,-219,910,195,1831,1001,64
-2,-8,0,-2.0,-8.0,0.44574594497680664,210.24367896810023,40,-119,-211,910,195,1831,1001,64
0,-5,0,-0.0,-5.0,0.45370006561279297,205.9012400135821,40,-119,-206,910,195,1831,1001,64
2,-5,0,2.0,-5.0,0.46177005767822266,202.61031520374377,40,-121,-201,910,195,1831,1001,64
4,-5,0,4.0,-5.0,0.4696788787841797,200.46720198772127,40,-125,-196,910,195,1831,1001,64
4,-4,0,4.0,-4.0,0.47794103622436523,199.3114783144148,40,-129,-192,910,195,1831,1001,64
4,-4,0,4.0,-4.0,0.4857909679412842,198.28894893155424,40,-133,-188,910,195,1831,1001,64
4,-3,0,4.0,-3.0,0.49373698234558105,198.20425712831639,40,-137,-185,910,195,1831,1001,64
4,-2,0,4.0,-2.0,0.5019199848175049,199.01947969814148,40,-141,-183,910,195,1831,1001,64
3,-2,0,3.0,-2.0,0.5098850727081299,199.29418496797535,40,-144,-181,910,195,1831,1001,64
3,-2,0,3.0,-2.0,0.5177590847015381,199.62469643800938,40,-147,-179,910,195,1831,1001,64
3,-2,0,3.0,-2.0,0.5257210731506348,200.01077561182368,40,-150,-177,910,195,1831,1001,64
1,-2,0,1.0,-2.0,0.5337390899658203,199.14064982170487,40,-151,-175,910,195,1831,1001,64
0,-2,0,-0.0,-2.0,0.5417618751525879,197.63013739489858,40,-151,-173,910,195,1831,1001,64
1,-3,0,1.0,-3.0,0.5497710704803467,196.04385543136215,40,-152,-170,910,195,1831,1001,64
0,-3,0,-0.0,-3.0,0.5578010082244873,193.8162970203878,40,-152,-167,910,195,1831,1001,64
0,-3,0,-0.0,-3.0,0.5658068656921387,191.60679774997897,40,-152,-164,910,195,1831,1001,64
0,-4,0,-0.0,-4.0,0.5737519264221191,188.68982758613956,40,-152,-160,910,195,1831,1001,64
0,-4,0,-0.0,-4.0,0.58172607421875,185.8072542409917,40,-152,-156,910,195,1831,1001,64
-2,-3,0,-2.0,-3.0,0.5897130966186523,182.26385602802915,40,-150,-153,910,195,1831,1001,64
-2,-5,0,-2.0,-5.0,0.5977199077606201,177.30360723121808,40,-148,-148,910,195,1831,1001,64
-2,-4,0,-2.0,-4.0,0.6056880950927734,173.06584308460538,40,-146,-144,910,195,1831,1001,64
-3,-6,0,-3.0,-6.0,0.6137490272521973,166.72845795205075,40,-143,-138,910,195,1831,1001,64
-4,-6,0,-4.0,-6.0,0.6218929290771484,159.68985366993215,40,-139,-132,910,195,1831,1001,64
-5,-5,0,-5.0,-5.0,0.6297810077667236,152.6212338816963,40,-134,-127,910,195,1831,1001,64
-5,-6,0,-5.0,-6.0,0.6377480030059814,144.86718180600946,40,-129,-121,910,195,1831,1001,64
-6,-7,0,-6.0,-7.0,0.6457700729370117,135.70509831248424,40,-123,-114,910,195,1831,1001,64
-8,-7,0,-8.0,-7.0,0.6538100242614746,125.07959765672945,40,-115,-107,910,195,1831,1001,64
-7,-7,0,-7.0,-7.0,0.6618649959564209,115.18695594379278,40,-108,-100,910,195,1831,1001,64
-8,-8,0,-8.0,-8.0,0.6697778701782227,103.88230201170424,40,-100,-92,910,195,1831,1001,64
-9,-9,0,-9.0,-9.0,0.6777350902557373,91.1665539016173,40,-91,-83,910,195,1831,1001,64
-9,-8,0,-9.0,-8.0,0.6857740879058838,79.12605455067681,40,-82,-75,910,195,1831,1001,64
-7,-7,0,-7.0,-7.0,0.6937899589538574,69.23734488813898,40,-75,-68,910,195,1831,1001,64
-5,-7,0,-5.0,-7.0,0.7017049789428711,60.84934033152847,40,-70,-61,910,195,1831,1001,64
-6,-8,0,-6.0,-8.0,0.7098009586334229,51.09632964216891,40,-64,-53,910,195,1831,1001,64
-5,-7,0,-5.0,-7.0,0.7179429531097412,42.81310045707235,40,-59,-46,910,195,1831,1001,64
-5,-8,0,-5.0,-8.0,0.7259268760681152,34.03029607687671,40,-54,-38,910,195,1831,1001,64
-4,-9,0,-4.0,-9.0,0.7339439392089844,25.8013840664737,40,-50,-29,910,195,1831,1001,64
-4,-9,0,-4.0,-9.0,0.741879940032959,18.159744815937813,40,-46,-20,910,195,1831,1001,64
-4,-8,0,-4.0,-8.0,0.7497940063476562,11.68065933568311,40,-42,-12,910,195,1831,1001,64
-3,-6,0,-3.0,-6.0,0.7577190399169922,7.45883931389772,40,-39,-6,910,195,1831,1001,64
-2,-5,0,-2.0,-5.0,0.7657349109649658,5.013511046643494,40,-37,-1,910,195,1831,1001,64
-2,-4,0,-2.0,-4.0,0.77388596534729,3.1283361405005934,40,-35,3,910,195,1831,1001,64
-1,-4,0,-1.0,-4.0,0.7819139957427979,2.7131099154195653,40,-34,7,910,195,1831,1001,64
-1,-1,0,-1.0,-1.0,0.789902925491333,1.9558536926992929,40,-33,8,910,195,1831,1001,64
0,-1,0,-0.0,-1.0,0.7978219985961914,2.205262752974143,40,-33,9,910,195,1831,1001,64
0,0,1,-0.0,-0.0,0.8128280639648438,2.205262752974143,40,-33,9,910,195,1831,1001,64
0,0,0,-0.0,-0.0,0.06316590309143066,691.6490602566026,41,611,349,1554,535,943,186,25
1,2,0,1.0,2.0,0.19233298301696777,689.7898545861146,41,610,347,1554,535,943,186,25
5,6,0,5.0,6.0,0.20019292831420898,682.4825411772423,41,605,341,1554,535,943,186,25
7,9,0,7.0,9.0,0.2082228660583496,671.9795318574965,41,598,332,1554,535,943,186,25
10,12,0,10.0,12.0,0.216141939163208,657.4355831594254,41,588,320,1554,535,943,186,25
13,15,0,13.0,15.0,0.22444701194763184,638.8840142452417,41,575,305,1554,535,943,186,25
16,17,0,16.0,17.0,0.23239588737487793,616.8282754456895,41,559,288,1554,535,943,186,25
21,18,0,21.0,18.0,0.240325927734375,589.9501640501479,41,538,270,1554,535,943,186,25
23,18,0,23.0,18.0,0.24849486351013184,561.3489338962793,41,515,252,1554,535,943,186,25
25,16,0,25.0,16.0,0.2563018798828125,531.8713083073973,41,490,236,1554,535,943,186,25
27,16,0,27.0,16.0,0.26433300971984863,500.60998819765496,41,463,220,1554,535,943,186,25
30,15,0,30.0,15.0,0.27237701416015625,467.07619435743203,41,433,205,1554,535,943,186,25
32,15,0,32.0,15.0,0.28037381172180176,431.73528144604416,41,401,190,1554,535,943,186,25
33,14,0,33.0,14.0,0.28842782974243164,395.9215610874228,41,368,176,1554,535,943,186,25
35,15,0,35.0,15.0,0.29630398750305176,357.87835838286077,41,333,161,1554,535,943,186,25
32,14,0,32.0,14.0,0.304271936416626,322.9776111921512,41,301,147,1554,535,943,186,25
31,14,0,31.0,14.0,0.3122529983520508,288.98006578509484,41,270,133,1554,535,943,186,25
26,13,0,26.0,13.0,0.3202199935913086,259.91175038971744,41,244,120,1554,535,943,186,25
24,12,0,24.0,12.0,0.32820987701416016,233.07957891264624,41,220,108,1554,535,943,186,25
18,10,0,18.0,10.0,0.33609795570373535,212.51725991557976,41,202,98,1554,535,943,186,25
17,10,0,17.0,10.0,0.3443138599395752,192.86336910243372,41,185,88,1554,535,943,186,25
16,9,0,16.0,9.0,0.3530588150024414,174.55294154743314,41,169,79,1554,535,943,186,25
15,10,0,15.0,10.0,0.3605039119720459,156.75129629131743,41,154,69,1554,535,943,186,25
13,9,0,13.0,9.0,0.3683040142059326,141.2351134694656,41,141,60,1554,535,943,186,25
12,9,0,12.0,9.0,0.3762779235839844,126.71553626036271,41,129,51,1554,535,943,186,25
14,7,0,14.0,7.0,0.38421082496643066,111.13001258832064,41,115,44,1554,535,943,186,25
13,7,0,13.0,7.0,0.3922548294067383,96.50345616615168,41,102,37,1554,535,943,186,25
14,7,0,14.0,7.0,0.4002718925476074,80.97311439335567,41,88,30,1554,535,943,186,25
15,7,0,15.0,7.0,0.40824389457702637,64.53757247260981,41,73,23,1554,535,943,186,25
15,6,0,15.0,6.0,0.4162759780883789,48.440052945046304,41,58,17,1554,535,943,186,25
13,4,0,13.0,4.0,0.42456698417663574,34.84015371452148,41,45,13,1554,535,943,186,25
11,4,0,11.0,4.0,0.43233394622802734,23.17101079013795,41,34,9,1554,535,943,186,25
8,3,0,8.0,3.0,0.44038987159729004,14.683328128252668,41,26,6,1554,535,943,186,25
4,3,0,4.0,3.0,0.44843196868896484,10.203603311174518,41,22,3,1554,535,943,186,25
2,2,0,2.0,2.0,0.45618295669555664,8.024984394500787,41,20,1,1554,535,943,186,25
1,1,0,1.0,1.0,0.4641909599304199,7.0,41,19,0,1554,535,943,186,25
0,1,0,-0.0,1.0,0.4723489284515381,7.026297590440446,41,19,-1,1554,535,943,186,25
0,1,0,-0.0,1.0,0.4802088737487793,7.104973174542799,41,19,-2,1554,535,943,186,25
1,1,0,1.0,1.0,0.4882988929748535,6.248287590894659,41,18,-3,1554,535,943,186,25
1,0,0,1.0,-0.0,0.5602560043334961,5.262676501632068,41,17,-3,1554,535,943,186,25
1,1,0,1.0,1.0,0.5691299438476562,4.492422502470642,41,16,-4,1554,535,943,186,25
1,0,0,1.0,-0.0,0.5923528671264648,3.524174696260024,41,15,-4,1554,535,943,186,25
1,0,0,1.0,-0.0,0.6002848148345947,2.560219778561036,41,14,-4,1554,535,943,186,25
2,0,0,2.0,-0.0,0.6083338260650635,0.6491106406735181,41,12,-4,1554,535,943,186,25
3,0,0,3.0,-0.0,0.6162688732147217,-2.151142198203896,41,9,-4,1554,535,943,186,25
3,0,0,3.0,-0.0,0.6244518756866455,-4.788897449072022,41,6,-4,1554,535,943,186,25
2,0,0,2.0,-0.0,0.6322169303894043,-6.343145750507619,41,4,-4,1554,535,943,186,25
3,0,0,3.0,-0.0,0.6402928829193115,-7.876894374382339,41,1,-4,1554,535,943,186,25
2,0,0,2.0,-0.0,0.649122953414917,-7.876894374382339,41,-1,-4,1554,535,943,186,25
1,0,0,1.0,-0.0,0.6561288833618164,-7.52786404500042,41,-2,-4,1554,535,943,186,25
1,0,0,1.0,-0.0,0.6650149822235107,-7.0,41,-3,-4,1554,535,943,186,25
0,0,1,-0.0,-0.0,0.6792199611663818,-7.0,41,-3,-4,1554,535,943,186,25
0,0,0,-0.0,-0.0,0.06330060958862305,885.7413995170111,42,-894,-139,663,400,1557,539,39
-1,0,0,-1.0,-0.0,0.0740976333618164,884.7532849179581,42,-893,-139,663,400,1557,539,39
-2,0,0,-2.0,-0.0,0.08214163780212402,882.7771343297633,42,-891,-139,663,400,1557,539,39
-4,0,0,-4.0,-0.0,0.09018850326538086,878.8251500153023,42,-887,-139,663,400,1557,539,39
-4,1,0,-4.0,1.0,0.09825253486633301,875.0296415667659,42,-883,-140,663,400,1557,539,39
-5,2,0,-5.0,2.0,0.10608458518981934,870.4087924008846,42,-878,-142,663,400,1557,539,39
-6,2,0,-6.0,2.0,0.11415958404541016,864.8099343184597,42,-872,-144,663,400,1557,539,39
-6,1,0,-6.0,1.0,0.12209057807922363,859.0552374423833,42,-866,-145,663,400,1557,539,39
-7,2,0,-7.0,2.0,0.1300945281982422,852.4872345594054,42,-859,-147,663,400,1557,539,39
-6,0,0,-6.0,-0.0,0.13813161849975586,846.5737981246891,42,-853,-147,663,400,1557,539,39
-5,0,0,-5.0,-0.0,0.14621853828430176,841.6468497589473,42,-848,-147,663,400,1557,539,39
-7,0,0,-7.0,-0.0,0.15433359146118164,834.7505490481398,42,-841,-147,663,400,1557,539,39
-9,-1,0,-9.0,-1.0,0.16219472885131836,825.7129690018971,42,-832,-146,663,400,1557,539,39
-11,-3,0,-11.0,-3.0,0.17017650604248047,814.3606662184147,42,-821,-143,663,400,1557,539,39
-14,-2,0,-14.0,-2.0,0.17809772491455078,800.2252437516803,42,-807,-141,663,400,1557,539,39
-19,-4,0,-19.0,-4.0,0.18606066703796387,780.8206048858707,42,-788,-137,663,400,1557,539,39
-23,-2,0,-23.0,-2.0,0.19404268264770508,757.8204425734431,42,-765,-135,663,400,1557,539,39
-25,-3,0,-25.0,-3.0,0.2021186351776123,732.6807833116395,42,-740,-132,663,400,1557,539,39
-25,-4,0,-25.0,-4.0,0.21013951301574707,707.366987135291,42,-715,-128,663,400,1557,539,39
-28,-4,0,-28.0,-4.0,0.21811771392822266,679.1009955586655,42,-687,-124,663,400,1557,539,39
-29,-3,0,-29.0,-3.0,0.2269585132598877,650.032884094646,42,-658,-121,663,400,1557,539,39
-30,-4,0,-30.0,-4.0,0.23410367965698242,619.8059173176154,42,-628,-117,663,400,1557,539,39
-31,-4,0,-31.0,-4.0,0.24233055114746094,588.6001974983221,42,-597,-113,663,400,1557,539,39
-33,-6,0,-33.0,-6.0,0.2500786781311035,555.0601013831217,42,-564,-107,663,400,1557,539,39
-31,-5,0,-31.0,-5.0,0.2580685615539551,523.6720925199674,42,-533,-102,663,400,1557,539,39
-31,-7,0,-31.0,-7.0,0.26604151725769043,491.9099725000482,42,-502,-95,663,400,1557,539,39
-28,-6,0,-28.0,-6.0,0.2740635871887207,463.2831118751723,42,-474,-89,663,400,1557,539,39
-28,-7,0,-28.0,-7.0,0.2821176052093506,434.4754679141971,42,-446,-82,663,400,1557,539,39
-25,-6,0,-25.0,-6.0,0.2900235652923584,408.8048620574572,42,-421,-76,663,400,1557,539,39
-26,-5,0,-26.0,-5.0,0.2988016605377197,382.33028791757044,42,-395,-71,663,400,1557,539,39
-23,-4,0,-23.0,-4.0,0.3062615394592285,358.985449455399,42,-372,-67,663,400,1557,539,39
-25,-6,0,-25.0,-6.0,0.31432652473449707,333.32087647484076,42,-347,-61,663,400,1557,539,39
-25,-5,0,-25.0,-5.0,0.3222935199737549,307.83329083800504,42,-322,-56,663,400,1557,539,39
-23,-5,0,-23.0,-5.0,0.33010363578796387,284.3183146465112,42,-299,-51,663,400,1557,539,39
-23,-6,0,-23.0,-6.0,0.33817362785339355,260.6444170728248,42,-276,-45,663,400,1557,539,39
-23,-6,0,-23.0,-6.0,0.34601259231567383,236.98828098176682,42,-253,-39,663,400,1557,539,39
-22,-6,0,-22.0,-6.0,0.3541417121887207,214.3452377915607,42,-231,-33,663,400,1557,539,39
-21,-6,0,-21.0,-6.0,0.362060546875,192.72859986312668,42,-210,-27,663,400,1557,539,39
-18,-6,0,-18.0,-6.0,0.37085652351379395,174.14502323383846,42,-192,-21,663,400,1557,539,39
-17,-5,0,-17.0,-5.0,0.3784596920013428,156.72990639046048,42,-175,-16,663,400,1557,539,39
-17,-5,0,-17.0,-5.0,0.38636159896850586,139.38244852255568,42,-158,-11,663,400,1557,539,39
-15,-5,0,-15.0,-5.0,0.39418864250183105,124.1258187749506,42,-143,-6,663,400,1557,539,39
-14,-3,0,-14.0,-3.0,0.40219950675964355,110.0348790056394,42,-129,-3,663,400,1557,539,39
-13,-2,0,-13.0,-2.0,0.41007351875305176,97.00431026474836,42,-116,-1,663,400,1557,539,39
-11,-1,0,-11.0,-1.0,0.41809964179992676,86.0,42,-105,0,663,400,1557,539,39
-11,-1,0,-11.0,-1.0,0.42616868019104004,75.00531899844816,42,-94,1,663,400,1557,539,39
-10,-1,0,-10.0,-1.0,0.4343125820159912,65.02380615040002,42,-84,2,663,400,1557,539,39
-9,0,0,-9.0,-0.0,0.4420936107635498,56.026661927610775,42,-75,2,663,400,1557,539,39
-9,0,0,-9.0,-0.0,0.45055651664733887,47.03029607687671,42,-66,2,663,400,1557,539,39
-8,0,0,-8.0,-0.0,0.458296537399292,39.034472514187634,42,-58,2,663,400,1557,539,39
-9,0,0,-9.0,-0.0,0.46625661849975586,30.040799340956916,42,-49,2,663,400,1557,539,39
-7,0,0,-7.0,-0.0,0.47403955459594727,23.04759208325728,42,-42,2,663,400,1557,539,39
-7,0,0,-7.0,-0.0,0.48210763931274414,16.05709628591621,42,-35,2,663,400,1557,539,39
-7,0,0,-7.0,-0.0,0.4901115894317627,9.071337695236398,42,-28,2,663,400,1557,539,39
-7,0,0,-7.0,-0.0,0.49808454513549805,2.095023109728988,42,-21,2,663,400,1557,539,39
-8,1,0,-8.0,1.0,0.5061604976654053,-5.961595189594702,42,-13,1,663,400,1557,539,39
-7,1,0,-7.0,1.0,0.5141305923461914,-13.0,42,-6,0,663,400,1557,539,39
-6,0,0,-6.0,-0.0,0.5222735404968262,-19.0,42,0,0,663,400,1557,539,39
-6,1,0,-6.0,1.0,0.5301697254180908,-12.917237469701782,42,6,-1,663,400,1557,539,39
-5,0,0,-5.0,-0.0,0.5381636619567871,-7.954638982812739,42,11,-1,663,400,1557,539,39
-3,0,0,-3.0,-0.0,0.5460906028747559,-4.964331152381801,42,14,-1,663,400,1557,539,39
-3,0,0,-3.0,-0.0,0.5542457103729248,-1.9706136340735974,42,17,-1,663,400,1557,539,39
-2,0,0,-2.0,-0.0,0.5620815753936768,0.026297590440446328,42,19,-1,663,400,1557,539,39
-2,0,0,-2.0,-0.0,0.5700535774230957,2.023796041628639,42,21,-1,663,400,1557,539,39
-1,0,0,-1.0,-0.0,0.5780606269836426,3.022715545545239,42,22,-1,663,400,1557,539,39
0,0,1,-0.0,-0.0,0.6180946826934814,3.022715545545239,42,22,-1,663,400,1557,539,39
2,0,1,2.0,-0.0,0.07510972023010254,984.5148230096056,43,961,289,1604,690,641,401,38
1,0,1,1.0,-0.0,0.08299660682678223,983.5572302866306,43,960,289,1604,690,641,401,38
2,0,1,2.0,-0.0,0.09105873107910156,981.6422937293826,43,958,289,1604,690,641,401,38
0,0,0,-0.0,-0.0,0.09313058853149414,981.6422937293826,43,958,289,1604,690,641,401,38
3,0,0,3.0,-0.0,0.09900355339050293,978.7705146976433,43,955,289,1604,690,641,401,38
3,1,0,3.0,1.0,0.10693669319152832,975.6094710990842,43,952,288,1604,690,641,401,38
3,1,0,3.0,1.0,0.11499166488647461,972.4484353711997,43,949,287,1604,690,641,401,38
5,1,0,5.0,1.0,0.12291359901428223,967.373154541424,43,944,286,1604,690,641,401,38
6,3,0,6.0,3.0,0.13111662864685059,960.761705722366,43,938,283,1604,690,641,401,38
8,2,0,8.0,2.0,0.13911962509155273,952.5250897429257,43,930,281,1604,690,641,401,38
8,2,0,8.0,2.0,0.14700055122375488,944.2886379481489,43,922,279,1604,690,641,401,38
11,2,0,11.0,2.0,0.154984712600708,933.1817053483016,43,911,277,1604,690,641,401,38
11,3,0,11.0,3.0,0.16304254531860352,921.7847787884326,43,900,274,1604,690,641,401,38
13,3,0,13.0,3.0,0.1709287166595459,908.4750670503224,43,887,271,1604,690,641,401,38
16,3,0,16.0,3.0,0.17903470993041992,892.2985240852747,43,871,268,1604,690,641,401,38
21,4,0,21.0,4.0,0.1871016025543213,871.0539309502543,43,850,264,1604,690,641,401,38
24,4,0,24.0,4.0,0.19496774673461914,846.953809391702,43,826,260,1604,690,641,401,38
29,6,0,29.0,6.0,0.2030346393585205,817.4956664561987,43,797,254,1604,690,641,401,38
28,7,0,28.0,7.0,0.2108325958251953,788.6942490819159,43,769,247,1604,690,641,401,38
28,8,0,28.0,8.0,0.21897268295288086,759.589750767373,43,741,239,1604,690,641,401,38
29,10,0,29.0,10.0,0.22696161270141602,728.9204503154062,43,712,229,1604,690,641,401,38
31,10,0,31.0,10.0,0.2349536418914795,696.3474680181653,43,681,219,1604,690,641,401,38
30,12,0,30.0,12.0,0.24296069145202637,664.117852204142,43,651,207,1604,690,641,401,38
32,12,0,32.0,12.0,0.2509806156158447,629.9884436567419,43,619,195,1604,690,641,401,38
32,12,0,32.0,12.0,0.25908660888671875,595.8642126518668,43,587,183,1604,690,641,401,38
32,12,0,32.0,12.0,0.26706767082214355,561.746071876513,43,555,171,1604,690,641,401,38
32,12,0,32.0,12.0,0.2750566005706787,527.6351616937937,43,523,159,1604,690,641,401,38
33,12,0,33.0,12.0,0.2829866409301758,492.57501893661697,43,490,147,1604,690,641,401,38
31,12,0,31.0,12.0,0.29099369049072266,459.44121896007243,43,459,135,1604,690,641,401,38
31,12,0,31.0,12.0,0.2990245819091797,426.3234779348603,43,428,123,1604,690,641,401,38
29,12,0,29.0,12.0,0.3069615364074707,395.1521459560484,43,399,111,1604,690,641,401,38
28,11,0,28.0,11.0,0.31492161750793457,365.24080990961903,43,371,100,1604,690,641,401,38
25,10,0,25.0,10.0,0.3231196403503418,338.5136361035758,43,346,90,1604,690,641,401,38
23,9,0,23.0,9.0,0.33213067054748535,314.0015014981164,43,323,81,1604,690,641,401,38
21,9,0,21.0,9.0,0.339214563369751,291.46416862497995,43,302,72,1604,690,641,401,38
20,7,0,20.0,7.0,0.3469686508178711,270.394194827747,43,282,65,1604,690,641,401,38
19,6,0,19.0,6.0,0.35501575469970703,250.53663943887108,43,263,59,1604,690,641,401,38
19,6,0,19.0,6.0,0.3630356788635254,230.68980756130196,43,244,53,1604,690,641,401,38
19,6,0,19.0,6.0,0.3709535598754883,210.85647695899283,43,225,47,1604,690,641,401,38
17,5,0,17.0,5.0,0.3791067600250244,193.19802072592478,43,208,42,1604,690,641,401,38
17,5,0,17.0,5.0,0.38696861267089844,175.5507645834372,43,191,37,1604,690,641,401,38
15,3,0,15.0,3.0,0.39490556716918945,160.25400971805345,43,176,34,1604,690,641,401,38
13,3,0,13.0,3.0,0.4033787250518799,146.92166826548,43,163,31,1604,690,641,401,38
11,3,0,11.0,3.0,0.4111287593841553,135.55743269089325,43,152,28,1604,690,641,401,38
10,2,0,10.0,2.0,0.4190647602081299,125.36065946094871,43,142,26,1604,690,641,401,38
8,1,0,8.0,1.0,0.4270355701446533,117.31214179228496,43,134,25,1604,690,641,401,38
6,1,0,6.0,1.0,0.4350926876068115,111.23056476879765,43,128,24,1604,690,641,401,38
4,0,0,4.0,-0.0,0.4430415630340576,107.30122723077555,43,124,24,1604,690,641,401,38
4,0,0,4.0,-0.0,0.45099663734436035,103.37646832622684,43,120,24,1604,690,641,401,38
2,0,0,2.0,-0.0,0.4590725898742676,101.41594578792295,43,118,24,1604,690,641,401,38
1,0,0,1.0,-0.0,0.467024564743042,100.4361754243663,43,117,24,1604,690,641,401,38
1,0,0,1.0,-0.0,0.4830045700073242,99.45674315968678,43,116,24,1604,690,641,401,38
1,0,0,1.0,-0.0,0.5069806575775146,98.47765745025733,43,115,24,1604,690,641,401,38
1,0,0,1.0,-0.0,0.5149655342102051,97.49892703368559,43,114,24,1604,690,641,401,38
2,0,0,2.0,-0.0,0.5230576992034912,95.54256850621083,43,112,24,1604,690,641,401,38
4,0,0,4.0,-0.0,0.5310425758361816,91.63453348751464,43,108,24,1604,690,641,401,38
5,0,0,5.0,-0.0,0.5389187335968018,86.75916035975324,43,103,24,1604,690,641,401,38
6,2,0,6.0,2.0,0.5470187664031982,80.46356116689167,43,97,22,1604,690,641,401,38
9,2,0,9.0,2.0,0.5550305843353271,71.24411338142782,43,88,20,1604,690,641,401,38
10,3,0,10.0,3.0,0.5630917549133301,60.83107164506812,43,78,17,1604,690,641,401,38
11,3,0,11.0,3.0,0.5712237358093262,49.447059834590405,43,67,14,1604,690,641,401,38
11,3,0,11.0,3.0,0.5791995525360107,38.0701322935211,43,56,11,1604,690,641,401,38
11,3,0,11.0,3.0,0.5869965553283691,26.70557952810576,43,45,8,1604,690,641,401,38
10,2,0,10.0,2.0,0.5948266983032227,16.510561809129406,43,35,6,1604,690,641,401,38
9,3,0,9.0,3.0,0.602940559387207,7.172504656604801,43,26,3,1604,690,641,401,38
10,3,0,10.0,3.0,0.6109776496887207,-3.0,43,16,0,1604,690,641,401,38
10,3,0,10.0,3.0,0.619126558303833,-12.29179606750063,43,6,-3,1604,690,641,401,38
9,2,0,9.0,2.0,0.6279056072235107,-13.1690481051547,43,-3,-5,1604,690,641,401,38
5,0,0,5.0,-0.0,0.6350126266479492,-9.566018867943397,43,-8,-5,1604,690,641,401,38
3,1,0,3.0,1.0,0.643061637878418,-6.470035913858332,43,-11,-6,1604,690,641,401,38
2,0,0,2.0,-0.0,0.6511116027832031,-4.682178936723647,43,-13,-6,1604,690,641,401,38
2,0,0,2.0,-0.0,0.6590497493743896,-2.8445055785964897,43,-15,-6,1604,690,641,401,38
1,0,0,1.0,-0.0,0.6670577526092529,-1.9119925093649393,43,-16,-6,1604,690,641,401,38
0,0,1,-0.0,-0.0,0.7150857448577881,-1.9119925093649393,43,-16,-6,1604,690,641,401,38
0,0,0,-0.0,-0.0,0.07126522064208984,586.1436899261948,44,-203,-552,1417,144,1620,696,4
-1,1,0,-1.0,1.0,0.0752260684967041,586.7384818406217,44,-202,-553,1417,144,1620,696,4
-2,0,0,-2.0,-0.0,0.08317923545837402,586.0552695112934,44,-200,-553,1417,144,1620,696,4
-2,1,0,-2.0,1.0,0.091339111328125,586.3196410115847,44,-198,-554,1417,144,1620,696,4
-2,0,0,-2.0,-0.0,0.09922409057617188,585.6495554324873,44,-196,-554,1417,144,1620,696,4
-2,0,0,-2.0,-0.0,0.10722613334655762,584.985519412532,44,-194,-554,1417,144,1620,696,4
-3,1,0,-3.0,1.0,0.11520218849182129,584.9463348552404,44,-191,-555,1417,144,1620,696,4
-3,0,0,-3.0,-0.0,0.12321305274963379,583.9769620044801,44,-188,-555,1417,144,1620,696,4
-4,0,0,-4.0,-0.0,0.13142609596252441,582.705908983311,44,-184,-555,1417,144,1620,696,4
-6,0,0,-6.0,-0.0,0.13924908638000488,580.8456056281115,44,-178,-555,1417,144,1620,696,4
-6,0,0,-6.0,-0.0,0.14746403694152832,579.0413066211386,44,-172,-555,1417,144,1620,696,4
-5,-1,0,-5.0,-1.0,0.15528011322021484,576.6233662755074,44,-167,-554,1417,144,1620,696,4
-6,-1,0,-6.0,-1.0,0.1632990837097168,573.960068060278,44,-161,-553,1417,144,1620,696,4
-8,-2,0,-8.0,-2.0,0.17129206657409668,569.8478818706947,44,-153,-551,1417,144,1620,696,4
-9,-2,0,-9.0,-2.0,0.17926621437072754,565.5711409153922,44,-144,-549,1417,144,1620,696,4
-13,-5,0,-13.0,-5.0,0.18721723556518555,557.5507126257637,44,-131,-544,1417,144,1620,696,4
-18,-6,0,-18.0,-6.0,0.19523406028747559,547.7390289946676,44,-113,-538,1417,144,1620,696,4
-21,-11,0,-21.0,-11.0,0.20406007766723633,532.9700926220082,44,-92,-527,1417,144,1620,696,4
-26,-18,0,-26.0,-18.0,0.21196413040161133,511.26114210994,44,-66,-509,1417,144,1620,696,4
-25,-18,0,-25.0,-18.0,0.21932721138000488,490.70883897084695,44,-41,-491,1417,144,1620,696,4
-24,-18,0,-24.0,-18.0,0.22844719886779785,471.30539823669875,44,-17,-473,1417,144,1620,696,4
-18,-16,0,-18.0,-16.0,0.23527312278747559,455.00109409059405,44,1,-457,1417,144,1620,696,4
-10,-14,0,-10.0,-14.0,0.2433180809020996,441.13654780439856,44,11,-443,1417,144,1620,696,4
-5,-12,0,-5.0,-12.0,0.2511742115020752,429.29688150970907,44,16,-431,1417,144,1620,696,4
-3,-11,0,-3.0,-11.0,0.2592031955718994,418.42954225410944,44,19,-420,1417,144,1620,696,4
-2,-10,0,-2.0,-10.0,0.2671701908111572,408.5374526154709,44,21,-410,1417,144,1620,696,4
0,-12,0,-0.0,-12.0,0.2750861644744873,396.55363503548676,44,21,-398,1417,144,1620,696,4
0,-13,0,-0.0,-13.0,0.2830982208251953,383.5723019097715,44,21,-385,1417,144,1620,696,4
1,-15,0,1.0,-15.0,0.2912461757659912,368.5401462729781,44,20,-370,1417,144,1620,696,4
3,-16,0,3.0,-16.0,0.2992231845855713,352.4079570212836,44,17,-354,1417,144,1620,696,4
3,-16,0,3.0,-16.0,0.30736207962036133,336.28981657744293,44,14,-338,1417,144,1620,696,4
4,-15,0,4.0,-15.0,0.31530022621154785,321.154761685481,44,10,-323,1417,144,1620,696,4
4,-16,0,4.0,-16.0,0.323167085647583,305.05862632402955,44,6,-307,1417,144,1620,696,4
4,-16,0,4.0,-16.0,0.3312091827392578,289.0068727710739,44,2,-291,1417,144,1620,696,4
4,-16,0,4.0,-16.0,0.3391561508178711,273.00727263110696,44,-2,-275,1417,144,1620,696,4
4,-15,0,4.0,-15.0,0.3472151756286621,258.06922155457,44,-6,-260,1417,144,1620,696,4
2,-14,0,2.0,-14.0,0.355302095413208,244.13004692641653,44,-8,-246,1417,144,1620,696,4
3,-14,0,3.0,-14.0,0.363361120223999,230.26062946612367,44,-11,-232,1417,144,1620,696,4
3,-14,0,3.0,-14.0,0.3713042736053467,216.44907873461037,44,-14,-218,1417,144,1620,696,4
2,-13,0,2.0,-13.0,0.37917208671569824,203.62344224333955,44,-16,-205,1417,144,1620,696,4
3,-13,0,3.0,-13.0,0.38736605644226074,190.93781381574738,44,-19,-192,1417,144,1620,696,4
3,-13,0,3.0,-13.0,0.3952300548553467,178.34688796871433,44,-22,-179,1417,144,1620,696,4
2,-12,0,2.0,-12.0,0.40322113037109375,166.71573726241425,44,-24,-167,1417,144,1620,696,4
2,-12,0,2.0,-12.0,0.41129422187805176,155.16551784663199,44,-26,-155,1417,144,1620,696,4
2,-10,0,2.0,-10.0,0.4192972183227539,145.6787053031005,44,-28,-145,1417,144,1620,696,4
1,-9,0,1.0,-9.0,0.4272322654724121,137.05754204644924,44,-29,-136,1417,144,1620,696,4
1,-7,0,1.0,-7.0,0.43518519401550293,130.4424403278647,44,-30,-129,1417,144,1620,696,4
1,-8,0,1.0,-8.0,0.44331812858581543,122.90796611905904,44,-31,-121,1417,144,1620,696,4
0,-7,0,-0.0,-7.0,0.45125722885131836,116.1397477566293,44,-31,-114,1417,144,1620,696,4
0,-6,0,-0.0,-6.0,0.459165096282959,110.36102527122117,44,-31,-108,1417,144,1620,696,4
0,-6,0,-0.0,-6.0,0.46719908714294434,104.60675400742676,44,-31,-102,1417,144,1620,696,4
-1,-6,0,-1.0,-6.0,0.4751312732696533,98.57832768544127,44,-30,-96,1417,144,1620,696,4
-1,-5,0,-1.0,-5.0,0.4831690788269043,93.50916186418976,44,-29,-91,1417,144,1620,696,4
-1,-4,0,-1.0,-4.0,0.4912722110748291,89.39474820797966,44,-28,-87,1417,144,1620,696,4
-2,-4,0,-2.0,-4.0,0.4992091655731201,84.97700845625813,44,-26,-83,1417,144,1620,696,4
-3,-4,0,-3.0,-4.0,0.5073542594909668,80.28000972289685,44,-23,-79,1417,144,1620,696,4
-2,-3,0,-2.0,-3.0,0.5152561664581299,76.84795495128583,44,-21,-76,1417,144,1620,696,4
-2,-3,0,-2.0,-3.0,0.5232982635498047,73.43208866258443,44,-19,-73,1417,144,1620,696,4
-1,-3,0,-1.0,-3.0,0.5311622619628906,70.27724399837061,44,-18,-70,1417,144,1620,696,4
-1,-3,0,-1.0,-3.0,0.5392961502075195,67.12307863514182,44,-17,-67,1417,144,1620,696,4
-1,-3,0,-1.0,-3.0,0.547173261642456,63.96969000988257,44,-16,-64,1417,144,1620,696,4
-1,-3,0,-1.0,-3.0,0.5551822185516357,60.81719509815764,44,-15,-61,1417,144,1620,696,4
-1,-3,0,-1.0,-3.0,0.5632622241973877,57.665735560705194,44,-14,-58,1417,144,1620,696,4
-1,-4,0,-1.0,-4.0,0.5711791515350342,53.54277630799526,44,-13,-54,1417,144,1620,696,4
-2,-4,0,-2.0,-4.0,0.5792770385742188,49.19570294468082,44,-11,-50,1417,144,1620,696,4
0,-4,0,-0.0,-4.0,0.5873141288757324,45.29693436154187,44,-11,-46,1417,144,1620,696,4
-1,-3,0,-1.0,-3.0,0.5952551364898682,42.14748010928823,44,-10,-43,1417,144,1620,696,4
0,-3,0,-0.0,-3.0,0.6031930446624756,39.23105625617661,44,-10,-40,1417,144,1620,696,4
-1,-2,0,-1.0,-2.0,0.6112492084503174,37.05124837953327,44,-9,-38,1417,144,1620,696,4
0,-3,0,-0.0,-3.0,0.6191482543945312,34.138621999185304,44,-9,-35,1417,144,1620,696,4
0,-2,0,-0.0,-2.0,0.6271481513977051,32.20526275297414,44,-9,-33,1417,144,1620,696,4
0,-1,0,-0.0,-1.0,0.6351642608642578,31.241540277189323,44,-9,-32,1417,144,1620,696,4
0,-2,0,-0.0,-2.0,0.6431071758270264,29.32091952673165,44,-9,-30,1417,144,1620,696,4
-1,-1,0,-1.0,-1.0,0.6515071392059326,28.083217912982647,44,-8,-29,1417,144,1620,696,4
0,-2,0,-0.0,-2.0,0.6591742038726807,26.160255680657446,44,-8,-27,1417,144,1620,696,4
-1,-2,0,-1.0,-2.0,0.6672711372375488,23.96150997149434,44,-7,-25,1417,144,1620,696,4
0,-2,0,-0.0,-2.0,0.675605058670044,22.041630560342615,44,-7,-23,1417,144,1620,696,4
0,-2,0,-0.0,-2.0,0.6832680702209473,20.135943621178654,44,-7,-21,1417,144,1620,696,4
0,-2,0,-0.0,-2.0,0.6913492679595947,18.248456731316587,44,-7,-19,1417,144,1620,696,4
-1,-2,0,-1.0,-2.0,0.6994292736053467,16.027756377319946,44,-6,-17,1417,144,1620,696,4
0,-2,0,-0.0,-2.0,0.707160234451294,14.15549442140351,44,-6,-15,1417,144,1620,696,4
-1,-2,0,-1.0,-2.0,0.7152292728424072,11.92838827718412,44,-5,-13,1417,144,1620,696,4
0,-2,0,-0.0,-2.0,0.7237932682037354,10.083045973594572,44,-5,-11,1417,144,1620,696,4
0,-2,0,-0.0,-2.0,0.7312171459197998,8.295630140987,44,-5,-9,1417,144,1620,696,4
0,-1,0,-0.0,-1.0,0.7393131256103516,7.433981132056603,44,-5,-8,1417,144,1620,696,4
0,-1,0,-0.0,-1.0,0.7551102638244629,6.602325267042627,44,-5,-7,1417,144,1620,696,4
0,-1,0,-0.0,-1.0,0.7633481025695801,5.810249675906654,44,-5,-6,1417,144,1620,696,4
0,-1,0,-0.0,-1.0,0.779116153717041,5.0710678118654755,44,-5,-5,1417,144,1620,696,4
-1,-1,0,-1.0,-1.0,0.8032722473144531,3.6568542494923806,44,-4,-4,1417,144,1620,696,4
-1,-1,0,-1.0,-1.0,0.8191592693328857,2.2426406871192848,44,-3,-3,1417,144,1620,696,4
-1,0,0,-1.0,-0.0,0.827174186706543,1.6055512754639891,44,-2,-3,1417,144,1620,696,4
-1,0,0,-1.0,-0.0,0.8351480960845947,1.1622776601683795,44,-1,-3,1417,144,1620,696,4
-1,-1,0,-1.0,-1.0,0.8433630466461182,0.0,44,0,-2,1417,144,1620,696,4
-1,0,0,-1.0,-0.0,0.851182222366333,0.2360679774997898,44,1,-2,1417,144,1620,696,4
0,0,1,-0.0,-0.0,0.9072332382202148,0.2360679774997898,44,1,-2,1417,144,1620,696,4
0,0,0,-0.0,-0.0,0.10692429542541504,375.30797017541914,45,-195,330,1221,476,1416,146,17
-2,3,0,-2.0,3.0,0.18819117546081543,371.7077823800824,45,-193,327,1221,476,1416,146,17
-2,6,0,-2.0,6.0,0.19604039192199707,365.5264381539813,45,-191,321,1221,476,1416,146,17
-4,7,0,-4.0,7.0,0.20415925979614258,357.4654566439898,45,-187,314,1221,476,1416,146,17
-5,8,0,-5.0,8.0,0.2120363712310791,348.03370626950476,45,-182,306,1221,476,1416,146,17
-5,8,0,-5.0,8.0,0.22013235092163086,338.60207731633693,45,-177,298,1221,476,1416,146,17
-4,8,0,-4.0,8.0,0.22801923751831055,329.6818028854975,45,-173,290,1221,476,1416,146,17
-5,8,0,-5.0,8.0,0.23600339889526367,320.2499047981583,45,-168,282,1221,476,1416,146,17
-6,10,0,-6.0,10.0,0.24485135078430176,308.5880604192142,45,-162,272,1221,476,1416,146,17
-7,10,0,-7.0,10.0,0.2529482841491699,296.4158340165636,45,-155,262,1221,476,1416,146,17
-8,11,0,-8.0,11.0,0.2608973979949951,282.8779812911249,45,-147,251,1221,476,1416,146,17
-9,14,0,-9.0,14.0,0.2681741714477539,266.2498860528478,45,-138,237,1221,476,1416,146,17
-11,14,0,-11.0,14.0,0.2761082649230957,248.62813563598206,45,-127,223,1221,476,1416,146,17
-12,17,0,-12.0,17.0,0.2840712070465088,227.92583580439003,45,-115,206,1221,476,1416,146,17
-12,17,0,-12.0,17.0,0.2926352024078369,207.24404753674375,45,-103,189,1221,476,1416,146,17
-12,17,0,-12.0,17.0,0.30002927780151367,186.58931111445972,45,-91,172,1221,476,1416,146,17
-12,14,0,-12.0,14.0,0.30808019638061523,168.64937022248338,45,-79,158,1221,476,1416,146,17
-11,15,0,-11.0,15.0,0.3160233497619629,150.3445610054226,45,-68,143,1221,476,1416,146,17
-10,12,0,-10.0,12.0,0.32419538497924805,135.26548781894402,45,-58,131,1221,476,1416,146,17
-9,12,0,-9.0,12.0,0.3327043056488037,120.69343417595164,45,-49,119,1221,476,1416,146,17
-7,10,0,-7.0,10.0,0.3402373790740967,108.81181447096864,45,-42,109,1221,476,1416,146,17
-7,9,0,-7.0,9.0,0.3483273983001709,97.94810050208545,45,-35,100,1221,476,1416,146,17
-6,7,0,-6.0,7.0,0.35611438751220703,89.41663102366043,45,-29,93,1221,476,1416,146,17
-4,7,0,-4.0,7.0,0.36400437355041504,81.56003573022959,45,-25,86,1221,476,1416,146,17
-4,5,0,-4.0,5.0,0.3720862865447998,75.67795408588812,45,-21,81,1221,476,1416,146,17
-4,4,0,-4.0,4.0,0.3801603317260742,70.85429601486528,45,-17,77,1221,476,1416,146,17
-3,4,0,-3.0,4.0,0.38820624351501465,66.33034373659252,45,-14,73,1221,476,1416,146,17
-3,2,0,-3.0,2.0,0.39614224433898926,63.847059786744225,45,-11,71,1221,476,1416,146,17
-2,2,0,-2.0,2.0,0.404158353805542,61.58448102845921,45,-9,69,1221,476,1416,146,17
-1,1,0,-1.0,1.0,0.4124603271484375,60.46897107449476,45,-8,68,1221,476,1416,146,17
-1,2,0,-1.0,2.0,0.4201493263244629,58.37017402418047,45,-7,66,1221,476,1416,146,17
-1,0,0,-1.0,-0.0,0.4281473159790039,58.27216610312357,45,-6,66,1221,476,1416,146,17
0,1,0,-0.0,1.0,0.47614336013793945,57.27633568147036,45,-6,65,1221,476,1416,146,17
-1,0,0,-1.0,-0.0,0.4841923713684082,57.19202405202648,45,-5,65,1221,476,1416,146,17
0,2,0,-0.0,2.0,0.4921383857727051,55.198101237299845,45,-5,63,1221,476,1416,146,17
0,4,0,-0.0,4.0,0.5000593662261963,51.21148537234985,45,-5,59,1221,476,1416,146,17
0,2,0,-0.0,2.0,0.5083503723144531,49.21887800367987,45,-5,57,1221,476,1416,146,17
0,3,0,-0.0,3.0,0.5160253047943115,46.230987451824994,45,-5,54,1221,476,1416,146,17
0,4,0,-0.0,4.0,0.5240132808685303,42.24937810560445,45,-5,50,1221,476,1416,146,17
0,4,0,-0.0,4.0,0.5319383144378662,38.2709412050371,45,-5,46,1221,476,1416,146,17
0,5,0,-0.0,5.0,0.540048360824585,33.30375285612676,45,-5,41,1221,476,1416,146,17
0,5,0,-0.0,5.0,0.5481052398681641,28.345563690772494,45,-5,36,1221,476,1416,146,17
-1,7,0,-1.0,7.0,0.5569813251495361,21.274562336608895,45,-4,29,1221,476,1416,146,17
-2,7,0,-2.0,7.0,0.5642533302307129,14.090722034374522,45,-2,22,1221,476,1416,146,17
-2,7,0,-2.0,7.0,0.5722033977508545,7.0,45,0,15,1221,476,1416,146,17
-2,7,0,-2.0,7.0,0.5800251960754395,0.24621125123532117,45,2,8,1221,476,1416,146,17
-1,5,0,-1.0,5.0,0.5880851745605469,-3.7573593128807152,45,3,3,1221,476,1416,146,17
-2,6,0,-2.0,6.0,0.5960943698883057,-2.1690481051546993,45,5,-3,1221,476,1416,146,17
-1,3,0,-1.0,3.0,0.6041643619537354,0.48528137423856954,45,6,-6,1221,476,1416,146,17
-1,4,0,-1.0,4.0,0.6120443344116211,4.206555615733702,45,7,-10,1221,476,1416,146,17
-1,2,0,-1.0,2.0,0.6208562850952148,6.4222051018559565,45,8,-12,1221,476,1416,146,17
-1,1,0,-1.0,1.0,0.628204345703125,7.811388300841896,45,9,-13,1221,476,1416,146,17
0,0,1,-0.0,-0.0,0.6900372505187988,7.811388300841896,45,9,-13,1221,476,1416,146,17
0,0,0,-0.0,-0.0,0.07517123222351074,1245.7336976796369,46,-1111,625,101,1114,1212,489,59
-1,0,0,-1.0,-0.0,0.2521951198577881,1244.8622374495603,46,-1110,625,101,1114,1212,489,59
-2,0,0,-2.0,-0.0,0.2600221633911133,1243.1198842876406,46,-1108,625,101,1114,1212,489,59
-2,0,0,-2.0,-0.0,0.26831817626953125,1241.3782901167667,46,-1106,625,101,1114,1212,489,59
-2,0,0,-2.0,-0.0,0.2767012119293213,1239.6374580627833,46,-1104,625,101,1114,1212,489,59
-3,0,0,-3.0,-0.0,0.28427815437316895,1237.027645827689,46,-1101,625,101,1114,1212,489,59
-5,1,0,-5.0,1.0,0.2922492027282715,1232.1867427149716,46,-1096,624,101,1114,1212,489,59
-7,3,0,-7.0,3.0,0.30023908615112305,1224.6195595155652,46,-1089,621,101,1114,1212,489,59
-10,4,0,-10.0,4.0,0.30797815322875977,1213.95213101712,46,-1079,617,101,1114,1212,489,59
-13,6,0,-13.0,6.0,0.31617307662963867,1199.689138879318,46,-1066,611,101,1114,1212,489,59
-17,7,0,-17.0,7.0,0.32404017448425293,1181.4614822455112,46,-1049,604,101,1114,1212,489,59
-20,10,0,-20.0,10.0,0.33295512199401855,1159.1401432491034,46,-1029,594,101,1114,1212,489,59
-24,11,0,-24.0,11.0,0.3399331569671631,1132.857994765281,46,-1005,583,101,1114,1212,489,59
-28,15,0,-28.0,15.0,0.34810900688171387,1101.1119413580232,46,-977,568,101,1114,1212,489,59
-33,17,0,-33.0,17.0,0.3569071292877197,1064.040255434355,46,-944,551,101,1114,1212,489,59
-33,17,0,-33.0,17.0,0.36524510383605957,1026.972064024423,46,-911,534,101,1114,1212,489,59
-34,19,0,-34.0,19.0,0.37218618392944336,988.0319562334313,46,-877,515,101,1114,1212,489,59
-36,22,0,-36.0,22.0,0.380169153213501,945.8487062103535,46,-841,493,101,1114,1212,489,59
-35,20,0,-35.0,20.0,0.3880650997161865,905.5399937937381,46,-806,473,101,1114,1212,489,59
-36,20,0,-36.0,20.0,0.396071195602417,864.369464443463,46,-770,453,101,1114,1212,489,59
-36,19,0,-36.0,19.0,0.4041290283203125,823.708625498769,46,-734,434,101,1114,1212,489,59
-34,20,0,-34.0,20.0,0.4120461940765381,784.2625652272457,46,-700,414,101,1114,1212,489,59
-31,21,0,-31.0,21.0,0.4200630187988281,746.8930338648491,46,-669,393,101,1114,1212,489,59
-29,22,0,-29.0,22.0,0.42817211151123047,710.7573926632974,46,-640,371,101,1114,1212,489,59
-27,22,0,-27.0,22.0,0.4360940456390381,676.3864189222812,46,-613,349,101,1114,1212,489,59
-25,22,0,-25.0,22.0,0.4441351890563965,643.8097799526996,46,-588,327,101,1114,1212,489,59
-24,19,0,-24.0,19.0,0.4521031379699707,613.6196386666065,46,-564,308,101,1114,1212,489,59
-23,16,0,-23.0,16.0,0.4601271152496338,585.772315577076,46,-541,292,101,1114,1212,489,59
-21,13,0,-21.0,13.0,0.46805906295776367,561.1194794276834,46,-520,279,101,1114,1212,489,59
-18,11,0,-18.0,11.0,0.4760570526123047,540.0588721740485,46,-502,268,101,1114,1212,489,59
-16,10,0,-16.0,10.0,0.48404407501220703,521.236312869298,46,-486,258,101,1114,1212,489,59
-17,9,0,-17.0,9.0,0.49202704429626465,502.00094161875086,46,-469,249,101,1114,1212,489,59
-17,8,0,-17.0,8.0,0.5005500316619873,483.2352974952039,46,-452,241,101,1114,1212,489,59
-19,7,0,-19.0,7.0,0.5080251693725586,463.1839087170567,46,-433,234,101,1114,1212,489,59
-21,7,0,-21.0,7.0,0.5159640312194824,441.3966411444708,46,-412,227,101,1114,1212,489,59
-21,7,0,-21.0,7.0,0.5240340232849121,419.64351104189615,46,-391,220,101,1114,1212,489,59
-22,7,0,-22.0,7.0,0.5320830345153809,397.0633755675322,46,-369,213,101,1114,1212,489,59
-21,6,0,-21.0,6.0,0.5401420593261719,375.911101354359,46,-348,207,101,1114,1212,489,59
-20,7,0,-20.0,7.0,0.5480201244354248,355.166630513375,46,-328,200,101,1114,1212,489,59
-20,6,0,-20.0,6.0,0.556035041809082,335.0054944640259,46,-308,194,101,1114,1212,489,59
-17,6,0,-17.0,6.0,0.5640602111816406,317.44624402640017,46,-291,188,101,1114,1212,489,59
-18,8,0,-18.0,8.0,0.5720441341400146,298.0,46,-273,180,101,1114,1212,489,59
-19,8,0,-19.0,8.0,0.5800361633300781,277.75723300355935,46,-254,172,101,1114,1212,489,59
-16,7,0,-16.0,7.0,0.5881481170654297,260.6014502726117,46,-238,165,101,1114,1212,489,59
-15,7,0,-15.0,7.0,0.5960640907287598,244.30020124398004,46,-223,158,101,1114,1212,489,59
-16,7,0,-16.0,7.0,0.6040282249450684,227.22255950637913,46,-207,151,101,1114,1212,489,59
-16,7,0,-16.0,7.0,0.6121070384979248,210.20075250717753,46,-191,144,101,1114,1212,489,59
-16,6,0,-16.0,6.0,0.6198830604553223,193.86543024883872,46,-175,138,101,1114,1212,489,59
-15,7,0,-15.0,7.0,0.6279761791229248,177.7873303662485,46,-160,131,101,1114,1212,489,59
-14,7,0,-14.0,7.0,0.6360681056976318,162.55155963865187,46,-146,124,101,1114,1212,489,59
-13,5,0,-13.0,5.0,0.6440920829772949,149.46568297574746,46,-133,119,101,1114,1212,489,59
-11,7,0,-11.0,7.0,0.6520922183990479,136.61400906928134,46,-122,112,101,1114,1212,489,59
-10,5,0,-10.0,5.0,0.6600451469421387,125.89673979784081,46,-112,107,101,1114,1212,489,59
-9,6,0,-9.0,6.0,0.6680190563201904,115.25671561490648,46,-103,101,101,1114,1212,489,59
-10,6,0,-10.0,6.0,0.6760950088500977,103.94359706281458,46,-93,95,101,1114,1212,489,59
-10,6,0,-10.0,6.0,0.68404221534729,92.69634341261039,46,-83,89,101,1114,1212,489,59
-9,5,0,-9.0,5.0,0.6920490264892578,82.94641575325224,46,-74,84,101,1114,1212,489,59
-10,5,0,-10.0,5.0,0.7000501155853271,72.67103815738285,46,-64,79,101,1114,1212,489,59
-7,5,0,-7.0,5.0,0.7080550193786621,64.40770846134703,46,-57,74,101,1114,1212,489,59
-6,2,0,-6.0,2.0,0.7161221504211426,59.232647019116456,46,-51,72,101,1114,1212,489,59
-5,3,0,-5.0,3.0,0.7240462303161621,53.927679335671755,46,-46,69,101,1114,1212,489,59
-5,3,0,-5.0,3.0,0.7320802211761475,48.69813382572325,46,-41,66,101,1114,1212,489,59
-3,2,0,-3.0,2.0,0.7400281429290771,45.43117626371358,46,-38,64,101,1114,1212,489,59
-4,2,0,-4.0,2.0,0.7481682300567627,41.710678118654755,46,-34,62,101,1114,1212,489,59
-4,2,0,-4.0,2.0,0.7560350894927979,38.08203932499369,46,-30,60,101,1114,1212,489,59
-5,3,0,-5.0,3.0,0.7640171051025391,33.24146527838174,46,-25,57,101,1114,1212,489,59
-5,3,0,-5.0,3.0,0.7720420360565186,28.584720195551874,46,-20,54,101,1114,1212,489,59
-3,3,0,-3.0,3.0,0.7800180912017822,24.75872022286245,46,-17,51,101,1114,1212,489,59
-4,2,0,-4.0,2.0,0.788032054901123,21.695167422546305,46,-13,49,101,1114,1212,489,59
-4,4,0,-4.0,4.0,0.7960622310638428,16.891175622335062,46,-9,45,101,1114,1212,489,59
-2,2,0,-2.0,2.0,0.8039920330047607,14.56604182158393,46,-7,43,101,1114,1212,489,59
-2,1,0,-2.0,1.0,0.8119990825653076,13.296571965113202,46,-5,42,101,1114,1212,489,59
-2,2,0,-2.0,2.0,0.8199141025543213,11.11234224026316,46,-3,40,101,1114,1212,489,59
-3,2,0,-3.0,2.0,0.8281421661376953,9.0,46,0,38,101,1114,1212,489,59
-2,2,0,-2.0,2.0,0.8360040187835693,7.055512754639892,46,2,36,101,1114,1212,489,59
-1,1,0,-1.0,1.0,0.844074010848999,6.128336140500593,46,3,35,101,1114,1212,489,59
-1,1,0,-1.0,1.0,0.8520181179046631,5.23448553724738,46,4,34,101,1114,1212,489,59
-1,1,0,-1.0,1.0,0.8599770069122314,4.376638536557273,46,5,33,101,1114,1212,489,59
-1,1,0,-1.0,1.0,0.8682510852813721,3.557641192199412,46,6,32,101,1114,1212,489,59
0,0,1,-0.0,-0.0,0.8742341995239258,3.557641192199412,46,6,32,101,1114,1212,489,59
0,0,0,-0.0,-0.0,0.07875418663024902,1127.346335966666,47,641,-954,736,128,95,1082,44
1,0,0,1.0,-0.0,0.10970401763916016,1126.7889275232417,47,640,-954,736,128,95,1082,44
2,0,0,2.0,-0.0,0.11775708198547363,1125.6759124421842,47,638,-954,736,128,95,1082,44
3,-1,0,3.0,-1.0,0.12568902969360352,1123.178588692611,47,635,-953,736,128,95,1082,44
4,-3,0,4.0,-3.0,0.13363122940063477,1118.4652559372425,47,631,-950,736,128,95,1082,44
5,-3,0,5.0,-3.0,0.14198923110961914,1113.202625085055,47,626,-947,736,128,95,1082,44
5,-3,0,5.0,-3.0,0.14988422393798828,1107.9455739105313,47,621,-944,736,128,95,1082,44
7,-5,0,7.0,-5.0,0.15771818161010742,1099.925576854365,47,614,-939,736,128,95,1082,44
9,-6,0,9.0,-6.0,0.16572904586791992,1089.98651070955,47,605,-933,736,128,95,1082,44
11,-7,0,11.0,-7.0,0.17365622520446777,1078.1418090409982,47,594,-926,736,128,95,1082,44
14,-9,0,14.0,-9.0,0.18166613578796387,1063.0294926867195,47,580,-917,736,128,95,1082,44
17,-11,0,17.0,-11.0,0.1896190643310547,1044.6794270070086,47,563,-906,736,128,95,1082,44
19,-13,0,19.0,-13.0,0.19778013229370117,1023.6505152296345,47,544,-893,736,128,95,1082,44
21,-20,0,21.0,-20.0,0.2057971954345703,995.6728354436901,47,523,-873,736,128,95,1082,44
21,-22,0,21.0,-22.0,0.21373224258422852,966.0308699630797,47,502,-851,736,128,95,1082,44
23,-25,0,23.0,-25.0,0.22171401977539062,932.8387298387095,47,479,-826,736,128,95,1082,44
23,-28,0,23.0,-28.0,0.22962212562561035,897.0973833060347,47,456,-798,736,128,95,1082,44
22,-29,0,22.0,-29.0,0.23761415481567383,861.0158548972946,47,434,-769,736,128,95,1082,44
19,-33,0,19.0,-33.0,0.24568724632263184,822.9384592974804,47,415,-736,736,128,95,1082,44
16,-34,0,16.0,-34.0,0.2536170482635498,785.4682656302971,47,399,-702,736,128,95,1082,44
14,-36,0,14.0,-36.0,0.2616870403289795,747.2730334543127,47,385,-666,736,128,95,1082,44
13,-32,0,13.0,-32.0,0.26959824562072754,713.0782271296029,47,372,-634,736,128,95,1082,44
11,-32,0,11.0,-32.0,0.2776601314544678,679.9437299385187,47,361,-602,736,128,95,1082,44
11,-32,0,11.0,-32.0,0.285642147064209,646.8796603276257,47,350,-570,736,128,95,1082,44
11,-33,0,11.0,-33.0,0.29364919662475586,613.0511790399258,47,339,-537,736,128,95,1082,44
12,-31,0,12.0,-31.0,0.30161404609680176,580.4657666623059,47,327,-506,736,128,95,1082,44
14,-30,0,14.0,-30.0,0.3096940517425537,547.6885113814391,47,313,-476,736,128,95,1082,44
15,-26,0,15.0,-26.0,0.3176450729370117,517.725856338197,47,298,-450,736,128,95,1082,44
15,-24,0,15.0,-24.0,0.32560110092163086,489.43425774971314,47,283,-426,736,128,95,1082,44
15,-21,0,15.0,-21.0,0.3336191177368164,463.64287290147684,47,268,-405,736,128,95,1082,44
13,-18,0,13.0,-18.0,0.34220123291015625,441.4587360272757,47,255,-387,736,128,95,1082,44
12,-17,0,12.0,-17.0,0.3496990203857422,420.6612700474258,47,243,-370,736,128,95,1082,44
11,-15,0,11.0,-15.0,0.35795116424560547,402.08607616850617,47,232,-355,736,128,95,1082,44
8,-14,0,8.0,-14.0,0.365645170211792,385.99142147844236,47,224,-341,736,128,95,1082,44
9,-13,0,9.0,-13.0,0.3736860752105713,370.1849053699033,47,215,-328,736,128,95,1082,44
8,-12,0,8.0,-12.0,0.38172221183776855,355.7631533117014,47,207,-316,736,128,95,1082,44
8,-11,0,8.0,-11.0,0.3896651268005371,342.1785276481852,47,199,-305,736,128,95,1082,44
8,-10,0,8.0,-10.0,0.3975951671600342,329.4342043683284,47,191,-295,736,128,95,1082,44
9,-10,0,9.0,-10.0,0.4056222438812256,316.15528977083886,47,182,-285,736,128,95,1082,44
7,-11,0,7.0,-11.0,0.41371703147888184,303.11690205216956,47,175,-274,736,128,95,1082,44
9,-11,0,9.0,-11.0,0.42169904708862305,289.0064308016797,47,166,-263,736,128,95,1082,44
7,-10,0,7.0,-10.0,0.42960619926452637,276.8143236192,47,159,-253,736,128,95,1082,44
7,-11,0,7.0,-11.0,0.4376220703125,263.77613616255644,47,152,-242,736,128,95,1082,44
5,-10,0,5.0,-10.0,0.44565606117248535,252.6506872374435,47,147,-232,736,128,95,1082,44
5,-9,0,5.0,-9.0,0.45360612869262695,242.372842780797,47,142,-223,736,128,95,1082,44
5,-9,0,5.0,-9.0,0.4617440700531006,232.09643838511394,47,137,-214,736,128,95,1082,44
4,-8,0,4.0,-8.0,0.4696621894836426,223.20399670478457,47,133,-206,736,128,95,1082,44
6,-9,0,6.0,-9.0,0.47774624824523926,212.3885662740399,47,127,-197,736,128,95,1082,44
5,-9,0,5.0,-9.0,0.4855661392211914,202.11604137142882,47,122,-188,736,128,95,1082,44
5,-7,0,5.0,-7.0,0.4937121868133545,193.52262062252305,47,117,-181,736,128,95,1082,44
5,-6,0,5.0,-6.0,0.5015690326690674,185.77150911518163,47,112,-175,736,128,95,1082,44
6,-7,0,6.0,-7.0,0.5096480846405029,176.6454127333425,47,106,-168,736,128,95,1082,44
4,-6,0,4.0,-6.0,0.51763916015625,169.43667360252581,47,102,-162,736,128,95,1082,44
5,-5,0,5.0,-5.0,0.5257110595703125,162.54809671194118,47,97,-157,736,128,95,1082,44
4,-5,0,4.0,-5.0,0.5336301326751709,156.1937148162078,47,93,-152,736,128,95,1082,44
4,-6,0,4.0,-6.0,0.5415980815887451,148.98830369355676,47,89,-146,736,128,95,1082,44
5,-7,0,5.0,-7.0,0.5497472286224365,140.40997506310995,47,84,-139,736,128,95,1082,44
5,-6,0,5.0,-6.0,0.5575461387634277,132.69324484281788,47,79,-133,736,128,95,1082,44
5,-7,0,5.0,-7.0,0.5656230449676514,124.12323566086263,47,74,-126,736,128,95,1082,44
5,-6,0,5.0,-6.0,0.5737500190734863,116.42326394071193,47,69,-120,736,128,95,1082,44
5,-7,0,5.0,-7.0,0.5818490982055664,107.86531484580476,47,64,-113,736,128,95,1082,44
5,-7,0,5.0,-7.0,0.5896091461181641,99.31364309095659,47,59,-106,736,128,95,1082,44
6,-6,0,6.0,-6.0,0.59775710105896,91.17685275708986,47,53,-100,736,128,95,1082,44
5,-7,0,5.0,-7.0,0.6058471202850342,82.65658125507444,47,48,-93,736,128,95,1082,44
5,-6,0,5.0,-6.0,0.6136422157287598,75.04638066409278,47,43,-87,736,128,95,1082,44
4,-8,0,4.0,-8.0,0.6216771602630615,66.10221336606703,47,39,-79,736,128,95,1082,44
6,-7,0,6.0,-7.0,0.6298141479492188,57.202272694664515,47,33,-72,736,128,95,1082,44
4,-6,0,4.0,-6.0,0.6375820636749268,50.09022125087424,47,29,-66,736,128,95,1082,44
4,-6,0,4.0,-6.0,0.645747184753418,43.0,47,25,-60,736,128,95,1082,44
3,-5,0,3.0,-5.0,0.6537771224975586,37.23681287847955,47,22,-55,736,128,95,1082,44
3,-6,0,3.0,-6.0,0.6616480350494385,30.55473337388365,47,19,-49,736,128,95,1082,44
3,-4,0,3.0,-4.0,0.6696140766143799,25.75981574503821,47,16,-45,736,128,95,1082,44
2,-5,0,2.0,-5.0,0.6776552200317383,20.379240200834182,47,14,-40,736,128,95,1082,44
2,-4,0,2.0,-4.0,0.6856832504272461,15.947331922020552,47,12,-36,736,128,95,1082,44
1,-3,0,1.0,-3.0,0.6937141418457031,12.785054261852174,47,11,-33,736,128,95,1082,44
1,-2,0,1.0,-2.0,0.7015831470489502,10.57299494980466,47,10,-31,736,128,95,1082,44
0,-1,0,-0.0,-1.0,0.7096691131591797,9.622776601683793,47,10,-30,736,128,95,1082,44
0,0,1,-0.0,-0.0,0.7447152137756348,9.622776601683793,47,10,-30,736,128,95,1082,44
0,0,0,-0.0,-0.0,0.09139180183410645,203.11703976023054,48,157,132,883,290,726,158,5
-1,0,0,-1.0,-0.0,0.14554476737976074,203.8834621818858,48,158,132,883,290,726,158,5
-2,0,0,-2.0,-0.0,0.15358686447143555,205.42227459942677,48,160,132,883,290,726,158,5
-2,1,0,-2.0,1.0,0.16147494316101074,206.33866659840174,48,162,131,883,290,726,158,5
-2,2,0,-2.0,2.0,0.16933298110961914,206.65521800328887,48,164,129,883,290,726,158,5
0,4,0,-0.0,4.0,0.1773669719696045,204.20620747203515,48,164,125,883,290,726,158,5
0,4,0,-0.0,4.0,0.18542790412902832,201.8062805705457,48,164,121,883,290,726,158,5
3,7,0,3.0,7.0,0.1934669017791748,195.27392123643713,48,161,114,883,290,726,158,5
5,6,0,5.0,6.0,0.20146799087524414,187.73665961010275,48,156,108,883,290,726,158,5
8,6,0,8.0,6.0,0.20949482917785645,177.74426277353055,48,148,102,883,290,726,158,5
10,7,0,10.0,7.0,0.21746587753295898,165.53805537847214,48,138,95,883,290,726,158,5
13,6,0,13.0,6.0,0.22547292709350586,151.44705927452634,48,125,89,883,290,726,158,5
16,8,0,16.0,8.0,0.2335667610168457,133.80132547217644,48,109,81,883,290,726,158,5
20,9,0,20.0,9.0,0.24144792556762695,112.47707194019246,48,89,72,883,290,726,158,5
20,8,0,20.0,8.0,0.2495718002319336,92.11163583744573,48,69,64,883,290,726,158,5
21,8,0,21.0,8.0,0.2574279308319092,71.7563556583431,48,48,56,883,290,726,158,5
18,6,0,18.0,6.0,0.2654838562011719,56.309518948453004,48,30,50,883,290,726,158,5
13,6,0,13.0,6.0,0.27349376678466797,45.16990566028302,48,17,44,883,290,726,158,5
9,5,0,9.0,5.0,0.28154897689819336,37.81205847478876,48,8,39,883,290,726,158,5
8,5,0,8.0,5.0,0.28952479362487793,32.0,48,0,34,883,290,726,158,5
5,4,0,5.0,4.0,0.2975127696990967,28.4138126514911,48,-5,30,883,290,726,158,5
4,3,0,4.0,3.0,0.30549192428588867,26.460498941515414,48,-9,27,883,290,726,158,5
2,2,0,2.0,2.0,0.3133859634399414,25.313000567495326,48,-11,25,883,290,726,158,5
1,1,0,1.0,1.0,0.3213827610015869,24.832815729997478,48,-12,24,883,290,726,158,5
0,1,0,-0.0,1.0,0.3295409679412842,23.942243542145693,48,-12,23,883,290,726,158,5
-1,0,0,-1.0,-0.0,0.3695847988128662,23.495097567963924,48,-11,23,883,290,726,158,5
-3,1,0,-3.0,1.0,0.37746381759643555,21.40939982143925,48,-8,22,883,290,726,158,5
-2,1,0,-2.0,1.0,0.38559985160827637,19.840329667841555,48,-6,21,883,290,726,158,5
-2,0,0,-2.0,-0.0,0.39351487159729004,19.37755832643195,48,-4,21,883,290,726,158,5
0,1,0,-0.0,1.0,0.40144896507263184,18.396078054371138,48,-4,20,883,290,726,158,5
-2,0,0,-2.0,-0.0,0.409531831741333,18.09975124224178,48,-2,20,883,290,726,158,5
-2,1,0,-2.0,1.0,0.41759681701660156,17.0,48,0,19,883,290,726,158,5
-1,0,0,-1.0,-0.0,0.42555689811706543,17.026297590440446,48,1,19,883,290,726,158,5
-1,1,0,-1.0,1.0,0.433398962020874,16.110770276274835,48,2,18,883,290,726,158,5
-1,1,0,-1.0,1.0,0.44157981872558594,15.262676501632068,48,3,17,883,290,726,158,5
-1,1,0,-1.0,1.0,0.44972777366638184,14.492422502470642,48,4,16,883,290,726,158,5
-1,1,0,-1.0,1.0,0.4655587673187256,13.811388300841896,48,5,15,883,290,726,158,5
0,1,0,-0.0,1.0,0.47334980964660645,12.866068747318506,48,5,14,883,290,726,158,5
1,2,0,1.0,2.0,0.6335649490356445,10.649110640673518,48,4,12,883,290,726,158,5
1,1,0,1.0,1.0,0.6414768695831299,9.40175425099138,48,3,11,883,290,726,158,5
1,1,0,1.0,1.0,0.6495468616485596,8.198039027185569,48,2,10,883,290,726,158,5
1,1,0,1.0,1.0,0.657418966293335,7.055385138137417,48,1,9,883,290,726,158,5
0,1,0,-0.0,1.0,0.6655869483947754,6.062257748298549,48,1,8,883,290,726,158,5
0,1,0,-0.0,1.0,0.6734769344329834,5.0710678118654755,48,1,7,883,290,726,158,5
1,0,0,1.0,-0.0,0.6814959049224854,5.0,48,0,7,883,290,726,158,5
0,1,0,-0.0,1.0,0.6894857883453369,4.0,48,0,6,883,290,726,158,5
0,1,0,-0.0,1.0,0.6974778175354004,3.0,48,0,5,883,290,726,158,5
0,0,1,-0.0,-0.0,0.7034609317779541,3.0,48,0,5,883,290,726,158,5
1,1,1,1.0,1.0,0.7066738605499268,2.1231056256176606,48,-1,4,883,290,726,158,5
0,1,1,-0.0,1.0,0.7133958339691162,1.1622776601683795,48,-1,3,883,290,726,158,5
0,1,1,-0.0,1.0,0.7455339431762695,0.2360679774997898,48,-1,2,883,290,726,158,5
1,1,1,1.0,1.0,0.753532886505127,0.2360679774997898,48,-2,1,883,290,726,158,5
0,1,1,-0.0,1.0,0.7614688873291016,0.0,48,-2,0,883,290,726,158,5
0,1,1,-0.0,1.0,0.7775769233703613,0.2360679774997898,48,-2,-1,883,290,726,158,5
0,0,0,-0.0,-0.0,0.8227028846740723,0.2360679774997898,48,-2,-1,883,290,726,158,5
0,0,1,-0.0,-0.0,0.9216139316558838,0.2360679774997898,48,-2,-1,883,290,726,158,5
0,0,0,-0.0,-0.0,0.20774173736572266,564.1881312779349,49,555,112,1440,403,885,291,4
3,3,0,3.0,3.0,0.24370455741882324,560.6588664546218,49,552,109,1440,403,885,291,4
3,4,0,3.0,4.0,0.25170373916625977,556.9508028440428,49,549,105,1440,403,885,291,4
2,2,0,2.0,2.0,0.2597775459289551,554.6129714622181,49,547,103,1440,403,885,291,4
3,0,0,3.0,-0.0,0.2677185535430908,551.6650612057799,49,544,103,1440,403,885,291,4
2,2,0,2.0,2.0,0.2755575180053711,549.3302095840568,49,542,101,1440,403,885,291,4
2,0,0,2.0,-0.0,0.2836587429046631,547.3641779366397,49,540,101,1440,403,885,291,4
2,1,0,2.0,1.0,0.2915825843811035,545.2147658826468,49,538,100,1440,403,885,291,4
2,1,0,2.0,1.0,0.2996096611022949,543.0660510433574,49,536,99,1440,403,885,291,4
3,0,0,3.0,-0.0,0.30767273902893066,540.1162237011544,49,533,99,1440,403,885,291,4
3,0,0,3.0,-0.0,0.31566452980041504,537.1669500256854,49,530,99,1440,403,885,291,4
4,2,0,4.0,2.0,0.32386064529418945,532.8691428751522,49,526,97,1440,403,885,291,4
4,1,0,4.0,1.0,0.33161067962646484,528.7541803886239,49,522,96,1440,403,885,291,4
6,1,0,6.0,1.0,0.33954358100891113,522.6722786654542,49,516,95,1440,403,885,291,4
9,2,0,9.0,2.0,0.3475916385650635,513.4590187396084,49,507,93,1440,403,885,291,4
13,4,0,13.0,4.0,0.35567760467529297,499.9531850680898,49,494,89,1440,403,885,291,4
17,4,0,17.0,4.0,0.3636176586151123,482.5141896786925,49,477,85,1440,403,885,291,4
19,4,0,19.0,4.0,0.37163853645324707,463.1075144523038,49,458,81,1440,403,885,291,4
24,6,0,24.0,6.0,0.37964963912963867,438.4327417438445,49,434,75,1440,403,885,291,4
27,6,0,27.0,6.0,0.3876485824584961,410.8074611728814,49,407,69,1440,403,885,291,4
30,6,0,30.0,6.0,0.3955976963043213,380.227680839575,49,377,63,1440,403,885,291,4
32,5,0,32.0,5.0,0.4036827087402344,347.84139263386203,49,345,58,1440,403,885,291,4
31,5,0,31.0,5.0,0.4116096496582031,316.44151739369664,49,314,53,1440,403,885,291,4
31,4,0,31.0,4.0,0.4195556640625,285.2107240337658,49,283,49,1440,403,885,291,4
29,4,0,29.0,4.0,0.4276297092437744,255.9554225055174,49,254,45,1440,403,885,291,4
28,4,0,28.0,4.0,0.4356865882873535,227.68892006363737,49,226,41,1440,403,885,291,4
26,4,0,26.0,4.0,0.4440736770629883,201.39370688396434,49,200,37,1440,403,885,291,4
27,3,0,27.0,3.0,0.4516277313232422,174.30938715791623,49,173,34,1440,403,885,291,4
26,4,0,26.0,4.0,0.45983052253723145,148.02999700059985,49,147,30,1440,403,885,291,4
20,2,0,20.0,2.0,0.46843457221984863,128.04999038831184,49,127,28,1440,403,885,291,4
17,2,0,17.0,2.0,0.4759976863861084,111.03096920755833,49,110,26,1440,403,885,291,4
13,1,0,13.0,1.0,0.4838826656341553,98.16985574512923,49,97,25,1440,403,885,291,4
11,2,0,11.0,2.0,0.491729736328125,87.02246907382428,49,86,23,1440,403,885,291,4
7,0,0,7.0,-0.0,0.4997596740722656,80.28000972289685,49,79,23,1440,403,885,291,4
6,0,0,6.0,-0.0,0.5077495574951172,74.53757247260981,49,73,23,1440,403,885,291,4
3,0,0,3.0,-0.0,0.5155596733093262,71.68174807915459,49,70,23,1440,403,885,291,4
1,0,0,1.0,-0.0,0.5236036777496338,70.73238618387272,49,69,23,1440,403,885,291,4
1,0,0,1.0,-0.0,0.5480077266693115,69.78439941937245,49,68,23,1440,403,885,291,4
1,1,0,1.0,1.0,0.5718395709991455,68.51950084905593,49,67,22,1440,403,885,291,4
1,0,0,1.0,-0.0,0.5877785682678223,67.57010852370435,49,66,22,1440,403,885,291,4
1,1,0,1.0,1.0,0.6041855812072754,66.30812543175226,49,65,21,1440,403,885,291,4
1,0,0,1.0,-0.0,0.6116526126861572,65.35725647619564,49,64,21,1440,403,885,291,4
1,2,0,1.0,2.0,0.6202225685119629,63.80273550544841,49,63,19,1440,403,885,291,4
2,1,0,2.0,1.0,0.6277856826782227,61.60031446463138,49,61,18,1440,403,885,291,4
