dx,dy,button,rx,ry,time,distance,targetID,directionX,directionY,targetX,targetY,initMouseX,initMouseY,targetSize
0,0,0,-0.0,-0.0,0.7431426048278809,469.2003756258962,1,-383,-288,574,310,957,598,20
-1,0,0,-1.0,-0.0,0.8433516025543213,468.40150501435505,1,-382,-288,574,310,957,598,20
-7,1,0,-7.0,1.0,0.8519856929779053,463.44059817468127,1,-375,-289,574,310,957,598,20
-10,1,0,-10.0,1.0,0.8591375350952148,456.1812952060604,1,-365,-290,574,310,957,598,20
-16,-1,0,-16.0,-1.0,0.8671677112579346,443.1247068964569,1,-349,-289,574,310,957,598,20
-20,-6,0,-20.0,-6.0,0.8750886917114258,423.9700450491946,1,-329,-283,574,310,957,598,20
-23,-9,0,-23.0,-9.0,0.8830745220184326,400.7456633976797,1,-306,-274,574,310,957,598,20
-23,-12,0,-23.0,-12.0,0.8911416530609131,375.6591759572174,1,-283,-262,574,310,957,598,20
-23,-13,0,-23.0,-13.0,0.899012565612793,350.0013888862097,1,-260,-249,574,310,957,598,20
-22,-10,0,-22.0,-10.0,0.9070756435394287,327.2906758272455,1,-238,-239,574,310,957,598,20
-20,-12,0,-20.0,-12.0,0.9152586460113525,304.7268657105713,1,-218,-227,574,310,957,598,20
-18,-11,0,-18.0,-11.0,0.9231696128845215,284.37391188758556,1,-200,-216,574,310,957,598,20
-15,-12,0,-15.0,-12.0,0.931694746017456,265.3924472457442,1,-185,-204,574,310,957,598,20
-13,-8,0,-13.0,-8.0,0.9391946792602539,250.76809620810593,1,-172,-196,574,310,957,598,20
-11,-8,0,-11.0,-8.0,0.9472687244415283,237.51767613647314,1,-161,-188,574,310,957,598,20
-9,-6,0,-9.0,-6.0,0.9554145336151123,227.12443990445186,1,-152,-182,574,310,957,598,20
-4,-4,0,-4.0,-4.0,0.9631385803222656,221.49082055234933,1,-148,-178,574,310,957,598,20
-1,-3,0,-1.0,-3.0,0.9710836410522461,218.5475880424031,1,-147,-175,574,310,957,598,20
0,-3,0,-0.0,-3.0,0.9792065620422363,216.25870149013053,1,-147,-172,574,310,957,598,20
-1,-5,0,-1.0,-5.0,0.9871556758880615,211.82200071228283,1,-146,-167,574,310,957,598,20
0,-6,0,-0.0,-6.0,0.9951057434082031,207.3407462948446,1,-146,-161,574,310,957,598,20
0,-6,0,-0.0,-6.0,1.0031626224517822,202.93426215618754,1,-146,-155,574,310,957,598,20
0,-4,0,-0.0,-4.0,1.0113236904144287,200.0404722904612,1,-146,-151,574,310,957,598,20
0,-4,0,-0.0,-4.0,1.0192925930023193,197.18349355100662,1,-146,-147,574,310,957,598,20
0,-4,0,-0.0,-4.0,1.0272767543792725,194.36486977951958,1,-146,-143,574,310,957,598,20
0,-5,0,-0.0,-5.0,1.0351767539978027,190.89798406156294,1,-146,-138,574,310,957,598,20
0,-4,0,-0.0,-4.0,1.0432446002960205,188.17164277464119,1,-146,-134,574,310,957,598,20
0,-4,0,-0.0,-4.0,1.0511066913604736,185.48913013259843,1,-146,-130,574,310,957,598,20
0,-5,0,-0.0,-5.0,1.0590016841888428,182.20041623263984,1,-146,-125,574,310,957,598,20
-1,-5,0,-1.0,-5.0,1.0670735836029053,178.2153022471871,1,-145,-120,574,310,957,598,20
-2,-5,0,-2.0,-5.0,1.0753846168518066,173.50476833041697,1,-143,-115,574,310,957,598,20
-3,-6,0,-3.0,-6.0,1.0834627151489258,167.4288589829738,1,-140,-109,574,310,957,598,20
-4,-6,0,-4.0,-6.0,1.091139554977417,160.60187572239644,1,-136,-103,574,310,957,598,20
-5,-7,0,-5.0,-7.0,1.0992026329040527,152.40997506310995,1,-131,-96,574,310,957,598,20
-6,-7,0,-6.0,-7.0,1.1071467399597168,143.44705927452634,1,-125,-89,574,310,957,598,20
-7,-6,0,-7.0,-6.0,1.1151466369628906,134.26711336961034,1,-118,-83,574,310,957,598,20
-5,-5,0,-5.0,-5.0,1.1231696605682373,127.3062270984095,1,-113,-78,574,310,957,598,20
-6,-5,0,-6.0,-5.0,1.1311495304107666,119.52991932368366,1,-107,-73,574,310,957,598,20
-5,-5,0,-5.0,-5.0,1.1390876770019531,112.58874336577564,1,-102,-68,574,310,957,598,20
-5,-5,0,-5.0,-5.0,1.1477477550506592,105.66330446602328,1,-97,-63,574,310,957,598,20
-4,-4,0,-4.0,-4.0,1.1553025245666504,100.13627921806692,1,-93,-59,574,310,957,598,20
-5,-5,0,-5.0,-5.0,1.1633846759796143,93.24727599312246,1,-88,-54,574,310,957,598,20
-3,-3,0,-3.0,-3.0,1.171149730682373,89.12618221237011,1,-85,-51,574,310,957,598,20
-3,-2,0,-3.0,-2.0,1.18011474609375,85.524865872714,1,-82,-49,574,310,957,598,20
-4,-2,0,-4.0,-2.0,1.187065601348877,81.0659101969557,1,-78,-47,574,310,957,598,20
-2,-1,0,-2.0,-1.0,1.1950335502624512,78.83692925805124,1,-76,-46,574,310,957,598,20
-3,-1,0,-3.0,-1.0,1.2030525207519531,75.75546629807339,1,-73,-45,574,310,957,598,20
-2,-1,0,-2.0,-1.0,1.211538553237915,73.52843827104634,1,-71,-44,574,310,957,598,20
-3,-1,0,-3.0,-1.0,1.219132661819458,70.45495634204272,1,-68,-43,574,310,957,598,20
-3,-1,0,-3.0,-1.0,1.2271716594696045,67.38862965578342,1,-65,-42,574,310,957,598,20
-3,-1,0,-3.0,-1.0,1.235013723373413,64.33034373659252,1,-62,-41,574,310,957,598,20
-3,-1,0,-3.0,-1.0,1.2432215213775635,61.28113354878694,1,-59,-40,574,310,957,598,20
-2,-1,0,-2.0,-1.0,1.2511286735534668,59.06518659932803,1,-57,-39,574,310,957,598,20
-4,-2,0,-4.0,-2.0,1.2590315341949463,54.63745044476924,1,-53,-37,574,310,957,598,20
-2,-2,0,-2.0,-2.0,1.2671356201171875,51.85466837676846,1,-51,-35,574,310,957,598,20
-2,-2,0,-2.0,-2.0,1.274991750717163,49.07622195096772,1,-49,-33,574,310,957,598,20
-1,-2,0,-1.0,-2.0,1.2831816673278809,47.14017850864661,1,-48,-31,574,310,957,598,20
-1,-3,0,-1.0,-3.0,1.2911756038665771,44.70831746635972,1,-47,-28,574,310,957,598,20
-1,-2,0,-1.0,-2.0,1.2991347312927246,42.839379254491625,1,-46,-26,574,310,957,598,20
-1,-3,0,-1.0,-3.0,1.3070926666259766,40.53711507397311,1,-45,-23,574,310,957,598,20
-1,-2,0,-1.0,-2.0,1.315063714981079,38.75448697299562,1,-44,-21,574,310,957,598,20
-2,-2,0,-2.0,-2.0,1.3230805397033691,36.09772228646444,1,-42,-19,574,310,957,598,20
-2,-2,0,-2.0,-2.0,1.3310637474060059,33.46262762420146,1,-40,-17,574,310,957,598,20
-2,-1,0,-2.0,-1.0,1.3392555713653564,31.231056256176608,1,-38,-16,574,310,957,598,20
-2,-1,0,-2.0,-1.0,1.347106695175171,29.0,1,-36,-15,574,310,957,598,20
-2,-1,0,-2.0,-1.0,1.3554296493530273,26.76955262170047,1,-34,-14,574,310,957,598,20
-2,-1,0,-2.0,-1.0,1.3630547523498535,24.539832078341085,1,-32,-13,574,310,957,598,20
-2,0,0,-2.0,-0.0,1.3712115287780762,22.695565448543633,1,-30,-13,574,310,957,598,20
-2,-1,0,-2.0,-1.0,1.379051685333252,20.463092423455635,1,-28,-12,574,310,957,598,20
-1,-1,0,-1.0,-1.0,1.387162685394287,19.154759474226502,1,-27,-11,574,310,957,598,20
-2,-1,0,-2.0,-1.0,1.3950517177581787,16.92582403567252,1,-25,-10,574,310,957,598,20
-2,-1,0,-2.0,-1.0,1.4029877185821533,14.698178070456937,1,-23,-9,574,310,957,598,20
-3,-1,0,-3.0,-1.0,1.4109387397766113,11.540659228538015,1,-20,-8,574,310,957,598,20
-2,-1,0,-2.0,-1.0,1.4192557334899902,9.313207915827967,1,-18,-7,574,310,957,598,20
-2,-1,0,-2.0,-1.0,1.4269757270812988,7.088007490635061,1,-16,-6,574,310,957,598,20
-3,0,0,-3.0,-0.0,1.4349255561828613,4.317821063276353,1,-13,-6,574,310,957,598,20
-3,-2,0,-3.0,-2.0,1.4429285526275635,0.7703296142690075,1,-10,-4,574,310,957,598,20
-3,0,0,-3.0,-0.0,1.4509456157684326,-1.9377422517014509,1,-7,-4,574,310,957,598,20
-2,-1,0,-2.0,-1.0,1.4589977264404297,-4.169048105154699,1,-5,-3,574,310,957,598,20
-1,-1,0,-1.0,-1.0,1.46693754196167,-5.52786404500042,1,-4,-2,574,310,957,598,20
-1,0,0,-1.0,-0.0,1.4831476211547852,-6.39444872453601,1,-3,-2,574,310,957,598,20
0,0,1,-0.0,-0.0,1.4861626625061035,-6.39444872453601,1,-3,-2,574,310,957,598,20
0,0,0,-0.0,-0.0,0.06899547576904297,429.4806826728341,2,-47,444,530,756,577,312,34
2,0,0,2.0,-0.0,0.13705039024353027,429.6956458261038,2,-49,444,530,756,577,312,34
4,1,0,4.0,1.0,0.14500641822814941,429.15916442453585,2,-53,443,530,756,577,312,34
4,1,0,4.0,1.0,0.15305352210998535,428.66018444550326,2,-57,442,530,756,577,312,34
3,1,0,3.0,1.0,0.16102957725524902,428.0629169005209,2,-60,441,530,756,577,312,34
2,2,0,2.0,2.0,0.16919851303100586,426.3565156846124,2,-62,439,530,756,577,312,34
2,1,0,2.0,1.0,0.17709851264953613,425.6511041441103,2,-64,438,530,756,577,312,34
2,4,0,2.0,4.0,0.1850893497467041,421.98974931084666,2,-66,434,530,756,577,312,34
1,5,0,1.0,5.0,0.1929943561553955,417.20041455530645,2,-67,429,530,756,577,312,34
1,9,0,1.0,9.0,0.20109844207763672,408.46915281839176,2,-68,420,530,756,577,312,34
0,9,0,-0.0,9.0,0.20911049842834473,399.58732577936166,2,-68,411,530,756,577,312,34
0,11,0,-0.0,11.0,0.21715235710144043,388.73883225543005,2,-68,400,530,756,577,312,34
-3,15,0,-3.0,15.0,0.22502946853637695,373.4484601070927,2,-65,385,530,756,577,312,34
-3,15,0,-3.0,15.0,0.2330033779144287,358.15863311404684,2,-62,370,530,756,577,312,34
-3,14,0,-3.0,14.0,0.24118638038635254,343.855926929294,2,-59,356,530,756,577,312,34
-4,13,0,-4.0,13.0,0.24905157089233398,330.3816345174281,2,-55,343,530,756,577,312,34
-4,13,0,-4.0,13.0,0.25704336166381836,316.91765451979325,2,-51,330,530,756,577,312,34
-3,13,0,-3.0,13.0,0.26508641242980957,303.6134744517142,2,-48,317,530,756,577,312,34
-4,14,0,-4.0,14.0,0.27312445640563965,289.1780527732189,2,-44,303,530,756,577,312,34
-3,13,0,-3.0,13.0,0.28116536140441895,275.8839360565888,2,-41,290,530,756,577,312,34
-5,15,0,-5.0,15.0,0.2891354560852051,260.34635386101615,2,-36,275,530,756,577,312,34
-6,17,0,-6.0,17.0,0.2983064651489258,242.73832986296037,2,-30,258,530,756,577,312,34
-8,17,0,-8.0,17.0,0.30517148971557617,225.00206610688264,2,-22,241,530,756,577,312,34
-7,16,0,-7.0,16.0,0.3130924701690674,208.49944567559362,2,-15,225,530,756,577,312,34
-7,14,0,-7.0,14.0,0.32114744186401367,194.15160430363773,2,-8,211,530,756,577,312,34
-5,11,0,-5.0,11.0,0.3292264938354492,183.02249873451737,2,-3,200,530,756,577,312,34
-4,10,0,-4.0,10.0,0.33724546432495117,173.0026315607234,2,1,190,530,756,577,312,34
-2,8,0,-2.0,8.0,0.3452024459838867,165.02472359545007,2,3,182,530,756,577,312,34
-1,7,0,-1.0,7.0,0.35334348678588867,158.04570831642803,2,4,175,530,756,577,312,34
-2,8,0,-2.0,8.0,0.3612074851989746,150.10774967068403,2,6,167,530,756,577,312,34
-1,8,0,-1.0,8.0,0.36924147605895996,142.15401345866212,2,7,159,530,756,577,312,34
-2,7,0,-2.0,7.0,0.37717342376708984,135.26621424334422,2,9,152,530,756,577,312,34
0,7,0,-0.0,7.0,0.3849294185638428,128.27904184706065,2,9,145,530,756,577,312,34
0,4,0,-0.0,4.0,0.39318346977233887,124.28694207179942,2,9,141,530,756,577,312,34
0,5,0,-0.0,5.0,0.40128040313720703,119.2974687952788,2,9,136,530,756,577,312,34
0,3,0,-0.0,3.0,0.4090275764465332,116.30416347586447,2,9,133,530,756,577,312,34
0,4,0,-0.0,4.0,0.4171445369720459,112.31357237351384,2,9,129,530,756,577,312,34
0,3,0,-0.0,3.0,0.4250824451446533,109.3210196285638,2,9,126,530,756,577,312,34
1,4,0,1.0,4.0,0.4334714412689209,105.2620137246234,2,8,122,530,756,577,312,34
0,5,0,-0.0,5.0,0.44116735458374023,100.27318534089538,2,8,117,530,756,577,312,34
1,4,0,1.0,4.0,0.4494655132293701,96.21660655575224,2,7,113,530,756,577,312,34
0,4,0,-0.0,4.0,0.4571664333343506,92.22453936730518,2,7,109,530,756,577,312,34
1,4,0,1.0,4.0,0.4651224613189697,88.17128885774862,2,6,105,530,756,577,312,34
1,3,0,1.0,3.0,0.4731113910675049,85.12247548899312,2,5,102,530,756,577,312,34
1,4,0,1.0,4.0,0.4810314178466797,81.08159868191383,2,4,98,530,756,577,312,34
0,4,0,-0.0,4.0,0.489194393157959,77.08506789071261,2,4,94,530,756,577,312,34
0,5,0,-0.0,5.0,0.4971303939819336,72.08984229416954,2,4,89,530,756,577,312,34
0,5,0,-0.0,5.0,0.5052103996276855,67.09518416651456,2,4,84,530,756,577,312,34
1,5,0,1.0,5.0,0.5133533477783203,62.05694150420949,2,3,79,530,756,577,312,34
0,4,0,-0.0,4.0,0.5212814807891846,58.05997601918082,2,3,75,530,756,577,312,34
0,4,0,-0.0,4.0,0.5291085243225098,54.06335201775947,2,3,71,530,756,577,312,34
0,5,0,-0.0,5.0,0.5370645523071289,49.06814663663572,2,3,66,530,756,577,312,34
-1,5,0,-1.0,5.0,0.5450384616851807,44.1310068623117,2,4,61,530,756,577,312,34
0,4,0,-0.0,4.0,0.5530235767364502,40.14017850864661,2,4,57,530,756,577,312,34
-1,6,0,-1.0,6.0,0.5611605644226074,34.24451190127583,2,5,51,530,756,577,312,34
0,5,0,-0.0,5.0,0.569204568862915,29.270941205037097,2,5,46,530,756,577,312,34
0,4,0,-0.0,4.0,0.5770463943481445,25.296571965113202,2,5,42,530,756,577,312,34
-1,4,0,-1.0,4.0,0.5850975513458252,21.470768123342687,2,6,38,530,756,577,312,34
0,3,0,-0.0,3.0,0.593219518661499,18.510561809129406,2,6,35,530,756,577,312,34
0,4,0,-0.0,4.0,0.6012234687805176,14.575306807693888,2,6,31,530,756,577,312,34
0,3,0,-0.0,3.0,0.6091485023498535,11.635642126552707,2,6,28,530,756,577,312,34
0,3,0,-0.0,3.0,0.6171295642852783,8.709920264364882,2,6,25,530,756,577,312,34
0,2,0,-0.0,2.0,0.625185489654541,6.769728648009426,2,6,23,530,756,577,312,34
0,2,0,-0.0,2.0,0.6330773830413818,4.840329667841555,2,6,21,530,756,577,312,34
0,2,0,-0.0,2.0,0.6410784721374512,2.9248588451712756,2,6,19,530,756,577,312,34
0,2,0,-0.0,2.0,0.6491954326629639,1.027756377319946,2,6,17,530,756,577,312,34
0,2,0,-0.0,2.0,0.6571784019470215,-0.8445055785964897,2,6,15,530,756,577,312,34
0,1,0,-0.0,1.0,0.6651513576507568,-1.7684537882721827,2,6,14,530,756,577,312,34
0,1,0,-0.0,1.0,0.6741034984588623,-2.6821789367236466,2,6,13,530,756,577,312,34
0,0,1,-0.0,-0.0,0.6802175045013428,-2.6821789367236466,2,6,13,530,756,577,312,34
0,1,1,-0.0,1.0,0.6812944412231445,-3.583592135001261,2,6,12,530,756,577,312,34
0,0,0,-0.0,-0.0,0.7621283531188965,-3.583592135001261,2,6,12,530,756,577,312,34
2,0,0,2.0,-0.0,0.8171384334564209,-4.350889359326482,2,4,12,530,756,577,312,34
3,-1,0,3.0,-1.0,0.8250315189361572,-3.9615951895947017,2,1,13,530,756,577,312,34
4,-1,0,4.0,-1.0,0.8330714702606201,-2.6821789367236466,2,-3,14,530,756,577,312,34
3,-2,0,3.0,-2.0,0.8411264419555664,0.08800749063506075,2,-6,16,530,756,577,312,34
2,-2,0,2.0,-2.0,0.8491613864898682,2.697715603592208,2,-8,18,530,756,577,312,34
3,-2,0,3.0,-2.0,0.857215404510498,5.8254244210266535,2,-11,20,530,756,577,312,34
2,-1,0,2.0,-1.0,0.8653473854064941,7.698178070456937,2,-13,21,530,756,577,312,34
1,-2,0,1.0,-2.0,0.8732435703277588,9.92582403567252,2,-14,23,530,756,577,312,34
2,-2,0,2.0,-2.0,0.8811404705047607,12.68164415931166,2,-16,25,530,756,577,312,34
2,-1,0,2.0,-1.0,0.8891844749450684,14.622776601683793,2,-18,26,530,756,577,312,34
1,0,0,1.0,-0.0,0.897071361541748,15.202484376209235,2,-19,26,530,756,577,312,34
0,-1,0,-0.0,-1.0,0.9051365852355957,16.015148038438355,2,-19,27,530,756,577,312,34
0,2,0,-0.0,2.0,0.9531574249267578,14.400636936215164,2,-19,25,530,756,577,312,34
0,4,0,-0.0,4.0,0.9610755443572998,11.319604517012593,2,-19,21,530,756,577,312,34
-1,4,0,-1.0,4.0,0.9688963890075684,7.758836806279895,2,-18,17,530,756,577,312,34
-1,2,0,-1.0,2.0,0.9771385192871094,5.671568097509269,2,-17,15,530,756,577,312,34
0,2,0,-0.0,2.0,0.9850635528564453,4.400934559032695,2,-17,13,530,756,577,312,34
0,2,0,-0.0,2.0,0.9931235313415527,3.248456731316587,2,-17,11,530,756,577,312,34
0,0,1,-0.0,-0.0,0.9975354671478271,3.248456731316587,2,-17,11,530,756,577,312,34
-1,1,1,-1.0,1.0,1.0010933876037598,1.8679622641132063,2,-16,10,530,756,577,312,34
0,1,1,-0.0,1.0,0.007620334625244141,356.55469397123426,3,-371,-34,175,713,546,746,32
0,0,0,-0.0,-0.0,0.0734403133392334,356.55469397123426,3,-371,-34,175,713,546,746,32
1,-2,0,1.0,-2.0,0.1915903091430664,357.3738073298661,3,-372,-32,175,713,546,746,32
2,-3,0,2.0,-3.0,0.19954633712768555,359.12264661041195,3,-374,-29,175,713,546,746,32
2,-2,0,2.0,-2.0,0.20748138427734375,360.9681684174408,3,-376,-27,175,713,546,746,32
1,-3,0,1.0,-3.0,0.21553635597229004,361.7631533117014,3,-377,-24,175,713,546,746,32
0,-4,0,-0.0,-4.0,0.22352337837219238,361.530131247825,3,-377,-20,175,713,546,746,32
0,-4,0,-0.0,-4.0,0.23149323463439941,361.3393697985939,3,-377,-16,175,713,546,746,32
-2,-6,0,-2.0,-6.0,0.2395951747894287,359.13330963805384,3,-375,-10,175,713,546,746,32
-3,-5,0,-3.0,-5.0,0.2476813793182373,356.0336006330611,3,-372,-5,175,713,546,746,32
-4,-3,0,-4.0,-3.0,0.2555973529815674,352.0054347424777,3,-368,-2,175,713,546,746,32
-4,-3,0,-4.0,-3.0,0.26366639137268066,348.00137362378183,3,-364,1,175,713,546,746,32
-5,-2,0,-5.0,-2.0,0.2716712951660156,343.01253460011674,3,-359,3,175,713,546,746,32
-7,-3,0,-7.0,-3.0,0.27963733673095703,336.05113264978996,3,-352,6,175,713,546,746,32
-12,-2,0,-12.0,-2.0,0.2876853942871094,324.0941046239996,3,-340,8,175,713,546,746,32
-17,-2,0,-17.0,-2.0,0.2956063747406006,307.154761685481,3,-323,10,175,713,546,746,32
-21,-2,0,-21.0,-2.0,0.3035743236541748,286.2383165649253,3,-302,12,175,713,546,746,32
-23,0,0,-23.0,-0.0,0.3115673065185547,263.2579452764057,3,-279,12,175,713,546,746,32
-22,0,0,-22.0,-0.0,0.3199193477630615,241.2800031094527,3,-257,12,175,713,546,746,32
-21,0,0,-21.0,-0.0,0.3276093006134033,220.30488780387088,3,-236,12,175,713,546,746,32
-20,2,0,-20.0,2.0,0.3356943130493164,200.23135757794242,3,-216,10,175,713,546,746,32
-16,2,0,-16.0,2.0,0.34360432624816895,184.15993605114886,3,-200,8,175,713,546,746,32
-13,2,0,-13.0,2.0,0.3515913486480713,171.09623192357455,3,-187,6,175,713,546,746,32
-10,2,0,-10.0,2.0,0.359600305557251,161.04519197086375,3,-177,4,175,713,546,746,32
-7,2,0,-7.0,2.0,0.36759519577026367,154.01176429882727,3,-170,2,175,713,546,746,32
-7,2,0,-7.0,2.0,0.3755931854248047,147.0,3,-163,0,175,713,546,746,32
-7,2,0,-7.0,2.0,0.38349437713623047,140.01281998605114,3,-156,-2,175,713,546,746,32
-6,0,0,-6.0,-0.0,0.3915243148803711,134.0133327407934,3,-150,-2,175,713,546,746,32
-5,2,0,-5.0,2.0,0.3994762897491455,129.0551619212498,3,-145,-4,175,713,546,746,32
-4,0,0,-4.0,-0.0,0.40747737884521484,125.05672617780408,3,-141,-4,175,713,546,746,32
-2,0,0,-2.0,-0.0,0.41553735733032227,123.05754204644924,3,-139,-4,175,713,546,746,32
-2,0,0,-2.0,-0.0,0.4234623908996582,121.05838172107534,3,-137,-4,175,713,546,746,32
-1,0,0,-1.0,-0.0,0.43149518966674805,120.0588108135596,3,-136,-4,175,713,546,746,32
-2,0,0,-2.0,-0.0,0.43933725357055664,118.05968819895114,3,-134,-4,175,713,546,746,32
-2,0,0,-2.0,-0.0,0.44761037826538086,116.06059215375342,3,-132,-4,175,713,546,746,32
-3,0,0,-3.0,-0.0,0.4554412364959717,113.06200060436069,3,-129,-4,175,713,546,746,32
-2,-1,0,-2.0,-1.0,0.4635603427886963,111.03542812932147,3,-127,-3,175,713,546,746,32
-4,-1,0,-4.0,-1.0,0.47196316719055176,107.01625908797584,3,-123,-2,175,713,546,746,32
-4,-1,0,-4.0,-1.0,0.47953033447265625,103.00420160649792,3,-119,-1,175,713,546,746,32
-4,-1,0,-4.0,-1.0,0.4875202178955078,99.0,3,-115,0,175,713,546,746,32
-4,-1,0,-4.0,-1.0,0.49566030502319336,95.00450441310929,3,-111,1,175,713,546,746,32
-4,-1,0,-4.0,-1.0,0.503502368927002,91.01868995647442,3,-107,2,175,713,546,746,32
-4,-1,0,-4.0,-1.0,0.5114822387695312,87.04368005850722,3,-103,3,175,713,546,746,32
-2,-1,0,-2.0,-1.0,0.5194642543792725,85.07917688624102,3,-101,4,175,713,546,746,32
-3,0,0,-3.0,-0.0,0.5277812480926514,82.08159868191383,3,-98,4,175,713,546,746,32
-1,-1,0,-1.0,-1.0,0.5356712341308594,81.12878049270464,3,-97,5,175,713,546,746,32
-2,0,0,-2.0,-0.0,0.5436193943023682,79.13148795220224,3,-95,5,175,713,546,746,32
-2,-1,0,-2.0,-1.0,0.5514001846313477,77.1933474020544,3,-93,6,175,713,546,746,32
-2,0,0,-2.0,-0.0,0.5596673488616943,75.19758768739445,3,-91,6,175,713,546,746,32
-2,0,0,-2.0,-0.0,0.5674183368682861,73.20201791439474,3,-89,6,175,713,546,746,32
-4,-1,0,-4.0,-1.0,0.5754551887512207,69.28774824088158,3,-85,7,175,713,546,746,32
-3,0,0,-3.0,-0.0,0.5834972858428955,66.29823813423954,3,-82,7,175,713,546,746,32
-4,0,0,-4.0,-0.0,0.5915813446044922,62.31347265956222,3,-78,7,175,713,546,746,32
-4,-1,0,-4.0,-1.0,0.599534273147583,58.43117626371358,3,-74,8,175,713,546,746,32
-4,0,0,-4.0,-0.0,0.6083223819732666,54.45565981523414,3,-70,8,175,713,546,746,32
-4,-1,0,-4.0,-1.0,0.6155543327331543,50.610809933523555,3,-66,9,175,713,546,746,32
-4,0,0,-4.0,-0.0,0.623563289642334,46.64982043070834,3,-62,9,175,713,546,746,32
-3,0,0,-3.0,-0.0,0.631690263748169,43.682493245507096,3,-59,9,175,713,546,746,32
-3,0,0,-3.0,-0.0,0.6394681930541992,40.71860364994893,3,-56,9,175,713,546,746,32
-2,0,0,-2.0,-0.0,0.6475732326507568,38.74486277268398,3,-54,9,175,713,546,746,32
-1,-1,0,-1.0,-1.0,0.6554582118988037,37.9351462406472,3,-53,10,175,713,546,746,32
-2,0,0,-2.0,-0.0,0.6635103225708008,35.97114584074513,3,-51,10,175,713,546,746,32
-1,0,0,-1.0,-0.0,0.6716172695159912,34.99019513592785,3,-50,10,175,713,546,746,32
-1,0,0,-1.0,-0.0,0.679490327835083,34.00999900019995,3,-49,10,175,713,546,746,32
-2,0,0,-2.0,-0.0,0.695824384689331,32.05205510693585,3,-47,10,175,713,546,746,32
-1,0,0,-1.0,-0.0,0.7115612030029297,31.07440918375928,3,-46,10,175,713,546,746,32
-1,0,0,-1.0,-0.0,0.7194101810455322,30.09772228646444,3,-45,10,175,713,546,746,32
0,0,1,-0.0,-0.0,0.7275533676147461,30.09772228646444,3,-45,10,175,713,546,746,32
-1,-1,1,-1.0,-1.0,0.7353873252868652,29.35416188179427,3,-44,11,175,713,546,746,32
-1,0,1,-1.0,-0.0,0.7434682846069336,28.384682042344295,3,-43,11,175,713,546,746,32
-2,0,1,-2.0,-0.0,0.7514853477478027,26.449970553582247,3,-41,11,175,713,546,746,32
-1,0,1,-1.0,-0.0,0.7594761848449707,25.484937025383083,3,-40,11,175,713,546,746,32
-1,0,1,-1.0,-0.0,0.767573356628418,24.52159917870962,3,-39,11,175,713,546,746,32
-2,0,1,-2.0,-0.0,0.775482177734375,22.600518131237564,3,-37,11,175,713,546,746,32
-2,0,1,-2.0,-0.0,0.783480167388916,20.68787265568828,3,-35,11,175,713,546,746,32
0,0,0,-0.0,-0.0,0.7893753051757812,20.68787265568828,3,-35,11,175,713,546,746,32
-2,0,0,-2.0,-0.0,0.7921032905578613,18.785054261852174,3,-33,11,175,713,546,746,32
-2,0,0,-2.0,-0.0,0.7993812561035156,16.89376840679705,3,-31,11,175,713,546,746,32
-1,0,0,-1.0,-0.0,0.8074321746826172,15.953090617340916,3,-30,11,175,713,546,746,32
-2,0,0,-2.0,-0.0,0.8154633045196533,14.083217912982647,3,-28,11,175,713,546,746,32
-2,0,0,-2.0,-0.0,0.8234553337097168,12.231188426986208,3,-26,11,175,713,546,746,32
-2,0,0,-2.0,-0.0,0.8314352035522461,10.40075756488817,3,-24,11,175,713,546,746,32
-2,1,0,-2.0,1.0,0.8394553661346436,8.166091947189145,3,-22,10,175,713,546,746,32
-1,0,0,-1.0,-0.0,0.8475492000579834,7.259406699226016,3,-21,10,175,713,546,746,32
-1,0,0,-1.0,-0.0,0.8554322719573975,6.360679774997898,3,-20,10,175,713,546,746,32
-1,0,0,-1.0,-0.0,0.8634781837463379,5.470910553583888,3,-19,10,175,713,546,746,32
-1,0,0,-1.0,-0.0,0.8713271617889404,4.591260281974002,3,-18,10,175,713,546,746,32
0,1,0,-0.0,1.0,0.8795263767242432,4.124611797498108,3,-18,9,175,713,546,746,32
0,0,1,-0.0,-0.0,0.9073631763458252,4.124611797498108,3,-18,9,175,713,546,746,32
0,0,0,-0.0,-0.0,0.09635043144226074,1481.4095471096573,4,1504,139,1697,843,193,704,59
1,0,0,1.0,-0.0,0.18825650215148926,1480.4137934973298,4,1503,139,1697,843,193,704,59
2,0,0,2.0,-0.0,0.1962285041809082,1478.4223031387057,4,1501,139,1697,843,193,704,59
5,1,0,5.0,1.0,0.20444059371948242,1473.3514901646686,4,1496,138,1697,843,193,704,59
7,0,0,7.0,-0.0,0.21220755577087402,1466.3812222975116,4,1489,138,1697,843,193,704,59
10,1,0,10.0,1.0,0.2203235626220703,1456.331612805706,4,1479,137,1697,843,193,704,59
14,1,0,14.0,1.0,0.22826743125915527,1442.2990858421683,4,1465,136,1697,843,193,704,59
20,1,0,20.0,1.0,0.23634743690490723,1422.2925273699993,4,1445,135,1697,843,193,704,59
25,1,0,25.0,1.0,0.24422359466552734,1397.3085220246005,4,1420,134,1697,843,193,704,59
30,2,0,30.0,2.0,0.25232553482055664,1367.2535586346771,4,1390,132,1697,843,193,704,59
40,1,0,40.0,1.0,0.2604236602783203,1327.3410338111871,4,1350,131,1697,843,193,704,59
43,3,0,43.0,3.0,0.2683224678039551,1284.2528317121573,4,1307,128,1697,843,193,704,59
47,3,0,47.0,3.0,0.2763345241546631,1237.1852155194358,4,1260,125,1697,843,193,704,59
46,4,0,46.0,4.0,0.2842745780944824,1191.0151638401876,4,1214,121,1697,843,193,704,59
44,4,0,44.0,4.0,0.2923574447631836,1146.8354476711443,4,1170,117,1697,843,193,704,59
42,5,0,42.0,5.0,0.30025553703308105,1104.546646592014,4,1128,112,1697,843,193,704,59
39,5,0,39.0,5.0,0.30823349952697754,1065.2440312836986,4,1089,107,1697,843,193,704,59
37,6,0,37.0,6.0,0.31625843048095703,1027.8372627798474,4,1052,101,1697,843,193,704,59
39,8,0,39.0,8.0,0.32418155670166016,988.2600454161168,4,1013,93,1697,843,193,704,59
42,9,0,42.0,9.0,0.3323204517364502,945.6265951635016,4,971,84,1697,843,193,704,59
40,9,0,40.0,9.0,0.340484619140625,905.0160598191018,4,931,75,1697,843,193,704,59
35,9,0,35.0,9.0,0.34841465950012207,869.4275151619078,4,896,66,1697,843,193,704,59
33,9,0,33.0,9.0,0.3562736511230469,835.8803385440092,4,863,57,1697,843,193,704,59
32,7,0,32.0,7.0,0.3643155097961426,803.5028528479647,4,831,50,1697,843,193,704,59
32,7,0,32.0,7.0,0.37221455574035645,771.1562347441904,4,799,43,1697,843,193,704,59
34,5,0,34.0,5.0,0.3803684711456299,736.9432093830455,4,765,38,1697,843,193,704,59
32,4,0,32.0,4.0,0.3883185386657715,704.7881165568165,4,733,34,1697,843,193,704,59
31,4,0,31.0,4.0,0.39701151847839355,673.6407332342753,4,702,30,1697,843,193,704,59
30,3,0,30.0,3.0,0.4042694568634033,643.5421919850085,4,672,27,1697,843,193,704,59
30,2,0,30.0,2.0,0.41248059272766113,613.4865757352444,4,642,25,1697,843,193,704,59
28,3,0,28.0,3.0,0.4202995300292969,585.3940103874711,4,614,22,1697,843,193,704,59
29,3,0,29.0,3.0,0.42818450927734375,556.3084656828397,4,585,19,1697,843,193,704,59
27,3,0,27.0,3.0,0.4362516403198242,529.2293435497636,4,558,16,1697,843,193,704,59
25,2,0,25.0,2.0,0.44503355026245117,504.1838332132736,4,533,14,1697,843,193,704,59
22,2,0,22.0,2.0,0.4522244930267334,482.1408807755451,4,511,12,1697,843,193,704,59
19,2,0,19.0,2.0,0.4602816104888916,463.10161552264793,4,492,10,1697,843,193,704,59
17,3,0,17.0,3.0,0.46823549270629883,446.05157614726426,4,475,7,1697,843,193,704,59
15,2,0,15.0,2.0,0.47637152671813965,431.02717311045876,4,460,5,1697,843,193,704,59
12,1,0,12.0,1.0,0.4842255115509033,419.0178567869812,4,448,4,1697,843,193,704,59
11,1,0,11.0,1.0,0.4923725128173828,408.01029736151526,4,437,3,1697,843,193,704,59
9,1,0,9.0,1.0,0.5002195835113525,399.0046728716872,4,428,2,1697,843,193,704,59
9,0,0,9.0,-0.0,0.5083675384521484,390.00477324250136,4,419,2,1697,843,193,704,59
6,0,0,6.0,-0.0,0.5168564319610596,384.0048425866215,4,413,2,1697,843,193,704,59
6,-1,0,6.0,-1.0,0.5243134498596191,378.0110563608807,4,407,3,1697,843,193,704,59
3,0,0,3.0,-0.0,0.5322556495666504,375.01113846031524,4,404,3,1697,843,193,704,59
4,-2,0,4.0,-2.0,0.5403826236724854,371.03124877939223,4,400,5,1697,843,193,704,59
3,-1,0,3.0,-1.0,0.5483555793762207,368.04533746160524,4,397,6,1697,843,193,704,59
3,-1,0,3.0,-1.0,0.5562994480133057,365.06217783491985,4,394,7,1697,843,193,704,59
5,-2,0,5.0,-2.0,0.5642426013946533,360.1040991816971,4,389,9,1697,843,193,704,59
5,-1,0,5.0,-1.0,0.5722825527191162,355.13018626502134,4,384,10,1697,843,193,704,59
8,-2,0,8.0,-2.0,0.5803775787353516,347.19144062564743,4,376,12,1697,843,193,704,59
10,-2,0,10.0,-2.0,0.588322639465332,337.2676616901907,4,366,14,1697,843,193,704,59
11,-1,0,11.0,-1.0,0.5966415405273438,326.31676008879737,4,355,15,1697,843,193,704,59
11,-1,0,11.0,-1.0,0.6043174266815186,315.37189200049414,4,344,16,1697,843,193,704,59
11,-1,0,11.0,-1.0,0.612459659576416,304.4336515710434,4,333,17,1697,843,193,704,59
12,0,0,12.0,-0.0,0.6201884746551514,292.4498405661449,4,321,17,1697,843,193,704,59
12,0,0,12.0,-0.0,0.6282656192779541,280.46728421595714,4,309,17,1697,843,193,704,59
11,-1,0,11.0,-1.0,0.636359453201294,269.54312921251426,4,298,18,1697,843,193,704,59
12,0,0,12.0,-0.0,0.6442375183105469,257.5658737533135,4,286,18,1697,843,193,704,59
12,0,0,12.0,-0.0,0.6523165702819824,245.5906043549196,4,274,18,1697,843,193,704,59
14,-1,0,14.0,-1.0,0.6603856086730957,231.69330639661615,4,260,19,1697,843,193,704,59
15,0,0,15.0,-0.0,0.6686396598815918,216.7356303021603,4,245,19,1697,843,193,704,59
16,0,0,16.0,-0.0,0.6763756275177002,200.78685776170926,4,229,19,1697,843,193,704,59
15,0,0,15.0,-0.0,0.6844944953918457,185.84180226389836,4,214,19,1697,843,193,704,59
14,0,0,14.0,-0.0,0.692312479019165,171.90047287151916,4,200,19,1697,843,193,704,59
13,0,0,13.0,-0.0,0.700249433517456,158.9627622695517,4,187,19,1697,843,193,704,59
11,0,0,11.0,-0.0,0.7082874774932861,148.02259742756007,4,176,19,1697,843,193,704,59
12,0,0,12.0,-0.0,0.7162704467773438,136.0969412193939,4,164,19,1697,843,193,704,59
13,0,0,13.0,-0.0,0.7242226600646973,123.19066988485201,4,151,19,1697,843,193,704,59
12,0,0,12.0,-0.0,0.7323606014251709,111.29255147726127,4,139,19,1697,843,193,704,59
11,0,0,11.0,-0.0,0.7405166625976562,100.40247292845683,4,128,19,1697,843,193,704,59
11,1,0,11.0,1.0,0.7484204769134521,89.37651794169315,4,117,18,1697,843,193,704,59
10,0,0,10.0,-0.0,0.7564175128936768,79.50345616615168,4,107,18,1697,843,193,704,59
10,0,0,10.0,-0.0,0.7643206119537354,69.65596788841515,4,97,18,1697,843,193,704,59
7,1,0,7.0,1.0,0.7722985744476318,62.59148432032315,4,90,17,1697,843,193,704,59
8,0,0,8.0,-0.0,0.7802674770355225,54.74365647617735,4,82,17,1697,843,193,704,59
7,0,0,7.0,-0.0,0.7882425785064697,47.90253571892151,4,75,17,1697,843,193,704,59
6,0,0,6.0,-0.0,0.796257495880127,42.06335201775947,4,69,17,1697,843,193,704,59
6,0,0,6.0,-0.0,0.8043246269226074,36.25335240430181,4,63,17,1697,843,193,704,59
3,0,0,3.0,-0.0,0.8122644424438477,33.36184731067546,4,60,17,1697,843,193,704,59
1,0,0,1.0,-0.0,0.8201756477355957,32.40032573203501,4,59,17,1697,843,193,704,59
1,0,0,1.0,-0.0,0.8530404567718506,31.440052945046304,4,58,17,1697,843,193,704,59
0,0,1,-0.0,-0.0,0.8612844944000244,31.440052945046304,4,58,17,1697,843,193,704,59
0,0,0,-0.0,-0.0,0.9342174530029297,31.440052945046304,4,58,17,1697,843,193,704,59
2,0,0,2.0,-0.0,1.0043375492095947,29.52349955359813,4,56,17,1697,843,193,704,59
2,0,0,2.0,-0.0,1.0123536586761475,27.612719418872643,4,54,17,1697,843,193,704,59
4,0,0,4.0,-0.0,1.020390510559082,23.810983706043572,4,50,17,1697,843,193,704,59
3,1,0,3.0,1.0,1.0283775329589844,20.64876634922564,4,47,16,1697,843,193,704,59
4,0,0,4.0,-0.0,1.036252498626709,16.880278987817846,4,43,16,1697,843,193,704,59
3,0,0,3.0,-0.0,1.0442686080932617,14.08131845707603,4,40,16,1697,843,193,704,59
3,0,0,3.0,-0.0,1.052189588546753,11.311288741492746,4,37,16,1697,843,193,704,59
2,1,0,2.0,1.0,1.0603384971618652,9.078865529319543,4,35,15,1697,843,193,704,59
1,0,0,1.0,-0.0,1.0682785511016846,8.16180835212409,4,34,15,1697,843,193,704,59
1,0,0,1.0,-0.0,1.1162655353546143,7.249137920783717,4,33,15,1697,843,193,704,59
1,0,0,1.0,-0.0,1.1243915557861328,6.3411940941445835,4,32,15,1697,843,193,704,59
0,0,1,-0.0,-0.0,1.1268694400787354,6.3411940941445835,4,32,15,1697,843,193,704,59
1,0,1,1.0,-0.0,0.0012116432189941406,578.8273372863089,5,-440,-428,1226,400,1665,828,71
1,0,1,1.0,-0.0,0.009219646453857422,579.5445467986841,5,-441,-428,1226,400,1665,828,71
0,0,0,-0.0,-0.0,0.09012460708618164,579.5445467986841,5,-441,-428,1226,400,1665,828,71
0,1,0,-0.0,1.0,0.11329865455627441,580.2414160311381,5,-441,-429,1226,400,1665,828,71
-2,0,0,-2.0,-0.0,0.15342473983764648,578.809416675893,5,-439,-429,1226,400,1665,828,71
-2,0,0,-2.0,-0.0,0.16157174110412598,577.3806006071715,5,-437,-429,1226,400,1665,828,71
-1,0,0,-1.0,-0.0,0.1694338321685791,576.6673932784058,5,-436,-429,1226,400,1665,828,71
-1,0,0,-1.0,-0.0,0.17721080780029297,575.9549901588496,5,-435,-429,1226,400,1665,828,71
-2,0,0,-2.0,-0.0,0.18539667129516602,574.5326078234043,5,-433,-429,1226,400,1665,828,71
-2,0,0,-2.0,-0.0,0.19322466850280762,573.1134762525824,5,-431,-429,1226,400,1665,828,71
-3,0,0,-3.0,-0.0,0.20111560821533203,570.9909240244444,5,-428,-429,1226,400,1665,828,71
-5,0,0,-5.0,-0.0,0.20920562744140625,567.4699162613848,5,-423,-429,1226,400,1665,828,71
-7,0,0,-7.0,-0.0,0.21717166900634766,562.5759365971826,5,-416,-429,1226,400,1665,828,71
-8,-1,0,-8.0,-1.0,0.22601079940795898,556.3104091760943,5,-408,-428,1226,400,1665,828,71
-10,-3,0,-10.0,-3.0,0.23339271545410156,547.261968533065,5,-398,-425,1226,400,1665,828,71
-13,-4,0,-13.0,-4.0,0.24138379096984863,535.4962751850358,5,-385,-421,1226,400,1665,828,71
-15,-8,0,-15.0,-8.0,0.24927473068237305,519.4988728572854,5,-370,-413,1226,400,1665,828,71
-19,-10,0,-19.0,-10.0,0.2571747303009033,499.42492456845616,5,-351,-403,1226,400,1665,828,71
-22,-15,0,-22.0,-15.0,0.26513075828552246,473.70915069418595,5,-329,-388,1226,400,1665,828,71
-22,-19,0,-22.0,-19.0,0.27356982231140137,445.01041655364105,5,-307,-369,1226,400,1665,828,71
-25,-21,0,-25.0,-21.0,0.28118181228637695,412.915170540137,5,-282,-348,1226,400,1665,828,71
-26,-23,0,-26.0,-23.0,0.28965067863464355,378.7160862233906,5,-256,-325,1226,400,1665,828,71
-24,-22,0,-24.0,-22.0,0.2972986698150635,346.61891986640285,5,-232,-303,1226,400,1665,828,71
-21,-21,0,-21.0,-21.0,0.3053116798400879,317.2002271435951,5,-211,-282,1226,400,1665,828,71
-19,-18,0,-19.0,-18.0,0.3132467269897461,291.43529220965064,5,-192,-264,1226,400,1665,828,71
-17,-17,0,-17.0,-17.0,0.3211216926574707,267.71108337819413,5,-175,-247,1226,400,1665,828,71
-11,-13,0,-11.0,-13.0,0.32927465438842773,250.74814085134483,5,-164,-234,1226,400,1665,828,71
-9,-12,0,-9.0,-12.0,0.3371286392211914,235.75634803269156,5,-155,-222,1226,400,1665,828,71
-8,-11,0,-8.0,-11.0,0.3451807498931885,222.15753926338618,5,-147,-211,1226,400,1665,828,71
-6,-11,0,-6.0,-11.0,0.3532116413116455,209.70594598415462,5,-141,-200,1226,400,1665,828,71
-4,-8,0,-4.0,-8.0,0.36149168014526367,200.8664876577425,5,-137,-192,1226,400,1665,828,71
-3,-8,0,-3.0,-8.0,0.36936473846435547,192.62249449472256,5,-134,-184,1226,400,1665,828,71
-3,-7,0,-3.0,-7.0,0.3773787021636963,185.20445045457188,5,-131,-177,1226,400,1665,828,71
-1,-9,0,-1.0,-9.0,0.38527774810791016,177.4241040936739,5,-130,-168,1226,400,1665,828,71
-1,-6,0,-1.0,-6.0,0.3932666778564453,172.0869382650678,5,-129,-162,1226,400,1665,828,71
0,-4,0,-0.0,-4.0,0.40113377571105957,168.9730374338726,5,-129,-158,1226,400,1665,828,71
0,-3,0,-0.0,-3.0,0.409146785736084,166.65812654093563,5,-129,-155,1226,400,1665,828,71
0,-4,0,-0.0,-4.0,0.41715073585510254,163.600100704909,5,-129,-151,1226,400,1665,828,71
1,-4,0,1.0,-4.0,0.42520761489868164,161.23710148695125,5,-130,-147,1226,400,1665,828,71
0,-5,0,-0.0,-5.0,0.43323779106140137,157.52012881774206,5,-130,-142,1226,400,1665,828,71
1,-5,0,1.0,-5.0,0.44114160537719727,154.5521036549054,5,-131,-137,1226,400,1665,828,71
0,-4,0,-0.0,-4.0,0.45010972023010254,151.6815470259447,5,-131,-133,1226,400,1665,828,71
0,-5,0,-0.0,-5.0,0.457324743270874,148.15294155431957,5,-131,-128,1226,400,1665,828,71
-1,-3,0,-1.0,-3.0,0.46523165702819824,145.34688796871433,5,-130,-125,1226,400,1665,828,71
-3,-4,0,-3.0,-4.0,0.47310471534729004,140.41379649275024,5,-127,-121,1226,400,1665,828,71
-3,-4,0,-3.0,-4.0,0.48113274574279785,135.48460341039598,5,-124,-117,1226,400,1665,828,71
-5,-5,0,-5.0,-5.0,0.48914170265197754,128.41664541900252,5,-119,-112,1226,400,1665,828,71
-7,-5,0,-7.0,-5.0,0.4980156421661377,119.89673979784081,5,-112,-107,1226,400,1665,828,71
-8,-5,0,-8.0,-5.0,0.5052616596221924,110.67086187704115,5,-104,-102,1226,400,1665,828,71
-8,-5,0,-8.0,-5.0,0.5134696960449219,101.4734406395618,5,-96,-97,1226,400,1665,828,71
-9,-4,0,-9.0,-4.0,0.5212066173553467,92.34991166074674,5,-87,-93,1226,400,1665,828,71
-7,-4,0,-7.0,-4.0,0.5293886661529541,84.6703806294607,5,-80,-89,1226,400,1665,828,71
-6,-4,0,-6.0,-4.0,0.5373067855834961,77.69871339105873,5,-74,-85,1226,400,1665,828,71
-6,-5,0,-6.0,-5.0,0.545123815536499,69.9952379872535,5,-68,-80,1226,400,1665,828,71
-6,-4,0,-6.0,-4.0,0.553330659866333,63.08159868191383,5,-62,-76,1226,400,1665,828,71
-5,-5,0,-5.0,-5.0,0.5614027976989746,56.0494371207203,5,-57,-71,1226,400,1665,828,71
-5,-5,0,-5.0,-5.0,0.5692696571350098,49.02380615040002,5,-52,-66,1226,400,1665,828,71
-5,-4,0,-5.0,-4.0,0.5772457122802734,42.80102827083971,5,-47,-62,1226,400,1665,828,71
-4,-6,0,-4.0,-6.0,0.5852947235107422,35.60453243241541,5,-43,-56,1226,400,1665,828,71
-6,-6,0,-6.0,-6.0,0.5932726860046387,27.201286160335947,5,-37,-50,1226,400,1665,828,71
-5,-6,0,-5.0,-6.0,0.6012828350067139,19.405882034941776,5,-32,-44,1226,400,1665,828,71
-5,-6,0,-5.0,-6.0,0.6091737747192383,11.61544808322666,5,-27,-38,1226,400,1665,828,71
-4,-5,0,-4.0,-5.0,0.6171448230743408,5.224370722237531,5,-23,-33,1226,400,1665,828,71
-4,-5,0,-4.0,-5.0,0.6252126693725586,-1.1621513686227374,5,-19,-28,1226,400,1665,828,71
-3,-5,0,-3.0,-5.0,0.6339328289031982,-6.9821485477562,5,-16,-23,1226,400,1665,828,71
-3,-2,0,-3.0,-2.0,0.6412258148193359,-10.301821929543063,5,-13,-21,1226,400,1665,828,71
-1,-1,0,-1.0,-1.0,0.6492748260498047,-11.676192420618797,5,-12,-20,1226,400,1665,828,71
0,0,1,-0.0,-0.0,0.6550347805023193,-11.676192420618797,5,-12,-20,1226,400,1665,828,71
0,-1,1,-0.0,-1.0,0.6572396755218506,-12.527794945755769,5,-12,-19,1226,400,1665,828,71
0,0,0,-0.0,-0.0,0.08986806869506836,1338.1385515614654,6,-1160,683,78,1102,1238,419,16
-2,0,0,-2.0,-0.0,0.16490602493286133,1336.4154863731674,6,-1158,683,78,1102,1238,419,16
-5,0,0,-5.0,-0.0,0.1728990077972412,1332.1111894167589,6,-1153,683,78,1102,1238,419,16
-8,0,0,-8.0,-0.0,0.1809849739074707,1325.2344129972043,6,-1145,683,78,1102,1238,419,16
-8,-1,0,-8.0,-1.0,0.1889481544494629,1318.88545097156,6,-1137,684,78,1102,1238,419,16
-11,-1,0,-11.0,-1.0,0.19687914848327637,1309.9912746296918,6,-1126,685,78,1102,1238,419,16
-13,-2,0,-13.0,-2.0,0.20519018173217773,1299.9518339755482,6,-1113,687,78,1102,1238,419,16
-17,0,0,-17.0,-0.0,0.2128891944885254,1285.5165248267995,6,-1096,687,78,1102,1238,419,16
-20,0,0,-20.0,-0.0,0.22086310386657715,1268.6146638669009,6,-1076,687,78,1102,1238,419,16
-23,4,0,-23.0,4.0,0.22896504402160645,1247.1087602275747,6,-1053,683,78,1102,1238,419,16
-26,7,0,-26.0,7.0,0.2368011474609375,1221.5141316796648,6,-1027,676,78,1102,1238,419,16
-27,9,0,-27.0,9.0,0.24481201171875,1194.035357217083,6,-1000,667,78,1102,1238,419,16
-29,9,0,-29.0,9.0,0.25290417671203613,1164.9471428841114,6,-971,658,78,1102,1238,419,16
-28,10,0,-28.0,10.0,0.26097917556762695,1136.1822407291593,6,-943,648,78,1102,1238,419,16
-28,11,0,-28.0,11.0,0.2692131996154785,1106.8964077437868,6,-915,637,78,1102,1238,419,16
-28,11,0,-28.0,11.0,0.27730703353881836,1077.654180667122,6,-887,626,78,1102,1238,419,16
-29,13,0,-29.0,13.0,0.28484010696411133,1046.4823374528376,6,-858,613,78,1102,1238,419,16
-31,17,0,-31.0,17.0,0.29282498359680176,1011.3846182869349,6,-827,596,78,1102,1238,419,16
-33,17,0,-33.0,17.0,0.30086708068847656,974.6886587317471,6,-794,579,78,1102,1238,419,16
-34,18,0,-34.0,18.0,0.3088500499725342,936.6274397877716,6,-760,561,78,1102,1238,419,16
-34,17,0,-34.0,17.0,0.3169410228729248,899.2000881834173,6,-726,544,78,1102,1238,419,16
-33,18,0,-33.0,18.0,0.3247950077056885,862.0143676974536,6,-693,526,78,1102,1238,419,16
-34,18,0,-34.0,18.0,0.3329591751098633,824.0727131687471,6,-659,508,78,1102,1238,419,16
-31,18,0,-31.0,18.0,0.340939998626709,788.5450395300946,6,-628,490,78,1102,1238,419,16
-33,18,0,-33.0,18.0,0.3490321636199951,751.4794269761361,6,-595,472,78,1102,1238,419,16
-31,20,0,-31.0,20.0,0.3569760322570801,714.772439983706,6,-564,452,78,1102,1238,419,16
-27,21,0,-27.0,21.0,0.36495208740234375,680.5709839951144,6,-537,431,78,1102,1238,419,16
-25,22,0,-25.0,22.0,0.37278008460998535,647.3052723731131,6,-512,409,78,1102,1238,419,16
-21,21,0,-21.0,21.0,0.3808131217956543,617.7994886543133,6,-491,388,78,1102,1238,419,16
-16,19,0,-16.0,19.0,0.38875412940979004,593.4864919513986,6,-475,369,78,1102,1238,419,16
-12,16,0,-12.0,16.0,0.39681100845336914,574.2181721657269,6,-463,353,78,1102,1238,419,16
-10,13,0,-10.0,13.0,0.404818058013916,558.4000353107334,6,-453,340,78,1102,1238,419,16
-7,11,0,-7.0,11.0,0.4127650260925293,546.2174663433118,6,-446,329,78,1102,1238,419,16
-6,11,0,-6.0,11.0,0.42088913917541504,534.8848865091015,6,-440,318,78,1102,1238,419,16
-6,9,0,-6.0,9.0,0.4289560317993164,524.763549804226,6,-434,309,78,1102,1238,419,16
-5,8,0,-5.0,8.0,0.43677616119384766,516.0629733152305,6,-429,301,78,1102,1238,419,16
-5,7,0,-5.0,7.0,0.4448211193084717,507.95736257950614,6,-424,294,78,1102,1238,419,16
-7,6,0,-7.0,6.0,0.45292210578918457,498.78693747964735,6,-417,288,78,1102,1238,419,16
-6,7,0,-6.0,7.0,0.4614431858062744,489.8774949724079,6,-411,281,78,1102,1238,419,16
-7,6,0,-7.0,6.0,0.46901512145996094,480.71361757168177,6,-404,275,78,1102,1238,419,16
-7,6,0,-7.0,6.0,0.47689008712768555,471.5518741491894,6,-397,269,78,1102,1238,419,16
-8,7,0,-8.0,7.0,0.4849050045013428,461.00426437293726,6,-389,262,78,1102,1238,419,16
-10,6,0,-10.0,6.0,0.4928441047668457,449.3587213555679,6,-379,256,78,1102,1238,419,16
-9,7,0,-9.0,7.0,0.5009222030639648,437.98318353946934,6,-370,249,78,1102,1238,419,16
-10,7,0,-10.0,7.0,0.5089590549468994,425.7787454451866,6,-360,242,78,1102,1238,419,16
-10,6,0,-10.0,6.0,0.5168111324310303,414.13268056382464,6,-350,236,78,1102,1238,419,16
-8,5,0,-8.0,5.0,0.5248150825500488,404.70449476592813,6,-342,231,78,1102,1238,419,16
-7,5,0,-7.0,5.0,0.5328361988067627,396.1051843270512,6,-335,226,78,1102,1238,419,16
-5,5,0,-5.0,5.0,0.5409681797027588,389.1662120573703,6,-330,221,78,1102,1238,419,16
-7,5,0,-7.0,5.0,0.5489110946655273,380.5678833871889,6,-323,216,78,1102,1238,419,16
-7,6,0,-7.0,6.0,0.557030200958252,371.41533970043963,6,-316,210,78,1102,1238,419,16
-9,8,0,-9.0,8.0,0.5647971630096436,359.4955782046908,6,-307,202,78,1102,1238,419,16
-9,7,0,-9.0,7.0,0.5728800296783447,348.1305940241585,6,-298,195,78,1102,1238,419,16
-10,7,0,-10.0,7.0,0.5808200836181641,335.93022548185553,6,-288,188,78,1102,1238,419,16
-10,7,0,-10.0,7.0,0.5888361930847168,323.7303121513016,6,-278,181,78,1102,1238,419,16
-10,8,0,-10.0,8.0,0.5969099998474121,310.9874605685935,6,-268,173,78,1102,1238,419,16
-10,8,0,-10.0,8.0,0.6048541069030762,298.2498979591667,6,-258,165,78,1102,1238,419,16
-11,8,0,-11.0,8.0,0.612800121307373,284.67387994148027,6,-247,157,78,1102,1238,419,16
-10,8,0,-10.0,8.0,0.6214210987091064,271.94642344563005,6,-237,149,78,1102,1238,419,16
-10,7,0,-10.0,7.0,0.6290221214294434,259.75548547135315,6,-227,142,78,1102,1238,419,16
-9,7,0,-9.0,7.0,0.6370041370391846,248.4156781478075,6,-218,135,78,1102,1238,419,16
-8,6,0,-8.0,6.0,0.6449511051177979,238.45689278249046,6,-210,129,78,1102,1238,419,16
-8,6,0,-8.0,6.0,0.6529340744018555,228.50158561836324,6,-202,123,78,1102,1238,419,16
-7,6,0,-7.0,6.0,0.6607789993286133,219.40712389896672,6,-195,117,78,1102,1238,419,16
-7,6,0,-7.0,6.0,0.6687960624694824,210.3231549790356,6,-188,111,78,1102,1238,419,16
-8,5,0,-8.0,5.0,0.6769201755523682,200.89231675674432,6,-180,106,78,1102,1238,419,16
-7,6,0,-7.0,6.0,0.6859431266784668,191.82242116439286,6,-173,100,78,1102,1238,419,16
-6,4,0,-6.0,4.0,0.6929450035095215,184.62658175859323,6,-167,96,78,1102,1238,419,16
-7,5,0,-7.0,5.0,0.7009341716766357,176.06792224611002,6,-160,91,78,1102,1238,419,16
-7,4,0,-7.0,4.0,0.7090520858764648,168.00568172647155,6,-153,87,78,1102,1238,419,16
-6,4,0,-6.0,4.0,0.7167811393737793,160.81350656863924,6,-147,83,78,1102,1238,419,16
-4,2,0,-4.0,2.0,0.7248351573944092,156.34719346554112,6,-143,81,78,1102,1238,419,16
-3,3,0,-3.0,3.0,0.7328851222991943,152.262285020525,6,-140,78,78,1102,1238,419,16
-3,2,0,-3.0,2.0,0.7408480644226074,148.66843970627906,6,-137,76,78,1102,1238,419,16
-4,3,0,-4.0,3.0,0.7490789890289307,143.71684151734772,6,-133,73,78,1102,1238,419,16
-4,2,0,-4.0,2.0,0.7569501399993896,139.24808997063425,6,-129,71,78,1102,1238,419,16
-3,2,0,-3.0,2.0,0.764916181564331,135.65583872575453,6,-126,69,78,1102,1238,419,16
-3,2,0,-3.0,2.0,0.7728500366210938,132.06427096158393,6,-123,67,78,1102,1238,419,16
-2,2,0,-2.0,2.0,0.7808330059051514,129.35355838128112,6,-121,65,78,1102,1238,419,16
-1,1,0,-1.0,1.0,0.7888190746307373,128.0,6,-120,64,78,1102,1238,419,16
-2,1,0,-2.0,1.0,0.7967560291290283,125.76471881628578,6,-118,63,78,1102,1238,419,16
-3,3,0,-3.0,3.0,0.804840087890625,121.71121771072848,6,-115,60,78,1102,1238,419,16
-4,2,0,-4.0,2.0,0.8128080368041992,117.23977004130916,6,-111,58,78,1102,1238,419,16
-4,3,0,-4.0,3.0,0.821209192276001,112.30793822520607,6,-107,55,78,1102,1238,419,16
-4,2,0,-4.0,2.0,0.8292021751403809,107.83609109426992,6,-103,53,78,1102,1238,419,16
-7,4,0,-7.0,4.0,0.8371660709381104,99.78218776773832,6,-96,49,78,1102,1238,419,16
-6,3,0,-6.0,3.0,0.8450181484222412,93.07423014794622,6,-90,46,78,1102,1238,419,16
-7,3,0,-7.0,3.0,0.8528780937194824,85.47726996441435,6,-83,43,78,1102,1238,419,16
-6,5,0,-6.0,5.0,0.8608970642089844,77.86617494683223,6,-77,38,78,1102,1238,419,16
-6,3,0,-6.0,3.0,0.8690640926361084,71.1580697086532,6,-71,35,78,1102,1238,419,16
-6,3,0,-6.0,3.0,0.8771200180053711,64.44998274671983,6,-65,32,78,1102,1238,419,16
-5,4,0,-5.0,4.0,0.8849689960479736,58.21178142898739,6,-60,28,78,1102,1238,419,16
-4,3,0,-4.0,3.0,0.8927900791168213,53.326992425847855,6,-56,25,78,1102,1238,419,16
-5,3,0,-5.0,3.0,0.9009251594543457,47.54277630799526,6,-51,22,78,1102,1238,419,16
-4,4,0,-4.0,4.0,0.9087960720062256,42.32891812864648,6,-47,18,78,1102,1238,419,16
-5,3,0,-5.0,3.0,0.9168381690979004,36.598206241955516,6,-42,15,78,1102,1238,419,16
-4,3,0,-4.0,3.0,0.9250810146331787,31.84971769034255,6,-38,12,78,1102,1238,419,16
-3,2,0,-3.0,2.0,0.932866096496582,28.400549446402593,6,-35,10,78,1102,1238,419,16
-2,1,0,-2.0,1.0,0.9407961368560791,26.205262752974143,6,-33,9,78,1102,1238,419,16
-2,2,0,-2.0,2.0,0.9490830898284912,23.78049716414141,6,-31,7,78,1102,1238,419,16
-3,2,0,-3.0,2.0,0.9569501876831055,20.442925306655784,6,-28,5,78,1102,1238,419,16
-1,1,0,-1.0,1.0,0.9662749767303467,19.294688127912362,6,-27,4,78,1102,1238,419,16
-3,2,0,-3.0,2.0,0.9728691577911377,16.08318915758459,6,-24,2,78,1102,1238,419,16
-3,1,0,-3.0,1.0,0.9808189868927002,13.02379604162864,6,-21,1,78,1102,1238,419,16
-3,3,0,-3.0,3.0,0.9888920783996582,10.110770276274835,6,-18,-2,78,1102,1238,419,16
-4,2,0,-4.0,2.0,0.9968421459197998,6.560219778561036,6,-14,-4,78,1102,1238,419,16
-5,2,0,-5.0,2.0,1.0053560733795166,2.8166538263919687,6,-9,-6,78,1102,1238,419,16
-4,2,0,-4.0,2.0,1.0128560066223145,1.4339811320566032,6,-5,-8,78,1102,1238,419,16
-6,3,0,-6.0,3.0,1.0209071636199951,3.045361017187261,6,1,-11,78,1102,1238,419,16
-5,3,0,-5.0,3.0,1.0293340682983398,7.231546211727817,6,6,-14,78,1102,1238,419,16
-6,3,0,-6.0,3.0,1.0371730327606201,12.808652046684813,6,12,-17,78,1102,1238,419,16
-6,2,0,-6.0,2.0,1.045091152191162,18.1725046566048,6,18,-19,78,1102,1238,419,16
-4,3,0,-4.0,3.0,1.0528411865234375,23.11269837220809,6,22,-22,78,1102,1238,419,16
-3,1,0,-3.0,1.0,1.0608689785003662,25.97057550292606,6,25,-23,78,1102,1238,419,16
-1,2,0,-1.0,2.0,1.0688211917877197,28.069377593742864,6,26,-25,78,1102,1238,419,16
-2,1,0,-2.0,1.0,1.0768730640411377,30.209946349085598,6,28,-26,78,1102,1238,419,16
-1,0,0,-1.0,-0.0,1.085561990737915,30.948684188300895,6,29,-26,78,1102,1238,419,16
0,0,1,-0.0,-0.0,1.1298890113830566,30.948684188300895,6,29,-26,78,1102,1238,419,16
1,0,1,1.0,-0.0,1.2128801345825195,30.209946349085598,6,28,-26,78,1102,1238,419,16
0,0,0,-0.0,-0.0,1.213757038116455,30.209946349085598,6,28,-26,78,1102,1238,419,16
2,-2,0,2.0,-2.0,1.2208311557769775,27.383612025908263,6,26,-24,78,1102,1238,419,16
2,-2,0,2.0,-2.0,1.2288591861724854,24.557641192199412,6,24,-22,78,1102,1238,419,16
2,-2,0,2.0,-2.0,1.237396001815796,21.732137494637012,6,22,-20,78,1102,1238,419,16
1,-1,0,1.0,-1.0,1.244899034500122,20.319604517012593,6,21,-19,78,1102,1238,419,16
3,-2,0,3.0,-2.0,1.2530250549316406,16.758836806279895,6,18,-17,78,1102,1238,419,16
2,-2,0,2.0,-2.0,1.260836124420166,13.931712199461309,6,16,-15,78,1102,1238,419,16
1,-2,0,1.0,-2.0,1.2688190937042236,11.849433241279208,6,15,-13,78,1102,1238,419,16
2,-2,0,2.0,-2.0,1.2768521308898926,9.029386365926403,6,13,-11,78,1102,1238,419,16
1,-2,0,1.0,-2.0,1.2849500179290771,7.0,6,12,-9,78,1102,1238,419,16
2,-2,0,2.0,-2.0,1.292809009552002,4.206555615733702,6,10,-7,78,1102,1238,419,16
1,-3,0,1.0,-3.0,1.3010101318359375,1.848857801796104,6,9,-4,78,1102,1238,419,16
2,-2,0,2.0,-2.0,1.3088221549987793,-0.719890110719482,6,7,-2,78,1102,1238,419,16
1,-1,0,1.0,-1.0,1.3168370723724365,-1.9172374697017807,6,6,-1,78,1102,1238,419,16
1,-1,0,1.0,-1.0,1.3249311447143555,-3.0,6,5,0,78,1102,1238,419,16
0,-1,0,-0.0,-1.0,1.3329741954803467,-2.9009804864072155,6,5,1,78,1102,1238,419,16
1,-1,0,1.0,-1.0,1.3408501148223877,-3.5278640450004204,6,4,2,78,1102,1238,419,16
0,0,1,-0.0,-0.0,1.375852108001709,-3.5278640450004204,6,4,2,78,1102,1238,419,16
0,0,0,-0.0,-0.0,0.07811713218688965,1844.8550397721656,7,1769,-615,1843,485,74,1100,57
2,-1,0,2.0,-1.0,0.21702003479003906,1842.6375918386757,7,1767,-614,1843,485,74,1100,57
6,-3,0,6.0,-3.0,0.22514104843139648,1835.985514965178,7,1761,-611,1843,485,74,1100,57
9,-5,0,9.0,-5.0,0.23302698135375977,1825.8446536859553,7,1752,-606,1843,485,74,1100,57
13,-4,0,13.0,-4.0,0.24117302894592285,1812.2513415291944,7,1739,-602,1843,485,74,1100,57
20,-7,0,20.0,-7.0,0.24936604499816895,1791.061846117388,7,1719,-595,1843,485,74,1100,57
27,-7,0,27.0,-7.0,0.2572970390319824,1763.2587752750858,7,1692,-588,1843,485,74,1100,57
35,-9,0,35.0,-9.0,0.2650420665740967,1727.246421446288,7,1657,-579,1843,485,74,1100,57
39,-10,0,39.0,-10.0,0.2730090618133545,1687.1341055439368,7,1618,-569,1843,485,74,1100,57
45,-11,0,45.0,-11.0,0.2810099124908447,1641.039544169041,7,1573,-558,1843,485,74,1100,57
48,-15,0,48.0,-15.0,0.2897911071777344,1590.7878180910554,7,1525,-543,1843,485,74,1100,57
52,-17,0,52.0,-17.0,0.29714512825012207,1536.0987820467094,7,1473,-526,1843,485,74,1100,57
56,-17,0,56.0,-17.0,0.30515599250793457,1477.6460407413158,7,1417,-509,1843,485,74,1100,57
62,-19,0,62.0,-19.0,0.3131539821624756,1412.876469375498,7,1355,-490,1843,485,74,1100,57
61,-20,0,61.0,-20.0,0.3211789131164551,1348.7120250800456,7,1294,-470,1843,485,74,1100,57
61,-20,0,61.0,-20.0,0.32903313636779785,1284.550570454335,7,1233,-450,1843,485,74,1100,57
60,-22,0,60.0,-22.0,0.33710694313049316,1220.6444650099563,7,1173,-428,1843,485,74,1100,57
58,-23,0,58.0,-23.0,0.34502601623535156,1158.275684653445,7,1115,-405,1843,485,74,1100,57
54,-19,0,54.0,-19.0,0.3530600070953369,1101.0336576028192,7,1061,-386,1843,485,74,1100,57
57,-18,0,57.0,-18.0,0.36199092864990234,1041.317539367984,7,1004,-368,1843,485,74,1100,57
55,-16,0,55.0,-16.0,0.36966800689697266,984.1783439690853,7,949,-352,1843,485,74,1100,57
48,-16,0,48.0,-16.0,0.37702393531799316,933.6116679824554,7,901,-336,1843,485,74,1100,57
42,-15,0,42.0,-15.0,0.3852100372314453,889.0179932803936,7,859,-321,1843,485,74,1100,57
35,-13,0,35.0,-13.0,0.3930540084838867,851.6817606384709,7,824,-308,1843,485,74,1100,57
32,-13,0,32.0,-13.0,0.4009709358215332,817.156198581067,7,792,-295,1843,485,74,1100,57
32,-11,0,32.0,-11.0,0.40904903411865234,783.32977265721,7,760,-284,1843,485,74,1100,57
31,-11,0,31.0,-11.0,0.41707396507263184,750.4407491903286,7,729,-273,1843,485,74,1100,57
31,-10,0,31.0,-10.0,0.4251699447631836,717.9041493382377,7,698,-263,1843,485,74,1100,57
32,-9,0,32.0,-9.0,0.433337926864624,684.7916946766426,7,666,-254,1843,485,74,1100,57
30,-8,0,30.0,-8.0,0.44109392166137695,653.9178836194282,7,636,-246,1843,485,74,1100,57
28,-5,0,28.0,-5.0,0.4491720199584961,626.0221708780215,7,608,-241,1843,485,74,1100,57
26,-5,0,26.0,-5.0,0.4570460319519043,600.0286617663241,7,582,-236,1843,485,74,1100,57
22,-4,0,22.0,-4.0,0.46500205993652344,578.1550956644677,7,560,-232,1843,485,74,1100,57
20,-3,0,20.0,-3.0,0.47307705879211426,558.5500831131131,7,540,-229,1843,485,74,1100,57
18,-4,0,18.0,-4.0,0.48107099533081055,540.4267762869727,7,522,-225,1843,485,74,1100,57
16,-4,0,16.0,-4.0,0.4891939163208008,524.1566806622917,7,506,-221,1843,485,74,1100,57
11,-3,0,11.0,-3.0,0.4972259998321533,512.8779899385812,7,495,-218,1843,485,74,1100,57
8,-3,0,8.0,-3.0,0.5051219463348389,504.3476307827433,7,487,-215,1843,485,74,1100,57
5,-1,0,5.0,-1.0,0.5134861469268799,499.3708372672877,7,482,-214,1843,485,74,1100,57
2,-2,0,2.0,-2.0,0.521245002746582,496.73231270810834,7,480,-212,1843,485,74,1100,57
2,-1,0,2.0,-1.0,0.5291619300842285,494.49880382638196,7,478,-211,1843,485,74,1100,57
2,-1,0,2.0,-1.0,0.5371849536895752,492.2653169297373,7,476,-210,1843,485,74,1100,57
3,-1,0,3.0,-1.0,0.5450379848480225,489.11700803589895,7,473,-209,1843,485,74,1100,57
2,-2,0,2.0,-2.0,0.5531489849090576,486.4803203233337,7,471,-207,1843,485,74,1100,57
4,-4,0,4.0,-4.0,0.5611059665679932,481.21311844845474,7,467,-203,1843,485,74,1100,57
4,-3,0,4.0,-3.0,0.5690529346466064,476.35007683155953,7,463,-200,1843,485,74,1100,57
4,-5,0,4.0,-5.0,0.5770630836486816,470.70432121649,7,459,-195,1843,485,74,1100,57
4,-4,0,4.0,-4.0,0.5851290225982666,465.4632711762852,7,455,-191,1843,485,74,1100,57
6,-6,0,6.0,-6.0,0.593142032623291,457.6191923719655,7,449,-185,1843,485,74,1100,57
7,-6,0,7.0,-6.0,0.6011149883270264,448.8700032503617,7,442,-179,1843,485,74,1100,57
7,-7,0,7.0,-7.0,0.6093471050262451,439.7702427474411,7,435,-172,1843,485,74,1100,57
10,-9,0,10.0,-9.0,0.6171879768371582,427.18567640030153,7,425,-163,1843,485,74,1100,57
11,-10,0,11.0,-10.0,0.6250650882720947,413.3671940686122,7,414,-153,1843,485,74,1100,57
13,-10,0,13.0,-10.0,0.6330530643463135,397.73465914816,7,401,-143,1843,485,74,1100,57
15,-11,0,15.0,-11.0,0.6410391330718994,379.9460748677452,7,386,-132,1843,485,74,1100,57
14,-10,0,14.0,-10.0,0.649061918258667,363.4945721207383,7,372,-122,1843,485,74,1100,57
15,-10,0,15.0,-10.0,0.6570501327514648,346.15638441699747,7,357,-112,1843,485,74,1100,57
14,-9,0,14.0,-9.0,0.6650941371917725,330.1312608527773,7,343,-103,1843,485,74,1100,57
13,-9,0,13.0,-9.0,0.6731710433959961,315.1267987202399,7,330,-94,1843,485,74,1100,57
12,-8,0,12.0,-8.0,0.681365966796875,301.4237392781522,7,318,-86,1843,485,74,1100,57
13,-9,0,13.0,-9.0,0.6892900466918945,286.5695471592888,7,305,-77,1843,485,74,1100,57
13,-8,0,13.0,-8.0,0.6970460414886475,272.04166377354994,7,292,-69,1843,485,74,1100,57
13,-8,0,13.0,-8.0,0.7050731182098389,257.5906160923359,7,279,-61,1843,485,74,1100,57
15,-7,0,15.0,-7.0,0.7130720615386963,241.46613887462746,7,264,-54,1843,485,74,1100,57
13,-6,0,13.0,-6.0,0.7211260795593262,227.54842985234717,7,251,-48,1843,485,74,1100,57
14,-6,0,14.0,-6.0,0.7290749549865723,212.69275020241054,7,237,-42,1843,485,74,1100,57
14,-6,0,14.0,-6.0,0.737030029296875,197.88713996153035,7,223,-36,1843,485,74,1100,57
15,-6,0,15.0,-6.0,0.745448112487793,182.15232570685484,7,208,-30,1843,485,74,1100,57
16,-6,0,16.0,-6.0,0.7531030178070068,165.49418595916518,7,192,-24,1843,485,74,1100,57
16,-6,0,16.0,-6.0,0.7610571384429932,148.91806012954132,7,176,-18,1843,485,74,1100,57
15,-4,0,15.0,-4.0,0.7690920829772949,133.60754932861275,7,161,-14,1843,485,74,1100,57
14,-3,0,14.0,-3.0,0.7770900726318359,119.41099009232656,7,147,-11,1843,485,74,1100,57
14,-4,0,14.0,-4.0,0.7850539684295654,105.18408313308313,7,133,-7,1843,485,74,1100,57
14,-3,0,14.0,-3.0,0.7930080890655518,91.06720791217035,7,119,-4,1843,485,74,1100,57
12,-2,0,12.0,-2.0,0.801098108291626,79.01868995647442,7,107,-2,1843,485,74,1100,57
13,-2,0,13.0,-2.0,0.8092119693756104,66.0,7,94,0,1843,485,74,1100,57
12,-3,0,12.0,-3.0,0.8172540664672852,54.05485969764375,7,82,3,1843,485,74,1100,57
11,-2,0,11.0,-2.0,0.8251910209655762,43.175838597096984,7,71,5,1843,485,74,1100,57
9,-2,0,9.0,-2.0,0.8332309722900391,34.39390995922599,7,62,7,1843,485,74,1100,57
8,-3,0,8.0,-3.0,0.841109037399292,26.918120870983927,7,54,10,1843,485,74,1100,57
6,-2,0,6.0,-2.0,0.8491709232330322,21.477267507411923,7,48,12,1843,485,74,1100,57
6,-2,0,6.0,-2.0,0.857090950012207,16.27188724235731,7,42,14,1843,485,74,1100,57
6,-2,0,6.0,-2.0,0.8650600910186768,11.395431207184416,7,36,16,1843,485,74,1100,57
6,-1,0,6.0,-1.0,0.8733599185943604,6.4818792991333325,7,30,17,1843,485,74,1100,57
5,-2,0,5.0,-2.0,0.8812170028686523,3.4006369362151645,7,25,19,1843,485,74,1100,57
5,-2,0,5.0,-2.0,0.8892619609832764,1.0,7,20,21,1843,485,74,1100,57
7,-1,0,7.0,-1.0,0.8971900939941406,-2.4461353216387245,7,13,22,1843,485,74,1100,57
6,-1,0,6.0,-1.0,0.9051759243011475,-3.9583694396573854,7,7,23,1843,485,74,1100,57
6,-1,0,6.0,-1.0,0.9130270481109619,-3.979175701071373,7,1,24,1843,485,74,1100,57
4,-1,0,4.0,-1.0,0.9210340976715088,-2.820643375971656,7,-3,25,1843,485,74,1100,57
5,-1,0,5.0,-1.0,0.9291000366210938,-0.7970589825291121,7,-8,26,1843,485,74,1100,57
3,-1,0,3.0,-1.0,0.9378321170806885,1.154759474226502,7,-11,27,1843,485,74,1100,57
2,-1,0,2.0,-1.0,0.9450070858001709,2.870698080866262,7,-13,28,1843,485,74,1100,57
1,0,0,1.0,-0.0,0.953139066696167,3.3049516849970573,7,-14,28,1843,485,74,1100,57
0,0,1,-0.0,-0.0,0.9780571460723877,3.3049516849970573,7,-14,28,1843,485,74,1100,57
0,0,0,-0.0,-0.0,0.08072900772094727,1440.635786571038,8,-1449,-116,408,341,1857,457,27
-3,0,0,-3.0,-0.0,0.12699389457702637,1437.6453736182389,8,-1446,-116,408,341,1857,457,27
-5,0,0,-5.0,-0.0,0.13491010665893555,1432.6614403102824,8,-1441,-116,408,341,1857,457,27
-5,1,0,-5.0,1.0,0.1429119110107422,1427.758480800998,8,-1436,-117,408,341,1857,457,27
-8,2,0,-8.0,2.0,0.15074396133422852,1419.9497548762831,8,-1428,-119,408,341,1857,457,27
-9,2,0,-9.0,2.0,0.15872693061828613,1411.149570796551,8,-1419,-121,408,341,1857,457,27
-10,3,0,-10.0,3.0,0.16678404808044434,1401.4458278774766,8,-1409,-124,408,341,1857,457,27
-11,3,0,-11.0,3.0,0.17477798461914062,1390.7567453088159,8,-1398,-127,408,341,1857,457,27
-12,4,0,-12.0,4.0,0.18265390396118164,1379.1770720709346,8,-1386,-131,408,341,1857,457,27
-12,3,0,-12.0,3.0,0.1907179355621338,1367.5187430817446,8,-1374,-134,408,341,1857,457,27
-18,4,0,-18.0,4.0,0.19876790046691895,1350.004035210461,8,-1356,-138,408,341,1857,457,27
-23,3,0,-23.0,3.0,0.2068948745727539,1327.4364960713358,8,-1333,-141,408,341,1857,457,27
-30,3,0,-30.0,3.0,0.21513605117797852,1297.9328739489295,8,-1303,-144,408,341,1857,457,27
-36,2,0,-36.0,2.0,0.22290396690368652,1262.3842558225344,8,-1267,-146,408,341,1857,457,27
-39,0,0,-39.0,-0.0,0.23087191581726074,1223.64869708418,8,-1228,-146,408,341,1857,457,27
-43,-2,0,-43.0,-2.0,0.23880910873413086,1180.7173032171395,8,-1185,-144,408,341,1857,457,27
-45,-3,0,-45.0,-3.0,0.24672389030456543,1135.68664134306,8,-1140,-141,408,341,1857,457,27
-42,-4,0,-42.0,-4.0,0.254863977432251,1093.5138950776895,8,-1098,-137,408,341,1857,457,27
-39,-3,0,-39.0,-3.0,0.2629220485687256,1054.4441437377413,8,-1059,-134,408,341,1857,457,27
-35,-4,0,-35.0,-4.0,0.2707788944244385,1019.2189690177177,8,-1024,-130,408,341,1857,457,27
-34,-4,0,-34.0,-4.0,0.27907609939575195,984.985971845296,8,-990,-126,408,341,1857,457,27
-33,-6,0,-33.0,-6.0,0.28707098960876465,951.4941679450426,8,-957,-120,408,341,1857,457,27
-33,-5,0,-33.0,-5.0,0.29502296447753906,918.128884741527,8,-924,-115,408,341,1857,457,27
-35,-6,0,-35.0,-6.0,0.30304598808288574,882.6573005340827,8,-889,-109,408,341,1857,457,27
-38,-7,0,-38.0,-7.0,0.31078410148620605,844.0910103367087,8,-851,-102,408,341,1857,457,27
-41,-7,0,-41.0,-7.0,0.3187859058380127,802.5519603311612,8,-810,-95,408,341,1857,457,27
-43,-8,0,-43.0,-8.0,0.3267669677734375,758.9183894687313,8,-767,-87,408,341,1857,457,27
-46,-8,0,-46.0,-8.0,0.3346569538116455,712.3151039375921,8,-721,-79,408,341,1857,457,27
-42,-7,0,-42.0,-7.0,0.3428940773010254,669.8067076413354,8,-679,-72,408,341,1857,457,27
-42,-6,0,-42.0,-6.0,0.350985050201416,627.4100249059192,8,-637,-66,408,341,1857,457,27
-36,-5,0,-36.0,-5.0,0.359158992767334,591.0877419713133,8,-601,-61,408,341,1857,457,27
-30,-4,0,-30.0,-4.0,0.3670639991760254,560.8379562210921,8,-571,-57,408,341,1857,457,27
-27,-4,0,-27.0,-4.0,0.3747680187225342,533.5757038142109,8,-544,-53,408,341,1857,457,27
-25,-3,0,-25.0,-3.0,0.3827528953552246,508.40291522008204,8,-519,-50,408,341,1857,457,27
-20,-3,0,-20.0,-3.0,0.39057397842407227,488.20853943244026,8,-499,-47,408,341,1857,457,27
-18,-4,0,-18.0,-4.0,0.39861488342285156,469.9182125370713,8,-481,-43,408,341,1857,457,27
-17,-3,0,-17.0,-3.0,0.40665197372436523,452.7209464904923,8,-464,-40,408,341,1857,457,27
-15,-2,0,-15.0,-2.0,0.4145839214324951,437.6051486612198,8,-449,-38,408,341,1857,457,27
-13,-1,0,-13.0,-1.0,0.42267489433288574,424.5671377057468,8,-436,-37,408,341,1857,457,27
-14,-1,0,-14.0,-1.0,0.4308180809020996,410.5327614246624,8,-422,-36,408,341,1857,457,27
-13,-1,0,-13.0,-1.0,0.43886590003967285,397.4948233534742,8,-409,-35,408,341,1857,457,27
-14,-1,0,-14.0,-1.0,0.4467799663543701,383.4605907275022,8,-395,-34,408,341,1857,457,27
-13,0,0,-13.0,-0.0,0.4547898769378662,370.5101041693687,8,-382,-34,408,341,1857,457,27
-12,0,0,-12.0,-0.0,0.4626801013946533,358.5588782413899,8,-370,-34,408,341,1857,457,27
-11,0,0,-11.0,-0.0,0.47087907791137695,347.60643366418185,8,-359,-34,408,341,1857,457,27
-10,0,0,-10.0,-0.0,0.47873497009277344,337.6522493867678,8,-349,-34,408,341,1857,457,27
-11,0,0,-11.0,-0.0,0.48688387870788574,326.70575502926056,8,-338,-34,408,341,1857,457,27
-11,-1,0,-11.0,-1.0,0.49475598335266113,315.6609194899813,8,-327,-33,408,341,1857,457,27
-13,-1,0,-13.0,-1.0,0.5033519268035889,302.6263613832026,8,-314,-32,408,341,1857,457,27
-12,0,0,-12.0,-0.0,0.5108070373535156,290.6906320583498,8,-302,-32,408,341,1857,457,27
-11,0,0,-11.0,-0.0,0.5187380313873291,279.7541630788536,8,-291,-32,408,341,1857,457,27
-12,0,0,-12.0,-0.0,0.5267848968505859,267.8291295432153,8,-279,-32,408,341,1857,457,27
-11,0,0,-11.0,-0.0,0.534804105758667,256.9036865253974,8,-268,-32,408,341,1857,457,27
-13,0,0,-13.0,-0.0,0.5427389144897461,244.0,8,-255,-32,408,341,1857,457,27
-13,0,0,-13.0,-0.0,0.550786018371582,231.10653411983876,8,-242,-32,408,341,1857,457,27
-12,-1,0,-12.0,-1.0,0.5587210655212402,219.07972767995054,8,-230,-31,408,341,1857,457,27
-11,-1,0,-11.0,-1.0,0.5668210983276367,208.04524423746375,8,-219,-30,408,341,1857,457,27
-11,-1,0,-11.0,-1.0,0.5747220516204834,197.01190442448734,8,-208,-29,408,341,1857,457,27
-11,-2,0,-11.0,-2.0,0.5835878849029541,185.84164553734712,8,-197,-27,408,341,1857,457,27
-13,-3,0,-13.0,-3.0,0.5907020568847656,172.55861607589122,8,-184,-24,408,341,1857,457,27
-11,-2,0,-11.0,-2.0,0.5987811088562012,161.39323381370048,8,-173,-22,408,341,1857,457,27
-12,-4,0,-12.0,-4.0,0.6068329811096191,149.00308639035245,8,-161,-18,408,341,1857,457,27
-11,-3,0,-11.0,-3.0,0.6147539615631104,137.74813431681335,8,-150,-15,408,341,1857,457,27
-11,-3,0,-11.0,-3.0,0.6229219436645508,126.51702405083043,8,-139,-12,408,341,1857,457,27
-11,-4,0,-11.0,-4.0,0.6307930946350098,115.24975633505119,8,-128,-8,408,341,1857,457,27
-11,-3,0,-11.0,-3.0,0.6387948989868164,104.10678887237921,8,-117,-5,408,341,1857,457,27
-12,-3,0,-12.0,-3.0,0.6467890739440918,92.01904589168576,8,-105,-2,408,341,1857,457,27
-10,-3,0,-10.0,-3.0,0.6547908782958984,82.00526301210897,8,-95,1,408,341,1857,457,27
-11,-3,0,-11.0,-3.0,0.663322925567627,71.09518416651456,8,-84,4,408,341,1857,457,27
-10,-2,0,-10.0,-2.0,0.6710469722747803,61.24284477308234,8,-74,6,408,341,1857,457,27
-10,-2,0,-10.0,-2.0,0.6788709163665771,51.49806198638839,8,-64,8,408,341,1857,457,27
-9,-2,0,-9.0,-2.0,0.686892032623291,42.90169943749474,8,-55,10,408,341,1857,457,27
-7,-2,0,-7.0,-2.0,0.6948280334472656,36.47726750741192,8,-48,12,408,341,1857,457,27
-7,-1,0,-7.0,-1.0,0.7029049396514893,30.011626335213137,8,-41,13,408,341,1857,457,27
-6,-1,0,-6.0,-1.0,0.7107648849487305,24.69615364994153,8,-35,14,408,341,1857,457,27
-5,-1,0,-5.0,-1.0,0.7187869548797607,20.541019662496844,8,-30,15,408,341,1857,457,27
-4,-1,0,-4.0,-1.0,0.7268099784851074,17.528675044947494,8,-26,16,408,341,1857,457,27
-3,0,0,-3.0,-0.0,0.734900951385498,15.0178514522438,8,-23,16,408,341,1857,457,27
-2,-1,0,-2.0,-1.0,0.7429120540618896,14.018512172212592,8,-21,17,408,341,1857,457,27
-3,0,0,-3.0,-0.0,0.7508618831634521,11.758836806279895,8,-18,17,408,341,1857,457,27
-2,-1,0,-2.0,-1.0,0.75888991355896,11.083189157584592,8,-16,18,408,341,1857,457,27
-2,0,0,-2.0,-0.0,0.7668259143829346,9.803508501982758,8,-14,18,408,341,1857,457,27
-2,0,0,-2.0,-0.0,0.774683952331543,8.633307652783937,8,-12,18,408,341,1857,457,27
-4,-1,0,-4.0,-1.0,0.782634973526001,7.615528128088304,8,-8,19,408,341,1857,457,27
-3,0,0,-3.0,-0.0,0.7908051013946533,6.646882704388499,8,-5,19,408,341,1857,457,27
-2,0,0,-2.0,-0.0,0.79876708984375,6.235384061671343,8,-3,19,408,341,1857,457,27
-2,0,0,-2.0,-0.0,0.806757926940918,6.026297590440446,8,-1,19,408,341,1857,457,27
-2,0,0,-2.0,-0.0,0.8147280216217041,6.026297590440446,8,1,19,408,341,1857,457,27
-1,0,0,-1.0,-0.0,0.8227639198303223,6.104973174542799,8,2,19,408,341,1857,457,27
-1,0,0,-1.0,-0.0,0.8388988971710205,6.235384061671343,8,3,19,408,341,1857,457,27
0,0,1,-0.0,-0.0,0.8858330249786377,6.235384061671343,8,3,19,408,341,1857,457,27
0,0,0,-0.0,-0.0,0.07468152046203613,828.8105671265803,9,567,633,972,955,405,322,42
2,0,0,2.0,-0.0,0.12892961502075195,827.4774599245403,9,565,633,972,955,405,322,42
4,1,0,4.0,1.0,0.13687348365783691,824.071002934073,9,561,632,972,955,405,322,42
6,1,0,6.0,1.0,0.1446835994720459,819.3487371323884,9,555,631,972,955,405,322,42
6,2,0,6.0,2.0,0.15268754959106445,813.8904119703376,9,549,629,972,955,405,322,42
7,2,0,7.0,2.0,0.1606614589691162,807.790081986989,9,542,627,972,955,405,322,42
6,3,0,6.0,3.0,0.16962051391601562,801.6007537074106,9,536,624,972,955,405,322,42
6,3,0,6.0,3.0,0.17691445350646973,795.4196224981367,9,530,621,972,955,405,322,42
5,4,0,5.0,4.0,0.18471145629882812,789.1320879955317,9,525,617,972,955,405,322,42
7,7,0,7.0,7.0,0.19273161888122559,779.2649561239077,9,518,610,972,955,405,322,42
11,8,0,11.0,8.0,0.20060062408447266,766.0533654079627,9,507,602,972,955,405,322,42
14,10,0,14.0,10.0,0.20863056182861328,749.3979491146118,9,493,592,972,955,405,322,42
16,13,0,16.0,13.0,0.21675848960876465,729.1799784051824,9,477,579,972,955,405,322,42
18,16,0,18.0,16.0,0.22479748725891113,705.3952092353032,9,459,563,972,955,405,322,42
18,15,0,18.0,15.0,0.23320245742797852,682.4095535319377,9,441,548,972,955,405,322,42
19,17,0,19.0,17.0,0.24083447456359863,657.26617194137,9,422,531,972,955,405,322,42
22,23,0,22.0,23.0,0.24887967109680176,625.578688173373,9,400,508,972,955,405,322,42
23,27,0,23.0,27.0,0.2565765380859375,590.1382822242442,9,377,481,972,955,405,322,42
22,25,0,22.0,25.0,0.26477646827697754,556.893588820641,9,355,456,972,955,405,322,42
21,26,0,21.0,26.0,0.27280759811401367,523.4777314087327,9,334,430,972,955,405,322,42
20,24,0,20.0,24.0,0.2806284427642822,492.2562712719641,9,314,406,972,955,405,322,42
19,24,0,19.0,24.0,0.2884945869445801,461.64790479188866,9,295,382,972,955,405,322,42
19,23,0,19.0,23.0,0.29694461822509766,431.83219850182917,9,276,359,972,955,405,322,42
17,21,0,17.0,21.0,0.3046236038208008,404.82273307093413,9,259,338,972,955,405,322,42
18,22,0,18.0,22.0,0.31284356117248535,376.4128835354989,9,241,316,972,955,405,322,42
16,20,0,16.0,20.0,0.3207244873046875,350.8077460193642,9,225,296,972,955,405,322,42
16,18,0,16.0,18.0,0.3287835121154785,326.80023001717524,9,209,278,972,955,405,322,42
13,17,0,13.0,17.0,0.336667537689209,305.400061274504,9,196,261,972,955,405,322,42
13,14,0,13.0,14.0,0.3446686267852783,286.405269961333,9,183,247,972,955,405,322,42
13,14,0,13.0,14.0,0.3527565002441406,267.4250335875858,9,170,233,972,955,405,322,42
9,10,0,9.0,10.0,0.36066150665283203,254.04545078950133,9,161,223,972,955,405,322,42
10,10,0,10.0,10.0,0.3687155246734619,240.09385285755008,9,151,213,972,955,405,322,42
8,9,0,8.0,9.0,0.3767526149749756,228.12848090894786,9,143,204,972,955,405,322,42
6,7,0,6.0,7.0,0.38474345207214355,218.95416228938393,9,137,197,972,955,405,322,42
4,8,0,4.0,8.0,0.3927786350250244,210.10603626906848,9,133,189,972,955,405,322,42
5,6,0,5.0,6.0,0.4009096622467041,202.32263655975405,9,128,183,972,955,405,322,42
4,6,0,4.0,6.0,0.40883755683898926,195.11339616044165,9,124,177,972,955,405,322,42
4,6,0,4.0,6.0,0.4167766571044922,187.90428430264421,9,120,171,972,955,405,322,42
5,6,0,5.0,6.0,0.4245924949645996,180.12185361118767,9,115,165,972,955,405,322,42
5,5,0,5.0,5.0,0.43266844749450684,173.164878389476,9,110,160,972,955,405,322,42
6,6,0,6.0,6.0,0.4407196044921875,164.82787734890587,9,104,154,972,955,405,322,42
5,6,0,5.0,6.0,0.44861865043640137,157.05897899291685,9,99,148,972,955,405,322,42
5,8,0,5.0,8.0,0.4566175937652588,147.6297719858507,9,94,140,972,955,405,322,42
4,6,0,4.0,6.0,0.4647104740142822,140.4187101918486,9,90,134,972,955,405,322,42
2,4,0,2.0,4.0,0.47275757789611816,135.98407562552325,9,88,130,972,955,405,322,42
1,5,0,1.0,5.0,0.48108458518981934,131.2957648787385,9,87,125,972,955,405,322,42
1,4,0,1.0,4.0,0.48869967460632324,127.44864431849825,9,86,121,972,955,405,322,42
2,4,0,2.0,4.0,0.4967036247253418,123.03124660989366,9,84,117,972,955,405,322,42
1,5,0,1.0,5.0,0.5047435760498047,118.40229553346674,9,83,112,972,955,405,322,42
1,4,0,1.0,4.0,0.5128514766693115,114.60235986147143,9,82,108,972,955,405,322,42
3,4,0,3.0,4.0,0.5207774639129639,109.60245020672468,9,79,104,972,955,405,322,42
3,4,0,3.0,4.0,0.5288405418395996,104.60254774486066,9,76,100,972,955,405,322,42
2,5,0,2.0,5.0,0.5366384983062744,99.42009799032718,9,74,95,972,955,405,322,42
3,5,0,3.0,5.0,0.5446336269378662,93.63420083029322,9,71,90,972,955,405,322,42
3,4,0,3.0,4.0,0.5526385307312012,88.63576058932597,9,68,86,972,955,405,322,42
3,6,0,3.0,6.0,0.5606706142425537,82.07764064044152,9,65,80,972,955,405,322,42
3,6,0,3.0,6.0,0.5686726570129395,75.54014708917737,9,62,74,972,955,405,322,42
4,6,0,4.0,6.0,0.5766966342926025,68.37561188601732,9,58,68,972,955,405,322,42
3,6,0,3.0,6.0,0.5847415924072266,61.87943049997388,9,55,62,972,955,405,322,42
3,5,0,3.0,5.0,0.5927846431732178,56.15568676384133,9,52,57,972,955,405,322,42
3,5,0,3.0,5.0,0.6007266044616699,50.449282711585,9,49,52,972,955,405,322,42
3,6,0,3.0,6.0,0.6087296009063721,44.05382386916237,9,46,46,972,955,405,322,42
4,4,0,4.0,4.0,0.616614580154419,38.39696961966999,9,42,42,972,955,405,322,42
3,5,0,3.0,5.0,0.6246545314788818,32.75872022286245,9,39,37,972,955,405,322,42
3,3,0,3.0,3.0,0.6325855255126953,28.51767361255979,9,36,34,972,955,405,322,42
3,5,0,3.0,5.0,0.6406974792480469,22.931765272977593,9,33,29,972,955,405,322,42
4,5,0,4.0,5.0,0.649059534072876,16.64306044943742,9,29,24,972,955,405,322,42
4,4,0,4.0,4.0,0.6566295623779297,11.015621187164243,9,25,20,972,955,405,322,42
4,4,0,4.0,4.0,0.6648776531219482,5.4007575648881705,9,21,16,972,955,405,322,42
3,3,0,3.0,3.0,0.6726055145263672,1.2036033111745184,9,18,13,972,955,405,322,42
2,2,0,2.0,2.0,0.6806645393371582,-1.5835121610524006,9,16,11,972,955,405,322,42
2,2,0,2.0,2.0,0.6887216567993164,-4.356683022906761,9,14,9,972,955,405,322,42
1,2,0,1.0,2.0,0.6966686248779297,-6.2351769397666,9,13,7,972,955,405,322,42
1,1,0,1.0,1.0,0.7046966552734375,-7.583592135001261,9,12,6,972,955,405,322,42
1,0,0,1.0,-0.0,0.7126264572143555,-8.470035913858332,9,11,6,972,955,405,322,42
1,1,0,1.0,1.0,0.7211954593658447,-9.819660112501051,9,10,5,972,955,405,322,42
0,1,0,-0.0,1.0,0.7289676666259766,-10.229670385730993,9,10,4,972,955,405,322,42
1,0,0,1.0,-0.0,0.7367885112762451,-11.151142198203896,9,9,4,972,955,405,322,42
0,1,0,-0.0,1.0,0.744666576385498,-11.513167019494862,9,9,3,972,955,405,322,42
1,0,0,1.0,-0.0,0.7526295185089111,-12.45599625468247,9,8,3,972,955,405,322,42
0,0,1,-0.0,-0.0,0.7865664958953857,-12.45599625468247,9,8,3,972,955,405,322,42
0,0,0,-0.0,-0.0,0.06543159484863281,113.07980517283357,10,-104,-58,860,894,964,952,12
1,-1,0,1.0,-1.0,0.15272855758666992,113.47384651043926,10,-105,-57,860,894,964,952,12
1,-3,0,1.0,-3.0,0.160691499710083,112.96217886370441,10,-106,-54,860,894,964,952,12
0,-3,0,-0.0,-3.0,0.16850948333740234,111.63077828527702,10,-106,-51,860,894,964,952,12
1,-3,0,1.0,-3.0,0.1766185760498047,111.27318534089538,10,-107,-48,860,894,964,952,12
0,-3,0,-0.0,-3.0,0.18459057807922363,110.0775602776006,10,-107,-45,860,894,964,952,12
0,-4,0,-0.0,-4.0,0.19260168075561523,108.58621208504974,10,-107,-41,860,894,964,952,12
-4,-4,0,-4.0,-4.0,0.20058465003967285,103.4440496326776,10,-103,-37,860,894,964,952,12
-4,-4,0,-4.0,-4.0,0.20860958099365234,98.35516278555652,10,-99,-33,860,894,964,952,12
-6,-4,0,-6.0,-4.0,0.21662354469299316,91.41663102366043,10,-93,-29,860,894,964,952,12
-3,-2,0,-3.0,-2.0,0.22477149963378906,87.96275858019496,10,-90,-27,860,894,964,952,12
-5,-3,0,-5.0,-3.0,0.2325756549835205,82.32326986700618,10,-85,-24,860,894,964,952,12
-5,-2,0,-5.0,-2.0,0.2406785488128662,76.96987405076617,10,-80,-22,860,894,964,952,12
-6,-3,0,-6.0,-3.0,0.2485666275024414,70.40026177965623,10,-74,-19,860,894,964,952,12
-7,-2,0,-7.0,-2.0,0.25651049613952637,63.12307863514182,10,-67,-17,860,894,964,952,12
-7,-3,0,-7.0,-3.0,0.26447248458862305,55.61168720299745,10,-60,-14,860,894,964,952,12
-8,-4,0,-8.0,-4.0,0.27237462997436523,46.952809179494906,10,-52,-10,860,894,964,952,12
-10,-3,0,-10.0,-3.0,0.280409574508667,36.579337712087536,10,-42,-7,860,894,964,952,12
-12,-4,0,-12.0,-4.0,0.28861069679260254,24.14962686336267,10,-30,-3,860,894,964,952,12
-11,-3,0,-11.0,-3.0,0.29654669761657715,13.0,10,-19,0,860,894,964,952,12
-9,-3,0,-9.0,-3.0,0.30472469329833984,4.440306508910551,10,-10,3,860,894,964,952,12
-7,-1,0,-7.0,-1.0,0.3127295970916748,-1.0,10,-3,4,860,894,964,952,12
-6,-2,0,-6.0,-2.0,0.3205745220184326,0.7082039324993694,10,3,6,860,894,964,952,12
-3,-1,0,-3.0,-1.0,0.32860851287841797,3.219544457292887,10,6,7,860,894,964,952,12
-3,-1,0,-3.0,-1.0,0.3364906311035156,6.041594578792296,10,9,8,860,894,964,952,12
-1,0,0,-1.0,-0.0,0.34461069107055664,6.806248474865697,10,10,8,860,894,964,952,12
-1,0,0,-1.0,-0.0,0.35258960723876953,7.601470508735444,10,11,8,860,894,964,952,12
0,0,1,-0.0,-0.0,0.43662261962890625,7.601470508735444,10,11,8,860,894,964,952,12
0,0,0,-0.0,-0.0,0.515526533126831,7.601470508735444,10,11,8,860,894,964,952,12
1,0,0,1.0,-0.0,0.6086435317993164,6.806248474865697,10,10,8,860,894,964,952,12
1,0,0,1.0,-0.0,0.6166195869445801,6.041594578792296,10,9,8,860,894,964,952,12
2,0,0,2.0,-0.0,0.6244475841522217,4.63014581273465,10,7,8,860,894,964,952,12
1,0,0,1.0,-0.0,0.6324365139007568,4.0,10,6,8,860,894,964,952,12
1,0,0,1.0,-0.0,0.6405096054077148,3.433981132056603,10,5,8,860,894,964,952,12
2,1,0,2.0,1.0,0.6485705375671387,1.6157731058639087,10,3,7,860,894,964,952,12
3,0,0,3.0,-0.0,0.656517505645752,1.0,10,0,7,860,894,964,952,12
1,0,0,1.0,-0.0,0.6644406318664551,1.0710678118654755,10,-1,7,860,894,964,952,12
2,1,0,2.0,1.0,0.672581672668457,0.7082039324993694,10,-3,6,860,894,964,952,12
1,0,0,1.0,-0.0,0.6804745197296143,1.2111025509279782,10,-4,6,860,894,964,952,12
1,0,0,1.0,-0.0,0.6885755062103271,1.810249675906654,10,-5,6,860,894,964,952,12
0,1,0,-0.0,1.0,0.6965696811676025,1.0710678118654755,10,-5,5,860,894,964,952,12
1,0,0,1.0,-0.0,0.7045235633850098,1.810249675906654,10,-6,5,860,894,964,952,12
0,0,1,-0.0,-0.0,0.7426455020904541,1.810249675906654,10,-6,5,860,894,964,952,12
0,0,0,-0.0,-0.0,0.09986758232116699,423.9130352577539,11,-296,-352,570,537,866,889,72
-1,0,0,-1.0,-0.0,0.19083571434020996,423.2700730507051,11,-295,-352,570,537,866,889,72
-1,0,0,-1.0,-0.0,0.206770658493042,422.62838987572496,11,-294,-352,570,537,866,889,72
-1,0,0,-1.0,-0.0,0.21482467651367188,421.98799110893725,11,-293,-352,570,537,866,889,72
-1,-1,0,-1.0,-1.0,0.22285175323486328,420.5796754127367,11,-292,-351,570,537,866,889,72
-1,-1,0,-1.0,-1.0,0.23078370094299316,419.1713962893538,11,-291,-350,570,537,866,889,72
0,-2,0,-0.0,-2.0,0.2388145923614502,417.6353160855094,11,-291,-348,570,537,866,889,72
-2,-4,0,-2.0,-4.0,0.24672365188598633,413.2849875079291,11,-289,-344,570,537,866,889,72
-4,-11,0,-4.0,-11.0,0.2548377513885498,402.308110807911,11,-285,-333,570,537,866,889,72
-6,-14,0,-6.0,-14.0,0.26274776458740234,387.7947616476636,11,-279,-319,570,537,866,889,72
-8,-17,0,-8.0,-17.0,0.2708306312561035,369.7647101461634,11,-271,-302,570,537,866,889,72
-12,-18,0,-12.0,-18.0,0.27881956100463867,348.365711269879,11,-259,-284,570,537,866,889,72
-14,-20,0,-14.0,-20.0,0.28690457344055176,324.16801634792614,11,-245,-264,570,537,866,889,72
-17,-19,0,-17.0,-19.0,0.29493165016174316,298.6774566653691,11,-228,-245,570,537,866,889,72
-17,-18,0,-17.0,-18.0,0.30280256271362305,273.9193443462347,11,-211,-227,570,537,866,889,72
-15,-15,0,-15.0,-15.0,0.31079769134521484,252.72131892189742,11,-196,-212,570,537,866,889,72
-12,-14,0,-12.0,-14.0,0.3188285827636719,234.29613389761977,11,-184,-198,570,537,866,889,72
-11,-13,0,-11.0,-13.0,0.3268756866455078,217.28639916110774,11,-173,-185,570,537,866,889,72
-12,-12,0,-12.0,-12.0,0.33482956886291504,200.32604596192948,11,-161,-173,570,537,866,889,72
-12,-12,0,-12.0,-12.0,0.34290361404418945,183.36727194365162,11,-149,-161,570,537,866,889,72
-11,-9,0,-11.0,-9.0,0.35092878341674805,169.2997808084558,11,-138,-152,570,537,866,889,72
-11,-9,0,-11.0,-9.0,0.35875964164733887,155.25375813301028,11,-127,-143,570,537,866,889,72
-10,-9,0,-10.0,-9.0,0.3669116497039795,141.89041570584965,11,-117,-134,570,537,866,889,72
-10,-10,0,-10.0,-10.0,0.37484073638916016,127.783393541592,11,-107,-124,570,537,866,889,72
-9,-9,0,-9.0,-9.0,0.3830597400665283,115.09268678529745,11,-98,-115,570,537,866,889,72
-8,-8,0,-8.0,-8.0,0.39088869094848633,103.8177385026664,11,-90,-107,570,537,866,889,72
-8,-8,0,-8.0,-8.0,0.3988516330718994,92.54960132182441,11,-82,-99,570,537,866,889,72
-6,-8,0,-6.0,-8.0,0.40681958198547363,82.56221995222593,11,-76,-91,570,537,866,889,72
-7,-7,0,-7.0,-7.0,0.41472959518432617,72.70602559196064,11,-69,-84,570,537,866,889,72
-4,-5,0,-4.0,-5.0,0.4228026866912842,66.30347012687302,11,-65,-79,570,537,866,889,72
-4,-5,0,-4.0,-5.0,0.4324166774749756,59.90099061010788,11,-61,-74,570,537,866,889,72
-5,-4,0,-5.0,-4.0,0.4387955665588379,53.64373932405988,11,-56,-70,570,537,866,889,72
-4,-4,0,-4.0,-4.0,0.4468495845794678,48.02380615040002,11,-52,-66,570,537,866,889,72
-5,-5,0,-5.0,-5.0,0.4548227787017822,41.00649323271382,11,-47,-61,570,537,866,889,72
-4,-4,0,-4.0,-4.0,0.4628176689147949,35.40028011149536,11,-43,-57,570,537,866,889,72
-4,-3,0,-4.0,-3.0,0.47088074684143066,30.610809933523555,11,-39,-54,570,537,866,889,72
-2,-2,0,-2.0,-2.0,0.4787876605987549,27.820059542435402,11,-37,-52,570,537,866,889,72
0,-1,0,-0.0,-1.0,0.4868175983428955,27.00793600809346,11,-37,-51,570,537,866,889,72
0,0,1,-0.0,-0.0,0.5217926502227783,27.00793600809346,11,-37,-51,570,537,866,889,72
0,0,0,-0.0,-0.0,0.06301188468933105,634.4503726869887,12,643,-179,1250,409,607,588,66
1,0,0,1.0,-0.0,0.19606399536132812,633.4870591391854,12,642,-179,1250,409,607,588,66
5,0,0,5.0,-0.0,0.20460987091064453,628.6721242428156,12,637,-179,1250,409,607,588,66
9,0,0,9.0,-0.0,0.2121419906616211,620.0122510336234,12,628,-179,1250,409,607,588,66
11,0,0,11.0,-0.0,0.21991801261901855,609.4406587382215,12,617,-179,1250,409,607,588,66
13,-1,0,13.0,-1.0,0.22815585136413574,596.6824596572466,12,604,-178,1250,409,607,588,66
16,-2,0,16.0,-2.0,0.23629093170166016,580.7752031485143,12,588,-176,1250,409,607,588,66
20,-1,0,20.0,-1.0,0.243818998336792,561.3475414267313,12,568,-175,1250,409,607,588,66
26,-2,0,26.0,-2.0,0.2518939971923828,535.9402429078119,12,542,-173,1250,409,607,588,66
28,-3,0,28.0,-3.0,0.2598700523376465,508.3834131186511,12,514,-170,1250,409,607,588,66
32,-4,0,32.0,-4.0,0.26790690422058105,476.7842680977906,12,482,-166,1250,409,607,588,66
33,-5,0,33.0,-5.0,0.27591800689697266,443.99266241735836,12,449,-161,1250,409,607,588,66
32,-8,0,32.0,-8.0,0.283998966217041,411.1823949685534,12,417,-153,1250,409,607,588,66
31,-9,0,31.0,-9.0,0.29192304611206055,378.9854366358112,12,386,-144,1250,409,607,588,66
29,-9,0,29.0,-9.0,0.29986095428466797,348.67263459671824,12,357,-135,1250,409,607,588,66
27,-10,0,27.0,-10.0,0.307858943939209,319.8809997718778,12,330,-125,1250,409,607,588,66
25,-9,0,25.0,-9.0,0.31583595275878906,293.31426570102633,12,305,-116,1250,409,607,588,66
21,-9,0,21.0,-9.0,0.3239619731903076,270.48805577814755,12,284,-107,1250,409,607,588,66
17,-8,0,17.0,-8.0,0.3319869041442871,251.76305940202286,12,267,-99,1250,409,607,588,66
15,-7,0,15.0,-7.0,0.33992791175842285,235.26852219371546,12,252,-92,1250,409,607,588,66
15,-8,0,15.0,-8.0,0.3479480743408203,218.44581921360316,12,237,-84,1250,409,607,588,66
11,-8,0,11.0,-8.0,0.3560609817504883,205.43657437566074,12,226,-76,1250,409,607,588,66
10,-7,0,10.0,-7.0,0.36383700370788574,193.75316976836288,12,216,-69,1250,409,607,588,66
7,-6,0,7.0,-6.0,0.3717679977416992,185.28879952943075,12,209,-63,1250,409,607,588,66
7,-5,0,7.0,-5.0,0.37996697425842285,177.16184239771025,12,202,-58,1250,409,607,588,66
6,-5,0,6.0,-5.0,0.38828301429748535,170.03940504246953,12,196,-53,1250,409,607,588,66
5,-4,0,5.0,-4.0,0.3958868980407715,164.18519214180358,12,191,-49,1250,409,607,588,66
2,-2,0,2.0,-2.0,0.40391993522644043,161.7562579225633,12,189,-47,1250,409,607,588,66
2,-2,0,2.0,-2.0,0.4118819236755371,159.33824372703418,12,187,-45,1250,409,607,588,66
1,0,0,1.0,-0.0,0.4199669361114502,158.36614120580475,12,186,-45,1250,409,607,588,66
3,0,0,3.0,-0.0,0.4681069850921631,155.45158529447292,12,183,-45,1250,409,607,588,66
3,-1,0,3.0,-1.0,0.4759230613708496,152.29975715040752,12,180,-44,1250,409,607,588,66
3,0,0,3.0,-0.0,0.48384594917297363,149.3869512876401,12,177,-44,1250,409,607,588,66
0,0,1,-0.0,-0.0,0.48700785636901855,149.3869512876401,12,177,-44,1250,409,607,588,66
2,0,1,2.0,-0.0,0.49191904067993164,147.44666802132977,12,175,-44,1250,409,607,588,66
2,0,1,2.0,-0.0,0.4999120235443115,145.5077029150283,12,173,-44,1250,409,607,588,66
2,-1,1,2.0,-1.0,0.5079350471496582,143.32356620712955,12,171,-43,1250,409,607,588,66
2,0,1,2.0,-0.0,0.5240139961242676,141.38463235044537,12,169,-43,1250,409,607,588,66
3,0,1,3.0,-0.0,0.5319919586181641,138.4788616710526,12,166,-43,1250,409,607,588,66
5,0,1,5.0,-0.0,0.5398709774017334,133.6433316997713,12,161,-43,1250,409,607,588,66
7,-1,1,7.0,-1.0,0.5479240417480469,126.62455951387932,12,154,-42,1250,409,607,588,66
10,0,1,10.0,-0.0,0.5558688640594482,117.0,12,144,-42,1250,409,607,588,66
0,0,0,-0.0,-0.0,0.560858964920044,117.0,12,144,-42,1250,409,607,588,66
13,-2,0,13.0,-2.0,0.5637869834899902,103.97079980784227,12,131,-40,1250,409,607,588,66
14,-1,0,14.0,-1.0,0.5718119144439697,90.3288287465668,12,117,-39,1250,409,607,588,66
16,-2,0,16.0,-2.0,0.5799729824066162,74.56393447619885,12,101,-37,1250,409,607,588,66
17,-3,0,17.0,-3.0,0.5879008769989014,57.620086073673534,12,84,-34,1250,409,607,588,66
17,-3,0,17.0,-3.0,0.596013069152832,40.824115301167,12,67,-31,1250,409,607,588,66
15,-4,0,15.0,-4.0,0.603813886642456,25.59180830116101,12,52,-27,1250,409,607,588,66
15,-4,0,15.0,-4.0,0.6120350360870361,10.56604182158393,12,37,-23,1250,409,607,588,66
12,-4,0,12.0,-4.0,0.6201138496398926,-1.5993630637848355,12,25,-19,1250,409,607,588,66
9,-2,0,9.0,-2.0,0.6280579566955566,-9.654764940142496,12,16,-17,1250,409,607,588,66
5,-3,0,5.0,-3.0,0.6359150409698486,-15.195506185235143,12,11,-14,1250,409,607,588,66
4,-1,0,4.0,-1.0,0.6439130306243896,-18.2351769397666,12,7,-13,1250,409,607,588,66
1,-2,0,1.0,-2.0,0.6526889801025391,-20.470035913858332,12,6,-11,1250,409,607,588,66
1,0,0,1.0,-0.0,0.6598949432373047,-20.916954026405428,12,5,-11,1250,409,607,588,66
0,0,1,-0.0,-0.0,0.6810250282287598,-20.916954026405428,12,5,-11,1250,409,607,588,66
0,0,0,-0.0,-0.0,0.10865402221679688,684.0863255740254,13,491,492,1736,912,1245,420,23
-2,1,0,-2.0,1.0,0.20571398735046387,684.7945098949833,13,493,491,1736,912,1245,420,23
-4,4,0,-4.0,4.0,0.21370506286621094,684.8290019825273,13,497,487,1736,912,1245,420,23
-5,3,0,-5.0,3.0,0.22180414199829102,686.3234543595963,13,502,484,1736,912,1245,420,23
-3,4,0,-3.0,4.0,0.2297501564025879,685.7244792599151,13,505,480,1736,912,1245,420,23
-2,3,0,-2.0,3.0,0.2377181053161621,685.116369581983,13,507,477,1736,912,1245,420,23
0,2,0,-0.0,2.0,0.24574613571166992,683.7474361233728,13,507,475,1736,912,1245,420,23
0,3,0,-0.0,3.0,0.25373101234436035,681.6997906741419,13,507,472,1736,912,1245,420,23
1,3,0,1.0,3.0,0.2617020606994629,678.9253582816043,13,506,469,1736,912,1245,420,23
4,4,0,4.0,4.0,0.26964402198791504,673.2726064953938,13,502,465,1736,912,1245,420,23
8,6,0,8.0,6.0,0.277662992477417,663.3270719762036,13,494,459,1736,912,1245,420,23
12,6,0,12.0,6.0,0.2857241630554199,650.4627729509803,13,482,453,1736,912,1245,420,23
17,8,0,17.0,8.0,0.29454517364501953,632.622560201241,13,465,445,1736,912,1245,420,23
23,11,0,23.0,11.0,0.301800012588501,608.4513701655684,13,442,434,1736,912,1245,420,23
29,13,0,29.0,13.0,0.3098411560058594,578.7541860809467,13,413,421,1736,912,1245,420,23
32,16,0,32.0,16.0,0.31780099868774414,545.044962210791,13,381,405,1736,912,1245,420,23
34,17,0,34.0,17.0,0.32587313652038574,509.5314591837846,13,347,388,1736,912,1245,420,23
31,18,0,31.0,18.0,0.3336641788482666,475.5757906020397,13,316,370,1736,912,1245,420,23
31,18,0,31.0,18.0,0.3416471481323242,441.91169117168965,13,285,352,1736,912,1245,420,23
28,20,0,28.0,20.0,0.3497040271759033,408.84878230143767,13,257,332,1736,912,1245,420,23
25,19,0,25.0,19.0,0.357882022857666,378.60621144945827,13,232,313,1736,912,1245,420,23
24,21,0,24.0,21.0,0.36645007133483887,347.5080194361069,13,208,292,1736,912,1245,420,23
24,22,0,24.0,22.0,0.373790979385376,315.7353669255901,13,184,270,1736,912,1245,420,23
24,22,0,24.0,22.0,0.38172101974487305,284.13386793114745,13,160,248,1736,912,1245,420,23
22,22,0,22.0,22.0,0.38970208168029785,253.80181268261742,13,138,226,1736,912,1245,420,23
17,19,0,17.0,19.0,0.3977530002593994,228.77072381756702,13,121,207,1736,912,1245,420,23
16,18,0,16.0,18.0,0.4057471752166748,205.208232960727,13,105,189,1736,912,1245,420,23
11,15,0,11.0,15.0,0.4136641025543213,186.76754030932378,13,94,174,1736,912,1245,420,23
12,14,0,12.0,14.0,0.42180800437927246,168.78876494375282,13,82,160,1736,912,1245,420,23
10,14,0,10.0,14.0,0.4300529956817627,151.78820596099706,13,72,146,1736,912,1245,420,23
10,11,0,10.0,11.0,0.43817615509033203,137.5563866011825,13,62,135,1736,912,1245,420,23
8,10,0,8.0,10.0,0.4461510181427002,125.1653406708183,13,54,125,1736,912,1245,420,23
8,8,0,8.0,8.0,0.4537210464477539,114.7179382586272,13,46,117,1736,912,1245,420,23
6,7,0,6.0,7.0,0.4617440700531006,106.04699910719626,13,40,110,1736,912,1245,420,23
5,5,0,5.0,5.0,0.46961498260498047,99.67971810589327,13,35,105,1736,912,1245,420,23
3,6,0,3.0,6.0,0.47766613960266113,93.04326023342406,13,32,99,1736,912,1245,420,23
3,6,0,3.0,6.0,0.48575401306152344,86.41663102366043,13,29,93,1736,912,1245,420,23
2,4,0,2.0,4.0,0.49379897117614746,82.00537618869137,13,27,89,1736,912,1245,420,23
2,5,0,2.0,5.0,0.5016391277313232,76.64131445842195,13,25,84,1736,912,1245,420,23
1,2,0,1.0,2.0,0.5096971988677979,74.44003745317531,13,24,82,1736,912,1245,420,23
0,2,0,-0.0,2.0,0.5176689624786377,72.5224520712844,13,24,80,1736,912,1245,420,23
0,1,0,-0.0,1.0,0.5338091850280762,71.56512580987206,13,24,79,1736,912,1245,420,23
-2,1,0,-2.0,1.0,0.5417799949645996,71.21921916437786,13,26,78,1736,912,1245,420,23
-2,2,0,-2.0,2.0,0.5497920513153076,69.99382692526635,13,28,76,1736,912,1245,420,23
-1,1,0,-1.0,1.0,0.5578231811523438,69.4114419718985,13,29,75,1736,912,1245,420,23
-1,1,0,-1.0,1.0,0.5657031536102295,68.84985911070852,13,30,74,1736,912,1245,420,23
0,2,0,-0.0,2.0,0.5736851692199707,67.0,13,30,72,1736,912,1245,420,23
0,1,0,-0.0,1.0,0.5817351341247559,66.07788269017254,13,30,71,1736,912,1245,420,23
0,1,0,-0.0,1.0,0.5896790027618408,65.15773105863909,13,30,70,1736,912,1245,420,23
0,1,0,-0.0,1.0,0.5977091789245605,64.23961722390672,13,30,69,1736,912,1245,420,23
0,2,0,-0.0,2.0,0.6057600975036621,62.40980860893181,13,30,67,1736,912,1245,420,23
1,1,0,1.0,1.0,0.6136941909790039,61.09022125087424,13,29,66,1736,912,1245,420,23
1,2,0,1.0,2.0,0.6216859817504883,58.856996786291916,13,28,64,1736,912,1245,420,23
1,2,0,1.0,2.0,0.629688024520874,56.62396025078685,13,27,62,1736,912,1245,420,23
2,3,0,2.0,3.0,0.6377441883087158,53.07807737440318,13,25,59,1736,912,1245,420,23
1,3,0,1.0,3.0,0.645658016204834,49.92618484691127,13,24,56,1736,912,1245,420,23
3,4,0,3.0,4.0,0.6535639762878418,45.08029957123981,13,21,52,1736,912,1245,420,23
2,5,0,2.0,5.0,0.6616601943969727,39.695167422546305,13,19,47,1736,912,1245,420,23
4,4,0,4.0,4.0,0.6697239875793457,34.5411901469428,13,15,43,1736,912,1245,420,23
3,5,0,3.0,5.0,0.6776700019836426,28.84971769034255,13,12,38,1736,912,1245,420,23
3,5,0,3.0,5.0,0.685858964920044,23.205262752974143,13,9,33,1736,912,1245,420,23
3,5,0,3.0,5.0,0.6936399936676025,17.635642126552707,13,6,28,1736,912,1245,420,23
3,6,0,3.0,6.0,0.701570987701416,11.203603311174518,13,3,22,1736,912,1245,420,23
3,5,0,3.0,5.0,0.7096710205078125,6.0,13,0,17,1736,912,1245,420,23
2,5,0,2.0,5.0,0.7177011966705322,1.1655250605964387,13,-2,12,1736,912,1245,420,23
2,4,0,2.0,4.0,0.7259440422058105,-2.055728090000841,13,-4,8,1736,912,1245,420,23
1,4,0,1.0,4.0,0.7345371246337891,-4.5968757625671515,13,-5,4,1736,912,1245,420,23
1,3,0,1.0,3.0,0.7417080402374268,-4.917237469701781,13,-6,1,1736,912,1245,420,23
0,2,0,-0.0,2.0,0.7495801448822021,-4.917237469701781,13,-6,-1,1736,912,1245,420,23
1,2,0,1.0,2.0,0.7576920986175537,-3.3842268941360913,13,-7,-3,1736,912,1245,420,23
0,1,0,-0.0,1.0,0.7657990455627441,-2.937742251701451,13,-7,-4,1736,912,1245,420,23
1,2,0,1.0,2.0,0.7737400531768799,-1.0,13,-8,-6,1736,912,1245,420,23
0,1,0,-0.0,1.0,0.781684160232544,-0.36985418726535,13,-8,-7,1736,912,1245,420,23
1,2,0,1.0,2.0,0.7899441719055176,1.7279220613578552,13,-9,-9,1736,912,1245,420,23
1,1,0,1.0,1.0,0.7976861000061035,3.142135623730951,13,-10,-10,1736,912,1245,420,23
0,1,0,-0.0,1.0,0.8058211803436279,3.866068747318506,13,-10,-11,1736,912,1245,420,23
1,1,0,1.0,1.0,0.8137631416320801,5.278820596099706,13,-11,-12,1736,912,1245,420,23
0,1,0,-0.0,1.0,0.8217740058898926,6.029386365926403,13,-11,-13,1736,912,1245,420,23
1,1,0,1.0,1.0,0.8297209739685059,7.439088914585774,13,-12,-14,1736,912,1245,420,23
0,1,0,-0.0,1.0,0.8377270698547363,8.209372712298546,13,-12,-15,1736,912,1245,420,23
0,0,1,-0.0,-0.0,0.8407909870147705,8.209372712298546,13,-12,-15,1736,912,1245,420,23
1,0,1,1.0,-0.0,0.8456799983978271,8.849433241279208,13,-13,-15,1736,912,1245,420,23
0,0,0,-0.0,-0.0,0.9347221851348877,8.849433241279208,13,-13,-15,1736,912,1245,420,23
0,1,0,-0.0,1.0,1.0136950016021729,9.615528128088304,13,-13,-16,1736,912,1245,420,23
-1,0,0,-1.0,-0.0,1.0296680927276611,9.0,13,-12,-16,1736,912,1245,420,23
-1,0,0,-1.0,-0.0,1.0617930889129639,8.4164878389476,13,-11,-16,1736,912,1245,420,23
-1,0,0,-1.0,-0.0,1.0777781009674072,7.867962264113206,13,-10,-16,1736,912,1245,420,23
0,-1,0,-0.0,-1.0,1.085759162902832,7.027756377319946,13,-10,-15,1736,912,1245,420,23
-1,0,0,-1.0,-0.0,1.0936691761016846,6.4928556845359005,13,-9,-15,1736,912,1245,420,23
0,0,1,-0.0,-0.0,1.117922067642212,6.4928556845359005,13,-9,-15,1736,912,1245,420,23
0,0,0,-0.0,-0.0,0.09084820747375488,1610.242256276853,14,-1612,-142,133,785,1745,927,16
-1,0,0,-1.0,-0.0,0.1469111442565918,1609.246116087468,14,-1611,-142,133,785,1745,927,16
-1,0,0,-1.0,-0.0,0.15487217903137207,1608.2499806651197,14,-1610,-142,133,785,1745,927,16
-1,0,0,-1.0,-0.0,0.17076706886291504,1607.2538500186279,14,-1609,-142,133,785,1745,927,16
-1,0,0,-1.0,-0.0,0.178786039352417,1606.2577241568335,14,-1608,-142,133,785,1745,927,16
-2,0,0,-2.0,-0.0,0.18686699867248535,1604.2654868228124,14,-1606,-142,133,785,1745,927,16
-3,-1,0,-3.0,-1.0,0.19488120079040527,1601.1892368519,14,-1603,-141,133,785,1745,927,16
-3,0,0,-3.0,-0.0,0.2027881145477295,1598.2007969117685,14,-1600,-141,133,785,1745,927,16
-5,-1,0,-5.0,-1.0,0.2107710838317871,1593.1324117636243,14,-1595,-140,133,785,1745,927,16
-5,-2,0,-5.0,-2.0,0.21874618530273438,1587.9774434496246,14,-1590,-138,133,785,1745,927,16
-8,-4,0,-8.0,-4.0,0.22684907913208008,1579.6649520601002,14,-1582,-134,133,785,1745,927,16
-12,-6,0,-12.0,-6.0,0.23557519912719727,1567.2091924566719,14,-1570,-128,133,785,1745,927,16
-17,-7,0,-17.0,-7.0,0.2427690029144287,1549.7066476073087,14,-1553,-121,133,785,1745,927,16
-27,-9,0,-27.0,-9.0,0.2507619857788086,1522.1045715897983,14,-1526,-112,133,785,1745,927,16
-33,-9,0,-33.0,-9.0,0.25887107849121094,1488.5486961672848,14,-1493,-103,133,785,1745,927,16
-38,-10,0,-38.0,-10.0,0.2668330669403076,1449.9691354757822,14,-1455,-93,133,785,1745,927,16
-43,-8,0,-43.0,-8.0,0.2747831344604492,1406.5561141220237,14,-1412,-85,133,785,1745,927,16
-47,-8,0,-47.0,-8.0,0.2827332019805908,1359.1700698888928,14,-1365,-77,133,785,1745,927,16
-54,-7,0,-54.0,-7.0,0.2907991409301758,1304.8674723672607,14,-1311,-70,133,785,1745,927,16
-62,-8,0,-62.0,-8.0,0.29929304122924805,1242.5378842722039,14,-1249,-62,133,785,1745,927,16
-64,-7,0,-64.0,-7.0,0.30684900283813477,1178.275684653445,14,-1185,-55,133,785,1745,927,16
-68,-4,0,-68.0,-4.0,0.31469106674194336,1110.1636731713295,14,-1117,-51,133,785,1745,927,16
-59,-2,0,-59.0,-2.0,0.3227880001068115,1051.1340802750142,14,-1058,-49,133,785,1745,927,16
-55,0,0,-55.0,-0.0,0.3307352066040039,996.196195969692,14,-1003,-49,133,785,1745,927,16
-48,0,0,-48.0,-0.0,0.33879804611206055,948.2562418096941,14,-955,-49,133,785,1745,927,16
-44,1,0,-44.0,1.0,0.34676408767700195,904.3710867843193,14,-911,-50,133,785,1745,927,16
-41,2,0,-41.0,2.0,0.3548769950866699,863.5526375383188,14,-870,-52,133,785,1745,927,16
-39,1,0,-39.0,1.0,0.3628420829772949,824.6884171165107,14,-831,-53,133,785,1745,927,16
-38,1,0,-38.0,1.0,0.37083005905151367,786.8364611666981,14,-793,-54,133,785,1745,927,16
-32,0,0,-32.0,-0.0,0.3787710666656494,754.9134944408835,14,-761,-54,133,785,1745,927,16
-33,0,0,-33.0,-0.0,0.3867621421813965,722.0,14,-728,-54,133,785,1745,927,16
-31,0,0,-31.0,-0.0,0.394733190536499,691.0886925133319,14,-697,-54,133,785,1745,927,16
-29,-2,0,-29.0,-2.0,0.40279102325439453,662.0208951965602,14,-668,-52,133,785,1745,927,16
-28,-3,0,-28.0,-3.0,0.410736083984375,633.8730404059669,14,-640,-49,133,785,1745,927,16
-26,-2,0,-26.0,-2.0,0.41878700256347656,607.7962325315087,14,-614,-47,133,785,1745,927,16
-24,-2,0,-24.0,-2.0,0.42678117752075195,583.7136131609615,14,-590,-45,133,785,1745,927,16
-25,-2,0,-25.0,-2.0,0.4346590042114258,558.6339206224774,14,-565,-43,133,785,1745,927,16
-23,-1,0,-23.0,-1.0,0.44281005859375,535.6248706599064,14,-542,-42,133,785,1745,927,16
-21,-1,0,-21.0,-1.0,0.4509420394897461,514.6107538120508,14,-521,-41,133,785,1745,927,16
-21,-1,0,-21.0,-1.0,0.45879507064819336,493.5974481593781,14,-500,-40,133,785,1745,927,16
-18,-2,0,-18.0,-2.0,0.4668262004852295,475.49560494382985,14,-482,-38,133,785,1745,927,16
-18,-1,0,-18.0,-1.0,0.47478508949279785,457.4728778350034,14,-464,-37,133,785,1745,927,16
-17,-2,0,-17.0,-2.0,0.482802152633667,440.36815230343916,14,-447,-35,133,785,1745,927,16
-15,-1,0,-15.0,-1.0,0.490692138671875,425.3358974283114,14,-432,-34,133,785,1745,927,16
-14,-2,0,-14.0,-2.0,0.49877405166625977,411.2230909670888,14,-418,-32,133,785,1745,927,16
-12,-1,0,-12.0,-1.0,0.5068671703338623,399.1817775883395,14,-406,-31,133,785,1745,927,16
-10,-2,0,-10.0,-2.0,0.514794111251831,389.0604487984166,14,-396,-29,133,785,1745,927,16
-10,-1,0,-10.0,-1.0,0.5228149890899658,379.0142116253614,14,-386,-28,133,785,1745,927,16
-10,-2,0,-10.0,-2.0,0.5306901931762695,368.8978641488964,14,-376,-26,133,785,1745,927,16
-9,-3,0,-9.0,-3.0,0.5389230251312256,359.72000217556837,14,-367,-23,133,785,1745,927,16
-8,-2,0,-8.0,-2.0,0.5468621253967285,351.61368160847275,14,-359,-21,133,785,1745,927,16
-6,-2,0,-6.0,-2.0,0.5547890663146973,345.5109616405126,14,-353,-19,133,785,1745,927,16
-5,-1,0,-5.0,-1.0,0.5628161430358887,340.4652062975585,14,-348,-18,133,785,1745,927,16
-5,-3,0,-5.0,-3.0,0.5707650184631348,335.32783167113035,14,-343,-15,133,785,1745,927,16
-5,-2,0,-5.0,-2.0,0.5788590908050537,330.2499076126999,14,-338,-13,133,785,1745,927,16
-6,-2,0,-6.0,-2.0,0.5867650508880615,324.18217893198306,14,-332,-11,133,785,1745,927,16
-6,-2,0,-6.0,-2.0,0.5948300361633301,318.1242094662707,14,-326,-9,133,785,1745,927,16
-7,-2,0,-7.0,-2.0,0.6028070449829102,311.0767932645682,14,-319,-7,133,785,1745,927,16
-8,-2,0,-8.0,-2.0,0.6108131408691406,303.0401903291599,14,-311,-5,133,785,1745,927,16
-9,-2,0,-9.0,-2.0,0.6186771392822266,294.0149002946709,14,-302,-3,133,785,1745,927,16
-9,-2,0,-9.0,-2.0,0.6267910003662109,285.00170647967224,14,-293,-1,133,785,1745,927,16
-9,-2,0,-9.0,-2.0,0.6347610950469971,276.0017605579233,14,-284,1,133,785,1745,927,16
-9,-1,0,-9.0,-1.0,0.6428580284118652,267.00727263110696,14,-275,2,133,785,1745,927,16
-9,-2,0,-9.0,-2.0,0.6508781909942627,258.03007348794233,14,-266,4,133,785,1745,927,16
-8,-1,0,-8.0,-1.0,0.6586451530456543,250.0484450641003,14,-258,5,133,785,1745,927,16
-9,-2,0,-9.0,-2.0,0.6666970252990723,241.09837414162303,14,-249,7,133,785,1745,927,16
-10,-1,0,-10.0,-1.0,0.6747381687164307,231.13385373049965,14,-239,8,133,785,1745,927,16
-11,-1,0,-11.0,-1.0,0.6827731132507324,220.17756243767704,14,-228,9,133,785,1745,927,16
-11,0,0,-11.0,-0.0,0.6907720565795898,209.18655575334307,14,-217,9,133,785,1745,927,16
-11,-1,0,-11.0,-1.0,0.698760986328125,198.24257562394823,14,-206,10,133,785,1745,927,16
-12,-1,0,-12.0,-1.0,0.7067761421203613,186.31160541768986,14,-194,11,133,785,1745,927,16
-12,-1,0,-12.0,-1.0,0.7146890163421631,174.3951753747889,14,-182,12,133,785,1745,927,16
-12,0,0,-12.0,-0.0,0.7227890491485596,162.42300314218147,14,-170,12,133,785,1745,927,16
-10,0,0,-10.0,-0.0,0.730816125869751,152.44936896105264,14,-160,12,133,785,1745,927,16
-10,-1,0,-10.0,-1.0,0.7388131618499756,142.56227947264878,14,-150,13,133,785,1745,927,16
-9,0,0,-9.0,-0.0,0.7467300891876221,133.59802258506295,14,-141,13,133,785,1745,927,16
-9,0,0,-9.0,-0.0,0.7548060417175293,124.63860674780929,14,-132,13,133,785,1745,927,16
-10,0,0,-10.0,-0.0,0.7628891468048096,114.6906679417795,14,-122,13,133,785,1745,927,16
-9,0,0,-9.0,-0.0,0.77081298828125,105.7453295744489,14,-113,13,133,785,1745,927,16
-7,0,0,-7.0,-0.0,0.7787501811981201,98.7941945987702,14,-106,13,133,785,1745,927,16
-6,0,0,-6.0,-0.0,0.7868411540985107,92.84145972763385,14,-100,13,133,785,1745,927,16
-5,0,0,-5.0,-0.0,0.7948000431060791,87.88534820294495,14,-95,13,133,785,1745,927,16
-4,0,0,-4.0,-0.0,0.8028662204742432,83.92388155425118,14,-91,13,133,785,1745,927,16
-5,0,0,-5.0,-0.0,0.8107020854949951,78.97700845625813,14,-86,13,133,785,1745,927,16
-4,0,0,-4.0,-0.0,0.8187351226806641,75.02409288875127,14,-82,13,133,785,1745,927,16
-3,0,0,-3.0,-0.0,0.8273451328277588,72.06247560499239,14,-79,13,133,785,1745,927,16
-2,0,0,-2.0,-0.0,0.834691047668457,70.08969202141856,14,-77,13,133,785,1745,927,16
-3,1,0,-3.0,1.0,0.8428261280059814,66.96665925596525,14,-74,12,133,785,1745,927,16
-2,0,0,-2.0,-0.0,0.850816011428833,64.99315036357864,14,-72,12,133,785,1745,927,16
-2,1,0,-2.0,1.0,0.8592910766601562,62.8590149522275,14,-70,11,133,785,1745,927,16
-2,0,0,-2.0,-0.0,0.8667922019958496,60.8839603971781,14,-68,11,133,785,1745,927,16
-1,1,0,-1.0,1.0,0.874765157699585,59.742158217759794,14,-67,10,133,785,1745,927,16
-1,0,0,-1.0,-0.0,0.8829541206359863,58.753277073114546,14,-66,10,133,785,1745,927,16
-2,1,0,-2.0,1.0,0.8907191753387451,56.6297145282261,14,-64,9,133,785,1745,927,16
-1,1,0,-1.0,1.0,0.8986961841583252,55.50590523722971,14,-63,8,133,785,1745,927,16
-2,0,0,-2.0,-0.0,0.9067370891571045,53.5223536610881,14,-61,8,133,785,1745,927,16
-2,1,0,-2.0,1.0,0.9146950244903564,51.413803110051795,14,-59,7,133,785,1745,927,16
-2,1,0,-2.0,1.0,0.9228360652923584,49.3149195236284,14,-57,6,133,785,1745,927,16
-2,1,0,-2.0,1.0,0.9307451248168945,47.226805085936306,14,-55,5,133,785,1745,927,16
-2,0,0,-2.0,-0.0,0.9387609958648682,45.23532661682466,14,-53,5,133,785,1745,927,16
-3,1,0,-3.0,1.0,0.9468021392822266,42.15974481593781,14,-50,4,133,785,1745,927,16
-2,1,0,-2.0,1.0,0.954780101776123,40.093658625644196,14,-48,3,133,785,1745,927,16
-3,1,0,-3.0,1.0,0.9629170894622803,37.044422518220834,14,-45,2,133,785,1745,927,16
-3,1,0,-3.0,1.0,0.9707310199737549,34.01190307520001,14,-42,1,133,785,1745,927,16
-5,1,0,-5.0,1.0,0.978856086730957,29.0,14,-37,0,133,785,1745,927,16
-4,1,0,-4.0,1.0,0.9867651462554932,25.015148038438355,14,-33,-1,133,785,1745,927,16
-6,2,0,-6.0,2.0,0.9947412014007568,19.16615541441225,14,-27,-3,133,785,1745,927,16
-6,1,0,-6.0,1.0,1.0027720928192139,13.377558326431949,14,-21,-4,133,785,1745,927,16
-4,1,0,-4.0,1.0,1.0106801986694336,9.72004514666935,14,-17,-5,133,785,1745,927,16
-3,0,0,-3.0,-0.0,1.018848180770874,6.866068747318506,14,-14,-5,133,785,1745,927,16
-3,0,0,-3.0,-0.0,1.0266571044921875,4.083045973594572,14,-11,-5,133,785,1745,927,16
-1,0,0,-1.0,-0.0,1.0347731113433838,3.180339887498949,14,-10,-5,133,785,1745,927,16
-2,0,0,-2.0,-0.0,1.0427892208099365,1.4339811320566032,14,-8,-5,133,785,1745,927,16
-2,0,0,-2.0,-0.0,1.0508131980895996,-0.18975032409334602,14,-6,-5,133,785,1745,927,16
-1,0,0,-1.0,-0.0,1.0587689876556396,-0.9289321881345245,14,-5,-5,133,785,1745,927,16
-1,0,0,-1.0,-0.0,1.0747671127319336,-1.5968757625671515,14,-4,-5,133,785,1745,927,16
-1,0,0,-1.0,-0.0,1.0828502178192139,-2.1690481051546993,14,-3,-5,133,785,1745,927,16
-1,0,0,-1.0,-0.0,1.090766191482544,-2.6148351928654963,14,-2,-5,133,785,1745,927,16
-1,0,0,-1.0,-0.0,1.1066319942474365,-2.9009804864072155,14,-1,-5,133,785,1745,927,16
-1,0,0,-1.0,-0.0,1.122772216796875,-3.0,14,0,-5,133,785,1745,927,16
0,0,1,-0.0,-0.0,1.160654067993164,-3.0,14,0,-5,133,785,1745,927,16
0,0,0,-0.0,-0.0,0.07744121551513672,356.52548303305167,15,76,-380,209,410,133,790,62
4,-1,0,4.0,-1.0,0.12642812728881836,354.77843381920667,15,72,-379,209,410,133,790,62
4,-1,0,4.0,-1.0,0.1345372200012207,353.06770236509084,15,68,-378,209,410,133,790,62
6,-1,0,6.0,-1.0,0.14240407943725586,351.06413074247104,15,62,-377,209,410,133,790,62
7,-1,0,7.0,-1.0,0.15033221244812012,349.00131578719567,15,55,-376,209,410,133,790,62
7,-2,0,7.0,-2.0,0.1583251953125,346.06763319065186,15,48,-374,209,410,133,790,62
7,-1,0,7.0,-1.0,0.1665511131286621,344.24658559405975,15,41,-373,209,410,133,790,62
7,-2,0,7.0,-2.0,0.17430806159973145,341.55469397123426,15,34,-371,209,410,133,790,62
9,-3,0,9.0,-3.0,0.18249225616455078,337.84820726146955,15,25,-368,209,410,133,790,62
9,-4,0,9.0,-4.0,0.19052720069885254,333.3514786576281,15,16,-364,209,410,133,790,62
11,-4,0,11.0,-4.0,0.19853806495666504,329.0347205478938,15,5,-360,209,410,133,790,62
11,-7,0,11.0,-7.0,0.2064361572265625,322.0509878190401,15,-6,-353,209,410,133,790,62
11,-9,0,11.0,-9.0,0.21442914009094238,313.41980198589044,15,-17,-344,209,410,133,790,62
9,-10,0,9.0,-10.0,0.22246217727661133,304.0104475982801,15,-26,-334,209,410,133,790,62
7,-11,0,7.0,-11.0,0.2304081916809082,293.68138228115265,15,-33,-323,209,410,133,790,62
7,-11,0,7.0,-11.0,0.23854613304138184,283.5536520214,15,-40,-312,209,410,133,790,62
4,-11,0,4.0,-11.0,0.24653220176696777,273.19894805866767,15,-44,-301,209,410,133,790,62
3,-12,0,3.0,-12.0,0.2544081211090088,261.7968579066381,15,-47,-289,209,410,133,790,62
2,-16,0,2.0,-16.0,0.2623891830444336,246.3625785862253,15,-49,-273,209,410,133,790,62
0,-15,0,-0.0,-15.0,0.27034616470336914,231.6118809193522,15,-49,-258,209,410,133,790,62
0,-16,0,-0.0,-16.0,0.2784152030944824,215.9109151090733,15,-49,-242,209,410,133,790,62
-2,-16,0,-2.0,-16.0,0.2864551544189453,199.8354392202376,15,-47,-226,209,410,133,790,62
-3,-21,0,-3.0,-21.0,0.29443812370300293,178.6687864227768,15,-44,-205,209,410,133,790,62
-4,-21,0,-4.0,-21.0,0.30242919921875,157.29763673503712,15,-40,-184,209,410,133,790,62
-3,-18,0,-3.0,-18.0,0.31044816970825195,139.07351351694948,15,-37,-166,209,410,133,790,62
-2,-11,0,-2.0,-11.0,0.31837916374206543,127.90248582070703,15,-35,-155,209,410,133,790,62
-2,-8,0,-2.0,-8.0,0.32645225524902344,119.65855435387664,15,-33,-147,209,410,133,790,62
-1,-9,0,-1.0,-9.0,0.33428311347961426,110.66156853571826,15,-32,-138,209,410,133,790,62
-2,-8,0,-2.0,-8.0,0.3423640727996826,102.41664064126334,15,-30,-130,209,410,133,790,62
-2,-8,0,-2.0,-8.0,0.35057902336120605,94.1718818265508,15,-28,-122,209,410,133,790,62
-1,-9,0,-1.0,-9.0,0.35843920707702637,85.18089343777659,15,-27,-113,209,410,133,790,62
-2,-8,0,-2.0,-8.0,0.36643004417419434,76.93516572461452,15,-25,-105,209,410,133,790,62
-2,-6,0,-2.0,-6.0,0.3744242191314697,70.6366075781753,15,-23,-99,209,410,133,790,62
-2,-6,0,-2.0,-6.0,0.38251519203186035,64.34149149242423,15,-21,-93,209,410,133,790,62
-2,-4,0,-2.0,-4.0,0.39036011695861816,60.005494339627646,15,-19,-89,209,410,133,790,62
-1,-3,0,-1.0,-3.0,0.3983042240142822,56.863530545955186,15,-18,-86,209,410,133,790,62
-2,-3,0,-2.0,-3.0,0.40644001960754395,53.528101836016646,15,-16,-83,209,410,133,790,62
-1,-2,0,-1.0,-2.0,0.4142892360687256,51.37718130647589,15,-15,-81,209,410,133,790,62
-1,-3,0,-1.0,-3.0,0.4225640296936035,48.2464510246358,15,-14,-78,209,410,133,790,62
-2,-3,0,-2.0,-3.0,0.4304661750793457,44.95393340703298,15,-12,-75,209,410,133,790,62
-1,-2,0,-1.0,-2.0,0.43845319747924805,42.824115301167,15,-11,-73,209,410,133,790,62
-1,-2,0,-1.0,-2.0,0.44643521308898926,40.70076708097341,15,-10,-71,209,410,133,790,62
-1,-2,0,-1.0,-2.0,0.454437255859375,38.58448102845921,15,-9,-69,209,410,133,790,62
-2,-3,0,-2.0,-3.0,0.46245718002319336,35.37017402418047,15,-7,-66,209,410,133,790,62
-1,-3,0,-1.0,-3.0,0.47039103507995605,32.28506932918696,15,-6,-63,209,410,133,790,62
-1,-3,0,-1.0,-3.0,0.4782991409301758,29.207972893961475,15,-5,-60,209,410,133,790,62
-1,-3,0,-1.0,-3.0,0.4863772392272949,26.140178508646613,15,-4,-57,209,410,133,790,62
-1,-4,0,-1.0,-4.0,0.49444103240966797,22.084837759947987,15,-3,-53,209,410,133,790,62
0,-2,0,-0.0,-2.0,0.5024862289428711,20.088159097779204,15,-3,-51,209,410,133,790,62
-1,-5,0,-1.0,-5.0,0.5103821754455566,15.04345773288535,15,-2,-46,209,410,133,790,62
-1,-2,0,-1.0,-2.0,0.5184540748596191,13.011362169330773,15,-1,-44,209,410,133,790,62
0,-4,0,-0.0,-4.0,0.5264532566070557,9.01249804748511,15,-1,-40,209,410,133,790,62
0,-3,0,-0.0,-3.0,0.5344090461730957,6.013511046643494,15,-1,-37,209,410,133,790,62
0,-2,0,-0.0,-2.0,0.5423481464385986,4.014282800023196,15,-1,-35,209,410,133,790,62
-1,-3,0,-1.0,-3.0,0.550288200378418,1.0,15,0,-32,209,410,133,790,62
0,0,1,-0.0,-0.0,0.5555572509765625,1.0,15,0,-32,209,410,133,790,62
-1,-2,1,-1.0,-2.0,0.5584540367126465,-0.9833379603927312,15,1,-30,209,410,133,790,62
0,-2,1,-0.0,-2.0,0.005474090576171875,1309.6911960091063,16,1126,694,1334,1132,208,440,27
0,-1,1,-0.0,-1.0,0.01344609260559082,1310.216157700623,16,1126,695,1334,1132,208,440,27
-1,-1,1,-1.0,-1.0,0.021519184112548828,1311.5923901336591,16,1127,696,1334,1132,208,440,27
0,0,0,-0.0,-0.0,0.11432123184204102,1311.5923901336591,16,1127,696,1334,1132,208,440,27
2,1,0,2.0,1.0,0.2294020652770996,1309.3653050500077,16,1125,695,1334,1132,208,440,27
7,5,0,7.0,5.0,0.23751115798950195,1300.7823259581473,16,1118,690,1334,1132,208,440,27
13,7,0,13.0,7.0,0.24541521072387695,1286.043494267994,16,1105,683,1334,1132,208,440,27
20,6,0,20.0,6.0,0.2534041404724121,1265.8877980495397,16,1085,677,1334,1132,208,440,27
26,8,0,26.0,8.0,0.26140522956848145,1239.6140666621943,16,1059,669,1334,1132,208,440,27
29,11,0,29.0,11.0,0.2694070339202881,1209.2372928363789,16,1030,658,1334,1132,208,440,27
28,14,0,28.0,14.0,0.2775261402130127,1178.108727194961,16,1002,644,1334,1132,208,440,27
30,16,0,30.0,16.0,0.285351037979126,1144.2242652139644,16,972,628,1334,1132,208,440,27
28,17,0,28.0,17.0,0.29331517219543457,1111.4807690663279,16,944,611,1334,1132,208,440,27
28,19,0,28.0,19.0,0.30146002769470215,1077.651181634165,16,916,592,1334,1132,208,440,27
29,20,0,29.0,20.0,0.30936217308044434,1042.43971879023,16,887,572,1334,1132,208,440,27
29,20,0,29.0,20.0,0.3174872398376465,1007.2293859716059,16,858,552,1334,1132,208,440,27
30,22,0,30.0,22.0,0.3254990577697754,970.0991811612905,16,828,530,1334,1132,208,440,27
31,23,0,31.0,23.0,0.3334231376647949,931.5940927191955,16,797,507,1334,1132,208,440,27
32,23,0,32.0,23.0,0.34143614768981934,892.2518986447916,16,765,484,1334,1132,208,440,27
32,25,0,32.0,25.0,0.34943318367004395,851.8525885953051,16,733,459,1334,1132,208,440,27
31,24,0,31.0,24.0,0.3573300838470459,812.8504707269955,16,702,435,1334,1132,208,440,27
29,22,0,29.0,22.0,0.3654160499572754,776.6188954172766,16,673,413,1334,1132,208,440,27
25,20,0,25.0,20.0,0.3733100891113281,744.8608051614756,16,648,393,1334,1132,208,440,27
23,18,0,23.0,18.0,0.3813302516937256,715.8689868556626,16,625,375,1334,1132,208,440,27
19,14,0,19.0,14.0,0.38941121101379395,692.3772040546817,16,606,361,1334,1132,208,440,27
18,13,0,18.0,13.0,0.3973672389984131,670.2627605833644,16,588,348,1334,1132,208,440,27
17,12,0,17.0,12.0,0.40538620948791504,649.5232071407008,16,571,336,1334,1132,208,440,27
15,10,0,15.0,10.0,0.41340112686157227,631.5246310266195,16,556,326,1334,1132,208,440,27
14,8,0,14.0,8.0,0.42147016525268555,615.4011457659828,16,542,318,1334,1132,208,440,27
14,7,0,14.0,7.0,0.4295530319213867,599.7846277445282,16,528,311,1334,1132,208,440,27
13,7,0,13.0,7.0,0.43738818168640137,585.03093565467,16,515,304,1334,1132,208,440,27
13,6,0,13.0,6.0,0.44529008865356445,570.7876326199452,16,502,298,1334,1132,208,440,27
13,7,0,13.0,7.0,0.45336222648620605,556.0360269789603,16,489,291,1334,1132,208,440,27
13,6,0,13.0,6.0,0.46146225929260254,541.7981614965933,16,476,285,1334,1132,208,440,27
14,6,0,14.0,6.0,0.4693472385406494,526.7082545227561,16,462,279,1334,1132,208,440,27
12,6,0,12.0,6.0,0.47753024101257324,513.3354443698429,16,450,273,1334,1132,208,440,27
13,7,0,13.0,7.0,0.4853091239929199,498.5906566777779,16,437,266,1334,1132,208,440,27
14,7,0,14.0,7.0,0.4932861328125,482.99395157602476,16,423,259,1334,1132,208,440,27
14,8,0,14.0,8.0,0.5013241767883301,466.8770675912738,16,409,251,1334,1132,208,440,27
15,7,0,15.0,7.0,0.5094292163848877,450.4350008361475,16,394,244,1334,1132,208,440,27
14,7,0,14.0,7.0,0.517402172088623,434.84930501229985,16,380,237,1334,1132,208,440,27
14,8,0,14.0,8.0,0.5255122184753418,418.7371885765691,16,366,229,1334,1132,208,440,27
15,7,0,15.0,7.0,0.5334081649780273,402.31313487536124,16,351,222,1334,1132,208,440,27
14,8,0,14.0,8.0,0.5413670539855957,386.2054608844924,16,337,214,1334,1132,208,440,27
16,8,0,16.0,8.0,0.5494651794433594,368.4144727196387,16,321,206,1334,1132,208,440,27
17,8,0,17.0,8.0,0.5575160980224609,349.7947077894053,16,304,198,1334,1132,208,440,27
16,8,0,16.0,8.0,0.5654282569885254,332.0275351330673,16,288,190,1334,1132,208,440,27
15,7,0,15.0,7.0,0.573371171951294,315.6609194899813,16,273,183,1334,1132,208,440,27
12,5,0,12.0,5.0,0.5812890529632568,302.9192934912333,16,261,178,1334,1132,208,440,27
11,6,0,11.0,6.0,0.5893971920013428,290.4534560686367,16,250,172,1334,1132,208,440,27
8,4,0,8.0,4.0,0.5973432064056396,281.59803122220626,16,242,168,1334,1132,208,440,27
8,4,0,8.0,4.0,0.6054081916809082,272.74814085134483,16,234,164,1334,1132,208,440,27
8,5,0,8.0,5.0,0.613476037979126,263.3277040037788,16,226,159,1334,1132,208,440,27
6,4,0,6.0,4.0,0.6213600635528564,256.1189328159578,16,220,155,1334,1132,208,440,27
8,3,0,8.0,3.0,0.6294100284576416,247.8601157708859,16,212,152,1334,1132,208,440,27
8,5,0,8.0,5.0,0.6374990940093994,238.44581921360316,16,204,147,1334,1132,208,440,27
8,4,0,8.0,4.0,0.6453311443328857,229.62110378118388,16,196,143,1334,1132,208,440,27
10,6,0,10.0,6.0,0.6533091068267822,218.00865784641059,16,186,137,1334,1132,208,440,27
10,5,0,10.0,5.0,0.6613340377807617,207.0,16,176,132,1334,1132,208,440,27
9,5,0,9.0,5.0,0.6693282127380371,196.80467106334882,16,167,127,1334,1132,208,440,27
9,6,0,9.0,6.0,0.6773931980133057,186.01004999748127,16,158,121,1334,1132,208,440,27
9,6,0,9.0,6.0,0.6854081153869629,175.2179587605816,16,149,115,1334,1132,208,440,27
9,6,0,9.0,6.0,0.693425178527832,164.4288589829738,16,140,109,1334,1132,208,440,27
9,4,0,9.0,4.0,0.7013950347900391,154.88686666919483,16,131,105,1334,1132,208,440,27
9,6,0,9.0,6.0,0.7094831466674805,144.1146078504478,16,122,99,1334,1132,208,440,27
10,6,0,10.0,6.0,0.717292070388794,132.57815770231468,16,112,93,1334,1132,208,440,27
8,5,0,8.0,5.0,0.725377082824707,123.23509092741122,16,104,88,1334,1132,208,440,27
7,5,0,7.0,5.0,0.7332930564880371,114.66362050325849,16,97,83,1334,1132,208,440,27
8,4,0,8.0,4.0,0.741361141204834,106.00420160649792,16,89,79,1334,1132,208,440,27
7,4,0,7.0,4.0,0.7494170665740967,98.12605455067681,16,82,75,1334,1132,208,440,27
5,3,0,5.0,3.0,0.7573771476745605,92.41821474489122,16,77,72,1334,1132,208,440,27
5,3,0,5.0,3.0,0.7653970718383789,86.72462083156798,16,72,69,1334,1132,208,440,27
4,4,0,4.0,4.0,0.7734861373901367,81.06912352095134,16,68,65,1334,1132,208,440,27
4,3,0,4.0,3.0,0.7813911437988281,76.10667763978185,16,64,62,1334,1132,208,440,27
4,4,0,4.0,4.0,0.7892792224884033,70.45058418010026,16,60,58,1334,1132,208,440,27
3,3,0,3.0,3.0,0.7973201274871826,66.20858539325141,16,57,55,1334,1132,208,440,27
3,3,0,3.0,3.0,0.8053350448608398,61.966659255965254,16,54,52,1334,1132,208,440,27
4,4,0,4.0,4.0,0.8133492469787598,56.31089380465383,16,50,48,1334,1132,208,440,27
5,4,0,5.0,4.0,0.8213841915130615,49.93647591023825,16,45,44,1334,1132,208,440,27
6,4,0,6.0,4.0,0.8295230865478516,42.86591089385369,16,39,40,1334,1132,208,440,27
7,4,0,7.0,4.0,0.8374080657958984,35.16637831516918,16,32,36,1334,1132,208,440,27
6,3,0,6.0,3.0,0.8457262516021729,29.01190307520001,16,26,33,1334,1132,208,440,27
7,4,0,7.0,4.0,0.8535380363464355,21.66987164671943,16,19,29,1334,1132,208,440,27
6,4,0,6.0,4.0,0.8614981174468994,15.178005607210743,16,13,25,1334,1132,208,440,27
5,4,0,5.0,4.0,0.869434118270874,9.472205054244231,16,8,21,1334,1132,208,440,27
5,4,0,5.0,4.0,0.8773112297058105,4.262676501632068,16,3,17,1334,1132,208,440,27
4,3,0,4.0,3.0,0.8854920864105225,1.035668847618199,16,-1,14,1334,1132,208,440,27
3,2,0,3.0,2.0,0.8934130668640137,-0.3508893593264819,16,-4,12,1334,1132,208,440,27
4,3,0,4.0,3.0,0.9014010429382324,-0.9584054212077042,16,-8,9,1334,1132,208,440,27
4,4,0,4.0,4.0,0.9094572067260742,0.0,16,-12,5,1334,1132,208,440,27
4,3,0,4.0,3.0,0.9174110889434814,3.1245154965970983,16,-16,2,1334,1132,208,440,27
5,2,0,5.0,2.0,0.9255831241607666,8.0,16,-21,0,1334,1132,208,440,27
3,3,0,3.0,3.0,0.9333992004394531,11.186773244895647,16,-24,-3,1334,1132,208,440,27
3,1,0,3.0,1.0,0.9413752555847168,14.294688127912362,16,-27,-4,1334,1132,208,440,27
2,2,0,2.0,2.0,0.9494431018829346,16.614185789921695,16,-29,-6,1334,1132,208,440,27
1,1,0,1.0,1.0,0.9574122428894043,17.805843601498726,16,-30,-7,1334,1132,208,440,27
1,0,0,1.0,-0.0,0.965440034866333,18.78049716414141,16,-31,-7,1334,1132,208,440,27
0,0,1,-0.0,-0.0,1.036426067352295,18.78049716414141,16,-31,-7,1334,1132,208,440,27
-2,0,1,-2.0,-0.0,1.1013422012329102,16.832867780352597,16,-29,-7,1334,1132,208,440,27
0,0,0,-0.0,-0.0,1.106288194656372,16.832867780352597,16,-29,-7,1334,1132,208,440,27
-3,0,0,-3.0,-0.0,1.109584093093872,13.92582403567252,16,-26,-7,1334,1132,208,440,27
-5,0,0,-5.0,-0.0,1.1174821853637695,9.135943621178654,16,-21,-7,1334,1132,208,440,27
-4,0,0,-4.0,-0.0,1.1255390644073486,5.384776310850235,16,-17,-7,1334,1132,208,440,27
-3,0,0,-3.0,-0.0,1.1334500312805176,2.6524758424985286,16,-14,-7,1334,1132,208,440,27
-3,0,0,-3.0,-0.0,1.1414711475372314,0.038404810405298306,16,-11,-7,1334,1132,208,440,27
-1,-1,0,-1.0,-1.0,1.1496400833129883,-1.3380962103093985,16,-10,-6,1334,1132,208,440,27
-3,0,0,-3.0,-0.0,1.1573381423950195,-3.780455542707113,16,-7,-6,1334,1132,208,440,27
-2,-1,0,-2.0,-1.0,1.1653060913085938,-5.9289321881345245,16,-5,-5,1334,1132,208,440,27
-2,-1,0,-2.0,-1.0,1.173295259475708,-8.0,16,-3,-4,1334,1132,208,440,27
-1,-1,0,-1.0,-1.0,1.1813380718231201,-9.39444872453601,16,-2,-3,1334,1132,208,440,27
-1,-1,0,-1.0,-1.0,1.1894042491912842,-10.76393202250021,16,-1,-2,1334,1132,208,440,27
-1,-1,0,-1.0,-1.0,1.1974151134490967,-12.0,16,0,-1,1334,1132,208,440,27
0,-1,0,-0.0,-1.0,1.2053792476654053,-13.0,16,0,0,1334,1132,208,440,27
0,0,1,-0.0,-0.0,1.2493271827697754,-13.0,16,0,0,1334,1132,208,440,27
0,0,0,-0.0,-0.0,0.1020050048828125,1350.9489711439264,17,-907,-1016,427,116,1334,1132,23
-1,0,0,-1.0,-0.0,0.1489119529724121,1350.2832181438218,17,-906,-1016,427,116,1334,1132,23
-1,-1,0,-1.0,-1.0,0.15707802772521973,1348.8713174414702,17,-905,-1015,427,116,1334,1132,23
-4,-2,0,-4.0,-2.0,0.16495203971862793,1344.7175221999603,17,-901,-1013,427,116,1334,1132,23
-5,-3,0,-5.0,-3.0,0.17296314239501953,1339.1540652829217,17,-896,-1010,427,116,1334,1132,23
-6,-4,0,-6.0,-4.0,0.18097615242004395,1332.1812982617053,17,-890,-1006,427,116,1334,1132,23
-8,-6,0,-8.0,-6.0,0.18889713287353516,1322.3881655392026,17,-882,-1000,427,116,1334,1132,23
-11,-9,0,-11.0,-9.0,0.1968240737915039,1308.36424083723,17,-871,-991,427,116,1334,1132,23
-16,-12,0,-16.0,-12.0,0.20487403869628906,1288.7945991578824,17,-855,-979,427,116,1334,1132,23
-18,-16,0,-18.0,-16.0,0.2129809856414795,1264.9067364035664,17,-837,-963,427,116,1334,1132,23
-24,-22,0,-24.0,-22.0,0.22086215019226074,1232.5634282174753,17,-813,-941,427,116,1334,1132,23
-29,-26,0,-29.0,-26.0,0.22895598411560059,1193.940247481177,17,-784,-915,427,116,1334,1132,23
-31,-28,0,-31.0,-28.0,0.2370309829711914,1152.5196603409845,17,-753,-887,427,116,1334,1132,23
-34,-29,0,-34.0,-29.0,0.24492907524108887,1108.4306588619056,17,-719,-858,427,116,1334,1132,23
-30,-24,0,-30.0,-24.0,0.2530701160430908,1070.7934183567581,17,-689,-834,427,116,1334,1132,23
-25,-21,0,-25.0,-21.0,0.2609531879425049,1038.6975754949613,17,-664,-813,427,116,1334,1132,23
-23,-21,0,-23.0,-21.0,0.26897215843200684,1007.8940082265672,17,-641,-792,427,116,1334,1132,23
-19,-20,0,-19.0,-20.0,0.27687811851501465,980.3969941451305,17,-622,-772,427,116,1334,1132,23
-20,-22,0,-20.0,-22.0,0.284945011138916,950.7192937650779,17,-602,-750,427,116,1334,1132,23
-20,-24,0,-20.0,-24.0,0.2929060459136963,919.4837451562494,17,-582,-726,427,116,1334,1132,23
-20,-26,0,-20.0,-26.0,0.3012421131134033,886.6881418399154,17,-562,-700,427,116,1334,1132,23
-19,-28,0,-19.0,-28.0,0.30900096893310547,852.9635408974154,17,-543,-672,427,116,1334,1132,23
-18,-27,0,-18.0,-27.0,0.31696105003356934,820.6549765377467,17,-525,-645,427,116,1334,1132,23
-15,-26,0,-15.0,-26.0,0.3249821662902832,791.0355353723425,17,-510,-619,427,116,1334,1132,23
-13,-26,0,-13.0,-26.0,0.33298611640930176,762.7299270417294,17,-497,-593,427,116,1334,1132,23
-12,-24,0,-12.0,-24.0,0.34101295471191406,736.6536631355457,17,-485,-569,427,116,1334,1132,23
-11,-23,0,-11.0,-23.0,0.34893798828125,712.0435671520769,17,-474,-546,427,116,1334,1132,23
-12,-22,0,-12.0,-22.0,0.35690903663635254,687.5842826746104,17,-462,-524,427,116,1334,1132,23
-12,-21,0,-12.0,-21.0,0.3649780750274658,663.9140686042928,17,-450,-503,427,116,1334,1132,23
-15,-19,0,-15.0,-19.0,0.37299299240112305,639.7541778582754,17,-435,-484,427,116,1334,1132,23
-15,-16,0,-15.0,-16.0,0.38099098205566406,617.8274803155473,17,-420,-468,427,116,1334,1132,23
-16,-14,0,-16.0,-14.0,0.3889741897583008,596.7269123545542,17,-404,-454,427,116,1334,1132,23
-18,-15,0,-18.0,-15.0,0.39701318740844727,573.5656507185485,17,-386,-439,427,116,1334,1132,23
-17,-13,0,-17.0,-13.0,0.40516209602355957,552.5929382098395,17,-369,-426,427,116,1334,1132,23
-14,-11,0,-14.0,-11.0,0.4128420352935791,535.122696836526,17,-355,-415,427,116,1334,1132,23
-15,-12,0,-15.0,-12.0,0.420957088470459,516.2655877259581,17,-340,-403,427,116,1334,1132,23
-11,-10,0,-11.0,-10.0,0.42884397506713867,501.53292577160346,17,-329,-393,427,116,1334,1132,23
-9,-11,0,-9.0,-11.0,0.4370729923248291,487.32118156867466,17,-320,-382,427,116,1334,1132,23
-8,-10,0,-8.0,-10.0,0.44497013092041016,474.51827977945385,17,-312,-372,427,116,1334,1132,23
-9,-11,0,-9.0,-11.0,0.45297718048095703,460.30669420240577,17,-303,-361,427,116,1334,1132,23
-9,-9,0,-9.0,-9.0,0.46102118492126465,447.62838987572496,17,-294,-352,427,116,1334,1132,23
-9,-8,0,-9.0,-8.0,0.469041109085083,435.72250894710913,17,-285,-344,427,116,1334,1132,23
-10,-7,0,-10.0,-7.0,0.47696518898010254,423.96436635660166,17,-275,-337,427,116,1334,1132,23
-11,-8,0,-11.0,-8.0,0.4850010871887207,410.82579342662297,17,-264,-329,427,116,1334,1132,23
-12,-7,0,-12.0,-7.0,0.4929060935974121,397.88629226228653,17,-252,-322,427,116,1334,1132,23
-12,-8,0,-12.0,-8.0,0.5008761882781982,384.2163964209987,17,-240,-314,427,116,1334,1132,23
-13,-8,0,-13.0,-8.0,0.5089709758758545,370.0052493076703,17,-227,-306,427,116,1334,1132,23
-13,-8,0,-13.0,-8.0,0.5169620513916016,355.87872655688284,17,-214,-298,427,116,1334,1132,23
-12,-8,0,-12.0,-8.0,0.524968147277832,342.4176000144871,17,-202,-290,427,116,1334,1132,23
-11,-8,0,-11.0,-8.0,0.532966136932373,329.5950674921761,17,-191,-282,427,116,1334,1132,23
-10,-9,0,-10.0,-9.0,0.5409359931945801,316.55152266475574,17,-181,-273,427,116,1334,1132,23
-9,-8,0,-9.0,-8.0,0.5488541126251221,304.92562415859845,17,-172,-265,427,116,1334,1132,23
-9,-10,0,-9.0,-10.0,0.5569431781768799,291.6450065671,17,-163,-255,427,116,1334,1132,23
-10,-9,0,-10.0,-9.0,0.5649840831756592,278.69811873741946,17,-153,-246,427,116,1334,1132,23
-8,-8,0,-8.0,-8.0,0.5729639530181885,267.69158580768095,17,-145,-238,427,116,1334,1132,23
-8,-7,0,-8.0,-7.0,0.5810470581054688,257.5702887513807,17,-137,-231,427,116,1334,1132,23
-8,-10,0,-8.0,-10.0,0.5889360904693604,244.89450951515158,17,-129,-221,427,116,1334,1132,23
-7,-8,0,-7.0,-8.0,0.5969769954681396,234.46486510293076,17,-122,-213,427,116,1334,1132,23
-6,-9,0,-6.0,-9.0,0.6050059795379639,223.67424230196207,17,-116,-204,427,116,1334,1132,23
-8,-8,0,-8.0,-8.0,0.6131210327148438,212.78561169118984,17,-108,-196,427,116,1334,1132,23
-6,-8,0,-6.0,-8.0,0.6212420463562012,202.88782106515555,17,-102,-188,427,116,1334,1132,23
-6,-8,0,-6.0,-8.0,0.6289231777191162,193.0,17,-96,-180,427,116,1334,1132,23
-7,-8,0,-7.0,-8.0,0.6368591785430908,182.6620768245554,17,-89,-172,427,116,1334,1132,23
-6,-9,0,-6.0,-9.0,0.6449670791625977,171.91528093628483,17,-83,-163,427,116,1334,1132,23
-6,-8,0,-6.0,-8.0,0.6529910564422607,162.07223925286226,17,-77,-155,427,116,1334,1132,23
-4,-7,0,-4.0,-7.0,0.6609079837799072,154.0242406436097,17,-73,-148,427,116,1334,1132,23
-3,-7,0,-3.0,-7.0,0.6689879894256592,146.41982086128797,17,-70,-141,427,116,1334,1132,23
-2,-6,0,-2.0,-6.0,0.6769871711730957,140.15885683611134,17,-68,-135,427,116,1334,1132,23
-2,-7,0,-2.0,-7.0,0.6850800514221191,133.01388821915754,17,-66,-128,427,116,1334,1132,23
-2,-7,0,-2.0,-7.0,0.6930801868438721,125.88316185711082,17,-64,-121,427,116,1334,1132,23
-1,-5,0,-1.0,-5.0,0.7009720802307129,121.00378782444085,17,-63,-116,427,116,1334,1132,23
-1,-6,0,-1.0,-6.0,0.7089641094207764,115.26955294131677,17,-62,-110,427,116,1334,1132,23
-1,-5,0,-1.0,-5.0,0.7169511318206787,110.43310915891102,17,-61,-105,427,116,1334,1132,23
-2,-6,0,-2.0,-6.0,0.7249259948730469,104.24755962709145,17,-59,-99,427,116,1334,1132,23
-3,-6,0,-3.0,-6.0,0.7329950332641602,97.55873986004075,17,-56,-93,427,116,1334,1132,23
-3,-6,0,-3.0,-6.0,0.741002082824707,90.87246929372037,17,-53,-87,427,116,1334,1132,23
-3,-4,0,-3.0,-4.0,0.7490291595458984,85.89685237405806,17,-50,-83,427,116,1334,1132,23
-2,-4,0,-2.0,-4.0,0.757033109664917,81.43916918709297,17,-48,-79,427,116,1334,1132,23
-3,-3,0,-3.0,-3.0,0.7651321887969971,77.32326986700618,17,-45,-76,427,116,1334,1132,23
-3,-4,0,-3.0,-4.0,0.7728841304779053,72.35466393669883,17,-42,-72,427,116,1334,1132,23
-2,-4,0,-2.0,-4.0,0.7808401584625244,67.89233169326408,17,-40,-68,427,116,1334,1132,23
-3,-5,0,-3.0,-5.0,0.7889490127563477,62.06161783043132,17,-37,-63,427,116,1334,1132,23
-3,-3,0,-3.0,-3.0,0.7969369888305664,57.963758598266665,17,-34,-60,427,116,1334,1132,23
-2,-5,0,-2.0,-5.0,0.8050611019134521,52.631753079732135,17,-32,-55,427,116,1334,1132,23
-3,-4,0,-3.0,-4.0,0.8130710124969482,47.66856057549052,17,-29,-51,427,116,1334,1132,23
-2,-3,0,-2.0,-3.0,0.8210310935974121,44.072679252057455,17,-27,-48,427,116,1334,1132,23
-1,-5,0,-1.0,-5.0,0.8289661407470703,39.24937810560445,17,-26,-43,427,116,1334,1132,23
-2,-4,0,-2.0,-4.0,0.8369569778442383,34.79301256742124,17,-24,-39,427,116,1334,1132,23
-2,-4,0,-2.0,-4.0,0.8449311256408691,30.340053217188775,17,-22,-35,427,116,1334,1132,23
-2,-5,0,-2.0,-5.0,0.8528211116790771,25.055512754639892,17,-20,-30,427,116,1334,1132,23
-1,-3,0,-1.0,-3.0,0.8610360622406006,22.015148038438355,17,-19,-27,427,116,1334,1132,23
-1,-4,0,-1.0,-4.0,0.8688781261444092,18.206163733020468,17,-18,-23,427,116,1334,1132,23
-1,-4,0,-1.0,-4.0,0.8769981861114502,14.495097567963924,17,-17,-19,427,116,1334,1132,23
-2,-4,0,-2.0,-4.0,0.8848750591278076,10.213203435596427,17,-15,-15,427,116,1334,1132,23
-2,-4,0,-2.0,-4.0,0.8929719924926758,6.029386365926403,17,-13,-11,427,116,1334,1132,23
-2,-4,0,-2.0,-4.0,0.9009790420532227,2.0384048104052983,17,-11,-7,427,116,1334,1132,23
-3,-3,0,-3.0,-3.0,0.909020185470581,-2.055728090000841,17,-8,-4,427,116,1334,1132,23
-2,-4,0,-2.0,-4.0,0.9170410633087158,-5.0,17,-6,0,427,116,1334,1132,23
-3,-5,0,-3.0,-5.0,0.9248361587524414,-5.169048105154699,17,-3,5,427,116,1334,1132,23
-2,-3,0,-2.0,-3.0,0.9328610897064209,-2.937742251701451,17,-1,8,427,116,1334,1132,23
-3,-4,0,-3.0,-4.0,0.9409570693969727,1.1655250605964387,17,2,12,427,116,1334,1132,23
-3,-3,0,-3.0,-3.0,0.9488539695739746,4.811388300841896,17,5,15,427,116,1334,1132,23
-2,-2,0,-2.0,-2.0,0.9569511413574219,7.384776310850235,17,7,17,427,116,1334,1132,23
-2,-2,0,-2.0,-2.0,0.9649579524993896,10.02379604162864,17,9,19,427,116,1334,1132,23
-1,-1,0,-1.0,-1.0,0.9729671478271484,11.360679774997898,17,10,20,427,116,1334,1132,23
-1,-1,0,-1.0,-1.0,0.9809551239013672,12.706539182259394,17,11,21,427,116,1334,1132,23
-1,-1,0,-1.0,-1.0,0.9889070987701416,14.059928172283335,17,12,22,427,116,1334,1132,23
0,0,1,-0.0,-0.0,1.0350430011749268,14.059928172283335,17,12,22,427,116,1334,1132,23
0,0,0,-0.0,-0.0,1.121840000152588,14.059928172283335,17,12,22,427,116,1334,1132,23
2,0,0,2.0,-0.0,1.2208499908447266,13.166091947189145,17,10,22,427,116,1334,1132,23
2,1,0,2.0,1.0,1.2289199829101562,11.472205054244231,17,8,21,427,116,1334,1132,23
1,1,0,1.0,1.0,1.236968994140625,10.189620100417091,17,7,20,427,116,1334,1132,23
1,0,0,1.0,-0.0,1.2450790405273438,9.880613017821101,17,6,20,427,116,1334,1132,23
0,1,0,-0.0,1.0,1.252985954284668,8.924858845171276,17,6,19,427,116,1334,1132,23
1,0,0,1.0,-0.0,1.2609691619873047,8.6468827043885,17,5,19,427,116,1334,1132,23
1,1,0,1.0,1.0,1.268982172012329,7.439088914585774,17,4,18,427,116,1334,1132,23
0,1,0,-0.0,1.0,1.276954174041748,6.464249196572979,17,4,17,427,116,1334,1132,23
1,0,0,1.0,-0.0,1.284980058670044,6.262676501632068,17,3,17,427,116,1334,1132,23
0,2,0,-0.0,2.0,1.2929229736328125,4.297058540778355,17,3,15,427,116,1334,1132,23
1,1,0,1.0,1.0,1.3010401725769043,3.142135623730951,17,2,14,427,116,1334,1132,23
1,2,0,1.0,2.0,1.3090171813964844,1.0415945787922958,17,1,12,427,116,1334,1132,23
1,1,0,1.0,1.0,1.316884994506836,0.0,17,0,11,427,116,1334,1132,23
0,0,1,-0.0,-0.0,1.3278820514678955,0.0,17,0,11,427,116,1334,1132,23
0,0,0,-0.0,-0.0,0.08796286582946777,436.29834186206386,18,262,365,689,470,427,105,27
0,1,0,-0.0,1.0,0.09103870391845703,435.4863431588525,18,262,364,689,470,427,105,27
1,0,0,1.0,-0.0,0.21893978118896484,434.9028912610411,18,261,364,689,470,427,105,27
3,4,0,3.0,4.0,0.22693085670471191,429.90405281505383,18,258,360,689,470,427,105,27
5,6,0,5.0,6.0,0.23495173454284668,422.1149273467873,18,253,354,689,470,427,105,27
6,7,0,6.0,7.0,0.24296879768371582,412.9319194425325,18,247,347,689,470,427,105,27
8,9,0,8.0,9.0,0.2513117790222168,400.96255869341616,18,239,338,689,470,427,105,27
9,11,0,9.0,11.0,0.25893378257751465,386.7861928581326,18,230,327,689,470,427,105,27
12,14,0,12.0,14.0,0.2668638229370117,368.43544670101124,18,218,313,689,470,427,105,27
13,16,0,13.0,16.0,0.274904727935791,347.8794812676387,18,205,297,689,470,427,105,27
16,17,0,16.0,17.0,0.28305482864379883,324.8179983363823,18,189,280,689,470,427,105,27
18,17,0,18.0,17.0,0.29106783866882324,300.70368184004474,18,171,263,689,470,427,105,27
20,19,0,20.0,19.0,0.2990298271179199,273.9442454554543,18,151,244,689,470,427,105,27
21,19,0,21.0,19.0,0.306931734085083,246.85572920372567,18,130,225,689,470,427,105,27
21,19,0,21.0,19.0,0.31496381759643555,220.0600780914655,18,109,206,689,470,427,105,27
19,18,0,19.0,18.0,0.3231778144836426,195.43224318708465,18,90,188,689,470,427,105,27
14,17,0,14.0,17.0,0.33092784881591797,174.128298234126,18,76,171,689,470,427,105,27
12,16,0,12.0,16.0,0.33890771865844727,154.69317219254933,18,64,155,689,470,427,105,27
11,16,0,11.0,16.0,0.34689974784851074,135.7615541731129,18,53,139,689,470,427,105,27
9,13,0,9.0,13.0,0.3549678325653076,120.46160496562297,18,44,126,689,470,427,105,27
9,12,0,9.0,12.0,0.36293983459472656,106.25183436744275,18,35,114,689,470,427,105,27
7,10,0,7.0,10.0,0.37090373039245605,94.70329614269008,18,28,104,689,470,427,105,27
4,8,0,4.0,8.0,0.3790297508239746,85.95453501482385,18,24,96,689,470,427,105,27
2,6,0,2.0,6.0,0.38704490661621094,79.64987857520376,18,22,90,689,470,427,105,27
2,5,0,2.0,5.0,0.3949728012084961,74.32124598286491,18,20,85,689,470,427,105,27
0,5,0,-0.0,5.0,0.4029977321624756,69.46211251235322,18,20,80,689,470,427,105,27
1,5,0,1.0,5.0,0.41090869903564453,64.3692445355388,18,19,75,689,470,427,105,27
0,5,0,-0.0,5.0,0.4189727306365967,59.532751223154364,18,19,70,689,470,427,105,27
0,4,0,-0.0,4.0,0.42701292037963867,55.6804193347711,18,19,66,689,470,427,105,27
0,5,0,-0.0,5.0,0.43498778343200684,50.89053137985315,18,19,61,689,470,427,105,27
0,5,0,-0.0,5.0,0.4429798126220703,46.135437767890075,18,19,56,689,470,427,105,27
-1,3,0,-1.0,3.0,0.4510219097137451,43.64803615307419,18,20,53,689,470,427,105,27
-1,3,0,-1.0,3.0,0.4589529037475586,41.230987451824994,18,21,50,689,470,427,105,27
-3,5,0,-3.0,5.0,0.4669487476348877,38.0,18,24,45,689,470,427,105,27
-2,3,0,-2.0,3.0,0.4748837947845459,36.39635614091387,18,26,42,689,470,427,105,27
-2,3,0,-2.0,3.0,0.48305177688598633,35.010415536631214,18,28,39,689,470,427,105,27
-3,3,0,-3.0,3.0,0.49092888832092285,34.50789408087881,18,31,36,689,470,427,105,27
-2,1,0,-2.0,1.0,0.4990818500518799,35.104053883222775,18,33,35,689,470,427,105,27
-1,3,0,-1.0,3.0,0.5069317817687988,33.69047011971501,18,34,32,689,470,427,105,27
-2,1,0,-2.0,1.0,0.5149827003479004,34.50789408087881,18,36,31,689,470,427,105,27
-2,2,0,-2.0,2.0,0.5228638648986816,34.80167361086848,18,38,29,689,470,427,105,27
-1,2,0,-1.0,2.0,0.5310778617858887,34.43416490252569,18,39,27,689,470,427,105,27
0,2,0,-0.0,2.0,0.5390098094940186,33.32493928760188,18,39,25,689,470,427,105,27
0,2,0,-0.0,2.0,0.5468618869781494,32.27692569068709,18,39,23,689,470,427,105,27
0,2,0,-0.0,2.0,0.5549867153167725,31.294469180700204,18,39,21,689,470,427,105,27
0,2,0,-0.0,2.0,0.5628538131713867,30.382023926967726,18,39,19,689,470,427,105,27
2,2,0,2.0,2.0,0.5709817409515381,27.718546143004666,18,37,17,689,470,427,105,27
1,2,0,1.0,2.0,0.5789449214935303,26.0,18,36,15,689,470,427,105,27
2,2,0,2.0,2.0,0.5869998931884766,23.400549446402593,18,34,13,689,470,427,105,27
2,2,0,2.0,2.0,0.5949559211730957,20.837848631377263,18,32,11,689,470,427,105,27
1,2,0,1.0,2.0,0.6029777526855469,19.280024783137947,18,31,9,689,470,427,105,27
1,1,0,1.0,1.0,0.6110508441925049,18.04834939252005,18,30,8,689,470,427,105,27
2,1,0,2.0,1.0,0.6191728115081787,15.861739379323623,18,28,7,689,470,427,105,27
1,3,0,1.0,3.0,0.6268398761749268,14.294688127912362,18,27,4,689,470,427,105,27
2,2,0,2.0,2.0,0.6349067687988281,12.079872407968907,18,25,2,689,470,427,105,27
2,2,0,2.0,2.0,0.6429457664489746,10.0,18,23,0,689,470,427,105,27
2,2,0,2.0,2.0,0.6509068012237549,8.095023109728988,18,21,-2,689,470,427,105,27
2,2,0,2.0,2.0,0.6588757038116455,6.416487838947599,18,19,-4,689,470,427,105,27
2,1,0,2.0,1.0,0.666975736618042,4.720045146669349,18,17,-5,689,470,427,105,27
1,2,0,1.0,2.0,0.67498779296875,4.464249196572979,18,16,-7,689,470,427,105,27
1,1,0,1.0,1.0,0.6829767227172852,4.0,18,15,-8,689,470,427,105,27
1,1,0,1.0,1.0,0.6909077167510986,3.6433169770932388,18,14,-9,689,470,427,105,27
1,1,0,1.0,1.0,0.698875904083252,3.401219466856727,18,13,-10,689,470,427,105,27
1,1,0,1.0,1.0,0.7068948745727539,3.278820596099706,18,12,-11,689,470,427,105,27
1,1,0,1.0,1.0,0.7148847579956055,3.278820596099706,18,11,-12,689,470,427,105,27
1,0,0,1.0,-0.0,0.7229669094085693,2.620499351813308,18,10,-12,689,470,427,105,27
0,0,1,-0.0,-0.0,0.7248399257659912,2.620499351813308,18,10,-12,689,470,427,105,27
1,0,1,1.0,-0.0,0.012025594711303711,1165.5431469543214,19,1079,446,1759,928,679,482,5
1,0,1,1.0,-0.0,0.02017045021057129,1164.6190466471905,19,1078,446,1759,928,679,482,5
0,1,1,-0.0,1.0,0.027907609939575195,1164.2371113971635,19,1078,445,1759,928,679,482,5
1,0,1,1.0,-0.0,0.035994529724121094,1163.312833534412,19,1077,445,1759,928,679,482,5
1,0,1,1.0,-0.0,0.04393148422241211,1162.3886808106647,19,1076,445,1759,928,679,482,5
0,0,0,-0.0,-0.0,0.09087657928466797,1162.3886808106647,19,1076,445,1759,928,679,482,5
1,0,0,1.0,-0.0,0.21197247505187988,1161.4646535241197,19,1075,445,1759,928,679,482,5
3,0,0,3.0,-0.0,0.21994543075561523,1158.6933272833096,19,1072,445,1759,928,679,482,5
9,1,0,9.0,1.0,0.22794342041015625,1150.000434027696,19,1063,444,1759,928,679,482,5
12,2,0,12.0,2.0,0.23607158660888672,1138.1600764804914,19,1051,442,1759,928,679,482,5
20,3,0,20.0,3.0,0.24394750595092773,1118.5721752747568,19,1031,439,1759,928,679,482,5
27,5,0,27.0,5.0,0.25188660621643066,1091.7879136285974,19,1004,434,1759,928,679,482,5
30,6,0,30.0,6.0,0.2599174976348877,1061.8890919640073,19,974,428,1759,928,679,482,5
32,8,0,32.0,8.0,0.2680075168609619,1029.3893542208004,19,942,420,1759,928,679,482,5
35,9,0,35.0,9.0,0.27599644660949707,993.7760792467351,19,907,411,1759,928,679,482,5
37,10,0,37.0,10.0,0.2839624881744385,955.967118433613,19,870,401,1759,928,679,482,5
36,11,0,36.0,11.0,0.2919294834136963,918.682355647158,19,834,390,1759,928,679,482,5
38,11,0,38.0,11.0,0.29995059967041016,879.62180100086,19,796,379,1759,928,679,482,5
35,9,0,35.0,9.0,0.3079085350036621,844.1802408470668,19,761,370,1759,928,679,482,5
33,10,0,33.0,10.0,0.31603455543518066,810.1477698054708,19,728,360,1759,928,679,482,5
33,9,0,33.0,9.0,0.3238046169281006,776.6051630961614,19,695,351,1759,928,679,482,5
34,10,0,34.0,10.0,0.3318796157836914,741.7755037644088,19,661,341,1759,928,679,482,5
33,10,0,33.0,10.0,0.3399806022644043,707.8908366784291,19,628,331,1759,928,679,482,5
32,9,0,32.0,9.0,0.34781551361083984,675.4215821775979,19,596,322,1759,928,679,482,5
32,8,0,32.0,8.0,0.3559544086456299,643.5168471852613,19,564,314,1759,928,679,482,5
32,8,0,32.0,8.0,0.36394762992858887,611.7263233722341,19,532,306,1759,928,679,482,5
30,7,0,30.0,7.0,0.37198853492736816,582.2987249686585,19,502,299,1759,928,679,482,5
27,5,0,27.0,5.0,0.3798995018005371,556.6242028412303,19,475,294,1759,928,679,482,5
27,7,0,27.0,7.0,0.3879516124725342,530.0460506384762,19,448,287,1759,928,679,482,5
24,6,0,24.0,6.0,0.3959355354309082,506.6619702710239,19,424,281,1759,928,679,482,5
23,6,0,23.0,6.0,0.4038236141204834,484.23656793787114,19,401,275,1759,928,679,482,5
22,7,0,22.0,7.0,0.4118804931640625,462.182076345048,19,379,268,1759,928,679,482,5
19,8,0,19.0,8.0,0.41986656188964844,442.07206622349037,19,360,260,1759,928,679,482,5
20,8,0,20.0,8.0,0.42790651321411133,421.2068052382901,19,340,252,1759,928,679,482,5
20,8,0,20.0,8.0,0.4359004497528076,400.41272345690066,19,320,244,1759,928,679,482,5
18,8,0,18.0,8.0,0.44387245178222656,381.275357934736,19,302,236,1759,928,679,482,5
17,9,0,17.0,9.0,0.4519386291503906,362.3542232498479,19,285,227,1759,928,679,482,5
13,8,0,13.0,8.0,0.4602046012878418,347.20624278497655,19,272,219,1759,928,679,482,5
12,8,0,12.0,8.0,0.46788859367370605,332.8447401408599,19,260,211,1759,928,679,482,5
9,6,0,9.0,6.0,0.4759635925292969,322.0771513081414,19,251,205,1759,928,679,482,5
8,6,0,8.0,6.0,0.4838845729827881,312.0859754907882,19,243,199,1759,928,679,482,5
9,6,0,9.0,6.0,0.49192357063293457,301.3232599059953,19,234,193,1759,928,679,482,5
9,6,0,9.0,6.0,0.499847412109375,290.5645227979633,19,225,187,1759,928,679,482,5
8,6,0,8.0,6.0,0.5079164505004883,280.57742301889584,19,217,181,1759,928,679,482,5
7,5,0,7.0,5.0,0.5159275531768799,272.0,19,210,176,1759,928,679,482,5
6,5,0,6.0,5.0,0.523991584777832,264.1897819225975,19,204,171,1759,928,679,482,5
4,4,0,4.0,4.0,0.5320515632629395,258.5551764981844,19,200,167,1759,928,679,482,5
4,5,0,4.0,5.0,0.539832592010498,252.2833065696606,19,196,162,1759,928,679,482,5
3,4,0,3.0,4.0,0.5478146076202393,247.42533953069002,19,193,158,1759,928,679,482,5
3,4,0,3.0,4.0,0.5560145378112793,242.57309745759036,19,190,154,1759,928,679,482,5
2,3,0,2.0,3.0,0.5640184879302979,239.13274352522097,19,188,151,1759,928,679,482,5
3,5,0,3.0,5.0,0.5720245838165283,233.6713813766958,19,185,146,1759,928,679,482,5
4,4,0,4.0,4.0,0.5800175666809082,228.05434140654683,19,181,142,1759,928,679,482,5
4,4,0,4.0,4.0,0.5879175662994385,222.43930137121706,19,177,138,1759,928,679,482,5
3,5,0,3.0,5.0,0.5960524082183838,217.0091322296858,19,174,133,1759,928,679,482,5
5,5,0,5.0,5.0,0.6039235591888428,210.00235847744713,19,169,128,1759,928,679,482,5
5,4,0,5.0,4.0,0.6119506359100342,203.60155641434235,19,164,124,1759,928,679,482,5
6,5,0,6.0,5.0,0.619971513748169,195.80040444852483,19,158,119,1759,928,679,482,5
5,5,0,5.0,5.0,0.6278045177459717,188.80094339389416,19,153,114,1759,928,679,482,5
7,5,0,7.0,5.0,0.6359546184539795,180.20043907740728,19,146,109,1759,928,679,482,5
7,6,0,7.0,6.0,0.6439094543457031,171.0028901492689,19,139,103,1759,928,679,482,5
9,6,0,9.0,6.0,0.6518886089324951,160.2004932174992,19,130,97,1759,928,679,482,5
8,5,0,8.0,5.0,0.6598145961761475,150.80052355931247,19,122,92,1759,928,679,482,5
9,5,0,9.0,5.0,0.6678674221038818,140.61135999632006,19,113,87,1759,928,679,482,5
8,5,0,8.0,5.0,0.6759955883026123,131.22537295875736,19,105,82,1759,928,679,482,5
9,6,0,9.0,6.0,0.6839725971221924,120.44182292011173,19,96,76,1759,928,679,482,5
8,5,0,8.0,5.0,0.6918735504150391,111.07077429645558,19,88,71,1759,928,679,482,5
9,5,0,9.0,5.0,0.6998224258422852,100.9417310909429,19,79,66,1759,928,679,482,5
6,4,0,6.0,4.0,0.7078084945678711,93.77577981932593,19,73,62,1759,928,679,482,5
5,3,0,5.0,3.0,0.7158424854278564,88.02777349240623,19,68,59,1759,928,679,482,5
5,4,0,5.0,4.0,0.7239534854888916,81.6301381082203,19,63,55,1759,928,679,482,5
5,2,0,5.0,2.0,0.7320055961608887,76.56844150166147,19,58,53,1759,928,679,482,5
5,3,0,5.0,3.0,0.7399134635925293,70.86288492778748,19,53,50,1759,928,679,482,5
4,2,0,4.0,2.0,0.747915506362915,66.59300255857006,19,49,48,1759,928,679,482,5
4,2,0,4.0,2.0,0.7558925151824951,62.350602172784676,19,45,46,1759,928,679,482,5
2,1,0,2.0,1.0,0.7638804912567139,60.24146527838174,19,43,45,1759,928,679,482,5
2,2,0,2.0,2.0,0.7718114852905273,57.413803110051795,19,41,43,1759,928,679,482,5
1,1,0,1.0,1.0,0.7800455093383789,56.0,19,40,42,1759,928,679,482,5
2,1,0,2.0,1.0,0.7879235744476318,53.90169943749474,19,38,41,1759,928,679,482,5
2,1,0,2.0,1.0,0.7958524227142334,51.81449618829484,19,36,40,1759,928,679,482,5
2,2,0,2.0,2.0,0.8039336204528809,48.99019513592785,19,34,38,1759,928,679,482,5
2,3,0,2.0,3.0,0.8119285106658936,45.4236228055175,19,32,35,1759,928,679,482,5
3,2,0,3.0,2.0,0.8199245929718018,41.93176527297759,19,29,33,1759,928,679,482,5
3,1,0,3.0,1.0,0.8279125690460205,39.23105625617661,19,26,32,1759,928,679,482,5
3,2,0,3.0,2.0,0.8358705043792725,35.8021163428716,19,23,30,1759,928,679,482,5
2,3,0,2.0,3.0,0.8439114093780518,32.20526275297414,19,21,27,1759,928,679,482,5
3,2,0,3.0,2.0,0.8518335819244385,28.805843601498726,19,18,25,1759,928,679,482,5
2,1,0,2.0,1.0,0.8597874641418457,26.844410203711913,19,16,24,1759,928,679,482,5
1,2,0,1.0,2.0,0.8680675029754639,24.627053911388696,19,15,22,1759,928,679,482,5
3,3,0,3.0,3.0,0.8759346008300781,20.47220505424423,19,12,19,1759,928,679,482,5
3,2,0,3.0,2.0,0.8839535713195801,17.235384061671343,19,9,17,1759,928,679,482,5
3,3,0,3.0,3.0,0.8919246196746826,13.231546211727817,19,6,14,1759,928,679,482,5
3,2,0,3.0,2.0,0.899937629699707,10.36931687685298,19,3,12,1759,928,679,482,5
3,2,0,3.0,2.0,0.9079184532165527,8.0,19,0,10,1759,928,679,482,5
3,2,0,3.0,2.0,0.9159305095672607,6.54400374531753,19,-3,8,1759,928,679,482,5
2,1,0,2.0,1.0,0.9238355159759521,6.602325267042627,19,-5,7,1759,928,679,482,5
2,1,0,2.0,1.0,0.931849479675293,7.219544457292887,19,-7,6,1759,928,679,482,5
1,1,0,1.0,1.0,0.9398396015167236,7.433981132056603,19,-8,5,1759,928,679,482,5
1,1,0,1.0,1.0,0.9478785991668701,7.848857801796104,19,-9,4,1759,928,679,482,5
1,1,0,1.0,1.0,0.9559295177459717,8.44030650891055,19,-10,3,1759,928,679,482,5
1,0,0,1.0,-0.0,0.9639484882354736,9.40175425099138,19,-11,3,1759,928,679,482,5
1,1,0,1.0,1.0,0.971888542175293,10.165525060596439,19,-12,2,1759,928,679,482,5
1,1,0,1.0,1.0,0.9798634052276611,11.038404810405298,19,-13,1,1759,928,679,482,5
0,1,0,-0.0,1.0,0.9878385066986084,11.0,19,-13,0,1759,928,679,482,5
1,0,0,1.0,-0.0,0.9959635734558105,12.0,19,-14,0,1759,928,679,482,5
1,1,0,1.0,1.0,1.0039234161376953,13.033296378372908,19,-15,-1,1759,928,679,482,5
-1,0,0,-1.0,-0.0,1.0839464664459229,12.035668847618199,19,-14,-1,1759,928,679,482,5
-1,0,0,-1.0,-0.0,1.0919914245605469,11.038404810405298,19,-13,-1,1759,928,679,482,5
-1,0,0,-1.0,-0.0,1.0999975204467773,10.041594578792296,19,-12,-1,1759,928,679,482,5
-2,0,0,-2.0,-0.0,1.1079704761505127,8.04987562112089,19,-10,-1,1759,928,679,482,5
-2,0,0,-2.0,-0.0,1.116032600402832,6.062257748298549,19,-8,-1,1759,928,679,482,5
-2,0,0,-2.0,-0.0,1.1239345073699951,4.082762530298219,19,-6,-1,1759,928,679,482,5
-1,0,0,-1.0,-0.0,1.131821632385254,3.0990195135927845,19,-5,-1,1759,928,679,482,5
-1,0,0,-1.0,-0.0,1.139864444732666,2.1231056256176606,19,-4,-1,1759,928,679,482,5
0,-1,0,-0.0,-1.0,1.14815354347229,2.0,19,-4,0,1759,928,679,482,5
-1,0,0,-1.0,-0.0,1.1559174060821533,1.0,19,-3,0,1759,928,679,482,5
0,0,1,-0.0,-0.0,1.2558395862579346,1.0,19,-3,0,1759,928,679,482,5
0,0,0,-0.0,-0.0,0.12701082229614258,1255.9303925579288,20,-1110,-663,652,265,1762,928,74
-2,0,0,-2.0,-0.0,0.21007204055786133,1254.2137700628816,20,-1108,-663,652,265,1762,928,74
-2,0,0,-2.0,-0.0,0.21808195114135742,1252.4979643256518,20,-1106,-663,652,265,1762,928,74
-4,-1,0,-4.0,-1.0,0.22614288330078125,1248.5535772576732,20,-1102,-662,652,265,1762,928,74
-3,-1,0,-3.0,-1.0,0.23406982421875,1245.4671535754824,20,-1099,-661,652,265,1762,928,74
-5,-1,0,-5.0,-1.0,0.24235296249389648,1240.6681885372275,20,-1094,-660,652,265,1762,928,74
-7,-4,0,-7.0,-4.0,0.249953031539917,1232.608207282861,20,-1087,-656,652,265,1762,928,74
-10,-6,0,-10.0,-6.0,0.258167028427124,1220.946342257888,20,-1077,-650,652,265,1762,928,74
-14,-7,0,-14.0,-7.0,0.26601386070251465,1205.3437527512262,20,-1063,-643,652,265,1762,928,74
-19,-11,0,-19.0,-11.0,0.2739708423614502,1183.3933792019686,20,-1044,-632,652,265,1762,928,74
-29,-17,0,-29.0,-17.0,0.28203797340393066,1149.7813614984018,20,-1015,-615,652,265,1762,928,74
-42,-23,0,-42.0,-23.0,0.2900879383087158,1101.9438089739108,20,-973,-592,652,265,1762,928,74
-49,-26,0,-49.0,-26.0,0.29842305183410645,1046.573716920081,20,-924,-566,652,265,1762,928,74
-53,-27,0,-53.0,-27.0,0.30603599548339844,987.2860928471107,20,-871,-539,652,265,1762,928,74
-54,-25,0,-54.0,-25.0,0.31404590606689453,928.2383125425555,20,-817,-514,652,265,1762,928,74
-52,-23,0,-52.0,-23.0,0.322192907333374,872.0137512711235,20,-765,-491,652,265,1762,928,74
-46,-21,0,-46.0,-21.0,0.3301398754119873,821.9883584775756,20,-719,-470,652,265,1762,928,74
-41,-19,0,-41.0,-19.0,0.3381478786468506,777.3003131523407,20,-678,-451,652,265,1762,928,74
-35,-19,0,-35.0,-19.0,0.3460538387298584,737.6437891056767,20,-643,-432,652,265,1762,928,74
-29,-17,0,-29.0,-17.0,0.3540780544281006,704.0944609157459,20,-614,-415,652,265,1762,928,74
-23,-16,0,-23.0,-16.0,0.36206984519958496,676.0792382337323,20,-591,-399,652,265,1762,928,74
-22,-15,0,-22.0,-15.0,0.370028018951416,649.4524746841547,20,-569,-384,652,265,1762,928,74
-21,-15,0,-21.0,-15.0,0.3779759407043457,623.6549780331637,20,-548,-369,652,265,1762,928,74
-18,-15,0,-18.0,-15.0,0.3861198425292969,600.35076684664,20,-530,-354,652,265,1762,928,74
-18,-15,0,-18.0,-15.0,0.39397382736206055,577.0561863543107,20,-512,-339,652,265,1762,928,74
-16,-13,0,-16.0,-13.0,0.40213990211486816,556.5419109043606,20,-496,-326,652,265,1762,928,74
-13,-12,0,-13.0,-12.0,0.41002988815307617,539.0946102854981,20,-483,-314,652,265,1762,928,74
-12,-11,0,-12.0,-11.0,0.418071985244751,523.0446410778341,20,-471,-303,652,265,1762,928,74
-8,-10,0,-8.0,-10.0,0.42604589462280273,510.9215272281242,20,-463,-293,652,265,1762,928,74
-7,-8,0,-7.0,-8.0,0.4340970516204834,500.7369245272264,20,-456,-285,652,265,1762,928,74
-4,-7,0,-4.0,-7.0,0.4421088695526123,493.6486596609851,20,-452,-278,652,265,1762,928,74
-4,-5,0,-4.0,-5.0,0.45000791549682617,487.62653383144857,20,-448,-273,652,265,1762,928,74
-3,-6,0,-3.0,-6.0,0.45795202255249023,481.9547186412317,20,-445,-267,652,265,1762,928,74
-5,-6,0,-5.0,-6.0,0.4659879207611084,474.5867472873002,20,-440,-261,652,265,1762,928,74
-7,-8,0,-7.0,-8.0,0.4740109443664551,464.49576269396334,20,-433,-253,652,265,1762,928,74
-9,-7,0,-9.0,-7.0,0.4821128845214844,453.1958792156458,20,-424,-246,652,265,1762,928,74
-11,-9,0,-11.0,-9.0,0.4900078773498535,439.1701376608995,20,-413,-237,652,265,1762,928,74
-11,-8,0,-11.0,-8.0,0.49798083305358887,425.6499756835614,20,-402,-229,652,265,1762,928,74
-13,-8,0,-13.0,-8.0,0.5059819221496582,410.39468034387716,20,-389,-221,652,265,1762,928,74
-14,-8,0,-14.0,-8.0,0.5140609741210938,394.27021691742175,20,-375,-213,652,265,1762,928,74
-13,-7,0,-13.0,-7.0,0.5219638347625732,379.50930361757827,20,-362,-206,652,265,1762,928,74
-11,-6,0,-11.0,-6.0,0.5299818515777588,366.98143521701587,20,-351,-200,652,265,1762,928,74
-11,-7,0,-11.0,-7.0,0.5379970073699951,353.9590771423526,20,-340,-193,652,265,1762,928,74
-10,-6,0,-10.0,-6.0,0.5460808277130127,342.3006722904667,20,-330,-187,652,265,1762,928,74
-10,-7,0,-10.0,-7.0,0.5540659427642822,330.1511950137164,20,-320,-180,652,265,1762,928,74
-12,-6,0,-12.0,-6.0,0.5620720386505127,316.75132508585745,20,-308,-174,652,265,1762,928,74
-10,-6,0,-10.0,-6.0,0.5700750350952148,305.0935544555027,20,-298,-168,652,265,1762,928,74
-11,-6,0,-11.0,-6.0,0.5781190395355225,292.56486463213884,20,-287,-162,652,265,1762,928,74
-13,-6,0,-13.0,-6.0,0.5859718322753906,278.2966856787429,20,-274,-156,652,265,1762,928,74
-13,-6,0,-13.0,-6.0,0.594080924987793,264.03322075810837,20,-261,-150,652,265,1762,928,74
-12,-7,0,-12.0,-7.0,0.6019480228424072,250.14108030722457,20,-249,-143,652,265,1762,928,74
-13,-7,0,-13.0,-7.0,0.6101109981536865,235.3820845797315,20,-236,-136,652,265,1762,928,74
-12,-6,0,-12.0,-6.0,0.6180758476257324,221.99034731047408,20,-224,-130,652,265,1762,928,74
-11,-5,0,-11.0,-5.0,0.6260828971862793,209.969633760914,20,-213,-125,652,265,1762,928,74
-12,-6,0,-12.0,-6.0,0.6341140270233154,196.58510226467783,20,-201,-119,652,265,1762,928,74
-12,-5,0,-12.0,-5.0,0.6420550346374512,183.7192787229969,20,-189,-114,652,265,1762,928,74
-14,-6,0,-14.0,-6.0,0.6500709056854248,168.6428943581567,20,-175,-108,652,265,1762,928,74
-16,-7,0,-16.0,-7.0,0.6582958698272705,151.36666371733614,20,-159,-101,652,265,1762,928,74
-15,-6,0,-15.0,-6.0,0.6660430431365967,135.51376756653366,20,-144,-95,652,265,1762,928,74
-13,-6,0,-13.0,-6.0,0.6739299297332764,121.37297749300541,20,-131,-89,652,265,1762,928,74
-11,-6,0,-11.0,-6.0,0.6819019317626953,108.90750494748377,20,-120,-83,652,265,1762,928,74
-10,-4,0,-10.0,-4.0,0.6901459693908691,98.4289481610191,20,-110,-79,652,265,1762,928,74
-9,-6,0,-9.0,-6.0,0.698051929473877,87.61942063739504,20,-101,-73,652,265,1762,928,74
-8,-5,0,-8.0,-5.0,0.7060599327087402,78.20850663036997,20,-93,-68,652,265,1762,928,74
-7,-5,0,-7.0,-5.0,0.7140579223632812,69.60675400742676,20,-86,-63,652,265,1762,928,74
-7,-5,0,-7.0,-5.0,0.7220818996429443,61.00510190801293,20,-79,-58,652,265,1762,928,74
-8,-5,0,-8.0,-5.0,0.7302289009094238,51.60022573334675,20,-71,-53,652,265,1762,928,74
-7,-5,0,-7.0,-5.0,0.7379150390625,43.0,20,-64,-48,652,265,1762,928,74
-7,-6,0,-7.0,-6.0,0.7459428310394287,33.802542327235685,20,-57,-42,652,265,1762,928,74
-5,-5,0,-5.0,-5.0,0.7541239261627197,26.820059542435402,20,-52,-37,652,265,1762,928,74
-6,-5,0,-6.0,-5.0,0.7619359493255615,19.0357029044876,20,-46,-32,652,265,1762,928,74
-5,-5,0,-5.0,-5.0,0.7700238227844238,12.09175083453431,20,-41,-27,652,265,1762,928,74
-4,-5,0,-4.0,-5.0,0.778033971786499,6.046486500061768,20,-37,-22,652,265,1762,928,74
-4,-3,0,-4.0,-3.0,0.7860939502716064,1.0788655293195433,20,-33,-19,652,265,1762,928,74
-3,-3,0,-3.0,-3.0,0.7940769195556641,-3.0,20,-30,-16,652,265,1762,928,74
-4,-3,0,-4.0,-3.0,0.8023660182952881,-7.9311162925027325,20,-26,-13,652,265,1762,928,74
-3,-3,0,-3.0,-3.0,0.8099088668823242,-11.920127592031093,20,-23,-10,652,265,1762,928,74
-4,-3,0,-4.0,-3.0,0.8181109428405762,-16.751543268683413,20,-19,-7,652,265,1762,928,74
-5,-2,0,-5.0,-2.0,0.8259978294372559,-22.133931252681492,20,-14,-5,652,265,1762,928,74
-3,-2,0,-3.0,-2.0,0.8341588973999023,-25.59824574900862,20,-11,-3,652,265,1762,928,74
-3,-2,0,-3.0,-2.0,0.84214186668396,-28.93774225170145,20,-8,-1,652,265,1762,928,74
-1,0,0,-1.0,-0.0,0.8501529693603516,-29.928932188134524,20,-7,-1,652,265,1762,928,74
0,0,1,-0.0,-0.0,0.9039719104766846,-29.928932188134524,20,-7,-1,652,265,1762,928,74
0,0,0,-0.0,-0.0,0.06291556358337402,659.4165420206501,21,414,560,1073,826,659,266,75
0,6,0,-0.0,6.0,0.19677162170410156,654.6010410634154,21,414,554,1073,826,659,266,75
3,11,0,3.0,11.0,0.20481157302856445,644.0066078974564,21,411,543,1073,826,659,266,75
11,13,0,11.0,13.0,0.21271371841430664,627.0030120413611,21,400,530,1073,826,659,266,75
18,14,0,18.0,14.0,0.22077059745788574,605.0124609382593,21,382,516,1073,826,659,266,75
20,14,0,20.0,14.0,0.22887468338012695,581.9087170172998,21,362,502,1073,826,659,266,75
22,14,0,22.0,14.0,0.23685455322265625,557.7638186709074,21,340,488,1073,826,659,266,75
22,16,0,22.0,16.0,0.2448596954345703,532.1291593302877,21,318,472,1073,826,659,266,75
20,17,0,20.0,17.0,0.2529795169830322,506.9016455205849,21,298,455,1073,826,659,266,75
18,17,0,18.0,17.0,0.2609286308288574,482.8499783591416,21,280,438,1073,826,659,266,75
17,19,0,17.0,19.0,0.2688887119293213,457.7019304591402,21,263,419,1073,826,659,266,75
17,19,0,17.0,19.0,0.276761531829834,432.5913116743111,21,246,400,1073,826,659,266,75
16,21,0,16.0,21.0,0.28502464294433594,406.3294486045338,21,230,379,1073,826,659,266,75
16,21,0,16.0,21.0,0.29279470443725586,380.0851232062827,21,214,358,1073,826,659,266,75
16,22,0,16.0,22.0,0.30097270011901855,353.0,21,198,336,1073,826,659,266,75
15,21,0,15.0,21.0,0.30886054039001465,327.2993274767331,21,183,315,1073,826,659,266,75
15,20,0,15.0,20.0,0.3169417381286621,302.48343111262443,21,168,295,1073,826,659,266,75
12,20,0,12.0,20.0,0.3248875141143799,279.16609558901155,21,156,275,1073,826,659,266,75
11,18,0,11.0,18.0,0.3329136371612549,258.0830391601659,21,145,257,1073,826,659,266,75
8,15,0,8.0,15.0,0.34074854850769043,241.08811553175013,21,137,242,1073,826,659,266,75
6,13,0,6.0,13.0,0.3489706516265869,226.82190962844612,21,131,229,1073,826,659,266,75
5,14,0,5.0,14.0,0.35672473907470703,212.20072231034965,21,126,215,1073,826,659,266,75
5,11,0,5.0,11.0,0.36486268043518066,200.1855813492886,21,121,204,1073,826,659,266,75
5,9,0,5.0,9.0,0.3728635311126709,189.8942484947558,21,116,195,1073,826,659,266,75
4,8,0,4.0,8.0,0.3810737133026123,180.97476918212345,21,112,187,1073,826,659,266,75
5,9,0,5.0,9.0,0.3888685703277588,170.68485741623053,21,107,178,1073,826,659,266,75
6,7,0,6.0,7.0,0.39706873893737793,161.600100704909,21,101,171,1073,826,659,266,75
4,6,0,4.0,6.0,0.40486860275268555,154.4001044931794,21,97,165,1073,826,659,266,75
4,7,0,4.0,7.0,0.4128856658935547,146.33848477611022,21,93,158,1073,826,659,266,75
5,6,0,5.0,6.0,0.4209475517272949,138.6359872008012,21,88,152,1073,826,659,266,75
4,5,0,4.0,5.0,0.4287526607513428,132.30741271426953,21,84,147,1073,826,659,266,75
4,6,0,4.0,6.0,0.43685150146484375,125.11415730897781,21,80,141,1073,826,659,266,75
4,7,0,4.0,7.0,0.4449036121368408,117.0519392932137,21,76,134,1073,826,659,266,75
4,8,0,4.0,8.0,0.4528505802154541,108.12063946937388,21,72,126,1073,826,659,266,75
4,6,0,4.0,6.0,0.4608266353607178,100.92751719653333,21,68,120,1073,826,659,266,75
3,6,0,3.0,6.0,0.46888065338134766,94.22880781291889,21,65,114,1073,826,659,266,75
3,5,0,3.0,5.0,0.47691965103149414,88.39936203984452,21,62,109,1073,826,659,266,75
3,3,0,3.0,3.0,0.4847705364227295,84.31364309095659,21,59,106,1073,826,659,266,75
3,4,0,3.0,4.0,0.49284863471984863,79.36150566231085,21,56,102,1073,826,659,266,75
2,3,0,2.0,3.0,0.5009615421295166,75.76967677527502,21,54,99,1073,826,659,266,75
4,4,0,4.0,4.0,0.508739709854126,70.35455276791944,21,50,95,1073,826,659,266,75
3,4,0,3.0,4.0,0.5167675018310547,65.42070103255493,21,47,91,1073,826,659,266,75
4,3,0,4.0,3.0,0.5248706340789795,60.94386147176351,21,43,88,1073,826,659,266,75
4,3,0,4.0,3.0,0.5328836441040039,56.5200513259055,21,39,85,1073,826,659,266,75
3,3,0,3.0,3.0,0.5408625602722168,52.55445270895244,21,36,82,1073,826,659,266,75
4,3,0,4.0,3.0,0.5489146709442139,48.234969349440135,21,32,79,1073,826,659,266,75
3,3,0,3.0,3.0,0.5568296909332275,44.344944526380985,21,29,76,1073,826,659,266,75
4,3,0,4.0,3.0,0.5649716854095459,40.1621668954417,21,25,73,1073,826,659,266,75
3,4,0,3.0,4.0,0.5728297233581543,35.422372233999624,21,22,69,1073,826,659,266,75
4,4,0,4.0,4.0,0.5808017253875732,30.446274915668994,21,18,65,1073,826,659,266,75
3,3,0,3.0,3.0,0.5888645648956299,26.788713735268246,21,15,62,1073,826,659,266,75
1,2,0,1.0,2.0,0.5968425273895264,24.61168720299745,21,14,60,1073,826,659,266,75
2,2,0,2.0,2.0,0.6049137115478516,22.22837157984339,21,12,58,1073,826,659,266,75
2,2,0,2.0,2.0,0.6128506660461426,19.88585061331157,21,10,56,1073,826,659,266,75
2,3,0,2.0,3.0,0.6208527088165283,16.600373133029585,21,8,53,1073,826,659,266,75
3,3,0,3.0,3.0,0.6287925243377686,13.24937810560445,21,5,50,1073,826,659,266,75
4,3,0,4.0,3.0,0.6369836330413818,10.010637094172637,21,1,47,1073,826,659,266,75
5,4,0,5.0,4.0,0.6447787284851074,6.185645763378368,21,-4,43,1073,826,659,266,75
3,4,0,3.0,4.0,0.6529445648193359,2.6232255123179016,21,-7,39,1073,826,659,266,75
3,3,0,3.0,3.0,0.6609046459197998,0.36308338453881106,21,-10,36,1073,826,659,266,75
2,3,0,2.0,3.0,0.6688666343688965,-1.885900267841123,21,-12,33,1073,826,659,266,75
2,3,0,2.0,3.0,0.6768965721130371,-3.8941092855063033,21,-14,30,1073,826,659,266,75
1,2,0,1.0,2.0,0.6848585605621338,-5.23523965146282,21,-15,28,1073,826,659,266,75
1,1,0,1.0,1.0,0.6928105354309082,-5.615290347049569,21,-16,27,1073,826,659,266,75
1,2,0,1.0,2.0,0.7008256912231445,-6.767567084338051,21,-17,25,1073,826,659,266,75
0,1,0,-0.0,1.0,0.7089645862579346,-7.589117660294516,21,-17,24,1073,826,659,266,75
1,1,0,1.0,1.0,0.7168796062469482,-7.7938362669795325,21,-18,23,1073,826,659,266,75
0,1,0,-0.0,1.0,0.7408616542816162,-8.57465919289621,21,-18,22,1073,826,659,266,75
0,0,1,-0.0,-0.0,0.7489476203918457,-8.57465919289621,21,-18,22,1073,826,659,266,75
1,0,1,1.0,-0.0,0.0008771419525146484,920.9443833726153,22,-925,-136,167,668,1091,804,29
0,0,0,-0.0,-0.0,0.07175111770629883,920.9443833726153,22,-925,-136,167,668,1091,804,29
-1,0,0,-1.0,-0.0,0.1766972541809082,919.9550310373621,22,-924,-136,167,668,1091,804,29
-2,0,0,-2.0,-0.0,0.18481111526489258,917.9763945508491,22,-922,-136,167,668,1091,804,29
-5,-1,0,-5.0,-1.0,0.19283127784729004,912.8840272655474,22,-917,-135,167,668,1091,804,29
-6,-2,0,-6.0,-2.0,0.20087432861328125,906.6573738367601,22,-911,-133,167,668,1091,804,29
-7,-3,0,-7.0,-3.0,0.20887112617492676,899.29951275581,22,-904,-130,167,668,1091,804,29
-12,-6,0,-12.0,-6.0,0.2168562412261963,886.5775924372092,22,-892,-124,167,668,1091,804,29
-16,-8,0,-16.0,-8.0,0.22495317459106445,869.6469883386691,22,-876,-116,167,668,1091,804,29
-22,-9,0,-22.0,-9.0,0.2327423095703125,846.6770590645483,22,-854,-107,167,668,1091,804,29
-28,-9,0,-28.0,-9.0,0.24079012870788574,817.7932435407251,22,-826,-98,167,668,1091,804,29
-30,-11,0,-30.0,-11.0,0.24875426292419434,786.7402824886482,22,-796,-87,167,668,1091,804,29
-35,-9,0,-35.0,-9.0,0.25687217712402344,750.9869279928906,22,-761,-78,167,668,1091,804,29
-35,-8,0,-35.0,-8.0,0.26479530334472656,715.3668487119496,22,-726,-70,167,668,1091,804,29
-34,-7,0,-34.0,-7.0,0.27294015884399414,680.8618567744239,22,-692,-63,167,668,1091,804,29
-30,-5,0,-30.0,-5.0,0.280886173248291,650.5359282988393,22,-662,-58,167,668,1091,804,29
-29,-5,0,-29.0,-5.0,0.28875231742858887,621.2149242579239,22,-633,-53,167,668,1091,804,29
-27,-5,0,-27.0,-5.0,0.2968583106994629,593.8980177628481,22,-606,-48,167,668,1091,804,29
-25,-4,0,-25.0,-4.0,0.3056011199951172,568.663710900207,22,-581,-44,167,668,1091,804,29
-25,-4,0,-25.0,-4.0,0.3127403259277344,543.4369919551447,22,-556,-40,167,668,1091,804,29
-26,-4,0,-26.0,-4.0,0.32082509994506836,517.2212345153382,22,-530,-36,167,668,1091,804,29
-26,-3,0,-26.0,-3.0,0.3287942409515381,491.07920170998926,22,-504,-33,167,668,1091,804,29
-29,-4,0,-29.0,-4.0,0.3368861675262451,461.88443975402265,22,-475,-29,167,668,1091,804,29
-30,-3,0,-30.0,-3.0,0.34485816955566406,431.7589034444517,22,-445,-26,167,668,1091,804,29
-29,-2,0,-29.0,-2.0,0.35286426544189453,402.69173257937337,22,-416,-24,167,668,1091,804,29
-26,-1,0,-26.0,-1.0,0.36087632179260254,376.6776164563309,22,-390,-23,167,668,1091,804,29
-23,-1,0,-23.0,-1.0,0.36883020401000977,353.6588092239869,22,-367,-22,167,668,1091,804,29
-22,-1,0,-22.0,-1.0,0.3769042491912842,331.63853951780317,22,-345,-21,167,668,1091,804,29
-17,0,0,-17.0,-0.0,0.38475823402404785,314.6715685908959,22,-328,-21,167,668,1091,804,29
-19,0,0,-19.0,-0.0,0.3927803039550781,295.7127701597078,22,-309,-21,167,668,1091,804,29
-17,-1,0,-17.0,-1.0,0.4009733200073242,278.6841300788275,22,-292,-20,167,668,1091,804,29
-18,0,0,-18.0,-0.0,0.408832311630249,260.7289573379552,22,-274,-20,167,668,1091,804,29
-17,-1,0,-17.0,-1.0,0.416823148727417,243.70137756713683,22,-257,-19,167,668,1091,804,29
-19,-1,0,-19.0,-1.0,0.42479825019836426,224.67970169245646,22,-238,-18,167,668,1091,804,29
-19,-2,0,-19.0,-2.0,0.43289732933044434,205.58369702689677,22,-219,-16,167,668,1091,804,29
-18,-2,0,-18.0,-2.0,0.4408292770385742,187.48697228356974,22,-201,-14,167,668,1091,804,29
-16,-1,0,-16.0,-1.0,0.4488391876220703,171.4561942885705,22,-185,-13,167,668,1091,804,29
-13,-2,0,-13.0,-2.0,0.45691823959350586,158.35138525698017,22,-172,-11,167,668,1091,804,29
-11,-1,0,-11.0,-1.0,0.4650990962982178,147.31026005806325,22,-161,-10,167,668,1091,804,29
-9,-1,0,-9.0,-1.0,0.4727821350097656,138.26621424334422,22,-152,-9,167,668,1091,804,29
-6,-1,0,-6.0,-1.0,0.48078131675720215,132.21901381147393,22,-146,-8,167,668,1091,804,29
-5,-1,0,-5.0,-1.0,0.48889732360839844,127.17365193264641,22,-141,-7,167,668,1091,804,29
-6,0,0,-6.0,-0.0,0.4967522621154785,121.18135966175217,22,-135,-7,167,668,1091,804,29
-6,-1,0,-6.0,-1.0,0.5048832893371582,115.1394595001853,22,-129,-6,167,668,1091,804,29
-4,0,0,-4.0,-0.0,0.512890100479126,111.14391715141412,22,-125,-6,167,668,1091,804,29
-4,0,0,-4.0,-0.0,0.5208930969238281,107.1486689980538,22,-121,-6,167,668,1091,804,29
-4,0,0,-4.0,-0.0,0.5288453102111816,103.15374513859982,22,-117,-6,167,668,1091,804,29
-3,0,0,-3.0,-0.0,0.5368301868438721,100.15778554264269,22,-114,-6,167,668,1091,804,29
-4,0,0,-4.0,-0.0,0.5447962284088135,96.16351483136329,22,-110,-6,167,668,1091,804,29
-2,0,0,-2.0,-0.0,0.552739143371582,94.16653826391968,22,-108,-6,167,668,1091,804,29
-3,0,0,-3.0,-0.0,0.5608422756195068,91.17128885774862,22,-105,-6,167,668,1091,804,29
-2,0,0,-2.0,-0.0,0.5688462257385254,89.1746092796091,22,-103,-6,167,668,1091,804,29
-3,0,0,-3.0,-0.0,0.5768282413482666,86.17983829094555,22,-100,-6,167,668,1091,804,29
-3,0,0,-3.0,-0.0,0.5848722457885742,83.18538984847466,22,-97,-6,167,668,1091,804,29
-4,0,0,-4.0,-0.0,0.5928521156311035,79.1933474020544,22,-93,-6,167,668,1091,804,29
-3,0,0,-3.0,-0.0,0.6008102893829346,76.19977827023745,22,-90,-6,167,668,1091,804,29
-3,1,0,-3.0,1.0,0.6087131500244141,73.28115489611719,22,-87,-7,167,668,1091,804,29
-4,0,0,-4.0,-0.0,0.616814136505127,69.2946576918352,22,-83,-7,167,668,1091,804,29
-4,0,0,-4.0,-0.0,0.6248171329498291,65.30952023559341,22,-79,-7,167,668,1091,804,29
-5,0,0,-5.0,-0.0,0.6328423023223877,60.330343736592525,22,-74,-7,167,668,1091,804,29
-6,0,0,-6.0,-0.0,0.6407983303070068,54.3593446428504,22,-68,-7,167,668,1091,804,29
-4,0,0,-4.0,-0.0,0.6488471031188965,50.38167441127949,22,-64,-7,167,668,1091,804,29
-5,0,0,-5.0,-0.0,0.6567971706390381,45.413803110051795,22,-59,-7,167,668,1091,804,29
-4,-1,0,-4.0,-1.0,0.6648342609405518,41.326304774492215,22,-55,-6,167,668,1091,804,29
-4,-1,0,-4.0,-1.0,0.6729302406311035,37.24451190127583,22,-51,-5,167,668,1091,804,29
-5,0,0,-5.0,-0.0,0.6808903217315674,32.2709412050371,22,-46,-5,167,668,1091,804,29
-5,-1,0,-5.0,-1.0,0.688826322555542,27.19465984809196,22,-41,-4,167,668,1091,804,29
-6,-1,0,-6.0,-1.0,0.6967222690582275,21.128336140500593,22,-35,-3,167,668,1091,804,29
-5,-1,0,-5.0,-1.0,0.704714298248291,16.066592756745816,22,-30,-2,167,668,1091,804,29
-4,-1,0,-4.0,-1.0,0.712881326675415,12.019223662515376,22,-26,-1,167,668,1091,804,29
-4,0,0,-4.0,-0.0,0.720919132232666,8.022715545545239,22,-22,-1,167,668,1091,804,29
-3,-1,0,-3.0,-1.0,0.7288691997528076,5.0,22,-19,0,167,668,1091,804,29
-2,0,0,-2.0,-0.0,0.7368512153625488,3.0,22,-17,0,167,668,1091,804,29
-2,-1,0,-2.0,-1.0,0.7448742389678955,1.033296378372908,22,-15,1,167,668,1091,804,29
-2,0,0,-2.0,-0.0,0.7528603076934814,-0.9615951895947017,22,-13,1,167,668,1091,804,29
-1,0,0,-1.0,-0.0,0.7608292102813721,-1.9584054212077042,22,-12,1,167,668,1091,804,29
0,0,1,-0.0,-0.0,0.803767204284668,-1.9584054212077042,22,-12,1,167,668,1091,804,29
0,-1,1,-0.0,-1.0,0.05111360549926758,803.3201558718025,23,647,-514,826,152,179,667,46
0,0,0,-0.0,-0.0,0.08213663101196289,803.3201558718025,23,647,-514,826,152,179,667,46
1,0,0,1.0,-0.0,0.1311194896697998,802.5374007275503,23,646,-514,826,152,179,667,46
3,0,0,3.0,-0.0,0.13904261589050293,800.1919581725759,23,643,-514,826,152,179,667,46
3,0,0,3.0,-0.0,0.1470015048980713,797.8507781564199,23,640,-514,826,152,179,667,46
3,0,0,3.0,-0.0,0.15503644943237305,795.5138972552635,23,637,-514,826,152,179,667,46
5,-1,0,5.0,-1.0,0.16315960884094238,790.9981572460714,23,632,-513,826,152,179,667,46
6,0,0,6.0,-0.0,0.17131853103637695,786.3485034272936,23,626,-513,826,152,179,667,46
7,-2,0,7.0,-2.0,0.1790635585784912,779.6717884664939,23,619,-511,826,152,179,667,46
10,-3,0,10.0,-3.0,0.1871175765991211,770.0605273243651,23,609,-508,826,152,179,667,46
13,-4,0,13.0,-4.0,0.19522356986999512,757.5331511217189,23,596,-504,826,152,179,667,46
17,-7,0,17.0,-7.0,0.20304656028747559,740.0530781013861,23,579,-497,826,152,179,667,46
21,-10,0,21.0,-10.0,0.21102452278137207,717.6301371129857,23,558,-487,826,152,179,667,46
22,-15,0,22.0,-15.0,0.21907758712768555,691.1988518613006,23,536,-472,826,152,179,667,46
25,-15,0,25.0,-15.0,0.22704267501831055,662.5435799422237,23,511,-457,826,152,179,667,46
25,-15,0,25.0,-15.0,0.2350785732269287,633.9322643926084,23,486,-442,826,152,179,667,46
24,-15,0,24.0,-15.0,0.24311447143554688,606.1049197073569,23,462,-427,826,152,179,667,46
25,-18,0,25.0,-18.0,0.2511265277862549,575.5398900658167,23,437,-409,826,152,179,667,46
23,-20,0,23.0,-20.0,0.25908565521240234,545.0818602983201,23,414,-389,826,152,179,667,46
22,-20,0,22.0,-20.0,0.26708245277404785,515.3539727725616,23,392,-369,826,152,179,667,46
21,-21,0,21.0,-21.0,0.2750895023345947,485.6698339787804,23,371,-348,826,152,179,667,46
19,-19,0,19.0,-19.0,0.2833375930786133,458.814279572534,23,352,-329,826,152,179,667,46
15,-18,0,15.0,-18.0,0.29096460342407227,435.5738762729512,23,337,-311,826,152,179,667,46
15,-19,0,15.0,-19.0,0.2991034984588623,411.6814925896892,23,322,-292,826,152,179,667,46
16,-20,0,16.0,-20.0,0.30714845657348633,386.41421567893804,23,306,-272,826,152,179,667,46
15,-20,0,15.0,-20.0,0.3150665760040283,361.94804844290354,23,291,-252,826,152,179,667,46
15,-19,0,15.0,-19.0,0.32312655448913574,338.19939091864484,23,276,-233,826,152,179,667,46
16,-18,0,16.0,-18.0,0.3311145305633545,314.37960815674677,23,260,-215,826,152,179,667,46
14,-15,0,14.0,-15.0,0.33902764320373535,294.04258389055565,23,246,-200,826,152,179,667,46
14,-13,0,14.0,-13.0,0.3470945358276367,274.9815430525857,23,232,-187,826,152,179,667,46
12,-11,0,12.0,-11.0,0.35507965087890625,258.73746644704534,23,220,-176,826,152,179,667,46
11,-10,0,11.0,-10.0,0.3631105422973633,243.9026039588224,23,209,-166,826,152,179,667,46
11,-11,0,11.0,-11.0,0.3710365295410156,228.45377308761942,23,198,-155,826,152,179,667,46
10,-9,0,10.0,-9.0,0.3792076110839844,215.03361107205006,23,188,-146,826,152,179,667,46
9,-9,0,9.0,-9.0,0.38715052604675293,202.41073621280776,23,179,-137,826,152,179,667,46
8,-8,0,8.0,-8.0,0.39510464668273926,191.2008403344861,23,171,-129,826,152,179,667,46
9,-7,0,9.0,-7.0,0.40313148498535156,179.8003944769339,23,162,-122,826,152,179,667,46
6,-6,0,6.0,-6.0,0.4111356735229492,171.40164608356588,23,156,-116,826,152,179,667,46
5,-5,0,5.0,-5.0,0.4190065860748291,164.40864441108366,23,151,-111,826,152,179,667,46
4,-3,0,4.0,-3.0,0.426999568939209,159.40888136272312,23,147,-108,826,152,179,667,46
3,-3,0,3.0,-3.0,0.43498945236206055,155.21616088334974,23,144,-105,826,152,179,667,46
3,-2,0,3.0,-2.0,0.4431126117706299,151.61385970191483,23,141,-103,826,152,179,667,46
3,-2,0,3.0,-2.0,0.4510986804962158,148.011695506477,23,138,-101,826,152,179,667,46
3,-2,0,3.0,-2.0,0.45910048484802246,144.40967713964446,23,135,-99,826,152,179,667,46
3,-2,0,3.0,-2.0,0.46712565422058105,140.8078142214223,23,132,-97,826,152,179,667,46
2,-1,0,2.0,-1.0,0.4750845432281494,138.60445538412608,23,130,-96,826,152,179,667,46
0,-1,0,-0.0,-1.0,0.4830615520477295,138.01242188104618,23,130,-95,826,152,179,667,46
2,-1,0,2.0,-1.0,0.49101948738098145,135.80806024884254,23,128,-94,826,152,179,667,46
1,0,0,1.0,-0.0,0.4990675449371338,135.00316452527144,23,127,-94,826,152,179,667,46
1,-1,0,1.0,-1.0,0.5071415901184082,133.60459763365824,23,126,-93,826,152,179,667,46
1,0,0,1.0,-0.0,0.5149505138397217,132.80115532305913,23,125,-93,826,152,179,667,46
1,-1,0,1.0,-1.0,0.5232095718383789,131.40207252495026,23,124,-92,826,152,179,667,46
3,-1,0,3.0,-1.0,0.5310945510864258,128.40013210033868,23,121,-91,826,152,179,667,46
3,-2,0,3.0,-2.0,0.539069652557373,124.80054127099805,23,118,-89,826,152,179,667,46
4,-1,0,4.0,-1.0,0.5471124649047852,121.01388821915754,23,114,-88,826,152,179,667,46
5,-3,0,5.0,-3.0,0.5550656318664551,115.2244551445221,23,109,-85,826,152,179,667,46
6,-2,0,6.0,-2.0,0.5630195140838623,109.2800060477773,23,103,-83,826,152,179,667,46
5,-3,0,5.0,-3.0,0.5710475444793701,103.50691680694776,23,98,-80,826,152,179,667,46
6,-3,0,6.0,-3.0,0.5790846347808838,96.97082978791136,23,92,-77,826,152,179,667,46
5,-4,0,5.0,-4.0,0.5870475769042969,90.56936206565572,23,87,-73,826,152,179,667,46
6,-4,0,6.0,-4.0,0.5951306819915771,83.4048871058092,23,81,-69,826,152,179,667,46
5,-4,0,5.0,-4.0,0.6032304763793945,77.00499987500625,23,76,-65,826,152,179,667,46
5,-4,0,5.0,-4.0,0.6111764907836914,70.60555539069249,23,71,-61,826,152,179,667,46
4,-3,0,4.0,-3.0,0.6191136837005615,65.61715409558128,23,67,-58,826,152,179,667,46
3,-3,0,3.0,-3.0,0.6270995140075684,61.38601779915912,23,64,-55,826,152,179,667,46
3,-4,0,3.0,-4.0,0.6351146697998047,56.51100552753688,23,61,-51,826,152,179,667,46
3,-3,0,3.0,-3.0,0.643000602722168,52.28612089887484,23,58,-48,826,152,179,667,46
3,-3,0,3.0,-3.0,0.651038646697998,48.06335201775947,23,55,-45,826,152,179,667,46
3,-3,0,3.0,-3.0,0.6591296195983887,43.84309986827361,23,52,-42,826,152,179,667,46
3,-4,0,3.0,-4.0,0.6670894622802734,39.00806399170998,23,49,-38,826,152,179,667,46
3,-3,0,3.0,-3.0,0.6751794815063477,34.8013840664737,23,46,-35,826,152,179,667,46
3,-3,0,3.0,-3.0,0.6831016540527344,30.600373133029585,23,43,-32,826,152,179,667,46
3,-2,0,3.0,-2.0,0.6911735534667969,27.0,23,40,-30,826,152,179,667,46
2,-3,0,2.0,-3.0,0.6990976333618164,23.61544808322666,23,38,-27,826,152,179,667,46
2,-2,0,2.0,-2.0,0.7071244716644287,20.829214001622255,23,36,-25,826,152,179,667,46
3,-3,0,3.0,-3.0,0.7150416374206543,16.66106403010388,23,33,-22,826,152,179,667,46
3,-4,0,3.0,-4.0,0.7231605052947998,11.985711369071801,23,30,-18,826,152,179,667,46
3,-3,0,3.0,-3.0,0.731109619140625,7.886890422961002,23,27,-15,826,152,179,667,46
3,-4,0,3.0,-4.0,0.7392284870147705,3.4007575648881705,23,24,-11,826,152,179,667,46
3,-4,0,3.0,-4.0,0.7470455169677734,-0.8640563788213456,23,21,-7,826,152,179,667,46
2,-3,0,2.0,-3.0,0.7551524639129639,-3.5835121610524006,23,19,-4,826,152,179,667,46
2,-2,0,2.0,-2.0,0.7631025314331055,-5.88275723137631,23,17,-2,826,152,179,667,46
1,-2,0,1.0,-2.0,0.7710115909576416,-7.0,23,16,0,826,152,179,667,46
1,-1,0,1.0,-1.0,0.7789914608001709,-7.966703621627092,23,15,1,826,152,179,667,46
1,-1,0,1.0,-1.0,0.7869796752929688,-8.857864376269049,23,14,2,826,152,179,667,46
1,0,0,1.0,-0.0,0.795020580291748,-9.847053562034095,23,13,2,826,152,179,667,46
0,0,1,-0.0,-0.0,0.8019835948944092,-9.847053562034095,23,13,2,826,152,179,667,46
0,0,0,-0.0,-0.0,0.08637404441833496,98.23088063270491,24,-103,26,710,176,813,150,17
-1,0,0,-1.0,-0.0,0.1727900505065918,97.26157893552613,24,-102,26,710,176,813,150,17
-2,0,0,-2.0,-0.0,0.18043923377990723,95.32473082471591,24,-100,26,710,176,813,150,17
-3,0,0,-3.0,-0.0,0.1884150505065918,92.42410069301094,24,-97,26,710,176,813,150,17
-4,3,0,-4.0,3.0,0.196364164352417,87.80187889597991,24,-93,23,710,176,813,150,17
-6,5,0,-6.0,5.0,0.20442724227905273,80.84255736976509,24,-87,18,710,176,813,150,17
-7,7,0,-7.0,7.0,0.21249008178710938,72.75270893288967,24,-80,11,710,176,813,150,17
-9,11,0,-9.0,11.0,0.2204742431640625,63.0,24,-71,0,710,176,813,150,17
-7,9,0,-7.0,9.0,0.22857117652893066,56.6297145282261,24,-64,-9,710,176,813,150,17
-6,8,0,-6.0,8.0,0.23650002479553223,52.440052945046304,24,-58,-17,710,176,813,150,17
-4,5,0,-4.0,5.0,0.24447417259216309,50.309518948453004,24,-54,-22,710,176,813,150,17
-2,3,0,-2.0,3.0,0.25249505043029785,49.697486947006624,24,-52,-25,710,176,813,150,17
-1,0,0,-1.0,-0.0,0.26053905487060547,48.79788728465171,24,-51,-25,710,176,813,150,17
-1,0,0,-1.0,-0.0,0.2926051616668701,47.90169943749474,24,-50,-25,710,176,813,150,17
-3,0,0,-3.0,-0.0,0.3005220890045166,45.23532661682466,24,-47,-25,710,176,813,150,17
-3,0,0,-3.0,-0.0,0.30858302116394043,42.60632371551998,24,-44,-25,710,176,813,150,17
-3,0,0,-3.0,-0.0,0.31638622283935547,40.02082881417188,24,-41,-25,710,176,813,150,17
-2,0,0,-2.0,-0.0,0.32441210746765137,38.32493928760188,24,-39,-25,710,176,813,150,17
-2,0,0,-2.0,-0.0,0.33257222175598145,36.654227123532216,24,-37,-25,710,176,813,150,17
-2,0,0,-2.0,-0.0,0.34049105644226074,35.01162633521314,24,-35,-25,710,176,813,150,17
-3,0,0,-3.0,-0.0,0.34873008728027344,32.607881008493905,24,-32,-25,710,176,813,150,17
-2,0,0,-2.0,-0.0,0.35650205612182617,31.05124837953327,24,-30,-25,710,176,813,150,17
-3,-1,0,-3.0,-1.0,0.3644230365753174,28.124783736376884,24,-27,-24,710,176,813,150,17
-1,0,0,-1.0,-0.0,0.37256813049316406,27.383612025908263,24,-26,-24,710,176,813,150,17
-2,0,0,-2.0,-0.0,0.38051509857177734,25.941125496954278,24,-24,-24,710,176,813,150,17
0,-1,0,-0.0,-1.0,0.3885931968688965,25.241540277189323,24,-24,-23,710,176,813,150,17
-1,0,0,-1.0,-0.0,0.3964660167694092,24.526911934581186,24,-23,-23,710,176,813,150,17
-2,0,0,-2.0,-0.0,0.404508113861084,23.144823004794873,24,-21,-23,710,176,813,150,17
-2,-1,0,-2.0,-1.0,0.41239023208618164,21.068883707497267,24,-19,-22,710,176,813,150,17
-2,0,0,-2.0,-0.0,0.4205620288848877,19.80287754891569,24,-17,-22,710,176,813,150,17
-2,-1,0,-2.0,-1.0,0.42855119705200195,17.80697580112788,24,-15,-21,710,176,813,150,17
-1,-1,0,-1.0,-1.0,0.4364960193634033,16.413111231467404,24,-14,-20,710,176,813,150,17
-2,-1,0,-2.0,-1.0,0.44451117515563965,14.472205054244231,24,-12,-19,710,176,813,150,17
-2,-2,0,-2.0,-2.0,0.45266008377075195,11.72308292331602,24,-10,-17,710,176,813,150,17
-2,-2,0,-2.0,-2.0,0.4604611396789551,9.0,24,-8,-15,710,176,813,150,17
-1,-1,0,-1.0,-1.0,0.468372106552124,7.652475842498529,24,-7,-14,710,176,813,150,17
-1,-1,0,-1.0,-1.0,0.4763820171356201,6.317821063276353,24,-6,-13,710,176,813,150,17
0,-1,0,-0.0,-1.0,0.4845390319824219,5.416407864998739,24,-6,-12,710,176,813,150,17
0,-1,0,-0.0,-1.0,0.49252915382385254,4.529964086141668,24,-6,-11,710,176,813,150,17
0,0,1,-0.0,-0.0,0.5565030574798584,4.529964086141668,24,-6,-11,710,176,813,150,17
0,-1,1,-0.0,-1.0,0.0037026405334472656,1188.5379860012824,25,1139,360,1855,546,716,187,13
0,0,0,-0.0,-0.0,0.08959460258483887,1188.5379860012824,25,1139,360,1855,546,716,187,13
0,1,0,-0.0,1.0,0.17178058624267578,1188.2369949051151,25,1139,359,1855,546,716,187,13
2,3,0,2.0,3.0,0.17963361740112305,1185.4298132915762,25,1137,356,1855,546,716,187,13
3,4,0,3.0,4.0,0.18762850761413574,1181.3752566059309,25,1134,352,1855,546,716,187,13
5,5,0,5.0,5.0,0.19565153121948242,1175.1223475999427,25,1129,347,1855,546,716,187,13
6,6,0,6.0,6.0,0.20371556282043457,1167.6311175152098,25,1123,341,1855,546,716,187,13
7,8,0,7.0,8.0,0.21169161796569824,1158.6222563561114,25,1116,333,1855,546,716,187,13
10,8,0,10.0,8.0,0.21966958045959473,1146.7623345685788,25,1106,325,1855,546,716,187,13
12,9,0,12.0,9.0,0.22769951820373535,1132.7238471200997,25,1094,316,1855,546,716,187,13
18,11,0,18.0,11.0,0.23563051223754883,1112.3921494717315,25,1076,305,1855,546,716,187,13
24,13,0,24.0,13.0,0.24367260932922363,1085.7728701520293,25,1052,292,1855,546,716,187,13
31,12,0,31.0,12.0,0.2516155242919922,1052.6977850170463,25,1021,280,1855,546,716,187,13
35,12,0,35.0,12.0,0.2597174644470215,1015.7729689123705,25,986,268,1855,546,716,187,13
38,11,0,38.0,11.0,0.26773953437805176,976.2184074837938,25,948,257,1855,546,716,187,13
37,10,0,37.0,10.0,0.27570343017578125,937.8908835241498,25,911,247,1855,546,716,187,13
35,8,0,35.0,8.0,0.28365445137023926,902.0181716243349,25,876,239,1855,546,716,187,13
36,7,0,36.0,7.0,0.29169559478759766,865.4493674333581,25,840,232,1855,546,716,187,13
36,7,0,36.0,7.0,0.2996084690093994,828.8898130891286,25,804,225,1855,546,716,187,13
34,6,0,34.0,6.0,0.30761146545410156,794.5379441350672,25,770,219,1855,546,716,187,13
32,6,0,32.0,6.0,0.3156094551086426,762.1230370194609,25,738,213,1855,546,716,187,13
32,6,0,32.0,6.0,0.32361650466918945,729.7207350618847,25,706,207,1855,546,716,187,13
31,6,0,31.0,6.0,0.3316824436187744,698.2911329840807,25,675,201,1855,546,716,187,13
33,6,0,33.0,6.0,0.3397674560546875,664.9612507440352,25,642,195,1855,546,716,187,13
33,5,0,33.0,5.0,0.34773945808410645,631.9506250486788,25,609,190,1855,546,716,187,13
32,5,0,32.0,5.0,0.35568952560424805,599.9323394571377,25,577,185,1855,546,716,187,13
33,4,0,33.0,4.0,0.36368441581726074,567.3210269997081,25,544,181,1855,546,716,187,13
31,3,0,31.0,3.0,0.3718605041503906,537.0036832287605,25,513,178,1855,546,716,187,13
31,4,0,31.0,4.0,0.3797166347503662,506.44511901275825,25,482,174,1855,546,716,187,13
30,3,0,30.0,3.0,0.3876175880432129,477.26493768946244,25,452,171,1855,546,716,187,13
27,3,0,27.0,3.0,0.39570045471191406,451.0,25,425,168,1855,546,716,187,13
24,3,0,24.0,3.0,0.40364551544189453,427.61964900128777,25,401,165,1855,546,716,187,13
19,3,0,19.0,3.0,0.4117004871368408,408.9313196180785,25,382,162,1855,546,716,187,13
19,3,0,19.0,3.0,0.4196815490722656,390.2953444086872,25,363,159,1855,546,716,187,13
17,3,0,17.0,3.0,0.4276845455169678,373.54182905181875,25,346,156,1855,546,716,187,13
16,3,0,16.0,3.0,0.43569159507751465,357.7430411705494,25,330,153,1855,546,716,187,13
15,3,0,15.0,3.0,0.4435994625091553,342.89110048839024,25,315,150,1855,546,716,187,13
12,4,0,12.0,4.0,0.45160460472106934,330.34060117684277,25,303,146,1855,546,716,187,13
12,3,0,12.0,3.0,0.45971155166625977,318.237567225021,25,291,143,1855,546,716,187,13
9,2,0,9.0,2.0,0.4676206111907959,309.28558482747036,25,282,141,1855,546,716,187,13
6,3,0,6.0,3.0,0.47578954696655273,302.577380894971,25,276,138,1855,546,716,187,13
4,2,0,4.0,2.0,0.483689546585083,298.1052449399714,25,272,136,1855,546,716,187,13
4,1,0,4.0,1.0,0.4917025566101074,294.08165555395084,25,268,135,1855,546,716,187,13
4,3,0,4.0,3.0,0.4996964931488037,289.16097302997224,25,264,132,1855,546,716,187,13
2,3,0,2.0,3.0,0.5076944828033447,286.0359566902678,25,262,129,1855,546,716,187,13
4,3,0,4.0,3.0,0.515709638595581,281.12366673612956,25,258,126,1855,546,716,187,13
3,4,0,3.0,4.0,0.5235564708709717,276.68179990936807,25,255,122,1855,546,716,187,13
4,5,0,4.0,5.0,0.5316765308380127,270.92959394040935,25,251,117,1855,546,716,187,13
3,4,0,3.0,4.0,0.5397195816040039,266.5307322119838,25,248,113,1855,546,716,187,13
4,5,0,4.0,5.0,0.5476596355438232,260.8332812825267,25,244,108,1855,546,716,187,13
6,6,0,6.0,6.0,0.5557324886322021,252.93628559937287,25,238,102,1855,546,716,187,13
5,4,0,5.0,4.0,0.5637655258178711,246.77064703006954,25,233,98,1855,546,716,187,13
5,5,0,5.0,5.0,0.571596622467041,240.2376900476448,25,228,93,1855,546,716,187,13
5,5,0,5.0,5.0,0.5797755718231201,233.7352706632881,25,223,88,1855,546,716,187,13
6,4,0,6.0,4.0,0.5876345634460449,226.69078194032525,25,217,84,1855,546,716,187,13
6,5,0,6.0,5.0,0.5956315994262695,219.30423875284725,25,211,79,1855,546,716,187,13
7,4,0,7.0,4.0,0.6036195755004883,211.34994824015948,25,204,75,1855,546,716,187,13
6,6,0,6.0,6.0,0.611661434173584,203.67832506007863,25,198,69,1855,546,716,187,13
7,4,0,7.0,4.0,0.6195735931396484,195.75727991822254,25,191,65,1855,546,716,187,13
7,5,0,7.0,5.0,0.6277215480804443,187.5355264544471,25,184,60,1855,546,716,187,13
7,4,0,7.0,4.0,0.635697603225708,179.64751546950473,25,177,56,1855,546,716,187,13
7,5,0,7.0,5.0,0.6437125205993652,171.48521065147935,25,170,51,1855,546,716,187,13
8,4,0,8.0,4.0,0.6517815589904785,162.6801707374047,25,162,47,1855,546,716,187,13
7,4,0,7.0,4.0,0.6598005294799805,154.85397104206038,25,155,43,1855,546,716,187,13
9,4,0,9.0,4.0,0.6679704189300537,145.11915828246265,25,146,39,1855,546,716,187,13
10,4,0,10.0,4.0,0.675776481628418,134.4314779527724,25,136,35,1855,546,716,187,13
10,4,0,10.0,4.0,0.6837844848632812,123.75746606650424,25,126,31,1855,546,716,187,13
10,4,0,10.0,4.0,0.6916844844818115,113.10079764636339,25,116,27,1855,546,716,187,13
9,3,0,9.0,3.0,0.6996796131134033,103.65856099730654,25,107,24,1855,546,716,187,13
8,3,0,8.0,3.0,0.7077145576477051,95.20276676059801,25,99,21,1855,546,716,187,13
7,3,0,7.0,3.0,0.7157125473022461,87.74433316206373,25,92,18,1855,546,716,187,13
6,2,0,6.0,2.0,0.723780632019043,81.47571091451616,25,86,16,1855,546,716,187,13
5,2,0,5.0,2.0,0.7317304611206055,76.20097323024831,25,81,14,1855,546,716,187,13
4,1,0,4.0,1.0,0.7396855354309082,72.08969202141856,25,77,13,1855,546,716,187,13
5,2,0,5.0,2.0,0.7476105690002441,66.83543093852057,25,72,11,1855,546,716,187,13
4,1,0,4.0,1.0,0.7557106018066406,62.731361109758325,25,68,10,1855,546,716,187,13
5,1,0,5.0,1.0,0.763683557510376,57.63961030678928,25,63,9,1855,546,716,187,13
4,2,0,4.0,2.0,0.7717854976654053,53.413803110051795,25,59,7,1855,546,716,187,13
3,1,0,3.0,1.0,0.7796685695648193,50.32051136131489,25,56,6,1855,546,716,187,13
3,1,0,3.0,1.0,0.7878785133361816,47.23532661682466,25,53,5,1855,546,716,187,13
3,0,0,3.0,-0.0,0.7956995964050293,44.24937810560445,25,50,5,1855,546,716,187,13
3,2,0,3.0,2.0,0.8037934303283691,41.095647357266465,25,47,3,1855,546,716,187,13
3,2,0,3.0,2.0,0.811598539352417,38.01136216933077,25,44,1,1855,546,716,187,13
3,2,0,3.0,2.0,0.8197755813598633,35.012193308819754,25,41,-1,1855,546,716,187,13
2,1,0,2.0,1.0,0.827716588973999,33.05124837953327,25,39,-2,1855,546,716,187,13
1,1,0,1.0,1.0,0.8356385231018066,32.118237105091836,25,38,-3,1855,546,716,187,13
3,0,0,3.0,-0.0,0.8436446189880371,29.128336140500593,25,35,-3,1855,546,716,187,13
1,1,0,1.0,1.0,0.8516654968261719,28.23448553724738,25,34,-4,1855,546,716,187,13
2,0,0,2.0,-0.0,0.8597574234008789,26.249030993194197,25,32,-4,1855,546,716,187,13
1,1,0,1.0,1.0,0.8678436279296875,25.400636936215164,25,31,-5,1855,546,716,187,13
3,0,0,3.0,-0.0,0.8757045269012451,22.442925306655784,25,28,-5,1855,546,716,187,13
1,1,0,1.0,1.0,0.8835804462432861,21.65863337187866,25,27,-6,1855,546,716,187,13
1,0,0,1.0,-0.0,0.8916666507720947,20.68332812825267,25,26,-6,1855,546,716,187,13
2,0,0,2.0,-0.0,0.8997325897216797,18.73863375370596,25,24,-6,1855,546,716,187,13
1,1,0,1.0,1.0,0.9077496528625488,18.041630560342615,25,23,-7,1855,546,716,187,13
1,0,0,1.0,-0.0,0.915818452835083,17.08679276123039,25,22,-7,1855,546,716,187,13
1,0,0,1.0,-0.0,0.9237246513366699,16.135943621178654,25,21,-7,1855,546,716,187,13
0,1,0,-0.0,1.0,0.931748628616333,16.47220505424423,25,21,-8,1855,546,716,187,13
1,0,0,1.0,-0.0,0.939720630645752,15.540659228538015,25,20,-8,1855,546,716,187,13
1,0,0,1.0,-0.0,0.9476385116577148,14.615528128088304,25,19,-8,1855,546,716,187,13
1,1,0,1.0,1.0,0.956120491027832,14.124611797498108,25,18,-9,1855,546,716,187,13
1,0,0,1.0,-0.0,0.9635515213012695,13.235384061671343,25,17,-9,1855,546,716,187,13
2,0,0,2.0,-0.0,0.9718074798583984,11.4928556845359,25,15,-9,1855,546,716,187,13
1,0,0,1.0,-0.0,0.9797606468200684,10.643316977093239,25,14,-9,1855,546,716,187,13
2,0,0,2.0,-0.0,0.987682580947876,9.0,25,12,-9,1855,546,716,187,13
1,0,0,1.0,-0.0,1.0038676261901855,8.212670403551895,25,11,-9,1855,546,716,187,13
1,0,0,1.0,-0.0,1.0118045806884766,7.45362404707371,25,10,-9,1855,546,716,187,13
1,0,0,1.0,-0.0,1.0197224617004395,6.727922061357855,25,9,-9,1855,546,716,187,13
1,0,0,1.0,-0.0,1.028275489807129,6.041594578792296,25,8,-9,1855,546,716,187,13
1,0,0,1.0,-0.0,1.0356075763702393,5.401754250991379,25,7,-9,1855,546,716,187,13
1,0,0,1.0,-0.0,1.0435805320739746,4.816653826391969,25,6,-9,1855,546,716,187,13
1,0,0,1.0,-0.0,1.0597455501556396,4.295630140987001,25,5,-9,1855,546,716,187,13
1,0,0,1.0,-0.0,1.0677814483642578,3.848857801796104,25,4,-9,1855,546,716,187,13
1,0,0,1.0,-0.0,1.0757346153259277,3.486832980505138,25,3,-9,1855,546,716,187,13
0,-1,0,-0.0,-1.0,1.0836944580078125,2.5440037453175304,25,3,-8,1855,546,716,187,13
1,0,0,1.0,-0.0,1.0917105674743652,2.246211251235321,25,2,-8,1855,546,716,187,13
1,0,0,1.0,-0.0,1.099604606628418,2.062257748298549,25,1,-8,1855,546,716,187,13
1,-2,0,1.0,-2.0,1.1076934337615967,0.0,25,0,-6,1855,546,716,187,13
1,0,0,1.0,-0.0,1.1156604290008545,0.08276253029821934,25,-1,-6,1855,546,716,187,13
1,-2,0,1.0,-2.0,1.1236155033111572,-1.5278640450004204,25,-2,-4,1855,546,716,187,13
1,-2,0,1.0,-2.0,1.1318166255950928,-2.394448724536011,25,-3,-2,1855,546,716,187,13
1,-2,0,1.0,-2.0,1.1396656036376953,-2.0,25,-4,0,1855,546,716,187,13
0,-3,0,-0.0,-3.0,1.1476266384124756,-1.0,25,-4,3,1855,546,716,187,13
0,0,1,-0.0,-0.0,1.152557611465454,-1.0,25,-4,3,1855,546,716,187,13
1,-1,1,1.0,-1.0,-0.00023484230041503906,465.22722057657535,26,-405,-285,1455,257,1859,543,60
0,-1,1,-0.0,-1.0,0.007764101028442383,464.65240320855617,26,-405,-284,1455,257,1859,543,60
0,0,0,-0.0,-0.0,0.1276991367340088,464.65240320855617,26,-405,-284,1455,257,1859,543,60
-2,0,0,-2.0,-0.0,0.15968608856201172,463.0162269134759,26,-403,-284,1455,257,1859,543,60
-2,0,0,-2.0,-0.0,0.16771316528320312,461.382742879723,26,-401,-284,1455,257,1859,543,60
-4,-1,0,-4.0,-1.0,0.17568731307983398,457.54281863237406,26,-397,-283,1455,257,1859,543,60
-7,-1,0,-7.0,-1.0,0.1838521957397461,451.27331112373145,26,-390,-282,1455,257,1859,543,60
-10,-3,0,-10.0,-3.0,0.19190526008605957,441.4244372113096,26,-380,-279,1455,257,1859,543,60
-11,-2,0,-11.0,-2.0,0.19974613189697266,431.4000433463352,26,-369,-277,1455,257,1859,543,60
-10,-2,0,-10.0,-2.0,0.20773029327392578,422.2233961218725,26,-359,-275,1455,257,1859,543,60
-10,-4,0,-10.0,-4.0,0.21573424339294434,411.86196939768416,26,-349,-271,1455,257,1859,543,60
-10,-4,0,-10.0,-4.0,0.22378826141357422,401.52056729662377,26,-339,-267,1455,257,1859,543,60
-11,-7,0,-11.0,-7.0,0.23167014122009277,388.54987755344047,26,-328,-260,1455,257,1859,543,60
-11,-7,0,-11.0,-7.0,0.23968911170959473,375.58353023760714,26,-317,-253,1455,257,1859,543,60
-11,-8,0,-11.0,-8.0,0.24771809577941895,361.9961734507111,26,-306,-245,1455,257,1859,543,60
-11,-8,0,-11.0,-8.0,0.255629301071167,348.4098307391075,26,-295,-237,1455,257,1859,543,60
-12,-11,0,-12.0,-11.0,0.263599157333374,332.1670885102621,26,-283,-226,1455,257,1859,543,60
-13,-13,0,-13.0,-13.0,0.27168917655944824,313.9026024908797,26,-270,-213,1455,257,1859,543,60
-13,-12,0,-13.0,-12.0,0.279691219329834,296.266762021509,26,-257,-201,1455,257,1859,543,60
-13,-12,0,-13.0,-12.0,0.28771114349365234,278.6373276193273,26,-244,-189,1455,257,1859,543,60
-13,-11,0,-13.0,-11.0,0.29564523696899414,261.62475889402805,26,-231,-178,1455,257,1859,543,60
-14,-12,0,-14.0,-12.0,0.30384111404418945,243.21237160860778,26,-217,-166,1455,257,1859,543,60
-14,-13,0,-14.0,-13.0,0.31165528297424316,224.200708102869,26,-203,-153,1455,257,1859,543,60
-13,-13,0,-13.0,-13.0,0.31964612007141113,206.00847442411893,26,-190,-140,1455,257,1859,543,60
-14,-12,0,-14.0,-12.0,0.3275883197784424,187.6235281397671,26,-176,-128,1455,257,1859,543,60
-13,-12,0,-13.0,-12.0,0.33576512336730957,170.06249023742558,26,-163,-116,1455,257,1859,543,60
-11,-10,0,-11.0,-10.0,0.3437931537628174,155.31055015837603,26,-152,-106,1455,257,1859,543,60
-9,-10,0,-9.0,-10.0,0.35184812545776367,142.23530416264836,26,-143,-96,1455,257,1859,543,60
-9,-9,0,-9.0,-9.0,0.36045312881469727,129.76545308670458,26,-134,-87,1455,257,1859,543,60
-6,-8,0,-6.0,-8.0,0.3677031993865967,120.41608956491322,26,-128,-79,1455,257,1859,543,60
-7,-8,0,-7.0,-8.0,0.3757481575012207,110.29255147726127,26,-121,-71,1455,257,1859,543,60
-7,-8,0,-7.0,-8.0,0.38377809524536133,100.24976007655445,26,-114,-63,1455,257,1859,543,60
-6,-7,0,-6.0,-7.0,0.3917052745819092,91.6552506059644,26,-108,-56,1455,257,1859,543,60
-8,-7,0,-8.0,-7.0,0.3998262882232666,81.35977729862789,26,-100,-49,1455,257,1859,543,60
-7,-7,0,-7.0,-7.0,0.40774011611938477,72.04410811016969,26,-93,-42,1455,257,1859,543,60
-7,-5,0,-7.0,-5.0,0.41562628746032715,63.62157870918435,26,-86,-37,1455,257,1859,543,60
-7,-4,0,-7.0,-4.0,0.4237942695617676,55.615419172015976,26,-79,-33,1455,257,1859,543,60
-8,-5,0,-8.0,-5.0,0.43175530433654785,46.321687612368734,26,-71,-28,1455,257,1859,543,60
-7,-4,0,-7.0,-4.0,0.43976712226867676,38.35202996254024,26,-64,-24,1455,257,1859,543,60
-7,-3,0,-7.0,-3.0,0.44760727882385254,30.74537019394976,26,-57,-21,1455,257,1859,543,60
-9,-4,0,-9.0,-4.0,0.45580124855041504,20.921508225896062,26,-48,-17,1455,257,1859,543,60
-7,-3,0,-7.0,-3.0,0.4636962413787842,13.324358044868937,26,-41,-14,1455,257,1859,543,60
-8,-3,0,-8.0,-3.0,0.4716923236846924,4.785054261852174,26,-33,-11,1455,257,1859,543,60
-6,-3,0,-6.0,-3.0,0.4797542095184326,-1.8397443193425538,26,-27,-8,1455,257,1859,543,60
-4,-1,0,-4.0,-1.0,0.48769116401672363,-5.958369439657385,26,-23,-7,1455,257,1859,543,60
-3,-1,0,-3.0,-1.0,0.49564218521118164,-9.119386982178899,26,-20,-6,1455,257,1859,543,60
-2,0,0,-2.0,-0.0,0.5037662982940674,-11.026334038989724,26,-18,-6,1455,257,1859,543,60
0,0,1,-0.0,-0.0,0.5467932224273682,-11.026334038989724,26,-18,-6,1455,257,1859,543,60
0,0,0,-0.0,-0.0,0.07415175437927246,1305.8658378178284,27,-1333,114,140,377,1473,263,65
-1,0,0,-1.0,-0.0,0.15627360343933105,1304.869477548201,27,-1332,114,140,377,1473,263,65
-5,3,0,-5.0,3.0,0.16424775123596191,1299.6343341923864,27,-1327,111,140,377,1473,263,65
-10,6,0,-10.0,6.0,0.1722126007080078,1289.1790189069761,27,-1317,105,140,377,1473,263,65
-15,6,0,-15.0,6.0,0.18012666702270508,1273.7584003176084,27,-1302,99,140,377,1473,263,65
-20,7,0,-20.0,7.0,0.18826079368591309,1253.2968528709623,27,-1282,92,140,377,1473,263,65
-25,7,0,-25.0,7.0,0.19632458686828613,1227.8706282789515,27,-1257,85,140,377,1473,263,65
-33,7,0,-33.0,7.0,0.20429062843322754,1194.4827760714784,27,-1224,78,140,377,1473,263,65
-39,9,0,-39.0,9.0,0.2122337818145752,1155.0071608882567,27,-1185,69,140,377,1473,263,65
-46,8,0,-46.0,8.0,0.2202296257019043,1108.6322807986805,27,-1139,61,140,377,1473,263,65
-48,8,0,-48.0,8.0,0.2282707691192627,1060.2865924289283,27,-1091,53,140,377,1473,263,65
-53,7,0,-53.0,7.0,0.2362055778503418,1007.0187678766924,27,-1038,46,140,377,1473,263,65
-47,6,0,-47.0,6.0,0.2440958023071289,959.8069368581771,27,-991,40,140,377,1473,263,65
-47,4,0,-47.0,4.0,0.2522156238555908,912.6861912825867,27,-944,36,140,377,1473,263,65
-40,2,0,-40.0,2.0,0.26024770736694336,872.6391545804327,27,-904,34,140,377,1473,263,65
-36,0,0,-36.0,-0.0,0.2681705951690674,836.6656433864528,27,-868,34,140,377,1473,263,65
-34,-1,0,-34.0,-1.0,0.27611565589904785,802.7340893961382,27,-834,35,140,377,1473,263,65
-30,-1,0,-30.0,-1.0,0.2841036319732666,772.8055665811463,27,-804,36,140,377,1473,263,65
-28,-2,0,-28.0,-2.0,0.2921016216278076,744.9298552636525,27,-776,38,140,377,1473,263,65
-27,0,0,-27.0,-0.0,0.30016374588012695,717.9633324369933,27,-749,38,140,377,1473,263,65
-25,0,0,-25.0,-0.0,0.308241605758667,692.9965517159375,27,-724,38,140,377,1473,263,65
-25,0,0,-25.0,-0.0,0.31619763374328613,668.032142119203,27,-699,38,140,377,1473,263,65
-27,1,0,-27.0,1.0,0.32422375679016113,641.0178303730147,27,-672,37,140,377,1473,263,65
-27,1,0,-27.0,1.0,0.3322286605834961,614.0038699574485,27,-645,36,140,377,1473,263,65
-27,1,0,-27.0,1.0,0.3401145935058594,586.9903068707943,27,-618,35,140,377,1473,263,65
-29,2,0,-29.0,2.0,0.34817075729370117,557.9237238830118,27,-589,33,140,377,1473,263,65
-27,3,0,-27.0,3.0,0.35619068145751953,530.8001421463929,27,-562,30,140,377,1473,263,65
-26,4,0,-26.0,4.0,0.36429858207702637,504.63022650611106,27,-536,26,140,377,1473,263,65
-25,3,0,-25.0,3.0,0.3721787929534912,479.5173506343651,27,-511,23,140,377,1473,263,65
-23,4,0,-23.0,4.0,0.38028478622436523,456.3697369821353,27,-488,19,140,377,1473,263,65
-19,3,0,-19.0,3.0,0.38821864128112793,437.27284174560964,27,-469,16,140,377,1473,263,65
-19,3,0,-19.0,3.0,0.39624476432800293,418.18773861579126,27,-450,13,140,377,1473,263,65
-18,3,0,-18.0,3.0,0.40422677993774414,400.11572524035734,27,-432,10,140,377,1473,263,65
-18,2,0,-18.0,2.0,0.4122886657714844,382.07728747179556,27,-414,8,140,377,1473,263,65
-17,1,0,-17.0,1.0,0.42017173767089844,365.06170805052454,27,-397,7,140,377,1473,263,65
-16,2,0,-16.0,2.0,0.4282236099243164,349.03280698648507,27,-381,5,140,377,1473,263,65
-14,0,0,-14.0,-0.0,0.436248779296875,335.03405836516043,27,-367,5,140,377,1473,263,65
-13,1,0,-13.0,1.0,0.44416069984436035,322.02259814876226,27,-354,4,140,377,1473,263,65
-12,1,0,-12.0,1.0,0.45220375061035156,310.01315764163223,27,-342,3,140,377,1473,263,65
-11,1,0,-11.0,1.0,0.46026062965393066,299.0060422409235,27,-331,2,140,377,1473,263,65
-12,1,0,-12.0,1.0,0.46822261810302734,287.0015673942685,27,-319,1,140,377,1473,263,65
-14,2,0,-14.0,2.0,0.4762277603149414,273.00163933985664,27,-305,-1,140,377,1473,263,65
-16,1,0,-16.0,1.0,0.48421669006347656,257.0069203323685,27,-289,-2,140,377,1473,263,65
-17,1,0,-17.0,1.0,0.49219274520874023,240.01654361453825,27,-272,-3,140,377,1473,263,65
-16,1,0,-16.0,1.0,0.500159740447998,224.03124809288414,27,-256,-4,140,377,1473,263,65
-15,0,0,-15.0,-0.0,0.5083127021789551,209.03319273494262,27,-241,-4,140,377,1473,263,65
-14,1,0,-14.0,1.0,0.516258716583252,195.05505940189926,27,-227,-5,140,377,1473,263,65
-14,1,0,-14.0,1.0,0.5243327617645264,181.08449028495716,27,-213,-6,140,377,1473,263,65
-13,0,0,-13.0,-0.0,0.5321907997131348,168.08997975910736,27,-200,-6,140,377,1473,263,65
-13,1,0,-13.0,1.0,0.5402066707611084,155.13097017864254,27,-187,-7,140,377,1473,263,65
-11,0,0,-11.0,-0.0,0.5481867790222168,144.13914953808538,27,-176,-7,140,377,1473,263,65
-11,0,0,-11.0,-0.0,0.5562286376953125,133.14841809717706,27,-165,-7,140,377,1473,263,65
-10,0,0,-10.0,-0.0,0.5645236968994141,123.15798400340216,27,-155,-7,140,377,1473,263,65
-6,0,0,-6.0,-0.0,0.5722236633300781,117.16433890176299,27,-149,-7,140,377,1473,263,65
-6,0,0,-6.0,-0.0,0.5803036689758301,111.17122615944868,27,-143,-7,140,377,1473,263,65
-5,-1,0,-5.0,-1.0,0.5882117748260498,106.13037319865606,27,-138,-6,140,377,1473,263,65
-3,-1,0,-3.0,-1.0,0.596381664276123,103.09256086106296,27,-135,-5,140,377,1473,263,65
-5,-1,0,-5.0,-1.0,0.6041717529296875,98.06152390311286,27,-130,-4,140,377,1473,263,65
-3,0,0,-3.0,-0.0,0.6122376918792725,95.06297651164952,27,-127,-4,140,377,1473,263,65
-5,-1,0,-5.0,-1.0,0.6202597618103027,90.03687967167957,27,-122,-3,140,377,1473,263,65
-4,-1,0,-4.0,-1.0,0.6283116340637207,86.01694793545543,27,-118,-2,140,377,1473,263,65
-4,-1,0,-4.0,-1.0,0.6362237930297852,82.00438588054409,27,-114,-1,140,377,1473,263,65
-3,-1,0,-3.0,-1.0,0.6442286968231201,79.0,27,-111,0,140,377,1473,263,65
-4,-1,0,-4.0,-1.0,0.6522805690765381,75.00467279516349,27,-107,1,140,377,1473,263,65
-6,0,0,-6.0,-0.0,0.6602327823638916,69.00495037373169,27,-101,1,140,377,1473,263,65
-5,-1,0,-5.0,-1.0,0.6682467460632324,64.02083107326243,27,-96,2,140,377,1473,263,65
-7,-1,0,-7.0,-1.0,0.6762797832489014,57.05054744357274,27,-89,3,140,377,1473,263,65
-6,0,0,-6.0,-0.0,0.6842257976531982,51.05419917138447,27,-83,3,140,377,1473,263,65
-7,-1,0,-7.0,-1.0,0.6922686100006104,44.105190361761785,27,-76,4,140,377,1473,263,65
-5,0,0,-5.0,-0.0,0.700218677520752,39.11258679024411,27,-71,4,140,377,1473,263,65
-6,0,0,-6.0,-0.0,0.7082276344299316,33.12296062065974,27,-65,4,140,377,1473,263,65
-7,-1,0,-7.0,-1.0,0.7161877155303955,26.215118311311535,27,-58,5,140,377,1473,263,65
-7,0,0,-7.0,-0.0,0.7241005897521973,19.24451190127583,27,-51,5,140,377,1473,263,65
-4,0,0,-4.0,-0.0,0.732196569442749,15.265209192385896,27,-47,5,140,377,1473,263,65
-1,0,0,-1.0,-0.0,0.7402076721191406,14.270941205037097,27,-46,5,140,377,1473,263,65
-1,0,0,-1.0,-0.0,0.7481346130371094,13.276925690687087,27,-45,5,140,377,1473,263,65
-1,0,0,-1.0,-0.0,0.7642736434936523,12.28317965096906,27,-44,5,140,377,1473,263,65
0,0,1,-0.0,-0.0,0.7791197299957275,12.28317965096906,27,-44,5,140,377,1473,263,65
-1,0,1,-1.0,-0.0,0.0005559921264648438,714.8980907707262,28,705,211,888,583,184,372,42
0,0,0,-0.0,-0.0,0.0906980037689209,714.8980907707262,28,705,211,888,583,184,372,42
1,0,0,1.0,-0.0,0.1446530818939209,713.9401336163374,28,704,211,888,583,184,372,42
5,0,0,5.0,-0.0,0.15268898010253906,709.1520389617494,28,699,211,888,583,184,372,42
7,0,0,7.0,-0.0,0.1605689525604248,702.4535230406996,28,692,211,888,583,184,372,42
11,2,0,11.0,2.0,0.1686999797821045,691.3496332560297,28,681,209,888,583,184,372,42
15,3,0,15.0,3.0,0.17689299583435059,676.1312645406172,28,666,206,888,583,184,372,42
18,3,0,18.0,3.0,0.18469691276550293,658.0530170759865,28,648,203,888,583,184,372,42
22,5,0,22.0,5.0,0.19263792037963867,635.5668282817827,28,626,198,888,583,184,372,42
22,5,0,22.0,5.0,0.200653076171875,613.0859563182266,28,604,193,888,583,184,372,42
23,5,0,23.0,5.0,0.20864510536193848,589.6594795792496,28,581,188,888,583,184,372,42
23,4,0,23.0,4.0,0.21665191650390625,566.554252814155,28,558,184,888,583,184,372,42
23,5,0,23.0,5.0,0.22464489936828613,543.1506890893602,28,535,179,888,583,184,372,42
23,5,0,23.0,5.0,0.23276305198669434,519.7587262356475,28,512,174,888,583,184,372,42
23,5,0,23.0,5.0,0.24071407318115234,496.37993776334235,28,489,169,888,583,184,372,42
24,5,0,24.0,5.0,0.24861693382263184,472.07301690520444,28,465,164,888,583,184,372,42
26,6,0,26.0,6.0,0.2565629482269287,445.56725131539184,28,439,158,888,583,184,372,42
26,7,0,26.0,7.0,0.26456189155578613,418.7385586914115,28,413,151,888,583,184,372,42
25,8,0,25.0,8.0,0.2728269100189209,392.5129985865015,28,388,143,888,583,184,372,42
24,8,0,24.0,8.0,0.2806670665740967,367.2280257786653,28,364,135,888,583,184,372,42
22,8,0,22.0,8.0,0.2887229919433594,343.81913327017264,28,342,127,888,583,184,372,42
20,8,0,20.0,8.0,0.2966430187225342,322.2855953866984,28,322,119,888,583,184,372,42
18,7,0,18.0,7.0,0.30464696884155273,302.9753077010654,28,304,112,888,583,184,372,42
16,6,0,16.0,6.0,0.3125178813934326,285.88760157425713,28,288,106,888,583,184,372,42
14,5,0,14.0,5.0,0.32059407234191895,271.02225942554446,28,274,101,888,583,184,372,42
14,5,0,14.0,5.0,0.3287088871002197,256.1569952211201,28,260,96,888,583,184,372,42
12,5,0,12.0,5.0,0.33669090270996094,243.1685068285014,28,248,91,888,583,184,372,42
12,5,0,12.0,5.0,0.3446168899536133,230.18120948828954,28,236,86,888,583,184,372,42
11,4,0,11.0,4.0,0.3526489734649658,218.47651241823277,28,225,82,888,583,184,372,42
11,5,0,11.0,5.0,0.3606290817260742,206.43130831088317,28,214,77,888,583,184,372,42
10,4,0,10.0,4.0,0.3686490058898926,195.6679487141557,28,204,73,888,583,184,372,42
11,5,0,11.0,5.0,0.3766438961029053,183.62893246068603,28,193,68,888,583,184,372,42
11,5,0,11.0,5.0,0.3846290111541748,171.59543089076647,28,182,63,888,583,184,372,42
11,5,0,11.0,5.0,0.39251208305358887,159.56854654119581,28,171,58,888,583,184,372,42
11,4,0,11.0,4.0,0.4005589485168457,147.86681142249356,28,160,54,888,583,184,372,42
10,5,0,10.0,5.0,0.4085879325866699,136.8005069700348,28,150,49,888,583,184,372,42
9,3,0,9.0,3.0,0.41660189628601074,127.31385639919151,28,141,46,888,583,184,372,42
8,4,0,8.0,4.0,0.4246399402618408,118.47401191619892,28,133,42,888,583,184,372,42
9,3,0,9.0,3.0,0.43264293670654297,108.98846102635417,28,124,39,888,583,184,372,42
8,4,0,8.0,4.0,0.44060397148132324,100.16517651536682,28,116,35,888,583,184,372,42
8,3,0,8.0,3.0,0.4485509395599365,91.64102272262978,28,108,32,888,583,184,372,42
7,3,0,7.0,3.0,0.45670008659362793,84.08092119885512,28,101,29,888,583,184,372,42
6,2,0,6.0,2.0,0.4644920825958252,77.76234100101111,28,95,27,888,583,184,372,42
5,2,0,5.0,2.0,0.4726130962371826,72.40770846134703,28,90,25,888,583,184,372,42
4,3,0,4.0,3.0,0.48059701919555664,67.76936408468859,28,86,22,888,583,184,372,42
4,3,0,4.0,3.0,0.48868703842163086,63.17244204607586,28,82,19,888,583,184,372,42
4,2,0,4.0,2.0,0.4966750144958496,58.83107164506812,28,78,17,888,583,184,372,42
4,3,0,4.0,3.0,0.5047340393066406,54.31268153505093,28,74,14,888,583,184,372,42
3,2,0,3.0,2.0,0.512782096862793,51.00694410957877,28,71,12,888,583,184,372,42
5,3,0,5.0,3.0,0.5207569599151611,45.610809933523555,28,66,9,888,583,184,372,42
5,4,0,5.0,4.0,0.5286300182342529,40.204574992397426,28,61,5,888,583,184,372,42
7,3,0,7.0,3.0,0.5366120338439941,33.037024344425184,28,54,2,888,583,184,372,42
7,3,0,7.0,3.0,0.5446629524230957,26.010637094172637,28,47,-1,888,583,184,372,42
8,2,0,8.0,2.0,0.5525970458984375,18.11521443121589,28,39,-3,888,583,184,372,42
6,2,0,6.0,2.0,0.5606439113616943,12.376638536557273,28,33,-5,888,583,184,372,42
7,2,0,7.0,2.0,0.5686678886413574,5.92582403567252,28,26,-7,888,583,184,372,42
7,1,0,7.0,1.0,0.5768430233001709,-0.3844718719116962,28,19,-8,888,583,184,372,42
5,2,0,5.0,2.0,0.5846610069274902,-3.7953494659147466,28,14,-10,888,583,184,372,42
3,1,0,3.0,1.0,0.5924971103668213,-5.443650813895955,28,11,-11,888,583,184,372,42
2,0,0,2.0,-0.0,0.6005880832672119,-6.787329596448105,28,9,-11,888,583,184,372,42
1,1,0,1.0,1.0,0.6085898876190186,-6.5777948981440435,28,8,-12,888,583,184,372,42
0,0,1,-0.0,-0.0,0.6686348915100098,-6.5777948981440435,28,8,-12,888,583,184,372,42
0,0,0,-0.0,-0.0,0.08689355850219727,574.3551127062002,29,533,-263,1413,332,880,595,41
2,0,0,2.0,-0.0,0.1030724048614502,572.5622330186088,29,531,-263,1413,332,880,595,41
2,0,0,2.0,-0.0,0.11101055145263672,570.7706830911635,29,529,-263,1413,332,880,595,41
4,-1,0,4.0,-1.0,0.11900448799133301,566.7444077279306,29,525,-262,1413,332,880,595,41
6,-1,0,6.0,-1.0,0.12701749801635742,560.9320097911631,29,519,-261,1413,332,880,595,41
6,-2,0,6.0,-2.0,0.13496756553649902,554.6738205277843,29,513,-259,1413,332,880,595,41
8,-3,0,8.0,-3.0,0.1428813934326172,546.1810664442958,29,505,-256,1413,332,880,595,41
9,-3,0,9.0,-3.0,0.1510164737701416,536.7988864931394,29,496,-253,1413,332,880,595,41
8,-4,0,8.0,-4.0,0.15899348258972168,527.8549077995012,29,488,-249,1413,332,880,595,41
9,-4,0,9.0,-4.0,0.16710758209228516,518.0204457081534,29,479,-245,1413,332,880,595,41
10,-4,0,10.0,-4.0,0.17499256134033203,507.2968803245474,29,469,-241,1413,332,880,595,41
11,-4,0,11.0,-4.0,0.18297934532165527,495.6869205244593,29,458,-237,1413,332,880,595,41
10,-4,0,10.0,-4.0,0.1911165714263916,484.9683158377365,29,448,-233,1413,332,880,595,41
12,-4,0,12.0,-4.0,0.1990504264831543,472.4804564650256,29,436,-229,1413,332,880,595,41
11,-5,0,11.0,-5.0,0.20702052116394043,460.417526741063,29,425,-224,1413,332,880,595,41
12,-5,0,12.0,-5.0,0.21503257751464844,447.4719242906466,29,413,-219,1413,332,880,595,41
14,-7,0,14.0,-7.0,0.22299551963806152,431.82408081021975,29,399,-212,1413,332,880,595,41
14,-8,0,14.0,-8.0,0.23088955879211426,415.70747067269804,29,385,-204,1413,332,880,595,41
14,-9,0,14.0,-9.0,0.23894834518432617,399.1252796002646,29,371,-195,1413,332,880,595,41
14,-10,0,14.0,-10.0,0.24686837196350098,382.0870552504768,29,357,-185,1413,332,880,595,41
14,-10,0,14.0,-10.0,0.25495338439941406,365.06363110530185,29,343,-175,1413,332,880,595,41
12,-10,0,12.0,-10.0,0.2630484104156494,349.845913861435,29,331,-165,1413,332,880,595,41
13,-10,0,13.0,-10.0,0.27106642723083496,333.76404565755405,29,318,-155,1413,332,880,595,41
14,-11,0,14.0,-11.0,0.2790095806121826,316.3807366660582,29,304,-144,1413,332,880,595,41
14,-12,0,14.0,-12.0,0.2870213985443115,298.62831010442244,29,290,-132,1413,332,880,595,41
15,-11,0,15.0,-11.0,0.29491639137268066,280.4430062424486,29,275,-121,1413,332,880,595,41
15,-12,0,15.0,-12.0,0.3029494285583496,261.9237485562364,29,260,-109,1413,332,880,595,41
17,-12,0,17.0,-12.0,0.31092357635498047,241.64479738760332,29,243,-97,1413,332,880,595,41
16,-11,0,16.0,-11.0,0.3189854621887207,222.7447218787671,29,227,-86,1413,332,880,595,41
16,-10,0,16.0,-10.0,0.3269965648651123,204.26992665089986,29,211,-76,1413,332,880,595,41
14,-8,0,14.0,-8.0,0.3350653648376465,188.40585404445815,29,197,-68,1413,332,880,595,41
13,-7,0,13.0,-7.0,0.3430213928222656,173.84787850270635,29,184,-61,1413,332,880,595,41
9,-4,0,9.0,-4.0,0.35095953941345215,164.04890654388578,29,175,-57,1413,332,880,595,41
10,-5,0,10.0,-5.0,0.35907840728759766,153.0,29,165,-52,1413,332,880,595,41
10,-5,0,10.0,-5.0,0.36704254150390625,141.96913286178943,29,155,-47,1413,332,880,595,41
9,-5,0,9.0,-5.0,0.3748605251312256,131.92103211866353,29,146,-42,1413,332,880,595,41
8,-4,0,8.0,-4.0,0.38292455673217773,123.13629868066312,29,138,-38,1413,332,880,595,41
5,-3,0,5.0,-3.0,0.39090657234191895,117.52817893071949,29,133,-35,1413,332,880,595,41
4,-3,0,4.0,-3.0,0.3990345001220703,112.90974381135493,29,129,-32,1413,332,880,595,41
5,-4,0,5.0,-4.0,0.4070093631744385,107.12198865656563,29,124,-28,1413,332,880,595,41
4,-3,0,4.0,-3.0,0.41503047943115234,102.57650672131263,29,120,-25,1413,332,880,595,41
5,-3,0,5.0,-3.0,0.4230315685272217,97.08543888972702,29,115,-22,1413,332,880,595,41
5,-4,0,5.0,-4.0,0.43101048469543457,91.46299834474219,29,110,-18,1413,332,880,595,41
6,-4,0,6.0,-4.0,0.439023494720459,84.93807697875924,29,104,-14,1413,332,880,595,41
6,-2,0,6.0,-2.0,0.4470405578613281,78.73196037757987,29,98,-12,1413,332,880,595,41
5,-2,0,5.0,-2.0,0.45498156547546387,73.53608929178085,29,93,-10,1413,332,880,595,41
5,-3,0,5.0,-3.0,0.46306943893432617,68.2779700718135,29,88,-7,1413,332,880,595,41
4,-2,0,4.0,-2.0,0.47110843658447266,64.1486779456457,29,84,-5,1413,332,880,595,41
5,-1,0,5.0,-1.0,0.47901058197021484,59.101201002260396,29,79,-4,1413,332,880,595,41
3,-1,0,3.0,-1.0,0.4870035648345947,56.05918747922567,29,76,-3,1413,332,880,595,41
3,-2,0,3.0,-2.0,0.4950284957885742,53.00684899377592,29,73,-1,1413,332,880,595,41
4,-1,0,4.0,-1.0,0.5030255317687988,49.0,29,69,0,1413,332,880,595,41
3,-1,0,3.0,-1.0,0.5111305713653564,46.007575322837,29,66,1,1413,332,880,595,41
3,-1,0,3.0,-1.0,0.518958568572998,43.0317380372777,29,63,2,1413,332,880,595,41
3,-1,0,3.0,-1.0,0.5270335674285889,40.07495318350236,29,60,3,1413,332,880,595,41
4,0,0,4.0,-0.0,0.5349404811859131,36.08029957123981,29,56,3,1413,332,880,595,41
4,0,0,4.0,-0.0,0.5429885387420654,32.08646657242167,29,52,3,1413,332,880,595,41
5,-1,0,5.0,-1.0,0.5510265827178955,27.16990566028302,29,47,4,1413,332,880,595,41
4,0,0,4.0,-0.0,0.5591154098510742,23.185645763378368,29,43,4,1413,332,880,595,41
5,0,0,5.0,-0.0,0.5670914649963379,18.209946349085598,29,38,4,1413,332,880,595,41
5,0,0,5.0,-0.0,0.575108528137207,13.241540277189323,29,33,4,1413,332,880,595,41
4,-1,0,4.0,-1.0,0.5828704833984375,9.427877939124322,29,29,5,1413,332,880,595,41
2,0,0,2.0,-0.0,0.5910923480987549,7.459060435491963,29,27,5,1413,332,880,595,41
2,0,0,2.0,-0.0,0.5989944934844971,5.495097567963924,29,25,5,1413,332,880,595,41
1,0,0,1.0,-0.0,0.6151015758514404,4.515301344262525,29,24,5,1413,332,880,595,41
1,0,0,1.0,-0.0,0.6230983734130859,3.5372045918796395,29,23,5,1413,332,880,595,41
0,0,1,-0.0,-0.0,0.6510264873504639,3.5372045918796395,29,23,5,1413,332,880,595,41
0,0,0,-0.0,-0.0,0.08661699295043945,274.83043021590464,30,157,246,1547,573,1390,327,34
-1,3,0,-1.0,3.0,0.10367178916931152,272.8499611868182,30,158,243,1547,573,1390,327,34
-2,2,0,-2.0,2.0,0.11171388626098633,272.2766841624122,30,160,241,1547,573,1390,327,34
-1,1,0,-1.0,1.0,0.11974382400512695,272.0,30,161,240,1547,573,1390,327,34
-2,2,0,-2.0,2.0,0.1277458667755127,271.46663585239804,30,163,238,1547,573,1390,327,34
-2,1,0,-2.0,1.0,0.13578581809997559,271.7801932266131,30,165,237,1547,573,1390,327,34
-2,1,0,-2.0,1.0,0.14393877983093262,272.110705439975,30,167,236,1547,573,1390,327,34
-3,1,0,-3.0,1.0,0.15167999267578125,273.0431002454635,30,170,235,1547,573,1390,327,34
-4,0,0,-4.0,-0.0,0.15971899032592773,275.4055403031892,30,174,235,1547,573,1390,327,34
-3,1,0,-3.0,1.0,0.16767287254333496,276.4024539774676,30,177,234,1547,573,1390,327,34
-3,0,0,-3.0,-0.0,0.17582392692565918,278.22195040342103,30,180,234,1547,573,1390,327,34
-4,2,0,-4.0,2.0,0.1838209629058838,279.10808837314795,30,184,232,1547,573,1390,327,34
-4,2,0,-4.0,2.0,0.19174981117248535,280.05891671518634,30,188,230,1547,573,1390,327,34
-3,2,0,-3.0,2.0,0.19974589347839355,280.4306641891518,30,191,228,1547,573,1390,327,34
-3,3,0,-3.0,3.0,0.2077488899230957,280.08752918963125,30,194,225,1547,573,1390,327,34
-2,4,0,-2.0,4.0,0.21576690673828125,278.39295861614573,30,196,221,1547,573,1390,327,34
-2,5,0,-2.0,5.0,0.22365880012512207,276.0187707297947,30,198,216,1547,573,1390,327,34
0,6,0,-0.0,6.0,0.23170089721679688,271.62432329933665,30,198,210,1547,573,1390,327,34
3,7,0,3.0,7.0,0.2397468090057373,264.48534597737057,30,195,203,1547,573,1390,327,34
5,8,0,5.0,8.0,0.24775385856628418,255.2590678012396,30,190,195,1547,573,1390,327,34
8,10,0,8.0,10.0,0.25572896003723145,242.5168587972658,30,182,185,1547,573,1390,327,34
12,9,0,12.0,9.0,0.26372194290161133,227.69572942738498,30,170,176,1547,573,1390,327,34
13,10,0,13.0,10.0,0.27188992500305176,211.4841351166422,30,157,166,1547,573,1390,327,34
15,10,0,15.0,10.0,0.27973484992980957,193.95023109728987,30,142,156,1547,573,1390,327,34
17,10,0,17.0,10.0,0.28772997856140137,175.20041623263984,30,125,146,1547,573,1390,327,34
16,9,0,16.0,9.0,0.29575085639953613,158.07141400011596,30,109,137,1547,573,1390,327,34
12,7,0,12.0,7.0,0.3037078380584717,145.2004932174992,30,97,130,1547,573,1390,327,34
10,7,0,10.0,7.0,0.3116588592529297,133.65855435387664,30,87,123,1547,573,1390,327,34
7,5,0,7.0,5.0,0.31966686248779297,125.56226709757388,30,80,118,1547,573,1390,327,34
4,4,0,4.0,4.0,0.32779479026794434,120.01094846763161,30,76,114,1547,573,1390,327,34
4,3,0,4.0,3.0,0.3357219696044922,115.30646242719968,30,72,111,1547,573,1390,327,34
2,3,0,2.0,3.0,0.3437809944152832,111.70120434556935,30,70,108,1547,573,1390,327,34
2,3,0,2.0,3.0,0.3517649173736572,108.0959631642844,30,68,105,1547,573,1390,327,34
1,3,0,1.0,3.0,0.35984086990356445,105.03687967167957,30,67,102,1547,573,1390,327,34
1,4,0,1.0,4.0,0.36772680282592773,101.15244390193544,30,66,98,1547,573,1390,327,34
1,3,0,1.0,3.0,0.37563180923461914,98.10864433221339,30,65,95,1547,573,1390,327,34
1,3,0,1.0,3.0,0.3836479187011719,95.0714058089752,30,64,92,1547,573,1390,327,34
0,4,0,-0.0,4.0,0.3917667865753174,91.81176406988355,30,64,88,1547,573,1390,327,34
0,3,0,-0.0,3.0,0.3997678756713867,89.40018796975878,30,64,85,1547,573,1390,327,34
1,3,0,1.0,3.0,0.40782785415649414,86.40696301506973,30,63,82,1547,573,1390,327,34
1,4,0,1.0,4.0,0.4157979488372803,82.6393496566492,30,62,78,1547,573,1390,327,34
0,3,0,-0.0,3.0,0.4237639904022217,80.30878685915265,30,62,75,1547,573,1390,327,34
1,3,0,1.0,3.0,0.431751012802124,77.36630754670864,30,61,72,1547,573,1390,327,34
1,4,0,1.0,4.0,0.43962597846984863,73.68627239003708,30,60,68,1547,573,1390,327,34
1,3,0,1.0,3.0,0.44765591621398926,70.78382538941898,30,59,65,1547,573,1390,327,34
1,4,0,1.0,4.0,0.4557969570159912,67.17244204607586,30,58,61,1547,573,1390,327,34
0,4,0,-0.0,4.0,0.46378183364868164,64.32035415564789,30,58,57,1547,573,1390,327,34
1,5,0,1.0,5.0,0.4717698097229004,60.15568676384133,30,57,52,1547,573,1390,327,34
2,4,0,2.0,4.0,0.4797968864440918,56.0,30,55,48,1547,573,1390,327,34
1,4,0,1.0,4.0,0.4877758026123047,52.65629906907199,30,54,44,1547,573,1390,327,34
2,4,0,2.0,4.0,0.4958980083465576,48.60487786742691,30,52,40,1547,573,1390,327,34
3,4,0,3.0,4.0,0.5036308765411377,43.802960454241045,30,49,36,1547,573,1390,327,34
3,4,0,3.0,4.0,0.5116958618164062,39.0357029044876,30,46,32,1547,573,1390,327,34
3,3,0,3.0,3.0,0.5196869373321533,34.86520991955976,30,43,29,1547,573,1390,327,34
3,3,0,3.0,3.0,0.5278139114379883,30.707441767506253,30,40,26,1547,573,1390,327,34
4,3,0,4.0,3.0,0.5359249114990234,25.720018726587654,30,36,23,1547,573,1390,327,34
4,2,0,4.0,2.0,0.5436959266662598,21.275318418009277,30,32,21,1547,573,1390,327,34
4,2,0,4.0,2.0,0.5516889095306396,16.837848631377263,30,28,19,1547,573,1390,327,34
5,2,0,5.0,2.0,0.5597679615020752,11.600699292150182,30,23,17,1547,573,1390,327,34
4,2,0,4.0,2.0,0.5677998065948486,7.207436873820409,30,19,15,1547,573,1390,327,34
5,2,0,5.0,2.0,0.5758798122406006,2.104973174542799,30,14,13,1547,573,1390,327,34
4,2,0,4.0,2.0,0.583745002746582,-2.133931252681494,30,10,11,1547,573,1390,327,34
4,1,0,4.0,1.0,0.5916588306427002,-5.3380962103093985,30,6,10,1547,573,1390,327,34
5,2,0,5.0,2.0,0.5997447967529297,-8.93774225170145,30,1,8,1547,573,1390,327,34
5,1,0,5.0,1.0,0.6077578067779541,-8.93774225170145,30,-4,7,1547,573,1390,327,34
5,2,0,5.0,2.0,0.6157917976379395,-6.704369859012999,30,-9,5,1547,573,1390,327,34
4,1,0,4.0,1.0,0.6279768943786621,-3.398529491264556,30,-13,4,1547,573,1390,327,34
4,1,0,4.0,1.0,0.631706953048706,0.26267650163206824,30,-17,3,1547,573,1390,327,34
3,1,0,3.0,1.0,0.6396639347076416,3.09975124224178,30,-20,2,1547,573,1390,327,34
3,1,0,3.0,1.0,0.647648811340332,6.021728866442675,30,-23,1,1547,573,1390,327,34
3,1,0,3.0,1.0,0.6556179523468018,9.0,30,-26,0,1547,573,1390,327,34
1,1,0,1.0,1.0,0.6635918617248535,10.018512172212592,30,-27,-1,1547,573,1390,327,34
0,1,0,-0.0,1.0,0.6718478202819824,10.073972741361768,30,-27,-2,1547,573,1390,327,34
1,0,0,1.0,-0.0,0.6796848773956299,11.071337695236398,30,-28,-2,1547,573,1390,327,34
0,0,1,-0.0,-0.0,0.689626932144165,11.071337695236398,30,-28,-2,1547,573,1390,327,34
-2,0,1,-2.0,-0.0,0.08337616920471191,609.9263523845184,31,-627,151,946,726,1575,575,71
0,0,0,-0.0,-0.0,0.0901942253112793,609.9263523845184,31,-627,151,946,726,1575,575,71
-1,0,0,-1.0,-0.0,0.09552717208862305,608.9541909173354,31,-626,151,946,726,1575,575,71
-1,0,0,-1.0,-0.0,0.09960412979125977,607.982114836797,31,-625,151,946,726,1575,575,71
-1,0,0,-1.0,-0.0,0.10732817649841309,607.0101245307585,31,-624,151,946,726,1575,575,71
-1,0,0,-1.0,-0.0,0.11526203155517578,606.038220389393,31,-623,151,946,726,1575,575,71
-1,0,0,-1.0,-0.0,0.12334704399108887,605.066402805209,31,-622,151,946,726,1575,575,71
-1,0,0,-1.0,-0.0,0.13933610916137695,604.094672173067,31,-621,151,946,726,1575,575,71
-1,-1,0,-1.0,-1.0,0.14739418029785156,603.3603997742968,31,-620,152,946,726,1575,575,71
-2,0,0,-2.0,-0.0,0.15535521507263184,601.4181015653153,31,-618,152,946,726,1575,575,71
-1,0,0,-1.0,-0.0,0.17149710655212402,600.4470867035271,31,-617,152,946,726,1575,575,71
-2,0,0,-2.0,-0.0,0.17937111854553223,598.5053275229815,31,-615,152,946,726,1575,575,71
-1,-1,0,-1.0,-1.0,0.18730425834655762,597.7756316420537,31,-614,153,946,726,1575,575,71
-2,0,0,-2.0,-0.0,0.19529008865356445,595.835160719502,31,-612,153,946,726,1575,575,71
-2,0,0,-2.0,-0.0,0.20330119132995605,593.8950627886977,31,-610,153,946,726,1575,575,71
-3,0,0,-3.0,-0.0,0.21147513389587402,590.9856228380968,31,-607,153,946,726,1575,575,71
-5,0,0,-5.0,-0.0,0.2194230556488037,586.1384708742488,31,-602,153,946,726,1575,575,71
-7,0,0,-7.0,-0.0,0.22745513916015625,579.3565739861501,31,-595,153,946,726,1575,575,71
-9,0,0,-9.0,-0.0,0.23533225059509277,570.6442850386685,31,-586,153,946,726,1575,575,71
-13,0,0,-13.0,-0.0,0.243455171585083,558.0750374109502,31,-573,153,946,726,1575,575,71
-15,0,0,-15.0,-0.0,0.2513010501861572,543.5957137760355,31,-558,153,946,726,1575,575,71
-19,2,0,-19.0,2.0,0.25926804542541504,524.7517306806652,31,-539,151,946,726,1575,575,71
-23,4,0,-23.0,4.0,0.2673330307006836,501.5305210330537,31,-516,147,946,726,1575,575,71
-26,5,0,-26.0,5.0,0.27526211738586426,475.1607589770111,31,-490,142,946,726,1575,575,71
-33,6,0,-33.0,6.0,0.28333020210266113,441.8070888734772,31,-457,136,946,726,1575,575,71
-36,8,0,-36.0,8.0,0.29133009910583496,405.028408173836,31,-421,128,946,726,1575,575,71
-36,7,0,-36.0,7.0,0.2993452548980713,368.56659921257113,31,-385,121,946,726,1575,575,71
-32,7,0,-32.0,7.0,0.3073270320892334,335.95147930693037,31,-353,114,946,726,1575,575,71
-30,7,0,-30.0,7.0,0.3154420852661133,305.26166401756166,31,-323,107,946,726,1575,575,71
-22,5,0,-22.0,5.0,0.32319021224975586,282.81283800375337,31,-301,102,946,726,1575,575,71
-20,5,0,-20.0,5.0,0.3312680721282959,262.27092020579477,31,-281,97,946,726,1575,575,71
-18,5,0,-18.0,5.0,0.33929920196533203,243.62699079593853,31,-263,92,946,726,1575,575,71
-15,3,0,-15.0,3.0,0.34734511375427246,228.48624252510797,31,-248,89,946,726,1575,575,71
-15,4,0,-15.0,4.0,0.35542917251586914,213.02016047087784,31,-233,85,946,726,1575,575,71
-13,3,0,-13.0,3.0,0.36336708068847656,199.78500803926983,31,-220,82,946,726,1575,575,71
-14,5,0,-14.0,5.0,0.3713350296020508,184.92044015961773,31,-206,77,946,726,1575,575,71
-11,2,0,-11.0,2.0,0.3793480396270752,173.92582415776178,31,-195,75,946,726,1575,575,71
-9,3,0,-9.0,3.0,0.38748621940612793,164.44924166313595,31,-186,72,946,726,1575,575,71
-9,2,0,-9.0,2.0,0.3951761722564697,155.33917095542893,31,-177,70,946,726,1575,575,71
-7,2,0,-7.0,2.0,0.40322208404541016,148.09560344257315,31,-170,68,946,726,1575,575,71
-6,2,0,-6.0,2.0,0.41118311882019043,141.7823520603796,31,-164,66,946,726,1575,575,71
-5,2,0,-5.0,2.0,0.41923022270202637,136.39719951037708,31,-159,64,946,726,1575,575,71
-3,2,0,-3.0,2.0,0.42728424072265625,132.86899654194636,31,-156,62,946,726,1575,575,71
-3,1,0,-3.0,1.0,0.43526721000671387,129.7118696390761,31,-153,61,946,726,1575,575,71
-2,1,0,-2.0,1.0,0.4432852268218994,127.48384535085327,31,-151,60,946,726,1575,575,71
-2,1,0,-2.0,1.0,0.45131421089172363,125.25604512778918,31,-149,59,946,726,1575,575,71
-3,2,0,-3.0,2.0,0.45937013626098633,121.73225577397909,31,-146,57,946,726,1575,575,71
-2,2,0,-2.0,2.0,0.4672701358795166,119.14603465545261,31,-144,55,946,726,1575,575,71
-2,2,0,-2.0,2.0,0.47535204887390137,116.56846637740978,31,-142,53,946,726,1575,575,71
-2,2,0,-2.0,2.0,0.48342204093933105,114.0,31,-140,51,946,726,1575,575,71
-2,2,0,-2.0,2.0,0.4912760257720947,111.44111444536333,31,-138,49,946,726,1575,575,71
-3,2,0,-3.0,2.0,0.49930310249328613,107.94754282603111,31,-135,47,946,726,1575,575,71
-3,3,0,-3.0,3.0,0.5073962211608887,104.1402170474087,31,-132,44,946,726,1575,575,71
-3,2,0,-3.0,2.0,0.5153732299804688,100.66502865514016,31,-129,42,946,726,1575,575,71
-3,2,0,-3.0,2.0,0.5233912467956543,97.19682295728592,31,-126,40,946,726,1575,575,71
-2,2,0,-2.0,2.0,0.5313742160797119,94.6919426949878,31,-124,38,946,726,1575,575,71
-4,2,0,-4.0,2.0,0.5391881465911865,90.2836781069266,31,-120,36,946,726,1575,575,71
-3,2,0,-3.0,2.0,0.5473670959472656,86.8400590938793,31,-117,34,946,726,1575,575,71
-4,2,0,-4.0,2.0,0.5553312301635742,82.44360348695028,31,-113,32,946,726,1575,575,71
-5,2,0,-5.0,2.0,0.5633060932159424,77.08925015361643,31,-108,30,946,726,1575,575,71
-6,3,0,-6.0,3.0,0.571317195892334,70.51303237041384,31,-102,27,946,726,1575,575,71
-6,3,0,-6.0,3.0,0.579362154006958,63.95453501482385,31,-96,24,946,726,1575,575,71
-8,3,0,-8.0,3.0,0.5873351097106934,55.470989825468365,31,-88,21,946,726,1575,575,71
-7,3,0,-7.0,3.0,0.5953202247619629,47.97590011563598,31,-81,18,946,726,1575,575,71
-8,2,0,-8.0,2.0,0.6033921241760254,39.73285756613352,31,-73,16,946,726,1575,575,71
-6,2,0,-6.0,2.0,0.6113440990447998,33.447059834590405,31,-67,14,946,726,1575,575,71
-7,1,0,-7.0,1.0,0.6192970275878906,26.392181912683313,31,-60,13,946,726,1575,575,71
-7,1,0,-7.0,1.0,0.6273071765899658,19.3415126767741,31,-53,12,946,726,1575,575,71
-6,1,0,-6.0,1.0,0.6351921558380127,13.270073544588683,31,-47,11,946,726,1575,575,71
-5,1,0,-5.0,1.0,0.643247127532959,8.174066289845804,31,-42,10,946,726,1575,575,71
-2,0,0,-2.0,-0.0,0.6512942314147949,6.231056256176608,31,-40,10,946,726,1575,575,71
-1,0,0,-1.0,-0.0,0.6593282222747803,5.26164427839479,31,-39,10,946,726,1575,575,71
0,0,1,-0.0,-0.0,0.6992032527923584,5.26164427839479,31,-39,10,946,726,1575,575,71
0,0,0,-0.0,-0.0,0.07922124862670898,850.311580021826,32,-806,323,179,1039,985,716,37
-1,0,0,-1.0,-0.0,0.19022727012634277,849.3834215616529,32,-805,323,179,1039,985,716,37
-3,-1,0,-3.0,-1.0,0.19823122024536133,846.9739880481956,32,-802,324,179,1039,985,716,37
-6,0,0,-6.0,-0.0,0.20619916915893555,841.4137536716527,32,-796,324,179,1039,985,716,37
-7,0,0,-7.0,-0.0,0.21428322792053223,834.9343468286407,32,-789,324,179,1039,985,716,37
-10,1,0,-10.0,1.0,0.22222328186035156,825.3089588045416,32,-779,323,179,1039,985,716,37
-14,1,0,-14.0,1.0,0.23009228706359863,812.0054216690395,32,-765,322,179,1039,985,716,37
-16,1,0,-16.0,1.0,0.23815011978149414,796.8877223274382,32,-749,321,179,1039,985,716,37
-18,2,0,-18.0,2.0,0.24624419212341309,779.572567231346,32,-731,319,179,1039,985,716,37
-19,2,0,-19.0,2.0,0.254223108291626,761.3798817008302,32,-712,317,179,1039,985,716,37
-17,3,0,-17.0,3.0,0.2622091770172119,744.6408066711354,32,-695,314,179,1039,985,716,37
-17,4,0,-17.0,4.0,0.2702302932739258,727.5092219416202,32,-678,310,179,1039,985,716,37
-19,4,0,-19.0,4.0,0.2782022953033447,708.5789702434279,32,-659,306,179,1039,985,716,37
-18,4,0,-18.0,4.0,0.28620219230651855,690.5795650454506,32,-641,302,179,1039,985,716,37
-21,5,0,-21.0,5.0,0.2942471504211426,669.4656355047865,32,-620,297,179,1039,985,716,37
-22,6,0,-22.0,6.0,0.3021841049194336,647.0451112518608,32,-598,291,179,1039,985,716,37
-22,5,0,-22.0,5.0,0.31052422523498535,625.0956382996234,32,-576,286,179,1039,985,716,37
-22,6,0,-22.0,6.0,0.3182041645050049,602.7382701267902,32,-554,280,179,1039,985,716,37
-23,7,0,-23.0,7.0,0.32621216773986816,579.0678353420154,32,-531,273,179,1039,985,716,37
-21,6,0,-21.0,6.0,0.33421826362609863,557.6639644792784,32,-510,267,179,1039,985,716,37
-19,8,0,-19.0,8.0,0.34221816062927246,537.1234097027435,32,-491,259,179,1039,985,716,37
-18,7,0,-18.0,7.0,0.35019826889038086,517.9412281211439,32,-473,252,179,1039,985,716,37
-17,8,0,-17.0,8.0,0.35813307762145996,499.1769523093619,32,-456,244,179,1039,985,716,37
-12,6,0,-12.0,6.0,0.36620616912841797,485.7658186101951,32,-444,238,179,1039,985,716,37
-12,7,0,-12.0,7.0,0.37424421310424805,471.88263900652777,32,-432,231,179,1039,985,716,37
-10,6,0,-10.0,6.0,0.38230228424072266,460.2352977353303,32,-422,225,179,1039,985,716,37
-11,9,0,-11.0,9.0,0.39023828506469727,446.3027029858861,32,-411,216,179,1039,985,716,37
-11,8,0,-11.0,8.0,0.3982701301574707,432.8480897153719,32,-400,208,179,1039,985,716,37
-11,8,0,-11.0,8.0,0.4062941074371338,419.4025605777817,32,-389,200,179,1039,985,716,37
-11,10,0,-11.0,10.0,0.41422128677368164,405.0650068251923,32,-378,190,179,1039,985,716,37
-11,10,0,-11.0,10.0,0.4221363067626953,390.76521378414776,32,-367,180,179,1039,985,716,37
-12,9,0,-12.0,9.0,0.43010926246643066,376.03806922681974,32,-355,171,179,1039,985,716,37
-11,9,0,-11.0,9.0,0.43813228607177734,362.23676834309435,32,-344,162,179,1039,985,716,37
-11,10,0,-11.0,10.0,0.4462912082672119,348.0505429582095,32,-333,152,179,1039,985,716,37
-11,8,0,-11.0,8.0,0.4542372226715088,334.7321930303499,32,-322,144,179,1039,985,716,37
-12,9,0,-12.0,9.0,0.46286725997924805,320.11980125393427,32,-310,135,179,1039,985,716,37
-12,8,0,-12.0,8.0,0.4702272415161133,305.93363517856557,32,-298,127,179,1039,985,716,37
-13,8,0,-13.0,8.0,0.478161096572876,290.8462400612965,32,-285,119,179,1039,985,716,37
-14,10,0,-14.0,10.0,0.4862372875213623,274.09929818470977,32,-271,109,179,1039,985,716,37
-14,8,0,-14.0,8.0,0.4941132068634033,258.1340254296815,32,-257,101,179,1039,985,716,37
-12,7,0,-12.0,7.0,0.5021471977233887,244.4137953690697,32,-245,94,179,1039,985,716,37
-10,7,0,-10.0,7.0,0.5102522373199463,232.5873101336139,32,-235,87,179,1039,985,716,37
-9,7,0,-9.0,7.0,0.518085241317749,221.74152748324602,32,-226,80,179,1039,985,716,37
-8,6,0,-8.0,6.0,0.5262711048126221,212.21728866442677,32,-218,74,179,1039,985,716,37
-8,6,0,-8.0,6.0,0.5342302322387695,202.7351353998724,32,-210,68,179,1039,985,716,37
-8,5,0,-8.0,5.0,0.5422401428222656,193.59631376751344,32,-202,63,179,1039,985,716,37
-6,4,0,-6.0,4.0,0.5502221584320068,186.68756679388224,32,-196,59,179,1039,985,716,37
-6,4,0,-6.0,4.0,0.5582771301269531,179.80040444852483,32,-190,55,179,1039,985,716,37
-7,3,0,-7.0,3.0,0.5661041736602783,172.24457942343588,32,-183,52,179,1039,985,716,37
-5,2,0,-5.0,2.0,0.5742292404174805,166.88915598271305,32,-178,50,179,1039,985,716,37
-6,2,0,-6.0,2.0,0.5822141170501709,160.5721142843977,32,-172,48,179,1039,985,716,37
-5,2,0,-5.0,2.0,0.590259313583374,155.21951391226105,32,-167,46,179,1039,985,716,37
-4,1,0,-4.0,1.0,0.5983231067657471,151.09760495051373,32,-163,45,179,1039,985,716,37
-5,2,0,-5.0,2.0,0.606208086013794,145.74675569305182,32,-158,43,179,1039,985,716,37
-3,1,0,-3.0,1.0,0.6142501831054688,142.58953888718904,32,-155,42,179,1039,985,716,37
-3,1,0,-3.0,1.0,0.6221520900726318,139.4325252290644,32,-152,41,179,1039,985,716,37
-4,1,0,-4.0,1.0,0.6302320957183838,135.3101431738944,32,-148,40,179,1039,985,716,37
-2,1,0,-2.0,1.0,0.6381433010101318,133.11915828246265,32,-146,39,179,1039,985,716,37
-4,1,0,-4.0,1.0,0.646240234375,128.99659860010368,32,-142,38,179,1039,985,716,37
-4,1,0,-4.0,1.0,0.6540992259979248,124.87407042567241,32,-138,37,179,1039,985,716,37
-4,1,0,-4.0,1.0,0.6622121334075928,120.7515765676196,32,-134,36,179,1039,985,716,37
-5,2,0,-5.0,2.0,0.6701462268829346,115.40539719216761,32,-129,34,179,1039,985,716,37
-6,1,0,-6.0,1.0,0.6782581806182861,109.34991166074674,32,-123,33,179,1039,985,716,37
-5,3,0,-5.0,3.0,0.6862123012542725,103.75385004179539,32,-118,30,179,1039,985,716,37
-6,2,0,-6.0,2.0,0.6942121982574463,97.44695751729449,32,-112,28,179,1039,985,716,37
-6,2,0,-6.0,2.0,0.7022361755371094,91.14210919713803,32,-106,26,179,1039,985,716,37
-5,3,0,-5.0,3.0,0.7102112770080566,85.58571330062848,32,-101,23,179,1039,985,716,37
-5,3,0,-5.0,3.0,0.7181820869445801,80.0612053770501,32,-96,20,179,1039,985,716,37
-6,3,0,-6.0,3.0,0.7262132167816162,73.59148432032315,32,-90,17,179,1039,985,716,37
-7,4,0,-7.0,4.0,0.7341461181640625,66.01190391843289,32,-83,13,179,1039,985,716,37
-7,3,0,-7.0,3.0,0.7421262264251709,58.6550715869472,32,-76,10,179,1039,985,716,37
-7,3,0,-7.0,3.0,0.7502391338348389,51.35416353759881,32,-69,7,179,1039,985,716,37
-6,3,0,-6.0,3.0,0.7582712173461914,45.12685640834652,32,-63,4,179,1039,985,716,37
-7,3,0,-7.0,3.0,0.7662572860717773,38.00892785976178,32,-56,1,179,1039,985,716,37
-5,3,0,-5.0,3.0,0.7742083072662354,33.03920062069938,32,-51,-2,179,1039,985,716,37
-5,3,0,-5.0,3.0,0.7823002338409424,28.270941205037097,32,-46,-5,179,1039,985,716,37
-2,2,0,-2.0,2.0,0.7905542850494385,26.553338819890925,32,-44,-7,179,1039,985,716,37
-3,2,0,-3.0,2.0,0.7982702255249023,23.97618372363071,32,-41,-9,179,1039,985,716,37
-1,0,0,-1.0,-0.0,0.8060801029205322,23.0,32,-40,-9,179,1039,985,716,37
-1,1,0,-1.0,1.0,0.8141391277313232,22.26164427839479,32,-39,-10,179,1039,985,716,37
-1,0,0,-1.0,-0.0,0.8221852779388428,21.293765408777,32,-38,-10,179,1039,985,716,37
-1,1,0,-1.0,1.0,0.8302311897277832,20.600518131237564,32,-37,-11,179,1039,985,716,37
-1,1,0,-1.0,1.0,0.8383612632751465,19.947331922020552,32,-36,-12,179,1039,985,716,37
-2,0,0,-2.0,-0.0,0.8462212085723877,18.055512754639892,32,-34,-12,179,1039,985,716,37
-2,1,0,-2.0,1.0,0.8543901443481445,16.539832078341085,32,-32,-13,179,1039,985,716,37
-1,0,0,-1.0,-0.0,0.8701400756835938,15.61547262794322,32,-31,-13,179,1039,985,716,37
0,0,1,-0.0,-0.0,0.8731482028961182,15.61547262794322,32,-31,-13,179,1039,985,716,37
0,1,1,-0.0,1.0,0.8781571388244629,16.0147027033899,32,-31,-14,179,1039,985,716,37
-1,0,1,-1.0,-0.0,0.9421322345733643,15.105890714493697,32,-30,-14,179,1039,985,716,37
0,0,0,-0.0,-0.0,0.9681742191314697,15.105890714493697,32,-30,-14,179,1039,985,716,37
-1,0,0,-1.0,-0.0,0.9742162227630615,14.202484376209235,32,-29,-14,179,1039,985,716,37
-1,0,0,-1.0,-0.0,0.9902071952819824,13.304951684997057,32,-28,-14,179,1039,985,716,37
-1,0,0,-1.0,-0.0,1.0061862468719482,12.4138126514911,32,-27,-14,179,1039,985,716,37
-1,0,0,-1.0,-0.0,1.022219181060791,11.5296461204668,32,-26,-14,179,1039,985,716,37
-1,0,0,-1.0,-0.0,1.0462462902069092,10.653097563788805,32,-25,-14,179,1039,985,716,37
0,-1,0,-0.0,-1.0,1.0542020797729492,10.178005607210743,32,-25,-13,179,1039,985,716,37
-1,0,0,-1.0,-0.0,1.0622150897979736,9.294688127912362,32,-24,-13,179,1039,985,716,37
-1,0,0,-1.0,-0.0,1.0941872596740723,8.419689627245813,32,-23,-13,179,1039,985,716,37
-1,-1,0,-1.0,-1.0,1.118272304534912,7.059928172283335,32,-22,-12,179,1039,985,716,37
-1,0,0,-1.0,-0.0,1.1262571811676025,6.186773244895647,32,-21,-12,179,1039,985,716,37
-1,0,0,-1.0,-0.0,1.1343262195587158,5.323807579381203,32,-20,-12,179,1039,985,716,37
-1,0,0,-1.0,-0.0,1.1422431468963623,4.472205054244231,32,-19,-12,179,1039,985,716,37
-1,0,0,-1.0,-0.0,1.150341272354126,3.6333076527839374,32,-18,-12,179,1039,985,716,37
-1,0,0,-1.0,-0.0,1.1661832332611084,2.808652046684813,32,-17,-12,179,1039,985,716,37
0,0,1,-0.0,-0.0,1.1812551021575928,2.808652046684813,32,-17,-12,179,1039,985,716,37
0,0,0,-0.0,-0.0,0.09161567687988281,1217.293916779406,33,952,-795,1148,256,196,1051,47
3,-2,0,3.0,-2.0,0.1405806541442871,1213.7093433786292,33,949,-793,1148,256,196,1051,47
4,-2,0,4.0,-2.0,0.1488337516784668,1209.357902559155,33,945,-791,1148,256,196,1051,47
4,-2,0,4.0,-2.0,0.15682458877563477,1205.0073289683576,33,941,-789,1148,256,196,1051,47
4,-3,0,4.0,-3.0,0.16477274894714355,1200.014717818228,33,937,-786,1148,256,196,1051,47
6,-4,0,6.0,-4.0,0.17272472381591797,1192.8474410879023,33,931,-782,1148,256,196,1051,47
7,-4,0,7.0,-4.0,0.1807856559753418,1184.9155599626988,33,924,-778,1148,256,196,1051,47
9,-5,0,9.0,-5.0,0.18868565559387207,1174.8121722540643,33,915,-773,1148,256,196,1051,47
13,-7,0,13.0,-7.0,0.19678974151611328,1160.3680746073894,33,902,-766,1148,256,196,1051,47
17,-9,0,17.0,-9.0,0.20473170280456543,1141.5917739706047,33,885,-757,1148,256,196,1051,47
22,-11,0,22.0,-11.0,0.21264266967773438,1117.7387956933874,33,863,-746,1148,256,196,1051,47
24,-13,0,24.0,-13.0,0.22058367729187012,1091.0960461288785,33,839,-733,1148,256,196,1051,47
27,-15,0,27.0,-15.0,0.22870874404907227,1060.9132806640944,33,812,-718,1148,256,196,1051,47
28,-19,0,28.0,-19.0,0.2367417812347412,1027.3604143340513,33,784,-699,1148,256,196,1051,47
30,-22,0,30.0,-22.0,0.24475979804992676,990.3336074561033,33,754,-677,1148,256,196,1051,47
30,-24,0,30.0,-24.0,0.2526826858520508,951.9794869637002,33,724,-653,1148,256,196,1051,47
32,-28,0,32.0,-28.0,0.2607707977294922,909.4639403215548,33,692,-625,1148,256,196,1051,47
35,-33,0,35.0,-33.0,0.2686197757720947,861.3715282617368,33,657,-592,1148,256,196,1051,47
33,-34,0,33.0,-34.0,0.27675366401672363,814.1021443049826,33,624,-558,1148,256,196,1051,47
31,-30,0,31.0,-30.0,0.28470659255981445,770.9981108289868,33,593,-528,1148,256,196,1051,47
28,-29,0,28.0,-29.0,0.29265379905700684,730.807667777398,33,565,-499,1148,256,196,1051,47
24,-26,0,24.0,-26.0,0.3005976676940918,695.6167267744329,33,541,-473,1148,256,196,1051,47
21,-23,0,21.0,-23.0,0.30870866775512695,664.6772498781678,33,520,-450,1148,256,196,1051,47
20,-22,0,20.0,-22.0,0.31668972969055176,635.1671520214298,33,500,-428,1148,256,196,1051,47
19,-22,0,19.0,-22.0,0.32474374771118164,606.4418162149699,33,481,-406,1148,256,196,1051,47
17,-19,0,17.0,-19.0,0.3326256275177002,581.2060906677456,33,464,-387,1148,256,196,1051,47
17,-17,0,17.0,-17.0,0.34064364433288574,557.2663181677875,33,447,-370,1148,256,196,1051,47
16,-16,0,16.0,-16.0,0.3488187789916992,534.742772252586,33,431,-354,1148,256,196,1051,47
15,-14,0,15.0,-14.0,0.3566927909851074,514.2671588697749,33,416,-340,1148,256,196,1051,47
13,-11,0,13.0,-11.0,0.3646066188812256,497.24032907878257,33,403,-329,1148,256,196,1051,47
13,-11,0,13.0,-11.0,0.3728346824645996,480.2136723102821,33,390,-318,1148,256,196,1051,47
12,-9,0,12.0,-9.0,0.38077569007873535,465.2263819172413,33,378,-309,1148,256,196,1051,47
10,-8,0,10.0,-8.0,0.38870668411254883,452.4208661806926,33,368,-301,1148,256,196,1051,47
8,-7,0,8.0,-7.0,0.39676666259765625,441.79672976474353,33,360,-294,1148,256,196,1051,47
6,-5,0,6.0,-5.0,0.4047048091888428,433.98687070855766,33,354,-289,1148,256,196,1051,47
5,-4,0,5.0,-4.0,0.412799596786499,427.58406540844294,33,349,-285,1148,256,196,1051,47
7,-5,0,7.0,-5.0,0.42058277130126953,419.0,33,342,-280,1148,256,196,1051,47
10,-7,0,10.0,-7.0,0.4286208152770996,406.82903578050656,33,332,-273,1148,256,196,1051,47
10,-7,0,10.0,-7.0,0.43674468994140625,394.6601489249363,33,322,-266,1148,256,196,1051,47
10,-6,0,10.0,-6.0,0.4446277618408203,383.13298314714604,33,312,-260,1148,256,196,1051,47
10,-7,0,10.0,-7.0,0.4527747631072998,370.97081110153323,33,302,-253,1148,256,196,1051,47
11,-7,0,11.0,-7.0,0.4605827331542969,358.0472411657116,33,291,-246,1148,256,196,1051,47
12,-9,0,12.0,-9.0,0.4687516689300537,343.0737630587584,33,279,-237,1148,256,196,1051,47
10,-8,0,10.0,-8.0,0.4767026901245117,330.2732653343584,33,269,-229,1148,256,196,1051,47
11,-8,0,11.0,-8.0,0.4847288131713867,316.7131142596647,33,258,-221,1148,256,196,1051,47
9,-7,0,9.0,-7.0,0.4926877021789551,305.3245345690754,33,249,-214,1148,256,196,1051,47
10,-7,0,10.0,-7.0,0.5007166862487793,293.1803282938393,33,239,-207,1148,256,196,1051,47
9,-7,0,9.0,-7.0,0.5086758136749268,281.7950130825634,33,230,-200,1148,256,196,1051,47
11,-6,0,11.0,-6.0,0.5167567729949951,269.56964982718216,33,219,-194,1148,256,196,1051,47
8,-6,0,8.0,-6.0,0.5247306823730469,259.60396317107796,33,211,-188,1148,256,196,1051,47
10,-8,0,10.0,-8.0,0.5327696800231934,246.81660438156877,33,201,-180,1148,256,196,1051,47
11,-7,0,11.0,-7.0,0.540705680847168,233.96108654813867,33,190,-173,1148,256,196,1051,47
11,-9,0,11.0,-9.0,0.5487077236175537,219.76943794472976,33,179,-164,1148,256,196,1051,47
11,-8,0,11.0,-8.0,0.556586742401123,206.2596780945136,33,168,-156,1148,256,196,1051,47
9,-8,0,9.0,-8.0,0.5646157264709473,194.22108553268947,33,159,-148,1148,256,196,1051,47
8,-7,0,8.0,-7.0,0.5726337432861328,183.59622455408038,33,151,-141,1148,256,196,1051,47
8,-8,0,8.0,-8.0,0.5806066989898682,172.28952864913163,33,143,-133,1148,256,196,1051,47
7,-7,0,7.0,-7.0,0.5885956287384033,162.39687160251654,33,136,-126,1148,256,196,1051,47
7,-7,0,7.0,-7.0,0.5967767238616943,152.50498568416796,33,129,-119,1148,256,196,1051,47
7,-6,0,7.0,-6.0,0.604724645614624,143.29191201017565,33,122,-113,1148,256,196,1051,47
7,-6,0,7.0,-6.0,0.61271071434021,134.07959765672945,33,115,-107,1148,256,196,1051,47
8,-7,0,8.0,-7.0,0.6207077503204346,123.45477117526761,33,107,-100,1148,256,196,1051,47
8,-7,0,8.0,-7.0,0.6287558078765869,112.83077707206124,33,99,-93,1148,256,196,1051,47
8,-6,0,8.0,-6.0,0.6365966796875,102.89678312014172,33,91,-87,1148,256,196,1051,47
7,-6,0,7.0,-6.0,0.6446347236633301,93.69190203266035,33,84,-81,1148,256,196,1051,47
6,-5,0,6.0,-5.0,0.6527547836303711,85.90362712049586,33,78,-76,1148,256,196,1051,47
5,-4,0,5.0,-4.0,0.6606547832489014,79.53292154230269,33,73,-72,1148,256,196,1051,47
3,-3,0,3.0,-3.0,0.6686677932739258,75.29038610159185,33,70,-69,1148,256,196,1051,47
4,-4,0,4.0,-4.0,0.6766917705535889,69.63368717696602,33,66,-65,1148,256,196,1051,47
4,-3,0,4.0,-3.0,0.6846988201141357,64.68124086713189,33,62,-62,1148,256,196,1051,47
3,-2,0,3.0,-2.0,0.6926767826080322,61.1486779456457,33,59,-60,1148,256,196,1051,47
4,-3,0,4.0,-3.0,0.7007896900177002,56.20858539325141,33,55,-57,1148,256,196,1051,47
3,-3,0,3.0,-3.0,0.7087647914886475,51.966659255965254,33,52,-54,1148,256,196,1051,47
2,-1,0,2.0,-1.0,0.7165937423706055,49.862884927787476,33,50,-53,1148,256,196,1051,47
1,-1,0,1.0,-1.0,0.7246837615966797,48.449282711585,33,49,-52,1148,256,196,1051,47
2,-2,0,2.0,-2.0,0.7327497005462646,45.62215385719105,33,47,-50,1148,256,196,1051,47
2,-1,0,2.0,-1.0,0.7407107353210449,43.528189513919585,33,45,-49,1148,256,196,1051,47
2,-2,0,2.0,-2.0,0.7487547397613525,40.702433234531945,33,43,-47,1148,256,196,1051,47
2,-2,0,2.0,-2.0,0.756706714630127,37.876925020897694,33,41,-45,1148,256,196,1051,47
2,-1,0,2.0,-1.0,0.7647206783294678,35.7962583843564,33,39,-44,1148,256,196,1051,47
1,-1,0,1.0,-1.0,0.7727046012878418,34.38466694161429,33,38,-43,1148,256,196,1051,47
1,-1,0,1.0,-1.0,0.7805907726287842,32.97320787662612,33,37,-42,1148,256,196,1051,47
2,-2,0,2.0,-2.0,0.7887008190155029,30.150729063673246,33,35,-40,1148,256,196,1051,47
2,-2,0,2.0,-2.0,0.7968096733093262,27.328918128646478,33,33,-38,1148,256,196,1051,47
3,-3,0,3.0,-3.0,0.8046896457672119,23.09772228646444,33,30,-35,1148,256,196,1051,47
3,-3,0,3.0,-3.0,0.812647819519043,18.86884283091664,33,27,-32,1148,256,196,1051,47
4,-4,0,4.0,-4.0,0.8207037448883057,13.235341863986875,33,23,-28,1148,256,196,1051,47
5,-4,0,5.0,-4.0,0.8286588191986084,7.0,33,18,-24,1148,256,196,1051,47
5,-5,0,5.0,-5.0,0.8366706371307373,0.021728866442675354,33,13,-19,1148,256,196,1051,47
3,-3,0,3.0,-3.0,0.8449428081512451,-4.132037735886794,33,10,-16,1148,256,196,1051,47
4,-4,0,4.0,-4.0,0.8526337146759033,-9.583592135001261,33,6,-12,1148,256,196,1051,47
3,-3,0,3.0,-3.0,0.8606386184692383,-13.513167019494862,33,3,-9,1148,256,196,1051,47
3,-3,0,3.0,-3.0,0.8687167167663574,-17.0,33,0,-6,1148,256,196,1051,47
1,-1,0,1.0,-1.0,0.8769106864929199,-17.900980486407214,33,-1,-5,1148,256,196,1051,47
0,0,1,-0.0,-0.0,0.8817036151885986,-17.900980486407214,33,-1,-5,1148,256,196,1051,47
0,0,0,-0.0,-0.0,0.09003901481628418,504.40003835826485,34,-417,313,732,574,1149,261,34
-6,4,0,-6.0,4.0,0.18697404861450195,497.2003500582239,34,-411,309,732,574,1149,261,34
-11,9,0,-11.0,9.0,0.19490909576416016,483.0,34,-400,300,732,574,1149,261,34
-16,13,0,-16.0,13.0,0.20291399955749512,462.40066750057827,34,-384,287,732,574,1149,261,34
-19,15,0,-19.0,15.0,0.21103119850158691,438.20215289473316,34,-365,272,732,574,1149,261,34
-20,18,0,-20.0,18.0,0.21895503997802734,411.4168530765334,34,-345,254,732,574,1149,261,34
-19,18,0,-19.0,18.0,0.22705817222595215,385.45745116720104,34,-326,236,732,574,1149,261,34
-22,20,0,-22.0,20.0,0.23497509956359863,355.9235846658133,34,-304,216,732,574,1149,261,34
-22,19,0,-22.0,19.0,0.24301505088806152,326.99563950724723,34,-282,197,732,574,1149,261,34
-19,15,0,-19.0,15.0,0.25106120109558105,302.8327688026979,34,-263,182,732,574,1149,261,34
-17,14,0,-17.0,14.0,0.25893521308898926,280.89259809535383,34,-246,168,732,574,1149,261,34
-13,12,0,-13.0,12.0,0.2670609951019287,263.40149785619906,34,-233,156,732,574,1149,261,34
-11,9,0,-11.0,9.0,0.27503418922424316,249.2573942635209,34,-222,147,732,574,1149,261,34
-10,9,0,-10.0,9.0,0.28285813331604004,235.9584946191766,34,-212,138,732,574,1149,261,34
-11,8,0,-11.0,8.0,0.29102206230163574,222.3762728425689,34,-201,130,732,574,1149,261,34
-9,7,0,-9.0,7.0,0.2989661693572998,211.01973598791838,34,-192,123,732,574,1149,261,34
-9,8,0,-9.0,8.0,0.3069760799407959,199.1342175593675,34,-183,115,732,574,1149,261,34
-10,6,0,-10.0,6.0,0.31507205963134766,187.47493733951845,34,-173,109,732,574,1149,261,34
-11,7,0,-11.0,7.0,0.323012113571167,174.43667360252581,34,-162,102,732,574,1149,261,34
-10,5,0,-10.0,5.0,0.330916166305542,163.31361568112376,34,-152,97,732,574,1149,261,34
-9,5,0,-9.0,5.0,0.3388850688934326,153.03823099526764,34,-143,92,732,574,1149,261,34
-8,4,0,-8.0,4.0,0.3469841480255127,144.14899937635357,34,-135,88,732,574,1149,261,34
-7,3,0,-7.0,3.0,0.3549680709838867,136.6522046701576,34,-128,85,732,574,1149,261,34
-7,3,0,-7.0,3.0,0.3630561828613281,129.16771189288008,34,-121,82,732,574,1149,261,34
-7,4,0,-7.0,4.0,0.3710160255432129,121.13037319865606,34,-114,78,732,574,1149,261,34
-9,4,0,-9.0,4.0,0.37903404235839844,111.4562182223967,34,-105,74,732,574,1149,261,34
-8,3,0,-8.0,3.0,0.3870360851287842,103.20815280171308,34,-97,71,732,574,1149,261,34
-8,3,0,-8.0,3.0,0.3949282169342041,95.0044641967453,34,-89,68,732,574,1149,261,34
-8,3,0,-8.0,3.0,0.4029271602630615,86.85566907973777,34,-81,65,732,574,1149,261,34
-7,3,0,-7.0,3.0,0.41098904609680176,79.54014708917737,34,-74,62,732,574,1149,261,34
-6,3,0,-6.0,3.0,0.4189271926879883,73.02777349240623,34,-68,59,732,574,1149,261,34
-6,3,0,-6.0,3.0,0.4270811080932617,66.54639429682169,34,-62,56,732,574,1149,261,34
-5,3,0,-5.0,3.0,0.43505406379699707,60.833154889160184,34,-57,53,732,574,1149,261,34
-4,2,0,-4.0,2.0,0.442965030670166,56.55270219373317,34,-53,51,732,574,1149,261,34
-3,2,0,-3.0,2.0,0.4510030746459961,53.00714249274856,34,-50,49,732,574,1149,261,34
-1,1,0,-1.0,1.0,0.4590132236480713,51.59300255857006,34,-49,48,732,574,1149,261,34
-2,1,0,-2.0,1.0,0.4669790267944336,49.468037431535464,34,-47,47,732,574,1149,261,34
-1,1,0,-1.0,1.0,0.4749150276184082,48.05382386916237,34,-46,46,732,574,1149,261,34
-1,1,0,-1.0,1.0,0.4829142093658447,46.63961030678928,34,-45,45,732,574,1149,261,34
-2,2,0,-2.0,2.0,0.4908912181854248,43.81118318204309,34,-43,43,732,574,1149,261,34
-2,2,0,-2.0,2.0,0.4990100860595703,40.982756057296896,34,-41,41,732,574,1149,261,34
-2,2,0,-2.0,2.0,0.5070950984954834,38.154328932550705,34,-39,39,732,574,1149,261,34
-2,2,0,-2.0,2.0,0.5150480270385742,35.32590180780452,34,-37,37,732,574,1149,261,34
-2,4,0,-2.0,4.0,0.5230021476745605,31.104053883222775,34,-35,33,732,574,1149,261,34
-3,2,0,-3.0,2.0,0.5309979915618896,27.553338819890925,34,-32,31,732,574,1149,261,34
-3,4,0,-3.0,4.0,0.5390181541442871,22.6232255123179,34,-29,27,732,574,1149,261,34
-3,3,0,-3.0,3.0,0.5471420288085938,18.383612025908263,34,-26,24,732,574,1149,261,34
-3,3,0,-3.0,3.0,0.5553560256958008,14.144823004794873,34,-23,21,732,574,1149,261,34
-2,3,0,-2.0,3.0,0.5628561973571777,10.658633371878661,34,-21,18,732,574,1149,261,34
-1,2,0,-1.0,2.0,0.5709400177001953,8.612496949731394,34,-20,16,732,574,1149,261,34
-2,2,0,-2.0,2.0,0.5789101123809814,5.803508501982758,34,-18,14,732,574,1149,261,34
-2,1,0,-2.0,1.0,0.5870511531829834,3.615528128088304,34,-16,13,732,574,1149,261,34
-1,3,0,-1.0,3.0,0.5949850082397461,1.027756377319946,34,-15,10,732,574,1149,261,34
-2,1,0,-2.0,1.0,0.6030302047729492,-1.1886116991581037,34,-13,9,732,574,1149,261,34
-2,2,0,-2.0,2.0,0.6110460758209229,-3.9615951895947017,34,-11,7,732,574,1149,261,34
-1,2,0,-1.0,2.0,0.619002103805542,-5.819660112501051,34,-10,5,732,574,1149,261,34
-2,1,0,-2.0,1.0,0.6270930767059326,-8.05572809000084,34,-8,4,732,574,1149,261,34
0,1,0,-0.0,1.0,0.634958028793335,-8.45599625468247,34,-8,3,732,574,1149,261,34
-1,1,0,-1.0,1.0,0.6428952217102051,-9.719890110719483,34,-7,2,732,574,1149,261,34
-1,1,0,-1.0,1.0,0.6509561538696289,-10.917237469701782,34,-6,1,732,574,1149,261,34
0,0,1,-0.0,-0.0,0.6570250988006592,-10.917237469701782,34,-6,1,732,574,1149,261,34
0,0,0,-0.0,-0.0,0.09768486022949219,593.420776727303,35,592,136,1330,709,738,573,29
2,0,0,2.0,-0.0,0.1478726863861084,591.4717169282146,35,590,136,1330,709,738,573,29
2,1,0,2.0,1.0,0.15573573112487793,589.2984336130834,35,588,135,1330,709,738,573,29
1,0,0,1.0,-0.0,0.16379380226135254,588.3238331661798,35,587,135,1330,709,738,573,29
1,0,0,1.0,-0.0,0.17175984382629395,587.3493161216699,35,586,135,1330,709,738,573,29
2,0,0,2.0,-0.0,0.17978286743164062,585.4005338669627,35,584,135,1330,709,738,573,29
5,-1,0,5.0,-1.0,0.18763184547424316,580.7579339529655,35,579,136,1330,709,738,573,29
8,-1,0,8.0,-1.0,0.19575071334838867,573.205245208181,35,571,137,1330,709,738,573,29
13,-2,0,13.0,-2.0,0.20366787910461426,561.0521715461998,35,558,139,1330,709,738,573,29
18,0,0,18.0,-0.0,0.21172881126403809,543.602905300896,35,540,139,1330,709,738,573,29
28,0,0,28.0,-0.0,0.2197706699371338,516.5327511096747,35,512,139,1330,709,738,573,29
34,1,0,34.0,1.0,0.22773075103759766,483.5218588162735,35,478,138,1330,709,738,573,29
37,3,0,37.0,3.0,0.23580384254455566,447.20060711148244,35,441,135,1330,709,738,573,29
40,6,0,40.0,6.0,0.24388980865478516,407.23864969871886,35,401,129,1330,709,738,573,29
38,6,0,38.0,6.0,0.2518486976623535,369.27274883560403,35,363,123,1330,709,738,573,29
37,7,0,37.0,7.0,0.2596738338470459,332.0231206147936,35,326,116,1330,709,738,573,29
35,7,0,35.0,7.0,0.2677648067474365,296.7442678473732,35,291,109,1330,709,738,573,29
32,9,0,32.0,9.0,0.2757296562194824,263.6346520159182,35,259,100,1330,709,738,573,29
29,8,0,29.0,8.0,0.28378987312316895,233.7175811281872,35,230,92,1330,709,738,573,29
25,8,0,25.0,8.0,0.2917287349700928,207.54232101339014,35,205,84,1330,709,738,573,29
23,7,0,23.0,7.0,0.29977989196777344,183.61831898890347,35,182,77,1330,709,738,573,29
19,5,0,19.0,5.0,0.3081667423248291,164.1937148162078,35,163,72,1330,709,738,573,29
16,4,0,16.0,4.0,0.3157658576965332,147.9660458244258,35,147,68,1330,709,738,573,29
12,3,0,12.0,3.0,0.323772668838501,135.83324063771698,35,135,65,1330,709,738,573,29
11,2,0,11.0,2.0,0.33172178268432617,125.08630414242805,35,124,63,1330,709,738,573,29
9,2,0,9.0,2.0,0.33964085578918457,116.17680284904833,35,115,61,1330,709,738,573,29
8,1,0,8.0,1.0,0.34766578674316406,108.67436570041843,35,107,60,1330,709,738,573,29
9,2,0,9.0,2.0,0.35570573806762695,99.87712676389407,35,98,58,1330,709,738,573,29
9,1,0,9.0,1.0,0.3636598587036133,91.6882207249228,35,89,57,1330,709,738,573,29
8,1,0,8.0,1.0,0.37164974212646484,84.4733466477097,35,81,56,1330,709,738,573,29
8,2,0,8.0,2.0,0.3798198699951172,76.80198235721508,35,73,54,1330,709,738,573,29
8,1,0,8.0,1.0,0.3878438472747803,69.86894538504703,35,65,53,1330,709,738,573,29
6,1,0,6.0,1.0,0.39835572242736816,64.64477096412705,35,59,52,1330,709,738,573,29
3,1,0,3.0,1.0,0.4094228744506836,61.742986473996396,35,56,51,1330,709,738,573,29
3,1,0,3.0,1.0,0.4118678569793701,58.862884927787476,35,53,50,1330,709,738,573,29
1,1,0,1.0,1.0,0.41983485221862793,57.449282711585,35,52,49,1330,709,738,573,29
1,1,0,1.0,1.0,0.42783284187316895,56.03570517957252,35,51,48,1330,709,738,573,29
1,1,0,1.0,1.0,0.43566179275512695,54.62215385719105,35,50,47,1330,709,738,573,29
1,1,0,1.0,1.0,0.4436628818511963,53.208630398186216,35,49,46,1330,709,738,573,29
0,1,0,-0.0,1.0,0.4518706798553467,52.528189513919585,35,49,45,1330,709,738,573,29
1,1,0,1.0,1.0,0.46014881134033203,51.115282384398824,35,48,44,1330,709,738,573,29
0,2,0,-0.0,2.0,0.46767568588256836,49.7808748764079,35,48,42,1330,709,738,573,29
0,2,0,-0.0,2.0,0.47562074661254883,48.48199740725323,35,48,40,1330,709,738,573,29
0,1,0,-0.0,1.0,0.4837508201599121,47.84658438426491,35,48,39,1330,709,738,573,29
0,3,0,-0.0,3.0,0.4917008876800537,46.0,35,48,36,1330,709,738,573,29
1,2,0,1.0,2.0,0.49983978271484375,44.008620049092706,35,47,34,1330,709,738,573,29
1,3,0,1.0,3.0,0.5078527927398682,41.47071299343465,35,46,31,1330,709,738,573,29
1,3,0,1.0,3.0,0.5157308578491211,39.0,35,45,28,1330,709,738,573,29
3,3,0,3.0,3.0,0.5236508846282959,34.877397639399746,35,42,25,1330,709,738,573,29
2,3,0,2.0,3.0,0.5316717624664307,31.650848842053307,35,40,22,1330,709,738,573,29
3,2,0,3.0,2.0,0.5399417877197266,28.059481689626182,35,37,20,1330,709,738,573,29
3,2,0,3.0,2.0,0.5522058010101318,24.470768123342687,35,34,18,1330,709,738,573,29
5,3,0,5.0,3.0,0.5572986602783203,18.649655434629018,35,29,15,1330,709,738,573,29
5,2,0,5.0,2.0,0.5636427402496338,13.294688127912362,35,24,13,1330,709,738,573,29
5,3,0,5.0,3.0,0.5718088150024414,7.470910553583888,35,19,10,1330,709,738,573,29
2,1,0,2.0,1.0,0.5853216648101807,5.235384061671343,35,17,9,1330,709,738,573,29
3,2,0,3.0,2.0,0.5878727436065674,1.6524758424985286,35,14,7,1330,709,738,573,29
2,1,0,2.0,1.0,0.5956897735595703,-0.5835921350012612,35,12,6,1330,709,738,573,29
3,2,0,3.0,2.0,0.607123851776123,-4.151142198203896,35,9,4,1330,709,738,573,29
2,1,0,2.0,1.0,0.6117827892303467,-6.384226894136091,35,7,3,1330,709,738,573,29
3,1,0,3.0,1.0,0.6197316646575928,-9.52786404500042,35,4,2,1330,709,738,573,29
3,1,0,3.0,1.0,0.6277086734771729,-12.585786437626904,35,1,1,1330,709,738,573,29
3,0,0,3.0,-0.0,0.6356587409973145,-11.76393202250021,35,-2,1,1330,709,738,573,29
2,1,0,2.0,1.0,0.6437628269195557,-10.0,35,-4,0,1330,709,738,573,29
1,0,0,1.0,-0.0,0.6596508026123047,-9.0,35,-5,0,1330,709,738,573,29
0,0,1,-0.0,-0.0,0.6997287273406982,-9.0,35,-5,0,1330,709,738,573,29
0,0,0,-0.0,-0.0,0.09805154800415039,598.5129841973707,36,-597,107,738,816,1335,709,16
-2,0,0,-2.0,-0.0,0.14504456520080566,596.5444565952118,36,-595,107,738,816,1335,709,16
-2,0,0,-2.0,-0.0,0.15310335159301758,594.5761362682728,36,-593,107,738,816,1335,709,16
-2,0,0,-2.0,-0.0,0.1611645221710205,592.6080252544083,36,-591,107,738,816,1335,709,16
-3,0,0,-3.0,-0.0,0.16899657249450684,589.6562557189542,36,-588,107,738,816,1335,709,16
-3,0,0,-3.0,-0.0,0.1770775318145752,586.7049688711202,36,-585,107,738,816,1335,709,16
-3,-1,0,-3.0,-1.0,0.18535256385803223,583.9358073304909,36,-582,108,738,816,1335,709,16
-3,0,0,-3.0,-0.0,0.19317245483398438,580.9864175004378,36,-579,108,738,816,1335,709,16
-4,-1,0,-4.0,-1.0,0.20109343528747559,577.2401216594775,36,-575,109,738,816,1335,709,16
-4,0,0,-4.0,-0.0,0.20927953720092773,573.3105882400561,36,-571,109,738,816,1335,709,16
-9,0,0,-9.0,-0.0,0.21705341339111328,564.4727067729955,36,-562,109,738,816,1335,709,16
-11,0,0,-11.0,-0.0,0.22507238388061523,553.6778436078816,36,-551,109,738,816,1335,709,16
-15,0,0,-15.0,-0.0,0.2330164909362793,538.9707487608455,36,-536,109,738,816,1335,709,16
-17,0,0,-17.0,-0.0,0.24115443229675293,522.3225433639419,36,-519,109,738,816,1335,709,16
-18,0,0,-18.0,-0.0,0.2491164207458496,504.7201965984956,36,-501,109,738,816,1335,709,16
-18,2,0,-18.0,2.0,0.25706934928894043,486.7100160700206,36,-483,107,738,816,1335,709,16
-19,1,0,-19.0,1.0,0.2650644779205322,467.9537792685336,36,-464,106,738,816,1335,709,16
-19,2,0,-19.0,2.0,0.2730865478515625,448.99124718094987,36,-445,104,738,816,1335,709,16
-21,4,0,-21.0,4.0,0.2810535430908203,427.63287295611656,36,-424,100,738,816,1335,709,16
-21,4,0,-21.0,4.0,0.2891573905944824,406.2764777295472,36,-403,96,738,816,1335,709,16
-26,4,0,-26.0,4.0,0.2970924377441406,380.06313919258037,36,-377,92,738,816,1335,709,16
-24,4,0,-24.0,4.0,0.3050415515899658,355.8035183996988,36,-353,88,738,816,1335,709,16
-24,5,0,-24.0,5.0,0.31307148933410645,331.3081195609678,36,-329,83,738,816,1335,709,16
-24,5,0,-24.0,5.0,0.32097554206848145,306.8158191705112,36,-305,78,738,816,1335,709,16
-22,5,0,-22.0,5.0,0.32920336723327637,284.26357966739545,36,-283,73,738,816,1335,709,16
-22,6,0,-22.0,6.0,0.33695340156555176,261.462427807663,36,-261,67,738,816,1335,709,16
-22,6,0,-22.0,6.0,0.34528255462646484,238.661711661944,36,-239,61,738,816,1335,709,16
-20,4,0,-20.0,4.0,0.35308837890625,218.29626598775332,36,-219,57,738,816,1335,709,16
-17,4,0,-17.0,4.0,0.36116957664489746,200.83725721240452,36,-202,53,738,816,1335,709,16
-14,4,0,-14.0,4.0,0.36918044090270996,186.28072472584614,36,-188,49,738,816,1335,709,16
-13,3,0,-13.0,3.0,0.37714052200317383,172.9447429465692,36,-175,46,738,816,1335,709,16
-10,2,0,-10.0,2.0,0.38508057594299316,162.76592165886026,36,-165,44,738,816,1335,709,16
-11,3,0,-11.0,3.0,0.3931443691253662,151.3643623900902,36,-154,41,738,816,1335,709,16
-8,2,0,-8.0,2.0,0.40100836753845215,143.11915828246265,36,-146,39,738,816,1335,709,16
-7,2,0,-7.0,2.0,0.4091014862060547,135.8401890988746,36,-139,37,738,816,1335,709,16
-8,2,0,-8.0,2.0,0.41718053817749023,127.5949851580065,36,-131,35,738,816,1335,709,16
-7,2,0,-7.0,2.0,0.4250364303588867,120.31601614763451,36,-124,33,738,816,1335,709,16
-6,2,0,-6.0,2.0,0.4330425262451172,114.00409829181969,36,-118,31,738,816,1335,709,16
-3,1,0,-3.0,1.0,0.4411303997039795,110.84864324004712,36,-115,30,738,816,1335,709,16
-2,1,0,-2.0,1.0,0.4491734504699707,108.66190466471906,36,-113,29,738,816,1335,709,16
-3,1,0,-3.0,1.0,0.45713257789611816,105.50770898930169,36,-110,28,738,816,1335,709,16
-3,2,0,-3.0,2.0,0.46508240699768066,102.11357772772621,36,-107,26,738,816,1335,709,16
-3,1,0,-3.0,1.0,0.47315335273742676,98.96261028976434,36,-104,25,738,816,1335,709,16
-4,2,0,-4.0,2.0,0.48107242584228516,94.61091559868278,36,-100,23,738,816,1335,709,16
-3,2,0,-3.0,2.0,0.48915743827819824,91.24716620639605,36,-97,21,738,816,1335,709,16
-2,1,0,-2.0,1.0,0.49708056449890137,89.082439194738,36,-95,20,738,816,1335,709,16
-2,2,0,-2.0,2.0,0.5050454139709473,86.72592042308166,36,-93,18,738,816,1335,709,16
-2,2,0,-2.0,2.0,0.5131595134735107,84.39588735436226,36,-91,16,738,816,1335,709,16
-1,1,0,-1.0,1.0,0.5210413932800293,83.2414379544733,36,-90,15,738,816,1335,709,16
-2,2,0,-2.0,2.0,0.5290734767913818,80.95504482602435,36,-88,13,738,816,1335,709,16
-2,3,0,-2.0,3.0,0.5371005535125732,78.57944328765345,36,-86,10,738,816,1335,709,16
-2,2,0,-2.0,2.0,0.5450475215911865,76.38009243891595,36,-84,8,738,816,1335,709,16
-3,3,0,-3.0,3.0,0.553025484085083,73.15417426109393,36,-81,5,738,816,1335,709,16
-2,2,0,-2.0,2.0,0.5610215663909912,71.05694150420949,36,-79,3,738,816,1335,709,16
-3,2,0,-3.0,2.0,0.5691115856170654,68.00657866263946,36,-76,1,738,816,1335,709,16
-2,1,0,-2.0,1.0,0.5770654678344727,66.0,36,-74,0,738,816,1335,709,16
-3,1,0,-3.0,1.0,0.5850844383239746,63.00704190430693,36,-71,-1,738,816,1335,709,16
-2,1,0,-2.0,1.0,0.5932433605194092,61.02897942168927,36,-69,-2,738,816,1335,709,16
-3,1,0,-3.0,1.0,0.6010653972625732,58.06814663663572,36,-66,-3,738,816,1335,709,16
-4,1,0,-4.0,1.0,0.6090054512023926,54.12889826803627,36,-62,-4,738,816,1335,709,16
-3,0,0,-3.0,-0.0,0.6170854568481445,51.135437767890075,36,-59,-4,738,816,1335,709,16
-4,0,0,-4.0,-0.0,0.6251204013824463,47.14526271584895,36,-55,-4,738,816,1335,709,16
-4,0,0,-4.0,-0.0,0.6332063674926758,43.15662224971465,36,-51,-4,738,816,1335,709,16
-3,0,0,-3.0,-0.0,0.6415584087371826,40.16637831516918,36,-48,-4,738,816,1335,709,16
-4,1,0,-4.0,1.0,0.6490495204925537,36.28317965096906,36,-44,-5,738,816,1335,709,16
-4,1,0,-4.0,1.0,0.6570744514465332,32.44749683231337,36,-40,-6,738,816,1335,709,16
-3,0,0,-3.0,-0.0,0.6650464534759521,29.483329627982627,36,-37,-6,738,816,1335,709,16
-5,0,0,-5.0,-0.0,0.6731114387512207,24.557641192199412,36,-32,-6,738,816,1335,709,16
-4,0,0,-4.0,-0.0,0.6810624599456787,20.635642126552707,36,-28,-6,738,816,1335,709,16
-4,1,0,-4.0,1.0,0.6890673637390137,17.0,36,-24,-7,738,816,1335,709,16
-4,0,0,-4.0,-0.0,0.6970665454864502,13.189620100417091,36,-20,-7,738,816,1335,709,16
-3,0,0,-3.0,-0.0,0.705040454864502,10.384776310850235,36,-17,-7,738,816,1335,709,16
-3,0,0,-3.0,-0.0,0.7135524749755859,7.652475842498529,36,-14,-7,738,816,1335,709,16
-3,0,0,-3.0,-0.0,0.7211825847625732,5.038404810405298,36,-11,-7,738,816,1335,709,16
-2,0,0,-2.0,-0.0,0.7290384769439697,3.401754250991379,36,-9,-7,738,816,1335,709,16
-1,0,0,-1.0,-0.0,0.7370884418487549,2.63014581273465,36,-8,-7,738,816,1335,709,16
-1,0,0,-1.0,-0.0,0.7450554370880127,1.8994949366116654,36,-7,-7,738,816,1335,709,16
-1,0,0,-1.0,-0.0,0.7529785633087158,1.219544457292887,36,-6,-7,738,816,1335,709,16
-1,0,0,-1.0,-0.0,0.7610204219818115,0.6023252670426267,36,-5,-7,738,816,1335,709,16
-1,0,0,-1.0,-0.0,0.7691144943237305,0.06225774829854913,36,-4,-7,738,816,1335,709,16
0,0,1,-0.0,-0.0,0.8609914779663086,0.06225774829854913,36,-4,-7,738,816,1335,709,16
0,0,0,-0.0,-0.0,0.07338452339172363,689.4806322849265,37,-142,-689,600,134,742,823,29
1,0,0,1.0,-0.0,0.12046337127685547,689.6831673416666,37,-143,-689,600,134,742,823,29
2,0,0,2.0,-0.0,0.12837743759155273,690.0923234917421,37,-145,-689,600,134,742,823,29
2,0,0,2.0,-0.0,0.1369304656982422,690.5069197672937,37,-147,-689,600,134,742,823,29
2,-1,0,2.0,-1.0,0.14435553550720215,689.9495720575445,37,-149,-688,600,134,742,823,29
3,0,0,3.0,-0.0,0.15233135223388672,690.5906613062651,37,-152,-688,600,134,742,823,29
5,-2,0,5.0,-2.0,0.16029143333435059,689.7364563528025,37,-157,-686,600,134,742,823,29
8,-4,0,8.0,-4.0,0.16837048530578613,687.6758510879507,37,-165,-682,600,134,742,823,29
7,-2,0,7.0,-2.0,0.17636346817016602,687.4157112583093,37,-172,-680,600,134,742,823,29
5,-3,0,5.0,-3.0,0.18439340591430664,685.7556716454679,37,-177,-677,600,134,742,823,29
4,-3,0,4.0,-3.0,0.192596435546875,683.8803622398326,37,-181,-674,600,134,742,823,29
5,-5,0,5.0,-5.0,0.20031332969665527,680.3752587758294,37,-186,-669,600,134,742,823,29
6,-7,0,6.0,-7.0,0.20833635330200195,675.2807845863687,37,-192,-662,600,134,742,823,29
7,-8,0,7.0,-8.0,0.21625852584838867,669.6058806066549,37,-199,-654,600,134,742,823,29
7,-10,0,7.0,-10.0,0.22452354431152344,662.1449548728439,37,-206,-644,600,134,742,823,29
5,-8,0,5.0,-8.0,0.23241639137268066,656.0873077442968,37,-211,-636,600,134,742,823,29
2,-10,0,2.0,-10.0,0.24033546447753906,647.2450377885644,37,-213,-626,600,134,742,823,29
2,-10,0,2.0,-10.0,0.2483973503112793,638.4423346166311,37,-215,-616,600,134,742,823,29
0,-14,0,-0.0,-14.0,0.25640034675598145,625.2409561346957,37,-215,-602,600,134,742,823,29
0,-21,0,-0.0,-21.0,0.26433539390563965,605.5046408220038,37,-215,-581,600,134,742,823,29
-2,-23,0,-2.0,-23.0,0.2725844383239746,583.271295141496,37,-213,-558,600,134,742,823,29
-4,-25,0,-4.0,-25.0,0.28038644790649414,558.5120086076797,37,-209,-533,600,134,742,823,29
-6,-23,0,-6.0,-23.0,0.2882204055786133,534.9162048983433,37,-203,-510,600,134,742,823,29
-7,-24,0,-7.0,-24.0,0.29637932777404785,510.0343500191567,37,-196,-486,600,134,742,823,29
-8,-24,0,-8.0,-24.0,0.3044764995574951,484.78652748445404,37,-188,-462,600,134,742,823,29
-7,-25,0,-7.0,-25.0,0.3123784065246582,459.0010570812712,37,-181,-437,600,134,742,823,29
-8,-25,0,-8.0,-25.0,0.3204634189605713,432.84784882552583,37,-173,-412,600,134,742,823,29
-7,-23,0,-7.0,-23.0,0.32836055755615234,408.93852981254855,37,-166,-389,600,134,742,823,29
-9,-23,0,-9.0,-23.0,0.33623337745666504,384.25243250983414,37,-157,-366,600,134,742,823,29
-9,-20,0,-9.0,-20.0,0.34444546699523926,362.3243282064023,37,-148,-346,600,134,742,823,29
-9,-19,0,-9.0,-19.0,0.35236549377441406,341.31676008879737,37,-139,-327,600,134,742,823,29
-9,-17,0,-9.0,-17.0,0.3603634834289551,322.1547262794322,37,-130,-310,600,134,742,823,29
-7,-17,0,-7.0,-17.0,0.3683934211730957,303.77035733371986,37,-123,-293,600,134,742,823,29
-6,-14,0,-6.0,-14.0,0.3764164447784424,288.539253651489,37,-117,-279,600,134,742,823,29
-4,-13,0,-4.0,-13.0,0.3842043876647949,275.0069203323685,37,-113,-266,600,134,742,823,29
-3,-11,0,-3.0,-11.0,0.3924064636230469,263.71388153997634,37,-110,-255,600,134,742,823,29
-3,-12,0,-3.0,-12.0,0.40032434463500977,251.51459470243816,37,-107,-243,600,134,742,823,29
-2,-10,0,-2.0,-10.0,0.40835142135620117,241.56603843233944,37,-105,-233,600,134,742,823,29
-2,-10,0,-2.0,-10.0,0.4166593551635742,231.63794495150785,37,-103,-223,600,134,742,823,29
-2,-8,0,-2.0,-8.0,0.42438244819641113,223.54157530840786,37,-101,-215,600,134,742,823,29
-1,-8,0,-1.0,-8.0,0.4323873519897461,215.88910370002316,37,-100,-207,600,134,742,823,29
-1,-6,0,-1.0,-6.0,0.44028735160827637,210.05802819805407,37,-99,-201,600,134,742,823,29
-1,-6,0,-1.0,-6.0,0.44847941398620605,204.24069281414958,37,-98,-195,600,134,742,823,29
-1,-7,0,-1.0,-7.0,0.4564495086669922,197.5490486861144,37,-97,-188,600,134,742,823,29
-1,-5,0,-1.0,-5.0,0.4643523693084717,192.65188119153427,37,-96,-183,600,134,742,823,29
-2,-7,0,-2.0,-7.0,0.47240734100341797,185.52944644838766,37,-94,-176,600,134,742,823,29
-2,-7,0,-2.0,-7.0,0.4803783893585205,178.41881404893857,37,-92,-169,600,134,742,823,29
-3,-6,0,-3.0,-6.0,0.48824238777160645,171.71483516402236,37,-89,-163,600,134,742,823,29
-3,-7,0,-3.0,-7.0,0.4964125156402588,164.13478043324386,37,-86,-156,600,134,742,823,29
-3,-6,0,-3.0,-6.0,0.5042774677276611,157.4322023425004,37,-83,-150,600,134,742,823,29
-3,-5,0,-3.0,-5.0,0.5125603675842285,151.60495161679194,37,-80,-145,600,134,742,823,29
-3,-6,0,-3.0,-6.0,0.5204293727874756,144.90248582070703,37,-77,-139,600,134,742,823,29
-3,-5,0,-3.0,-5.0,0.5283975601196289,139.07514494521962,37,-74,-134,600,134,742,823,29
-2,-5,0,-2.0,-5.0,0.5362844467163086,133.73286702694156,37,-72,-129,600,134,742,823,29
-3,-7,0,-3.0,-7.0,0.5444223880767822,126.16062214473791,37,-69,-122,600,134,742,823,29
-2,-6,0,-2.0,-6.0,0.5523264408111572,119.9589489358587,37,-67,-116,600,134,742,823,29
-2,-6,0,-2.0,-6.0,0.5605185031890869,113.76932339180638,37,-65,-110,600,134,742,823,29
-2,-4,0,-2.0,-4.0,0.5683674812316895,109.30855606972291,37,-63,-106,600,134,742,823,29
-2,-4,0,-2.0,-4.0,0.5763723850250244,104.84864324004712,37,-61,-102,600,134,742,823,29
-1,-3,0,-1.0,-3.0,0.5843625068664551,101.76268828944843,37,-60,-99,600,134,742,823,29
-2,-4,0,-2.0,-4.0,0.5925283432006836,97.30588483993108,37,-58,-95,600,134,742,823,29
-3,-4,0,-3.0,-4.0,0.6004233360290527,92.3296760081587,37,-55,-91,600,134,742,823,29
-1,-3,0,-1.0,-3.0,0.6083405017852783,89.24727599312246,37,-54,-88,600,134,742,823,29
-2,-4,0,-2.0,-4.0,0.6162834167480469,84.79271228182775,37,-52,-84,600,134,742,823,29
-2,-3,0,-2.0,-3.0,0.6244125366210938,81.1892851112981,37,-50,-81,600,134,742,823,29
-2,-4,0,-2.0,-4.0,0.6322815418243408,76.7358804442873,37,-48,-77,600,134,742,823,29
-2,-3,0,-2.0,-3.0,0.640364408493042,73.13208364316786,37,-46,-74,600,134,742,823,29
-2,-3,0,-2.0,-3.0,0.6483323574066162,69.52843827104634,37,-44,-71,600,134,742,823,29
-2,-4,0,-2.0,-4.0,0.6564633846282959,65.07591289387686,37,-42,-67,600,134,742,823,29
-2,-2,0,-2.0,-2.0,0.6644735336303711,62.321687612368734,37,-40,-65,600,134,742,823,29
-2,-4,0,-2.0,-4.0,0.6722533702850342,57.867934435323804,37,-38,-61,600,134,742,823,29
-2,-4,0,-2.0,-4.0,0.6804285049438477,53.4166151627327,37,-36,-57,600,134,742,823,29
-3,-4,0,-3.0,-4.0,0.6882994174957275,48.433965115151864,37,-33,-53,600,134,742,823,29
-2,-3,0,-2.0,-3.0,0.6963424682617188,44.83026432033091,37,-31,-50,600,134,742,823,29
-2,-3,0,-2.0,-3.0,0.704465389251709,41.226805085936306,37,-29,-47,600,134,742,823,29
-1,-2,0,-1.0,-2.0,0.7123804092407227,39.0,37,-28,-45,600,134,742,823,29
-2,-2,0,-2.0,-2.0,0.7203764915466309,36.24937810560445,37,-26,-43,600,134,742,823,29
-1,-2,0,-1.0,-2.0,0.728487491607666,34.02082881417188,37,-25,-41,600,134,742,823,29
-2,-2,0,-2.0,-2.0,0.7362804412841797,31.276925690687087,37,-23,-39,600,134,742,823,29
-1,-2,0,-1.0,-2.0,0.7444183826446533,29.046486500061768,37,-22,-37,600,134,742,823,29
-2,-2,0,-2.0,-2.0,0.7524783611297607,26.311288741492746,37,-20,-35,600,134,742,823,29
-1,-2,0,-1.0,-2.0,0.7603034973144531,24.078865529319543,37,-19,-33,600,134,742,823,29
-1,-2,0,-1.0,-2.0,0.7682435512542725,21.84689665786984,37,-18,-31,600,134,742,823,29
-1,-1,0,-1.0,-1.0,0.7763915061950684,20.481879299133332,37,-17,-30,600,134,742,823,29
-1,-3,0,-1.0,-3.0,0.7842793464660645,17.38470965295043,37,-16,-27,600,134,742,823,29
-1,-3,0,-1.0,-3.0,0.7923274040222168,14.301943396169811,37,-15,-24,600,134,742,823,29
-2,-3,0,-2.0,-3.0,0.8003144264221191,10.698178070456937,37,-13,-21,600,134,742,823,29
-1,-3,0,-1.0,-3.0,0.8083133697509766,7.633307652783937,37,-12,-18,600,134,742,823,29
-1,-3,0,-1.0,-3.0,0.816333532333374,4.601075237738275,37,-11,-15,600,134,742,823,29
-1,-3,0,-1.0,-3.0,0.8243904113769531,1.620499351813308,37,-10,-12,600,134,742,823,29
-1,-3,0,-1.0,-3.0,0.8323245048522949,-1.2720779386421448,37,-9,-9,600,134,742,823,29
-1,-2,0,-1.0,-2.0,0.8403763771057129,-3.36985418726535,37,-8,-7,600,134,742,823,29
-1,-2,0,-1.0,-2.0,0.848360538482666,-5.397674732957373,37,-7,-5,600,134,742,823,29
-1,-2,0,-1.0,-2.0,0.856271505355835,-7.291796067500631,37,-6,-3,600,134,742,823,29
0,-1,0,-0.0,-1.0,0.8642964363098145,-7.675444679663241,37,-6,-2,600,134,742,823,29
-1,-1,0,-1.0,-1.0,0.8722264766693115,-8.900980486407216,37,-5,-1,600,134,742,823,29
0,-1,0,-0.0,-1.0,0.8803434371948242,-9.0,37,-5,0,600,134,742,823,29
0,0,1,-0.0,-0.0,0.9052374362945557,-9.0,37,-5,0,600,134,742,823,29
0,0,0,-0.0,-0.0,0.08656668663024902,1401.944598233674,38,1071,955,1676,1089,605,134,66
0,1,0,-0.0,1.0,0.14458084106445312,1401.279261510812,38,1071,954,1676,1089,605,134,66
-2,3,0,-2.0,3.0,0.15249180793762207,1400.7817128140532,38,1073,951,1676,1089,605,134,66
-1,1,0,-1.0,1.0,0.16046690940856934,1400.867497365081,38,1074,950,1676,1089,605,134,66
0,1,0,-0.0,1.0,0.2084817886352539,1400.205149306965,38,1074,949,1676,1089,605,134,66
2,5,0,2.0,5.0,0.2166738510131836,1395.3977037226011,38,1072,944,1676,1089,605,134,66
7,9,0,7.0,9.0,0.2245497703552246,1384.1979395977119,38,1065,935,1676,1089,605,134,66
13,10,0,13.0,10.0,0.23260974884033203,1367.8315387654577,38,1052,925,1676,1089,605,134,66
20,12,0,20.0,12.0,0.2404947280883789,1344.8944081459942,38,1032,913,1676,1089,605,134,66
23,14,0,23.0,14.0,0.24855470657348633,1318.400014799467,38,1009,899,1676,1089,605,134,66
27,16,0,27.0,16.0,0.2565639019012451,1287.610843511441,38,982,883,1676,1089,605,134,66
31,17,0,31.0,17.0,0.2647218704223633,1253.218099701602,38,951,866,1676,1089,605,134,66
32,19,0,32.0,19.0,0.2724778652191162,1216.7879820193505,38,919,847,1676,1089,605,134,66
33,20,0,33.0,20.0,0.2805027961730957,1178.9921616908255,38,886,827,1676,1089,605,134,66
33,22,0,33.0,22.0,0.28855180740356445,1139.8742473087216,38,853,805,1676,1089,605,134,66
34,22,0,34.0,22.0,0.2965068817138672,1100.0710480812754,38,819,783,1676,1089,605,134,66
35,25,0,35.0,25.0,0.3044767379760742,1057.5136404465559,38,784,758,1676,1089,605,134,66
34,25,0,34.0,25.0,0.3124878406524658,1015.7082530427613,38,750,733,1676,1089,605,134,66
32,25,0,32.0,25.0,0.3204677104949951,975.3590630326084,38,718,708,1676,1089,605,134,66
31,25,0,31.0,25.0,0.32856082916259766,935.7404193074634,38,687,683,1676,1089,605,134,66
27,26,0,27.0,26.0,0.3364748954772949,898.2620469019448,38,660,657,1676,1089,605,134,66
27,27,0,27.0,27.0,0.34453868865966797,860.0783840178867,38,633,630,1676,1089,605,134,66
25,25,0,25.0,25.0,0.35245370864868164,824.7231488073527,38,608,605,1676,1089,605,134,66
23,25,0,23.0,25.0,0.36055874824523926,790.786987030021,38,585,580,1676,1089,605,134,66
23,23,0,23.0,23.0,0.3685877323150635,758.260386977637,38,562,557,1676,1089,605,134,66
19,24,0,19.0,24.0,0.3767688274383545,727.8797539690487,38,543,533,1676,1089,605,134,66
18,23,0,18.0,23.0,0.3844928741455078,698.9323739253512,38,525,510,1676,1089,605,134,66
17,21,0,17.0,21.0,0.3924527168273926,672.1134660464229,38,508,489,1676,1089,605,134,66
15,19,0,15.0,19.0,0.4005908966064453,648.1380183193418,38,493,470,1676,1089,605,134,66
14,17,0,14.0,17.0,0.40858888626098633,626.2799102050661,38,479,453,1676,1089,605,134,66
12,15,0,12.0,15.0,0.41657090187072754,607.2601033954872,38,467,438,1676,1089,605,134,66
10,11,0,10.0,11.0,0.42458081245422363,592.4422435365235,38,457,427,1676,1089,605,134,66
10,10,0,10.0,10.0,0.43251585960388184,578.3084327898642,38,447,417,1676,1089,605,134,66
10,9,0,10.0,9.0,0.4407017230987549,564.8570063150553,38,437,408,1676,1089,605,134,66
8,9,0,8.0,9.0,0.44859790802001953,552.8685859473949,38,429,399,1676,1089,605,134,66
10,8,0,10.0,8.0,0.45654773712158203,540.0985953568548,38,419,391,1676,1089,605,134,66
9,9,0,9.0,9.0,0.46447086334228516,527.3784435539968,38,410,382,1676,1089,605,134,66
9,9,0,9.0,9.0,0.47260570526123047,514.6586528121326,38,401,373,1676,1089,605,134,66
6,8,0,6.0,8.0,0.48061084747314453,504.81967238099423,38,395,365,1676,1089,605,134,66
7,10,0,7.0,10.0,0.48859572410583496,492.89827913770546,38,388,355,1676,1089,605,134,66
7,9,0,7.0,9.0,0.49655985832214355,481.662025022247,38,381,346,1676,1089,605,134,66
9,11,0,9.0,11.0,0.5045568943023682,467.60862957004645,38,372,335,1676,1089,605,134,66
8,10,0,8.0,10.0,0.5124778747558594,454.97643385720994,38,364,325,1676,1089,605,134,66
9,11,0,9.0,11.0,0.5205748081207275,440.9419795713395,38,355,314,1676,1089,605,134,66
11,11,0,11.0,11.0,0.5285308361053467,425.4157501657202,38,344,303,1676,1089,605,134,66
10,10,0,10.0,10.0,0.5365128517150879,411.30282465903815,38,334,293,1676,1089,605,134,66
10,10,0,10.0,10.0,0.5444867610931396,397.1918176813687,38,324,283,1676,1089,605,134,66
10,9,0,10.0,9.0,0.5525407791137695,383.7397269279712,38,314,274,1676,1089,605,134,66
11,9,0,11.0,9.0,0.5606307983398438,369.53447057363917,38,303,265,1676,1089,605,134,66
10,8,0,10.0,8.0,0.5685896873474121,356.74093959962687,38,293,257,1676,1089,605,134,66
10,8,0,10.0,8.0,0.5765707492828369,343.9482723133242,38,283,249,1676,1089,605,134,66
12,8,0,12.0,8.0,0.5845508575439453,329.6596200295809,38,271,241,1676,1089,605,134,66
12,8,0,12.0,8.0,0.5925858020782471,315.38197427536346,38,259,233,1676,1089,605,134,66
13,8,0,13.0,8.0,0.6005327701568604,300.3781636520305,38,246,225,1676,1089,605,134,66
13,8,0,13.0,8.0,0.6084778308868408,285.39912060180063,38,233,217,1676,1089,605,134,66
13,9,0,13.0,9.0,0.6165387630462646,269.76063152266016,38,220,208,1676,1089,605,134,66
13,7,0,13.0,7.0,0.6246938705444336,255.53076092507018,38,207,201,1676,1089,605,134,66
14,9,0,14.0,9.0,0.6325328350067139,239.237029075767,38,193,192,1676,1089,605,134,66
15,8,0,15.0,8.0,0.6405837535858154,223.00781238079435,38,178,184,1676,1089,605,134,66
13,8,0,13.0,8.0,0.648486852645874,208.2488341940744,38,165,176,1676,1089,605,134,66
13,7,0,13.0,7.0,0.6566238403320312,194.29936207565564,38,152,169,1676,1089,605,134,66
12,7,0,12.0,7.0,0.6648168563842773,181.11212016137713,38,140,162,1676,1089,605,134,66
10,6,0,10.0,6.0,0.6726047992706299,170.06649157357302,38,130,156,1676,1089,605,134,66
9,5,0,9.0,5.0,0.6805377006530762,160.49935400408964,38,121,151,1676,1089,605,134,66
8,4,0,8.0,4.0,0.6884827613830566,152.41305239923105,38,113,147,1676,1089,605,134,66
7,5,0,7.0,5.0,0.6965796947479248,144.2004514666935,38,106,142,1676,1089,605,134,66
7,5,0,7.0,5.0,0.7045748233795166,136.0266251216062,38,99,137,1676,1089,605,134,66
7,5,0,7.0,5.0,0.712608814239502,127.89748288895012,38,92,132,1676,1089,605,134,66
7,5,0,7.0,5.0,0.7206296920776367,119.8201557386983,38,85,127,1676,1089,605,134,66
5,5,0,5.0,5.0,0.7288477420806885,112.89036979869508,38,80,122,1676,1089,605,134,66
4,4,0,4.0,4.0,0.7365787029266357,107.356688476182,38,76,118,1676,1089,605,134,66
5,2,0,5.0,2.0,0.7446348667144775,103.0036764208968,38,71,116,1676,1089,605,134,66
4,3,0,4.0,3.0,0.7524979114532471,98.36970731489052,38,67,113,1676,1089,605,134,66
3,3,0,3.0,3.0,0.7605228424072266,94.26350615946427,38,64,110,1676,1089,605,134,66
4,3,0,4.0,3.0,0.7685527801513672,89.67436570041843,38,60,107,1676,1089,605,134,66
3,4,0,3.0,4.0,0.776660680770874,84.72000679578642,38,57,103,1676,1089,605,134,66
3,3,0,3.0,3.0,0.7846317291259766,80.64858116140297,38,54,100,1676,1089,605,134,66
2,3,0,2.0,3.0,0.7926619052886963,77.05907504608605,38,52,97,1676,1089,605,134,66
3,4,0,3.0,4.0,0.800642728805542,72.11898020814318,38,49,93,1676,1089,605,134,66
2,4,0,2.0,4.0,0.8089509010314941,67.64790112068906,38,47,89,1676,1089,605,134,66
3,6,0,3.0,6.0,0.8165779113769531,60.941471140279674,38,44,83,1676,1089,605,134,66
4,6,0,4.0,6.0,0.824793815612793,53.76981041814025,38,40,77,1676,1089,605,134,66
4,6,0,4.0,6.0,0.8325567245483398,46.60527620704548,38,36,71,1676,1089,605,134,66
4,6,0,4.0,6.0,0.8405728340148926,39.449982746719826,38,32,65,1676,1089,605,134,66
4,5,0,4.0,5.0,0.8486227989196777,33.21178142898739,38,28,60,1676,1089,605,134,66
4,5,0,4.0,5.0,0.8565778732299805,27.00833275470999,38,24,55,1676,1089,605,134,66
4,5,0,4.0,5.0,0.8646318912506104,20.85164807134504,38,20,50,1676,1089,605,134,66
4,5,0,4.0,5.0,0.8726048469543457,14.75981574503821,38,16,45,1676,1089,605,134,66
4,4,0,4.0,4.0,0.8806328773498535,9.720018726587654,38,12,41,1676,1089,605,134,66
4,5,0,4.0,5.0,0.8886537551879883,3.8781778291715483,38,8,36,1676,1089,605,134,66
3,4,0,3.0,4.0,0.8966548442840576,-0.6117305185967084,38,5,32,1676,1089,605,134,66
3,4,0,3.0,4.0,0.9046478271484375,-4.928662304763602,38,2,28,1676,1089,605,134,66
4,5,0,4.0,5.0,0.9126968383789062,-9.913207238769608,38,-2,23,1676,1089,605,134,66
3,3,0,3.0,3.0,0.9206197261810303,-12.384471871911696,38,-5,20,1676,1089,605,134,66
3,4,0,3.0,4.0,0.9286937713623047,-15.111456180001682,38,-8,16,1676,1089,605,134,66
1,1,0,1.0,1.0,0.9366037845611572,-15.5071443154641,38,-9,15,1676,1089,605,134,66
2,2,0,2.0,2.0,0.9445147514343262,-15.970613634073597,38,-11,13,1676,1089,605,134,66
0,1,0,-0.0,1.0,0.9525518417358398,-16.721179403900294,38,-11,12,1676,1089,605,134,66
1,1,0,1.0,1.0,0.9605157375335693,-16.721179403900294,38,-12,11,1676,1089,605,134,66
1,1,0,1.0,1.0,0.9685757160186768,-16.598780533143273,38,-13,10,1676,1089,605,134,66
1,1,0,1.0,1.0,0.9764657020568848,-16.35668302290676,38,-14,9,1676,1089,605,134,66
0,0,1,-0.0,-0.0,0.9915778636932373,-16.35668302290676,38,-14,9,1676,1089,605,134,66
0,0,0,-0.0,-0.0,0.07794737815856934,175.08029417835473,39,124,-148,1814,932,1690,1080,37
-2,0,0,-2.0,-0.0,0.09107327461242676,176.3707796969493,39,126,-148,1814,932,1690,1080,37
-3,1,0,-3.0,1.0,0.09898638725280762,179.08373854785685,39,129,-149,1814,932,1690,1080,37
-3,0,0,-3.0,-0.0,0.10709834098815918,181.06029237394384,39,132,-149,1814,932,1690,1080,37
-2,0,0,-2.0,-0.0,0.1149742603302002,182.39211561336438,39,134,-149,1814,932,1690,1080,37
-3,0,0,-3.0,-0.0,0.12305235862731934,184.41047403728888,39,137,-149,1814,932,1690,1080,37
-3,0,0,-3.0,-0.0,0.13114142417907715,186.45292856792244,39,140,-149,1814,932,1690,1080,37
-4,0,0,-4.0,-0.0,0.13912034034729004,189.21245136332902,39,144,-149,1814,932,1690,1080,37
-4,-2,0,-4.0,-2.0,0.14706945419311523,190.5976989326584,39,148,-147,1814,932,1690,1080,37
-8,-2,0,-8.0,-2.0,0.15505146980285645,194.9812198293549,39,156,-145,1814,932,1690,1080,37
-9,-4,0,-9.0,-4.0,0.16320538520812988,199.03916697223107,39,165,-141,1814,932,1690,1080,37
-10,-5,0,-10.0,-5.0,0.1713733673095703,203.6325788326256,39,175,-136,1814,932,1690,1080,37
-11,-5,0,-11.0,-5.0,0.17896246910095215,209.50164834567684,39,186,-131,1814,932,1690,1080,37
-11,-6,0,-11.0,-6.0,0.18708038330078125,215.3109513074772,39,197,-125,1814,932,1690,1080,37
-15,-9,0,-15.0,-9.0,0.19495248794555664,223.66091947189145,39,212,-116,1814,932,1690,1080,37
-15,-11,0,-15.0,-11.0,0.2029714584350586,232.10797668207226,39,227,-105,1814,932,1690,1080,37
-16,-11,0,-16.0,-11.0,0.21106743812561035,242.54750046776502,39,243,-94,1814,932,1690,1080,37
-11,-11,0,-11.0,-11.0,0.21905231475830078,249.21714016881475,39,254,-83,1814,932,1690,1080,37
-7,-9,0,-7.0,-9.0,0.22741937637329102,253.2876701953113,39,261,-74,1814,932,1690,1080,37
-2,-7,0,-2.0,-7.0,0.23514747619628906,253.40007369195757,39,263,-67,1814,932,1690,1080,37
0,-5,0,-0.0,-5.0,0.24306845664978027,252.2091782304961,39,263,-62,1814,932,1690,1080,37
0,-4,0,-0.0,-4.0,0.251049280166626,251.31951284673005,39,263,-58,1814,932,1690,1080,37
2,-4,0,2.0,-4.0,0.25914430618286133,248.52767210929522,39,261,-54,1814,932,1690,1080,37
4,-4,0,4.0,-4.0,0.26717233657836914,243.81863951980193,39,257,-50,1814,932,1690,1080,37
5,-4,0,5.0,-4.0,0.27512240409851074,238.1640099623677,39,252,-46,1814,932,1690,1080,37
7,-5,0,7.0,-5.0,0.28308629989624023,230.4069242191127,39,245,-41,1814,932,1690,1080,37
10,-6,0,10.0,-6.0,0.2910933494567871,219.59208741033444,39,235,-35,1814,932,1690,1080,37
10,-4,0,10.0,-4.0,0.2991023063659668,209.1255159597882,39,225,-31,1814,932,1690,1080,37
10,-4,0,10.0,-4.0,0.30707836151123047,198.6887168266959,39,215,-27,1814,932,1690,1080,37
11,-3,0,11.0,-3.0,0.3149902820587158,187.40691322348428,39,204,-24,1814,932,1690,1080,37
11,-4,0,11.0,-4.0,0.32302331924438477,176.03350226185168,39,193,-20,1814,932,1690,1080,37
13,-3,0,13.0,-3.0,0.33092236518859863,162.8009955724802,39,180,-17,1814,932,1690,1080,37
14,-3,0,14.0,-3.0,0.3390233516693115,148.5893153836704,39,166,-14,1814,932,1690,1080,37
13,-3,0,13.0,-3.0,0.3471202850341797,135.39491516996253,39,153,-11,1814,932,1690,1080,37
14,-3,0,14.0,-3.0,0.3550693988800049,121.23002549737609,39,139,-8,1814,932,1690,1080,37
16,-2,0,16.0,-2.0,0.363086462020874,105.14625451064275,39,123,-6,1814,932,1690,1080,37
17,-1,0,17.0,-1.0,0.3710622787475586,88.1178590059185,39,106,-5,1814,932,1690,1080,37
16,-1,0,16.0,-1.0,0.37907838821411133,72.08884503644167,39,90,-4,1814,932,1690,1080,37
15,-2,0,15.0,-2.0,0.3870253562927246,57.026661927610775,39,75,-2,1814,932,1690,1080,37
14,-1,0,14.0,-1.0,0.3949263095855713,43.00819617067857,39,61,-1,1814,932,1690,1080,37
13,-1,0,13.0,-1.0,0.4030914306640625,30.0,39,48,0,1814,932,1690,1080,37
12,-2,0,12.0,-2.0,0.41108131408691406,18.055512754639892,39,36,2,1814,932,1690,1080,37
10,-1,0,10.0,-1.0,0.419081449508667,8.1725046566048,39,26,3,1814,932,1690,1080,37
8,-2,0,8.0,-2.0,0.4270603656768799,0.6815416922694055,39,18,5,1814,932,1690,1080,37
4,-2,0,4.0,-2.0,0.4350752830505371,-2.3475241575014714,39,14,7,1814,932,1690,1080,37
2,-1,0,2.0,-1.0,0.4430243968963623,-3.5777948981440435,39,12,8,1814,932,1690,1080,37
0,0,1,-0.0,-0.0,0.5589983463287354,-3.5777948981440435,39,12,8,1814,932,1690,1080,37
0,0,0,-0.0,-0.0,0.06849026679992676,1552.1614140797656,40,-1525,-447,277,477,1802,924,74
-1,0,0,-1.0,-0.0,0.11263632774353027,1551.2018133725953,40,-1524,-447,277,477,1802,924,74
-3,0,0,-3.0,-0.0,0.12060046195983887,1548.3233108738418,40,-1521,-447,277,477,1802,924,74
-4,0,0,-4.0,-0.0,0.1285724639892578,1544.4860100551,40,-1517,-447,277,477,1802,924,74
-6,-1,0,-6.0,-1.0,0.13657140731811523,1538.448190198586,40,-1511,-446,277,477,1802,924,74
-4,0,0,-4.0,-0.0,0.14452147483825684,1534.6122295273728,40,-1507,-446,277,477,1802,924,74
-5,-1,0,-5.0,-1.0,0.1526353359222412,1529.5340724031507,40,-1502,-445,277,477,1802,924,74
-7,0,0,-7.0,-0.0,0.16051125526428223,1522.8237079875405,40,-1495,-445,277,477,1802,924,74
-8,-1,0,-8.0,-1.0,0.16868138313293457,1514.8714508618295,40,-1487,-444,277,477,1802,924,74
-7,-2,0,-7.0,-2.0,0.17643046379089355,1507.591855475096,40,-1480,-442,277,477,1802,924,74
-9,-1,0,-9.0,-1.0,0.18445348739624023,1498.682909978489,40,-1471,-441,277,477,1802,924,74
-11,-3,0,-11.0,-3.0,0.19261932373046875,1487.2847503009402,40,-1460,-438,277,477,1802,924,74
-14,-3,0,-14.0,-3.0,0.20064425468444824,1473.0135760979103,40,-1446,-435,277,477,1802,924,74
-18,-4,0,-18.0,-4.0,0.2086033821105957,1454.624952861811,40,-1428,-431,277,477,1802,924,74
-24,-6,0,-24.0,-6.0,0.21659445762634277,1429.9154713206892,40,-1404,-425,277,477,1802,924,74
-27,-8,0,-27.0,-8.0,0.22466039657592773,1401.7557124126388,40,-1377,-417,277,477,1802,924,74
-32,-8,0,-32.0,-8.0,0.23254132270812988,1368.8115094136908,40,-1345,-409,277,477,1802,924,74
-31,-9,0,-31.0,-9.0,0.24047446250915527,1336.5341277157986,40,-1314,-400,277,477,1802,924,74
-32,-7,0,-32.0,-7.0,0.24852943420410156,1303.8851554104103,40,-1282,-393,277,477,1802,924,74
-28,-6,0,-28.0,-6.0,0.25671839714050293,1275.358563807925,40,-1254,-387,277,477,1802,924,74
-25,-6,0,-25.0,-6.0,0.26456737518310547,1249.7019856983202,40,-1229,-381,277,477,1802,924,74
-23,-6,0,-23.0,-6.0,0.2725844383239746,1225.9572439318758,40,-1206,-375,277,477,1802,924,74
-22,-6,0,-22.0,-6.0,0.28058838844299316,1203.1681337625153,40,-1184,-369,277,477,1802,924,74
-24,-8,0,-24.0,-8.0,0.28867340087890625,1177.8748906780484,40,-1160,-361,277,477,1802,924,74
-24,-9,0,-24.0,-9.0,0.296600341796875,1152.2854997854804,40,-1136,-352,277,477,1802,924,74
-30,-12,0,-30.0,-12.0,0.3046293258666992,1120.0808096239432,40,-1106,-340,277,477,1802,924,74
-32,-13,0,-32.0,-13.0,0.3124964237213135,1085.6776028762665,40,-1074,-327,277,477,1802,924,74
-37,-14,0,-37.0,-14.0,0.32045435905456543,1046.2072747170782,40,-1037,-313,277,477,1802,924,74
-40,-16,0,-40.0,-16.0,0.3285202980041504,1003.2970729556052,40,-997,-297,277,477,1802,924,74
-45,-16,0,-45.0,-16.0,0.33661627769470215,955.6051581570589,40,-952,-281,277,477,1802,924,74
-48,-16,0,-48.0,-16.0,0.34455037117004395,905.0408696017387,40,-904,-265,277,477,1802,924,74
-51,-15,0,-51.0,-15.0,0.3525724411010742,851.8807569072468,40,-853,-250,277,477,1802,924,74
-55,-15,0,-55.0,-15.0,0.3605673313140869,794.8828042458865,40,-798,-235,277,477,1802,924,74
-54,-14,0,-54.0,-14.0,0.36866331100463867,739.1294995037877,40,-744,-221,277,477,1802,924,74
-54,-12,0,-54.0,-12.0,0.376589298248291,683.9583899227472,40,-690,-209,277,477,1802,924,74
-53,-12,0,-53.0,-12.0,0.3845963478088379,629.7668258094429,40,-637,-197,277,477,1802,924,74
-49,-13,0,-49.0,-13.0,0.3925623893737793,579.1168720299745,40,-588,-184,277,477,1802,924,74
-44,-12,0,-44.0,-12.0,0.4006342887878418,533.5436004373373,40,-544,-172,277,477,1802,924,74
-38,-9,0,-38.0,-9.0,0.4085714817047119,494.6060571513459,40,-506,-163,277,477,1802,924,74
-32,-9,0,-32.0,-9.0,0.4165923595428467,461.38940598692506,40,-474,-154,277,477,1802,924,74
-27,-8,0,-27.0,-8.0,0.42460036277770996,433.2393007820593,40,-447,-146,277,477,1802,924,74
-21,-6,0,-21.0,-6.0,0.432659387588501,411.41498636865384,40,-426,-140,277,477,1802,924,74
-20,-6,0,-20.0,-6.0,0.4404904842376709,390.5418108208833,40,-406,-134,277,477,1802,924,74
-15,-7,0,-15.0,-7.0,0.4484283924102783,374.1082582483597,40,-391,-127,277,477,1802,924,74
-14,-5,0,-14.0,-5.0,0.4565293788909912,359.2486593037256,40,-377,-122,277,477,1802,924,74
-14,-6,0,-14.0,-6.0,0.46462130546569824,344.08398024582453,40,-363,-116,277,477,1802,924,74
-11,-5,0,-11.0,-5.0,0.47257137298583984,332.08671067921154,40,-352,-111,277,477,1802,924,74
-11,-4,0,-11.0,-4.0,0.48059725761413574,320.39334073258834,40,-341,-107,277,477,1802,924,74
-12,-5,0,-12.0,-5.0,0.48848628997802734,307.4488350974641,40,-329,-102,277,477,1802,924,74
-14,-5,0,-14.0,-5.0,0.4966413974761963,292.59672328468315,40,-315,-97,277,477,1802,924,74
-16,-6,0,-16.0,-6.0,0.5045533180236816,275.54119728445403,40,-299,-91,277,477,1802,924,74
-17,-5,0,-17.0,-5.0,0.5125772953033447,257.8219801846531,40,-282,-86,277,477,1802,924,74
-18,-4,0,-18.0,-4.0,0.520585298538208,239.4416755845616,40,-264,-82,277,477,1802,924,74
-20,-5,0,-20.0,-5.0,0.5286552906036377,218.86129054626454,40,-244,-77,277,477,1802,924,74
-18,-4,0,-18.0,-4.0,0.5365853309631348,200.49736840647307,40,-226,-73,277,477,1802,924,74
-17,-4,0,-17.0,-4.0,0.5446763038635254,183.0954338463204,40,-209,-69,277,477,1802,924,74
-14,-3,0,-14.0,-3.0,0.5525753498077393,168.86646157157313,40,-195,-66,277,477,1802,924,74
-13,-2,0,-13.0,-2.0,0.5605473518371582,155.92485583770693,40,-182,-64,277,477,1802,924,74
-12,-2,0,-12.0,-2.0,0.5685882568359375,143.95303258028034,40,-170,-62,277,477,1802,924,74
-13,-2,0,-13.0,-2.0,0.5765724182128906,131.07438829280326,40,-157,-60,277,477,1802,924,74
-11,-3,0,-11.0,-3.0,0.5845444202423096,119.73225577397909,40,-146,-57,277,477,1802,924,74
-9,-3,0,-9.0,-3.0,0.5925993919372559,110.2582765076381,40,-137,-54,277,477,1802,924,74
-7,-3,0,-7.0,-3.0,0.6004924774169922,102.64598096615597,40,-130,-51,277,477,1802,924,74
-7,-2,0,-7.0,-2.0,0.6085562705993652,95.40090634130871,40,-123,-49,277,477,1802,924,74
-5,-2,0,-5.0,-2.0,0.6164753437042236,90.01574705523721,40,-118,-47,277,477,1802,924,74
-6,-2,0,-6.0,-2.0,0.6245954036712646,83.70211265756701,40,-112,-45,277,477,1802,924,74
-6,-3,0,-6.0,-3.0,0.6325674057006836,77.0175425099138,40,-106,-42,277,477,1802,924,74
-8,-2,0,-8.0,-2.0,0.6406242847442627,68.84894897919393,40,-98,-40,277,477,1802,924,74
-9,-3,0,-9.0,-3.0,0.6484682559967041,59.38464608017192,40,-89,-37,277,477,1802,924,74
-10,-3,0,-10.0,-3.0,0.6565444469451904,49.005813756978085,40,-79,-34,277,477,1802,924,74
-12,-4,0,-12.0,-4.0,0.664473295211792,36.40980860893181,40,-67,-30,277,477,1802,924,74
-13,-3,0,-13.0,-3.0,0.6725013256072998,23.37383539249432,40,-54,-27,277,477,1802,924,74
-13,-3,0,-13.0,-3.0,0.6806743144989014,10.507894080878813,40,-41,-24,277,477,1802,924,74
-15,-4,0,-15.0,-4.0,0.6886863708496094,-4.197561066286546,40,-26,-20,277,477,1802,924,74
-12,-3,0,-12.0,-3.0,0.6965782642364502,-14.977284454454761,40,-14,-17,277,477,1802,924,74
-11,-2,0,-11.0,-2.0,0.7046043872833252,-21.702941459221645,40,-3,-15,277,477,1802,924,74
-8,-2,0,-8.0,-2.0,0.7126293182373047,-23.07161172281588,40,5,-13,277,477,1802,924,74
-4,-1,0,-4.0,-1.0,0.7214443683624268,-22.0,40,9,-12,277,477,1802,924,74
-2,0,0,-2.0,-0.0,0.7284293174743652,-20.721179403900294,40,11,-12,277,477,1802,924,74
1,0,0,1.0,-0.0,0.7686862945556641,-21.379500648186692,40,10,-12,277,477,1802,924,74
0,0,1,-0.0,-0.0,0.7744333744049072,-21.379500648186692,40,10,-12,277,477,1802,924,74
1,0,1,1.0,-0.0,0.7789773941040039,-22.0,40,9,-12,277,477,1802,924,74
1,0,1,1.0,-0.0,0.0007314682006835938,238.4731222669117,41,218,-115,487,374,268,489,16
0,0,0,-0.0,-0.0,0.06560850143432617,238.4731222669117,41,218,-115,487,374,268,489,16
1,0,0,1.0,-0.0,0.12071847915649414,237.58908770545975,41,217,-115,487,374,268,489,16
3,0,0,3.0,-0.0,0.12868547439575195,234.94237999986746,41,214,-115,487,374,268,489,16
5,1,0,5.0,1.0,0.13673949241638184,231.0334704596827,41,209,-116,487,374,268,489,16
8,2,0,8.0,2.0,0.14467453956604004,225.0772404161333,41,201,-118,487,374,268,489,16
10,1,0,10.0,1.0,0.15271353721618652,217.0377746068424,41,191,-119,487,374,268,489,16
14,3,0,14.0,3.0,0.16059350967407227,206.9720912118594,41,177,-122,487,374,268,489,16
18,2,0,18.0,2.0,0.16860151290893555,193.63581031156147,41,159,-124,487,374,268,489,16
24,3,0,24.0,3.0,0.17656540870666504,177.34832073693033,41,135,-127,487,374,268,489,16
29,4,0,29.0,4.0,0.18459153175354004,160.51409436602032,41,106,-131,487,374,268,489,16
32,3,0,32.0,3.0,0.19267749786376953,145.07514494521962,41,74,-134,487,374,268,489,16
35,3,0,35.0,3.0,0.20070457458496094,134.44297104455524,41,39,-137,487,374,268,489,16
37,4,0,37.0,4.0,0.20870137214660645,133.01418368376991,41,2,-141,487,374,268,489,16
35,1,0,35.0,1.0,0.21661043167114258,137.7840869230932,41,-33,-142,487,374,268,489,16
32,0,0,32.0,-0.0,0.2247464656829834,148.16977940690063,41,-65,-142,487,374,268,489,16
25,-3,0,25.0,-3.0,0.23271441459655762,157.59287424282482,41,-90,-139,487,374,268,489,16
18,-5,0,18.0,-5.0,0.24076151847839355,164.10461934532728,41,-108,-134,487,374,268,489,16
10,-5,0,10.0,-5.0,0.2487194538116455,166.82848738120455,41,-118,-129,487,374,268,489,16
4,-5,0,4.0,-5.0,0.2566204071044922,165.95401691251627,41,-122,-124,487,374,268,489,16
1,-4,0,1.0,-4.0,0.26464247703552246,163.84004189943624,41,-123,-120,487,374,268,489,16
0,-4,0,-0.0,-4.0,0.27269840240478516,161.07099100673656,41,-123,-116,487,374,268,489,16
-2,-4,0,-2.0,-4.0,0.2808685302734375,156.87874332369228,41,-121,-112,487,374,268,489,16
-4,-6,0,-4.0,-6.0,0.2886934280395508,149.87653403846943,41,-117,-106,487,374,268,489,16
-6,-7,0,-6.0,-7.0,0.2967033386230469,140.73466307488647,41,-111,-99,487,374,268,489,16
-7,-8,0,-7.0,-8.0,0.3047003746032715,130.19189556555045,41,-104,-91,487,374,268,489,16
-9,-8,0,-9.0,-8.0,0.31263041496276855,118.15070352558483,41,-95,-83,487,374,268,489,16
-12,-10,0,-12.0,-10.0,0.3205564022064209,102.5350623105628,41,-83,-73,487,374,268,489,16
-13,-9,0,-13.0,-9.0,0.3287503719329834,86.847245611035,41,-70,-64,487,374,268,489,16
-12,-9,0,-12.0,-9.0,0.3365974426269531,71.93122043357026,41,-58,-55,487,374,268,489,16
-12,-9,0,-12.0,-9.0,0.34467148780822754,57.05382386916237,41,-46,-46,487,374,268,489,16
-12,-7,0,-12.0,-7.0,0.35279035568237305,43.73973328110612,41,-34,-39,487,374,268,489,16
-11,-7,0,-11.0,-7.0,0.36061644554138184,31.408120990476064,41,-23,-32,487,374,268,489,16
-9,-5,0,-9.0,-5.0,0.36867451667785645,22.4138126514911,41,-14,-27,487,374,268,489,16
-8,-5,0,-8.0,-5.0,0.3766825199127197,14.803508501982758,41,-6,-22,487,374,268,489,16
-8,-5,0,-8.0,-5.0,0.38454651832580566,9.11724276862369,41,2,-17,487,374,268,489,16
-7,-4,0,-7.0,-4.0,0.3925454616546631,7.811388300841896,41,9,-13,487,374,268,489,16
-6,-3,0,-6.0,-3.0,0.4006185531616211,10.027756377319946,41,15,-10,487,374,268,489,16
-5,-3,0,-5.0,-3.0,0.40868139266967773,13.189620100417091,41,20,-7,487,374,268,489,16
-1,-3,0,-1.0,-3.0,0.4166843891143799,13.377558326431949,41,21,-4,487,374,268,489,16
-2,-2,0,-2.0,-2.0,0.4251124858856201,15.086792761230392,41,23,-2,487,374,268,489,16
-1,-2,0,-1.0,-2.0,0.43265748023986816,16.0,41,24,0,487,374,268,489,16
0,-2,0,-0.0,-2.0,0.4406905174255371,16.08318915758459,41,24,2,487,374,268,489,16
-1,-2,0,-1.0,-2.0,0.4485454559326172,17.317977802344327,41,25,4,487,374,268,489,16
0,-2,0,-0.0,-2.0,0.45662546157836914,17.709920264364882,41,25,6,487,374,268,489,16
0,-2,0,-0.0,-2.0,0.4646294116973877,18.248809496813376,41,25,8,487,374,268,489,16
0,-1,0,-0.0,-1.0,0.47280335426330566,18.570660511172846,41,25,9,487,374,268,489,16
1,-3,0,1.0,-3.0,0.4808013439178467,18.832815729997478,41,24,12,487,374,268,489,16
0,-2,0,-0.0,-2.0,0.4887094497680664,19.784887978899608,41,24,14,487,374,268,489,16
1,-2,0,1.0,-2.0,0.49674153327941895,20.0178514522438,41,23,16,487,374,268,489,16
0,-2,0,-0.0,-2.0,0.5047004222869873,21.206163733020468,41,23,18,487,374,268,489,16
1,-2,0,1.0,-2.0,0.5127005577087402,21.732137494637012,41,22,20,487,374,268,489,16
0,-1,0,-0.0,-1.0,0.5206694602966309,22.4138126514911,41,22,21,487,374,268,489,16
1,-1,0,1.0,-1.0,0.5286383628845215,22.4138126514911,41,21,22,487,374,268,489,16
0,-1,0,-0.0,-1.0,0.5365865230560303,23.144823004794873,41,21,23,487,374,268,489,16
0,-1,0,-0.0,-1.0,0.5446245670318604,23.89043743820395,41,21,24,487,374,268,489,16
0,-1,0,-0.0,-1.0,0.5527553558349609,24.649655434629018,41,21,25,487,374,268,489,16
0,-1,0,-0.0,-1.0,0.5606963634490967,25.421549934136806,41,21,26,487,374,268,489,16
0,0,1,-0.0,-0.0,0.590625524520874,25.421549934136806,41,21,26,487,374,268,489,16
0,0,0,-0.0,-0.0,0.6866405010223389,25.421549934136806,41,21,26,487,374,268,489,16
1,1,0,1.0,1.0,0.696629524230957,24.015621187164243,41,20,25,487,374,268,489,16
0,4,0,-0.0,4.0,0.7047073841094971,21.0,41,20,21,487,374,268,489,16
1,4,0,1.0,4.0,0.7126424312591553,17.495097567963924,41,19,17,487,374,268,489,16
1,3,0,1.0,3.0,0.7206125259399414,14.803508501982758,41,18,14,487,374,268,489,16
0,3,0,-0.0,3.0,0.7286803722381592,13.095023109728988,41,18,11,487,374,268,489,16
1,1,0,1.0,1.0,0.7365865707397461,11.72308292331602,41,17,10,487,374,268,489,16
0,2,0,-0.0,2.0,0.7446684837341309,10.788294228055936,41,17,8,487,374,268,489,16
1,1,0,1.0,1.0,0.7528934478759766,9.464249196572979,41,16,7,487,374,268,489,16
0,1,0,-0.0,1.0,0.7605814933776855,9.08800749063506,41,16,6,487,374,268,489,16
1,1,0,1.0,1.0,0.7687375545501709,7.811388300841896,41,15,5,487,374,268,489,16
1,1,0,1.0,1.0,0.7767393589019775,6.560219778561036,41,14,4,487,374,268,489,16
0,1,0,-0.0,1.0,0.7847025394439697,6.317821063276353,41,14,3,487,374,268,489,16
1,0,0,1.0,-0.0,0.7926905155181885,5.341664064126334,41,13,3,487,374,268,489,16
1,0,0,1.0,-0.0,0.8087964057922363,4.369316876852981,41,12,3,487,374,268,489,16
1,1,0,1.0,1.0,0.8166964054107666,3.180339887498949,41,11,2,487,374,268,489,16
0,0,1,-0.0,-0.0,0.8188235759735107,3.180339887498949,41,11,2,487,374,268,489,16
1,0,1,1.0,-0.0,0.006826877593994141,378.10303992719264,42,387,-69,864,303,476,372,30
0,0,0,-0.0,-0.0,0.0829169750213623,378.10303992719264,42,387,-69,864,303,476,372,30
2,0,0,2.0,-0.0,0.2470378875732422,376.1342480530182,42,385,-69,864,303,476,372,30
6,1,0,6.0,1.0,0.2553980350494385,370.4101711164354,42,379,-70,864,303,476,372,30
8,0,0,8.0,-0.0,0.26291489601135254,362.54602368453044,42,371,-70,864,303,476,372,30
9,0,0,9.0,-0.0,0.2709028720855713,353.7058448139926,42,362,-70,864,303,476,372,30
12,-1,0,12.0,-1.0,0.2789878845214844,341.7365975057788,42,350,-69,864,303,476,372,30
12,-2,0,12.0,-2.0,0.28704285621643066,329.5765517268986,42,338,-67,864,303,476,372,30
13,-2,0,13.0,-2.0,0.29482603073120117,316.436268383531,42,325,-65,864,303,476,372,30
14,-3,0,14.0,-3.0,0.3027808666229248,302.11985116040904,42,311,-62,864,303,476,372,30
14,-4,0,14.0,-4.0,0.3110039234161377,287.61031046545656,42,297,-58,864,303,476,372,30
17,-5,0,17.0,-5.0,0.3189549446105957,269.9719284420836,42,280,-53,864,303,476,372,30
18,-4,0,18.0,-4.0,0.3268418312072754,251.54267950930483,42,262,-49,864,303,476,372,30
23,-6,0,23.0,-6.0,0.33490586280822754,227.8373941550189,42,239,-43,864,303,476,372,30
23,-6,0,23.0,-6.0,0.34293103218078613,204.14607000811125,42,216,-37,864,303,476,372,30
23,-5,0,23.0,-5.0,0.35089993476867676,180.63486396856774,42,193,-32,864,303,476,372,30
22,-5,0,22.0,-5.0,0.35891199111938477,158.11845655504212,42,171,-27,864,303,476,372,30
21,-3,0,21.0,-3.0,0.36678481101989746,136.90786681406595,42,150,-24,864,303,476,372,30
18,-2,0,18.0,-2.0,0.3748648166656494,118.82077566656082,42,132,-22,864,303,476,372,30
17,-2,0,17.0,-2.0,0.3828558921813965,101.72617529928752,42,115,-20,864,303,476,372,30
15,-1,0,15.0,-1.0,0.39099597930908203,86.78899744078434,42,100,-19,864,303,476,372,30
15,-1,0,15.0,-1.0,0.39890098571777344,71.88498144098322,42,85,-18,864,303,476,372,30
12,-1,0,12.0,-1.0,0.40689587593078613,59.95331880577403,42,73,-17,864,303,476,372,30
10,-1,0,10.0,-1.0,0.41490697860717773,50.0,42,63,-16,864,303,476,372,30
8,-1,0,8.0,-1.0,0.4229269027709961,42.0087712549569,42,55,-15,864,303,476,372,30
6,-1,0,6.0,-1.0,0.43077898025512695,35.96076922496363,42,49,-14,864,303,476,372,30
5,0,0,5.0,-0.0,0.43895792961120605,31.173585522460783,42,44,-14,864,303,476,372,30
4,-1,0,4.0,-1.0,0.44679784774780273,27.059481689626182,42,40,-13,864,303,476,372,30
4,-1,0,4.0,-1.0,0.4548509120941162,22.947331922020552,42,36,-12,864,303,476,372,30
4,0,0,4.0,-0.0,0.46296000480651855,19.17601498127012,42,32,-12,864,303,476,372,30
4,0,0,4.0,-0.0,0.47091197967529297,15.463092423455635,42,28,-12,864,303,476,372,30
2,-1,0,2.0,-1.0,0.47896504402160645,13.231188426986208,42,26,-11,864,303,476,372,30
2,0,0,2.0,-0.0,0.4868960380554199,11.40075756488817,42,24,-11,864,303,476,372,30
2,-1,0,2.0,-1.0,0.49503397941589355,9.166091947189145,42,22,-10,864,303,476,372,30
2,0,0,2.0,-0.0,0.502802848815918,7.360679774997898,42,20,-10,864,303,476,372,30
1,-1,0,1.0,-1.0,0.5108659267425537,6.023796041628639,42,19,-9,864,303,476,372,30
2,0,0,2.0,-0.0,0.5189290046691895,4.235384061671343,42,17,-9,864,303,476,372,30
2,-1,0,2.0,-1.0,0.5268189907073975,2.0,42,15,-8,864,303,476,372,30
4,-1,0,4.0,-1.0,0.5348868370056152,-1.9615951895947017,42,11,-7,864,303,476,372,30
2,-1,0,2.0,-1.0,0.542982816696167,-4.183346173608031,42,9,-6,864,303,476,372,30
4,-1,0,4.0,-1.0,0.5510358810424805,-7.9289321881345245,42,5,-5,864,303,476,372,30
2,-1,0,2.0,-1.0,0.5588798522949219,-10.0,42,3,-4,864,303,476,372,30
3,-1,0,3.0,-1.0,0.5669598579406738,-12.0,42,0,-3,864,303,476,372,30
2,-1,0,2.0,-1.0,0.5749928951263428,-12.17157287525381,42,-2,-2,864,303,476,372,30
1,-1,0,1.0,-1.0,0.5828230381011963,-11.83772233983162,42,-3,-1,864,303,476,372,30
1,0,0,1.0,-0.0,0.5909628868103027,-10.876894374382339,42,-4,-1,864,303,476,372,30
0,-1,0,-0.0,-1.0,0.5987558364868164,-11.0,42,-4,0,864,303,476,372,30
1,0,0,1.0,-0.0,0.6068239212036133,-10.0,42,-5,0,864,303,476,372,30
0,0,1,-0.0,-0.0,0.6619968414306641,-10.0,42,-5,0,864,303,476,372,30
0,0,0,-0.0,-0.0,0.09778237342834473,1094.9078908874371,43,-700,851,169,1154,869,303,15
-1,1,0,-1.0,1.0,0.11768031120300293,1093.5003407541499,43,-699,850,169,1154,869,303,15
-1,2,0,-1.0,2.0,0.1257033348083496,1091.3205360913544,43,-698,848,169,1154,869,303,15
-1,1,0,-1.0,1.0,0.13355135917663574,1089.9129409392524,43,-697,847,169,1154,869,303,15
0,1,0,-0.0,1.0,0.14966917037963867,1089.1409580888765,43,-697,846,169,1154,869,303,15
0,1,0,-0.0,1.0,0.1896991729736328,1088.3693441027094,43,-697,845,169,1154,869,303,15
-1,4,0,-1.0,4.0,0.19769835472106934,1084.6487530336854,43,-696,841,169,1154,869,303,15
-1,5,0,-1.0,5.0,0.20567822456359863,1080.1619014663822,43,-695,836,169,1154,869,303,15
-3,6,0,-3.0,6.0,0.21364927291870117,1073.6312969741346,43,-692,830,169,1154,869,303,15
-4,6,0,-4.0,6.0,0.22171521186828613,1066.4616900476701,43,-688,824,169,1154,869,303,15
-7,8,0,-7.0,8.0,0.2296452522277832,1055.834417959825,43,-681,816,169,1154,869,303,15
-7,7,0,-7.0,7.0,0.23775529861450195,1045.97530835248,43,-674,809,169,1154,869,303,15
-9,8,0,-9.0,8.0,0.24566435813903809,1034.0696422430153,43,-665,801,169,1154,869,303,15
-11,10,0,-11.0,10.0,0.25368332862854004,1019.3513043787686,43,-654,791,169,1154,869,303,15
-13,12,0,-13.0,12.0,0.2616603374481201,1001.8220854045574,43,-641,779,169,1154,869,303,15
-17,14,0,-17.0,14.0,0.2696702480316162,980.2188207282112,43,-624,765,169,1154,869,303,15
-19,17,0,-19.0,17.0,0.2777211666107178,955.044177779794,43,-605,748,169,1154,869,303,15
-22,19,0,-22.0,19.0,0.28558826446533203,926.4505878727593,43,-583,729,169,1154,869,303,15
-25,22,0,-25.0,22.0,0.2935311794281006,893.6736367852675,43,-558,707,169,1154,869,303,15
-28,21,0,-28.0,21.0,0.3015592098236084,859.8886895097894,43,-530,686,169,1154,869,303,15
-28,21,0,-28.0,21.0,0.309617280960083,826.2040566391885,43,-502,665,169,1154,869,303,15
-28,21,0,-28.0,21.0,0.31772422790527344,792.6324155510456,43,-474,644,169,1154,869,303,15
-28,22,0,-28.0,22.0,0.32576417922973633,758.3757247260982,43,-446,622,169,1154,869,303,15
-26,21,0,-26.0,21.0,0.33375024795532227,726.2127931235243,43,-420,601,169,1154,869,303,15
-24,21,0,-24.0,21.0,0.34165120124816895,695.2933859862272,43,-396,580,169,1154,869,303,15
-22,21,0,-22.0,21.0,0.3498961925506592,665.5749028918638,43,-374,559,169,1154,869,303,15
-19,20,0,-19.0,20.0,0.3577122688293457,638.4037496017512,43,-355,539,169,1154,869,303,15
-17,19,0,-17.0,19.0,0.3655712604522705,613.1967429775813,43,-338,520,169,1154,869,303,15
-15,18,0,-15.0,18.0,0.3735623359680176,589.9363450151113,43,-323,502,169,1154,869,303,15
-13,17,0,-13.0,17.0,0.38171815872192383,568.6083738098326,43,-310,485,169,1154,869,303,15
-13,19,0,-13.0,19.0,0.3896942138671875,545.5984075257546,43,-297,466,169,1154,869,303,15
-12,18,0,-12.0,18.0,0.39773130416870117,523.9698673182877,43,-285,448,169,1154,869,303,15
-10,17,0,-10.0,17.0,0.4056813716888428,504.2592297455372,43,-275,431,169,1154,869,303,15
-9,17,0,-9.0,17.0,0.4137141704559326,485.0894227678543,43,-266,414,169,1154,869,303,15
-8,17,0,-8.0,17.0,0.4217243194580078,466.46911198091897,43,-258,397,169,1154,869,303,15
-9,17,0,-9.0,17.0,0.4296841621398926,447.31376822632177,43,-249,380,169,1154,869,303,15
-10,17,0,-10.0,17.0,0.4376962184906006,427.6147719532782,43,-239,363,169,1154,869,303,15
-10,18,0,-10.0,18.0,0.445695161819458,407.0845324326906,43,-229,345,169,1154,869,303,15
-10,17,0,-10.0,17.0,0.45368218421936035,387.3919370372574,43,-219,328,169,1154,869,303,15
-9,16,0,-9.0,16.0,0.4616532325744629,369.09041466115565,43,-210,312,169,1154,869,303,15
-8,14,0,-8.0,14.0,0.4696803092956543,353.01111093964863,43,-202,298,169,1154,869,303,15
-6,13,0,-6.0,13.0,0.4776473045349121,338.8916015170071,43,-196,285,169,1154,869,303,15
-5,12,0,-5.0,12.0,0.48569226264953613,326.1816321467917,43,-191,273,169,1154,869,303,15
-3,12,0,-3.0,12.0,0.49369215965270996,314.65975812961125,43,-188,261,169,1154,869,303,15
-3,11,0,-3.0,11.0,0.501732349395752,304.0064308016797,43,-185,250,169,1154,869,303,15
-2,9,0,-2.0,9.0,0.5097413063049316,295.60535355475787,43,-183,241,169,1154,869,303,15
-1,10,0,-1.0,10.0,0.517681360244751,287.0833215264001,43,-182,231,169,1154,869,303,15
-2,10,0,-2.0,10.0,0.525590181350708,278.02806879323305,43,-180,221,169,1154,869,303,15
-2,9,0,-2.0,9.0,0.5337932109832764,269.8176294963888,43,-178,212,169,1154,869,303,15
-2,9,0,-2.0,9.0,0.5416662693023682,261.6726632912251,43,-176,203,169,1154,869,303,15
-3,9,0,-3.0,9.0,0.549708366394043,252.93268359327192,43,-173,194,169,1154,869,303,15
-2,6,0,-2.0,6.0,0.557706356048584,247.13579047430528,43,-171,188,169,1154,869,303,15
-1,5,0,-1.0,5.0,0.5656893253326416,242.77790134437433,43,-170,183,169,1154,869,303,15
-3,6,0,-3.0,6.0,0.5736773014068604,236.34748817277733,43,-167,177,169,1154,869,303,15
-2,6,0,-2.0,6.0,0.5815722942352295,230.6257561797542,43,-165,171,169,1154,869,303,15
-3,4,0,-3.0,4.0,0.5898103713989258,225.66499521844707,43,-162,167,169,1154,869,303,15
-2,4,0,-2.0,4.0,0.5975863933563232,221.40534144367115,43,-160,163,169,1154,869,303,15
-3,4,0,-3.0,4.0,0.6056203842163086,216.45021816950637,43,-157,159,169,1154,869,303,15
-3,3,0,-3.0,3.0,0.6136691570281982,212.20766409959302,43,-154,156,169,1154,869,303,15
-3,4,0,-3.0,4.0,0.6217343807220459,207.2545215392198,43,-151,152,169,1154,869,303,15
-4,6,0,-4.0,6.0,0.6297893524169922,200.18349355100662,43,-147,146,169,1154,869,303,15
-6,6,0,-6.0,6.0,0.6377131938934326,191.69826370655582,43,-141,140,169,1154,869,303,15
-4,6,0,-4.0,6.0,0.645667314529419,184.637678967368,43,-137,134,169,1154,869,303,15
-4,5,0,-4.0,5.0,0.6536352634429932,178.28356645962967,43,-133,129,169,1154,869,303,15
-4,4,0,-4.0,4.0,0.66158127784729,172.62739212046696,43,-129,125,169,1154,869,303,15
-3,5,0,-3.0,5.0,0.6695683002471924,167.0,43,-126,120,169,1154,869,303,15
-3,4,0,-3.0,4.0,0.6777603626251221,162.07099100673656,43,-123,116,169,1154,869,303,15
-4,4,0,-4.0,4.0,0.685706377029419,156.41664541900252,43,-119,112,169,1154,869,303,15
-5,5,0,-5.0,5.0,0.693683385848999,149.348968656656,43,-114,107,169,1154,869,303,15
-6,6,0,-6.0,6.0,0.7016713619232178,140.8681845428556,43,-108,101,169,1154,869,303,15
-5,6,0,-5.0,6.0,0.7096881866455078,133.12137595670404,43,-103,95,169,1154,869,303,15
-5,6,0,-5.0,6.0,0.7175371646881104,125.38202294873727,43,-98,89,169,1154,869,303,15
-3,4,0,-3.0,4.0,0.7255961894989014,120.47548783981962,43,-95,85,169,1154,869,303,15
-4,6,0,-4.0,6.0,0.7336952686309814,113.50726119201282,43,-91,79,169,1154,869,303,15
-3,4,0,-3.0,4.0,0.7416121959686279,108.62439189029277,43,-88,75,169,1154,869,303,15
-3,4,0,-3.0,4.0,0.7497603893280029,103.75197515168747,43,-85,71,169,1154,869,303,15
-3,4,0,-3.0,4.0,0.7577033042907715,98.89145385724005,43,-82,67,169,1154,869,303,15
-3,3,0,-3.0,3.0,0.7656822204589844,94.67103815738285,43,-79,64,169,1154,869,303,15
-2,3,0,-2.0,3.0,0.7737782001495361,91.2344135219425,43,-77,61,169,1154,869,303,15
-2,5,0,-2.0,5.0,0.7816822528839111,86.60021367496978,43,-75,56,169,1154,869,303,15
-3,4,0,-3.0,4.0,0.7898263931274414,81.81441324469807,43,-72,52,169,1154,869,303,15
-2,4,0,-2.0,4.0,0.7975723743438721,77.87638069569178,43,-70,48,169,1154,869,303,15
-2,3,0,-2.0,3.0,0.8057193756103516,74.54140052758476,43,-68,45,169,1154,869,303,15
-1,3,0,-1.0,3.0,0.813650369644165,72.07591289387686,43,-67,42,169,1154,869,303,15
-2,3,0,-2.0,3.0,0.821763277053833,68.8023746329889,43,-65,39,169,1154,869,303,15
-2,3,0,-2.0,3.0,0.829620361328125,65.56031973468694,43,-63,36,169,1154,869,303,15
-1,2,0,-1.0,2.0,0.8377432823181152,63.710678118654755,43,-62,34,169,1154,869,303,15
-2,3,0,-2.0,3.0,0.8457622528076172,60.53517601961218,43,-60,31,169,1154,869,303,15
-3,4,0,-3.0,4.0,0.8536713123321533,56.071388124885914,43,-57,27,169,1154,869,303,15
-2,3,0,-2.0,3.0,0.8616821765899658,53.00833275470999,43,-55,24,169,1154,869,303,15
-2,3,0,-2.0,3.0,0.8696703910827637,50.0087712549569,43,-53,21,169,1154,869,303,15
-3,3,0,-3.0,3.0,0.8775303363800049,46.14132102234569,43,-50,18,169,1154,869,303,15
-3,3,0,-3.0,3.0,0.8855583667755127,42.33558553417604,43,-47,15,169,1154,869,303,15
-3,3,0,-3.0,3.0,0.8936412334442139,38.60701700396552,43,-44,12,169,1154,869,303,15
-3,2,0,-3.0,2.0,0.9016673564910889,35.20189569201838,43,-41,10,169,1154,869,303,15
-2,2,0,-2.0,2.0,0.9097023010253906,32.81205847478876,43,-39,8,169,1154,869,303,15
-2,1,0,-2.0,1.0,0.9176733493804932,30.656340767525464,43,-37,7,169,1154,869,303,15
-2,2,0,-2.0,2.0,0.9257552623748779,28.355339059327378,43,-35,5,169,1154,869,303,15
-1,2,0,-1.0,2.0,0.9336602687835693,27.132096331752024,43,-34,3,169,1154,869,303,15
-3,1,0,-3.0,1.0,0.9415493011474609,24.064449134018133,43,-31,2,169,1154,869,303,15
-3,1,0,-3.0,1.0,0.9497241973876953,21.0178514522438,43,-28,1,169,1154,869,303,15
-1,2,0,-1.0,2.0,0.9576683044433594,20.018512172212592,43,-27,-1,169,1154,869,303,15
-2,1,0,-2.0,1.0,0.9656322002410889,18.079872407968907,43,-25,-2,169,1154,869,303,15
-2,2,0,-2.0,2.0,0.9737582206726074,16.345235059857504,43,-23,-4,169,1154,869,303,15
-2,1,0,-2.0,1.0,0.9817233085632324,14.587033144922902,43,-21,-5,169,1154,869,303,15
-2,1,0,-2.0,1.0,0.9896993637084961,12.924858845171276,43,-19,-6,169,1154,869,303,15
-1,2,0,-1.0,2.0,0.9977271556854248,12.697715603592208,43,-18,-8,169,1154,869,303,15
-2,1,0,-2.0,1.0,1.0057153701782227,11.35755975068582,43,-16,-9,169,1154,869,303,15
-1,1,0,-1.0,1.0,1.0136082172393799,11.027756377319946,43,-15,-10,169,1154,869,303,15
-1,0,0,-1.0,-0.0,1.0216171741485596,10.204650534085253,43,-14,-10,169,1154,869,303,15
-1,0,0,-1.0,-0.0,1.0297622680664062,9.401219466856727,43,-13,-10,169,1154,869,303,15
-1,0,0,-1.0,-0.0,1.0376791954040527,8.620499351813308,43,-12,-10,169,1154,869,303,15
-1,0,0,-1.0,-0.0,1.0457792282104492,7.866068747318506,43,-11,-10,169,1154,869,303,15
-1,0,0,-1.0,-0.0,1.0616662502288818,7.142135623730951,43,-10,-10,169,1154,869,303,15
-1,0,0,-1.0,-0.0,1.0856971740722656,6.45362404707371,43,-9,-10,169,1154,869,303,15
0,0,1,-0.0,-0.0,1.1736571788787842,6.45362404707371,43,-9,-10,169,1154,869,303,15
0,0,0,-0.0,-0.0,0.02796006202697754,1037.0676670212285,44,844,-648,1022,516,178,1164,55
-1,0,0,-1.0,-0.0,0.03663802146911621,1037.8610237960634,44,845,-648,1022,516,178,1164,55
-1,0,0,-1.0,-0.0,0.052438974380493164,1038.6547283243292,44,846,-648,1022,516,178,1164,55
-1,0,0,-1.0,-0.0,0.06851792335510254,1039.44877982958,44,847,-648,1022,516,178,1164,55
-1,0,0,-1.0,-0.0,0.08456993103027344,1040.243177537341,44,848,-648,1022,516,178,1164,55
-1,-1,0,-1.0,-1.0,0.10853290557861328,1040.4314966310485,44,849,-647,1022,516,178,1164,55
-1,0,0,-1.0,-0.0,0.11670589447021484,1041.2270357934217,44,850,-647,1022,516,178,1164,55
-1,0,0,-1.0,-0.0,0.13242697715759277,1042.0229183698543,44,851,-647,1022,516,178,1164,55
4,-2,0,4.0,-2.0,0.2285630702972412,1037.628573728885,44,847,-645,1022,516,178,1164,55
4,-3,0,4.0,-3.0,0.2364809513092041,1032.6287085578608,44,843,-642,1022,516,178,1164,55
7,-5,0,7.0,-5.0,0.24459600448608398,1024.0304467521387,44,836,-637,1022,516,178,1164,55
9,-6,0,9.0,-6.0,0.2524259090423584,1013.2355502481157,44,827,-631,1022,516,178,1164,55
10,-6,0,10.0,-6.0,0.26042985916137695,1001.6466837549228,44,817,-625,1022,516,178,1164,55
14,-7,0,14.0,-7.0,0.2683839797973633,986.278342806161,44,803,-618,1022,516,178,1164,55
19,-9,0,19.0,-9.0,0.27639102935791016,965.7421618930064,44,784,-609,1022,516,178,1164,55
24,-11,0,24.0,-11.0,0.2843790054321289,940.0594604262966,44,760,-598,1022,516,178,1164,55
27,-11,0,27.0,-11.0,0.2924339771270752,912.0729471132687,44,733,-587,1022,516,178,1164,55
33,-13,0,33.0,-13.0,0.3004639148712158,878.2491369783238,44,700,-574,1022,516,178,1164,55
33,-15,0,33.0,-15.0,0.3085620403289795,843.2700730233115,44,667,-559,1022,516,178,1164,55
37,-18,0,37.0,-18.0,0.31649303436279297,803.4101396298097,44,630,-541,1022,516,178,1164,55
38,-21,0,38.0,-21.0,0.324509859085083,760.9492369435991,44,592,-520,1022,516,178,1164,55
38,-25,0,38.0,-25.0,0.3325209617614746,715.9273181139592,44,554,-495,1022,516,178,1164,55
38,-26,0,38.0,-26.0,0.34041285514831543,670.2926215011887,44,516,-469,1022,516,178,1164,55
35,-23,0,35.0,-23.0,0.3484020233154297,628.9550289463448,44,481,-446,1022,516,178,1164,55
33,-22,0,33.0,-22.0,0.35656094551086426,589.8306088384395,44,448,-424,1022,516,178,1164,55
27,-20,0,27.0,-20.0,0.3644838333129883,556.4869321587246,44,421,-404,1022,516,178,1164,55
22,-21,0,22.0,-21.0,0.3725130558013916,526.0732320407488,44,399,-383,1022,516,178,1164,55
21,-23,0,21.0,-23.0,0.3805549144744873,495.0,44,378,-360,1022,516,178,1164,55
17,-23,0,17.0,-23.0,0.3885660171508789,466.85220461186566,44,361,-337,1022,516,178,1164,55
14,-21,0,14.0,-21.0,0.3965120315551758,442.32398191441274,44,347,-316,1022,516,178,1164,55
13,-20,0,13.0,-20.0,0.4045429229736328,419.2869032360237,44,334,-296,1022,516,178,1164,55
11,-19,0,11.0,-19.0,0.41248297691345215,398.5091068355647,44,323,-277,1022,516,178,1164,55
11,-14,0,11.0,-14.0,0.4203798770904541,381.0600446012817,44,312,-263,1022,516,178,1164,55
9,-12,0,9.0,-12.0,0.42839789390563965,366.45901946708506,44,303,-251,1022,516,178,1164,55
9,-11,0,9.0,-11.0,0.43655991554260254,352.5207504208433,44,294,-240,1022,516,178,1164,55
7,-8,0,7.0,-8.0,0.44457006454467773,342.04335788630584,44,287,-232,1022,516,178,1164,55
5,-7,0,5.0,-7.0,0.4525279998779297,333.7616941971528,44,282,-225,1022,516,178,1164,55
4,-5,0,4.0,-5.0,0.46051883697509766,327.5193929815406,44,278,-220,1022,516,178,1164,55
2,-5,0,2.0,-5.0,0.46855592727661133,322.8585428426752,44,276,-215,1022,516,178,1164,55
2,-2,0,2.0,-2.0,0.47644591331481934,320.0518693221519,44,274,-213,1022,516,178,1164,55
0,-2,0,-0.0,-2.0,0.4843559265136719,318.8279919266224,44,274,-211,1022,516,178,1164,55
2,-3,0,2.0,-3.0,0.4925398826599121,315.4149529445231,44,272,-208,1022,516,178,1164,55
1,-2,0,1.0,-2.0,0.500514030456543,313.4071092089588,44,271,-206,1022,516,178,1164,55
2,-3,0,2.0,-3.0,0.508551836013794,310.0014836762592,44,269,-203,1022,516,178,1164,55
2,-3,0,2.0,-3.0,0.5164289474487305,306.600059952033,44,267,-200,1022,516,178,1164,55
3,-4,0,3.0,-4.0,0.5244379043579102,301.80389292099323,44,264,-196,1022,516,178,1164,55
4,-4,0,4.0,-4.0,0.5325138568878174,296.20891076825217,44,260,-192,1022,516,178,1164,55
4,-5,0,4.0,-5.0,0.5405130386352539,290.02523558858843,44,256,-187,1022,516,178,1164,55
4,-5,0,4.0,-5.0,0.5485339164733887,283.85044635644323,44,252,-182,1022,516,178,1164,55
5,-5,0,5.0,-5.0,0.5565910339355469,276.87168344549644,44,247,-177,1022,516,178,1164,55
6,-7,0,6.0,-7.0,0.5645339488983154,267.9254142999548,44,241,-170,1022,516,178,1164,55
8,-6,0,8.0,-6.0,0.5725059509277344,257.92981591964013,44,233,-164,1022,516,178,1164,55
8,-5,0,8.0,-5.0,0.580467939376831,248.51043537405258,44,225,-159,1022,516,178,1164,55
9,-6,0,9.0,-6.0,0.5886549949645996,237.69794105734934,44,216,-153,1022,516,178,1164,55
10,-6,0,10.0,-6.0,0.5965049266815186,226.07113624433742,44,206,-147,1022,516,178,1164,55
11,-8,0,11.0,-8.0,0.6045548915863037,212.47024867402632,44,195,-139,1022,516,178,1164,55
11,-7,0,11.0,-7.0,0.6125478744506836,199.45087767549057,44,184,-132,1022,516,178,1164,55
10,-7,0,10.0,-7.0,0.6205258369445801,187.24518664371436,44,174,-125,1022,516,178,1164,55
8,-7,0,8.0,-7.0,0.6285288333892822,176.66639388961548,44,166,-118,1022,516,178,1164,55
7,-7,0,7.0,-7.0,0.6363909244537354,166.91235133430774,44,159,-111,1022,516,178,1164,55
7,-7,0,7.0,-7.0,0.6445050239562988,157.1738309315414,44,152,-104,1022,516,178,1164,55
6,-7,0,6.0,-7.0,0.6523919105529785,148.28548142958104,44,146,-97,1022,516,178,1164,55
7,-8,0,7.0,-8.0,0.660444974899292,138.05150711217394,44,139,-89,1022,516,178,1164,55
6,-7,0,6.0,-7.0,0.6685130596160889,129.24659996300718,44,133,-82,1022,516,178,1164,55
7,-8,0,7.0,-8.0,0.6765329837799072,119.12323566086263,44,126,-74,1022,516,178,1164,55
7,-8,0,7.0,-8.0,0.684561014175415,109.07718398026907,44,119,-66,1022,516,178,1164,55
5,-7,0,5.0,-7.0,0.6926300525665283,101.36276718737409,44,114,-59,1022,516,178,1164,55
6,-7,0,6.0,-7.0,0.7003579139709473,92.86659251017358,44,108,-52,1022,516,178,1164,55
3,-5,0,3.0,-5.0,0.7084488868713379,88.03912377969506,44,105,-47,1022,516,178,1164,55
4,-4,0,4.0,-4.0,0.7164008617401123,82.77249200050075,44,101,-43,1022,516,178,1164,55
4,-5,0,4.0,-5.0,0.7244529724121094,77.17773274553444,44,97,-38,1022,516,178,1164,55
6,-5,0,6.0,-5.0,0.732429027557373,69.79876032264049,44,91,-33,1022,516,178,1164,55
5,-5,0,5.0,-5.0,0.7405200004577637,63.44335243676011,44,86,-28,1022,516,178,1164,55
6,-5,0,6.0,-5.0,0.7485089302062988,56.24061508662703,44,80,-23,1022,516,178,1164,55
6,-4,0,6.0,-4.0,0.7564990520477295,49.40026177965623,44,74,-19,1022,516,178,1164,55
5,-4,0,5.0,-4.0,0.7645390033721924,43.611613775638915,44,69,-15,1022,516,178,1164,55
2,-2,0,2.0,-2.0,0.7725389003753662,41.24954212300622,44,67,-13,1022,516,178,1164,55
2,-1,0,2.0,-1.0,0.7804129123687744,39.09841147864296,44,65,-12,1022,516,178,1164,55
2,-2,0,2.0,-2.0,0.7884519100189209,36.788713735268246,44,63,-10,1022,516,178,1164,55
2,-1,0,2.0,-1.0,0.7966809272766113,34.66036003787198,44,61,-9,1022,516,178,1164,55
2,-1,0,2.0,-1.0,0.8045589923858643,32.53990258641679,44,59,-8,1022,516,178,1164,55
2,-1,0,2.0,-1.0,0.8125059604644775,30.42821606144492,44,57,-7,1022,516,178,1164,55
2,-1,0,2.0,-1.0,0.8205230236053467,28.326304774492215,44,55,-6,1022,516,178,1164,55
0,0,1,-0.0,-0.0,0.8724160194396973,28.326304774492215,44,55,-6,1022,516,178,1164,55
0,0,0,-0.0,-0.0,0.06274247169494629,920.8253630704679,45,-921,39,46,561,967,522,3
1,0,0,1.0,-0.0,0.0838165283203125,921.8244686829668,45,-922,39,46,561,967,522,3
1,0,0,1.0,-0.0,0.09986448287963867,922.8235762308732,45,-923,39,46,561,967,522,3
1,0,0,1.0,-0.0,0.11577749252319336,923.8226857079145,45,-924,39,46,561,967,522,3
1,0,0,1.0,-0.0,0.18787145614624023,924.8217971078451,45,-925,39,46,561,967,522,3
1,0,0,1.0,-0.0,0.19572949409484863,925.8209104244465,45,-926,39,46,561,967,522,3
1,0,0,1.0,-0.0,0.203857421875,926.8200256515269,45,-927,39,46,561,967,522,3
-3,4,0,-3.0,4.0,0.2597663402557373,923.6626411832588,45,-924,35,46,561,967,522,3
-8,8,0,-8.0,8.0,0.2679634094238281,915.3978393689064,45,-916,27,46,561,967,522,3
-13,10,0,-13.0,10.0,0.2759213447570801,902.1600079720093,45,-903,17,46,561,967,522,3
-15,10,0,-15.0,10.0,0.2839033603668213,887.0275896614925,45,-888,7,46,561,967,522,3
-16,10,0,-16.0,10.0,0.29204440116882324,871.0051605351886,45,-872,-3,46,561,967,522,3
-15,6,0,-15.0,6.0,0.2998483180999756,856.0472565734051,45,-857,-9,46,561,967,522,3
-14,3,0,-14.0,3.0,0.30791735649108887,842.0854049264523,45,-843,-12,46,561,967,522,3
-18,2,0,-18.0,2.0,0.3159165382385254,824.1187793281644,45,-825,-14,46,561,967,522,3
-20,1,0,-20.0,1.0,0.32402753829956055,804.1397394241574,45,-805,-15,46,561,967,522,3
-25,0,0,-25.0,-0.0,0.3318965435028076,779.1442174367506,45,-780,-15,46,561,967,522,3
-31,-1,0,-31.0,-1.0,0.3399693965911865,748.1308296953209,45,-749,-14,46,561,967,522,3
-36,-2,0,-36.0,-2.0,0.34780240058898926,712.1009746171997,45,-713,-12,46,561,967,522,3
-40,-3,0,-40.0,-3.0,0.3558633327484131,672.0601756158211,45,-673,-9,46,561,967,522,3
-39,-2,0,-39.0,-2.0,0.363924503326416,633.0386423554955,45,-634,-7,46,561,967,522,3
-37,-3,0,-37.0,-3.0,0.37189340591430664,596.013400184619,45,-597,-4,46,561,967,522,3
-39,-3,0,-39.0,-3.0,0.3798844814300537,557.0008960566282,45,-558,-1,46,561,967,522,3
-37,-2,0,-37.0,-2.0,0.3879053592681885,520.0009596920144,45,-521,1,46,561,967,522,3
-38,-3,0,-38.0,-3.0,0.395829439163208,482.01656286301403,45,-483,4,46,561,967,522,3
-36,-3,0,-36.0,-3.0,0.4037904739379883,446.0548064835004,45,-447,7,46,561,967,522,3
-34,-2,0,-34.0,-2.0,0.41185450553894043,412.09805131469693,45,-413,9,46,561,967,522,3
-32,-3,0,-32.0,-3.0,0.41986751556396484,380.1889295349486,45,-381,12,46,561,967,522,3
-29,-3,0,-29.0,-3.0,0.4277193546295166,351.319457311117,45,-352,15,46,561,967,522,3
-25,-1,0,-25.0,-1.0,0.4358785152435303,326.3912033027155,45,-327,16,46,561,967,522,3
-22,-2,0,-22.0,-2.0,0.4438295364379883,304.5306858565928,45,-305,18,46,561,967,522,3
-20,-1,0,-20.0,-1.0,0.4518883228302002,284.63263118908526,45,-285,19,46,561,967,522,3
-17,0,0,-17.0,-0.0,0.45990538597106934,267.6726632912251,45,-268,19,46,561,967,522,3
-15,0,0,-15.0,-0.0,0.4678823947906494,252.71243564319033,45,-253,19,46,561,967,522,3
-13,0,0,-13.0,-0.0,0.47592735290527344,239.75090861718465,45,-240,19,46,561,967,522,3
-12,0,0,-12.0,-0.0,0.48386144638061523,227.79029699705362,45,-228,19,46,561,967,522,3
-12,1,0,-12.0,1.0,0.49184131622314453,215.74870241826133,45,-216,18,46,561,967,522,3
-11,1,0,-11.0,1.0,0.4998493194580078,204.70367036103173,45,-205,17,46,561,967,522,3
-8,1,0,-8.0,1.0,0.5077915191650391,196.6486782146544,45,-197,16,46,561,967,522,3
-7,1,0,-7.0,1.0,0.5159144401550293,189.59118552545917,45,-190,15,46,561,967,522,3
-4,1,0,-4.0,1.0,0.523862361907959,185.52613757862463,45,-186,14,46,561,967,522,3
-3,0,0,-3.0,-0.0,0.5318624973297119,182.53473785635242,45,-183,14,46,561,967,522,3
-1,0,0,-1.0,-0.0,0.5398433208465576,181.53766734567415,45,-182,14,46,561,967,522,3
-1,0,0,-1.0,-0.0,0.5477645397186279,180.54062906137568,45,-181,14,46,561,967,522,3
-1,0,0,-1.0,-0.0,0.5637493133544922,179.54362353736008,45,-180,14,46,561,967,522,3
-1,0,0,-1.0,-0.0,0.5717794895172119,178.5466513193716,45,-179,14,46,561,967,522,3
-2,1,0,-2.0,1.0,0.5798983573913574,176.47675904185314,45,-177,13,46,561,967,522,3
-3,1,0,-3.0,1.0,0.5877795219421387,173.41330224498358,45,-174,12,46,561,967,522,3
-3,2,0,-3.0,2.0,0.5958395004272461,170.29214809792072,45,-171,10,46,561,967,522,3
-5,1,0,-5.0,1.0,0.603844404220581,165.24379687675568,45,-166,9,46,561,967,522,3
-5,2,0,-5.0,2.0,0.6118664741516113,160.15210206509875,45,-161,7,46,561,967,522,3
-5,1,0,-5.0,1.0,0.6198713779449463,155.11534197509224,45,-156,6,46,561,967,522,3
-6,1,0,-6.0,1.0,0.6279013156890869,149.08331019803634,45,-150,5,46,561,967,522,3
-5,2,0,-5.0,2.0,0.6357264518737793,144.03103116229988,45,-145,3,46,561,967,522,3
-6,1,0,-6.0,1.0,0.6437604427337646,138.01438774457844,45,-139,2,46,561,967,522,3
-7,2,0,-7.0,2.0,0.6519265174865723,131.0,45,-132,0,46,561,967,522,3
-7,0,0,-7.0,-0.0,0.6598913669586182,124.0,45,-125,0,46,561,967,522,3
-7,2,0,-7.0,2.0,0.6678354740142822,117.01694793545543,45,-118,-2,46,561,967,522,3
-8,0,0,-8.0,-0.0,0.6758334636688232,109.01818031580054,45,-110,-2,46,561,967,522,3
-9,2,0,-9.0,2.0,0.6838934421539307,100.07917688624102,45,-101,-4,46,561,967,522,3
-7,0,0,-7.0,-0.0,0.6919143199920654,93.08506789071261,45,-94,-4,46,561,967,522,3
-6,1,0,-6.0,1.0,0.6999504566192627,87.14193099768123,45,-88,-5,46,561,967,522,3
-6,0,0,-6.0,-0.0,0.7079274654388428,81.15229759416349,45,-82,-5,46,561,967,522,3
-6,0,0,-6.0,-0.0,0.7157855033874512,75.16429609731846,45,-76,-5,46,561,967,522,3
-7,0,0,-7.0,-0.0,0.7237603664398193,68.18092222571191,45,-69,-5,46,561,967,522,3
-7,1,0,-7.0,1.0,0.7318594455718994,61.289646009589745,45,-62,-6,46,561,967,522,3
-6,0,0,-6.0,-0.0,0.7398543357849121,55.32051136131489,45,-56,-6,46,561,967,522,3
-7,0,0,-7.0,-0.0,0.7478814125061035,48.36598018878993,45,-49,-6,46,561,967,522,3
-5,1,0,-5.0,1.0,0.7558653354644775,43.553338819890925,45,-44,-7,46,561,967,522,3
-4,0,0,-4.0,-0.0,0.7638654708862305,39.607881008493905,45,-40,-7,46,561,967,522,3
-4,0,0,-4.0,-0.0,0.7719683647155762,35.6742416417845,45,-36,-7,46,561,967,522,3
-4,0,0,-4.0,-0.0,0.7797143459320068,31.756678708318397,45,-32,-7,46,561,967,522,3
-3,0,0,-3.0,-0.0,0.7878084182739258,28.832867780352597,45,-29,-7,46,561,967,522,3
-3,0,0,-3.0,-0.0,0.7959144115447998,25.92582403567252,45,-26,-7,46,561,967,522,3
-2,0,0,-2.0,-0.0,0.8037865161895752,24.0,45,-24,-7,46,561,967,522,3
-2,0,0,-2.0,-0.0,0.8118853569030762,22.08679276123039,45,-22,-7,46,561,967,522,3
-1,0,0,-1.0,-0.0,0.8198535442352295,21.135943621178654,45,-21,-7,46,561,967,522,3
-1,0,0,-1.0,-0.0,0.8278903961181641,20.18962010041709,45,-20,-7,46,561,967,522,3
-1,0,0,-1.0,-0.0,0.8358645439147949,19.248456731316587,45,-19,-7,46,561,967,522,3
-1,0,0,-1.0,-0.0,0.8438084125518799,18.313207915827967,45,-18,-7,46,561,967,522,3
-1,0,0,-1.0,-0.0,0.8597965240478516,17.384776310850235,45,-17,-7,46,561,967,522,3
-1,0,0,-1.0,-0.0,0.8759534358978271,16.46424919657298,45,-16,-7,46,561,967,522,3
-1,0,0,-1.0,-0.0,0.8839445114135742,15.552945357246848,45,-15,-7,46,561,967,522,3
-1,0,0,-1.0,-0.0,0.891864538192749,14.652475842498529,45,-14,-7,46,561,967,522,3
-1,-1,0,-1.0,-1.0,0.8998444080352783,13.317821063276353,45,-13,-6,46,561,967,522,3
-1,0,0,-1.0,-0.0,0.9078843593597412,12.416407864998739,45,-12,-6,46,561,967,522,3
-1,0,0,-1.0,-0.0,0.9157884120941162,11.529964086141668,45,-11,-6,46,561,967,522,3
-1,0,0,-1.0,-0.0,0.9237244129180908,10.661903789690601,45,-10,-6,46,561,967,522,3
-2,0,0,-2.0,-0.0,0.931755542755127,9.0,45,-8,-6,46,561,967,522,3
-1,-1,0,-1.0,-1.0,0.9398014545440674,7.602325267042627,45,-7,-5,46,561,967,522,3
-1,0,0,-1.0,-0.0,0.9477615356445312,6.810249675906654,45,-6,-5,46,561,967,522,3
-1,0,0,-1.0,-0.0,0.9559173583984375,6.0710678118654755,45,-5,-5,46,561,967,522,3
-1,0,0,-1.0,-0.0,0.9639325141906738,5.4031242374328485,45,-4,-5,46,561,967,522,3
-1,-1,0,-1.0,-1.0,0.971860408782959,4.0,45,-3,-4,46,561,967,522,3
-1,0,0,-1.0,-0.0,0.9798624515533447,3.4721359549995796,45,-2,-4,46,561,967,522,3
-1,0,0,-1.0,-0.0,0.9877455234527588,3.1231056256176606,45,-1,-4,46,561,967,522,3
-1,0,0,-1.0,-0.0,1.0198814868927002,3.0,45,0,-4,46,561,967,522,3
0,-1,0,-0.0,-1.0,1.0838944911956787,2.0,45,0,-3,46,561,967,522,3
-1,0,0,-1.0,-0.0,1.0918164253234863,2.1622776601683795,45,1,-3,46,561,967,522,3
-1,0,0,-1.0,-0.0,1.1078684329986572,2.605551275463989,45,2,-3,46,561,967,522,3
0,-1,0,-0.0,-1.0,1.1158814430236816,1.8284271247461903,45,2,-2,46,561,967,522,3
0,0,1,-0.0,-0.0,1.1297714710235596,1.8284271247461903,45,2,-2,46,561,967,522,3
0,0,0,-0.0,-0.0,0.12242388725280762,1447.1999864883123,46,1424,-404,1468,159,44,563,66
5,0,0,5.0,-0.0,0.25551486015319824,1442.390456794404,46,1419,-404,1468,159,44,563,66
8,-3,0,8.0,-3.0,0.26349878311157227,1433.874909458881,46,1411,-401,1468,159,44,563,66
10,-2,0,10.0,-2.0,0.271500825881958,1423.7093052493349,46,1401,-399,1468,159,44,563,66
11,-3,0,11.0,-3.0,0.27956175804138184,1412.3082716154363,46,1390,-396,1468,159,44,563,66
15,-2,0,15.0,-2.0,0.2875208854675293,1397.3359745178752,46,1375,-394,1468,159,44,563,66
15,-3,0,15.0,-3.0,0.29546070098876953,1382.0904564726595,46,1360,-391,1468,159,44,563,66
19,-3,0,19.0,-3.0,0.303480863571167,1363.0032234919804,46,1341,-388,1468,159,44,563,66
23,-5,0,23.0,-5.0,0.31148386001586914,1339.5206737969377,46,1318,-383,1468,159,44,563,66
28,-5,0,28.0,-5.0,0.31956982612609863,1311.2410498121235,46,1290,-378,1468,159,44,563,66
32,-5,0,32.0,-5.0,0.32744574546813965,1279.13299630792,46,1258,-373,1468,159,44,563,66
39,-7,0,39.0,-7.0,0.3355567455291748,1239.7596002387882,46,1219,-366,1468,159,44,563,66
42,-6,0,42.0,-6.0,0.34372568130493164,1197.8245203927324,46,1177,-360,1468,159,44,563,66
45,-7,0,45.0,-7.0,0.3515138626098633,1152.7626237995528,46,1132,-353,1468,159,44,563,66
51,-9,0,51.0,-9.0,0.35962867736816406,1101.4148271245401,46,1081,-344,1468,159,44,563,66
54,-10,0,54.0,-10.0,0.3673686981201172,1046.9467579468906,46,1027,-334,1468,159,44,563,66
53,-11,0,53.0,-11.0,0.3756067752838135,993.160318858608,46,974,-323,1468,159,44,563,66
51,-11,0,51.0,-11.0,0.38349175453186035,941.3064199726902,46,923,-312,1468,159,44,563,66
48,-11,0,48.0,-11.0,0.39140868186950684,892.3248078377668,46,875,-301,1468,159,44,563,66
45,-10,0,45.0,-10.0,0.3995397090911865,846.5345359904862,46,830,-291,1468,159,44,563,66
43,-11,0,43.0,-11.0,0.40752077102661133,802.3256849875982,46,787,-280,1468,159,44,563,66
38,-11,0,38.0,-11.0,0.41564273834228516,762.8404362684771,46,749,-269,1468,159,44,563,66
37,-10,0,37.0,-10.0,0.423602819442749,724.6443756803055,46,712,-259,1468,159,44,563,66
36,-11,0,36.0,-11.0,0.4315378665924072,687.0555534123739,46,676,-248,1468,159,44,563,66
31,-10,0,31.0,-10.0,0.43955469131469727,654.5092726647401,46,645,-238,1468,159,44,563,66
30,-11,0,30.0,-11.0,0.44751977920532227,622.5562523536787,46,615,-227,1468,159,44,563,66
28,-11,0,28.0,-11.0,0.4555327892303467,592.479815821422,46,587,-216,1468,159,44,563,66
26,-11,0,26.0,-11.0,0.46336984634399414,564.2821778690537,46,561,-205,1468,159,44,563,66
26,-10,0,26.0,-10.0,0.47140979766845703,536.4295391003175,46,535,-195,1468,159,44,563,66
22,-8,0,22.0,-8.0,0.4794447422027588,513.0201461484731,46,513,-187,1468,159,44,563,66
20,-8,0,20.0,-8.0,0.4876668453216553,491.4902286983047,46,493,-179,1468,159,44,563,66
18,-6,0,18.0,-6.0,0.4955558776855469,472.5234910466575,46,475,-173,1468,159,44,563,66
15,-5,0,15.0,-5.0,0.5035357475280762,456.71828636472213,46,460,-168,1468,159,44,563,66
14,-5,0,14.0,-5.0,0.5115537643432617,441.8526087113769,46,446,-163,1468,159,44,563,66
15,-4,0,15.0,-4.0,0.5195188522338867,426.3930778755814,46,431,-159,1468,159,44,563,66
12,-3,0,12.0,-3.0,0.5276317596435547,414.0984231687694,46,419,-156,1468,159,44,563,66
12,-3,0,12.0,-3.0,0.5355238914489746,401.8080036061894,46,407,-153,1468,159,44,563,66
10,-4,0,10.0,-4.0,0.5434846878051758,391.04009244409895,46,397,-149,1468,159,44,563,66
9,-2,0,9.0,-2.0,0.55147385597229,381.9132439438394,46,388,-147,1468,159,44,563,66
7,-2,0,7.0,-2.0,0.5594887733459473,374.659171367455,46,381,-145,1468,159,44,563,66
4,-3,0,4.0,-3.0,0.5675396919250488,369.85605369660266,46,377,-142,1468,159,44,563,66
5,-3,0,5.0,-3.0,0.5755417346954346,364.1208883954608,46,372,-139,1468,159,44,563,66
5,-4,0,5.0,-4.0,0.5835137367248535,358.042197211503,46,367,-135,1468,159,44,563,66
5,-3,0,5.0,-3.0,0.5914719104766846,352.3154551792596,46,362,-132,1468,159,44,563,66
4,-4,0,4.0,-4.0,0.5996367931365967,347.1946869697156,46,358,-128,1468,159,44,563,66
5,-2,0,5.0,-2.0,0.6074907779693604,341.8132868509333,46,353,-126,1468,159,44,563,66
3,-3,0,3.0,-3.0,0.6153807640075684,337.98382714075285,46,350,-123,1468,159,44,563,66
5,-3,0,5.0,-3.0,0.6234557628631592,332.2738698565776,46,345,-120,1468,159,44,563,66
6,-3,0,6.0,-3.0,0.6315178871154785,325.62236405444656,46,339,-117,1468,159,44,563,66
5,-4,0,5.0,-4.0,0.6394858360290527,319.59750424527965,46,334,-113,1468,159,44,563,66
7,-4,0,7.0,-4.0,0.6475667953491211,311.68826495835333,46,327,-109,1468,159,44,563,66
9,-6,0,9.0,-6.0,0.6555187702178955,301.26486503968675,46,318,-103,1468,159,44,563,66
10,-5,0,10.0,-5.0,0.6635618209838867,290.2150986572255,46,308,-98,1468,159,44,563,66
9,-5,0,9.0,-5.0,0.6715106964111328,280.12936623702353,46,299,-93,1468,159,44,563,66
10,-6,0,10.0,-6.0,0.6795446872711182,268.8111992620552,46,289,-87,1468,159,44,563,66
12,-6,0,12.0,-6.0,0.6874537467956543,255.60006930006097,46,277,-81,1468,159,44,563,66
11,-5,0,11.0,-5.0,0.6955327987670898,243.64417579265967,46,266,-76,1468,159,44,563,66
11,-6,0,11.0,-6.0,0.7034049034118652,231.43335644354704,46,255,-70,1468,159,44,563,66
11,-6,0,11.0,-6.0,0.7115128040313721,219.253840406841,46,244,-64,1468,159,44,563,66
11,-6,0,11.0,-6.0,0.7195107936859131,207.11039127867832,46,233,-58,1468,159,44,563,66
12,-5,0,12.0,-5.0,0.7275288105010986,194.26636354727023,46,221,-53,1468,159,44,563,66
12,-6,0,12.0,-6.0,0.7355248928070068,181.21951358361358,46,209,-47,1468,159,44,563,66
12,-7,0,12.0,-7.0,0.7435238361358643,168.0198995124612,46,197,-40,1468,159,44,563,66
12,-7,0,12.0,-7.0,0.7515246868133545,154.92019582790988,46,185,-33,1468,159,44,563,66
11,-5,0,11.0,-5.0,0.7595038414001465,143.23847480048164,46,174,-28,1468,159,44,563,66
11,-6,0,11.0,-6.0,0.767568826675415,131.47796204963143,46,163,-22,1468,159,44,563,66
9,-6,0,9.0,-6.0,0.77541184425354,121.82893786369524,46,154,-16,1468,159,44,563,66
11,-5,0,11.0,-5.0,0.7835607528686523,110.42245291445826,46,143,-11,1468,159,44,563,66
9,-4,0,9.0,-4.0,0.7915797233581543,101.18271125595876,46,134,-7,1468,159,44,563,66
10,-4,0,10.0,-4.0,0.7995097637176514,91.03628501370073,46,124,-3,1468,159,44,563,66
9,-5,0,9.0,-5.0,0.807499885559082,82.0173899895142,46,115,2,1468,159,44,563,66
8,-4,0,8.0,-4.0,0.8155398368835449,74.16809226630845,46,107,6,1468,159,44,563,66
8,-3,0,8.0,-3.0,0.8233819007873535,66.40824915468535,46,99,9,1468,159,44,563,66
6,-3,0,6.0,-3.0,0.8314158916473389,60.7709976485267,46,93,12,1468,159,44,563,66
6,-1,0,6.0,-1.0,0.839465856552124,54.96590248499699,46,87,13,1468,159,44,563,66
5,-2,0,5.0,-2.0,0.8475618362426758,50.36066218546971,46,82,15,1468,159,44,563,66
4,0,0,4.0,-0.0,0.8555958271026611,46.42921376924235,46,78,15,1468,159,44,563,66
3,-1,0,3.0,-1.0,0.8635408878326416,43.687678280151374,46,75,16,1468,159,44,563,66
6,-1,0,6.0,-1.0,0.8715057373046875,38.06335201775947,46,69,17,1468,159,44,563,66
4,-1,0,4.0,-1.0,0.8796536922454834,34.446274915668994,46,65,18,1468,159,44,563,66
5,-1,0,5.0,-1.0,0.8875217437744141,29.93647591023825,46,60,19,1468,159,44,563,66
4,0,0,4.0,-0.0,0.8957467079162598,26.135437767890075,46,56,19,1468,159,44,563,66
3,0,0,3.0,-0.0,0.903540849685669,23.302753041036986,46,53,19,1468,159,44,563,66
4,-1,0,4.0,-1.0,0.9113688468933105,19.924474489596967,46,49,20,1468,159,44,563,66
3,0,0,3.0,-0.0,0.9194867610931396,17.159744815937813,46,46,20,1468,159,44,563,66
3,0,0,3.0,-0.0,0.927567720413208,14.423622805517503,46,43,20,1468,159,44,563,66
3,0,0,3.0,-0.0,0.9355669021606445,11.721359549995796,46,40,20,1468,159,44,563,66
3,0,0,3.0,-0.0,0.9435527324676514,9.059481689626182,46,37,20,1468,159,44,563,66
2,0,0,2.0,-0.0,0.9515547752380371,7.311288741492746,46,35,20,1468,159,44,563,66
1,1,0,1.0,1.0,0.959601879119873,5.948684188300895,46,34,19,1468,159,44,563,66
1,0,0,1.0,-0.0,0.9675278663635254,5.078865529319543,46,33,19,1468,159,44,563,66
1,0,0,1.0,-0.0,0.975409746170044,4.215588131856791,46,32,19,1468,159,44,563,66
0,0,1,-0.0,-0.0,0.9835028648376465,4.215588131856791,46,32,19,1468,159,44,563,66
1,0,1,1.0,-0.0,0.005812644958496094,148.88007490635061,47,-92,144,1345,284,1436,140,44
1,1,1,1.0,1.0,0.021922588348388672,148.5813588877753,47,-93,143,1345,284,1436,140,44
1,0,1,1.0,-0.0,0.03791356086730957,149.1286066091815,47,-94,143,1345,284,1436,140,44
1,0,1,1.0,-0.0,0.05396866798400879,149.67993476233616,47,-95,143,1345,284,1436,140,44
0,0,0,-0.0,-0.0,0.08486771583557129,149.67993476233616,47,-95,143,1345,284,1436,140,44
-1,2,0,-1.0,2.0,0.16624069213867188,147.4609099468075,47,-94,141,1345,284,1436,140,44
-4,5,0,-4.0,5.0,0.1739635467529297,141.0828010551695,47,-90,136,1345,284,1436,140,44
-6,7,0,-6.0,7.0,0.18198752403259277,131.93829932800998,47,-84,129,1345,284,1436,140,44
-9,8,0,-9.0,8.0,0.1900186538696289,120.35870187663275,47,-75,121,1345,284,1436,140,44
-11,11,0,-11.0,11.0,0.19773149490356445,105.26350615946427,47,-64,110,1345,284,1436,140,44
-13,13,0,-13.0,13.0,0.20581650733947754,87.59014554237986,47,-51,97,1345,284,1436,140,44
-15,14,0,-15.0,14.0,0.21385669708251953,68.47098982546837,47,-36,83,1345,284,1436,140,44
-16,16,0,-16.0,16.0,0.22193455696105957,47.92138442565336,47,-20,67,1345,284,1436,140,44
-16,16,0,-16.0,16.0,0.2299635410308838,29.15662224971465,47,-4,51,1345,284,1436,140,44
-15,18,0,-15.0,18.0,0.2378406524658203,12.785054261852174,47,11,33,1345,284,1436,140,44
-13,16,0,-13.0,16.0,0.24596452713012695,7.410882339705484,47,24,17,1345,284,1436,140,44
-11,13,0,-11.0,13.0,0.2539186477661133,13.227829907617071,47,35,4,1345,284,1436,140,44
-8,11,0,-8.0,11.0,0.2620246410369873,21.56604182158393,47,43,-7,1345,284,1436,140,44
-3,8,0,-3.0,8.0,0.27001070976257324,26.383881613611777,47,46,-15,1345,284,1436,140,44
-2,6,0,-2.0,6.0,0.27783656120300293,30.392747589718944,47,48,-21,1345,284,1436,140,44
-1,2,0,-1.0,2.0,0.28586268424987793,32.12947441089743,47,49,-23,1345,284,1436,140,44
0,1,0,-0.0,1.0,0.29375362396240234,32.56189146281496,47,49,-24,1345,284,1436,140,44
1,1,0,1.0,1.0,0.34996461868286133,32.120236510939236,47,48,-25,1345,284,1436,140,44
2,0,0,2.0,-0.0,0.35799551010131836,30.354560450833695,47,46,-25,1345,284,1436,140,44
2,0,0,2.0,-0.0,0.3659505844116211,28.606323715519977,47,44,-25,1345,284,1436,140,44
2,1,0,2.0,1.0,0.37383151054382324,27.396356140913873,47,42,-26,1345,284,1436,140,44
2,0,0,2.0,-0.0,0.3819096088409424,25.707441767506253,47,40,-26,1345,284,1436,140,44
3,0,0,3.0,-0.0,0.3898036479949951,23.221676218380054,47,37,-26,1345,284,1436,140,44
4,-1,0,4.0,-1.0,0.3978705406188965,19.400483088968905,47,33,-25,1345,284,1436,140,44
5,-1,0,5.0,-1.0,0.4059154987335205,14.878177829171548,47,28,-24,1345,284,1436,140,44
6,-2,0,6.0,-2.0,0.4137907028198242,9.11269837220809,47,22,-22,1345,284,1436,140,44
4,-1,0,4.0,-1.0,0.4218716621398926,5.658633371878661,47,18,-21,1345,284,1436,140,44
4,0,0,4.0,-0.0,0.42987561225891113,3.238858928247925,47,14,-21,1345,284,1436,140,44
3,-1,0,3.0,-1.0,0.43793368339538574,0.8254244210266535,47,11,-20,1345,284,1436,140,44
2,0,0,2.0,-0.0,0.4458925724029541,-0.0682878005386911,47,9,-20,1345,284,1436,140,44
2,-1,0,2.0,-1.0,0.4539005756378174,-1.7515432686834131,47,7,-19,1345,284,1436,140,44
1,0,0,1.0,-0.0,0.46187758445739746,-2.0751411548287244,47,6,-19,1345,284,1436,140,44
1,-1,0,1.0,-1.0,0.4698946475982666,-3.3184583077305945,47,5,-18,1345,284,1436,140,44
0,0,1,-0.0,-0.0,0.5067615509033203,-3.3184583077305945,47,5,-18,1345,284,1436,140,44
0,0,0,-0.0,-0.0,0.0794820785522461,827.588484337015,48,-742,395,598,697,1340,302,26
-4,1,0,-4.0,1.0,0.1816551685333252,823.588309743807,48,-738,394,598,697,1340,302,26
-7,2,0,-7.0,2.0,0.18962717056274414,816.4727240844029,48,-731,392,598,697,1340,302,26
-11,2,0,-11.0,2.0,0.19764018058776855,805.8406438373709,48,-720,390,598,697,1340,302,26
-13,4,0,-13.0,4.0,0.2054731845855713,792.5091557518139,48,-707,386,598,697,1340,302,26
-16,4,0,-16.0,4.0,0.21355915069580078,776.5600040528902,48,-691,382,598,697,1340,302,26
-17,7,0,-17.0,7.0,0.2214672565460205,758.2982561888754,48,-674,375,598,697,1340,302,26
-19,9,0,-19.0,9.0,0.22963714599609375,737.3205981445532,48,-655,366,598,697,1340,302,26
-18,10,0,-18.0,10.0,0.23747706413269043,716.7294019018283,48,-637,356,598,697,1340,302,26
-23,12,0,-23.0,12.0,0.2456190586090088,690.7982665508633,48,-614,344,598,697,1340,302,26
-22,12,0,-22.0,12.0,0.2536642551422119,665.7400091345728,48,-592,332,598,697,1340,302,26
-23,13,0,-23.0,13.0,0.2617170810699463,639.3204733871228,48,-569,319,598,697,1340,302,26
-23,12,0,-23.0,12.0,0.2696681022644043,613.3904533116704,48,-546,307,598,697,1340,302,26
-24,14,0,-24.0,14.0,0.27758216857910156,585.6092214458445,48,-522,293,598,697,1340,302,26
-29,16,0,-29.0,16.0,0.2854921817779541,552.4891687733727,48,-493,277,598,697,1340,302,26
-30,16,0,-30.0,16.0,0.29360127449035645,518.4978833447975,48,-463,261,598,697,1340,302,26
-33,18,0,-33.0,18.0,0.3016650676727295,480.911935470282,48,-430,243,598,697,1340,302,26
-35,17,0,-35.0,17.0,0.3096652030944824,442.0835088200846,48,-395,226,598,697,1340,302,26
-34,17,0,-34.0,17.0,0.3176400661468506,404.13546960190286,48,-361,209,598,697,1340,302,26
-34,16,0,-34.0,16.0,0.3256220817565918,366.7077823800824,48,-327,193,598,697,1340,302,26
-30,14,0,-30.0,14.0,0.33359813690185547,333.77081768799405,48,-297,179,598,697,1340,302,26
-25,13,0,-25.0,13.0,0.34153318405151367,305.6534167398806,48,-272,166,598,697,1340,302,26
-20,13,0,-20.0,13.0,0.3495481014251709,281.8101083748656,48,-252,153,598,697,1340,302,26
-15,10,0,-15.0,10.0,0.3575272560119629,263.79956647364895,48,-237,143,598,697,1340,302,26
-9,6,0,-9.0,6.0,0.36566615104675293,252.994360842481,48,-228,137,598,697,1340,302,26
-6,5,0,-6.0,5.0,0.3736612796783447,245.2789190003706,48,-222,132,598,697,1340,302,26
-5,5,0,-5.0,5.0,0.38163018226623535,238.43189932862538,48,-217,127,598,697,1340,302,26
-2,2,0,-2.0,2.0,0.38960814476013184,235.69660230891776,48,-215,125,598,697,1340,302,26
-2,2,0,-2.0,2.0,0.39759325981140137,232.96341191323557,48,-213,123,598,697,1340,302,26
-1,1,0,-1.0,1.0,0.4056541919708252,231.59762877019065,48,-212,122,598,697,1340,302,26
-2,2,0,-2.0,2.0,0.41357922554016113,228.8677324489565,48,-210,120,598,697,1340,302,26
-2,1,0,-2.0,1.0,0.42151808738708496,226.63513932643517,48,-208,119,598,697,1340,302,26
-3,1,0,-3.0,1.0,0.4296741485595703,223.53540961133072,48,-205,118,598,697,1340,302,26
-4,0,0,-4.0,-0.0,0.43775105476379395,220.0772404161333,48,-201,118,598,697,1340,302,26
-4,1,0,-4.0,1.0,0.44576525688171387,216.12442034842118,48,-197,117,598,697,1340,302,26
-5,1,0,-5.0,1.0,0.4536111354827881,211.32119828495925,48,-192,116,598,697,1340,302,26
-4,1,0,-4.0,1.0,0.4615602493286133,207.38375620721234,48,-188,115,598,697,1340,302,26
-3,3,0,-3.0,3.0,0.46968507766723633,203.26141588364763,48,-185,112,598,697,1340,302,26
-3,2,0,-3.0,2.0,0.47782015800476074,199.6593520163174,48,-182,110,598,697,1340,302,26
-2,2,0,-2.0,2.0,0.48554420471191406,196.91426821443082,48,-180,108,598,697,1340,302,26
-4,2,0,-4.0,2.0,0.49361610412597656,192.4555913086816,48,-176,106,598,697,1340,302,26
-3,4,0,-3.0,4.0,0.5016012191772461,187.83077453418338,48,-173,102,598,697,1340,302,26
-3,3,0,-3.0,3.0,0.5095381736755371,183.72569735548024,48,-170,99,598,697,1340,302,26
-4,4,0,-4.0,4.0,0.517632246017456,178.26160095534075,48,-166,95,598,697,1340,302,26
-5,5,0,-5.0,5.0,0.5255992412567139,171.44782460088814,48,-161,90,598,697,1340,302,26
-5,6,0,-5.0,6.0,0.533602237701416,164.17787672280082,48,-156,84,598,697,1340,302,26
-6,5,0,-6.0,5.0,0.5415942668914795,156.53170794869024,48,-150,79,598,697,1340,302,26
-6,5,0,-6.0,5.0,0.5494821071624756,148.90120444270946,48,-144,74,598,697,1340,302,26
-7,4,0,-7.0,4.0,0.5575251579284668,140.8473269186046,48,-137,70,598,697,1340,302,26
-7,4,0,-7.0,4.0,0.565622091293335,132.79437574886077,48,-130,66,598,697,1340,302,26
-8,5,0,-8.0,5.0,0.5737230777740479,123.40014662748717,48,-122,61,598,697,1340,302,26
-8,6,0,-8.0,6.0,0.5816750526428223,113.57408897558773,48,-114,55,598,697,1340,302,26
-9,5,0,-9.0,5.0,0.5896081924438477,103.29703349613007,48,-105,50,598,697,1340,302,26
-9,6,0,-9.0,6.0,0.5976572036743164,92.60303025955268,48,-96,44,598,697,1340,302,26
-10,7,0,-10.0,7.0,0.6055581569671631,80.62157870918435,48,-86,37,598,697,1340,302,26
-10,6,0,-10.0,6.0,0.6134741306304932,69.0792300158816,48,-76,31,598,697,1340,302,26
-8,3,0,-8.0,3.0,0.6216261386871338,60.53910524340094,48,-68,28,598,697,1340,302,26
-6,5,0,-6.0,5.0,0.6296291351318359,53.12866246946176,48,-62,23,598,697,1340,302,26
-6,3,0,-6.0,3.0,0.6376430988311768,46.464274989274024,48,-56,20,598,697,1340,302,26
-4,3,0,-4.0,3.0,0.6457321643829346,41.70831746635972,48,-52,17,598,697,1340,302,26
-4,2,0,-4.0,2.0,0.6536002159118652,37.28916384272063,48,-48,15,598,697,1340,302,26
-2,3,0,-2.0,3.0,0.6616470813751221,34.53945729601885,48,-46,12,598,697,1340,302,26
-3,2,0,-3.0,2.0,0.6695952415466309,31.14748010928823,48,-43,10,598,697,1340,302,26
-3,2,0,-3.0,2.0,0.6774930953979492,27.792156108742276,48,-40,8,598,697,1340,302,26
-3,2,0,-3.0,2.0,0.6855461597442627,24.483329627982627,48,-37,6,598,697,1340,302,26
-3,2,0,-3.0,2.0,0.6935322284698486,21.23448553724738,48,-34,4,598,697,1340,302,26
-3,1,0,-3.0,1.0,0.7016360759735107,18.144823004794873,48,-31,3,598,697,1340,302,26
-3,1,0,-3.0,1.0,0.7096512317657471,15.071337695236398,48,-28,2,598,697,1340,302,26
-2,1,0,-2.0,1.0,0.7175731658935547,13.019223662515376,48,-26,1,598,697,1340,302,26
-3,2,0,-3.0,2.0,0.7256512641906738,10.021728866442675,48,-23,-1,598,697,1340,302,26
-2,0,0,-2.0,-0.0,0.7336001396179199,8.02379604162864,48,-21,-1,598,697,1340,302,26
-1,0,0,-1.0,-0.0,0.7416641712188721,7.0249843945007875,48,-20,-1,598,697,1340,302,26
-1,1,0,-1.0,1.0,0.7495710849761963,6.104973174542799,48,-19,-2,598,697,1340,302,26
-2,1,0,-2.0,1.0,0.757573127746582,4.262676501632068,48,-17,-3,598,697,1340,302,26
-3,1,0,-3.0,1.0,0.7655971050262451,1.560219778561036,48,-14,-4,598,697,1340,302,26
-2,1,0,-2.0,1.0,0.773536205291748,0.0,48,-12,-5,598,697,1340,302,26
-2,1,0,-2.0,1.0,0.7815830707550049,-1.3380962103093985,48,-10,-6,598,697,1340,302,26
-2,1,0,-2.0,1.0,0.7894701957702637,-2.36985418726535,48,-8,-7,598,697,1340,302,26
-2,2,0,-2.0,2.0,0.7976701259613037,-2.1833461736080313,48,-6,-9,598,697,1340,302,26
-2,1,0,-2.0,1.0,0.8056590557098389,-2.2296703857309925,48,-4,-10,598,697,1340,302,26
-2,1,0,-2.0,1.0,0.8135950565338135,-1.819660112501051,48,-2,-11,598,697,1340,302,26
-1,1,0,-1.0,1.0,0.8216371536254883,-0.9584054212077042,48,-1,-12,598,697,1340,302,26
-1,1,0,-1.0,1.0,0.8295252323150635,0.0,48,0,-13,598,697,1340,302,26
-1,1,0,-1.0,1.0,0.8376760482788086,1.035668847618199,48,1,-14,598,697,1340,302,26
-1,1,0,-1.0,1.0,0.8456001281738281,2.1327459504215565,48,2,-15,598,697,1340,302,26
0,0,1,-0.0,-0.0,0.8527162075042725,2.1327459504215565,48,2,-15,598,697,1340,302,26
-1,0,1,-1.0,-0.0,0.8534672260284424,2.2970585407783553,48,3,-15,598,697,1340,302,26
0,1,1,-0.0,1.0,0.004535198211669922,1205.694176228025,49,1208,64,1803,777,595,712,8
0,0,0,-0.0,-0.0,0.1024942398071289,1205.694176228025,49,1208,64,1803,777,595,712,8
1,0,0,1.0,-0.0,0.16444110870361328,1204.6955778855154,49,1207,64,1803,777,595,712,8
1,0,0,1.0,-0.0,0.1725471019744873,1203.6969818625862,49,1206,64,1803,777,595,712,8
1,0,0,1.0,-0.0,0.18045520782470703,1202.6983881649962,49,1205,64,1803,777,595,712,8
3,0,0,3.0,-0.0,0.18839812278747559,1199.7026210821343,49,1202,64,1803,777,595,712,8
3,-1,0,3.0,-1.0,0.19631123542785645,1196.7605922914026,49,1199,65,1803,777,595,712,8
4,-2,0,4.0,-2.0,0.2045271396636963,1192.8767689281967,49,1195,67,1803,777,595,712,8
5,-1,0,5.0,-1.0,0.21245408058166504,1187.941273721151,49,1190,68,1803,777,595,712,8
6,-1,0,6.0,-1.0,0.22048616409301758,1182.0088532553204,49,1184,69,1803,777,595,712,8
8,-2,0,8.0,-2.0,0.2284550666809082,1174.141332778033,49,1176,71,1803,777,595,712,8
12,-1,0,12.0,-1.0,0.23646211624145508,1162.224678181696,49,1164,72,1803,777,595,712,8
18,-1,0,18.0,-1.0,0.24443912506103516,1144.3226898394023,49,1146,73,1803,777,595,712,8
23,-1,0,23.0,-1.0,0.25252604484558105,1121.435471273231,49,1123,74,1803,777,595,712,8
24,0,0,24.0,-0.0,0.26047325134277344,1097.4885382971536,49,1099,74,1803,777,595,712,8
27,1,0,27.0,1.0,0.26834917068481445,1070.482666216631,49,1072,73,1803,777,595,712,8
32,2,0,32.0,2.0,0.27643418312072754,1038.420740392285,49,1040,71,1803,777,595,712,8
35,2,0,35.0,2.0,0.2843501567840576,1003.3658719650969,49,1005,69,1803,777,595,712,8
40,4,0,40.0,4.0,0.2924501895904541,963.1866417605239,49,965,65,1803,777,595,712,8
44,3,0,44.0,3.0,0.30042409896850586,919.0845031740051,49,921,62,1803,777,595,712,8
49,5,0,49.0,5.0,0.30843019485473633,869.8609729241832,49,872,57,1803,777,595,712,8
50,5,0,50.0,5.0,0.3164222240447998,819.6431266027781,49,822,52,1803,777,595,712,8
51,5,0,51.0,5.0,0.3244631290435791,768.4312267121261,49,771,47,1803,777,595,712,8
52,6,0,52.0,6.0,0.33245110511779785,716.168035947167,49,719,41,1803,777,595,712,8
49,6,0,49.0,6.0,0.34033918380737305,666.9135562797937,49,670,35,1803,777,595,712,8
49,5,0,49.0,5.0,0.3483760356903076,617.7242153881414,49,621,30,1803,777,595,712,8
44,5,0,44.0,5.0,0.3564622402191162,573.5413405116554,49,577,25,1803,777,595,712,8
42,4,0,42.0,4.0,0.3643910884857178,531.4119909004654,49,535,21,1803,777,595,712,8
40,4,0,40.0,4.0,0.37239718437194824,491.2918331650543,49,495,17,1803,777,595,712,8
36,3,0,36.0,3.0,0.38045406341552734,455.2134579909435,49,459,14,1803,777,595,712,8
33,3,0,33.0,3.0,0.3884291648864746,422.1419951143046,49,426,11,1803,777,595,712,8
32,2,0,32.0,2.0,0.39654111862182617,390.10277847282424,49,394,9,1803,777,595,712,8
30,2,0,30.0,2.0,0.40485119819641113,360.06730147048364,49,364,7,1803,777,595,712,8
26,2,0,26.0,2.0,0.4122922420501709,334.03698022553687,49,338,5,1803,777,595,712,8
24,2,0,24.0,2.0,0.4203221797943115,310.0143308831621,49,314,3,1803,777,595,712,8
23,2,0,23.0,2.0,0.4283890724182129,287.00171820798585,49,291,1,1803,777,595,712,8
20,2,0,20.0,2.0,0.43648219108581543,267.0018450121696,49,271,-1,1803,777,595,712,8
19,1,0,19.0,1.0,0.44446516036987305,248.00793638296395,49,252,-2,1803,777,595,712,8
18,2,0,18.0,2.0,0.452437162399292,230.03418553707064,49,234,-4,1803,777,595,712,8
15,1,0,15.0,1.0,0.4604511260986328,215.0570701894828,49,219,-5,1803,777,595,712,8
14,0,0,14.0,-0.0,0.46852922439575195,201.0609665440988,49,205,-5,1803,777,595,712,8
11,1,0,11.0,1.0,0.4763221740722656,190.09276132818556,49,194,-6,1803,777,595,712,8
11,1,0,11.0,1.0,0.48430323600769043,179.13383084509536,49,183,-7,1803,777,595,712,8
9,0,0,9.0,-0.0,0.4924590587615967,170.14074767268,49,174,-7,1803,777,595,712,8
7,0,0,7.0,-0.0,0.5003652572631836,163.14664220378464,49,167,-7,1803,777,595,712,8
6,0,0,6.0,-0.0,0.5084371566772461,157.15210206509875,49,161,-7,1803,777,595,712,8
4,0,0,4.0,-0.0,0.5164880752563477,153.15597347857954,49,157,-7,1803,777,595,712,8
5,0,0,5.0,-0.0,0.5244481563568115,148.16109883935513,49,152,-7,1803,777,595,712,8
5,0,0,5.0,-0.0,0.5324480533599854,143.16657229140046,49,147,-7,1803,777,595,712,8
5,0,0,5.0,-0.0,0.5404050350189209,138.1724305201258,49,142,-7,1803,777,595,712,8
6,0,0,6.0,-0.0,0.5484480857849121,132.1800279042415,49,136,-7,1803,777,595,712,8
6,0,0,6.0,-0.0,0.5563530921936035,126.18832512940628,49,130,-7,1803,777,595,712,8
6,0,0,6.0,-0.0,0.5643031597137451,120.19742348374221,49,124,-7,1803,777,595,712,8
4,0,0,4.0,-0.0,0.572390079498291,116.20399327809372,49,120,-7,1803,777,595,712,8
4,0,0,4.0,-0.0,0.5804431438446045,112.21101496846157,49,116,-7,1803,777,595,712,8
1,-1,0,1.0,-1.0,0.5884952545166016,111.15641536623133,49,115,-6,1803,777,595,712,8
1,0,0,1.0,-0.0,0.5964281558990479,110.15778554264269,49,114,-6,1803,777,595,712,8
2,0,0,2.0,-0.0,0.6044392585754395,108.16059914247963,49,112,-6,1803,777,595,712,8
3,0,0,3.0,-0.0,0.6124041080474854,105.16501271011697,49,109,-6,1803,777,595,712,8
4,0,0,4.0,-0.0,0.620305061340332,101.17128885774862,49,105,-6,1803,777,595,712,8
5,0,0,5.0,-0.0,0.628425121307373,96.17983829094555,49,100,-6,1803,777,595,712,8
5,0,0,5.0,-0.0,0.636329174041748,91.1892851112981,49,95,-6,1803,777,595,712,8
3,0,0,3.0,-0.0,0.6443681716918945,88.19544457292888,49,92,-6,1803,777,595,712,8
4,-1,0,4.0,-1.0,0.6523871421813965,84.14193099768123,49,88,-5,1803,777,595,712,8
4,-2,0,4.0,-2.0,0.6604950428009033,80.0535543567314,49,84,-3,1803,777,595,712,8
4,-1,0,4.0,-1.0,0.6684260368347168,76.02499609497022,49,80,-2,1803,777,595,712,8
3,-1,0,3.0,-1.0,0.676436185836792,73.00649323271382,49,77,-1,1803,777,595,712,8
4,-1,0,4.0,-1.0,0.6845331192016602,69.0,49,73,0,1803,777,595,712,8
3,-1,0,3.0,-1.0,0.6923341751098633,66.00714249274856,49,70,1,1803,777,595,712,8
4,-1,0,4.0,-1.0,0.7005541324615479,62.03029607687671,49,66,2,1803,777,595,712,8
3,0,0,3.0,-0.0,0.7083170413970947,59.0317380372777,49,63,2,1803,777,595,712,8
4,0,0,4.0,-0.0,0.7165532112121582,55.033888572581766,49,59,2,1803,777,595,712,8
3,-1,0,3.0,-1.0,0.724473237991333,52.08029957123981,49,56,3,1803,777,595,712,8
4,0,0,4.0,-0.0,0.7324981689453125,48.08646657242167,49,52,3,1803,777,595,712,8
3,0,0,3.0,-0.0,0.7405130863189697,45.09175083453431,49,49,3,1803,777,595,712,8
3,0,0,3.0,-0.0,0.7484321594238281,42.09772228646444,49,46,3,1803,777,595,712,8
2,-1,0,2.0,-1.0,0.756507158279419,40.181444068749045,49,44,4,1803,777,595,712,8
3,0,0,3.0,-0.0,0.7644321918487549,37.19465984809196,49,41,4,1803,777,595,712,8
2,0,0,2.0,-0.0,0.7723822593688965,35.20459156782532,49,39,4,1803,777,595,712,8
1,0,0,1.0,-0.0,0.7803952693939209,34.2099463490856,49,38,4,1803,777,595,712,8
2,-1,0,2.0,-1.0,0.7883660793304443,32.345563690772494,49,36,5,1803,777,595,712,8
1,0,0,1.0,-0.0,0.7965850830078125,31.355339059327378,49,35,5,1803,777,595,712,8
1,0,0,1.0,-0.0,0.8044581413269043,30.365680554879162,49,34,5,1803,777,595,712,8
2,0,0,2.0,-0.0,0.8124210834503174,28.38826948140329,49,32,5,1803,777,595,712,8
2,0,0,2.0,-0.0,0.8204572200775146,26.4138126514911,49,30,5,1803,777,595,712,8
2,0,0,2.0,-0.0,0.828336238861084,24.442925306655784,49,28,5,1803,777,595,712,8
2,0,0,2.0,-0.0,0.8363051414489746,22.476404589747453,49,26,5,1803,777,595,712,8
1,0,0,1.0,-0.0,0.8444581031799316,21.495097567963924,49,25,5,1803,777,595,712,8
2,0,0,2.0,-0.0,0.8523080348968506,19.53720459187964,49,23,5,1803,777,595,712,8
1,0,0,1.0,-0.0,0.8684310913085938,18.561028345356956,49,22,5,1803,777,595,712,8
1,0,0,1.0,-0.0,0.8764710426330566,17.587033144922902,49,21,5,1803,777,595,712,8
2,0,0,2.0,-0.0,0.8844642639160156,15.6468827043885,49,19,5,1803,777,595,712,8
2,0,0,2.0,-0.0,0.8924560546875,13.72004514666935,49,17,5,1803,777,595,712,8
2,0,0,2.0,-0.0,0.9005422592163086,11.811388300841896,49,15,5,1803,777,595,712,8
3,0,0,3.0,-0.0,0.9083051681518555,9.0,49,12,5,1803,777,595,712,8
3,0,0,3.0,-0.0,0.9163732528686523,6.295630140987001,49,9,5,1803,777,595,712,8
1,0,0,1.0,-0.0,0.9243381023406982,5.433981132056603,49,8,5,1803,777,595,712,8
2,0,0,2.0,-0.0,0.9324052333831787,3.810249675906654,49,6,5,1803,777,595,712,8
1,0,0,1.0,-0.0,0.9404761791229248,3.0710678118654755,49,5,5,1803,777,595,712,8
1,0,0,1.0,-0.0,0.9564831256866455,2.4031242374328485,49,4,5,1803,777,595,712,8
1,0,0,1.0,-0.0,0.9644820690155029,1.8309518948453007,49,3,5,1803,777,595,712,8
1,0,0,1.0,-0.0,1.0125422477722168,1.3851648071345037,49,2,5,1803,777,595,712,8
1,0,0,1.0,-0.0,1.028435230255127,1.0990195135927845,49,1,5,1803,777,595,712,8
0,0,1,-0.0,-0.0,1.0745301246643066,1.0990195135927845,49,1,5,1803,777,595,712,8
-1,0,1,-1.0,-0.0,0.09260201454162598,199.65188119153427,50,-183,-96,1618,676,1802,772,15
0,0,0,-0.0,-0.0,0.09530496597290039,199.65188119153427,50,-183,-96,1618,676,1802,772,15
-1,0,0,-1.0,-0.0,0.10044598579406738,198.7668583615933,50,-182,-96,1618,676,1802,772,15
-1,0,0,-1.0,-0.0,0.10855913162231445,197.88289338058462,50,-181,-96,1618,676,1802,772,15
-1,0,0,-1.0,-0.0,0.11639904975891113,197.0,50,-180,-96,1618,676,1802,772,15
-1,0,0,-1.0,-0.0,0.12441396713256836,196.11819219360927,50,-179,-96,1618,676,1802,772,15
-1,0,0,-1.0,-0.0,0.14046096801757812,195.23748416156684,50,-178,-96,1618,676,1802,772,15
-1,0,0,-1.0,-0.0,0.14854693412780762,194.357890334598,50,-177,-96,1618,676,1802,772,15
-2,0,0,-2.0,-0.0,0.1564950942993164,192.60210419732553,50,-175,-96,1618,676,1802,772,15
-2,0,0,-2.0,-0.0,0.1644420623779297,190.85095400325974,50,-173,-96,1618,676,1802,772,15
-3,0,0,-3.0,-0.0,0.17283201217651367,188.2331938989884,50,-170,-96,1618,676,1802,772,15
-4,-1,0,-4.0,-1.0,0.180433988571167,184.26160095534075,50,-166,-95,1618,676,1802,772,15
-5,-2,0,-5.0,-2.0,0.1884310245513916,178.930094390338,50,-161,-93,1618,676,1802,772,15
-7,-2,0,-7.0,-2.0,0.196303129196167,171.87705274852894,50,-154,-91,1618,676,1802,772,15
-8,-2,0,-8.0,-2.0,0.2043321132659912,163.98830369355676,50,-146,-89,1618,676,1802,772,15
-9,-3,0,-9.0,-3.0,0.2124631404876709,154.75598906995685,50,-137,-86,1618,676,1802,772,15
-9,-3,0,-9.0,-3.0,0.22047805786132812,145.55490814785344,50,-128,-83,1618,676,1802,772,15
-8,-4,0,-8.0,-4.0,0.2284679412841797,136.6697602141801,50,-120,-79,1618,676,1802,772,15
-8,-4,0,-8.0,-4.0,0.23643112182617188,127.79243302203577,50,-112,-75,1618,676,1802,772,15
-7,-5,0,-7.0,-5.0,0.2444610595703125,119.19429464123962,50,-105,-70,1618,676,1802,772,15
-6,-6,0,-6.0,-6.0,0.25243496894836426,110.88553770501282,50,-99,-64,1618,676,1802,772,15
-4,-5,0,-4.0,-5.0,0.26039814949035645,104.83022847155415,50,-95,-59,1618,676,1802,772,15
-3,-4,0,-3.0,-4.0,0.2682981491088867,100.18675291284833,50,-92,-55,1618,676,1802,772,15
-3,-4,0,-3.0,-4.0,0.2764871120452881,95.57680049601859,50,-89,-51,1618,676,1802,772,15
-3,-5,0,-3.0,-5.0,0.2843959331512451,90.52948272189288,50,-86,-46,1618,676,1802,772,15
-3,-4,0,-3.0,-4.0,0.29251599311828613,86.02150289046077,50,-83,-42,1618,676,1802,772,15
-3,-2,0,-3.0,-2.0,0.3004460334777832,82.44271909999159,50,-80,-40,1618,676,1802,772,15
-2,-1,0,-2.0,-1.0,0.30843210220336914,80.20665112249179,50,-78,-39,1618,676,1802,772,15
-2,-2,0,-2.0,-2.0,0.3164379596710205,77.52810183601665,50,-76,-37,1618,676,1802,772,15
-3,-2,0,-3.0,-2.0,0.3244500160217285,73.95677859203639,50,-73,-35,1618,676,1802,772,15
-3,-2,0,-3.0,-2.0,0.3323690891265869,70.38862965578342,50,-70,-33,1618,676,1802,772,15
-3,-2,0,-3.0,-2.0,0.34041810035705566,66.824115301167,50,-67,-31,1618,676,1802,772,15
-3,-2,0,-3.0,-2.0,0.34842610359191895,63.26378868236469,50,-64,-29,1618,676,1802,772,15
-2,-1,0,-2.0,-1.0,0.35642194747924805,61.0294054067798,50,-62,-28,1618,676,1802,772,15
-3,-1,0,-3.0,-1.0,0.36441993713378906,57.88451279003334,50,-59,-27,1618,676,1802,772,15
-2,-2,0,-2.0,-2.0,0.37254905700683594,55.24146527838174,50,-57,-25,1618,676,1802,772,15
-3,-1,0,-3.0,-1.0,0.3805060386657715,52.09314681077663,50,-54,-24,1618,676,1802,772,15
-1,-1,0,-1.0,-1.0,0.38845396041870117,50.77542730261716,50,-53,-23,1618,676,1802,772,15
-2,-1,0,-2.0,-1.0,0.39647507667541504,48.54277630799526,50,-51,-22,1618,676,1802,772,15
-2,-2,0,-2.0,-2.0,0.4044039249420166,45.92447448959697,50,-49,-20,1618,676,1802,772,15
-2,-2,0,-2.0,-2.0,0.4123361110687256,43.32891812864648,50,-47,-18,1618,676,1802,772,15
-1,-1,0,-1.0,-1.0,0.4204540252685547,42.040799340956916,50,-46,-17,1618,676,1802,772,15
-1,0,0,-1.0,-0.0,0.42839694023132324,41.104053883222775,50,-45,-17,1618,676,1802,772,15
-1,0,0,-1.0,-0.0,0.4364910125732422,40.16990566028302,50,-44,-17,1618,676,1802,772,15
-1,-1,0,-1.0,-1.0,0.4444119930267334,38.880278987817846,50,-43,-16,1618,676,1802,772,15
-3,-1,0,-3.0,-1.0,0.4523770809173584,35.720018726587654,50,-40,-15,1618,676,1802,772,15
-3,0,0,-3.0,-0.0,0.4606199264526367,32.92492955535426,50,-37,-15,1618,676,1802,772,15
-2,-1,0,-2.0,-1.0,0.46834301948547363,30.69615364994153,50,-35,-14,1618,676,1802,772,15
-2,0,0,-2.0,-0.0,0.47640013694763184,28.84689665786984,50,-33,-14,1618,676,1802,772,15
-1,-1,0,-1.0,-1.0,0.48436594009399414,27.539832078341085,50,-32,-13,1618,676,1802,772,15
-2,0,0,-2.0,-0.0,0.49231505393981934,25.695565448543633,50,-30,-13,1618,676,1802,772,15
-3,-1,0,-3.0,-1.0,0.5004451274871826,22.546573405388315,50,-27,-12,1618,676,1802,772,15
-2,0,0,-2.0,-0.0,0.5084991455078125,20.730849247724095,50,-25,-12,1618,676,1802,772,15
-1,0,0,-1.0,-0.0,0.5164880752563477,19.832815729997478,50,-24,-12,1618,676,1802,772,15
-3,-1,0,-3.0,-1.0,0.5244441032409668,16.706539182259394,50,-21,-11,1618,676,1802,772,15
-4,-1,0,-4.0,-1.0,0.532459020614624,12.72308292331602,50,-17,-10,1618,676,1802,772,15
-3,-1,0,-3.0,-1.0,0.5403389930725098,9.643316977093239,50,-14,-9,1618,676,1802,772,15
-3,0,0,-3.0,-0.0,0.5484249591827393,7.212670403551895,50,-11,-9,1618,676,1802,772,15
-1,0,0,-1.0,-0.0,0.5564920902252197,6.45362404707371,50,-10,-9,1618,676,1802,772,15
-2,-1,0,-2.0,-1.0,0.5644090175628662,4.313708498984761,50,-8,-8,1618,676,1802,772,15
-1,0,0,-1.0,-0.0,0.5723049640655518,3.63014581273465,50,-7,-8,1618,676,1802,772,15
-2,-1,0,-2.0,-1.0,0.5804741382598877,1.6023252670426267,50,-5,-7,1618,676,1802,772,15
-1,-1,0,-1.0,-1.0,0.5884590148925781,0.21110255092797825,50,-4,-6,1618,676,1802,772,15
-2,0,0,-2.0,-0.0,0.5964570045471191,-0.675444679663241,50,-2,-6,1618,676,1802,772,15
-2,-1,0,-2.0,-1.0,0.6044430732727051,-2.0,50,0,-5,1618,676,1802,772,15
-1,-1,0,-1.0,-1.0,0.6124091148376465,-2.8768943743823394,50,1,-4,1618,676,1802,772,15
-1,0,0,-1.0,-0.0,0.6203539371490479,-2.5278640450004204,50,2,-4,1618,676,1802,772,15
-1,0,0,-1.0,-0.0,0.6284000873565674,-2.0,50,3,-4,1618,676,1802,772,15
-1,-1,0,-1.0,-1.0,0.6364340782165527,-2.0,50,4,-3,1618,676,1802,772,15
-1,0,0,-1.0,-0.0,0.6525759696960449,-1.1690481051546993,50,5,-3,1618,676,1802,772,15
0,0,1,-0.0,-0.0,0.6724121570587158,-1.1690481051546993,50,5,-3,1618,676,1802,772,15
0,0,0,-0.0,-0.0,0.10026097297668457,621.3887738621645,51,-492,436,1121,1115,1613,679,73
-1,0,0,-1.0,-0.0,0.12926101684570312,620.640693225755,51,-491,436,1121,1115,1613,679,73
-3,0,0,-3.0,-0.0,0.1452789306640625,618.4004889973723,51,-488,436,1121,1115,1613,679,73
-3,0,0,-3.0,-0.0,0.15326189994812012,616.1663898116799,51,-485,436,1121,1115,1613,679,73
-3,0,0,-3.0,-0.0,0.16123604774475098,613.9384586251224,51,-482,436,1121,1115,1613,679,73
-2,0,0,-2.0,-0.0,0.16927289962768555,612.4566292359112,51,-480,436,1121,1115,1613,679,73
-2,0,0,-2.0,-0.0,0.17725610733032227,610.977588483558,51,-478,436,1121,1115,1613,679,73
-2,0,0,-2.0,-0.0,0.18525099754333496,609.501355536919,51,-476,436,1121,1115,1613,679,73
-4,-1,0,-4.0,-1.0,0.19324207305908203,607.2363484754262,51,-472,437,1121,1115,1613,679,73
-7,-1,0,-7.0,-1.0,0.20123696327209473,602.8027864685627,51,-465,438,1121,1115,1613,679,73
-7,0,0,-7.0,-0.0,0.20924592018127441,597.7254926227916,51,-458,438,1121,1115,1613,679,73
-9,0,0,-9.0,-0.0,0.21726489067077637,591.251943002172,51,-449,438,1121,1115,1613,679,73
-10,1,0,-10.0,1.0,0.22537899017333984,583.4271547163556,51,-439,437,1121,1115,1613,679,73
-11,2,0,-11.0,2.0,0.23313689231872559,574.2532261283015,51,-428,435,1121,1115,1613,679,73
-10,3,0,-10.0,3.0,0.2411360740661621,565.1222837326861,51,-418,432,1121,1115,1613,679,73
-9,5,0,-9.0,5.0,0.24914002418518066,555.278276279452,51,-409,427,1121,1115,1613,679,73
-11,6,0,-11.0,6.0,0.2572650909423828,543.34877232976,51,-398,421,1121,1115,1613,679,73
-10,9,0,-10.0,9.0,0.2652430534362793,529.9399261405755,51,-388,412,1121,1115,1613,679,73
-12,9,0,-12.0,9.0,0.2732429504394531,515.1669438563964,51,-376,403,1121,1115,1613,679,73
-14,14,0,-14.0,14.0,0.2812330722808838,495.3802781436285,51,-362,389,1121,1115,1613,679,73
-15,14,0,-15.0,14.0,0.2892580032348633,474.91486570660675,51,-347,375,1121,1115,1613,679,73
-15,15,0,-15.0,15.0,0.29726099967956543,453.71828636472213,51,-332,360,1121,1115,1613,679,73
-16,17,0,-16.0,17.0,0.30513501167297363,430.37431318630746,51,-316,343,1121,1115,1613,679,73
-17,17,0,-17.0,17.0,0.3132181167602539,406.35393069351153,51,-299,326,1121,1115,1613,679,73
-15,17,0,-15.0,17.0,0.32128190994262695,383.68678797407955,51,-284,309,1121,1115,1613,679,73
-17,17,0,-17.0,17.0,0.329211950302124,359.6677899450497,51,-267,292,1121,1115,1613,679,73
-16,18,0,-16.0,18.0,0.337299108505249,335.5871364834902,51,-251,274,1121,1115,1613,679,73
-17,18,0,-17.0,18.0,0.34532904624938965,310.8313711301214,51,-234,256,1121,1115,1613,679,73
-15,17,0,-15.0,17.0,0.35326194763183594,288.1635389737717,51,-219,239,1121,1115,1613,679,73
-13,16,0,-13.0,16.0,0.3612370491027832,267.58689036254515,51,-206,223,1121,1115,1613,679,73
-12,14,0,-12.0,14.0,0.3699469566345215,249.16135783096558,51,-194,209,1121,1115,1613,679,73
-12,14,0,-12.0,14.0,0.37726712226867676,230.73769887288148,51,-182,195,1121,1115,1613,679,73
-10,11,0,-10.0,11.0,0.3852810859680176,215.87298386289865,51,-172,184,1121,1115,1613,679,73
-7,9,0,-7.0,9.0,0.3932070732116699,204.52026941611388,51,-165,175,1121,1115,1613,679,73
-7,9,0,-7.0,9.0,0.4011390209197998,193.17242417009948,51,-158,166,1121,1115,1613,679,73
-7,8,0,-7.0,8.0,0.409243106842041,182.55205329623422,51,-151,158,1121,1115,1613,679,73
-5,8,0,-5.0,8.0,0.41753292083740234,173.32271735289507,51,-146,150,1121,1115,1613,679,73
-5,5,0,-5.0,5.0,0.42527294158935547,166.25231766286387,51,-141,145,1121,1115,1613,679,73
-2,3,0,-2.0,3.0,0.433243989944458,162.70832896484234,51,-139,142,1121,1115,1613,679,73
-3,3,0,-3.0,3.0,0.4413590431213379,158.4659353203023,51,-136,139,1121,1115,1613,679,73
-3,1,0,-3.0,1.0,0.449199914932251,155.65855055279948,51,-133,138,1121,1115,1613,679,73
-3,3,0,-3.0,3.0,0.4571371078491211,151.41664813991312,51,-130,135,1121,1115,1613,679,73
-4,2,0,-4.0,2.0,0.46514391899108887,147.20753259623362,51,-126,133,1121,1115,1613,679,73
-3,2,0,-3.0,2.0,0.47327494621276855,143.6941846582688,51,-123,131,1121,1115,1613,679,73
-4,3,0,-4.0,3.0,0.4813249111175537,138.77127910500627,51,-119,128,1121,1115,1613,679,73
-4,3,0,-4.0,3.0,0.4892699718475342,133.85287751463028,51,-115,125,1121,1115,1613,679,73
-5,4,0,-5.0,4.0,0.49726009368896484,127.52675622050356,51,-110,121,1121,1115,1613,679,73
-5,4,0,-5.0,4.0,0.505357027053833,121.20687007888682,51,-105,117,1121,1115,1613,679,73
-4,3,0,-4.0,3.0,0.5133810043334961,116.30561381643159,51,-101,114,1121,1115,1613,679,73
-3,4,0,-3.0,4.0,0.5211539268493652,111.32277488562318,51,-98,110,1121,1115,1613,679,73
-4,5,0,-4.0,5.0,0.5292370319366455,104.92906016858268,51,-94,105,1121,1115,1613,679,73
-3,5,0,-3.0,5.0,0.5373198986053467,99.20724832641184,51,-91,100,1121,1115,1613,679,73
-4,5,0,-4.0,5.0,0.5454490184783936,92.81770064707723,51,-87,95,1121,1115,1613,679,73
-4,4,0,-4.0,4.0,0.5532660484313965,87.1665539016173,51,-83,91,1121,1115,1613,679,73
-5,5,0,-5.0,5.0,0.5612940788269043,80.10340218959993,51,-78,86,1121,1115,1613,679,73
-4,5,0,-4.0,5.0,0.5692601203918457,73.71326264403953,51,-74,81,1121,1115,1613,679,73
-6,6,0,-6.0,6.0,0.5772969722747803,65.23734488813898,51,-68,75,1121,1115,1613,679,73
-6,7,0,-6.0,7.0,0.5856740474700928,56.02173656261873,51,-62,68,1121,1115,1613,679,73
-6,6,0,-6.0,6.0,0.5932340621948242,47.54639429682169,51,-56,62,1121,1115,1613,679,73
-6,6,0,-6.0,6.0,0.6012110710144043,39.07329751649384,51,-50,56,1121,1115,1613,679,73
-5,5,0,-5.0,5.0,0.6092109680175781,32.01470429252781,51,-45,51,1121,1115,1613,679,73
-7,6,0,-7.0,6.0,0.6172389984130859,22.89821729050889,51,-38,45,1121,1115,1613,679,73
-6,5,0,-6.0,5.0,0.6251621246337891,15.224993899462788,51,-32,40,1121,1115,1613,679,73
-7,7,0,-7.0,7.0,0.6332800388336182,5.400483088968905,51,-25,33,1121,1115,1613,679,73
-6,4,0,-6.0,4.0,0.6412060260772705,-1.3301283532805712,51,-19,29,1121,1115,1613,679,73
-5,5,0,-5.0,5.0,0.6492431163787842,-8.215112021100392,51,-14,24,1121,1115,1613,679,73
-5,4,0,-5.0,4.0,0.657228946685791,-14.068287800538691,51,-9,20,1121,1115,1613,679,73
-4,3,0,-4.0,3.0,0.6651339530944824,-18.27995485333065,51,-5,17,1121,1115,1613,679,73
-4,1,0,-4.0,1.0,0.6731319427490234,-19.9687804581186,51,-1,16,1121,1115,1613,679,73
-3,2,0,-3.0,2.0,0.6810951232910156,-21.85786437626905,51,2,14,1121,1115,1613,679,73
-2,2,0,-2.0,2.0,0.689424991607666,-23.35088935932648,51,4,12,1121,1115,1613,679,73
-2,0,0,-2.0,-0.0,0.6974740028381348,-22.58359213500126,51,6,12,1121,1115,1613,679,73
-2,1,0,-2.0,1.0,0.7051959037780762,-22.398529491264554,51,8,11,1121,1115,1613,679,73
0,0,1,-0.0,-0.0,0.7543339729309082,-22.398529491264554,51,8,11,1121,1115,1613,679,73
0,0,0,-0.0,-0.0,0.06546473503112793,748.2346446817949,52,-435,-632,678,472,1113,1104,38
-1,0,0,-1.0,-0.0,0.17255473136901855,747.6681159406592,52,-434,-632,678,472,1113,1104,38
-3,0,0,-3.0,-0.0,0.18044376373291016,745.9738557624045,52,-431,-632,678,472,1113,1104,38
-6,-2,0,-6.0,-2.0,0.18833565711975098,740.9506562928938,52,-425,-630,678,472,1113,1104,38
-9,-5,0,-9.0,-5.0,0.19642972946166992,731.7869205040802,52,-416,-625,678,472,1113,1104,38
-13,-9,0,-13.0,-9.0,0.20444774627685547,717.1148008293271,52,-403,-616,678,472,1113,1104,38
-15,-12,0,-15.0,-12.0,0.21238374710083008,698.8857847875246,52,-388,-604,678,472,1113,1104,38
-17,-14,0,-17.0,-14.0,0.22045564651489258,677.9512178050915,52,-371,-590,678,472,1113,1104,38
-17,-20,0,-17.0,-20.0,0.22842764854431152,651.9813708293249,52,-354,-570,678,472,1113,1104,38
-17,-22,0,-17.0,-22.0,0.23645567893981934,624.3296200238258,52,-337,-548,678,472,1113,1104,38
-14,-21,0,-14.0,-21.0,0.24437665939331055,599.1084047317266,52,-323,-527,678,472,1113,1104,38
-13,-21,0,-13.0,-21.0,0.2524747848510742,574.4104818757418,52,-310,-506,678,472,1113,1104,38
-11,-19,0,-11.0,-19.0,0.26042866706848145,552.4630346750348,52,-299,-487,678,472,1113,1104,38
-9,-18,0,-9.0,-18.0,0.26836657524108887,532.4172648729816,52,-290,-469,678,472,1113,1104,38
-9,-20,0,-9.0,-20.0,0.276458740234375,510.6810360962529,52,-281,-449,678,472,1113,1104,38
-11,-21,0,-11.0,-21.0,0.2846035957336426,487.0474286072403,52,-270,-428,678,472,1113,1104,38
-11,-26,0,-11.0,-26.0,0.29254579544067383,459.2102048262877,52,-259,-402,678,472,1113,1104,38
-14,-27,0,-14.0,-27.0,0.30049872398376465,428.9397280885008,52,-245,-375,678,472,1113,1104,38
-15,-28,0,-15.0,-28.0,0.30849266052246094,397.3039754794566,52,-230,-347,678,472,1113,1104,38
-14,-26,0,-14.0,-26.0,0.31646180152893066,367.90696556149,52,-216,-321,678,472,1113,1104,38
-13,-24,0,-13.0,-24.0,0.3244907855987549,340.7471334145694,52,-203,-297,678,472,1113,1104,38
-12,-19,0,-12.0,-19.0,0.33251070976257324,318.2906758272455,52,-191,-278,678,472,1113,1104,38
-9,-15,0,-9.0,-15.0,0.34038376808166504,300.8327688026979,52,-182,-263,678,472,1113,1104,38
-6,-11,0,-6.0,-11.0,0.3483695983886719,288.37599125501004,52,-176,-252,678,472,1113,1104,38
-5,-8,0,-5.0,-8.0,0.3563716411590576,278.9546945426435,52,-171,-244,678,472,1113,1104,38
-4,-8,0,-4.0,-8.0,0.36460065841674805,270.110705439975,52,-167,-236,678,472,1113,1104,38
-4,-8,0,-4.0,-8.0,0.372511625289917,261.2730811191114,52,-163,-228,678,472,1113,1104,38
-5,-8,0,-5.0,-8.0,0.3804917335510254,251.8578963220382,52,-158,-220,678,472,1113,1104,38
-5,-6,0,-5.0,-6.0,0.3884716033935547,244.06843216167158,52,-153,-214,678,472,1113,1104,38
-5,-5,0,-5.0,-5.0,0.3965005874633789,237.09568524284043,52,-148,-209,678,472,1113,1104,38
-5,-5,0,-5.0,-5.0,0.40442967414855957,230.12848090894786,52,-143,-204,678,472,1113,1104,38
-4,-4,0,-4.0,-4.0,0.41234278678894043,224.55902775302746,52,-139,-200,678,472,1113,1104,38
-5,-4,0,-5.0,-4.0,0.42037177085876465,218.42788378789885,52,-134,-196,678,472,1113,1104,38
-3,-4,0,-3.0,-4.0,0.4283566474914551,213.43278598338918,52,-131,-192,678,472,1113,1104,38
-4,-5,0,-4.0,-5.0,0.43636560440063477,207.0486673263083,52,-127,-187,678,472,1113,1104,38
-4,-4,0,-4.0,-4.0,0.44470667839050293,201.4948979001555,52,-123,-183,678,472,1113,1104,38
-4,-7,0,-4.0,-7.0,0.45247459411621094,193.4547010541306,52,-119,-176,678,472,1113,1104,38
-6,-7,0,-6.0,-7.0,0.4604806900024414,184.29781110479277,52,-113,-169,678,472,1113,1104,38
-5,-6,0,-5.0,-6.0,0.46846675872802734,176.5326059765992,52,-108,-163,678,472,1113,1104,38
-4,-8,0,-4.0,-8.0,0.4764857292175293,167.65744024817226,52,-104,-155,678,472,1113,1104,38
-6,-8,0,-6.0,-8.0,0.4844217300415039,157.67201249773547,52,-98,-147,678,472,1113,1104,38
-5,-6,0,-5.0,-6.0,0.4924287796020508,149.90825912311098,52,-93,-141,678,472,1113,1104,38
-6,-9,0,-6.0,-9.0,0.5005137920379639,139.09174551506476,52,-87,-132,678,472,1113,1104,38
-6,-9,0,-6.0,-9.0,0.5083925724029541,128.27525250360293,52,-81,-123,678,472,1113,1104,38
-6,-9,0,-6.0,-9.0,0.5164976119995117,117.4587849865299,52,-75,-114,678,472,1113,1104,38
-7,-9,0,-7.0,-9.0,0.5246376991271973,106.0959631642844,52,-68,-105,678,472,1113,1104,38
-5,-8,0,-5.0,-8.0,0.5324716567993164,96.66330446602328,52,-63,-97,678,472,1113,1104,38
-5,-7,0,-5.0,-7.0,0.5405337810516357,88.07007051459338,52,-58,-90,678,472,1113,1104,38
-5,-5,0,-5.0,-5.0,0.5485086441040039,81.16985574512923,52,-53,-85,678,472,1113,1104,38
-5,-6,0,-5.0,-6.0,0.5564827919006348,73.43916918709297,52,-48,-79,678,472,1113,1104,38
-4,-7,0,-4.0,-7.0,0.564321756362915,65.38009243891595,52,-44,-72,678,472,1113,1104,38
-6,-6,0,-6.0,-6.0,0.572380781173706,57.15773105863909,52,-38,-66,678,472,1113,1104,38
-6,-6,0,-6.0,-6.0,0.5805137157440186,49.0,52,-32,-60,678,472,1113,1104,38
-5,-6,0,-5.0,-6.0,0.5885426998138428,41.37383539249432,52,-27,-54,678,472,1113,1104,38
-4,-5,0,-4.0,-5.0,0.5966506004333496,35.12947441089743,52,-23,-49,678,472,1113,1104,38
-4,-4,0,-4.0,-4.0,0.6044676303863525,29.846698967279252,52,-19,-45,678,472,1113,1104,38
-3,-5,0,-3.0,-5.0,0.6123895645141602,24.08131845707603,52,-16,-40,678,472,1113,1104,38
-3,-4,0,-3.0,-4.0,0.6205816268920898,19.275318418009277,52,-13,-36,678,472,1113,1104,38
-3,-4,0,-3.0,-4.0,0.6283648014068604,14.526109228480422,52,-10,-32,678,472,1113,1104,38
-2,-4,0,-2.0,-4.0,0.6364436149597168,10.120439557122072,52,-8,-28,678,472,1113,1104,38
-2,-3,0,-2.0,-3.0,0.644439697265625,6.709920264364882,52,-6,-25,678,472,1113,1104,38
-1,-2,0,-1.0,-2.0,0.6525065898895264,4.5372045918796395,52,-5,-23,678,472,1113,1104,38
-1,-1,0,-1.0,-1.0,0.660388708114624,3.360679774997898,52,-4,-22,678,472,1113,1104,38
-1,-1,0,-1.0,-1.0,0.6684665679931641,2.2132034355964265,52,-3,-21,678,472,1113,1104,38
0,-1,0,-0.0,-1.0,0.6764867305755615,1.2237484161566847,52,-3,-20,678,472,1113,1104,38
0,-1,0,-0.0,-1.0,0.7005326747894287,0.2353840616713434,52,-3,-19,678,472,1113,1104,38
0,-1,0,-0.0,-1.0,0.7084217071533203,-0.7517124091053411,52,-3,-18,678,472,1113,1104,38
-1,-1,0,-1.0,-1.0,0.7164685726165771,-1.88275723137631,52,-2,-17,678,472,1113,1104,38
0,-1,0,-0.0,-1.0,0.7245726585388184,-2.8754845034029017,52,-2,-16,678,472,1113,1104,38
-1,-2,0,-1.0,-2.0,0.7324676513671875,-4.964331152381801,52,-1,-14,678,472,1113,1104,38
0,-1,0,-0.0,-1.0,0.7404897212982178,-5.961595189594702,52,-1,-13,678,472,1113,1104,38
-1,-1,0,-1.0,-1.0,0.748424768447876,-7.0,52,0,-12,678,472,1113,1104,38
-1,-1,0,-1.0,-1.0,0.756422758102417,-7.954638982812739,52,1,-11,678,472,1113,1104,38
0,0,1,-0.0,-0.0,0.7723207473754883,-7.954638982812739,52,1,-11,678,472,1113,1104,38
0,0,0,-0.0,-0.0,0.09491205215454102,986.7695818173829,53,879,517,1556,1000,677,483,66
1,0,0,1.0,-0.0,0.15706992149353027,985.9077485228975,53,878,517,1556,1000,677,483,66
5,-2,0,5.0,-2.0,0.16571307182312012,982.6229615364158,53,873,519,1556,1000,677,483,66
6,-1,0,6.0,-1.0,0.1730799674987793,977.9841739611951,53,867,520,1556,1000,677,483,66
6,-1,0,6.0,-1.0,0.18108892440795898,973.3607703005915,53,861,521,1556,1000,677,483,66
5,0,0,5.0,-0.0,0.18900299072265625,969.086323626862,53,856,521,1556,1000,677,483,66
5,0,0,5.0,-0.0,0.19702792167663574,964.8186207923762,53,851,521,1556,1000,677,483,66
7,2,0,7.0,2.0,0.20502901077270508,957.8062373642992,53,844,519,1556,1000,677,483,66
8,4,0,8.0,4.0,0.2129669189453125,948.8966340710207,53,836,515,1556,1000,677,483,66
13,5,0,13.0,5.0,0.2211780548095703,935.2091716153075,53,823,510,1556,1000,677,483,66
18,7,0,18.0,7.0,0.2290029525756836,916.2281074641649,53,805,503,1556,1000,677,483,66
24,9,0,24.0,9.0,0.23711204528808594,891.1195810067006,53,781,494,1556,1000,677,483,66
33,13,0,33.0,13.0,0.24546098709106445,856.3059091223897,53,748,481,1556,1000,677,483,66
38,17,0,38.0,17.0,0.25313401222229004,815.1721523370123,53,710,464,1556,1000,677,483,66
41,19,0,41.0,19.0,0.26099205017089844,770.483665048643,53,669,445,1556,1000,677,483,66
41,21,0,41.0,21.0,0.2690119743347168,724.7334623731488,53,628,424,1556,1000,677,483,66
38,23,0,38.0,23.0,0.2770810127258301,680.3729739764466,53,590,401,1556,1000,677,483,66
38,25,0,38.0,25.0,0.28501105308532715,634.8922068717377,53,552,376,1556,1000,677,483,66
34,26,0,34.0,26.0,0.2931098937988281,592.159179729451,53,518,350,1556,1000,677,483,66
35,30,0,35.0,30.0,0.3010249137878418,546.3867447569024,53,483,320,1556,1000,677,483,66
30,28,0,30.0,28.0,0.30902695655822754,505.95547125899,53,453,292,1556,1000,677,483,66
27,27,0,27.0,27.0,0.3170890808105469,468.6981164006897,53,426,265,1556,1000,677,483,66
25,24,0,25.0,24.0,0.3251988887786865,434.84826600084773,53,401,241,1556,1000,677,483,66
23,21,0,23.0,21.0,0.3330690860748291,404.36026339849394,53,378,220,1556,1000,677,483,66
21,16,0,21.0,16.0,0.3409109115600586,378.17514516322603,53,357,204,1556,1000,677,483,66
19,15,0,19.0,15.0,0.3490889072418213,354.25314717894804,53,338,189,1556,1000,677,483,66
18,11,0,18.0,11.0,0.3570129871368408,333.17482163578643,53,320,178,1556,1000,677,483,66
17,11,0,17.0,11.0,0.3650989532470703,312.9739874614853,53,303,167,1556,1000,677,483,66
17,10,0,17.0,10.0,0.37308788299560547,293.2590994899606,53,286,157,1556,1000,677,483,66
16,9,0,16.0,9.0,0.38103604316711426,274.9025819963191,53,270,148,1556,1000,677,483,66
16,7,0,16.0,7.0,0.38901495933532715,257.5116176678654,53,254,141,1556,1000,677,483,66
16,7,0,16.0,7.0,0.397022008895874,240.13000567495328,53,238,134,1556,1000,677,483,66
14,4,0,14.0,4.0,0.40499401092529297,225.99034731047408,53,224,130,1556,1000,677,483,66
14,5,0,14.0,5.0,0.4130070209503174,211.38698819699874,53,210,125,1556,1000,677,483,66
12,4,0,12.0,4.0,0.4210240840911865,199.04525420701884,53,198,121,1556,1000,677,483,66
11,3,0,11.0,3.0,0.4289820194244385,188.11761576138613,53,187,118,1556,1000,677,483,66
11,3,0,11.0,3.0,0.43701601028442383,177.24033866030564,53,176,115,1556,1000,677,483,66
10,3,0,10.0,3.0,0.4450550079345703,167.24984394500785,53,166,112,1556,1000,677,483,66
10,3,0,10.0,3.0,0.4530470371246338,157.30764566879597,53,156,109,1556,1000,677,483,66
9,4,0,9.0,4.0,0.4611349105834961,147.64883060789515,53,147,105,1556,1000,677,483,66
9,3,0,9.0,3.0,0.4690389633178711,138.6041957529011,53,138,102,1556,1000,677,483,66
7,3,0,7.0,3.0,0.47711801528930664,131.20109622045769,53,131,99,1556,1000,677,483,66
7,3,0,7.0,3.0,0.4850280284881592,123.81836627130127,53,124,96,1556,1000,677,483,66
7,3,0,7.0,3.0,0.49309587478637695,116.45902448497381,53,117,93,1556,1000,677,483,66
6,3,0,6.0,3.0,0.5009920597076416,109.90206436577463,53,111,90,1556,1000,677,483,66
6,2,0,6.0,2.0,0.5090630054473877,104.0,53,105,88,1556,1000,677,483,66
3,2,0,3.0,2.0,0.517003059387207,100.41664064126334,53,102,86,1556,1000,677,483,66
1,1,0,1.0,1.0,0.5730080604553223,99.0075755401939,53,101,85,1556,1000,677,483,66
1,2,0,1.0,2.0,0.5809400081634521,96.9576854210631,53,100,83,1556,1000,677,483,66
3,3,0,3.0,3.0,0.5890519618988037,92.73384588089239,53,97,80,1556,1000,677,483,66
3,4,0,3.0,4.0,0.5970509052276611,87.88010589009261,53,94,76,1556,1000,677,483,66
4,3,0,4.0,3.0,0.605057954788208,82.88356225108029,53,90,73,1556,1000,677,483,66
3,4,0,3.0,4.0,0.6130878925323486,78.04053313993049,53,87,69,1556,1000,677,483,66
5,4,0,5.0,4.0,0.621068000793457,71.63746938836012,53,82,65,1556,1000,677,483,66
4,4,0,4.0,4.0,0.628978967666626,66.02019995940222,53,78,61,1556,1000,677,483,66
5,5,0,5.0,5.0,0.6369750499725342,59.005434622091755,53,73,56,1556,1000,677,483,66
4,4,0,4.0,4.0,0.6450278759002686,53.40023148117139,53,69,52,1556,1000,677,483,66
4,4,0,4.0,4.0,0.6530539989471436,47.80222769206304,53,65,48,1556,1000,677,483,66
3,4,0,3.0,4.0,0.6610889434814453,43.026311234992846,53,62,44,1556,1000,677,483,66
4,3,0,4.0,3.0,0.6691269874572754,38.02816342831905,53,58,41,1556,1000,677,483,66
3,4,0,3.0,4.0,0.6770849227905273,33.2872536767062,53,55,37,1556,1000,677,483,66
4,3,0,4.0,3.0,0.6850440502166748,28.29437168288782,53,51,34,1556,1000,677,483,66
3,3,0,3.0,3.0,0.6930050849914551,24.140178508646613,53,48,31,1556,1000,677,483,66
3,3,0,3.0,3.0,0.7009038925170898,20.0,53,45,28,1556,1000,677,483,66
3,2,0,3.0,2.0,0.7089109420776367,16.396356140913873,53,42,26,1556,1000,677,483,66
2,2,0,2.0,2.0,0.7169220447540283,13.647615158762406,53,40,24,1556,1000,677,483,66
2,2,0,2.0,2.0,0.7251589298248291,10.908996800200299,53,38,22,1556,1000,677,483,66
2,2,0,2.0,2.0,0.7331218719482422,8.182520563948003,53,36,20,1556,1000,677,483,66
2,1,0,2.0,1.0,0.7410259246826172,5.948684188300895,53,34,19,1556,1000,677,483,66
1,1,0,1.0,1.0,0.7489380836486816,4.589892258425003,53,33,18,1556,1000,677,483,66
1,1,0,1.0,1.0,0.7649950981140137,3.235341863986875,53,32,17,1556,1000,677,483,66
0,0,1,-0.0,-0.0,0.7889559268951416,3.235341863986875,53,32,17,1556,1000,677,483,66
0,0,0,-0.0,-0.0,0.06972837448120117,1261.0260249695193,54,-1267,-51,257,932,1524,983,15
-3,0,0,-3.0,-0.0,0.1727142333984375,1258.0284581779179,54,-1264,-51,257,932,1524,983,15
-3,0,0,-3.0,-0.0,0.18072223663330078,1255.0309029496862,54,-1261,-51,257,932,1524,983,15
-5,-2,0,-5.0,-2.0,0.18873929977416992,1249.9554486933894,54,-1256,-49,257,932,1524,983,15
-6,-5,0,-6.0,-5.0,0.1966092586517334,1243.7741602703504,54,-1250,-44,257,932,1524,983,15
-9,-8,0,-9.0,-8.0,0.2046501636505127,1234.5220497437813,54,-1241,-36,257,932,1524,983,15
-13,-13,0,-13.0,-13.0,0.21280527114868164,1221.2153719930393,54,-1228,-23,257,932,1524,983,15
-15,-11,0,-15.0,-11.0,0.2207353115081787,1206.059355513983,54,-1213,-12,257,932,1524,983,15
-18,-10,0,-18.0,-10.0,0.22873520851135254,1188.0016736389953,54,-1195,-2,257,932,1524,983,15
-21,-9,0,-21.0,-9.0,0.2367572784423828,1167.0208686390545,54,-1174,7,257,932,1524,983,15
-22,-8,0,-22.0,-8.0,0.24477124214172363,1145.0976521111395,54,-1152,15,257,932,1524,983,15
-28,-6,0,-28.0,-6.0,0.2528243064880371,1117.1961572608225,54,-1124,21,257,932,1524,983,15
-32,-6,0,-32.0,-6.0,0.26070618629455566,1085.3337402094655,54,-1092,27,257,932,1524,983,15
-33,-3,0,-33.0,-3.0,0.2687802314758301,1052.4248439601556,54,-1059,30,257,932,1524,983,15
-35,-1,0,-35.0,-1.0,0.27661919593811035,1017.4691308184938,54,-1024,31,257,932,1524,983,15
-34,0,0,-34.0,-0.0,0.28468918800354004,983.4852346198807,54,-990,31,257,932,1524,983,15
-35,1,0,-35.0,1.0,0.2928652763366699,948.4710879979572,54,-955,30,257,932,1524,983,15
-35,3,0,-35.0,3.0,0.3007493019104004,913.3961103785696,54,-920,27,257,932,1524,983,15
-38,3,0,-38.0,3.0,0.3086662292480469,875.3264701911645,54,-882,24,257,932,1524,983,15
-38,4,0,-38.0,4.0,0.3166322708129883,837.2369335678226,54,-844,20,257,932,1524,983,15
-36,4,0,-36.0,4.0,0.3247232437133789,801.1584003151858,54,-808,16,257,932,1524,983,15
-35,3,0,-35.0,3.0,0.33272719383239746,766.1093066313456,54,-773,13,257,932,1524,983,15
-33,3,0,-33.0,3.0,0.34069228172302246,733.0675644831356,54,-740,10,257,932,1524,983,15
-30,3,0,-30.0,3.0,0.3486342430114746,703.0345062037478,54,-710,7,257,932,1524,983,15
-30,3,0,-30.0,3.0,0.35657620429992676,673.0117646041133,54,-680,4,257,932,1524,983,15
-28,3,0,-28.0,3.0,0.364565372467041,645.0007668707146,54,-652,1,257,932,1524,983,15
-29,3,0,-29.0,3.0,0.3727073669433594,616.0032102646021,54,-623,-2,257,932,1524,983,15
-29,3,0,-29.0,3.0,0.38073134422302246,587.0210433982958,54,-594,-5,257,932,1524,983,15
-29,2,0,-29.0,2.0,0.3887321949005127,558.0433611679726,54,-565,-7,257,932,1524,983,15
-31,2,0,-31.0,2.0,0.3966972827911377,527.0758373115189,54,-534,-9,257,932,1524,983,15
-30,3,0,-30.0,3.0,0.40469837188720703,497.1428369024001,54,-504,-12,257,932,1524,983,15
-30,2,0,-30.0,2.0,0.4128131866455078,467.20670598379354,54,-474,-14,257,932,1524,983,15
-28,1,0,-28.0,1.0,0.4207303524017334,439.2521708630671,54,-446,-15,257,932,1524,983,15
-26,1,0,-26.0,1.0,0.428760290145874,413.3046514137097,54,-420,-16,257,932,1524,983,15
-24,1,0,-24.0,1.0,0.4365541934967041,389.36473102434326,54,-396,-17,257,932,1524,983,15
-20,1,0,-20.0,1.0,0.4446711540222168,369.4306044943742,54,-376,-18,257,932,1524,983,15
-16,0,0,-16.0,-0.0,0.45276331901550293,353.4497191010141,54,-360,-18,257,932,1524,983,15
-14,0,0,-14.0,-0.0,0.46070337295532227,339.4678917302439,54,-346,-18,257,932,1524,983,15
-12,0,0,-12.0,-0.0,0.4687342643737793,327.4846782739084,54,-334,-18,257,932,1524,983,15
-11,-2,0,-11.0,-2.0,0.47675633430480957,316.39604202896487,54,-323,-16,257,932,1524,983,15
-11,-1,0,-11.0,-1.0,0.484586238861084,305.360368805007,54,-312,-15,257,932,1524,983,15
-10,-1,0,-10.0,-1.0,0.4926152229309082,295.32432915661946,54,-302,-14,257,932,1524,983,15
-10,-2,0,-10.0,-2.0,0.5007352828979492,285.24647132172527,54,-292,-12,257,932,1524,983,15
-10,-2,0,-10.0,-2.0,0.5087423324584961,275.177249260106,54,-282,-10,257,932,1524,983,15
-7,-1,0,-7.0,-1.0,0.5168311595916748,268.14723331336626,54,-275,-9,257,932,1524,983,15
-8,-2,0,-8.0,-2.0,0.5247533321380615,260.09174453734056,54,-267,-7,257,932,1524,983,15
-7,-1,0,-7.0,-1.0,0.532691240310669,253.06922155457,54,-260,-6,257,932,1524,983,15
-10,-1,0,-10.0,-1.0,0.5407252311706543,243.04999500099976,54,-250,-5,257,932,1524,983,15
-11,-1,0,-11.0,-1.0,0.5487163066864014,232.0334704596827,54,-239,-4,257,932,1524,983,15
-12,0,0,-12.0,-0.0,0.5567092895507812,220.03523955544875,54,-227,-4,257,932,1524,983,15
-11,-1,0,-11.0,-1.0,0.5646092891693115,209.0208323287363,54,-216,-3,257,932,1524,983,15
-11,-1,0,-11.0,-1.0,0.5725982189178467,198.00975586542216,54,-205,-2,257,932,1524,983,15
-9,0,0,-9.0,-0.0,0.5806841850280762,189.01020381602586,54,-196,-2,257,932,1524,983,15
-9,-1,0,-9.0,-1.0,0.5887491703033447,180.00267377767625,54,-187,-1,257,932,1524,983,15
-9,-1,0,-9.0,-1.0,0.5966472625732422,171.0,54,-178,0,257,932,1524,983,15
-7,-1,0,-7.0,-1.0,0.6047072410583496,164.00292395160966,54,-171,1,257,932,1524,983,15
-8,-1,0,-8.0,-1.0,0.6127853393554688,156.01226947687098,54,-163,2,257,932,1524,983,15
-7,-1,0,-7.0,-1.0,0.6207292079925537,149.02884348735012,54,-156,3,257,932,1524,983,15
-5,0,0,-5.0,-0.0,0.628730297088623,144.02979838429235,54,-151,3,257,932,1524,983,15
-7,-1,0,-7.0,-1.0,0.6366393566131592,137.05554484295286,54,-144,4,257,932,1524,983,15
-6,0,0,-6.0,-0.0,0.6447391510009766,131.05795884337854,54,-138,4,257,932,1524,983,15
-8,-1,0,-8.0,-1.0,0.6527762413024902,123.09611831257686,54,-130,5,257,932,1524,983,15
-6,0,0,-6.0,-0.0,0.6606752872467041,117.10076550932311,54,-124,5,257,932,1524,983,15
-6,0,0,-6.0,-0.0,0.6686973571777344,111.10588469674151,54,-118,5,257,932,1524,983,15
-7,0,0,-7.0,-0.0,0.676727294921875,104.11255554616679,54,-111,5,257,932,1524,983,15
-8,0,0,-8.0,-0.0,0.6848251819610596,96.12128781197411,54,-103,5,257,932,1524,983,15
-10,0,0,-10.0,-0.0,0.6927852630615234,86.13431161500041,54,-93,5,257,932,1524,983,15
-9,0,0,-9.0,-0.0,0.7007942199707031,77.1486779456457,54,-84,5,257,932,1524,983,15
-9,0,0,-9.0,-0.0,0.7085592746734619,68.16648189186454,54,-75,5,257,932,1524,983,15
-7,0,0,-7.0,-0.0,0.7166943550109863,61.18357573492314,54,-68,5,257,932,1524,983,15
-6,0,0,-6.0,-0.0,0.7246851921081543,55.20128616033595,54,-62,5,257,932,1524,983,15
-5,0,0,-5.0,-0.0,0.7326822280883789,50.21887800367987,54,-57,5,257,932,1524,983,15
-4,0,0,-4.0,-0.0,0.7406492233276367,46.23532661682466,54,-53,5,257,932,1524,983,15
-3,0,0,-3.0,-0.0,0.7486941814422607,43.24937810560445,54,-50,5,257,932,1524,983,15
-3,0,0,-3.0,-0.0,0.756749153137207,40.265209192385896,54,-47,5,257,932,1524,983,15
-2,0,0,-2.0,-0.0,0.7647292613983154,38.27692569068709,54,-45,5,257,932,1524,983,15
-2,0,0,-2.0,-0.0,0.7727663516998291,36.289721643826724,54,-43,5,257,932,1524,983,15
-2,0,0,-2.0,-0.0,0.7805912494659424,34.30375285612676,54,-41,5,257,932,1524,983,15
-2,-1,0,-2.0,-1.0,0.7886922359466553,32.45883931389772,54,-39,6,257,932,1524,983,15
-3,0,0,-3.0,-0.0,0.7965762615203857,29.496575181789318,54,-36,6,257,932,1524,983,15
-3,0,0,-3.0,-0.0,0.8047282695770264,26.541019662496844,54,-33,6,257,932,1524,983,15
-4,0,0,-4.0,-0.0,0.81270432472229,22.614185789921695,54,-29,6,257,932,1524,983,15
-3,0,0,-3.0,-0.0,0.8205642700195312,19.68332812825267,54,-26,6,257,932,1524,983,15
-5,0,0,-5.0,-0.0,0.8286232948303223,14.840329667841555,54,-21,6,257,932,1524,983,15
-3,0,0,-3.0,-0.0,0.8367581367492676,11.973665961010276,54,-18,6,257,932,1524,983,15
-3,0,0,-3.0,-0.0,0.8447563648223877,9.15549442140351,54,-15,6,257,932,1524,983,15
-3,0,0,-3.0,-0.0,0.8525612354278564,6.416407864998739,54,-12,6,257,932,1524,983,15
-2,0,0,-2.0,-0.0,0.8606531620025635,4.6619037896906015,54,-10,6,257,932,1524,983,15
-2,0,0,-2.0,-0.0,0.8686351776123047,3.0,54,-8,6,257,932,1524,983,15
-1,0,0,-1.0,-0.0,0.87679123878479,2.219544457292887,54,-7,6,257,932,1524,983,15
-1,0,0,-1.0,-0.0,0.8847291469573975,1.4852813742385695,54,-6,6,257,932,1524,983,15
-1,0,0,-1.0,-0.0,0.8927011489868164,0.810249675906654,54,-5,6,257,932,1524,983,15
-1,0,0,-1.0,-0.0,0.9007062911987305,0.21110255092797825,54,-4,6,257,932,1524,983,15
-1,0,0,-1.0,-0.0,0.9087262153625488,-0.2917960675006306,54,-3,6,257,932,1524,983,15
-1,0,0,-1.0,-0.0,0.9168353080749512,-0.675444679663241,54,-2,6,257,932,1524,983,15
-1,0,0,-1.0,-0.0,0.924572229385376,-0.9172374697017807,54,-1,6,257,932,1524,983,15
-1,0,0,-1.0,-0.0,0.9326472282409668,-1.0,54,0,6,257,932,1524,983,15
-1,0,0,-1.0,-0.0,0.9406442642211914,-0.9172374697017807,54,1,6,257,932,1524,983,15
-1,0,0,-1.0,-0.0,0.9486961364746094,-0.675444679663241,54,2,6,257,932,1524,983,15
-1,0,0,-1.0,-0.0,0.9727091789245605,-0.2917960675006306,54,3,6,257,932,1524,983,15
-1,0,0,-1.0,-0.0,0.9887382984161377,0.21110255092797825,54,4,6,257,932,1524,983,15
0,0,1,-0.0,-0.0,1.017787218093872,0.21110255092797825,54,4,6,257,932,1524,983,15
0,0,0,-0.0,-0.0,0.06897974014282227,1135.3763621172466,55,884,-722,1137,204,253,926,13
1,0,0,1.0,-0.0,0.11621761322021484,1134.6020340153702,55,883,-722,1137,204,253,926,13
2,0,0,2.0,-0.0,0.12395572662353516,1133.054432413131,55,881,-722,1137,204,253,926,13
3,0,0,3.0,-0.0,0.13203954696655273,1130.7356772794633,55,878,-722,1137,204,253,926,13
5,-1,0,5.0,-1.0,0.14027953147888184,1126.2411403936885,55,873,-721,1137,204,253,926,13
7,-1,0,7.0,-1.0,0.14812970161437988,1120.2131237026142,55,866,-720,1137,204,253,926,13
9,-2,0,9.0,-2.0,0.15613460540771484,1112.021913917612,55,857,-718,1137,204,253,926,13
9,-2,0,9.0,-2.0,0.16412973403930664,1103.8468362796734,55,848,-716,1137,204,253,926,13
11,-1,0,11.0,-1.0,0.17232370376586914,1094.815152511992,55,837,-715,1137,204,253,926,13
12,-2,0,12.0,-2.0,0.18018674850463867,1084.4100146275252,55,825,-713,1137,204,253,926,13
14,-3,0,14.0,-3.0,0.18817353248596191,1071.878007939674,55,811,-710,1137,204,253,926,13
15,-3,0,15.0,-3.0,0.19603466987609863,1058.643132697525,55,796,-707,1137,204,253,926,13
16,-4,0,16.0,-4.0,0.2040417194366455,1044.0519034790614,55,780,-703,1137,204,253,926,13
17,-5,0,17.0,-5.0,0.21208763122558594,1028.1049269779155,55,763,-698,1137,204,253,926,13
17,-8,0,17.0,-8.0,0.22011256217956543,1010.1771499103884,55,746,-690,1137,204,253,926,13
16,-9,0,16.0,-9.0,0.2281486988067627,992.3291040533678,55,730,-681,1137,204,253,926,13
18,-10,0,18.0,-10.0,0.2360537052154541,972.358318817804,55,712,-671,1137,204,253,926,13
20,-14,0,20.0,-14.0,0.2440507411956787,948.2080485931776,55,692,-657,1137,204,253,926,13
22,-15,0,22.0,-15.0,0.25205564498901367,921.9353425751171,55,670,-642,1137,204,253,926,13
21,-15,0,21.0,-15.0,0.26012158393859863,896.4023492877221,55,649,-627,1137,204,253,926,13
20,-14,0,20.0,-14.0,0.2680346965789795,872.2994933392596,55,629,-613,1137,204,253,926,13
20,-18,0,20.0,-18.0,0.2761726379394531,845.4141178063704,55,609,-595,1137,204,253,926,13
23,-21,0,23.0,-21.0,0.28409576416015625,814.2877543886657,55,586,-574,1137,204,253,926,13
23,-22,0,23.0,-22.0,0.29200267791748047,782.4624277668531,55,563,-552,1137,204,253,926,13
24,-24,0,24.0,-24.0,0.3000786304473877,748.5230281442707,55,539,-528,1137,204,253,926,13
24,-25,0,24.0,-25.0,0.30812668800354004,713.8847129922957,55,515,-503,1137,204,253,926,13
24,-23,0,24.0,-23.0,0.31609559059143066,680.644740750266,55,491,-480,1137,204,253,926,13
23,-22,0,23.0,-22.0,0.32399654388427734,648.8190589773636,55,468,-458,1137,204,253,926,13
21,-22,0,21.0,-22.0,0.3319995403289795,618.423734334306,55,447,-436,1137,204,253,926,13
23,-23,0,23.0,-23.0,0.34015774726867676,585.8994847100308,55,424,-413,1137,204,253,926,13
22,-22,0,22.0,-22.0,0.3480415344238281,554.7896218725878,55,402,-391,1137,204,253,926,13
21,-19,0,21.0,-19.0,0.3562135696411133,526.4894365149415,55,381,-372,1137,204,253,926,13
19,-17,0,19.0,-17.0,0.36414265632629395,501.01972348223296,55,362,-355,1137,204,253,926,13
18,-15,0,18.0,-15.0,0.3720986843109131,477.66930851564274,55,344,-340,1137,204,253,926,13
16,-13,0,16.0,-13.0,0.3800966739654541,457.1554814530429,55,328,-327,1137,204,253,926,13
14,-13,0,14.0,-13.0,0.3879725933074951,438.06305858515185,55,314,-314,1137,204,253,926,13
14,-12,0,14.0,-12.0,0.3960456848144531,419.68063145978346,55,300,-302,1137,204,253,926,13
13,-12,0,13.0,-12.0,0.4040555953979492,402.0061274049693,55,287,-290,1137,204,253,926,13
14,-12,0,14.0,-12.0,0.41196465492248535,383.6318775459729,55,273,-278,1137,204,253,926,13
12,-11,0,12.0,-11.0,0.4200897216796875,367.37648560132976,55,261,-267,1137,204,253,926,13
11,-10,0,11.0,-10.0,0.42806458473205566,352.53730628764424,55,250,-257,1137,204,253,926,13
12,-10,0,12.0,-10.0,0.4361286163330078,337.0058308542291,55,238,-247,1137,204,253,926,13
12,-10,0,12.0,-10.0,0.4441406726837158,321.48282397707516,55,226,-237,1137,204,253,926,13
12,-9,0,12.0,-9.0,0.4521186351776123,306.697937313312,55,214,-228,1137,204,253,926,13
11,-9,0,11.0,-9.0,0.46023058891296387,292.6134625230417,55,203,-219,1137,204,253,926,13
10,-8,0,10.0,-8.0,0.46824073791503906,279.9545418418809,55,193,-211,1137,204,253,926,13
9,-7,0,9.0,-7.0,0.4761466979980469,268.7216773390844,55,184,-204,1137,204,253,926,13
8,-6,0,8.0,-6.0,0.4842827320098877,258.9150807334305,55,176,-198,1137,204,253,926,13
7,-6,0,7.0,-6.0,0.49207353591918945,249.78311124857325,55,169,-192,1137,204,253,926,13
9,-7,0,9.0,-7.0,0.5001466274261475,238.59149617270018,55,160,-185,1137,204,253,926,13
8,-6,0,8.0,-6.0,0.5080597400665283,228.8297255459794,55,152,-179,1137,204,253,926,13
8,-7,0,8.0,-7.0,0.5163326263427734,218.32119828495925,55,144,-172,1137,204,253,926,13
9,-7,0,9.0,-7.0,0.5241696834564209,207.19005605327843,55,135,-165,1137,204,253,926,13
9,-6,0,9.0,-6.0,0.5321097373962402,196.87188075236054,55,126,-159,1137,204,253,926,13
7,-6,0,7.0,-6.0,0.5400805473327637,187.82982226685345,55,119,-153,1137,204,253,926,13
5,-4,0,5.0,-4.0,0.5481836795806885,181.608635195718,55,114,-149,1137,204,253,926,13
4,-4,0,4.0,-4.0,0.556065559387207,176.00274723201295,55,110,-145,1137,204,253,926,13
3,-4,0,3.0,-4.0,0.5640747547149658,171.00282483621552,55,107,-141,1137,204,253,926,13
4,-4,0,4.0,-4.0,0.5721535682678223,165.40011668607463,55,103,-137,1137,204,253,926,13
2,-2,0,2.0,-2.0,0.5801787376403809,162.6001186239203,55,101,-135,1137,204,253,926,13
2,-3,0,2.0,-3.0,0.5880837440490723,159.0,55,99,-132,1137,204,253,926,13
2,-2,0,2.0,-2.0,0.5961086750030518,156.2004932174992,55,97,-130,1137,204,253,926,13
2,-2,0,2.0,-2.0,0.6041076183319092,153.40200751558933,55,95,-128,1137,204,253,926,13
1,-2,0,1.0,-2.0,0.6120996475219727,151.20050890502867,55,94,-126,1137,204,253,926,13
1,-2,0,1.0,-2.0,0.6200525760650635,149.0,55,93,-124,1137,204,253,926,13
2,-3,0,2.0,-3.0,0.6279635429382324,145.40013210033868,55,91,-121,1137,204,253,926,13
1,-2,0,1.0,-2.0,0.6360507011413574,143.20120642943877,55,90,-119,1137,204,253,926,13
1,-3,0,1.0,-3.0,0.6440966129302979,140.2087548678259,55,89,-116,1137,204,253,926,13
2,-4,0,2.0,-4.0,0.6521816253662109,135.82030884185804,55,87,-112,1137,204,253,926,13
2,-3,0,2.0,-3.0,0.6601645946502686,132.2244551445221,55,85,-109,1137,204,253,926,13
2,-4,0,2.0,-4.0,0.6680986881256104,127.843191832831,55,83,-105,1137,204,253,926,13
2,-5,0,2.0,-5.0,0.6761207580566406,122.68954891520912,55,81,-100,1137,204,253,926,13
3,-5,0,3.0,-5.0,0.684119701385498,116.9186723000212,55,78,-95,1137,204,253,926,13
4,-5,0,4.0,-5.0,0.6921176910400391,110.51609330903607,55,74,-90,1137,204,253,926,13
3,-5,0,3.0,-5.0,0.7000715732574463,104.75197515168747,55,71,-85,1137,204,253,926,13
4,-5,0,4.0,-5.0,0.7080485820770264,98.35037134576953,55,67,-80,1137,204,253,926,13
4,-4,0,4.0,-4.0,0.7160775661468506,92.71676655968832,55,63,-76,1137,204,253,926,13
3,-4,0,3.0,-4.0,0.7240955829620361,87.72299611087985,55,60,-72,1137,204,253,926,13
3,-4,0,3.0,-4.0,0.7322037220001221,82.72992730753249,55,57,-68,1137,204,253,926,13
3,-4,0,3.0,-4.0,0.7401766777038574,77.73768566183328,55,54,-64,1137,204,253,926,13
2,-3,0,2.0,-3.0,0.7481276988983154,74.15609770940699,55,52,-61,1137,204,253,926,13
3,-3,0,3.0,-3.0,0.7561206817626953,69.92759709091287,55,49,-58,1137,204,253,926,13
3,-3,0,3.0,-3.0,0.7640447616577148,65.7007670809734,55,46,-55,1137,204,253,926,13
3,-4,0,3.0,-4.0,0.7720036506652832,60.70832032063167,55,43,-51,1137,204,253,926,13
3,-3,0,3.0,-3.0,0.7800486087799072,56.48199740725323,55,40,-48,1137,204,253,926,13
3,-3,0,3.0,-3.0,0.788097620010376,52.25804665451803,55,37,-45,1137,204,253,926,13
3,-3,0,3.0,-3.0,0.7960076332092285,48.037024344425184,55,34,-42,1137,204,253,926,13
4,-4,0,4.0,-4.0,0.8040757179260254,42.41487374764082,55,30,-38,1137,204,253,926,13
3,-4,0,3.0,-4.0,0.8121545314788818,37.41658669218482,55,27,-34,1137,204,253,926,13
3,-3,0,3.0,-3.0,0.8201355934143066,33.20459156782532,55,24,-31,1137,204,253,926,13
4,-3,0,4.0,-3.0,0.8280997276306152,28.409301068170507,55,20,-28,1137,204,253,926,13
3,-3,0,3.0,-3.0,0.8361287117004395,24.23243291566195,55,17,-25,1137,204,253,926,13
2,-3,0,2.0,-3.0,0.8439626693725586,20.627053911388696,55,15,-22,1137,204,253,926,13
2,-3,0,2.0,-3.0,0.8521935939788818,17.021728866442675,55,13,-19,1137,204,253,926,13
2,-2,0,2.0,-2.0,0.8601226806640625,14.248456731316587,55,11,-17,1137,204,253,926,13
2,-2,0,2.0,-2.0,0.8682277202606201,11.4928556845359,55,9,-15,1137,204,253,926,13
2,-3,0,2.0,-3.0,0.8760266304016113,7.892443989449804,55,7,-12,1137,204,253,926,13
2,-2,0,2.0,-2.0,0.8840806484222412,5.180339887498949,55,5,-10,1137,204,253,926,13
1,-2,0,1.0,-2.0,0.892162561416626,2.944271909999159,55,4,-8,1137,204,253,926,13
2,-2,0,2.0,-2.0,0.9001286029815674,0.32455532033675905,55,2,-6,1137,204,253,926,13
2,-2,0,2.0,-2.0,0.9081027507781982,-2.0,55,0,-4,1137,204,253,926,13
1,-1,0,1.0,-1.0,0.9160497188568115,-2.8377223398316205,55,-1,-3,1137,204,253,926,13
2,-2,0,2.0,-2.0,0.9240555763244629,-2.8377223398316205,55,-3,-1,1137,204,253,926,13
1,-1,0,1.0,-1.0,0.9321496486663818,-2.0,55,-4,0,1137,204,253,926,13
1,-2,0,1.0,-2.0,0.9400825500488281,-0.6148351928654963,55,-5,2,1137,204,253,926,13
1,0,0,1.0,-0.0,0.9481005668640137,0.32455532033675905,55,-6,2,1137,204,253,926,13
1,-1,0,1.0,-1.0,0.9560146331787109,1.6157731058639087,55,-7,3,1137,204,253,926,13
0,-1,0,-0.0,-1.0,0.9721765518188477,2.062257748298549,55,-7,4,1137,204,253,926,13
1,0,0,1.0,-0.0,0.9801416397094727,2.944271909999159,55,-8,4,1137,204,253,926,13
0,-1,0,-0.0,-1.0,0.9881646633148193,3.433981132056603,55,-8,5,1137,204,253,926,13
1,-1,0,1.0,-1.0,0.9959957599639893,4.816653826391969,55,-9,6,1137,204,253,926,13
1,0,0,1.0,-0.0,1.0040335655212402,5.6619037896906015,55,-10,6,1137,204,253,926,13
0,0,1,-0.0,-0.0,1.0370166301727295,5.6619037896906015,55,-10,6,1137,204,253,926,13
0,0,0,-0.0,-0.0,0.0777592658996582,844.0856764433962,56,-851,-43,296,155,1147,198,16
-1,0,0,-1.0,-0.0,0.1607353687286377,843.0869520795158,56,-850,-43,296,155,1147,198,16
-2,0,0,-2.0,-0.0,0.16875243186950684,841.0895123601516,56,-848,-43,296,155,1147,198,16
-3,0,0,-3.0,-0.0,0.17686033248901367,838.0933754615976,56,-845,-43,296,155,1147,198,16
-3,1,0,-3.0,1.0,0.18482542037963867,835.1488599292535,56,-842,-44,296,155,1147,198,16
-3,1,0,-3.0,1.0,0.19294142723083496,832.2059271392936,56,-839,-45,296,155,1147,198,16
-4,2,0,-4.0,2.0,0.20091748237609863,828.3217084352169,56,-835,-47,296,155,1147,198,16
-5,3,0,-5.0,3.0,0.20884346961975098,823.5046602394962,56,-830,-50,296,155,1147,198,16
-9,4,0,-9.0,4.0,0.21702337265014648,814.773966530298,56,-821,-54,296,155,1147,198,16
-13,1,0,-13.0,1.0,0.22485041618347168,801.8697426129711,56,-808,-55,296,155,1147,198,16
-18,0,0,-18.0,-0.0,0.23276925086975098,783.9122426127784,56,-790,-55,296,155,1147,198,16
-23,-3,0,-23.0,-3.0,0.24100041389465332,760.760690982571,56,-767,-52,296,155,1147,198,16
-25,-7,0,-25.0,-7.0,0.24898838996887207,735.3633028338162,56,-742,-45,296,155,1147,198,16
-26,-6,0,-26.0,-6.0,0.25707530975341797,709.0613641802213,56,-716,-39,296,155,1147,198,16
-29,-8,0,-29.0,-8.0,0.26491236686706543,679.6990620903885,56,-687,-31,296,155,1147,198,16
-34,-8,0,-34.0,-8.0,0.27290844917297363,645.4049280499803,56,-653,-23,296,155,1147,198,16
-34,-5,0,-34.0,-5.0,0.2809152603149414,611.2616571369489,56,-619,-18,296,155,1147,198,16
-31,-2,0,-31.0,-2.0,0.2889232635498047,580.2176467941097,56,-588,-16,296,155,1147,198,16
-26,-1,0,-26.0,-1.0,0.29688334465026855,554.2001422980966,56,-562,-15,296,155,1147,198,16
-26,0,0,-26.0,-0.0,0.3047373294830322,528.2098469815712,56,-536,-15,296,155,1147,198,16
-25,0,0,-25.0,-0.0,0.3128392696380615,503.22010915064754,56,-511,-15,296,155,1147,198,16
-23,0,0,-23.0,-0.0,0.32083845138549805,480.2304783603744,56,-488,-15,296,155,1147,198,16
-24,0,0,-24.0,-0.0,0.3288083076477051,456.2423935833521,56,-464,-15,296,155,1147,198,16
-21,-1,0,-21.0,-1.0,0.3368194103240967,435.22116375462036,56,-443,-14,296,155,1147,198,16
-23,0,0,-23.0,-0.0,0.34487342834472656,412.23326855450176,56,-420,-14,296,155,1147,198,16
-22,0,0,-22.0,-0.0,0.3529374599456787,390.24615503479754,56,-398,-14,296,155,1147,198,16
-21,0,0,-21.0,-0.0,0.3609323501586914,369.25985739275256,56,-377,-14,296,155,1147,198,16
-19,0,0,-19.0,-0.0,0.36893343925476074,350.27363843855437,56,-358,-14,296,155,1147,198,16
-18,0,0,-18.0,-0.0,0.37680625915527344,332.28811322172277,56,-340,-14,296,155,1147,198,16
-20,0,0,-20.0,-0.0,0.3848762512207031,312.30610359467084,56,-320,-14,296,155,1147,198,16
-21,0,0,-21.0,-0.0,0.3927903175354004,291.3275797516828,56,-299,-14,296,155,1147,198,16
-19,0,0,-19.0,-0.0,0.4009513854980469,272.349781523011,56,-280,-14,296,155,1147,198,16
-19,0,0,-19.0,-0.0,0.40888142585754395,253.37520922994975,56,-261,-14,296,155,1147,198,16
-18,0,0,-18.0,-0.0,0.4168972969055176,235.402958075698,56,-243,-14,296,155,1147,198,16
-16,0,0,-16.0,-0.0,0.4248793125152588,219.43130831088317,56,-227,-14,296,155,1147,198,16
-14,0,0,-14.0,-0.0,0.4328882694244385,205.45959805077868,56,-213,-14,296,155,1147,198,16
-12,0,0,-12.0,-0.0,0.44091248512268066,193.48697228356974,56,-201,-14,296,155,1147,198,16
-9,0,0,-9.0,-0.0,0.4487574100494385,184.50974001333023,56,-192,-14,296,155,1147,198,16
-9,0,0,-9.0,-0.0,0.45677733421325684,175.53473785635242,56,-183,-14,296,155,1147,198,16
-9,0,0,-9.0,-0.0,0.4647972583770752,166.56230979223437,56,-174,-14,296,155,1147,198,16
-9,-1,0,-9.0,-1.0,0.47283244132995605,157.51132891738862,56,-165,-13,296,155,1147,198,16
-8,-1,0,-8.0,-1.0,0.4809303283691406,149.45793088949188,56,-157,-12,296,155,1147,198,16
-6,-1,0,-6.0,-1.0,0.48885226249694824,143.40013210033868,56,-151,-11,296,155,1147,198,16
-5,-1,0,-5.0,-1.0,0.49692535400390625,138.34206503941374,56,-146,-10,296,155,1147,198,16
-4,-1,0,-4.0,-1.0,0.5049004554748535,134.28492541376264,56,-142,-9,296,155,1147,198,16
-3,0,0,-3.0,-0.0,0.5129663944244385,131.29106216839614,56,-139,-9,296,155,1147,198,16
-1,0,0,-1.0,-0.0,0.5207724571228027,130.2931668593933,56,-138,-9,296,155,1147,198,16
-2,0,0,-2.0,-0.0,0.5288114547729492,128.2974687952788,56,-136,-9,296,155,1147,198,16
-2,0,0,-2.0,-0.0,0.5369722843170166,126.30189872075525,56,-134,-9,296,155,1147,198,16
-2,-1,0,-2.0,-1.0,0.5449504852294922,124.24220203853233,56,-132,-8,296,155,1147,198,16
-2,0,0,-2.0,-0.0,0.552889347076416,122.24592124131948,56,-130,-8,296,155,1147,198,16
-3,0,0,-3.0,-0.0,0.5609092712402344,119.251719045363,56,-127,-8,296,155,1147,198,16
-4,0,0,-4.0,-0.0,0.5689444541931152,115.25988804148737,56,-123,-8,296,155,1147,198,16
-3,-1,0,-3.0,-1.0,0.576885461807251,112.20399327809372,56,-120,-7,296,155,1147,198,16
-4,0,0,-4.0,-0.0,0.5847973823547363,108.21101496846157,56,-116,-7,296,155,1147,198,16
-4,-1,0,-4.0,-1.0,0.5929772853851318,104.16059914247963,56,-112,-6,296,155,1147,198,16
-5,0,0,-5.0,-0.0,0.6008753776550293,99.16809226630845,56,-107,-6,296,155,1147,198,16
-3,-1,0,-3.0,-1.0,0.6089372634887695,96.12012293500234,56,-104,-5,296,155,1147,198,16
-4,0,0,-4.0,-0.0,0.6168124675750732,92.12492197250393,56,-100,-5,296,155,1147,198,16
-4,-1,0,-4.0,-1.0,0.624941349029541,88.08329719571451,56,-96,-4,296,155,1147,198,16
-4,-1,0,-4.0,-1.0,0.6328563690185547,84.04890004774636,56,-92,-3,296,155,1147,198,16
-5,0,0,-5.0,-0.0,0.6408793926239014,79.05170877128145,56,-87,-3,296,155,1147,198,16
-4,-2,0,-4.0,-2.0,0.6488964557647705,75.00602387778854,56,-83,-1,296,155,1147,198,16
-6,0,0,-6.0,-0.0,0.656975269317627,69.00649323271382,56,-77,-1,296,155,1147,198,16
-6,-1,0,-6.0,-1.0,0.6651544570922852,63.0,56,-71,0,296,155,1147,198,16
-6,0,0,-6.0,-0.0,0.6727333068847656,57.0,56,-65,0,296,155,1147,198,16
-7,0,0,-7.0,-0.0,0.6809084415435791,50.0,56,-58,0,296,155,1147,198,16
-5,0,0,-5.0,-0.0,0.6889023780822754,45.0,56,-53,0,296,155,1147,198,16
-5,0,0,-5.0,-0.0,0.6969394683837891,40.0,56,-48,0,296,155,1147,198,16
-3,0,0,-3.0,-0.0,0.7048864364624023,37.0,56,-45,0,296,155,1147,198,16
-2,-1,0,-2.0,-1.0,0.7129714488983154,35.01162633521314,56,-43,1,296,155,1147,198,16
-1,0,0,-1.0,-0.0,0.7209024429321289,34.01190307520001,56,-42,1,296,155,1147,198,16
-2,0,0,-2.0,-0.0,0.728973388671875,32.01249804748511,56,-40,1,296,155,1147,198,16
-1,0,0,-1.0,-0.0,0.7369873523712158,31.01281840626232,56,-39,1,296,155,1147,198,16
-2,0,0,-2.0,-0.0,0.7447423934936523,29.013511046643494,56,-37,1,296,155,1147,198,16
-2,-1,0,-2.0,-1.0,0.7529244422912598,27.05709628591621,56,-35,2,296,155,1147,198,16
-2,0,0,-2.0,-0.0,0.7608444690704346,25.06055050963308,56,-33,2,296,155,1147,198,16
-2,0,0,-2.0,-0.0,0.7688143253326416,23.064449134018133,56,-31,2,296,155,1147,198,16
-2,0,0,-2.0,-0.0,0.7768864631652832,21.068883707497267,56,-29,2,296,155,1147,198,16
-1,-1,0,-1.0,-1.0,0.7849082946777344,20.160255680657446,56,-28,3,296,155,1147,198,16
-2,0,0,-2.0,-0.0,0.7928893566131592,18.1725046566048,56,-26,3,296,155,1147,198,16
-1,-1,0,-1.0,-1.0,0.8009023666381836,17.317977802344327,56,-25,4,296,155,1147,198,16
-2,0,0,-2.0,-0.0,0.8087544441223145,15.345235059857504,56,-23,4,296,155,1147,198,16
-2,0,0,-2.0,-0.0,0.8169114589691162,13.377558326431949,56,-21,4,296,155,1147,198,16
-2,0,0,-2.0,-0.0,0.8247432708740234,11.4164878389476,56,-19,4,296,155,1147,198,16
-3,0,0,-3.0,-0.0,0.832977294921875,8.492422502470642,56,-16,4,296,155,1147,198,16
-3,0,0,-3.0,-0.0,0.8408534526824951,5.601470508735444,56,-13,4,296,155,1147,198,16
-4,0,0,-4.0,-0.0,0.8488912582397461,1.848857801796104,56,-9,4,296,155,1147,198,16
-4,1,0,-4.0,1.0,0.856879472732544,-2.1690481051546993,56,-5,3,296,155,1147,198,16
-2,0,0,-2.0,-0.0,0.8649322986602783,-3.7573593128807152,56,-3,3,296,155,1147,198,16
-2,1,0,-2.0,1.0,0.8728773593902588,-5.76393202250021,56,-1,2,296,155,1147,198,16
-1,0,0,-1.0,-0.0,0.8811564445495605,-6.0,56,0,2,296,155,1147,198,16
0,0,1,-0.0,-0.0,0.9227943420410156,-6.0,56,0,2,296,155,1147,198,16
0,0,0,-0.0,-0.0,0.06915903091430664,1109.4456894937223,57,1122,88,1418,241,296,153,32
3,1,0,3.0,1.0,0.14720821380615234,1106.3769420297265,57,1119,87,1418,241,296,153,32
3,1,0,3.0,1.0,0.15528202056884766,1103.3087152345415,57,1116,86,1418,241,296,153,32
3,2,0,3.0,2.0,0.16326403617858887,1100.1653103371382,57,1113,84,1418,241,296,153,32
6,4,0,6.0,4.0,0.17126011848449707,1093.8869311781268,57,1107,80,1418,241,296,153,32
9,3,0,9.0,3.0,0.17931509017944336,1084.696597614438,57,1098,77,1418,241,296,153,32
10,4,0,10.0,4.0,0.1873610019683838,1074.446238931567,57,1088,73,1418,241,296,153,32
13,4,0,13.0,4.0,0.19516301155090332,1061.212142523468,57,1075,69,1418,241,296,153,32
20,6,0,20.0,6.0,0.20319819450378418,1040.8793687077064,57,1055,63,1418,241,296,153,32
27,6,0,27.0,6.0,0.21126413345336914,1013.5790401906986,57,1028,57,1418,241,296,153,32
36,9,0,36.0,9.0,0.21933412551879883,977.1606113816637,57,992,48,1418,241,296,153,32
41,8,0,41.0,8.0,0.22729706764221191,935.8408480413099,57,951,40,1418,241,296,153,32
46,8,0,46.0,8.0,0.23538899421691895,889.5655691334559,57,905,32,1418,241,296,153,32
51,8,0,51.0,8.0,0.24327516555786133,838.3371699744779,57,854,24,1418,241,296,153,32
52,8,0,52.0,8.0,0.25128722190856934,786.1595851200682,57,802,16,1418,241,296,153,32
52,4,0,52.0,4.0,0.25928807258605957,734.0959938567863,57,750,12,1418,241,296,153,32
51,3,0,51.0,3.0,0.26717305183410645,683.0579375130504,57,699,9,1418,241,296,153,32
49,1,0,49.0,1.0,0.2753620147705078,634.0492289050114,57,650,8,1418,241,296,153,32
43,1,0,43.0,1.0,0.2832159996032715,591.0403610963607,57,607,7,1418,241,296,153,32
39,0,0,39.0,-0.0,0.2912020683288574,552.0431321651553,57,568,7,1418,241,296,153,32
36,0,0,36.0,-0.0,0.2994270324707031,516.0460506384762,57,532,7,1418,241,296,153,32
32,1,0,32.0,1.0,0.30713510513305664,484.0359987040933,57,500,6,1418,241,296,153,32
28,0,0,28.0,-0.0,0.31528306007385254,456.0381340527479,57,472,6,1418,241,296,153,32
25,-2,0,25.0,-2.0,0.32326722145080566,431.07158263526435,57,447,8,1418,241,296,153,32
24,0,0,24.0,-0.0,0.3312489986419678,407.0756433547079,57,423,8,1418,241,296,153,32
22,-1,0,22.0,-1.0,0.33925604820251465,385.10098479061355,57,401,9,1418,241,296,153,32
19,-1,0,19.0,-1.0,0.34717822074890137,366.13086763568316,57,382,10,1418,241,296,153,32
18,-1,0,18.0,-1.0,0.3552892208099365,348.16617086159994,57,364,11,1418,241,296,153,32
17,-1,0,17.0,-1.0,0.36331820487976074,331.2074307960589,57,347,12,1418,241,296,153,32
15,-1,0,15.0,-1.0,0.3712351322174072,316.2544205875973,57,332,13,1418,241,296,153,32
16,-1,0,16.0,-1.0,0.379270076751709,300.30997455028194,57,316,14,1418,241,296,153,32
17,0,0,17.0,-0.0,0.3872840404510498,283.3275797516828,57,299,14,1418,241,296,153,32
16,0,0,16.0,-0.0,0.3952641487121582,267.346078144731,57,283,14,1418,241,296,153,32
16,-1,0,16.0,-1.0,0.4032630920410156,251.4210163767986,57,267,15,1418,241,296,153,32
14,0,0,14.0,-0.0,0.411452054977417,237.4442739538615,57,253,15,1418,241,296,153,32
13,-1,0,13.0,-1.0,0.419201135635376,224.53274205396653,57,240,16,1418,241,296,153,32
14,0,0,14.0,-0.0,0.4272291660308838,210.56566377101365,57,226,16,1418,241,296,153,32
10,0,0,10.0,-0.0,0.43529820442199707,200.59178193089414,57,216,16,1418,241,296,153,32
9,0,0,9.0,-0.0,0.44318699836730957,191.6174366473105,57,207,16,1418,241,296,153,32
9,0,0,9.0,-0.0,0.451214075088501,182.6454127333425,57,198,16,1418,241,296,153,32
10,0,0,10.0,-0.0,0.4593160152435303,172.67962264113208,57,188,16,1418,241,296,153,32
7,0,0,7.0,-0.0,0.4672560691833496,165.70580618131055,57,181,16,1418,241,296,153,32
7,1,0,7.0,1.0,0.4751930236816406,158.6453549339346,57,174,15,1418,241,296,153,32
7,0,0,7.0,-0.0,0.48336100578308105,151.6722994414999,57,167,15,1418,241,296,153,32
6,1,0,6.0,1.0,0.49122118949890137,145.60754932861275,57,161,14,1418,241,296,153,32
5,0,0,5.0,-0.0,0.4991312026977539,140.62694531912445,57,156,14,1418,241,296,153,32
4,1,0,4.0,1.0,0.507256031036377,136.55490814785344,57,152,13,1418,241,296,153,32
3,0,0,3.0,-0.0,0.5152440071105957,133.56603892595405,57,149,13,1418,241,296,153,32
4,1,0,4.0,1.0,0.523231029510498,129.49570440394453,57,145,12,1418,241,296,153,32
2,0,0,2.0,-0.0,0.5312681198120117,127.50261321662404,57,143,12,1418,241,296,153,32
4,0,0,4.0,-0.0,0.5392031669616699,123.51702405083043,57,139,12,1418,241,296,153,32
4,0,0,4.0,-0.0,0.54728102684021,119.5322839769182,57,135,12,1418,241,296,153,32
5,1,0,5.0,1.0,0.5553321838378906,114.46455457326331,57,130,11,1418,241,296,153,32
6,1,0,6.0,1.0,0.5632531642913818,108.4025723206719,57,124,10,1418,241,296,153,32
6,0,0,6.0,-0.0,0.571174144744873,102.4229707446997,57,118,10,1418,241,296,153,32
6,1,0,6.0,1.0,0.5792200565338135,96.36102527122117,57,112,9,1418,241,296,153,32
4,0,0,4.0,-0.0,0.5872740745544434,92.37435120913067,57,108,9,1418,241,296,153,32
3,1,0,3.0,1.0,0.5951991081237793,89.30432089900205,57,105,8,1418,241,296,153,32
4,0,0,4.0,-0.0,0.6032290458679199,85.31633629380802,57,101,8,1418,241,296,153,32
5,0,0,5.0,-0.0,0.6111969947814941,80.33275663033837,57,96,8,1418,241,296,153,32
4,1,0,4.0,1.0,0.6192750930786133,76.26592003551474,57,92,7,1418,241,296,153,32
5,0,0,5.0,-0.0,0.6272811889648438,71.28115489611719,57,87,7,1418,241,296,153,32
5,1,0,5.0,1.0,0.6351311206817627,66.21921916437786,57,82,6,1418,241,296,153,32
5,1,0,5.0,1.0,0.6431441307067871,61.1621668954417,57,77,5,1418,241,296,153,32
4,1,0,4.0,1.0,0.6511821746826172,57.109506905736964,57,73,4,1418,241,296,153,32
6,1,0,6.0,1.0,0.6592001914978027,51.067130548428864,57,67,3,1418,241,296,153,32
6,1,0,6.0,1.0,0.667384147644043,45.032778078668514,57,61,2,1418,241,296,153,32
7,1,0,7.0,1.0,0.675260066986084,38.00925846556311,57,54,1,1418,241,296,153,32
7,0,0,7.0,-0.0,0.6832849979400635,31.010637094172637,57,47,1,1418,241,296,153,32
8,1,0,8.0,1.0,0.6912281513214111,23.0,57,39,0,1418,241,296,153,32
5,1,0,5.0,1.0,0.6993520259857178,18.0147027033899,57,34,-1,1418,241,296,153,32
4,0,0,4.0,-0.0,0.7073972225189209,14.016662039607269,57,30,-1,1418,241,296,153,32
4,1,0,4.0,1.0,0.7151460647583008,10.076809620810597,57,26,-2,1418,241,296,153,32
3,0,0,3.0,-0.0,0.7231311798095703,7.086792761230392,57,23,-2,1418,241,296,153,32
2,0,0,2.0,-0.0,0.7312672138214111,5.095023109728988,57,21,-2,1418,241,296,153,32
3,0,0,3.0,-0.0,0.7392899990081787,2.1107702762748346,57,18,-2,1418,241,296,153,32
3,0,0,3.0,-0.0,0.7472851276397705,-0.8672540495784435,57,15,-2,1418,241,296,153,32
4,0,0,4.0,-0.0,0.7552640438079834,-4.819660112501051,57,11,-2,1418,241,296,153,32
4,0,0,4.0,-0.0,0.763282060623169,-8.719890110719483,57,7,-2,1418,241,296,153,32
4,0,0,4.0,-0.0,0.7711830139160156,-12.39444872453601,57,3,-2,1418,241,296,153,32
2,0,0,2.0,-0.0,0.7793011665344238,-13.76393202250021,57,1,-2,1418,241,296,153,32
2,0,0,2.0,-0.0,0.7871620655059814,-13.76393202250021,57,-1,-2,1418,241,296,153,32
1,0,0,1.0,-0.0,0.7951571941375732,-13.17157287525381,57,-2,-2,1418,241,296,153,32
1,0,0,1.0,-0.0,0.8031392097473145,-12.39444872453601,57,-3,-2,1418,241,296,153,32
0,0,1,-0.0,-0.0,0.8502349853515625,-12.39444872453601,57,-3,-2,1418,241,296,153,32
0,0,0,-0.0,-0.0,0.07202315330505371,245.6972977742074,58,-155,228,1266,471,1421,243,61
-3,0,0,-3.0,-0.0,0.11199736595153809,244.02189693526321,58,-152,228,1266,471,1421,243,61
-5,0,0,-5.0,-0.0,0.12002134323120117,241.28029784707917,58,-147,228,1266,471,1421,243,61
-4,1,0,-4.0,1.0,0.12793731689453125,238.28715958837836,58,-143,227,1266,471,1421,243,61
-6,2,0,-6.0,2.0,0.13592219352722168,233.4274093559742,58,-137,225,1266,471,1421,243,61
-6,2,0,-6.0,2.0,0.1439042091369629,228.63101128828305,58,-131,223,1266,471,1421,243,61
-4,2,0,-4.0,2.0,0.1521012783050537,224.8921340488953,58,-127,221,1266,471,1421,243,61
-4,2,0,-4.0,2.0,0.15979433059692383,221.17722826721374,58,-123,219,1266,471,1421,243,61
-5,2,0,-5.0,2.0,0.16788125038146973,217.00809703327542,58,-118,217,1266,471,1421,243,61
-6,3,0,-6.0,3.0,0.1759333610534668,211.5367466867102,58,-112,214,1266,471,1421,243,61
-6,4,0,-6.0,4.0,0.18395233154296875,205.23605165875404,58,-106,210,1266,471,1421,243,61
-4,4,0,-4.0,4.0,0.1919243335723877,199.8695282111137,58,-102,206,1266,471,1421,243,61
-5,5,0,-5.0,5.0,0.2001643180847168,193.1815404552984,58,-97,201,1266,471,1421,243,61
-5,5,0,-5.0,5.0,0.20786213874816895,186.51789764358972,58,-92,196,1266,471,1421,243,61
-4,6,0,-4.0,6.0,0.21598529815673828,179.3895890439637,58,-88,190,1266,471,1421,243,61
-4,5,0,-4.0,5.0,0.2239992618560791,173.1772625073977,58,-84,185,1266,471,1421,243,61
-3,5,0,-3.0,5.0,0.23183631896972656,167.3854097951518,58,-81,180,1266,471,1421,243,61
-2,5,0,-2.0,5.0,0.23983120918273926,162.00520826269272,58,-79,175,1266,471,1421,243,61
-3,6,0,-3.0,6.0,0.2480173110961914,155.3024554613349,58,-76,169,1266,471,1421,243,61
-2,5,0,-2.0,5.0,0.25579118728637695,149.9222054111165,58,-74,164,1266,471,1421,243,61
-2,6,0,-2.0,6.0,0.2639913558959961,143.63179432350518,58,-72,158,1266,471,1421,243,61
-2,6,0,-2.0,6.0,0.27186036109924316,137.3439571660716,58,-70,152,1266,471,1421,243,61
-3,7,0,-3.0,7.0,0.2798912525177002,129.7310239120754,58,-67,145,1266,471,1421,243,61
-3,8,0,-3.0,8.0,0.2879042625427246,121.21177202850313,58,-64,137,1266,471,1421,243,61
-3,8,0,-3.0,8.0,0.2958672046661377,112.6954799564443,58,-61,129,1266,471,1421,243,61
-3,8,0,-3.0,8.0,0.3038971424102783,104.18271125595876,58,-58,121,1266,471,1421,243,61
-4,8,0,-4.0,8.0,0.31197619438171387,95.23977004130916,58,-54,113,1266,471,1421,243,61
-3,7,0,-3.0,7.0,0.3198692798614502,87.63077828527702,58,-51,106,1266,471,1421,243,61
-5,8,0,-5.0,8.0,0.3278663158416748,78.25894882179486,58,-46,98,1266,471,1421,243,61
-3,8,0,-3.0,8.0,0.3358783721923828,69.74467404327912,58,-43,90,1266,471,1421,243,61
-3,8,0,-3.0,8.0,0.34381628036499023,61.23595782365635,58,-40,82,1266,471,1421,243,61
-3,7,0,-3.0,7.0,0.3518192768096924,53.630138108220294,58,-37,75,1266,471,1421,243,61
-3,8,0,-3.0,8.0,0.360018253326416,45.13321502504735,58,-34,67,1266,471,1421,243,61
-3,6,0,-3.0,6.0,0.36783432960510254,38.425141578224014,58,-31,61,1266,471,1421,243,61
-3,6,0,-3.0,6.0,0.37581634521484375,31.71709649683789,58,-28,55,1266,471,1421,243,61
-3,5,0,-3.0,5.0,0.38377833366394043,25.90169943749474,58,-25,50,1266,471,1421,243,61
-3,4,0,-3.0,4.0,0.39189720153808594,20.99019513592785,58,-22,46,1266,471,1421,243,61
-3,5,0,-3.0,5.0,0.3999793529510498,15.188494110780013,58,-19,41,1266,471,1421,243,61
-3,5,0,-3.0,5.0,0.40796613693237305,9.395431207184416,58,-16,36,1266,471,1421,243,61
-3,4,0,-3.0,4.0,0.4158601760864258,4.539832078341085,58,-13,32,1266,471,1421,243,61
-3,4,0,-3.0,4.0,0.42388033866882324,-0.26786250536298795,58,-10,28,1266,471,1421,243,61
-3,4,0,-3.0,4.0,0.4317922592163086,-5.0,58,-7,24,1266,471,1421,243,61
-2,2,0,-2.0,2.0,0.4398951530456543,-7.438971654643044,58,-5,22,1266,471,1421,243,61
-1,1,0,-1.0,1.0,0.4478881359100342,-8.622441673568051,58,-4,21,1266,471,1421,243,61
-1,2,0,-1.0,2.0,0.4557993412017822,-10.764615938328657,58,-3,19,1266,471,1421,243,61
-1,1,0,-1.0,1.0,0.46524930000305176,-11.889229723725165,58,-2,18,1266,471,1421,243,61
-1,0,0,-1.0,-0.0,0.471799373626709,-11.972243622680054,58,-1,18,1266,471,1421,243,61
0,0,1,-0.0,-0.0,0.4997892379760742,-11.972243622680054,58,-1,18,1266,471,1421,243,61
0,0,0,-0.0,-0.0,0.07619237899780273,719.9202085327937,59,378,650,1645,1103,1267,453,64
-3,2,0,-3.0,2.0,0.12426948547363281,719.7080550320051,59,381,648,1645,1103,1267,453,64
-4,2,0,-4.0,2.0,0.13233351707458496,720.0246006614411,59,385,646,1645,1103,1267,453,64
-4,2,0,-4.0,2.0,0.140289306640625,720.3675963250943,59,389,644,1645,1103,1267,453,64
-4,2,0,-4.0,2.0,0.1483774185180664,720.7370058659266,59,393,642,1645,1103,1267,453,64
-4,2,0,-4.0,2.0,0.1563873291015625,721.1327904161391,59,397,640,1645,1103,1267,453,64
-5,2,0,-5.0,2.0,0.16462039947509766,722.0875280761511,59,402,638,1645,1103,1267,453,64
-5,3,0,-5.0,3.0,0.17228031158447266,722.2373631689164,59,407,635,1645,1103,1267,453,64
-5,3,0,-5.0,3.0,0.18036437034606934,722.4322368509978,59,412,632,1645,1103,1267,453,64
-5,4,0,-5.0,4.0,0.1883714199066162,721.838842193741,59,417,628,1645,1103,1267,453,64
-3,4,0,-3.0,4.0,0.19624543190002441,720.1808293223113,59,420,624,1645,1103,1267,453,64
-2,3,0,-2.0,3.0,0.20433330535888672,718.8162225205314,59,422,621,1645,1103,1267,453,64
-1,3,0,-1.0,3.0,0.21226239204406738,716.9011950851727,59,423,618,1645,1103,1267,453,64
-1,6,0,-1.0,6.0,0.22036147117614746,712.5266952903704,59,424,612,1645,1103,1267,453,64
0,5,0,-0.0,5.0,0.22834229469299316,708.4221768693858,59,424,607,1645,1103,1267,453,64
3,7,0,3.0,7.0,0.2363443374633789,700.9672571131674,59,421,600,1645,1103,1267,453,64
5,8,0,5.0,8.0,0.24427437782287598,691.5468194940809,59,416,592,1645,1103,1267,453,64
5,8,0,5.0,8.0,0.25235748291015625,682.1267394517587,59,411,584,1645,1103,1267,453,64
8,11,0,8.0,11.0,0.2604033946990967,668.5269445210513,59,403,573,1645,1103,1267,453,64
9,12,0,9.0,12.0,0.26830339431762695,653.5340983496006,59,394,561,1645,1103,1267,453,64
11,14,0,11.0,14.0,0.27628540992736816,635.755943440416,59,383,547,1645,1103,1267,453,64
13,18,0,13.0,18.0,0.28429651260375977,613.5548001525509,59,370,529,1645,1103,1267,453,64
16,21,0,16.0,21.0,0.29227447509765625,587.1768729531167,59,354,508,1645,1103,1267,453,64
19,23,0,19.0,23.0,0.3004493713378906,557.4488951554664,59,335,485,1645,1103,1267,453,64
22,25,0,22.0,25.0,0.30846452713012695,524.3892522326433,59,313,460,1645,1103,1267,453,64
24,28,0,24.0,28.0,0.31659650802612305,487.754749858046,59,289,432,1645,1103,1267,453,64
22,28,0,22.0,28.0,0.3242654800415039,452.2571630858959,59,267,404,1645,1103,1267,453,64
24,32,0,24.0,32.0,0.33229947090148926,412.33433358227,59,243,372,1645,1103,1267,453,64
22,33,0,22.0,33.0,0.3403134346008301,372.675178383849,59,221,339,1645,1103,1267,453,64
20,31,0,20.0,31.0,0.3482973575592041,335.78390394360656,59,201,308,1645,1103,1267,453,64
19,30,0,19.0,30.0,0.3562583923339844,300.27699288394916,59,182,278,1645,1103,1267,453,64
17,29,0,17.0,29.0,0.3643624782562256,266.7072145094591,59,165,249,1645,1103,1267,453,64
14,25,0,14.0,25.0,0.3723905086517334,238.14255495941399,59,151,224,1645,1103,1267,453,64
14,23,0,14.0,23.0,0.3803293704986572,211.24884377936928,59,137,201,1645,1103,1267,453,64
11,19,0,11.0,19.0,0.38829541206359863,189.35943621178654,59,126,182,1645,1103,1267,453,64
11,15,0,11.0,15.0,0.39635539054870605,170.76587484091104,59,115,167,1645,1103,1267,453,64
8,12,0,8.0,12.0,0.40431642532348633,156.3454273402994,59,107,155,1645,1103,1267,453,64
8,10,0,8.0,10.0,0.41246747970581055,143.5733464965568,59,99,145,1645,1103,1267,453,64
6,9,0,6.0,9.0,0.42031240463256836,132.7573974060042,59,93,136,1645,1103,1267,453,64
6,7,0,6.0,7.0,0.42841243743896484,123.59562975867928,59,87,129,1645,1103,1267,453,64
5,7,0,5.0,7.0,0.43630552291870117,114.99659860010368,59,82,122,1645,1103,1267,453,64
4,5,0,4.0,5.0,0.44429945945739746,108.61649974309557,59,78,117,1645,1103,1267,453,64
3,5,0,3.0,5.0,0.45231032371520996,102.79243302203577,59,75,112,1645,1103,1267,453,64
3,4,0,3.0,4.0,0.4604225158691406,97.79984591670362,59,72,108,1645,1103,1267,453,64
2,3,0,2.0,3.0,0.4683034420013428,94.19429464123962,59,70,105,1645,1103,1267,453,64
2,3,0,2.0,3.0,0.4763484001159668,90.58874336577564,59,68,102,1645,1103,1267,453,64
2,3,0,2.0,3.0,0.484405517578125,86.98319209031165,59,66,99,1645,1103,1267,453,64
2,3,0,2.0,3.0,0.49236130714416504,83.37764081484765,59,64,96,1645,1103,1267,453,64
2,4,0,2.0,4.0,0.5003523826599121,78.9414259868693,59,62,92,1645,1103,1267,453,64
2,3,0,2.0,3.0,0.5084354877471924,75.33592129385204,59,60,89,1645,1103,1267,453,64
2,4,0,2.0,4.0,0.5162413120269775,70.90286682109493,59,58,85,1645,1103,1267,453,64
3,2,0,3.0,2.0,0.5242483615875244,67.56907150315303,59,55,83,1645,1103,1267,453,64
3,4,0,3.0,4.0,0.5323143005371094,62.57801012920498,59,52,79,1645,1103,1267,453,64
2,2,0,2.0,2.0,0.540351390838623,59.809585556193426,59,50,77,1645,1103,1267,453,64
1,2,0,1.0,2.0,0.5483393669128418,57.58794561770016,59,49,75,1645,1103,1267,453,64
2,1,0,2.0,1.0,0.5563914775848389,55.66413177577246,59,47,74,1645,1103,1267,453,64
2,3,0,2.0,3.0,0.5642855167388916,52.05950273467003,59,45,71,1645,1103,1267,453,64
3,4,0,3.0,4.0,0.5723295211791992,47.07591289387686,59,42,67,1645,1103,1267,453,64
4,4,0,4.0,4.0,0.5804455280303955,41.57309290766564,59,38,63,1645,1103,1267,453,64
5,5,0,5.0,5.0,0.5883514881134033,34.730802482811484,59,33,58,1645,1103,1267,453,64
5,5,0,5.0,5.0,0.5963172912597656,27.941638282582836,59,28,53,1645,1103,1267,453,64
5,4,0,5.0,4.0,0.6042532920837402,22.12947441089743,59,23,49,1645,1103,1267,453,64
5,3,0,5.0,3.0,0.6123433113098145,17.396356140913873,59,18,46,1645,1103,1267,453,64
4,3,0,4.0,3.0,0.6202743053436279,13.221676218380054,59,14,43,1645,1103,1267,453,64
3,3,0,3.0,3.0,0.6284644603729248,9.484937025383083,59,11,40,1645,1103,1267,453,64
2,1,0,2.0,1.0,0.6363472938537598,8.024992192379003,59,9,39,1645,1103,1267,453,64
2,2,0,2.0,2.0,0.6443564891815186,5.656340767525464,59,7,37,1645,1103,1267,453,64
1,1,0,1.0,1.0,0.6528923511505127,4.496575181789318,59,6,36,1645,1103,1267,453,64
1,1,0,1.0,1.0,0.6604244709014893,3.3553390593273775,59,5,35,1645,1103,1267,453,64
1,1,0,1.0,1.0,0.6684393882751465,2.23448553724738,59,4,34,1645,1103,1267,453,64
0,1,0,-0.0,1.0,0.6761994361877441,1.2415402771893227,59,4,33,1645,1103,1267,453,64
1,0,0,1.0,-0.0,0.6844124794006348,1.1360830515617835,59,3,33,1645,1103,1267,453,64
1,1,0,1.0,1.0,0.6923685073852539,0.062439083762797054,59,2,32,1645,1103,1267,453,64
0,1,0,-0.0,1.0,0.7003023624420166,-0.9355508659818668,59,2,31,1645,1103,1267,453,64
1,0,0,1.0,-0.0,0.7162773609161377,-0.9838751614583536,59,1,31,1645,1103,1267,453,64
0,0,1,-0.0,-0.0,0.7453904151916504,-0.9838751614583536,59,1,31,1645,1103,1267,453,64
0,0,0,-0.0,-0.0,0.04488110542297363,1603.7759845591022,60,-1531,-544,113,528,1644,1072,42
-1,0,0,-1.0,-0.0,0.12596726417541504,1602.8337353312993,60,-1530,-544,113,528,1644,1072,42
-3,0,0,-3.0,-0.0,0.13399910926818848,1600.0074028208508,60,-1527,-544,113,528,1644,1072,42
-2,0,0,-2.0,-0.0,0.14195919036865234,1598.123528332536,60,-1525,-544,113,528,1644,1072,42
-2,0,0,-2.0,-0.0,0.14998412132263184,1596.239932724888,60,-1523,-544,113,528,1644,1072,42
-1,0,0,-1.0,-0.0,0.1580202579498291,1595.298239806008,60,-1522,-544,113,528,1644,1072,42
-2,-1,0,-2.0,-1.0,0.1660292148590088,1593.0783748009264,60,-1520,-543,113,528,1644,1072,42
-1,0,0,-1.0,-0.0,0.1740562915802002,1592.1366960056423,60,-1519,-543,113,528,1644,1072,42
-2,0,0,-2.0,-0.0,0.1820671558380127,1590.2535492590855,60,-1517,-543,113,528,1644,1072,42
-3,-1,0,-3.0,-1.0,0.1900932788848877,1587.0920371670272,60,-1514,-542,113,528,1644,1072,42
-4,0,0,-4.0,-0.0,0.1978752613067627,1583.3266500310963,60,-1510,-542,113,528,1644,1072,42
-7,-2,0,-7.0,-2.0,0.20588207244873047,1576.062616180092,60,-1503,-540,113,528,1644,1072,42
-11,-3,0,-11.0,-3.0,0.21381807327270508,1564.6963769902484,60,-1492,-537,113,528,1644,1072,42
-18,-4,0,-18.0,-4.0,0.22199511528015137,1546.4070945354306,60,-1474,-533,113,528,1644,1072,42
-26,-5,0,-26.0,-5.0,0.2298600673675537,1520.2618207170383,60,-1448,-528,113,528,1644,1072,42
-32,-7,0,-32.0,-7.0,0.238037109375,1487.806481958505,60,-1416,-521,113,528,1644,1072,42
-35,-9,0,-35.0,-9.0,0.24607229232788086,1451.8560690033496,60,-1381,-512,113,528,1644,1072,42
-39,-11,0,-39.0,-11.0,0.25406312942504883,1411.4681497331799,60,-1342,-501,113,528,1644,1072,42
-41,-10,0,-41.0,-10.0,0.26197314262390137,1369.5689483085691,60,-1301,-491,113,528,1644,1072,42
-46,-14,0,-46.0,-14.0,0.26990413665771484,1321.5922687100503,60,-1255,-477,113,528,1644,1072,42
-49,-14,0,-49.0,-14.0,0.2778952121734619,1270.8223562084688,60,-1206,-463,113,528,1644,1072,42
-56,-18,0,-56.0,-18.0,0.28598928451538086,1212.0956978272206,60,-1150,-445,113,528,1644,1072,42
-61,-17,0,-61.0,-17.0,0.29393815994262695,1149.0876035579558,60,-1089,-428,113,528,1644,1072,42
-65,-18,0,-65.0,-18.0,0.30203819274902344,1082.0303712953692,60,-1024,-410,113,528,1644,1072,42
-66,-18,0,-66.0,-18.0,0.30994319915771484,1014.0980629872709,60,-958,-392,113,528,1644,1072,42
-65,-18,0,-65.0,-18.0,0.3179042339324951,947.1554627228005,60,-893,-374,113,528,1644,1072,42
-63,-17,0,-63.0,-17.0,0.32589006423950195,882.520337347201,60,-830,-357,113,528,1644,1072,42
-60,-18,0,-60.0,-18.0,0.33387327194213867,820.3209851180463,60,-770,-339,113,528,1644,1072,42
-55,-16,0,-55.0,-16.0,0.34195613861083984,763.5724950570215,60,-715,-323,113,528,1644,1072,42
-54,-17,0,-54.0,-17.0,0.34987807273864746,707.393437642048,60,-661,-306,113,528,1644,1072,42
-47,-16,0,-47.0,-16.0,0.35801124572753906,658.0404995285627,60,-614,-290,113,528,1644,1072,42
-42,-18,0,-42.0,-18.0,0.3659811019897461,612.3782440216904,60,-572,-272,113,528,1644,1072,42
-37,-17,0,-37.0,-17.0,0.3739292621612549,571.663479556485,60,-535,-255,113,528,1644,1072,42
-31,-16,0,-31.0,-16.0,0.3819551467895508,536.7965578954392,60,-504,-239,113,528,1644,1072,42
-25,-14,0,-25.0,-14.0,0.3899691104888916,508.21262267636814,60,-479,-225,113,528,1644,1072,42
-21,-11,0,-21.0,-11.0,0.39788126945495605,484.52942545414703,60,-458,-214,113,528,1644,1072,42
-16,-10,0,-16.0,-10.0,0.4059112071990967,465.805916151396,60,-442,-204,113,528,1644,1072,42
-12,-8,0,-12.0,-8.0,0.4140052795410156,451.56322328340366,60,-430,-196,113,528,1644,1072,42
-9,-7,0,-9.0,-7.0,0.42198729515075684,440.4780601502091,60,-421,-189,113,528,1644,1072,42
-6,-4,0,-6.0,-4.0,0.4298560619354248,433.3676925134532,60,-415,-185,113,528,1644,1072,42
-3,-3,0,-3.0,-3.0,0.4379732608795166,429.40870329068906,60,-412,-182,113,528,1644,1072,42
-3,-2,0,-3.0,-2.0,0.44596219062805176,425.8568003286959,60,-409,-180,113,528,1644,1072,42
-3,-3,0,-3.0,-3.0,0.4540441036224365,421.9051817262923,60,-406,-177,113,528,1644,1072,42
-4,-4,0,-4.0,-4.0,0.46202516555786133,416.6448331695463,60,-402,-173,113,528,1644,1072,42
-4,-3,0,-4.0,-3.0,0.46995115280151367,411.78632141046234,60,-398,-170,113,528,1644,1072,42
-3,-3,0,-3.0,-3.0,0.4779391288757324,407.8519558075957,60,-395,-167,113,528,1644,1072,42
-3,-3,0,-3.0,-3.0,0.4859621524810791,403.92352253081964,60,-392,-164,113,528,1644,1072,42
-5,-3,0,-5.0,-3.0,0.49393510818481445,398.15390967996467,60,-387,-161,113,528,1644,1072,42
-4,-3,0,-4.0,-3.0,0.501981258392334,393.31027020821,60,-383,-158,113,528,1644,1072,42
-4,-4,0,-4.0,-4.0,0.5099451541900635,388.0928989850594,60,-379,-154,113,528,1644,1072,42
-6,-3,0,-6.0,-3.0,0.5179562568664551,381.4052683551745,60,-373,-151,113,528,1644,1072,42
-7,-4,0,-7.0,-4.0,0.52596116065979,373.4172917101886,60,-366,-147,113,528,1644,1072,42
-7,-5,0,-7.0,-5.0,0.5339651107788086,365.0634662850138,60,-359,-142,113,528,1644,1072,42
-8,-5,0,-8.0,-5.0,0.5420131683349609,355.7890656587582,60,-351,-137,113,528,1644,1072,42
-8,-5,0,-8.0,-5.0,0.550065279006958,346.52278840909986,60,-343,-132,113,528,1644,1072,42
-7,-4,0,-7.0,-4.0,0.5579531192779541,338.5552808679077,60,-336,-128,113,528,1644,1072,42
-7,-6,0,-7.0,-6.0,0.5660302639007568,329.891721190455,60,-329,-122,113,528,1644,1072,42
-8,-6,0,-8.0,-6.0,0.573876142501831,320.31656859871305,60,-321,-116,113,528,1644,1072,42
-10,-8,0,-10.0,-8.0,0.5819780826568604,308.21877224727024,60,-311,-108,113,528,1644,1072,42
-10,-9,0,-10.0,-9.0,0.5899531841278076,295.8627463113958,60,-301,-99,113,528,1644,1072,42
-10,-9,0,-10.0,-9.0,0.5979652404785156,283.59973736035954,60,-291,-90,113,528,1644,1072,42
-11,-9,0,-11.0,-9.0,0.6060261726379395,270.48070262025925,60,-280,-81,113,528,1644,1072,42
-11,-7,0,-11.0,-7.0,0.6143090724945068,257.9928314491252,60,-269,-74,113,528,1644,1072,42
-10,-7,0,-10.0,-7.0,0.6219501495361328,246.52569970004748,60,-259,-67,113,528,1644,1072,42
-11,-6,0,-11.0,-6.0,0.6300561428070068,234.3918557824427,60,-248,-61,113,528,1644,1072,42
-10,-6,0,-10.0,-6.0,0.6379492282867432,223.2723889431632,60,-238,-55,113,528,1644,1072,42
-12,-5,0,-12.0,-5.0,0.6459362506866455,210.46490014686893,60,-226,-50,113,528,1644,1072,42
-11,-6,0,-11.0,-6.0,0.6538851261138916,198.45614596087302,60,-215,-44,113,528,1644,1072,42
-13,-6,0,-13.0,-6.0,0.6620121002197266,184.54318281081473,60,-202,-38,113,528,1644,1072,42
-11,-6,0,-11.0,-6.0,0.6700050830841064,172.6620768245554,60,-191,-32,113,528,1644,1072,42
-12,-6,0,-12.0,-6.0,0.6778790950775146,159.87841220001906,60,-179,-26,113,528,1644,1072,42
-12,-6,0,-12.0,-6.0,0.6859092712402344,147.19334112859522,60,-167,-20,113,528,1644,1072,42
-13,-6,0,-13.0,-6.0,0.6939651966094971,133.63505424062166,60,-154,-14,113,528,1644,1072,42
-14,-7,0,-14.0,-7.0,0.7020761966705322,119.17489076150551,60,-140,-7,113,528,1644,1072,42
-14,-7,0,-14.0,-7.0,0.710017204284668,105.0,60,-126,0,113,528,1644,1072,42
-15,-7,0,-15.0,-7.0,0.7179322242736816,90.22050170719426,60,-111,7,113,528,1644,1072,42
-13,-5,0,-13.0,-5.0,0.7259531021118164,77.73196037757987,60,-98,12,113,528,1644,1072,42
-13,-5,0,-13.0,-5.0,0.7339441776275635,65.68333173107735,60,-85,17,113,528,1644,1072,42
-12,-4,0,-12.0,-4.0,0.7419641017913818,54.960516059331766,60,-73,21,113,528,1644,1072,42
-12,-3,0,-12.0,-3.0,0.750014066696167,44.55150646628954,60,-61,24,113,528,1644,1072,42
-10,-4,0,-10.0,-4.0,0.7580502033233643,37.180752831155424,60,-51,28,113,528,1644,1072,42
-8,-2,0,-8.0,-2.0,0.7659511566162109,31.43090691567332,60,-43,30,113,528,1644,1072,42
-6,-2,0,-6.0,-2.0,0.7739291191101074,27.918299234540036,60,-37,32,113,528,1644,1072,42
-4,-2,0,-4.0,-2.0,0.7818872928619385,26.381430961928537,60,-33,34,113,528,1644,1072,42
-3,-1,0,-3.0,-1.0,0.7900352478027344,25.09772228646444,60,-30,35,113,528,1644,1072,42
-4,-2,0,-4.0,-2.0,0.7980122566223145,24.221676218380054,60,-26,37,113,528,1644,1072,42
-4,-1,0,-4.0,-1.0,0.8059332370758057,22.9089968002003,60,-22,38,113,528,1644,1072,42
-3,-1,0,-3.0,-1.0,0.8138251304626465,22.382023926967726,60,-19,39,113,528,1644,1072,42
-4,-1,0,-4.0,-1.0,0.8219990730285645,21.720018726587654,60,-15,40,113,528,1644,1072,42
-3,0,0,-3.0,-0.0,0.8299291133880615,20.761226035642203,60,-12,40,113,528,1644,1072,42
-2,-1,0,-2.0,-1.0,0.8381352424621582,21.201895692018383,60,-10,41,113,528,1644,1072,42
-2,0,0,-2.0,-0.0,0.8459341526031494,20.773197148410844,60,-8,41,113,528,1644,1072,42
-3,0,0,-3.0,-0.0,0.8539772033691406,20.303752856126764,60,-5,41,113,528,1644,1072,42
-4,0,0,-4.0,-0.0,0.8620972633361816,20.012193308819754,60,-1,41,113,528,1644,1072,42
-4,0,0,-4.0,-0.0,0.8698601722717285,20.10960958218893,60,3,41,113,528,1644,1072,42
-6,1,0,-6.0,1.0,0.878007173538208,20.0,60,9,40,113,528,1644,1072,42
-5,0,0,-5.0,-0.0,0.8859632015228271,21.379240200834182,60,14,40,113,528,1644,1072,42
-5,0,0,-5.0,-0.0,0.894038200378418,23.28317965096906,60,19,40,113,528,1644,1072,42
-6,1,0,-6.0,1.0,0.9019992351531982,25.32493928760188,60,25,39,113,528,1644,1072,42
-5,1,0,-5.0,1.0,0.9100782871246338,27.41487374764082,60,30,38,113,528,1644,1072,42
-5,0,0,-5.0,-0.0,0.9183351993560791,30.662365412357957,60,35,38,113,528,1644,1072,42
-3,0,0,-3.0,-0.0,0.9259152412414551,32.74011537017761,60,38,38,113,528,1644,1072,42
-3,1,0,-3.0,1.0,0.9339611530303955,34.226805085936306,60,41,37,113,528,1644,1072,42
-1,1,0,-1.0,1.0,0.9419732093811035,34.31726674375732,60,42,36,113,528,1644,1072,42
0,0,1,-0.0,-0.0,0.95884108543396,34.31726674375732,60,42,36,113,528,1644,1072,42
0,0,0,-0.0,-0.0,1.0288341045379639,34.31726674375732,60,42,36,113,528,1644,1072,42
1,0,0,1.0,-0.0,1.1339221000671387,33.56189146281496,60,41,36,113,528,1644,1072,42
2,1,0,2.0,1.0,1.1420512199401855,31.40229002629561,60,39,35,113,528,1644,1072,42
3,2,0,3.0,2.0,1.149834156036377,27.83646178829912,60,36,33,113,528,1644,1072,42
3,3,0,3.0,3.0,1.1579811573028564,23.598206241955516,60,33,30,113,528,1644,1072,42
2,4,0,2.0,4.0,1.1658222675323486,19.45985664828782,60,31,26,113,528,1644,1072,42
2,3,0,2.0,3.0,1.1739110946655273,16.013511046643494,60,29,23,113,528,1644,1072,42
2,4,0,2.0,4.0,1.1819672584533691,12.015148038438355,60,27,19,113,528,1644,1072,42
3,4,0,3.0,4.0,1.1899011135101318,7.301943396169811,60,24,15,113,528,1644,1072,42
2,3,0,2.0,3.0,1.1978321075439453,4.059928172283335,60,22,12,113,528,1644,1072,42
2,3,0,2.0,3.0,1.2058892250061035,0.9317121994613089,60,20,9,113,528,1644,1072,42
3,4,0,3.0,4.0,1.2138891220092773,-3.2799548533306506,60,17,5,113,528,1644,1072,42
3,3,0,3.0,3.0,1.2219910621643066,-6.857864376269049,60,14,2,113,528,1644,1072,42
2,3,0,2.0,3.0,1.229802131652832,-8.958405421207704,60,12,-1,113,528,1644,1072,42
2,2,0,2.0,2.0,1.237821102142334,-10.55969349108945,60,10,-3,113,528,1644,1072,42
0,0,1,-0.0,-0.0,1.2438082695007324,-10.55969349108945,60,10,-3,113,528,1644,1072,42
1,2,1,1.0,2.0,1.2457880973815918,-10.704369859013,60,9,-5,113,528,1644,1072,42
0,0,0,-0.0,-0.0,1.3298211097717285,-10.704369859013,60,9,-5,113,528,1644,1072,42
1,0,0,1.0,-0.0,1.4059462547302246,-11.566018867943397,60,8,-5,113,528,1644,1072,42
3,0,0,3.0,-0.0,1.4379572868347168,-13.928932188134524,60,5,-5,113,528,1644,1072,42
3,0,0,3.0,-0.0,1.4458041191101074,-15.614835192865495,60,2,-5,113,528,1644,1072,42
4,0,0,4.0,-0.0,1.4539930820465088,-15.614835192865495,60,-2,-5,113,528,1644,1072,42
5,0,0,5.0,-0.0,1.4619112014770508,-12.397674732957373,60,-7,-5,113,528,1644,1072,42
5,1,0,5.0,1.0,1.4700262546539307,-7.583592135001261,60,-12,-6,113,528,1644,1072,42
5,0,0,5.0,-0.0,1.4779250621795654,-2.972243622680054,60,-17,-6,113,528,1644,1072,42
6,0,0,6.0,-0.0,1.4859871864318848,2.7697286480094263,60,-23,-6,113,528,1644,1072,42
6,0,0,6.0,-0.0,1.4939351081848145,8.614185789921695,60,-29,-6,113,528,1644,1072,42
6,0,0,6.0,-0.0,1.5020132064819336,14.510561809129406,60,-35,-6,113,528,1644,1072,42
4,0,0,4.0,-0.0,1.5099692344665527,18.45883931389772,60,-39,-6,113,528,1644,1072,42
3,0,0,3.0,-0.0,1.5180041790008545,21.426406871192853,60,-42,-6,113,528,1644,1072,42
1,0,0,1.0,-0.0,1.5259101390838623,22.416586692184822,60,-43,-6,113,528,1644,1072,42
1,1,0,1.0,1.0,1.533886194229126,23.553338819890925,60,-44,-7,113,528,1644,1072,42
0,0,1,-0.0,-0.0,1.6239311695098877,23.553338819890925,60,-44,-7,113,528,1644,1072,42
0,0,0,-0.0,-0.0,1.6989092826843262,23.553338819890925,60,-44,-7,113,528,1644,1072,42
-2,0,0,-2.0,-0.0,1.8139612674713135,21.579337712087536,60,-42,-7,113,528,1644,1072,42
-1,0,0,-1.0,-0.0,1.8220152854919434,20.593268686170845,60,-41,-7,113,528,1644,1072,42
-2,0,0,-2.0,-0.0,1.8298981189727783,18.6232255123179,60,-39,-7,113,528,1644,1072,42
-2,0,0,-2.0,-0.0,1.837846279144287,16.656340767525464,60,-37,-7,113,528,1644,1072,42
-1,0,0,-1.0,-0.0,1.8459560871124268,15.674241641784498,60,-36,-7,113,528,1644,1072,42
-2,1,0,-2.0,1.0,1.853943109512329,13.928498393145958,60,-34,-8,113,528,1644,1072,42
-4,0,0,-4.0,-0.0,1.8619191646575928,10.048349392520048,60,-30,-8,113,528,1644,1072,42
-2,0,0,-2.0,-0.0,1.8699431419372559,8.120439557122072,60,-28,-8,113,528,1644,1072,42
-3,0,0,-3.0,-0.0,1.878040075302124,5.248809496813376,60,-25,-8,113,528,1644,1072,42
-2,0,0,-2.0,-0.0,1.885986089706421,3.351591323771842,60,-23,-8,113,528,1644,1072,42
-4,0,0,-4.0,-0.0,1.8938910961151123,-0.3844718719116962,60,-19,-8,113,528,1644,1072,42
-2,0,0,-2.0,-0.0,1.9019622802734375,-2.2117057719440645,60,-17,-8,113,528,1644,1072,42
-3,0,0,-3.0,-0.0,1.909900188446045,-4.875484503402902,60,-14,-8,113,528,1644,1072,42
-1,0,0,-1.0,-0.0,1.9180281162261963,-5.735662477526253,60,-13,-8,113,528,1644,1072,42
0,0,1,-0.0,-0.0,1.9358501434326172,-5.735662477526253,60,-13,-8,113,528,1644,1072,42
-1,0,1,-1.0,-0.0,0.04114174842834473,710.1342658385187,61,516,532,641,1068,126,536,63
0,0,0,-0.0,-0.0,0.09601974487304688,710.1342658385187,61,516,532,641,1068,126,536,63
1,0,0,1.0,-0.0,0.20122575759887695,709.4383836620033,61,515,532,641,1068,126,536,63
5,3,0,5.0,3.0,0.20916366577148438,703.8067773231273,61,510,529,641,1068,126,536,63
7,4,0,7.0,4.0,0.2171328067779541,696.0722109942038,61,503,525,641,1068,126,536,63
10,6,0,10.0,6.0,0.22513079643249512,684.8281916773046,61,493,519,641,1068,126,536,63
14,6,0,14.0,6.0,0.23311686515808105,670.8618097602974,61,479,513,641,1068,126,536,63
18,9,0,18.0,9.0,0.2410566806793213,652.0351381883659,61,461,504,641,1068,126,536,63
21,9,0,21.0,9.0,0.24902987480163574,631.2877018335763,61,440,495,641,1068,126,536,63
24,11,0,24.0,11.0,0.25710272789001465,607.2099967878911,61,416,484,641,1068,126,536,63
25,12,0,25.0,12.0,0.26518678665161133,581.9151654185105,61,391,472,641,1068,126,536,63
27,16,0,27.0,16.0,0.27314066886901855,552.4655088349267,61,364,456,641,1068,126,536,63
28,16,0,28.0,16.0,0.281160831451416,522.6208088574706,61,336,440,641,1068,126,536,63
23,16,0,23.0,16.0,0.2891829013824463,496.0151800470268,61,313,424,641,1068,126,536,63
20,16,0,20.0,16.0,0.29714083671569824,471.3076746377662,61,293,408,641,1068,126,536,63
14,14,0,14.0,14.0,0.30522775650024414,451.78048842098,61,279,394,641,1068,126,536,63
13,15,0,13.0,15.0,0.31322383880615234,432.0302365936808,61,266,379,641,1068,126,536,63
13,14,0,13.0,14.0,0.3212437629699707,413.1103466482176,61,253,365,641,1068,126,536,63
13,16,0,13.0,16.0,0.32900166511535645,392.55755216971403,61,240,349,641,1068,126,536,63
13,17,0,13.0,17.0,0.33713388442993164,371.18528068540746,61,227,332,641,1068,126,536,63
12,17,0,12.0,17.0,0.34505367279052734,350.3790765104976,61,215,315,641,1068,126,536,63
10,18,0,10.0,18.0,0.353165864944458,329.8794812676387,61,205,297,641,1068,126,536,63
8,15,0,8.0,15.0,0.36121678352355957,312.99563950724723,61,197,282,641,1068,126,536,63
7,13,0,7.0,13.0,0.3691267967224121,298.3341767870441,61,190,269,641,1068,126,536,63
5,11,0,5.0,11.0,0.3773317337036133,286.47283348343365,61,185,258,641,1068,126,536,63
4,11,0,4.0,11.0,0.3851737976074219,275.2188759694608,61,181,247,641,1068,126,536,63
4,8,0,4.0,8.0,0.3930227756500244,266.40544715926103,61,177,239,641,1068,126,536,63
3,9,0,3.0,9.0,0.40111279487609863,257.4024965217881,61,174,230,641,1068,126,536,63
3,7,0,3.0,7.0,0.40917372703552246,250.01601377857457,61,171,223,641,1068,126,536,63
1,6,0,1.0,6.0,0.4171767234802246,244.66102372297757,61,170,217,641,1068,126,536,63
2,4,0,2.0,4.0,0.42522573471069336,240.28029784707917,61,168,213,641,1068,126,536,63
0,6,0,-0.0,6.0,0.433093786239624,235.59519875646674,61,168,207,641,1068,126,536,63
2,6,0,2.0,6.0,0.44116973876953125,229.6856344335069,61,166,201,641,1068,126,536,63
2,6,0,2.0,6.0,0.4491398334503174,223.7959968288356,61,164,195,641,1068,126,536,63
2,6,0,2.0,6.0,0.45708370208740234,217.92770034690795,61,162,189,641,1068,126,536,63
2,7,0,2.0,7.0,0.4651336669921875,211.33035303073365,61,160,182,641,1068,126,536,63
2,6,0,2.0,6.0,0.4729938507080078,205.51638421048128,61,158,176,641,1068,126,536,63
2,7,0,2.0,7.0,0.48110485076904297,198.99347816840373,61,156,169,641,1068,126,536,63
2,7,0,2.0,7.0,0.4892756938934326,192.51733713517615,61,154,162,641,1068,126,536,63
3,5,0,3.0,5.0,0.4971587657928467,186.83020910791964,61,151,157,641,1068,126,536,63
2,6,0,2.0,6.0,0.50516676902771,181.13674834879504,61,149,151,641,1068,126,536,63
3,5,0,3.0,5.0,0.5131747722625732,175.47518010647187,61,146,146,641,1068,126,536,63
3,7,0,3.0,7.0,0.5212597846984863,168.42417105255822,61,143,139,641,1068,126,536,63
4,6,0,4.0,6.0,0.529167890548706,161.37983262286096,61,139,133,641,1068,126,536,63
3,5,0,3.0,5.0,0.5371627807617188,155.76188047886004,61,136,128,641,1068,126,536,63
5,5,0,5.0,5.0,0.545097827911377,148.6941846582688,61,131,123,641,1068,126,536,63
4,4,0,4.0,4.0,0.5531117916107178,143.04022523543227,61,127,119,641,1068,126,536,63
6,5,0,6.0,5.0,0.5611958503723145,135.24379687675568,61,121,114,641,1068,126,536,63
6,6,0,6.0,6.0,0.569166898727417,126.76247969653622,61,115,108,641,1068,126,536,63
9,6,0,9.0,6.0,0.5771486759185791,116.10540438746634,61,106,102,641,1068,126,536,63
9,8,0,9.0,8.0,0.5851428508758545,104.07405376311175,61,97,94,641,1068,126,536,63
10,7,0,10.0,7.0,0.5932068824768066,92.03657992645927,61,87,87,641,1068,126,536,63
9,7,0,9.0,7.0,0.6011147499084473,80.73182178770737,61,78,80,641,1068,126,536,63
9,7,0,9.0,7.0,0.6091527938842773,69.44899203078147,61,69,73,641,1068,126,536,63
8,7,0,8.0,7.0,0.6170437335968018,58.872131386765275,61,61,66,641,1068,126,536,63
8,8,0,8.0,8.0,0.625037670135498,47.56844150166147,61,53,58,641,1068,126,536,63
8,7,0,8.0,7.0,0.6331486701965332,37.01470429252781,61,45,51,641,1068,126,536,63
7,7,0,7.0,7.0,0.641157865524292,27.137767414994535,61,38,44,641,1068,126,536,63
6,6,0,6.0,6.0,0.6491687297821045,18.678969393496885,61,32,38,641,1068,126,536,63
5,6,0,5.0,6.0,0.657174825668335,10.868842830916641,61,27,32,641,1068,126,536,63
4,5,0,4.0,5.0,0.6651308536529541,4.468295701936398,61,23,27,641,1068,126,536,63
3,4,0,3.0,4.0,0.6732816696166992,-0.5204986917436578,61,20,23,641,1068,126,536,63
2,4,0,2.0,4.0,0.6810348033905029,-4.827495343395199,61,18,19,641,1068,126,536,63
2,4,0,2.0,4.0,0.6891276836395264,-9.068287800538691,61,16,15,641,1068,126,536,63
1,2,0,1.0,2.0,0.6970667839050293,-11.150566758720792,61,15,13,641,1068,126,536,63
1,3,0,1.0,3.0,0.7050297260284424,-13.795349465914747,61,14,10,641,1068,126,536,63
1,3,0,1.0,3.0,0.7131307125091553,-16.2351769397666,61,13,7,641,1068,126,536,63
1,3,0,1.0,3.0,0.7211878299713135,-18.35088935932648,61,12,4,641,1068,126,536,63
1,3,0,1.0,3.0,0.729205846786499,-19.95463898281274,61,11,1,641,1068,126,536,63
1,4,0,1.0,4.0,0.7373597621917725,-20.559693491089448,61,10,-3,641,1068,126,536,63
2,2,0,2.0,2.0,0.745067834854126,-21.5660188679434,61,8,-5,641,1068,126,536,63
2,4,0,2.0,4.0,0.7530426979064941,-20.18334617360803,61,6,-9,641,1068,126,536,63
2,4,0,2.0,4.0,0.7611217498779297,-17.398529491264554,61,4,-13,641,1068,126,536,63
2,3,0,2.0,3.0,0.7691988945007324,-14.875484503402902,61,2,-16,641,1068,126,536,63
3,3,0,3.0,3.0,0.7772128582000732,-11.973702409559554,61,-1,-19,641,1068,126,536,63
2,4,0,2.0,4.0,0.7851057052612305,-7.805172990513597,61,-3,-23,641,1068,126,536,63
1,2,0,1.0,2.0,0.7931838035583496,-5.682022197655673,61,-4,-25,641,1068,126,536,63
1,0,0,1.0,-0.0,0.8091397285461426,-5.504902432036076,61,-5,-25,641,1068,126,536,63
0,0,1,-0.0,-0.0,0.8201897144317627,-5.504902432036076,61,-5,-25,641,1068,126,536,63
0,0,0,-0.0,-0.0,0.0742034912109375,1104.9429575517643,62,770,-816,1416,277,646,1093,34
0,-1,0,-0.0,-1.0,0.15122246742248535,1104.2158578971312,62,770,-815,1416,277,646,1093,34
0,-4,0,-0.0,-4.0,0.15912556648254395,1101.311673908486,62,770,-811,1416,277,646,1093,34
3,-4,0,3.0,-4.0,0.16723346710205078,1096.3454091161466,62,767,-807,1416,277,646,1093,34
4,-4,0,4.0,-4.0,0.17520952224731445,1090.6903899556048,62,763,-803,1416,277,646,1093,34
5,-5,0,5.0,-5.0,0.18323445320129395,1083.6216425275309,62,758,-798,1416,277,646,1093,34
6,-6,0,6.0,-6.0,0.19123053550720215,1075.139185268984,62,752,-792,1416,277,646,1093,34
9,-9,0,9.0,-9.0,0.19923758506774902,1062.4155826186686,62,743,-783,1416,277,646,1093,34
12,-12,0,12.0,-12.0,0.20726251602172852,1045.4509400438214,62,731,-771,1416,277,646,1093,34
15,-14,0,15.0,-14.0,0.21509456634521484,1024.971688674889,62,716,-757,1416,277,646,1093,34
18,-19,0,18.0,-19.0,0.22325849533081055,998.7991927541585,62,698,-738,1416,277,646,1093,34
19,-22,0,19.0,-22.0,0.23122549057006836,969.7608626207264,62,679,-716,1416,277,646,1093,34
22,-23,0,22.0,-23.0,0.23929643630981445,937.9335055384746,62,657,-693,1416,277,646,1093,34
23,-23,0,23.0,-23.0,0.24722957611083984,905.4185600908082,62,634,-670,1416,277,646,1093,34
26,-22,0,26.0,-22.0,0.255204439163208,871.5763895130233,62,608,-648,1416,277,646,1093,34
29,-24,0,29.0,-24.0,0.26320648193359375,834.2443832413815,62,579,-624,1416,277,646,1093,34
32,-27,0,32.0,-27.0,0.271221399307251,792.7024144708969,62,547,-597,1416,277,646,1093,34
36,-31,0,36.0,-31.0,0.27928638458251953,745.5463920313308,62,511,-566,1416,277,646,1093,34
34,-31,0,34.0,-31.0,0.28726840019226074,699.766349656567,62,477,-535,1416,277,646,1093,34
36,-33,0,36.0,-33.0,0.2951054573059082,651.1953307229855,62,441,-502,1416,277,646,1093,34
32,-31,0,32.0,-31.0,0.3031885623931885,606.7964411568889,62,409,-471,1416,277,646,1093,34
29,-30,0,29.0,-30.0,0.3112635612487793,565.1348640993768,62,380,-441,1416,277,646,1093,34
25,-27,0,25.0,-27.0,0.3192145824432373,528.3631817422221,62,355,-414,1416,277,646,1093,34
22,-28,0,22.0,-28.0,0.3271815776824951,492.7891721094123,62,333,-386,1416,277,646,1093,34
21,-27,0,21.0,-27.0,0.3352854251861572,458.631159618459,62,312,-359,1416,277,646,1093,34
18,-24,0,18.0,-24.0,0.34320640563964844,428.7140338827127,62,294,-335,1416,277,646,1093,34
15,-21,0,15.0,-21.0,0.3511674404144287,403.04404530953656,62,279,-314,1416,277,646,1093,34
15,-20,0,15.0,-20.0,0.35910558700561523,378.13541982464693,62,264,-294,1416,277,646,1093,34
14,-17,0,14.0,-17.0,0.36707258224487305,356.1340241789805,62,250,-277,1416,277,646,1093,34
12,-15,0,12.0,-15.0,0.37519359588623047,336.96044976804967,62,238,-262,1416,277,646,1093,34
11,-14,0,11.0,-14.0,0.3832125663757324,319.2038072360276,62,227,-248,1416,277,646,1093,34
9,-13,0,9.0,-13.0,0.3912184238433838,303.5448486561592,62,218,-235,1416,277,646,1093,34
9,-12,0,9.0,-12.0,0.39926743507385254,288.6304958606062,62,209,-223,1416,277,646,1093,34
8,-12,0,8.0,-12.0,0.40717148780822754,274.41379514360676,62,201,-211,1416,277,646,1093,34
7,-10,0,7.0,-10.0,0.415224552154541,262.35103364763125,62,194,-201,1416,277,646,1093,34
6,-10,0,6.0,-10.0,0.42325758934020996,251.00186566514793,62,188,-191,1416,277,646,1093,34
6,-7,0,6.0,-7.0,0.4313063621520996,241.80494585691366,62,182,-184,1416,277,646,1093,34
5,-6,0,5.0,-6.0,0.43919944763183594,234.02390324429265,62,177,-178,1416,277,646,1093,34
6,-7,0,6.0,-7.0,0.4473404884338379,224.83051916579925,62,171,-171,1416,277,646,1093,34
7,-6,0,7.0,-6.0,0.4552154541015625,215.63920563825866,62,164,-165,1416,277,646,1093,34
6,-6,0,6.0,-6.0,0.46315455436706543,207.1539649437413,62,158,-159,1416,277,646,1093,34
7,-5,0,7.0,-5.0,0.4712405204772949,198.67800073257357,62,151,-154,1416,277,646,1093,34
6,-5,0,6.0,-5.0,0.47913646697998047,190.90863377935992,62,145,-149,1416,277,646,1093,34
7,-5,0,7.0,-5.0,0.4872465133666992,182.44924166313595,62,138,-144,1416,277,646,1093,34
6,-5,0,6.0,-5.0,0.4952714443206787,174.68985366993215,62,132,-139,1416,277,646,1093,34
7,-4,0,7.0,-4.0,0.5031523704528809,166.98369492974098,62,125,-135,1416,277,646,1093,34
5,-5,0,5.0,-5.0,0.5112204551696777,159.91806012954132,62,120,-130,1416,277,646,1093,34
5,-6,0,5.0,-6.0,0.5190694332122803,152.11830178901394,62,115,-124,1416,277,646,1093,34
5,-4,0,5.0,-4.0,0.5272684097290039,145.78820596099706,62,110,-120,1416,277,646,1093,34
4,-5,0,4.0,-5.0,0.5352184772491455,139.40012787718558,62,106,-115,1416,277,646,1093,34
5,-6,0,5.0,-6.0,0.5432083606719971,131.60013458944107,62,101,-109,1416,277,646,1093,34
5,-6,0,5.0,-6.0,0.5512394905090332,123.80127840328723,62,96,-103,1416,277,646,1093,34
4,-4,0,4.0,-4.0,0.559227466583252,118.14806694880988,62,92,-99,1416,277,646,1093,34
4,-5,0,4.0,-5.0,0.5670835971832275,111.76334882255898,62,88,-94,1416,277,646,1093,34
5,-5,0,5.0,-5.0,0.5751535892486572,104.69634341261039,62,83,-89,1416,277,646,1093,34
3,-4,0,3.0,-4.0,0.5832314491271973,99.72617529928752,62,80,-85,1416,277,646,1093,34
4,-4,0,4.0,-4.0,0.5911214351654053,94.07204868912791,62,76,-81,1416,277,646,1093,34
3,-4,0,3.0,-4.0,0.5991365909576416,89.10372283760829,62,73,-77,1416,277,646,1093,34
3,-3,0,3.0,-3.0,0.6072235107421875,84.86265262597475,62,70,-74,1416,277,646,1093,34
3,-3,0,3.0,-3.0,0.6152234077453613,80.62171889492625,62,67,-71,1416,277,646,1093,34
3,-3,0,3.0,-3.0,0.623192548751831,76.38094023943002,62,64,-68,1416,277,646,1093,34
3,-3,0,3.0,-3.0,0.6312503814697266,72.1403387922662,62,61,-65,1416,277,646,1093,34
3,-3,0,3.0,-3.0,0.6391935348510742,67.8999411071645,62,58,-62,1416,277,646,1093,34
3,-4,0,3.0,-4.0,0.6470625400543213,62.93122043357026,62,55,-58,1416,277,646,1093,34
4,-3,0,4.0,-3.0,0.6552004814147949,58.0066663703967,62,51,-55,1416,277,646,1093,34
3,-3,0,3.0,-3.0,0.6632664203643799,53.76722405181653,62,48,-52,1416,277,646,1093,34
4,-3,0,4.0,-3.0,0.6712005138397217,48.85590330410783,62,44,-49,1416,277,646,1093,34
3,-3,0,3.0,-3.0,0.6792304515838623,44.61980201201558,62,41,-46,1416,277,646,1093,34
3,-3,0,3.0,-3.0,0.6872105598449707,40.38466694161429,62,38,-43,1416,277,646,1093,34
3,-3,0,3.0,-3.0,0.6952705383300781,36.150729063673246,62,35,-40,1416,277,646,1093,34
4,-3,0,4.0,-3.0,0.7032215595245361,31.270073544588683,62,31,-37,1416,277,646,1093,34
5,-4,0,5.0,-4.0,0.7113065719604492,25.01190307520001,62,26,-33,1416,277,646,1093,34
4,-3,0,4.0,-3.0,0.719151496887207,20.20215047547655,62,22,-30,1416,277,646,1093,34
5,-4,0,5.0,-4.0,0.7271485328674316,14.064449134018133,62,17,-26,1416,277,646,1093,34
3,-4,0,3.0,-4.0,0.7352464199066162,9.076809620810597,62,14,-22,1416,277,646,1093,34
4,-3,0,4.0,-3.0,0.7431795597076416,4.470910553583888,62,10,-19,1416,277,646,1093,34
2,-3,0,2.0,-3.0,0.751225471496582,0.8885438199983184,62,8,-16,1416,277,646,1093,34
2,-3,0,2.0,-3.0,0.7593145370483398,-2.6821789367236466,62,6,-13,1416,277,646,1093,34
2,-3,0,2.0,-3.0,0.7672173976898193,-6.2296703857309925,62,4,-10,1416,277,646,1093,34
2,-3,0,2.0,-3.0,0.7752254009246826,-9.719890110719483,62,2,-7,1416,277,646,1093,34
2,-3,0,2.0,-3.0,0.7835085391998291,-13.0,62,0,-4,1416,277,646,1093,34
1,-1,0,1.0,-1.0,0.7912755012512207,-13.83772233983162,62,-1,-3,1416,277,646,1093,34
0,-2,0,-0.0,-2.0,0.7990825176239014,-15.585786437626904,62,-1,-1,1416,277,646,1093,34
1,-2,0,1.0,-2.0,0.8072633743286133,-14.76393202250021,62,-2,1,1416,277,646,1093,34
1,-1,0,1.0,-1.0,0.8151273727416992,-13.39444872453601,62,-3,2,1416,277,646,1093,34
1,-1,0,1.0,-1.0,0.8232405185699463,-12.0,62,-4,3,1416,277,646,1093,34
0,-1,0,-0.0,-1.0,0.8312053680419922,-11.34314575050762,62,-4,4,1416,277,646,1093,34
1,0,0,1.0,-0.0,0.8392534255981445,-10.596875762567151,62,-5,4,1416,277,646,1093,34
0,0,1,-0.0,-0.0,0.8631343841552734,-10.596875762567151,62,-5,4,1416,277,646,1093,34
0,0,0,-0.0,-0.0,0.07941746711730957,1192.0907191174226,63,-1207,-164,214,109,1421,273,52
-3,0,0,-3.0,-0.0,0.20643138885498047,1189.1181012560055,63,-1204,-164,214,109,1421,273,52
-9,0,0,-9.0,-0.0,0.2145862579345703,1180.2010611834164,63,-1195,-164,214,109,1421,273,52
-16,0,0,-16.0,-0.0,0.22244739532470703,1164.3516287215302,63,-1179,-164,214,109,1421,273,52
-24,7,0,-24.0,7.0,0.23046040534973145,1141.5898252382983,63,-1155,-171,214,109,1421,273,52
-23,9,0,-23.0,9.0,0.2386174201965332,1120.2216190597699,63,-1132,-180,214,109,1421,273,52
-23,8,0,-23.0,8.0,0.24651145935058594,1098.822208173363,63,-1109,-188,214,109,1421,273,52
-22,8,0,-22.0,8.0,0.25452232360839844,1078.5293115169013,63,-1087,-196,214,109,1421,273,52
-23,5,0,-23.0,5.0,0.26247525215148926,1056.81900611321,63,-1064,-201,214,109,1421,273,52
-26,1,0,-26.0,1.0,0.2705364227294922,1031.4724582701906,63,-1038,-202,214,109,1421,273,52
-32,0,0,-32.0,-0.0,0.2784852981567383,1000.0799189147012,63,-1006,-202,214,109,1421,273,52
-34,-4,0,-34.0,-4.0,0.2864983081817627,965.9616928087495,63,-972,-198,214,109,1421,273,52
-38,-7,0,-38.0,-7.0,0.2945554256439209,927.3294288964335,63,-934,-191,214,109,1421,273,52
-41,-7,0,-41.0,-7.0,0.302457332611084,885.7592884089528,63,-893,-184,214,109,1421,273,52
-43,-9,0,-43.0,-9.0,0.31047630310058594,841.8277478854891,63,-850,-175,214,109,1421,273,52
-46,-8,0,-46.0,-8.0,0.3184332847595215,795.1607637971995,63,-804,-167,214,109,1421,273,52
-46,-9,0,-46.0,-9.0,0.3265223503112793,748.2919346086462,63,-758,-158,214,109,1421,273,52
-47,-9,0,-47.0,-9.0,0.33449530601501465,700.4447673429826,63,-711,-149,214,109,1421,273,52
-44,-8,0,-44.0,-8.0,0.34250426292419434,655.7404198080087,63,-667,-141,214,109,1421,273,52
-42,-9,0,-42.0,-9.0,0.3505432605743408,612.7871319931234,63,-625,-132,214,109,1421,273,52
-38,-9,0,-38.0,-9.0,0.35846829414367676,573.7482805310908,63,-587,-123,214,109,1421,273,52
-33,-7,0,-33.0,-7.0,0.36639833450317383,540.0141340991406,63,-554,-116,214,109,1421,273,52
-30,-6,0,-30.0,-6.0,0.37442827224731445,509.42132942197964,63,-524,-110,214,109,1421,273,52
-25,-5,0,-25.0,-5.0,0.38260531425476074,483.92744581950086,63,-499,-105,214,109,1421,273,52
-23,-4,0,-23.0,-4.0,0.3904702663421631,460.5973694955615,63,-476,-101,214,109,1421,273,52
-20,-3,0,-20.0,-3.0,0.398700475692749,440.4118351843143,63,-456,-98,214,109,1421,273,52
-18,-3,0,-18.0,-3.0,0.4065284729003906,422.1841139531833,63,-438,-95,214,109,1421,273,52
-17,-3,0,-17.0,-3.0,0.41450047492980957,404.9350299059012,63,-421,-92,214,109,1421,273,52
-17,-2,0,-17.0,-2.0,0.42238640785217285,387.90337036559634,63,-404,-90,214,109,1421,273,52
-16,-2,0,-16.0,-2.0,0.4305853843688965,371.85424466756666,63,-388,-88,214,109,1421,273,52
-15,-2,0,-15.0,-2.0,0.4385073184967041,356.78584090846414,63,-373,-86,214,109,1421,273,52
-14,-3,0,-14.0,-3.0,0.44650936126708984,342.46980880392357,63,-359,-83,214,109,1421,273,52
-10,-3,0,-10.0,-3.0,0.45448946952819824,332.05167224857365,63,-349,-80,214,109,1421,273,52
-9,-3,0,-9.0,-3.0,0.46256041526794434,322.61009738675097,63,-340,-77,214,109,1421,273,52
-8,-4,0,-8.0,-4.0,0.4705793857574463,313.9308753261463,63,-332,-73,214,109,1421,273,52
-8,-4,0,-8.0,-4.0,0.4785323143005371,305.2657543423407,63,-324,-69,214,109,1421,273,52
-9,-5,0,-9.0,-5.0,0.4865074157714844,295.43584118763107,63,-315,-64,214,109,1421,273,52
-9,-4,0,-9.0,-4.0,0.49446630477905273,285.8268750444708,63,-306,-60,214,109,1421,273,52
-9,-5,0,-9.0,-5.0,0.502535343170166,276.04966479041155,63,-297,-55,214,109,1421,273,52
-9,-4,0,-9.0,-4.0,0.5105233192443848,266.48076859855246,63,-288,-51,214,109,1421,273,52
-9,-3,0,-9.0,-3.0,0.5184173583984375,257.0989226401259,63,-279,-48,214,109,1421,273,52
-6,-2,0,-6.0,-2.0,0.5265083312988281,250.8483339303309,63,-273,-46,214,109,1421,273,52
-5,-2,0,-5.0,-2.0,0.5345203876495361,245.5879231482873,63,-268,-44,214,109,1421,273,52
-5,-2,0,-5.0,-2.0,0.5425894260406494,240.33249895572266,63,-263,-42,214,109,1421,273,52
-5,-1,0,-5.0,-1.0,0.5505952835083008,235.23743988946148,63,-258,-41,214,109,1421,273,52
-4,-1,0,-4.0,-1.0,0.5584814548492432,231.13031715455105,63,-254,-40,214,109,1421,273,52
-5,-1,0,-5.0,-1.0,0.5669033527374268,226.03571175529868,63,-249,-39,214,109,1421,273,52
-6,-1,0,-6.0,-1.0,0.5743932723999023,219.9532475898621,63,-243,-38,214,109,1421,273,52
-6,0,0,-6.0,-0.0,0.58249831199646,214.0270818053663,63,-237,-38,214,109,1421,273,52
-8,-1,0,-8.0,-1.0,0.5903973579406738,205.96982562393757,63,-229,-37,214,109,1421,273,52
-8,0,0,-8.0,-0.0,0.5985963344573975,198.07588000496617,63,-221,-37,214,109,1421,273,52
-10,0,0,-10.0,-0.0,0.6065442562103271,188.21951358361358,63,-211,-37,214,109,1421,273,52
-10,-1,0,-10.0,-1.0,0.614565372467041,178.1984329028996,63,-201,-36,214,109,1421,273,52
-10,-1,0,-10.0,-1.0,0.622563362121582,168.18032856085088,63,-191,-35,214,109,1421,273,52
-10,-1,0,-10.0,-1.0,0.6305732727050781,158.16568627190028,63,-181,-34,214,109,1421,273,52
-11,-2,0,-11.0,-2.0,0.638580322265625,146.9855485293497,63,-170,-32,214,109,1421,273,52
-11,-1,0,-11.0,-1.0,0.6465413570404053,135.99382704288456,63,-159,-31,214,109,1421,273,52
-10,-2,0,-10.0,-2.0,0.6544773578643799,125.79591562357663,63,-149,-29,214,109,1421,273,52
-9,-3,0,-9.0,-3.0,0.6626043319702148,116.3938200906205,63,-140,-26,214,109,1421,273,52
-9,-3,0,-9.0,-3.0,0.6704483032226562,107.00375934536586,63,-131,-23,214,109,1421,273,52
-10,-3,0,-10.0,-3.0,0.6785094738006592,96.64175471673585,63,-121,-20,214,109,1421,273,52
-9,-4,0,-9.0,-4.0,0.6865463256835938,87.13708498984761,63,-112,-16,214,109,1421,273,52
-7,-4,0,-7.0,-4.0,0.694521427154541,79.68348972285122,63,-105,-12,214,109,1421,273,52
-6,-2,0,-6.0,-2.0,0.702526330947876,73.50376877284599,63,-99,-10,214,109,1421,273,52
-6,-3,0,-6.0,-3.0,0.7104554176330566,67.26306878931231,63,-93,-7,214,109,1421,273,52
-6,-4,0,-6.0,-4.0,0.7188782691955566,61.051708771281454,63,-87,-3,214,109,1421,273,52
-7,-3,0,-7.0,-3.0,0.7265512943267822,54.0,63,-80,0,214,109,1421,273,52
-7,-2,0,-7.0,-2.0,0.7343893051147461,47.02739212103907,63,-73,2,214,109,1421,273,52
-7,-3,0,-7.0,-3.0,0.7425923347473145,40.18912297349165,63,-66,5,214,109,1421,273,52
-6,-1,0,-6.0,-1.0,0.7504363059997559,34.29925372672534,63,-60,6,214,109,1421,273,52
-5,-1,0,-5.0,-1.0,0.7586374282836914,29.443665102516448,63,-55,7,214,109,1421,273,52
-3,-1,0,-3.0,-1.0,0.76651930809021,26.61178575186362,63,-52,8,214,109,1421,273,52
-3,0,0,-3.0,-0.0,0.7745623588562012,23.64876634922564,63,-49,8,214,109,1421,273,52
-4,0,0,-4.0,-0.0,0.7825052738189697,19.70557952810576,63,-45,8,214,109,1421,273,52
-3,0,0,-3.0,-0.0,0.7906553745269775,16.755116652863897,63,-42,8,214,109,1421,273,52
-3,0,0,-3.0,-0.0,0.7984774112701416,13.812058474788763,63,-39,8,214,109,1421,273,52
-3,0,0,-3.0,-0.0,0.8064513206481934,10.878177829171548,63,-36,8,214,109,1421,273,52
-3,0,0,-3.0,-0.0,0.81447434425354,7.955853692699293,63,-33,8,214,109,1421,273,52
-3,0,0,-3.0,-0.0,0.8225164413452148,5.048349392520048,63,-30,8,214,109,1421,273,52
-2,0,0,-2.0,-0.0,0.8305394649505615,3.120439557122072,63,-28,8,214,109,1421,273,52
-1,0,0,-1.0,-0.0,0.8385403156280518,2.160255680657446,63,-27,8,214,109,1421,273,52
0,0,1,-0.0,-0.0,0.8635523319244385,2.160255680657446,63,-27,8,214,109,1421,273,52
0,0,0,-0.0,-0.0,0.07317900657653809,174.54804791094466,64,135,155,376,256,241,101,63
0,2,0,-0.0,2.0,0.14331793785095215,173.04411287758342,64,135,153,376,256,241,101,63
3,6,0,3.0,6.0,0.1512761116027832,166.56770991232347,64,132,147,376,256,241,101,63
4,9,0,4.0,9.0,0.15922904014587402,157.22327167489146,64,128,138,376,256,241,101,63
4,9,0,4.0,9.0,0.16738295555114746,147.932948335403,64,124,129,376,256,241,101,63
6,10,0,6.0,10.0,0.17530202865600586,136.5857989210303,64,118,119,376,256,241,101,63
10,12,0,10.0,12.0,0.18325400352478027,121.02960238058901,64,108,107,376,256,241,101,63
11,13,0,11.0,13.0,0.19126105308532715,104.07405376311175,64,97,94,376,256,241,101,63
13,15,0,13.0,15.0,0.19927000999450684,84.31261856362468,64,84,79,376,256,241,101,63
14,13,0,14.0,13.0,0.207319974899292,65.20810776644555,64,70,66,376,256,241,101,63
13,13,0,13.0,13.0,0.21515202522277832,46.833154889160184,64,57,53,376,256,241,101,63
15,14,0,15.0,14.0,0.22314095497131348,26.314919523628397,64,42,39,376,256,241,101,63
17,14,0,17.0,14.0,0.2312159538269043,4.3553390593273775,64,25,25,376,256,241,101,63
18,16,0,18.0,16.0,0.23920297622680664,-19.59824574900862,64,7,9,376,256,241,101,63
18,13,0,18.0,13.0,0.24724388122558594,-19.295300089280374,64,-11,-4,376,256,241,101,63
15,12,0,15.0,12.0,0.2552609443664551,-0.4713249550525056,64,-26,-16,376,256,241,101,63
12,8,0,12.0,8.0,0.26326608657836914,13.944410108488462,64,-38,-24,376,256,241,101,63
5,3,0,5.0,3.0,0.2712690830230713,19.774009099144415,64,-43,-27,376,256,241,101,63
2,1,0,2.0,1.0,0.27933406829833984,22.0,64,-45,-28,376,256,241,101,63
0,1,0,-0.0,1.0,0.2871360778808594,22.53503525729669,64,-45,-29,376,256,241,101,63
2,2,0,2.0,2.0,0.29520606994628906,25.302753041036986,64,-47,-31,376,256,241,101,63
1,1,0,1.0,1.0,0.30321693420410156,26.688820407423826,64,-48,-32,376,256,241,101,63
-2,0,0,-2.0,-0.0,0.34325504302978516,25.0357029044876,64,-46,-32,376,256,241,101,63
-2,0,0,-2.0,-0.0,0.35127806663513184,23.405882034941776,64,-44,-32,376,256,241,101,63
-3,-1,0,-3.0,-1.0,0.35915708541870117,20.40038910358559,64,-41,-31,376,256,241,101,63
-3,0,0,-3.0,-0.0,0.3671700954437256,18.040799340956916,64,-38,-31,376,256,241,101,63
-3,-1,0,-3.0,-1.0,0.37522101402282715,15.097722286464439,64,-35,-30,376,256,241,101,63
-4,-2,0,-4.0,-2.0,0.3832380771636963,10.773197148410844,64,-31,-28,376,256,241,101,63
-5,0,0,-5.0,-0.0,0.3913090229034424,7.209946349085598,64,-26,-28,376,256,241,101,63
-5,-2,0,-5.0,-2.0,0.39930009841918945,2.421549934136806,64,-21,-26,376,256,241,101,63
-4,-2,0,-4.0,-2.0,0.40737199783325195,-1.5891176602945158,64,-17,-24,376,256,241,101,63
-5,-1,0,-5.0,-1.0,0.4153718948364258,-5.057756457854307,64,-12,-23,376,256,241,101,63
-4,-2,0,-4.0,-2.0,0.42322397232055664,-8.527794945755769,64,-8,-21,376,256,241,101,63
-5,-1,0,-5.0,-1.0,0.43111300468444824,-10.776251583843315,64,-3,-20,376,256,241,101,63
-5,-2,0,-5.0,-2.0,0.43924593925476074,-12.889229723725165,64,2,-18,376,256,241,101,63
-5,-1,0,-5.0,-1.0,0.44727587699890137,-12.615223689149765,64,7,-17,376,256,241,101,63
-3,-1,0,-3.0,-1.0,0.45529890060424805,-12.132037735886794,64,10,-16,376,256,241,101,63
-2,-1,0,-2.0,-1.0,0.4634060859680176,-11.790627287701454,64,12,-15,376,256,241,101,63
-2,0,0,-2.0,-0.0,0.4712638854980469,-10.481715471316807,64,14,-15,376,256,241,101,63
0,-1,0,-0.0,-1.0,0.4792790412902832,-11.20101012677667,64,14,-14,376,256,241,101,63
1,0,0,1.0,-0.0,0.5112020969390869,-11.895026825457201,64,13,-14,376,256,241,101,63
2,0,0,2.0,-0.0,0.5193490982055664,-13.195506185235143,64,11,-14,376,256,241,101,63
0,0,1,-0.0,-0.0,0.5273070335388184,-13.195506185235143,64,11,-14,376,256,241,101,63
1,1,1,1.0,1.0,0.0037164688110351562,1050.25602162613,65,999,395,1365,666,365,270,48
0,0,0,-0.0,-0.0,0.05467653274536133,1050.25602162613,65,999,395,1365,666,365,270,48
2,0,0,2.0,-0.0,0.15567755699157715,1048.3963819409314,65,997,395,1365,666,365,270,48
4,1,0,4.0,1.0,0.16368460655212402,1044.309412108683,65,993,394,1365,666,365,270,48
5,0,0,5.0,-0.0,0.17165350914001465,1039.6634806178126,65,988,394,1365,666,365,270,48
5,1,0,5.0,1.0,0.17979645729064941,1034.6491392335802,65,983,393,1365,666,365,270,48
7,2,0,7.0,2.0,0.18764066696166992,1027.4071523439434,65,976,391,1365,666,365,270,48
9,1,0,9.0,1.0,0.19553446769714355,1018.6835569816951,65,967,390,1365,666,365,270,48
12,1,0,12.0,1.0,0.2036604881286621,1007.1866950266572,65,955,389,1365,666,365,270,48
17,2,0,17.0,2.0,0.21155953407287598,990.6984773813352,65,938,387,1365,666,365,270,48
20,2,0,20.0,2.0,0.21964764595031738,971.4642133195949,65,918,385,1365,666,365,270,48
29,6,0,29.0,6.0,0.22768855094909668,942.4170942196749,65,889,379,1365,666,365,270,48
33,7,0,33.0,7.0,0.23572945594787598,909.3380952259475,65,856,372,1365,666,365,270,48
40,11,0,40.0,11.0,0.24376344680786133,868.2875097187004,65,816,361,1365,666,365,270,48
42,12,0,42.0,12.0,0.25162458419799805,825.0447573597048,65,774,349,1365,666,365,270,48
44,15,0,44.0,15.0,0.2597615718841553,778.7801691621437,65,730,334,1365,666,365,270,48
47,18,0,47.0,18.0,0.2675955295562744,728.5589677892358,65,683,316,1365,666,365,270,48
48,19,0,48.0,19.0,0.2756376266479492,677.0235374079817,65,635,297,1365,666,365,270,48
48,21,0,48.0,21.0,0.2836945056915283,624.6485951576554,65,587,276,1365,666,365,270,48
48,23,0,48.0,23.0,0.2916436195373535,571.4242185198717,65,539,253,1365,666,365,270,48
47,24,0,47.0,24.0,0.2997424602508545,518.6831488078471,65,492,229,1365,666,365,270,48
44,26,0,44.0,26.0,0.30762147903442383,467.84652077655284,65,448,203,1365,666,365,270,48
45,26,0,45.0,26.0,0.31570863723754883,416.15679024638484,65,403,177,1365,666,365,270,48
41,24,0,41.0,24.0,0.3236994743347168,369.0050890255748,65,362,153,1365,666,365,270,48
40,23,0,40.0,23.0,0.33168745040893555,323.2520698282445,65,322,130,1365,666,365,270,48
37,21,0,37.0,21.0,0.33954358100891113,281.1327579923205,65,285,109,1365,666,365,270,48
34,19,0,34.0,19.0,0.3476145267486572,242.6477076593759,65,251,90,1365,666,365,270,48
30,14,0,30.0,14.0,0.3557465076446533,209.70280272174745,65,221,76,1365,666,365,270,48
27,12,0,27.0,12.0,0.36367344856262207,180.2841158778626,65,194,64,1365,666,365,270,48
22,8,0,22.0,8.0,0.3716855049133301,156.88670487352022,65,172,56,1365,666,365,270,48
18,8,0,18.0,8.0,0.3796725273132324,137.3071604114337,65,154,48,1365,666,365,270,48
13,3,0,13.0,3.0,0.38767147064208984,124.00675660252813,65,141,45,1365,666,365,270,48
6,1,0,6.0,1.0,0.3955814838409424,117.98943622678414,65,135,44,1365,666,365,270,48
2,0,0,2.0,-0.0,0.40364861488342285,116.08925726121899,65,133,44,1365,666,365,270,48
1,0,0,1.0,-0.0,0.41971755027770996,115.1402170474087,65,132,44,1365,666,365,270,48
1,-2,0,1.0,-2.0,0.4276885986328125,114.84163640637487,65,131,46,1365,666,365,270,48
1,-5,0,1.0,-5.0,0.4356555938720703,115.64598096615597,65,130,51,1365,666,365,270,48
1,-5,0,1.0,-5.0,0.44370365142822266,116.63072210580447,65,129,56,1365,666,365,270,48
1,-6,0,1.0,-6.0,0.45171260833740234,118.22517358048822,65,128,62,1365,666,365,270,48
1,-6,0,1.0,-6.0,0.45966458320617676,120.05901568454507,65,127,68,1365,666,365,270,48
0,-5,0,-0.0,-5.0,0.4676826000213623,122.48549416239138,65,127,73,1365,666,365,270,48
0,-3,0,-0.0,-3.0,0.4757575988769531,124.00337833982033,65,127,76,1365,666,365,270,48
0,-3,0,-0.0,-3.0,0.48360443115234375,125.56603892595405,65,127,79,1365,666,365,270,48
0,-3,0,-0.0,-3.0,0.4916355609893799,127.17208737065187,65,127,82,1365,666,365,270,48
-1,-2,0,-1.0,-2.0,0.4997844696044922,129.1012736720371,65,128,84,1365,666,365,270,48
0,-2,0,-0.0,-2.0,0.5077345371246338,130.20765220960988,65,128,86,1365,666,365,270,48
0,-1,0,-0.0,-1.0,0.5156736373901367,130.76756766196203,65,128,87,1365,666,365,270,48
0,-1,0,-0.0,-1.0,0.5236494541168213,131.3319027115808,65,128,88,1365,666,365,270,48
3,0,0,3.0,-0.0,0.5556216239929199,128.86922515666782,65,125,88,1365,666,365,270,48
5,0,0,5.0,-0.0,0.5636255741119385,124.8086019019062,65,120,88,1365,666,365,270,48
4,2,0,4.0,2.0,0.5716564655303955,120.40221604947757,65,116,86,1365,666,365,270,48
4,1,0,4.0,1.0,0.5797245502471924,116.60227594174995,65,112,85,1365,666,365,270,48
5,3,0,5.0,3.0,0.5876996517181396,110.80726983364065,65,107,82,1365,666,365,270,48
9,5,0,9.0,5.0,0.5956695079803467,100.63145670335399,65,98,77,1365,666,365,270,48
9,6,0,9.0,6.0,0.6036756038665771,89.85077953180645,65,89,71,1365,666,365,270,48
10,6,0,10.0,6.0,0.6116676330566406,78.30347012687302,65,79,65,1365,666,365,270,48
10,8,0,10.0,8.0,0.6197426319122314,65.49860334105779,65,69,57,1365,666,365,270,48
10,9,0,10.0,9.0,0.6277925968170166,52.05918747922567,65,59,48,1365,666,365,270,48
11,10,0,11.0,10.0,0.6357326507568359,37.220911460055866,65,48,38,1365,666,365,270,48
11,8,0,11.0,8.0,0.6436755657196045,23.634021455258214,65,37,30,1365,666,365,270,48
9,7,0,9.0,7.0,0.6517834663391113,12.235341863986875,65,28,23,1365,666,365,270,48
7,6,0,7.0,6.0,0.6596555709838867,3.018512172212592,65,21,17,1365,666,365,270,48
6,4,0,6.0,4.0,0.6676175594329834,-4.150566758720792,65,15,13,1365,666,365,270,48
4,3,0,4.0,3.0,0.6757316589355469,-9.133931252681494,65,11,10,1365,666,365,270,48
3,2,0,3.0,2.0,0.6837794780731201,-12.686291501015239,65,8,8,1365,666,365,270,48
1,0,0,1.0,-0.0,0.6916506290435791,-13.36985418726535,65,7,8,1365,666,365,270,48
1,0,0,1.0,-0.0,0.699608564376831,-14.0,65,6,8,1365,666,365,270,48
0,1,0,-0.0,1.0,0.7156474590301514,-14.780455542707113,65,6,7,1365,666,365,270,48
0,0,1,-0.0,-0.0,0.7515666484832764,-14.780455542707113,65,6,7,1365,666,365,270,48
0,0,0,-0.0,-0.0,0.0821082592010498,186.25624189766637,66,125,-150,1484,509,1359,659,18
-2,0,0,-2.0,-0.0,0.12118220329284668,187.5426162439078,66,127,-150,1484,509,1359,659,18
-3,1,0,-3.0,1.0,0.1292281150817871,190.25109786397664,66,130,-151,1484,509,1359,659,18
-3,1,0,-3.0,1.0,0.13719725608825684,192.97277044195835,66,133,-152,1484,509,1359,659,18
-5,0,0,-5.0,-0.0,0.1451401710510254,196.2997808084558,66,138,-152,1484,509,1359,659,18
-5,0,0,-5.0,-0.0,0.15307307243347168,199.6935552430884,66,143,-152,1484,509,1359,659,18
-8,0,0,-8.0,-0.0,0.16113924980163574,205.2545215392198,66,151,-152,1484,509,1359,659,18
-9,0,0,-9.0,-0.0,0.16899704933166504,211.68982758613956,66,160,-152,1484,509,1359,659,18
-9,-1,0,-9.0,-1.0,0.17708921432495117,217.63186007267382,66,169,-151,1484,509,1359,659,18
-11,-1,0,-11.0,-1.0,0.18500804901123047,225.30749027719963,66,180,-150,1484,509,1359,659,18
-14,-3,0,-14.0,-3.0,0.19304323196411133,234.402958075698,66,194,-147,1484,509,1359,659,18
-13,-5,0,-13.0,-5.0,0.20113921165466309,242.02390324429265,66,207,-142,1484,509,1359,659,18
-11,-6,0,-11.0,-6.0,0.2091522216796875,247.9435735720977,66,218,-136,1484,509,1359,659,18
-9,-9,0,-9.0,-9.0,0.21710824966430664,251.1115145471265,66,227,-127,1484,509,1359,659,18
-4,-12,0,-4.0,-12.0,0.2250521183013916,249.04263213662972,66,231,-115,1484,509,1359,659,18
0,-10,0,-0.0,-10.0,0.2330000400543213,244.74396544548603,66,231,-105,1484,509,1359,659,18
3,-9,0,3.0,-9.0,0.24097013473510742,238.38633753705963,66,228,-96,1484,509,1359,659,18
8,-9,0,8.0,-9.0,0.2490861415863037,227.57768280207665,66,220,-87,1484,509,1359,659,18
11,-9,0,11.0,-9.0,0.2570512294769287,214.0807028857494,66,209,-78,1484,509,1359,659,18
13,-9,0,13.0,-9.0,0.265106201171875,198.79076014106113,66,196,-69,1484,509,1359,659,18
13,-7,0,13.0,-7.0,0.27312421798706055,184.2174940319846,66,183,-62,1484,509,1359,659,18
12,-7,0,12.0,-7.0,0.2811722755432129,170.62739212046696,66,171,-55,1484,509,1359,659,18
11,-5,0,11.0,-5.0,0.2891361713409424,158.6305461424021,66,160,-50,1484,509,1359,659,18
9,-5,0,9.0,-5.0,0.2970900535583496,148.56268593801008,66,151,-45,1484,509,1359,659,18
10,-4,0,10.0,-4.0,0.30509519577026367,137.84004903295286,66,141,-41,1484,509,1359,659,18
10,-5,0,10.0,-5.0,0.3129892349243164,126.85654198455074,66,131,-36,1484,509,1359,659,18
9,-3,0,9.0,-3.0,0.32102227210998535,117.38433447227548,66,122,-33,1484,509,1359,659,18
8,-4,0,8.0,-4.0,0.32916712760925293,108.63077828527702,66,114,-29,1484,509,1359,659,18
9,-2,0,9.0,-2.0,0.3370201587677002,99.41586599755591,66,105,-27,1484,509,1359,659,18
7,-3,0,7.0,-3.0,0.34508824348449707,91.89598604503551,66,98,-24,1484,509,1359,659,18
8,-1,0,8.0,-1.0,0.35312604904174805,83.89241088485109,66,90,-23,1484,509,1359,659,18
9,-1,0,9.0,-1.0,0.36112308502197266,74.93449827097318,66,81,-22,1484,509,1359,659,18
10,-2,0,10.0,-2.0,0.36915111541748047,64.76313442364011,66,71,-20,1484,509,1359,659,18
11,-2,0,11.0,-2.0,0.37711024284362793,53.6418390534633,66,60,-18,1484,509,1359,659,18
10,-1,0,10.0,-1.0,0.38503217697143555,43.81098370604357,66,50,-17,1484,509,1359,659,18
10,-2,0,10.0,-2.0,0.39298510551452637,33.720018726587654,66,40,-15,1484,509,1359,659,18
9,-2,0,9.0,-2.0,0.40100908279418945,24.61547262794322,66,31,-13,1484,509,1359,659,18
7,0,0,7.0,-0.0,0.4090540409088135,18.294688127912362,66,24,-13,1484,509,1359,659,18
5,-2,0,5.0,-2.0,0.4170560836791992,12.95449840010015,66,19,-11,1484,509,1359,659,18
4,-1,0,4.0,-1.0,0.42509913444519043,9.027756377319946,66,15,-10,1484,509,1359,659,18
4,-1,0,4.0,-1.0,0.43311619758605957,5.212670403551895,66,11,-9,1484,509,1359,659,18
3,-1,0,3.0,-1.0,0.44106316566467285,2.313708498984761,66,8,-8,1484,509,1359,659,18
1,0,0,1.0,-0.0,0.4491891860961914,1.63014581273465,66,7,-8,1484,509,1359,659,18
2,0,0,2.0,-0.0,0.45705509185791016,0.43398113205660316,66,5,-8,1484,509,1359,659,18
1,0,0,1.0,-0.0,0.46497416496276855,-0.05572809000084078,66,4,-8,1484,509,1359,659,18
2,0,0,2.0,-0.0,0.47310519218444824,-0.7537887487646788,66,2,-8,1484,509,1359,659,18
1,0,0,1.0,-0.0,0.4809861183166504,-0.9377422517014509,66,1,-8,1484,509,1359,659,18
1,0,0,1.0,-0.0,0.48913025856018066,-1.0,66,0,-8,1484,509,1359,659,18
1,0,0,1.0,-0.0,0.49709510803222656,-0.9377422517014509,66,-1,-8,1484,509,1359,659,18
1,0,0,1.0,-0.0,0.5134260654449463,-0.7537887487646788,66,-2,-8,1484,509,1359,659,18
0,-2,0,-0.0,-2.0,0.6011700630187988,-2.675444679663241,66,-2,-6,1484,509,1359,659,18
-1,0,0,-1.0,-0.0,0.6090571880340576,-2.9172374697017807,66,-1,-6,1484,509,1359,659,18
0,0,1,-0.0,-0.0,0.6321282386779785,-2.9172374697017807,66,-1,-6,1484,509,1359,659,18
0,0,0,-0.0,-0.0,0.09183883666992188,802.5176921150702,67,-812,-29,673,486,1485,515,20
-1,0,0,-1.0,-0.0,0.10672283172607422,801.5183300456004,67,-811,-29,673,486,1485,515,20
-2,0,0,-2.0,-0.0,0.11479783058166504,799.5196106333682,67,-809,-29,673,486,1485,515,20
-2,1,0,-2.0,1.0,0.12267780303955078,797.5574282984461,67,-807,-30,673,486,1485,515,20
-3,1,0,-3.0,1.0,0.13069891929626465,794.597414860376,67,-804,-31,673,486,1485,515,20
-4,1,0,-4.0,1.0,0.13881373405456543,790.6397442045954,67,-800,-32,673,486,1485,515,20
-3,2,0,-3.0,2.0,0.14686083793640137,787.7248899213312,67,-797,-34,673,486,1485,515,20
-4,2,0,-4.0,2.0,0.15481090545654297,783.8167294785364,67,-793,-36,673,486,1485,515,20
-4,1,0,-4.0,1.0,0.16284775733947754,779.8670774250563,67,-789,-37,673,486,1485,515,20
-3,0,0,-3.0,-0.0,0.17084193229675293,776.8703832271234,67,-786,-37,673,486,1485,515,20
-4,0,0,-4.0,-0.0,0.1788628101348877,772.8748303528477,67,-782,-37,673,486,1485,515,20
-3,1,0,-3.0,1.0,0.18680071830749512,769.9262785674041,67,-779,-38,673,486,1485,515,20
-4,0,0,-4.0,-0.0,0.19469475746154785,765.9310536381438,67,-775,-38,673,486,1485,515,20
-5,0,0,-5.0,-0.0,0.20282983779907227,760.9370921158223,67,-770,-38,673,486,1485,515,20
-8,0,0,-8.0,-0.0,0.2108297348022461,752.9469182059785,67,-762,-38,673,486,1485,515,20
-13,-2,0,-13.0,-2.0,0.21882176399230957,739.8646544543889,67,-749,-36,673,486,1485,515,20
-19,-3,0,-19.0,-3.0,0.22672772407531738,720.7455097364608,67,-730,-33,673,486,1485,515,20
-21,-3,0,-21.0,-3.0,0.23470687866210938,699.6344129197794,67,-709,-30,673,486,1485,515,20
-26,-3,0,-26.0,-3.0,0.24276089668273926,673.5334666276407,67,-683,-27,673,486,1485,515,20
-30,-3,0,-30.0,-3.0,0.25072383880615234,643.4408925067362,67,-653,-24,673,486,1485,515,20
-39,-3,0,-39.0,-3.0,0.25878286361694336,604.3590155601202,67,-614,-21,673,486,1485,515,20
-42,-3,0,-42.0,-3.0,0.2668027877807617,562.2831467027489,67,-572,-18,673,486,1485,515,20
-43,-3,0,-43.0,-3.0,0.2747049331665039,519.2126226763681,67,-529,-15,673,486,1485,515,20
-43,-2,0,-43.0,-2.0,0.28282880783081055,476.17383722286,67,-486,-13,673,486,1485,515,20
-41,-1,0,-41.0,-1.0,0.2908658981323242,435.16176834943946,67,-445,-12,673,486,1485,515,20
-41,-1,0,-41.0,-1.0,0.2988147735595703,394.149724730823,67,-404,-11,673,486,1485,515,20
-43,-1,0,-43.0,-1.0,0.3068509101867676,351.1384775955063,67,-361,-10,673,486,1485,515,20
-41,0,0,-41.0,-0.0,0.3148007392883301,310.1562118716424,67,-320,-10,673,486,1485,515,20
-38,0,0,-38.0,-0.0,0.3227407932281494,272.177249260106,67,-282,-10,673,486,1485,515,20
-32,2,0,-32.0,2.0,0.33069682121276855,240.28783430282823,67,-250,-12,673,486,1485,515,20
-27,2,0,-27.0,2.0,0.33877992630004883,213.4390297150433,67,-223,-14,673,486,1485,515,20
-18,1,0,-18.0,1.0,0.3468499183654785,195.54804791094466,67,-205,-15,673,486,1485,515,20
-14,1,0,-14.0,1.0,0.35480594635009766,181.66898549321954,67,-191,-16,673,486,1485,515,20
-10,0,0,-10.0,-0.0,0.36286282539367676,171.70580618131055,67,-181,-16,673,486,1485,515,20
-7,1,0,-7.0,1.0,0.37085580825805664,164.82848738120455,67,-174,-17,673,486,1485,515,20
-7,0,0,-7.0,-0.0,0.3787388801574707,157.86303941010956,67,-167,-17,673,486,1485,515,20
-6,0,0,-6.0,-0.0,0.38676881790161133,151.89502771858065,67,-161,-17,673,486,1485,515,20
-8,0,0,-8.0,-0.0,0.39478492736816406,143.9415473483361,67,-153,-17,673,486,1485,515,20
-7,0,0,-7.0,-0.0,0.40270376205444336,136.98639392814562,67,-146,-17,673,486,1485,515,20
-5,0,0,-5.0,-0.0,0.41075873374938965,132.0211251891774,67,-141,-17,673,486,1485,515,20
-5,0,0,-5.0,-0.0,0.4189119338989258,127.05838172107534,67,-136,-17,673,486,1485,515,20
-4,0,0,-4.0,-0.0,0.4268767833709717,123.09019498069722,67,-132,-17,673,486,1485,515,20
-6,0,0,-6.0,-0.0,0.4347038269042969,117.1416532848303,67,-126,-17,673,486,1485,515,20
-4,0,0,-4.0,-0.0,0.44275975227355957,113.17873193047572,67,-122,-17,673,486,1485,515,20
-5,0,0,-5.0,-0.0,0.45081377029418945,108.2285921425101,67,-117,-17,673,486,1485,515,20
-3,0,0,-3.0,-0.0,0.45877790451049805,105.26057435220423,67,-114,-17,673,486,1485,515,20
-4,0,0,-4.0,-0.0,0.46686387062072754,101.30588483993108,67,-110,-17,673,486,1485,515,20
-3,-1,0,-3.0,-1.0,0.4748067855834961,98.18964830333815,67,-107,-16,673,486,1485,515,20
-4,0,0,-4.0,-0.0,0.482968807220459,94.23531071570709,67,-103,-16,673,486,1485,515,20
-3,0,0,-3.0,-0.0,0.4908168315887451,91.27191120937731,67,-100,-16,673,486,1485,515,20
-3,-1,0,-3.0,-1.0,0.4988517761230469,88.15294188153507,67,-97,-15,673,486,1485,515,20
-1,0,0,-1.0,-0.0,0.5068459510803223,87.16480844420988,67,-96,-15,673,486,1485,515,20
-1,0,0,-1.0,-0.0,0.5148007869720459,86.17692030835673,67,-95,-15,673,486,1485,515,20
-1,-1,0,-1.0,-1.0,0.5548129081726074,85.03683496413377,67,-94,-14,673,486,1485,515,20
-2,0,0,-2.0,-0.0,0.5628628730773926,83.05912099305473,67,-92,-14,673,486,1485,515,20
-2,-1,0,-2.0,-1.0,0.5708589553833008,80.93404203047393,67,-90,-13,673,486,1485,515,20
-3,0,0,-3.0,-0.0,0.5788187980651855,77.96590248499699,67,-87,-13,673,486,1485,515,20
-4,-2,0,-4.0,-2.0,0.5868828296661377,73.72574275573791,67,-83,-11,673,486,1485,515,20
-5,0,0,-5.0,-0.0,0.5949149131774902,68.77182237323191,67,-78,-11,673,486,1485,515,20
-4,-1,0,-4.0,-1.0,0.6028587818145752,64.67261881037788,67,-74,-10,673,486,1485,515,20
-3,-1,0,-3.0,-1.0,0.6107728481292725,61.56814934033156,67,-71,-9,673,486,1485,515,20
-4,-1,0,-4.0,-1.0,0.6187887191772461,57.47592163134935,67,-67,-8,673,486,1485,515,20
-4,-1,0,-4.0,-1.0,0.6268448829650879,53.387695966961914,67,-63,-7,673,486,1485,515,20
-5,-2,0,-5.0,-2.0,0.6348569393157959,48.215118311311535,67,-58,-5,673,486,1485,515,20
-4,-1,0,-4.0,-1.0,0.6428077220916748,44.147945482723536,67,-54,-4,673,486,1485,515,20
-4,-2,0,-4.0,-2.0,0.6508898735046387,40.039984012787215,67,-50,-2,673,486,1485,515,20
-4,-1,0,-4.0,-1.0,0.658789873123169,36.010868281309364,67,-46,-1,673,486,1485,515,20
-3,-2,0,-3.0,-2.0,0.6667139530181885,33.01162633521314,67,-43,1,673,486,1485,515,20
-3,-1,0,-3.0,-1.0,0.6746869087219238,30.049968789001575,67,-40,2,673,486,1485,515,20
-4,-1,0,-4.0,-1.0,0.6828088760375977,26.124783736376884,67,-36,3,673,486,1485,515,20
-4,-2,0,-4.0,-2.0,0.6907117366790771,22.38826948140329,67,-32,5,673,486,1485,515,20
-5,-1,0,-5.0,-1.0,0.6988399028778076,17.65863337187866,67,-27,6,673,486,1485,515,20
-4,-1,0,-4.0,-1.0,0.7068898677825928,14.041630560342615,67,-23,7,673,486,1485,515,20
-4,-1,0,-4.0,-1.0,0.7149078845977783,10.615528128088304,67,-19,8,673,486,1485,515,20
-4,-2,0,-4.0,-2.0,0.7228677272796631,8.027756377319946,67,-15,10,673,486,1485,515,20
-4,-1,0,-4.0,-1.0,0.7309398651123047,5.556349186104045,67,-11,11,673,486,1485,515,20
-2,0,0,-2.0,-0.0,0.7389318943023682,4.212670403551895,67,-9,11,673,486,1485,515,20
-2,-1,0,-2.0,-1.0,0.746762752532959,3.892443989449804,67,-7,12,673,486,1485,515,20
-1,0,0,-1.0,-0.0,0.75472092628479,3.416407864998739,67,-6,12,673,486,1485,515,20
-1,0,0,-1.0,-0.0,0.7629208564758301,3.0,67,-5,12,673,486,1485,515,20
-1,0,0,-1.0,-0.0,0.7708737850189209,2.649110640673518,67,-4,12,673,486,1485,515,20
-1,0,0,-1.0,-0.0,0.7787809371948242,2.369316876852981,67,-3,12,673,486,1485,515,20
0,-1,0,-0.0,-1.0,0.7868199348449707,3.341664064126334,67,-3,13,673,486,1485,515,20
-1,0,0,-1.0,-0.0,0.7948267459869385,3.1529464379659053,67,-2,13,673,486,1485,515,20
0,0,1,-0.0,-0.0,0.8167338371276855,3.1529464379659053,67,-2,13,673,486,1485,515,20
0,0,0,-0.0,-0.0,0.07201290130615234,592.2413880357392,68,-444,423,231,896,675,473,43
-1,0,0,-1.0,-0.0,0.23001790046691895,591.5177548447065,68,-443,423,231,896,675,473,43
-3,3,0,-3.0,3.0,0.2380509376525879,587.276253029822,68,-440,420,231,896,675,473,43
-5,7,0,-5.0,7.0,0.24614381790161133,578.8283087684342,68,-435,413,231,896,675,473,43
-6,7,0,-6.0,7.0,0.2540898323059082,569.6581075376855,68,-429,406,231,896,675,473,43
-9,11,0,-9.0,11.0,0.26204800605773926,555.5630928181234,68,-420,395,231,896,675,473,43
-10,11,0,-10.0,11.0,0.27028989791870117,540.7437138055041,68,-410,384,231,896,675,473,43
-11,12,0,-11.0,12.0,0.2779839038848877,524.5135195391587,68,-399,372,231,896,675,473,43
-12,13,0,-12.0,13.0,0.28601598739624023,506.8730908087663,68,-387,359,231,896,675,473,43
-15,15,0,-15.0,15.0,0.2940189838409424,485.67543852055826,68,-372,344,231,896,675,473,43
-15,16,0,-15.0,16.0,0.30194783210754395,463.8020214479308,68,-357,328,231,896,675,473,43
-16,16,0,-16.0,16.0,0.31008100509643555,441.1958459354649,68,-341,312,231,896,675,473,43
-15,16,0,-15.0,16.0,0.318065881729126,419.33169315869145,68,-326,296,231,896,675,473,43
-16,17,0,-16.0,17.0,0.3260619640350342,396.06234545928504,68,-310,279,231,896,675,473,43
-17,19,0,-17.0,19.0,0.33391904830932617,370.72566931463655,68,-293,260,231,896,675,473,43
-18,18,0,-18.0,18.0,0.3421649932861328,345.31816771762766,68,-275,242,231,896,675,473,43
-17,16,0,-17.0,16.0,0.35013604164123535,321.98688021555574,68,-258,226,231,896,675,473,43
-17,16,0,-17.0,16.0,0.3580608367919922,298.65762934740036,68,-241,210,231,896,675,473,43
-14,13,0,-14.0,13.0,0.3660118579864502,279.5628054167714,68,-227,197,231,896,675,473,43
-13,12,0,-13.0,12.0,0.37406492233276367,261.8798331447472,68,-214,185,231,896,675,473,43
-11,12,0,-11.0,12.0,0.38199400901794434,245.71707856828368,68,-203,173,231,896,675,473,43
-10,11,0,-10.0,11.0,0.3900790214538574,230.9781736579579,68,-193,162,231,896,675,473,43
-9,11,0,-9.0,11.0,0.39809083938598633,217.0273093575609,68,-184,151,231,896,675,473,43
-9,10,0,-9.0,10.0,0.40594983100891113,203.73539997072112,68,-175,141,231,896,675,473,43
-7,8,0,-7.0,8.0,0.4140188694000244,193.27319011019554,68,-168,133,231,896,675,473,43
-7,8,0,-7.0,8.0,0.421954870223999,182.82835916525454,68,-161,125,231,896,675,473,43
-4,6,0,-4.0,6.0,0.42992186546325684,176.00253805471644,68,-157,119,231,896,675,473,43
-7,6,0,-7.0,6.0,0.4379608631134033,166.8004259846074,68,-150,113,231,896,675,473,43
-6,6,0,-6.0,6.0,0.4460179805755615,158.4017837146554,68,-144,107,231,896,675,473,43
-6,5,0,-6.0,5.0,0.4541199207305908,150.6041957529011,68,-138,102,231,896,675,473,43
-5,3,0,-5.0,3.0,0.46204686164855957,144.8010856418015,68,-133,99,231,896,675,473,43
-4,4,0,-4.0,4.0,0.47005295753479004,139.20611723651504,68,-129,95,231,896,675,473,43
-5,3,0,-5.0,3.0,0.47806382179260254,133.40207252495026,68,-124,92,231,896,675,473,43
-5,4,0,-5.0,4.0,0.48607397079467773,127.00337833982033,68,-119,88,231,896,675,473,43
-5,4,0,-5.0,4.0,0.4940519332885742,120.60508465447137,68,-114,84,231,896,675,473,43
-6,5,0,-6.0,5.0,0.5020689964294434,112.80956617521784,68,-108,79,231,896,675,473,43
-4,4,0,-4.0,4.0,0.5099270343780518,107.22246293064254,68,-104,75,231,896,675,473,43
-4,3,0,-4.0,3.0,0.5179760456085205,102.2233744059949,68,-100,72,231,896,675,473,43
-3,4,0,-3.0,4.0,0.5260629653930664,97.46096403457132,68,-97,68,231,896,675,473,43
-4,2,0,-4.0,2.0,0.5341148376464844,93.03946685248927,68,-93,66,231,896,675,473,43
-3,4,0,-3.0,4.0,0.5421040058135986,88.288608738514,68,-90,62,231,896,675,473,43
-4,3,0,-4.0,3.0,0.5501079559326172,83.29285689825551,68,-86,59,231,896,675,473,43
-3,3,0,-3.0,3.0,0.557960033416748,79.12492197250393,68,-83,56,231,896,675,473,43
-3,3,0,-3.0,3.0,0.5661048889160156,74.96353474106714,68,-80,53,231,896,675,473,43
-4,4,0,-4.0,4.0,0.5989229679107666,69.4267659490264,68,-76,49,231,896,675,473,43
-5,4,0,-5.0,4.0,0.603740930557251,63.05950273467003,68,-71,45,231,896,675,473,43
-5,4,0,-5.0,4.0,0.6037600040435791,56.69813382572325,68,-66,41,231,896,675,473,43
-5,3,0,-5.0,3.0,0.603773832321167,50.867934435323804,68,-61,38,231,896,675,473,43
-6,5,0,-6.0,5.0,0.6060919761657715,43.1404708432983,68,-55,33,231,896,675,473,43
-7,4,0,-7.0,4.0,0.613955020904541,35.08029957123981,68,-48,29,231,896,675,473,43
-7,5,0,-7.0,5.0,0.622290849685669,26.507894080878813,68,-41,24,231,896,675,473,43
-7,4,0,-7.0,4.0,0.6302099227905273,18.44616584663204,68,-34,20,231,896,675,473,43
-7,5,0,-7.0,5.0,0.638092041015625,9.886890422961002,68,-27,15,231,896,675,473,43
-8,4,0,-8.0,4.0,0.6460518836975098,0.9544984001001495,68,-19,11,231,896,675,473,43
-6,4,0,-6.0,4.0,0.6540670394897461,-6.2351769397666,68,-13,7,231,896,675,473,43
-7,4,0,-7.0,4.0,0.6621370315551758,-14.29179606750063,68,-6,3,231,896,675,473,43
-7,3,0,-7.0,3.0,0.6699948310852051,-20.0,68,1,0,231,896,675,473,43
-6,4,0,-6.0,4.0,0.6779119968414307,-12.93774225170145,68,7,-4,231,896,675,473,43
-5,2,0,-5.0,2.0,0.6860349178314209,-7.583592135001261,68,12,-6,231,896,675,473,43
-4,3,0,-4.0,3.0,0.693997859954834,-2.6424402493141805,68,16,-9,231,896,675,473,43
-3,3,0,-3.0,3.0,0.7029719352722168,1.472205054244231,68,19,-12,231,896,675,473,43
-2,1,0,-2.0,1.0,0.7100849151611328,3.6981780704569367,68,21,-13,231,896,675,473,43
0,1,0,-0.0,1.0,0.718066930770874,4.238858928247925,68,21,-14,231,896,675,473,43
0,0,1,-0.0,-0.0,0.7400050163269043,4.238858928247925,68,21,-14,231,896,675,473,43
-1,0,1,-1.0,-0.0,0.022461891174316406,868.593762553708,69,687,-573,896,337,210,910,53
0,0,0,-0.0,-0.0,0.055496931076049805,868.593762553708,69,687,-573,896,337,210,910,53
1,0,0,1.0,-0.0,0.13437294960021973,867.8260457158317,69,686,-573,896,337,210,910,53
2,0,0,2.0,-0.0,0.14242792129516602,866.2919925674555,69,684,-573,896,337,210,910,53
3,-1,0,3.0,-1.0,0.15050005912780762,863.3508868832369,69,681,-572,896,337,210,910,53
5,-1,0,5.0,-1.0,0.15849089622497559,858.8824780726535,69,676,-571,896,337,210,910,53
7,-3,0,7.0,-3.0,0.16659903526306152,851.6018459415409,69,669,-568,896,337,210,910,53
9,-3,0,9.0,-3.0,0.1745450496673584,842.80665282904,69,660,-565,896,337,210,910,53
14,-5,0,14.0,-5.0,0.18246698379516602,828.9362549336646,69,646,-560,896,337,210,910,53
17,-6,0,17.0,-6.0,0.1905660629272461,812.1867333715084,69,629,-554,896,337,210,910,53
22,-8,0,22.0,-8.0,0.19851398468017578,790.4343206896682,69,607,-546,896,337,210,910,53
24,-10,0,24.0,-10.0,0.20655202865600586,765.9501246922056,69,583,-536,896,337,210,910,53
30,-11,0,30.0,-11.0,0.2143878936767578,736.5181965041884,69,553,-525,896,337,210,910,53
33,-15,0,33.0,-15.0,0.22253990173339844,702.3543093852057,69,520,-510,896,337,210,910,53
33,-18,0,33.0,-18.0,0.23044490814208984,666.2665671545897,69,487,-492,896,337,210,910,53
35,-22,0,35.0,-22.0,0.2384660243988037,626.0766826071915,69,452,-470,896,337,210,910,53
33,-25,0,33.0,-25.0,0.24651789665222168,585.2168191403113,69,419,-445,896,337,210,910,53
36,-26,0,36.0,-26.0,0.2545790672302246,541.6706791793989,69,383,-419,896,337,210,910,53
37,-27,0,37.0,-27.0,0.2623889446258545,496.8575331770596,69,346,-392,896,337,210,910,53
36,-28,0,36.0,-28.0,0.27042698860168457,452.1171404582772,69,310,-364,896,337,210,910,53
30,-23,0,30.0,-23.0,0.2784569263458252,415.22669910149364,69,280,-341,896,337,210,910,53
23,-21,0,23.0,-21.0,0.286823034286499,384.42538907820995,69,257,-320,896,337,210,910,53
15,-17,0,15.0,-17.0,0.2944788932800293,361.7795765638,69,242,-303,896,337,210,910,53
12,-18,0,12.0,-18.0,0.3024449348449707,340.23080154459973,69,230,-285,896,337,210,910,53
10,-18,0,10.0,-18.0,0.3104119300842285,319.9609804587795,69,220,-267,896,337,210,910,53
8,-18,0,8.0,-18.0,0.318572998046875,301.0244639166923,69,212,-249,896,337,210,910,53
5,-16,0,5.0,-16.0,0.32645702362060547,285.66969695496545,69,207,-233,896,337,210,910,53
4,-15,0,4.0,-15.0,0.33459997177124023,271.8808486626826,69,203,-218,896,337,210,910,53
4,-14,0,4.0,-14.0,0.3425478935241699,258.98596456667826,69,199,-204,896,337,210,910,53
3,-11,0,3.0,-11.0,0.35065793991088867,249.0727176584403,69,196,-193,896,337,210,910,53
2,-8,0,2.0,-8.0,0.35846900939941406,242.0690209628856,69,194,-185,896,337,210,910,53
3,-8,0,3.0,-8.0,0.3665030002593994,234.4035330021465,69,191,-177,896,337,210,910,53
3,-7,0,3.0,-7.0,0.3744049072265625,227.46400138875737,69,188,-170,896,337,210,910,53
3,-6,0,3.0,-6.0,0.38254404067993164,221.226616690032,69,185,-164,896,337,210,910,53
3,-8,0,3.0,-8.0,0.39050889015197754,213.70815588961506,69,182,-156,896,337,210,910,53
4,-9,0,4.0,-9.0,0.39852094650268555,204.85276693165278,69,178,-147,896,337,210,910,53
4,-7,0,4.0,-7.0,0.4064960479736328,197.32935319836486,69,174,-140,896,337,210,910,53
4,-7,0,4.0,-7.0,0.41446399688720703,189.84485168750263,69,170,-133,896,337,210,910,53
3,-5,0,3.0,-5.0,0.4223790168762207,184.41150158677164,69,167,-128,896,337,210,910,53
4,-6,0,4.0,-6.0,0.4304029941558838,177.60009823180343,69,163,-122,896,337,210,910,53
3,-5,0,3.0,-5.0,0.43840909004211426,172.2145302443794,69,160,-117,896,337,210,910,53
4,-5,0,4.0,-5.0,0.4463660717010498,166.04166214652486,69,156,-112,896,337,210,910,53
3,-5,0,3.0,-5.0,0.45455193519592285,160.70297265978385,69,153,-107,896,337,210,910,53
4,-4,0,4.0,-4.0,0.46282291412353516,155.13530854032848,69,149,-103,896,337,210,910,53
5,-6,0,5.0,-6.0,0.47055697441101074,147.62315513778685,69,144,-97,896,337,210,910,53
7,-6,0,7.0,-6.0,0.47843289375305176,138.46884203398528,69,137,-91,896,337,210,910,53
6,-5,0,6.0,-5.0,0.4864990711212158,130.70673246545599,69,131,-86,896,337,210,910,53
6,-6,0,6.0,-6.0,0.4944489002227783,122.40822079655831,69,125,-80,896,337,210,910,53
8,-6,0,8.0,-6.0,0.5024628639221191,112.43771162512041,69,117,-74,896,337,210,910,53
8,-6,0,8.0,-6.0,0.5104000568389893,102.47178678604885,69,109,-68,896,337,210,910,53
8,-7,0,8.0,-7.0,0.5184729099273682,91.99152511939153,69,101,-61,896,337,210,910,53
8,-5,0,8.0,-5.0,0.5264530181884766,82.55873986004075,69,93,-56,896,337,210,910,53
7,-5,0,7.0,-5.0,0.5345239639282227,73.98499887483122,69,86,-51,896,337,210,910,53
8,-6,0,8.0,-6.0,0.5425028800964355,64.0499861188218,69,78,-45,896,337,210,910,53
6,-3,0,6.0,-3.0,0.5505099296569824,57.35466393669883,69,72,-42,896,337,210,910,53
6,-5,0,6.0,-5.0,0.5585348606109619,49.663729752107784,69,66,-37,896,337,210,910,53
6,-5,0,6.0,-5.0,0.566431999206543,42.0,69,60,-32,896,337,210,910,53
7,-4,0,7.0,-4.0,0.5743639469146729,33.941638282582836,69,53,-28,896,337,210,910,53
4,-4,0,4.0,-4.0,0.5825080871582031,28.561891462814962,69,49,-24,896,337,210,910,53
4,-4,0,4.0,-4.0,0.5904068946838379,23.244289008980523,69,45,-20,896,337,210,910,53
4,-4,0,4.0,-4.0,0.5985040664672852,18.011362169330773,69,41,-16,896,337,210,910,53
3,-2,0,3.0,-2.0,0.6065859794616699,14.496913462633174,69,38,-14,896,337,210,910,53
2,-3,0,2.0,-3.0,0.614501953125,11.64306044943742,69,36,-11,896,337,210,910,53
3,-4,0,3.0,-4.0,0.622499942779541,7.734255586865999,69,33,-7,896,337,210,910,53
4,-3,0,4.0,-3.0,0.6305830478668213,3.274562336608895,69,29,-4,896,337,210,910,53
5,-4,0,5.0,-4.0,0.6384389400482178,-2.0,69,24,0,896,337,210,910,53
4,-3,0,4.0,-3.0,0.646406888961792,-5.776251583843315,69,20,3,896,337,210,910,53
6,-4,0,6.0,-4.0,0.6544589996337891,-10.347524157501471,69,14,7,896,337,210,910,53
4,-4,0,4.0,-4.0,0.6623799800872803,-11.133931252681494,69,10,11,896,337,210,910,53
4,-3,0,4.0,-3.0,0.6705338954925537,-10.768453788272183,69,6,14,896,337,210,910,53
5,-3,0,5.0,-3.0,0.678555965423584,-8.970613634073597,69,1,17,896,337,210,910,53
4,-3,0,4.0,-3.0,0.6865050792694092,-5.776251583843315,69,-3,20,896,337,210,910,53
5,-2,0,5.0,-2.0,0.6944999694824219,-2.5906001785607486,69,-8,22,896,337,210,910,53
2,-1,0,2.0,-1.0,0.702549934387207,-0.9201275920310934,69,-10,23,896,337,210,910,53
0,0,1,-0.0,-0.0,0.717379093170166,-0.9201275920310934,69,-10,23,896,337,210,910,53
0,0,0,-0.0,-0.0,0.07831645011901855,348.44879167029046,70,270,-258,1176,56,906,314,50
0,3,0,-0.0,3.0,0.1513674259185791,350.5276288104512,70,270,-261,1176,56,906,314,50
-2,5,0,-2.0,5.0,0.15965938568115234,355.44710539048657,70,272,-266,1176,56,906,314,50
-2,5,0,-2.0,5.0,0.16727924346923828,360.3790341988002,70,274,-271,1176,56,906,314,50
-1,5,0,-1.0,5.0,0.17534232139587402,364.61647809095547,70,275,-276,1176,56,906,314,50
0,3,0,-0.0,3.0,0.18341922760009766,366.74736757252117,70,275,-279,1176,56,906,314,50
2,1,0,2.0,1.0,0.19142723083496094,366.0613762569758,70,273,-280,1176,56,906,314,50
2,1,0,2.0,1.0,0.19928431510925293,365.38698748805655,70,271,-281,1176,56,906,314,50
4,0,0,4.0,-0.0,0.20733237266540527,362.62094886628614,70,267,-281,1176,56,906,314,50
6,-1,0,6.0,-1.0,0.21535730361938477,357.78061601915005,70,261,-280,1176,56,906,314,50
8,-3,0,8.0,-3.0,0.2233593463897705,350.150636411562,70,253,-277,1176,56,906,314,50
9,-6,0,9.0,-6.0,0.23129630088806152,339.6601157242179,70,244,-271,1176,56,906,314,50
12,-7,0,12.0,-7.0,0.2392873764038086,326.45412218382074,70,232,-264,1176,56,906,314,50
14,-8,0,14.0,-8.0,0.24730944633483887,311.24395905354197,70,218,-256,1176,56,906,314,50
15,-10,0,15.0,-10.0,0.25533127784729004,293.9435686763412,70,203,-246,1176,56,906,314,50
15,-10,0,15.0,-10.0,0.2633833885192871,276.72835465033774,70,188,-236,1176,56,906,314,50
12,-10,0,12.0,-10.0,0.2714114189147949,261.44720281406137,70,176,-226,1176,56,906,314,50
11,-12,0,11.0,-12.0,0.2794034481048584,245.22398117117586,70,165,-214,1176,56,906,314,50
11,-11,0,11.0,-11.0,0.28731632232666016,229.80384612481814,70,154,-203,1176,56,906,314,50
9,-12,0,9.0,-12.0,0.2954103946685791,214.80408670412604,70,145,-191,1176,56,906,314,50
9,-11,0,9.0,-11.0,0.3032963275909424,200.6014184352572,70,136,-180,1176,56,906,314,50
8,-12,0,8.0,-12.0,0.31133532524108887,186.20606051910536,70,128,-168,1176,56,906,314,50
7,-9,0,7.0,-9.0,0.3193023204803467,174.80490484470096,70,121,-159,1176,56,906,314,50
7,-12,0,7.0,-12.0,0.32732129096984863,161.02419197512995,70,114,-147,1176,56,906,314,50
8,-12,0,8.0,-12.0,0.3353993892669678,146.64206943520577,70,106,-135,1176,56,906,314,50
7,-12,0,7.0,-12.0,0.34334540367126465,132.8923684032892,70,99,-123,1176,56,906,314,50
7,-10,0,7.0,-10.0,0.35143041610717773,120.71547618561317,70,92,-113,1176,56,906,314,50
8,-12,0,8.0,-12.0,0.35933828353881836,106.36590120727678,70,84,-101,1176,56,906,314,50
9,-10,0,9.0,-10.0,0.36737537384033203,92.92370414806346,70,75,-91,1176,56,906,314,50
8,-9,0,8.0,-9.0,0.3753323554992676,80.89145385724005,70,67,-82,1176,56,906,314,50
7,-9,0,7.0,-9.0,0.3833003044128418,69.49338601193207,70,60,-73,1176,56,906,314,50
7,-8,0,7.0,-8.0,0.3913004398345947,58.86894538504703,70,53,-65,1176,56,906,314,50
7,-8,0,7.0,-8.0,0.39932823181152344,48.246160308919954,70,46,-57,1176,56,906,314,50
5,-7,0,5.0,-7.0,0.4073293209075928,39.66065264130884,70,41,-50,1176,56,906,314,50
6,-6,0,6.0,-6.0,0.4153633117675781,31.222771187482387,70,35,-44,1176,56,906,314,50
5,-5,0,5.0,-5.0,0.42334532737731934,24.203658400570177,70,30,-39,1176,56,906,314,50
6,-5,0,6.0,-5.0,0.43149328231811523,16.617304093369626,70,24,-34,1176,56,906,314,50
5,-5,0,5.0,-5.0,0.4393744468688965,9.669871646719429,70,19,-29,1176,56,906,314,50
5,-4,0,5.0,-4.0,0.4473602771759033,3.653097563788805,70,14,-25,1176,56,906,314,50
4,-2,0,4.0,-2.0,0.4553713798522949,0.0798724079689066,70,10,-23,1176,56,906,314,50
4,-3,0,4.0,-3.0,0.4635944366455078,-4.119386982178899,70,6,-20,1176,56,906,314,50
2,-2,0,2.0,-2.0,0.47140932083129883,-6.560911085414226,70,4,-18,1176,56,906,314,50
3,-1,0,3.0,-1.0,0.47946929931640625,-7.970613634073597,70,1,-17,1176,56,906,314,50
0,-1,0,-0.0,-1.0,0.4874284267425537,-8.968780458118601,70,1,-16,1176,56,906,314,50
0,0,1,-0.0,-0.0,0.5263903141021729,-8.968780458118601,70,1,-16,1176,56,906,314,50
0,0,0,-0.0,-0.0,0.06169295310974121,1090.0126011886634,71,445,1018,1620,1090,1175,72,43
-1,3,0,-1.0,3.0,0.12466883659362793,1087.6663158949134,71,446,1015,1620,1090,1175,72,43
-3,4,0,-3.0,4.0,0.1327049732208252,1085.2196888502754,71,449,1011,1620,1090,1175,72,43
-5,6,0,-5.0,6.0,0.14079999923706055,1081.787830908557,71,454,1005,1620,1090,1175,72,43
-5,7,0,-5.0,7.0,0.1488800048828125,1077.4921483561,71,459,998,1620,1090,1175,72,43
-6,7,0,-6.0,7.0,0.15673279762268066,1073.6716402647874,71,465,991,1620,1090,1175,72,43
-8,9,0,-8.0,9.0,0.16484594345092773,1068.978440153749,71,473,982,1620,1090,1175,72,43
-9,9,0,-9.0,9.0,0.1727309226989746,1064.8420695478694,71,482,973,1620,1090,1175,72,43
-10,9,0,-10.0,9.0,0.18086886405944824,1061.2938602800998,71,492,964,1620,1090,1175,72,43
-10,10,0,-10.0,10.0,0.1888718605041504,1057.0166974588103,71,502,954,1620,1090,1175,72,43
-8,9,0,-8.0,9.0,0.19669079780578613,1052.8365797457266,71,510,945,1620,1090,1175,72,43
-6,9,0,-6.0,9.0,0.20488691329956055,1047.808682599463,71,516,936,1620,1090,1175,72,43
-3,9,0,-3.0,9.0,0.2127389907836914,1041.398230420213,71,519,927,1620,1090,1175,72,43
-2,9,0,-2.0,9.0,0.22064590454101562,1034.5401460863532,71,521,918,1620,1090,1175,72,43
0,9,0,-0.0,9.0,0.2287747859954834,1026.7222914494089,71,521,909,1620,1090,1175,72,43
2,10,0,2.0,10.0,0.2367708683013916,1017.0568385208971,71,519,899,1620,1090,1175,72,43
3,9,0,3.0,9.0,0.24480295181274414,1007.7643073124184,71,516,890,1620,1090,1175,72,43
6,10,0,6.0,10.0,0.2528269290924072,996.1037311896953,71,510,880,1620,1090,1175,72,43
11,12,0,11.0,12.0,0.26079392433166504,980.2117658118086,71,499,868,1620,1090,1175,72,43
12,15,0,12.0,15.0,0.26882100105285645,961.2311336951196,71,487,853,1620,1090,1175,72,43
13,18,0,13.0,18.0,0.27669191360473633,939.1567580348534,71,474,835,1620,1090,1175,72,43
16,21,0,16.0,21.0,0.2847719192504883,913.0021413251685,71,458,814,1620,1090,1175,72,43
16,24,0,16.0,24.0,0.2926199436187744,884.2425089444265,71,442,790,1620,1090,1175,72,43
17,26,0,17.0,26.0,0.3008718490600586,853.25453959359,71,425,764,1620,1090,1175,72,43
16,29,0,16.0,29.0,0.3087759017944336,820.1337586852641,71,409,735,1620,1090,1175,72,43
15,28,0,15.0,28.0,0.31679296493530273,788.3732142837443,71,394,707,1620,1090,1175,72,43
16,31,0,16.0,31.0,0.3248178958892822,753.5062943578961,71,378,676,1620,1090,1175,72,43
16,29,0,16.0,29.0,0.33279991149902344,720.3858644457689,71,362,647,1620,1090,1175,72,43
15,32,0,15.0,32.0,0.34073686599731445,685.1402127056638,71,347,615,1620,1090,1175,72,43
14,32,0,14.0,32.0,0.34882497787475586,650.400029788501,71,333,583,1620,1090,1175,72,43
15,33,0,15.0,33.0,0.3568089008331299,614.314095546447,71,318,550,1620,1090,1175,72,43
13,34,0,13.0,34.0,0.36482882499694824,578.4005338669627,71,305,516,1620,1090,1175,72,43
13,35,0,13.0,35.0,0.37274694442749023,541.6944108483751,71,292,481,1620,1090,1175,72,43
14,35,0,14.0,35.0,0.380936861038208,504.5473337388365,71,278,446,1620,1090,1175,72,43
12,30,0,12.0,30.0,0.38876986503601074,472.7732273017645,71,266,416,1620,1090,1175,72,43
13,25,0,13.0,25.0,0.3968079090118408,444.7145048202815,71,253,391,1620,1090,1175,72,43
13,21,0,13.0,21.0,0.40479588508605957,420.02154142399894,71,240,370,1620,1090,1175,72,43
14,19,0,14.0,19.0,0.4127500057220459,396.46496859018004,71,226,351,1620,1090,1175,72,43
13,16,0,13.0,16.0,0.42076897621154785,375.9811078628302,71,213,335,1620,1090,1175,72,43
14,15,0,14.0,15.0,0.42877984046936035,355.8302004882305,71,199,320,1620,1090,1175,72,43
13,14,0,13.0,14.0,0.43669795989990234,337.0949594730426,71,186,306,1620,1090,1175,72,43
14,14,0,14.0,14.0,0.4448099136352539,317.89231327960215,71,172,292,1620,1090,1175,72,43
13,13,0,13.0,13.0,0.4527599811553955,300.1261434389919,71,159,279,1620,1090,1175,72,43
11,12,0,11.0,12.0,0.46077394485473633,284.2752856030111,71,148,267,1620,1090,1175,72,43
9,11,0,9.0,11.0,0.4687938690185547,270.30224853234483,71,139,256,1620,1090,1175,72,43
7,10,0,7.0,10.0,0.4767589569091797,258.1773629791642,71,132,246,1620,1090,1175,72,43
6,8,0,6.0,8.0,0.48478198051452637,248.29537686339881,71,126,238,1620,1090,1175,72,43
4,9,0,4.0,9.0,0.49274301528930664,238.47061490658245,71,122,229,1620,1090,1175,72,43
4,9,0,4.0,9.0,0.5007989406585693,228.64775184247102,71,118,220,1620,1090,1175,72,43
5,10,0,5.0,10.0,0.5086648464202881,217.47222060441337,71,113,210,1620,1090,1175,72,43
5,10,0,5.0,10.0,0.516887903213501,206.29716232280595,71,108,200,1620,1090,1175,72,43
7,9,0,7.0,9.0,0.5247728824615479,195.06017680266763,71,101,191,1620,1090,1175,72,43
6,9,0,6.0,9.0,0.5328168869018555,184.30221625691235,71,95,182,1620,1090,1175,72,43
7,9,0,7.0,9.0,0.5407319068908691,173.09533739891847,71,88,173,1620,1090,1175,72,43
6,8,0,6.0,8.0,0.5487978458404541,163.25254408012933,71,82,165,1620,1090,1175,72,43
6,8,0,6.0,8.0,0.5566859245300293,153.42763542512407,71,76,157,1620,1090,1175,72,43
6,8,0,6.0,8.0,0.5647499561309814,143.62381358722072,71,70,149,1620,1090,1175,72,43
5,7,0,5.0,7.0,0.5727758407592773,135.16977940690063,71,65,142,1620,1090,1175,72,43
4,7,0,4.0,7.0,0.580676794052124,127.14182393908885,71,61,135,1620,1090,1175,72,43
4,8,0,4.0,8.0,0.5887978076934814,118.20488497175666,71,57,127,1620,1090,1175,72,43
4,7,0,4.0,7.0,0.5971817970275879,110.18307817702708,71,53,120,1620,1090,1175,72,43
5,8,0,5.0,8.0,0.6048188209533691,100.85236969382254,71,48,112,1620,1090,1175,72,43
6,7,0,6.0,7.0,0.6128318309783936,92.08846094982458,71,42,105,1620,1090,1175,72,43
6,6,0,6.0,6.0,0.6207358837127686,84.34229919647663,71,36,99,1620,1090,1175,72,43
5,6,0,5.0,6.0,0.628713846206665,77.03060746521976,71,31,93,1620,1090,1175,72,43
3,4,0,3.0,4.0,0.636772871017456,72.30058949438637,71,28,89,1620,1090,1175,72,43
2,3,0,2.0,3.0,0.644773006439209,68.8443097808648,71,26,86,1620,1090,1175,72,43
2,3,0,2.0,3.0,0.6527099609375,65.40023148117139,71,24,83,1620,1090,1175,72,43
1,2,0,1.0,2.0,0.6609377861022949,63.20213774008353,71,23,81,1620,1090,1175,72,43
2,5,0,2.0,5.0,0.6688649654388428,57.84795495128583,71,21,76,1620,1090,1175,72,43
3,5,0,3.0,5.0,0.6767919063568115,52.246160308919954,71,18,71,1620,1090,1175,72,43
3,5,0,3.0,5.0,0.6848199367523193,46.683085036070864,71,15,66,1620,1090,1175,72,43
3,5,0,3.0,5.0,0.6928019523620605,41.16912416947821,71,12,61,1620,1090,1175,72,43
2,4,0,2.0,4.0,0.7007617950439453,36.87054518492115,71,10,57,1620,1090,1175,72,43
2,4,0,2.0,4.0,0.7087810039520264,32.600373133029585,71,8,53,1620,1090,1175,72,43
2,3,0,2.0,3.0,0.716796875,29.358713248056688,71,6,50,1620,1090,1175,72,43
1,5,0,1.0,5.0,0.7247748374938965,24.276925690687087,71,5,45,1620,1090,1175,72,43
2,5,0,2.0,5.0,0.7327878475189209,19.11234224026316,71,3,40,1620,1090,1175,72,43
2,5,0,2.0,5.0,0.7407758235931396,14.014282800023196,71,1,35,1620,1090,1175,72,43
2,5,0,2.0,5.0,0.7487938404083252,9.016662039607269,71,-1,30,1620,1090,1175,72,43
3,4,0,3.0,4.0,0.756868839263916,5.305892875931811,71,-4,26,1620,1090,1175,72,43
1,4,0,1.0,4.0,0.7647848129272461,1.5610283453569558,71,-5,22,1620,1090,1175,72,43
2,2,0,2.0,2.0,0.7727508544921875,0.1896201004170912,71,-7,20,1620,1090,1175,72,43
2,3,0,2.0,3.0,0.7808468341827393,-1.7646159383286566,71,-9,17,1620,1090,1175,72,43
1,2,0,1.0,2.0,0.7886738777160645,-2.972243622680054,71,-10,15,1620,1090,1175,72,43
1,2,0,1.0,2.0,0.7967469692230225,-3.9706136340735974,71,-11,13,1620,1090,1175,72,43
1,2,0,1.0,2.0,0.8048758506774902,-4.721179403900294,71,-12,11,1620,1090,1175,72,43
0,0,1,-0.0,-0.0,0.8467049598693848,-4.721179403900294,71,-12,11,1620,1090,1175,72,43
0,1,1,-0.0,1.0,0.014118671417236328,230.93410011086166,72,133,-221,1765,859,1632,1079,55
0,0,0,-0.0,-0.0,0.08304977416992188,230.93410011086166,72,133,-221,1765,859,1632,1079,55
-1,0,0,-1.0,-0.0,0.10210490226745605,231.45115592699523,72,134,-221,1765,859,1632,1079,55
-1,0,0,-1.0,-0.0,0.11005568504333496,231.97104085206132,72,135,-221,1765,859,1632,1079,55
-1,0,0,-1.0,-0.0,0.11803984642028809,232.49373788205372,72,136,-221,1765,859,1632,1079,55
-1,0,0,-1.0,-0.0,0.1266007423400879,233.0192300580863,72,137,-221,1765,859,1632,1079,55
-2,1,0,-2.0,1.0,0.14234590530395508,234.92556194461054,72,139,-222,1765,859,1632,1079,55
-1,0,0,-1.0,-0.0,0.15012669563293457,235.45761562583778,72,140,-222,1765,859,1632,1079,55
-2,0,0,-2.0,-0.0,0.15801787376403809,236.52988445335757,72,142,-222,1765,859,1632,1079,55
-1,0,0,-1.0,-0.0,0.16608977317810059,237.07006645964248,72,143,-222,1765,859,1632,1079,55
-2,0,0,-2.0,-0.0,0.17405080795288086,238.15844319953305,72,145,-222,1765,859,1632,1079,55
-2,-1,0,-2.0,-1.0,0.1820976734161377,238.42418879973997,72,147,-221,1765,859,1632,1079,55
-2,-3,0,-2.0,-3.0,0.19011187553405762,237.0549185302179,72,149,-218,1765,859,1632,1079,55
-3,-8,0,-3.0,-8.0,0.19806480407714844,232.2373429890069,72,152,-210,1765,859,1632,1079,55
-3,-14,0,-3.0,-14.0,0.20601272583007812,222.88197213884797,72,155,-196,1765,859,1632,1079,55
-3,-18,0,-3.0,-18.0,0.21407771110534668,211.00840321299583,72,158,-178,1765,859,1632,1079,55
0,-22,0,-0.0,-22.0,0.22203969955444336,195.03603311174518,72,158,-156,1765,859,1632,1079,55
0,-25,0,-0.0,-25.0,0.2301788330078125,178.24375751773792,72,158,-131,1765,859,1632,1079,55
2,-24,0,2.0,-24.0,0.23801374435424805,162.16923639957952,72,156,-107,1765,859,1632,1079,55
4,-22,0,4.0,-22.0,0.24611783027648926,147.15223225672418,72,152,-85,1765,859,1632,1079,55
6,-16,0,6.0,-16.0,0.25406575202941895,134.48374531202822,72,146,-69,1765,859,1632,1079,55
6,-13,0,6.0,-13.0,0.2622568607330322,123.78461459976612,72,140,-56,1765,859,1632,1079,55
6,-9,0,6.0,-9.0,0.27002573013305664,115.00352108310554,72,134,-47,1765,859,1632,1079,55
6,-7,0,6.0,-7.0,0.2779388427734375,107.10443691392169,72,128,-40,1765,859,1632,1079,55
7,-6,0,7.0,-6.0,0.2860298156738281,98.686116973992,72,121,-34,1765,859,1632,1079,55
5,-4,0,5.0,-4.0,0.29408884048461914,92.81652640600127,72,116,-30,1765,859,1632,1079,55
5,-3,0,5.0,-3.0,0.3020658493041992,87.23659658795863,72,111,-27,1765,859,1632,1079,55
5,-2,0,5.0,-2.0,0.3101177215576172,81.90821823902914,72,106,-25,1765,859,1632,1079,55
4,-1,0,4.0,-1.0,0.3181898593902588,77.78549517943789,72,102,-24,1765,859,1632,1079,55
4,-2,0,4.0,-2.0,0.3260838985443115,73.43903623591775,72,98,-22,1765,859,1632,1079,55
4,-1,0,4.0,-1.0,0.3341808319091797,69.317184344228,72,94,-21,1765,859,1632,1079,55
5,-2,0,5.0,-2.0,0.3420748710632324,64.00549433962765,72,89,-19,1765,859,1632,1079,55
4,-1,0,4.0,-1.0,0.3501417636871338,59.884981440983225,72,85,-18,1765,859,1632,1079,55
5,-1,0,5.0,-1.0,0.35805273056030273,54.78630692236935,72,80,-17,1765,859,1632,1079,55
5,-1,0,5.0,-1.0,0.3660447597503662,49.687678280151374,72,75,-16,1765,859,1632,1079,55
5,0,0,5.0,-0.0,0.3741598129272461,44.80529228406496,72,70,-16,1765,859,1632,1079,55
7,0,0,7.0,-0.0,0.3821568489074707,38.0,72,63,-16,1765,859,1632,1079,55
5,0,0,5.0,-0.0,0.3900718688964844,33.166435825965294,72,58,-16,1765,859,1632,1079,55
4,0,0,4.0,-0.0,0.39804673194885254,29.320511361314892,72,54,-16,1765,859,1632,1079,55
5,0,0,5.0,-0.0,0.4060697555541992,24.54609587543949,72,49,-16,1765,859,1632,1079,55
5,-1,0,5.0,-1.0,0.41405367851257324,19.486557196677836,72,44,-15,1765,859,1632,1079,55
5,0,0,5.0,-0.0,0.42193174362182617,14.785164831552358,72,39,-15,1765,859,1632,1079,55
5,-1,0,5.0,-1.0,0.42995572090148926,9.76955262170047,72,34,-14,1765,859,1632,1079,55
4,-2,0,4.0,-2.0,0.4379386901855469,5.310988842807021,72,30,-12,1765,859,1632,1079,55
4,-1,0,4.0,-1.0,0.4460468292236328,1.2311884269862077,72,26,-11,1765,859,1632,1079,55
3,-1,0,3.0,-1.0,0.4541137218475342,-1.9201275920310934,72,23,-10,1765,859,1632,1079,55
1,-1,0,1.0,-1.0,0.4700586795806885,-3.2302713519905737,72,22,-9,1765,859,1632,1079,55
0,0,1,-0.0,-0.0,0.5172526836395264,-3.2302713519905737,72,22,-9,1765,859,1632,1079,55
0,0,0,-0.0,-0.0,0.06114983558654785,1452.0604083108656,73,-1461,109,282,977,1743,868,26
-1,0,0,-1.0,-0.0,0.06736874580383301,1451.0631816967464,73,-1460,109,282,977,1743,868,26
-2,0,0,-2.0,-0.0,0.0753028392791748,1449.068739834075,73,-1458,109,282,977,1743,868,26
-3,0,0,-3.0,-0.0,0.0832977294921875,1446.077105570504,73,-1455,109,282,977,1743,868,26
-3,0,0,-3.0,-0.0,0.09125375747680664,1443.0855057310337,73,-1452,109,282,977,1743,868,26
-3,1,0,-3.0,1.0,0.09917879104614258,1440.0192703470934,73,-1449,108,282,977,1743,868,26
-5,0,0,-5.0,-0.0,0.10725784301757812,1435.033148791836,73,-1444,108,282,977,1743,868,26
-5,0,0,-5.0,-0.0,0.11520576477050781,1430.0471232776842,73,-1439,108,282,977,1743,868,26
-6,0,0,-6.0,-0.0,0.1231527328491211,1424.0640208424954,73,-1433,108,282,977,1743,868,26
-7,-1,0,-7.0,-1.0,0.13135266304016113,1417.1597812831963,73,-1426,109,282,977,1743,868,26
-9,-1,0,-9.0,-1.0,0.13927578926086426,1408.2631705634253,73,-1417,110,282,977,1743,868,26
-11,-2,0,-11.0,-2.0,0.147263765335083,1397.4538276739158,73,-1406,112,282,977,1743,868,26
-13,-3,0,-13.0,-3.0,0.15528273582458496,1384.7388883478916,73,-1393,115,282,977,1743,868,26
-16,-3,0,-16.0,-3.0,0.16341376304626465,1369.0466707025491,73,-1377,118,282,977,1743,868,26
-21,-4,0,-21.0,-4.0,0.17124676704406738,1348.4771389927926,73,-1356,122,282,977,1743,868,26
-26,-4,0,-26.0,-4.0,0.1792747974395752,1322.955089065497,73,-1330,126,282,977,1743,868,26
-30,-5,0,-30.0,-5.0,0.1872546672821045,1293.5837133532623,73,-1300,131,282,977,1743,868,26
-30,-4,0,-30.0,-4.0,0.19522476196289062,1264.1550414886988,73,-1270,135,282,977,1743,868,26
-30,-3,0,-30.0,-3.0,0.2031717300415039,1234.655401142479,73,-1240,138,282,977,1743,868,26
-29,-4,0,-29.0,-4.0,0.21129274368286133,1206.2969285617019,73,-1211,142,282,977,1743,868,26
-30,-5,0,-30.0,-5.0,0.21923470497131348,1177.113439971165,73,-1181,147,282,977,1743,868,26
-30,-4,0,-30.0,-4.0,0.2272047996520996,1147.8626103032175,73,-1151,151,282,977,1743,868,26
-30,-5,0,-30.0,-5.0,0.2353496551513672,1118.8025446163301,73,-1121,156,282,977,1743,868,26
-32,-3,0,-32.0,-3.0,0.24316883087158203,1087.5462280158886,73,-1089,159,282,977,1743,868,26
-34,-3,0,-34.0,-3.0,0.25117969512939453,1054.3654481947597,73,-1055,162,282,977,1743,868,26
-35,-3,0,-35.0,-3.0,0.2592496871948242,1020.2594059576713,73,-1020,165,282,977,1743,868,26
-36,-3,0,-36.0,-3.0,0.26723265647888184,985.2384484681003,73,-984,168,282,977,1743,868,26
-38,-2,0,-38.0,-2.0,0.27533864974975586,948.153473697099,73,-946,170,282,977,1743,868,26
-40,-1,0,-40.0,-1.0,0.2833137512207031,908.9962038967406,73,-906,171,282,977,1743,868,26
-44,0,0,-44.0,-0.0,0.29131174087524414,865.7974738243164,73,-862,171,282,977,1743,868,26
-43,0,0,-43.0,-0.0,0.2993016242980957,823.6612217618311,73,-819,171,282,977,1743,868,26
-43,3,0,-43.0,3.0,0.3073916435241699,780.9773296511684,73,-776,168,282,977,1743,868,26
-41,5,0,-41.0,5.0,0.3151388168334961,739.8572241799902,73,-735,163,282,977,1743,868,26
-41,7,0,-41.0,7.0,0.3233046531677246,698.3170882243727,73,-694,156,282,977,1743,868,26
-40,7,0,-40.0,7.0,0.33118581771850586,657.7585258496533,73,-654,149,282,977,1743,868,26
-39,8,0,-39.0,8.0,0.3391847610473633,617.9564168783768,73,-615,141,282,977,1743,868,26
-38,8,0,-38.0,8.0,0.3472888469696045,579.1300532822161,73,-577,133,282,977,1743,868,26
-35,8,0,-35.0,8.0,0.35527777671813965,543.2274714539008,73,-542,125,282,977,1743,868,26
-33,8,0,-33.0,8.0,0.3632688522338867,509.2738745141288,73,-509,117,282,977,1743,868,26
-31,7,0,-31.0,7.0,0.3712747097015381,477.493628908674,73,-478,110,282,977,1743,868,26
-32,8,0,-32.0,8.0,0.3793816566467285,444.5150270756142,73,-446,102,282,977,1743,868,26
-30,8,0,-30.0,8.0,0.38729381561279297,413.487983418056,73,-416,94,282,977,1743,868,26
-30,8,0,-30.0,8.0,0.3952617645263672,382.4642841016114,73,-386,86,282,977,1743,868,26
-28,8,0,-28.0,8.0,0.403289794921875,353.3986899539899,73,-358,78,282,977,1743,868,26
-28,9,0,-28.0,9.0,0.4112076759338379,324.13647088382476,73,-330,69,282,977,1743,868,26
-25,8,0,-25.0,8.0,0.4192776679992676,298.0401903291599,73,-305,61,282,977,1743,868,26
-22,6,0,-22.0,6.0,0.4273037910461426,275.294987816299,73,-283,55,282,977,1743,868,26
-19,6,0,-19.0,6.0,0.4353008270263672,255.50884529191956,73,-264,49,282,977,1743,868,26
-16,6,0,-16.0,6.0,0.4432666301727295,238.70021851400924,73,-248,43,282,977,1743,868,26
-17,6,0,-17.0,6.0,0.45150184631347656,220.94443784796422,73,-231,37,282,977,1743,868,26
-15,5,0,-15.0,5.0,0.4591526985168457,205.3575050232989,73,-216,32,282,977,1743,868,26
-12,5,0,-12.0,5.0,0.4673027992248535,192.7790076757102,73,-204,27,282,977,1743,868,26
-12,5,0,-12.0,5.0,0.47538065910339355,180.25630649476875,73,-192,22,282,977,1743,868,26
-10,4,0,-10.0,4.0,0.48335981369018555,169.8879438344693,73,-182,18,282,977,1743,868,26
-10,3,0,-10.0,3.0,0.4912986755371094,159.6528308484978,73,-172,15,282,977,1743,868,26
-9,4,0,-9.0,4.0,0.49929285049438477,150.37074401495514,73,-163,11,282,977,1743,868,26
-8,3,0,-8.0,3.0,0.5072758197784424,142.2063143045411,73,-155,8,282,977,1743,868,26
-10,2,0,-10.0,2.0,0.5153186321258545,132.1240848377691,73,-145,6,282,977,1743,868,26
-9,2,0,-9.0,2.0,0.5233767032623291,123.0588108135596,73,-136,4,282,977,1743,868,26
-11,3,0,-11.0,3.0,0.5311357975006104,112.00399993600205,73,-125,1,282,977,1743,868,26
-10,2,0,-10.0,2.0,0.5391297340393066,102.00434774390054,73,-115,-1,282,977,1743,868,26
-9,2,0,-9.0,2.0,0.5471746921539307,93.04244433244644,73,-106,-3,282,977,1743,868,26
-8,1,0,-8.0,1.0,0.5554027557373047,85.08159868191383,73,-98,-4,282,977,1743,868,26
-8,0,0,-8.0,-0.0,0.5632658004760742,77.08884503644167,73,-90,-4,282,977,1743,868,26
-7,1,0,-7.0,1.0,0.5713827610015869,70.15046602394962,73,-83,-5,282,977,1743,868,26
-9,1,0,-9.0,1.0,0.5792708396911621,61.24284477308234,73,-74,-6,282,977,1743,868,26
-9,1,0,-9.0,1.0,0.587324857711792,52.37583651472461,73,-65,-7,282,977,1743,868,26
-9,1,0,-9.0,1.0,0.5952727794647217,43.568542494923804,73,-56,-8,282,977,1743,868,26
-9,1,0,-9.0,1.0,0.6032037734985352,34.853944456021594,73,-47,-9,282,977,1743,868,26
-9,0,0,-9.0,-0.0,0.6112346649169922,26.05124837953327,73,-38,-9,282,977,1743,868,26
-8,1,0,-8.0,1.0,0.6191606521606445,18.622776601683793,73,-30,-10,282,977,1743,868,26
-8,1,0,-8.0,1.0,0.6273138523101807,11.596747752497688,73,-22,-11,282,977,1743,868,26
-6,1,0,-6.0,1.0,0.6352596282958984,7.0,73,-16,-12,282,977,1743,868,26
-6,1,0,-6.0,1.0,0.6433956623077393,3.401219466856727,73,-10,-13,282,977,1743,868,26
-4,1,0,-4.0,1.0,0.6511366367340088,2.2315462117278173,73,-6,-14,282,977,1743,868,26
-3,0,0,-3.0,-0.0,0.6592037677764893,1.3178210632763534,73,-3,-14,282,977,1743,868,26
-3,0,0,-3.0,-0.0,0.667273759841919,1.0,73,0,-14,282,977,1743,868,26
-3,0,0,-3.0,-0.0,0.675257682800293,1.3178210632763534,73,3,-14,282,977,1743,868,26
-2,0,0,-2.0,-0.0,0.6831648349761963,1.866068747318506,73,5,-14,282,977,1743,868,26
-2,0,0,-2.0,-0.0,0.6912996768951416,2.6524758424985286,73,7,-14,282,977,1743,868,26
-2,0,0,-2.0,-0.0,0.6992948055267334,3.6433169770932388,73,9,-14,282,977,1743,868,26
-1,0,0,-1.0,-0.0,0.7073006629943848,4.204650534085253,73,10,-14,282,977,1743,868,26
-1,0,0,-1.0,-0.0,0.7232837677001953,4.804493814764857,73,11,-14,282,977,1743,868,26
0,0,1,-0.0,-0.0,0.7792568206787109,4.804493814764857,73,11,-14,282,977,1743,868,26
0,0,0,-0.0,-0.0,0.07628726959228516,920.2762756167282,74,647,-696,918,295,271,991,61
2,0,0,2.0,-0.0,0.09839034080505371,918.9156969931523,74,645,-696,918,295,271,991,61
3,-1,0,3.0,-1.0,0.10642623901367188,916.1442807521482,74,642,-695,918,295,271,991,61
6,-3,0,6.0,-3.0,0.11422324180603027,909.872331755755,74,636,-692,918,295,271,991,61
7,-2,0,7.0,-2.0,0.12234020233154297,903.6707128318849,74,629,-690,918,295,271,991,61
8,-3,0,8.0,-3.0,0.13029241561889648,896.0723513851389,74,621,-687,918,295,271,991,61
9,-3,0,9.0,-3.0,0.13836932182312012,887.8235124467012,74,612,-684,918,295,271,991,61
10,-4,0,10.0,-4.0,0.14639019966125488,878.1872053712274,74,602,-680,918,295,271,991,61
11,-4,0,11.0,-4.0,0.15436530113220215,867.9181477172627,74,591,-676,918,295,271,991,61
15,-5,0,15.0,-5.0,0.16237926483154297,854.3172507646789,74,576,-671,918,295,271,991,61
17,-5,0,17.0,-5.0,0.17040324211120605,839.5038815324518,74,559,-666,918,295,271,991,61
18,-6,0,18.0,-6.0,0.17821431159973145,823.393812960933,74,541,-660,918,295,271,991,61
19,-9,0,19.0,-9.0,0.1862783432006836,804.436935903487,74,522,-651,918,295,271,991,61
18,-9,0,18.0,-9.0,0.1943342685699463,786.1985052669479,74,504,-642,918,295,271,991,61
18,-11,0,18.0,-11.0,0.20233535766601562,766.4653162567721,74,486,-631,918,295,271,991,61
16,-13,0,16.0,-13.0,0.21048426628112793,746.4174135089964,74,470,-618,918,295,271,991,61
14,-14,0,14.0,-14.0,0.21840834617614746,726.803805487261,74,456,-604,918,295,271,991,61
13,-16,0,13.0,-16.0,0.22636628150939941,706.2017386559203,74,443,-588,918,295,271,991,61
11,-20,0,11.0,-20.0,0.23444342613220215,683.616143315158,74,432,-568,918,295,271,991,61
10,-22,0,10.0,-22.0,0.24241137504577637,660.0724599634447,74,422,-546,918,295,271,991,61
12,-27,0,12.0,-27.0,0.250211238861084,631.4083458802133,74,410,-519,918,295,271,991,61
11,-28,0,11.0,-28.0,0.25823140144348145,602.6784333292861,74,399,-491,918,295,271,991,61
8,-21,0,8.0,-21.0,0.2662353515625,581.3763161915908,74,391,-470,918,295,271,991,61
7,-19,0,7.0,-19.0,0.27444028854370117,562.3318326748952,74,384,-451,918,295,271,991,61
8,-19,0,8.0,-19.0,0.28226733207702637,542.7128425310541,74,376,-432,918,295,271,991,61
7,-20,0,7.0,-20.0,0.2903633117675781,523.0867924657033,74,369,-412,918,295,271,991,61
8,-23,0,8.0,-23.0,0.29840636253356934,500.69953834538046,74,361,-389,918,295,271,991,61
10,-25,0,10.0,-25.0,0.30638623237609863,475.6649088081948,74,351,-364,918,295,271,991,61
11,-24,0,11.0,-24.0,0.3144223690032959,450.83261120685233,74,340,-340,918,295,271,991,61
13,-27,0,13.0,-27.0,0.32244420051574707,422.6566027354511,74,327,-313,918,295,271,991,61
13,-26,0,13.0,-26.0,0.3303031921386719,395.39981194166035,74,314,-287,918,295,271,991,61
12,-22,0,12.0,-22.0,0.3383944034576416,371.78227935039644,74,302,-265,918,295,271,991,61
13,-19,0,13.0,-19.0,0.346447229385376,349.52206786957726,74,289,-246,918,295,271,991,61
12,-19,0,12.0,-19.0,0.35440921783447266,328.1312608527773,74,277,-227,918,295,271,991,61
13,-21,0,13.0,-21.0,0.3623373508453369,304.8611652610676,74,264,-206,918,295,271,991,61
13,-20,0,13.0,-20.0,0.37041425704956055,282.40518561637225,74,251,-186,918,295,271,991,61
15,-22,0,15.0,-22.0,0.3783602714538574,257.3882391469769,74,236,-164,918,295,271,991,61
13,-20,0,13.0,-20.0,0.38637638092041016,235.45244395183101,74,223,-144,918,295,271,991,61
12,-16,0,12.0,-16.0,0.39437437057495117,216.78938388836744,74,211,-128,918,295,271,991,61
10,-14,0,10.0,-14.0,0.40244126319885254,201.07790893982056,74,201,-114,918,295,271,991,61
10,-12,0,10.0,-12.0,0.4103963375091553,186.52944372532804,74,191,-102,918,295,271,991,61
10,-11,0,10.0,-11.0,0.41831231117248535,172.58825237411966,74,181,-91,918,295,271,991,61
9,-9,0,9.0,-9.0,0.42630434036254883,160.5465822312224,74,172,-82,918,295,271,991,61
7,-7,0,7.0,-7.0,0.4342973232269287,151.24568960391858,74,165,-75,918,295,271,991,61
9,-8,0,9.0,-8.0,0.4423692226409912,139.77926846349644,74,156,-67,918,295,271,991,61
11,-7,0,11.0,-7.0,0.4504983425140381,126.92354826475216,74,145,-60,918,295,271,991,61
9,-7,0,9.0,-7.0,0.4583563804626465,115.96232390586277,74,136,-53,918,295,271,991,61
9,-5,0,9.0,-5.0,0.4665071964263916,105.76818478568535,74,127,-48,918,295,271,991,61
9,-5,0,9.0,-5.0,0.47425222396850586,95.59060474414477,74,118,-43,918,295,271,991,61
8,-5,0,8.0,-5.0,0.4823172092437744,86.37869220780924,74,110,-38,918,295,271,991,61
7,-3,0,7.0,-3.0,0.4903702735900879,78.78419002777932,74,103,-35,918,295,271,991,61
6,-2,0,6.0,-2.0,0.49828338623046875,72.45974819410792,74,97,-33,918,295,271,991,61
7,-2,0,7.0,-2.0,0.5063633918762207,65.1892851112981,74,90,-31,918,295,271,991,61
5,-1,0,5.0,-1.0,0.5142743587493896,60.13878188659973,74,85,-30,918,295,271,991,61
5,-1,0,5.0,-1.0,0.5225033760070801,55.09406559801923,74,80,-29,918,295,271,991,61
5,-2,0,5.0,-2.0,0.53031325340271,49.71198153351854,74,75,-27,918,295,271,991,61
7,-1,0,7.0,-1.0,0.5382862091064453,42.801098892805186,74,68,-26,918,295,271,991,61
6,-1,0,6.0,-1.0,0.5463104248046875,36.85057965343307,74,62,-25,918,295,271,991,61
6,-1,0,6.0,-1.0,0.5542802810668945,30.92618484691127,74,56,-24,918,295,271,991,61
5,-1,0,5.0,-1.0,0.5622963905334473,25.94640292279746,74,51,-23,918,295,271,991,61
3,-1,0,3.0,-1.0,0.5703492164611816,22.80151512977634,74,48,-22,918,295,271,991,61
3,-1,0,3.0,-1.0,0.5783843994140625,19.658836071740545,74,45,-21,918,295,271,991,61
4,-1,0,4.0,-1.0,0.5863652229309082,15.617978911828175,74,41,-20,918,295,271,991,61
4,-1,0,4.0,-1.0,0.5944173336029053,11.593268686170845,74,37,-19,918,295,271,991,61
3,-1,0,3.0,-1.0,0.6024432182312012,8.470768123342687,74,34,-18,918,295,271,991,61
2,-1,0,2.0,-1.0,0.610410213470459,6.235341863986875,74,32,-17,918,295,271,991,61
2,-1,0,2.0,-1.0,0.6183643341064453,4.0,74,30,-16,918,295,271,991,61
1,-1,0,1.0,-1.0,0.626244306564331,2.649655434629018,74,29,-15,918,295,271,991,61
1,0,0,1.0,-0.0,0.6343212127685547,1.7647603485371803,74,28,-15,918,295,271,991,61
0,0,1,-0.0,-0.0,0.677281379699707,1.7647603485371803,74,28,-15,918,295,271,991,61
0,0,0,-0.0,-0.0,0.07858753204345703,1139.491290289953,75,-825,819,65,1129,890,310,47
-5,3,0,-5.0,3.0,0.12775659561157227,1133.8301517508955,75,-820,816,65,1129,890,310,47
-8,4,0,-8.0,4.0,0.1356794834136963,1125.3414126469531,75,-812,812,65,1129,890,310,47
-6,3,0,-6.0,3.0,0.14383459091186523,1118.9794218811476,75,-806,809,65,1129,890,310,47
-6,3,0,-6.0,3.0,0.1516435146331787,1112.6214157896109,75,-800,806,65,1129,890,310,47
-7,2,0,-7.0,2.0,0.1595604419708252,1106.2763169393043,75,-793,804,65,1129,890,310,47
-7,2,0,-7.0,2.0,0.16773247718811035,1099.9425630903836,75,-786,802,65,1129,890,310,47
-7,2,0,-7.0,2.0,0.1756443977355957,1093.6203472980421,75,-779,800,65,1129,890,310,47
-9,3,0,-9.0,3.0,0.1837475299835205,1085.2007940802064,75,-770,797,65,1129,890,310,47
-8,4,0,-8.0,4.0,0.1916666030883789,1076.7695213088969,75,-762,793,65,1129,890,310,47
-10,6,0,-10.0,6.0,0.19968056678771973,1065.5187182589007,75,-752,787,65,1129,890,310,47
-12,7,0,-12.0,7.0,0.20769548416137695,1052.174404457249,75,-740,780,65,1129,890,310,47
-10,7,0,-10.0,7.0,0.21575045585632324,1040.2163467516853,75,-730,773,65,1129,890,310,47
-9,9,0,-9.0,9.0,0.2235865592956543,1027.4936934603654,75,-721,764,65,1129,890,310,47
-13,9,0,-13.0,9.0,0.2317485809326172,1012.0309174126153,75,-708,755,65,1129,890,310,47
-13,10,0,-13.0,10.0,0.2397315502166748,995.8473879831071,75,-695,745,65,1129,890,310,47
-15,10,0,-15.0,10.0,0.24766945838928223,978.3116398005169,75,-680,735,65,1129,890,310,47
-17,13,0,-17.0,13.0,0.2556774616241455,957.2310952015346,75,-663,722,65,1129,890,310,47
-18,14,0,-18.0,14.0,0.2635483741760254,934.7520555968543,75,-645,708,65,1129,890,310,47
-21,15,0,-21.0,15.0,0.2717103958129883,909.5368625421731,75,-624,693,65,1129,890,310,47
-22,15,0,-22.0,15.0,0.27968454360961914,883.6906859563519,75,-602,678,65,1129,890,310,47
-22,17,0,-22.0,17.0,0.28763747215270996,856.3867181166656,75,-580,661,65,1129,890,310,47
-23,19,0,-23.0,19.0,0.2956264019012451,826.9488219887124,75,-557,642,65,1129,890,310,47
-24,18,0,-24.0,18.0,0.3035464286804199,797.6491333085047,75,-533,624,65,1129,890,310,47
-24,21,0,-24.0,21.0,0.31156158447265625,766.1070903242475,75,-509,603,65,1129,890,310,47
-24,21,0,-24.0,21.0,0.3197474479675293,734.5942185629455,75,-485,582,65,1129,890,310,47
-25,22,0,-25.0,22.0,0.3276805877685547,701.7068372797376,75,-460,560,65,1129,890,310,47
-25,25,0,-25.0,25.0,0.3356935977935791,666.5288246331694,75,-435,535,65,1129,890,310,47
-24,25,0,-24.0,25.0,0.34366345405578613,631.9969465577683,75,-411,510,65,1129,890,310,47
-22,24,0,-22.0,24.0,0.35169148445129395,599.5086344782698,75,-389,486,65,1129,890,310,47
-19,22,0,-19.0,22.0,0.3596615791320801,570.4610349466931,75,-370,464,65,1129,890,310,47
-18,23,0,-18.0,23.0,0.3676784038543701,541.256147507495,75,-352,441,65,1129,890,310,47
-17,21,0,-17.0,21.0,0.37562060356140137,514.2383083883725,75,-335,420,65,1129,890,310,47
-16,22,0,-16.0,22.0,0.3837134838104248,487.0637215093816,75,-319,398,65,1129,890,310,47
-16,20,0,-16.0,20.0,0.39151954650878906,461.4512359360847,75,-303,378,65,1129,890,310,47
-15,19,0,-15.0,19.0,0.39968347549438477,437.2445002387318,75,-288,359,65,1129,890,310,47
-14,19,0,-14.0,19.0,0.40767860412597656,413.6646310385122,75,-274,340,65,1129,890,310,47
-12,18,0,-12.0,18.0,0.4156675338745117,392.12407783697637,75,-262,322,65,1129,890,310,47
-13,17,0,-13.0,17.0,0.42374444007873535,370.7334123490157,75,-249,305,65,1129,890,310,47
-12,18,0,-12.0,18.0,0.4316444396972656,349.2069316925734,75,-237,287,65,1129,890,310,47
-11,17,0,-11.0,17.0,0.4398045539855957,329.1022578740443,75,-226,270,65,1129,890,310,47
-10,16,0,-10.0,16.0,0.4475405216217041,310.4246541574273,75,-216,254,65,1129,890,310,47
-10,17,0,-10.0,17.0,0.4556396007537842,291.0143308831621,75,-206,237,65,1129,890,310,47
-10,14,0,-10.0,14.0,0.46363258361816406,273.89223634174067,75,-196,223,65,1129,890,310,47
-9,13,0,-9.0,13.0,0.4716224670410156,258.19210515233175,75,-187,210,65,1129,890,310,47
-10,10,0,-10.0,10.0,0.47963547706604004,244.07489586256509,75,-177,200,65,1129,890,310,47
-8,9,0,-8.0,9.0,0.4876534938812256,232.03333115496883,75,-169,191,65,1129,890,310,47
-7,7,0,-7.0,7.0,0.49566650390625,222.15301344262525,75,-162,184,65,1129,890,310,47
-5,6,0,-5.0,6.0,0.5037734508514404,214.34573937612615,75,-157,178,65,1129,890,310,47
-5,6,0,-5.0,6.0,0.5115435123443604,206.53866776645717,75,-152,172,65,1129,890,310,47
-5,9,0,-5.0,9.0,0.5196723937988281,196.49487465542333,75,-147,163,65,1129,890,310,47
-4,8,0,-4.0,8.0,0.5277414321899414,187.8885961829136,75,-143,155,65,1129,890,310,47
-4,10,0,-4.0,10.0,0.5357015132904053,177.86313748420838,75,-139,145,65,1129,890,310,47
-3,8,0,-3.0,8.0,0.5435905456542969,170.04144632694815,75,-136,137,65,1129,890,310,47
-4,7,0,-4.0,7.0,0.5518054962158203,162.26737435393204,75,-132,130,65,1129,890,310,47
-3,7,0,-3.0,7.0,0.5596885681152344,155.24140933015536,75,-129,123,65,1129,890,310,47
-3,6,0,-3.0,6.0,0.5676014423370361,148.9447585708852,75,-126,117,65,1129,890,310,47
-2,6,0,-2.0,6.0,0.5756785869598389,143.42415690037308,75,-124,111,65,1129,890,310,47
-4,5,0,-4.0,5.0,0.583594560623169,137.11246047700348,75,-120,106,65,1129,890,310,47
-3,5,0,-3.0,5.0,0.5916464328765869,131.5639026422405,75,-117,101,65,1129,890,310,47
-4,5,0,-4.0,5.0,0.5995373725891113,125.27339613025663,75,-113,96,65,1129,890,310,47
-3,4,0,-3.0,4.0,0.6075625419616699,120.40153416194681,75,-110,92,65,1129,890,310,47
-4,4,0,-4.0,4.0,0.6157224178314209,114.7679207943562,75,-106,88,65,1129,890,310,47
-3,5,0,-3.0,5.0,0.6237175464630127,109.2800060477773,75,-103,83,65,1129,890,310,47
-3,5,0,-3.0,5.0,0.6317214965820312,103.82271089990152,75,-100,78,65,1129,890,310,47
-3,4,0,-3.0,4.0,0.639662504196167,99.00409829181969,75,-97,74,65,1129,890,310,47
-4,4,0,-4.0,4.0,0.6476254463195801,93.40017182117903,75,-93,70,65,1129,890,310,47
-3,3,0,-3.0,3.0,0.6556293964385986,89.2007130102122,75,-90,67,65,1129,890,310,47
-3,4,0,-3.0,4.0,0.6635434627532959,84.41508273980894,75,-87,63,65,1129,890,310,47
-3,4,0,-3.0,4.0,0.6715564727783203,79.6498904042279,75,-84,59,65,1129,890,310,47
-4,4,0,-4.0,4.0,0.679612398147583,74.082439194738,75,-80,55,65,1129,890,310,47
-4,4,0,-4.0,4.0,0.6876435279846191,68.52595260361949,75,-76,51,65,1129,890,310,47
-4,4,0,-4.0,4.0,0.6955945491790771,62.98255637046388,75,-72,47,65,1129,890,310,47
-3,4,0,-3.0,4.0,0.7037105560302734,58.30190649671138,75,-69,43,65,1129,890,310,47
-3,3,0,-3.0,3.0,0.7116625308990479,54.175125526298956,75,-66,40,65,1129,890,310,47
-2,3,0,-2.0,3.0,0.7195456027984619,50.92563831310488,75,-64,37,65,1129,890,310,47
-3,4,0,-3.0,4.0,0.7276344299316406,46.35416353759881,75,-61,33,65,1129,890,310,47
-4,4,0,-4.0,4.0,0.7356314659118652,40.953107821277925,75,-57,29,65,1129,890,310,47
-4,4,0,-4.0,4.0,0.7436094284057617,35.60034129593445,75,-53,25,65,1129,890,310,47
-5,4,0,-5.0,4.0,0.7515895366668701,29.392747589718944,75,-48,21,65,1129,890,310,47
-4,3,0,-4.0,3.0,0.7597124576568604,24.539457296018853,75,-44,18,65,1129,890,310,47
-3,3,0,-3.0,3.0,0.7676734924316406,20.657759905886145,75,-41,15,65,1129,890,310,47
-3,3,0,-3.0,3.0,0.7758305072784424,16.84971769034255,75,-38,12,65,1129,890,310,47
-3,2,0,-3.0,2.0,0.7836315631866455,13.400549446402593,75,-35,10,65,1129,890,310,47
-2,2,0,-2.0,2.0,0.7918844223022461,10.955853692699293,75,-33,8,65,1129,890,310,47
-2,2,0,-2.0,2.0,0.799668550491333,8.575306807693888,75,-31,6,65,1129,890,310,47
-2,2,0,-2.0,2.0,0.8075563907623291,6.274562336608895,75,-29,4,65,1129,890,310,47
-2,2,0,-2.0,2.0,0.8155543804168701,4.073972741361768,75,-27,2,65,1129,890,310,47
-1,1,0,-1.0,1.0,0.8236753940582275,3.019223662515376,75,-26,1,65,1129,890,310,47
-2,2,0,-2.0,2.0,0.831580400466919,1.020824298928627,75,-24,-1,65,1129,890,310,47
-2,2,0,-2.0,2.0,0.8397445678710938,-0.7963966888254816,75,-22,-3,65,1129,890,310,47
0,1,0,-0.0,1.0,0.8476495742797852,-0.639320225002102,75,-22,-4,65,1129,890,310,47
0,0,1,-0.0,-0.0,0.8965895175933838,-0.639320225002102,75,-22,-4,65,1129,890,310,47
0,0,0,-0.0,-0.0,0.04445528984069824,1188.1780297308449,76,1105,-508,1192,625,87,1133,57
3,0,0,3.0,-0.0,0.06755447387695312,1185.4529245092288,76,1102,-508,1192,625,87,1133,57
5,-1,0,5.0,-1.0,0.07568550109863281,1180.4941042470998,76,1097,-507,1192,625,87,1133,57
6,-2,0,6.0,-2.0,0.0835573673248291,1174.208800500146,76,1091,-505,1192,625,87,1133,57
7,-2,0,7.0,-2.0,0.09160542488098145,1167.0167362844757,76,1084,-503,1192,625,87,1133,57
8,-2,0,8.0,-2.0,0.09962344169616699,1158.9191210861843,76,1076,-501,1192,625,87,1133,57
8,-2,0,8.0,-2.0,0.10756731033325195,1150.8235661030874,76,1068,-499,1192,625,87,1133,57
9,-3,0,9.0,-3.0,0.1155853271484375,1141.400273644572,76,1059,-496,1192,625,87,1133,57
10,-2,0,10.0,-2.0,0.12359428405761719,1131.4985985330038,76,1049,-494,1192,625,87,1133,57
10,-2,0,10.0,-2.0,0.1314864158630371,1121.6021050781005,76,1039,-492,1192,625,87,1133,57
11,-3,0,11.0,-3.0,0.13972735404968262,1110.3782323990563,76,1028,-489,1192,625,87,1133,57
10,-3,0,10.0,-3.0,0.14756250381469727,1100.0602820771592,76,1018,-486,1192,625,87,1133,57
10,-2,0,10.0,-2.0,0.15558338165283203,1090.1770879426927,76,1008,-484,1192,625,87,1133,57
13,-4,0,13.0,-4.0,0.16355633735656738,1076.7284734268417,76,995,-480,1192,625,87,1133,57
15,-4,0,15.0,-4.0,0.17159628868103027,1061.4842816672483,76,980,-476,1192,625,87,1133,57
17,-6,0,17.0,-6.0,0.17947149276733398,1043.573142627231,76,963,-470,1192,625,87,1133,57
18,-5,0,18.0,-5.0,0.1874845027923584,1025.2093808925174,76,945,-465,1192,625,87,1133,57
21,-7,0,21.0,-7.0,0.19556450843811035,1003.2807571170908,76,924,-458,1192,625,87,1133,57
26,-8,0,26.0,-8.0,0.20363640785217285,976.4421337239891,76,898,-450,1192,625,87,1133,57
26,-8,0,26.0,-8.0,0.21146535873413086,949.6236494684445,76,872,-442,1192,625,87,1133,57
29,-10,0,29.0,-10.0,0.2195723056793213,919.2449524806136,76,843,-432,1192,625,87,1133,57
30,-10,0,30.0,-10.0,0.22759246826171875,887.9983624439511,76,813,-422,1192,625,87,1133,57
31,-11,0,31.0,-11.0,0.23555946350097656,855.4279823505706,76,782,-411,1192,625,87,1133,57
33,-13,0,33.0,-13.0,0.24363350868225098,820.1774578471183,76,749,-398,1192,625,87,1133,57
36,-15,0,36.0,-15.0,0.251711368560791,781.3565345383948,76,713,-383,1192,625,87,1133,57
40,-17,0,40.0,-17.0,0.25942039489746094,738.084199027757,76,673,-366,1192,625,87,1133,57
39,-19,0,39.0,-19.0,0.2675774097442627,694.7482272548305,76,634,-347,1192,625,87,1133,57
39,-20,0,39.0,-20.0,0.2755153179168701,650.9359321762253,76,595,-327,1192,625,87,1133,57
34,-21,0,34.0,-21.0,0.2836453914642334,611.0281683932251,76,561,-306,1192,625,87,1133,57
32,-20,0,32.0,-20.0,0.29163646697998047,573.3626193903309,76,529,-286,1192,625,87,1133,57
29,-19,0,29.0,-19.0,0.2995593547821045,538.8236057187456,76,500,-267,1192,625,87,1133,57
28,-18,0,28.0,-18.0,0.3076944351196289,505.6525086608326,76,472,-249,1192,625,87,1133,57
26,-17,0,26.0,-17.0,0.3155994415283203,474.7325332619722,76,446,-232,1192,625,87,1133,57
24,-17,0,24.0,-17.0,0.32353830337524414,445.6127109780733,76,422,-215,1192,625,87,1133,57
21,-15,0,21.0,-15.0,0.3314223289489746,420.1082458513791,76,401,-200,1192,625,87,1133,57
21,-14,0,21.0,-14.0,0.3395073413848877,395.07918880512193,76,380,-186,1192,625,87,1133,57
19,-13,0,19.0,-13.0,0.34760427474975586,372.3123780249619,76,361,-173,1192,625,87,1133,57
18,-11,0,18.0,-11.0,0.35555028915405273,351.3323081415555,76,343,-162,1192,625,87,1133,57
18,-9,0,18.0,-9.0,0.3636183738708496,331.21302871694394,76,325,-153,1192,625,87,1133,57
18,-8,0,18.0,-8.0,0.3714914321899414,311.52024976428135,76,307,-145,1192,625,87,1133,57
18,-6,0,18.0,-6.0,0.3796103000640869,292.689881349568,76,289,-139,1192,625,87,1133,57
16,-6,0,16.0,-6.0,0.3875443935394287,275.67416748877406,76,273,-133,1192,625,87,1133,57
14,-6,0,14.0,-6.0,0.3955953121185303,260.4614358974177,76,259,-127,1192,625,87,1133,57
14,-5,0,14.0,-5.0,0.40355944633483887,245.69508581631493,76,245,-122,1192,625,87,1133,57
13,-6,0,13.0,-6.0,0.4114363193511963,231.3838853899756,76,232,-116,1192,625,87,1133,57
14,-5,0,14.0,-5.0,0.41970229148864746,216.63237725207185,76,218,-111,1192,625,87,1133,57
14,-6,0,14.0,-6.0,0.4275343418121338,201.43626565998673,76,204,-105,1192,625,87,1133,57
13,-6,0,13.0,-6.0,0.4355483055114746,187.13251730038394,76,191,-99,1192,625,87,1133,57
14,-5,0,14.0,-5.0,0.4435863494873047,172.4120754844877,76,177,-94,1192,625,87,1133,57
12,-4,0,12.0,-4.0,0.45158839225769043,159.94946129212502,76,165,-90,1192,625,87,1133,57
9,-3,0,9.0,-3.0,0.4594714641571045,150.61970775925036,76,156,-87,1192,625,87,1133,57
10,-3,0,10.0,-3.0,0.4674344062805176,140.43990026119107,76,146,-84,1192,625,87,1133,57
8,-3,0,8.0,-3.0,0.4754824638366699,132.01562423713506,76,138,-81,1192,625,87,1133,57
7,-2,0,7.0,-2.0,0.48356032371520996,124.97712247261026,76,131,-79,1192,625,87,1133,57
7,-3,0,7.0,-3.0,0.4917004108428955,117.43727170158274,76,124,-76,1192,625,87,1133,57
6,-3,0,6.0,-3.0,0.499556303024292,110.75518008348374,76,118,-73,1192,625,87,1133,57
6,-2,0,6.0,-2.0,0.5075764656066895,104.60844618650805,76,112,-71,1192,625,87,1133,57
4,-2,0,4.0,-2.0,0.5155763626098633,100.16005617976296,76,108,-69,1192,625,87,1133,57
4,-2,0,4.0,-2.0,0.5235753059387207,95.71337841963576,76,104,-67,1192,625,87,1133,57
3,-1,0,3.0,-1.0,0.5316243171691895,92.65239326262865,76,101,-66,1192,625,87,1133,57
2,-1,0,2.0,-1.0,0.5394175052642822,90.43141475132347,76,99,-65,1192,625,87,1133,57
2,-1,0,2.0,-1.0,0.5474934577941895,88.21101496846157,76,97,-64,1192,625,87,1133,57
3,-1,0,3.0,-1.0,0.5555744171142578,85.1591799192624,76,94,-63,1192,625,87,1133,57
3,-1,0,3.0,-1.0,0.5635592937469482,82.11357772772621,76,91,-62,1192,625,87,1133,57
4,-1,0,4.0,-1.0,0.571575403213501,78.25441167311595,76,87,-61,1192,625,87,1133,57
5,-1,0,5.0,-1.0,0.5795834064483643,73.6070863670443,76,82,-60,1192,625,87,1133,57
4,-2,0,4.0,-2.0,0.5877244472503662,69.20082304178294,76,78,-58,1192,625,87,1133,57
5,-1,0,5.0,-1.0,0.5956454277038574,64.61749294814668,76,73,-57,1192,625,87,1133,57
4,-3,0,4.0,-3.0,0.6036365032196045,59.618491199061395,76,69,-54,1192,625,87,1133,57
5,-2,0,5.0,-2.0,0.6116933822631836,54.462112512353215,76,64,-52,1192,625,87,1133,57
5,-3,0,5.0,-3.0,0.6194334030151367,48.694197955256044,76,59,-49,1192,625,87,1133,57
3,-2,0,3.0,-2.0,0.6275835037231445,45.109506905736964,76,56,-47,1192,625,87,1133,57
3,-1,0,3.0,-1.0,0.6354334354400635,42.178344238091,76,53,-46,1192,625,87,1133,57
2,-2,0,2.0,-2.0,0.6435723304748535,39.357256476195644,76,51,-44,1192,625,87,1133,57
2,-1,0,2.0,-1.0,0.6516084671020508,37.19202405202648,76,49,-43,1192,625,87,1133,57
1,-1,0,1.0,-1.0,0.6596043109893799,35.7808748764079,76,48,-42,1192,625,87,1133,57
2,-2,0,2.0,-2.0,0.6675534248352051,32.959002616512684,76,46,-40,1192,625,87,1133,57
1,-1,0,1.0,-1.0,0.6755554676055908,31.548299723837623,76,45,-39,1192,625,87,1133,57
1,-1,0,1.0,-1.0,0.6834404468536377,30.137767414994535,76,44,-38,1192,625,87,1133,57
2,-1,0,2.0,-1.0,0.6914124488830566,27.97320787662612,76,42,-37,1192,625,87,1133,57
1,-2,0,1.0,-2.0,0.6995213031768799,25.907327887774215,76,41,-35,1192,625,87,1133,57
1,-1,0,1.0,-1.0,0.7074823379516602,24.49761899362675,76,40,-34,1192,625,87,1133,57
0,-1,0,-0.0,-1.0,0.7155942916870117,23.855568649856693,76,40,-33,1192,625,87,1133,57
1,-1,0,1.0,-1.0,0.7235922813415527,22.447993022517757,76,39,-32,1192,625,87,1133,57
1,0,0,1.0,-0.0,0.7396113872528076,21.678969393496885,76,38,-32,1192,625,87,1133,57
0,0,1,-0.0,-0.0,0.7534263134002686,21.678969393496885,76,38,-32,1192,625,87,1133,57
0,-1,1,-0.0,-1.0,0.7556014060974121,251.69679558159214,77,-100,-244,1054,412,1154,657,25
0,0,0,-0.0,-0.0,0.061385393142700195,251.69679558159214,77,-100,-244,1054,412,1154,657,25
2,0,0,2.0,-0.0,0.07162737846374512,252.4617174564213,77,-102,-244,1054,412,1154,657,25
3,-1,0,3.0,-1.0,0.07953834533691406,252.71494102146937,77,-105,-243,1054,412,1154,657,25
2,-1,0,2.0,-1.0,0.08745527267456055,252.5996976566678,77,-107,-242,1054,412,1154,657,25
1,-1,0,1.0,-1.0,0.09537839889526367,252.09278672466615,77,-108,-241,1054,412,1154,657,25
0,-1,0,-0.0,-1.0,0.24739527702331543,251.18054639353568,77,-108,-240,1054,412,1154,657,25
-1,-4,0,-1.0,-4.0,0.25549817085266113,247.12352266824405,77,-107,-236,1054,412,1154,657,25
-4,-7,0,-4.0,-7.0,0.2634751796722412,239.09759058979438,77,-103,-229,1054,412,1154,657,25
-5,-9,0,-5.0,-9.0,0.27144432067871094,228.84019598065436,77,-98,-220,1054,412,1154,657,25
-5,-9,0,-5.0,-9.0,0.2794952392578125,218.58620947489467,77,-93,-211,1054,412,1154,657,25
-4,-8,0,-4.0,-8.0,0.28752827644348145,209.65288177689007,77,-89,-203,1054,412,1154,657,25
-4,-9,0,-4.0,-9.0,0.29552316665649414,199.80415482232638,77,-85,-194,1054,412,1154,657,25
-5,-12,0,-5.0,-12.0,0.30341029167175293,186.80643852752857,77,-80,-182,1054,412,1154,657,25
-6,-15,0,-6.0,-15.0,0.3115081787109375,170.6608879864543,77,-74,-167,1054,412,1154,657,25
-6,-17,0,-6.0,-17.0,0.3194723129272461,152.69365500832143,77,-68,-150,1054,412,1154,657,25
-6,-17,0,-6.0,-17.0,0.32739830017089844,134.74126890551273,77,-62,-133,1054,412,1154,657,25
-6,-16,0,-6.0,-16.0,0.3354983329772949,117.71121771072848,77,-56,-117,1054,412,1154,657,25
-5,-14,0,-5.0,-14.0,0.3434484004974365,102.93476410555685,77,-51,-103,1054,412,1154,657,25
-5,-11,0,-5.0,-11.0,0.3515462875366211,90.85912696499032,77,-46,-92,1054,412,1154,657,25
-4,-10,0,-4.0,-10.0,0.35944128036499023,80.13034245024816,77,-42,-82,1054,412,1154,657,25
-3,-7,0,-3.0,-7.0,0.367659330368042,72.53401682163222,77,-39,-75,1054,412,1154,657,25
-1,-6,0,-1.0,-6.0,0.3753643035888672,66.77182237323191,77,-38,-69,1054,412,1154,657,25
-2,-4,0,-2.0,-4.0,0.38341331481933594,62.30343195303969,77,-36,-65,1054,412,1154,657,25
-1,-4,0,-1.0,-4.0,0.39147329330444336,58.327803890068964,77,-35,-61,1054,412,1154,657,25
-2,-5,0,-2.0,-5.0,0.39934825897216797,53.0,77,-33,-56,1054,412,1154,657,25
-2,-4,0,-2.0,-4.0,0.40741729736328125,48.53924347066124,77,-31,-52,1054,412,1154,657,25
-1,-5,0,-1.0,-5.0,0.41553735733032227,43.758407437802596,77,-30,-47,1054,412,1154,657,25
-1,-4,0,-1.0,-4.0,0.42345333099365234,39.86520991955976,77,-29,-43,1054,412,1154,657,25
-1,-3,0,-1.0,-3.0,0.4315643310546875,36.82622246293481,77,-28,-40,1054,412,1154,657,25
0,-3,0,-0.0,-3.0,0.43963027000427246,34.400431032480725,77,-28,-37,1054,412,1154,657,25
-1,-3,0,-1.0,-3.0,0.4474513530731201,31.416586692184822,77,-27,-34,1054,412,1154,657,25
0,-3,0,-0.0,-3.0,0.4553563594818115,29.10960958218893,77,-27,-31,1054,412,1154,657,25
0,-2,0,-0.0,-2.0,0.4633963108062744,27.6232255123179,77,-27,-29,1054,412,1154,657,25
0,-3,0,-0.0,-3.0,0.47156739234924316,25.483329627982627,77,-27,-26,1054,412,1154,657,25
0,-2,0,-0.0,-2.0,0.4794793128967285,24.124783736376884,77,-27,-24,1054,412,1154,657,25
0,-2,0,-0.0,-2.0,0.4874691963195801,22.828149534535996,77,-27,-22,1054,412,1154,657,25
-1,-1,0,-1.0,-1.0,0.49550533294677734,21.421549934136806,77,-26,-21,1054,412,1154,657,25
0,-1,0,-0.0,-1.0,0.5034873485565186,20.802438933713454,77,-26,-20,1054,412,1154,657,25
-1,-1,0,-1.0,-1.0,0.511371374130249,19.400636936215164,77,-25,-19,1054,412,1154,657,25
-1,-2,0,-1.0,-2.0,0.5194582939147949,17.410882339705484,77,-24,-17,1054,412,1154,657,25
-1,-2,0,-1.0,-2.0,0.5273592472076416,15.459060435491963,77,-23,-15,1054,412,1154,657,25
-2,-1,0,-2.0,-1.0,0.5354623794555664,13.238858928247925,77,-21,-14,1054,412,1154,657,25
-2,-2,0,-2.0,-2.0,0.5433821678161621,10.472205054244231,77,-19,-12,1054,412,1154,657,25
-2,-1,0,-2.0,-1.0,0.5514962673187256,8.248456731316587,77,-17,-11,1054,412,1154,657,25
-2,-1,0,-2.0,-1.0,0.5594441890716553,6.027756377319946,77,-15,-10,1054,412,1154,657,25
-2,-2,0,-2.0,-2.0,0.567493200302124,3.264337522473747,77,-13,-8,1054,412,1154,657,25
-2,-1,0,-2.0,-1.0,0.5755002498626709,1.0384048104052983,77,-11,-7,1054,412,1154,657,25
-3,-2,0,-3.0,-2.0,0.5835363864898682,-2.566018867943397,77,-8,-5,1054,412,1154,657,25
-3,-2,0,-3.0,-2.0,0.5914843082427979,-6.169048105154699,77,-5,-3,1054,412,1154,657,25
-4,-2,0,-4.0,-2.0,0.599412202835083,-10.585786437626904,77,-1,-1,1054,412,1154,657,25
-3,-2,0,-3.0,-2.0,0.6075212955474854,-9.76393202250021,77,2,1,1054,412,1154,657,25
-2,-1,0,-2.0,-1.0,0.6154563426971436,-7.52786404500042,77,4,2,1054,412,1154,657,25
-2,-1,0,-2.0,-1.0,0.6234292984008789,-5.291796067500631,77,6,3,1054,412,1154,657,25
-1,-1,0,-1.0,-1.0,0.6314823627471924,-3.937742251701451,77,7,4,1054,412,1154,657,25
-1,0,0,-1.0,-0.0,0.6395692825317383,-3.055728090000841,77,8,4,1054,412,1154,657,25
-1,0,0,-1.0,-0.0,0.6474823951721191,-2.151142198203896,77,9,4,1054,412,1154,657,25
0,0,1,-0.0,-0.0,0.6594312191009521,-2.151142198203896,77,9,4,1054,412,1154,657,25
0,0,0,-0.0,-0.0,0.09014010429382324,199.39316070523117,78,-155,151,890,559,1045,408,35
-1,2,0,-1.0,2.0,0.1833209991455078,197.28252378577213,78,-154,149,890,559,1045,408,35
-3,4,0,-3.0,4.0,0.19131016731262207,192.34660255184463,78,-151,145,890,559,1045,408,35
-4,7,0,-4.0,7.0,0.19925212860107422,184.62589119455865,78,-147,138,890,559,1045,408,35
-6,8,0,-6.0,8.0,0.2073051929473877,174.7837323653912,78,-141,130,890,559,1045,408,35
-8,12,0,-8.0,12.0,0.21520400047302246,160.80044994318772,78,-133,118,890,559,1045,408,35
-11,15,0,-11.0,15.0,0.2231290340423584,142.66527487215245,78,-122,103,890,559,1045,408,35
-14,19,0,-14.0,19.0,0.23110699653625488,119.82105101189657,78,-108,84,890,559,1045,408,35
-16,19,0,-16.0,19.0,0.23929715156555176,95.6454615153225,78,-92,65,890,559,1045,408,35
-16,19,0,-16.0,19.0,0.247298002243042,71.83692925805124,78,-76,46,890,559,1045,408,35
-17,19,0,-17.0,19.0,0.25525712966918945,47.88451279003334,78,-59,27,890,559,1045,408,35
-15,14,0,-15.0,14.0,0.26320409774780273,28.880278987817846,78,-44,13,890,559,1045,408,35
-11,13,0,-11.0,13.0,0.27138304710388184,16.0,78,-33,0,890,559,1045,408,35
-8,8,0,-8.0,8.0,0.27915501594543457,9.248809496813376,78,-25,-8,890,559,1045,408,35
-5,5,0,-5.0,5.0,0.2871851921081543,6.853720883753127,78,-20,-13,890,559,1045,408,35
-2,3,0,-2.0,3.0,0.2952561378479004,7.0831891575845916,78,-18,-16,890,559,1045,408,35
-1,1,0,-1.0,1.0,0.3031129837036133,7.041630560342615,78,-17,-17,890,559,1045,408,35
0,-1,0,-0.0,-1.0,0.38321709632873535,6.3452350598575045,78,-17,-16,890,559,1045,408,35
0,-3,0,-0.0,-3.0,0.3911101818084717,4.400934559032695,78,-17,-13,890,559,1045,408,35
0,-3,0,-0.0,-3.0,0.3993051052093506,2.7230829233160208,78,-17,-10,890,559,1045,408,35
0,-3,0,-0.0,-3.0,0.4072990417480469,1.384776310850235,78,-17,-7,890,559,1045,408,35
0,-2,0,-0.0,-2.0,0.41529417037963867,0.7200451466693494,78,-17,-5,890,559,1045,408,35
0,-4,0,-0.0,-4.0,0.42341113090515137,0.029386365926402647,78,-17,-1,890,559,1045,408,35
0,-3,0,-0.0,-3.0,0.431171178817749,0.1172427686236901,78,-17,2,890,559,1045,408,35
0,-2,0,-0.0,-2.0,0.43920207023620605,0.4642491965729789,78,-17,4,890,559,1045,408,35
-2,-2,0,-2.0,-2.0,0.4472970962524414,-0.8445055785964897,78,-15,6,890,559,1045,408,35
0,-1,0,-0.0,-1.0,0.45517516136169434,-0.44705464275315165,78,-15,7,890,559,1045,408,35
-2,0,0,-2.0,-0.0,0.46317410469055176,-2.2351769397665997,78,-13,7,890,559,1045,408,35
-1,-1,0,-1.0,-1.0,0.4792330265045166,-2.5777948981440435,78,-12,8,890,559,1045,408,35
0,0,1,-0.0,-0.0,0.51528000831604,-2.5777948981440435,78,-12,8,890,559,1045,408,35
-1,0,1,-1.0,-0.0,0.046762704849243164,431.1249820865574,79,386,-203,1287,348,902,551,11
0,0,0,-0.0,-0.0,0.09385371208190918,431.1249820865574,79,386,-203,1287,348,902,551,11
4,-1,0,4.0,-1.0,0.18281054496765137,427.12035360533525,79,382,-202,1287,348,902,551,11
9,-4,0,9.0,-4.0,0.1907486915588379,417.29492064196086,79,373,-198,1287,348,902,551,11
13,-5,0,13.0,-5.0,0.19878149032592773,403.471541236351,79,360,-193,1287,348,902,551,11
15,-7,0,15.0,-7.0,0.20673561096191406,386.94514922371474,79,345,-186,1287,348,902,551,11
15,-7,0,15.0,-7.0,0.21472454071044922,370.4210969031975,79,330,-179,1287,348,902,551,11
16,-6,0,16.0,-6.0,0.22258949279785156,353.50383540486706,79,314,-173,1287,348,902,551,11
17,-7,0,17.0,-7.0,0.23056960105895996,335.2425605358624,79,297,-166,1287,348,902,551,11
19,-7,0,19.0,-7.0,0.23871350288391113,315.2577087284551,79,278,-159,1287,348,902,551,11
19,-7,0,19.0,-7.0,0.24674749374389648,295.30817504690077,79,259,-152,1287,348,902,551,11
20,-8,0,20.0,-8.0,0.25466465950012207,274.0286723618202,79,239,-144,1287,348,902,551,11
17,-8,0,17.0,-8.0,0.2627274990081787,255.34592372457075,79,222,-136,1287,348,902,551,11
18,-8,0,18.0,-8.0,0.27066969871520996,235.8318915758459,79,204,-128,1287,348,902,551,11
16,-7,0,16.0,-7.0,0.27871251106262207,218.57325421436258,79,188,-121,1287,348,902,551,11
14,-8,0,14.0,-8.0,0.2866535186767578,202.4728897952694,79,174,-113,1287,348,902,551,11
14,-7,0,14.0,-7.0,0.29465651512145996,186.92706948213427,79,160,-106,1287,348,902,551,11
13,-8,0,13.0,-8.0,0.3027377128601074,171.67201249773547,79,147,-98,1287,348,902,551,11
12,-7,0,12.0,-7.0,0.31079769134521484,157.8066337714775,79,135,-91,1287,348,902,551,11
13,-7,0,13.0,-7.0,0.31873059272766113,143.12157169028418,79,122,-84,1287,348,902,551,11
10,-7,0,10.0,-7.0,0.32671570777893066,130.9154148726332,79,112,-77,1287,348,902,551,11
8,-5,0,8.0,-5.0,0.3347606658935547,121.49110640673517,79,104,-72,1287,348,902,551,11
5,-4,0,5.0,-4.0,0.3427736759185791,115.10412149464314,79,99,-68,1287,348,902,551,11
3,-4,0,3.0,-4.0,0.35091161727905273,110.37764081484765,79,96,-64,1287,348,902,551,11
3,-3,0,3.0,-3.0,0.3587465286254883,106.22050170719426,79,93,-61,1287,348,902,551,11
3,-4,0,3.0,-4.0,0.36673450469970703,101.53168542738823,79,90,-57,1287,348,902,551,11
3,-4,0,3.0,-4.0,0.3746817111968994,96.87246929372037,79,87,-53,1287,348,902,551,11
3,-5,0,3.0,-5.0,0.3828115463256836,91.74709297958259,79,84,-48,1287,348,902,551,11
4,-3,0,4.0,-3.0,0.3907606601715088,86.7877987534291,79,80,-45,1287,348,902,551,11
3,-3,0,3.0,-3.0,0.3987085819244385,82.70974860299168,79,77,-42,1287,348,902,551,11
4,-2,0,4.0,-2.0,0.4067096710205078,78.24061508662703,79,73,-40,1287,348,902,551,11
3,-2,0,3.0,-2.0,0.414623498916626,74.64923100695951,79,70,-38,1287,348,902,551,11
2,-2,0,2.0,-2.0,0.42259955406188965,71.94153624668537,79,68,-36,1287,348,902,551,11
3,-2,0,3.0,-2.0,0.43058156967163086,68.35529974037323,79,65,-34,1287,348,902,551,11
2,-1,0,2.0,-1.0,0.43872952461242676,66.11961754677819,79,63,-33,1287,348,902,551,11
2,-2,0,2.0,-2.0,0.4467475414276123,63.425141578224014,79,61,-31,1287,348,902,551,11
4,-2,0,4.0,-2.0,0.4547154903411865,58.953107821277925,79,57,-29,1287,348,902,551,11
3,-2,0,3.0,-2.0,0.4627547264099121,55.37383539249432,79,54,-27,1287,348,902,551,11
2,-1,0,2.0,-1.0,0.4708235263824463,53.137767414994535,79,52,-26,1287,348,902,551,11
3,-2,0,3.0,-2.0,0.4787406921386719,49.56189146281496,79,49,-24,1287,348,902,551,11
2,-1,0,2.0,-1.0,0.48676252365112305,47.32590180780452,79,47,-23,1287,348,902,551,11
2,-2,0,2.0,-2.0,0.49471259117126465,44.658836071740545,79,45,-21,1287,348,902,551,11
2,-1,0,2.0,-1.0,0.5026986598968506,42.4236228055175,79,43,-20,1287,348,902,551,11
2,-2,0,2.0,-2.0,0.5106656551361084,39.77722635447622,79,41,-18,1287,348,902,551,11
2,-2,0,2.0,-2.0,0.5187256336212158,37.15447781671598,79,39,-16,1287,348,902,551,11
3,-2,0,3.0,-2.0,0.526592493057251,33.62641583165593,79,36,-14,1287,348,902,551,11
2,-3,0,2.0,-3.0,0.5346846580505371,30.735136770411273,79,34,-11,1287,348,902,551,11
3,-2,0,3.0,-2.0,0.542710542678833,27.280024783137947,79,31,-9,1287,348,902,551,11
2,-2,0,2.0,-2.0,0.5507726669311523,24.832867780352597,79,29,-7,1287,348,902,551,11
2,-2,0,2.0,-2.0,0.558708667755127,22.459060435491963,79,27,-5,1287,348,902,551,11
3,-1,0,3.0,-1.0,0.5668497085571289,19.331050121192877,79,24,-4,1287,348,902,551,11
3,-2,0,3.0,-2.0,0.5747137069702148,16.095023109728988,79,21,-2,1287,348,902,551,11
2,-2,0,2.0,-2.0,0.5825865268707275,14.0,79,19,0,1287,348,902,551,11
1,-2,0,1.0,-2.0,0.5906276702880859,13.110770276274835,79,18,2,1287,348,902,551,11
2,-2,0,2.0,-2.0,0.5986616611480713,11.492422502470642,79,16,4,1287,348,902,551,11
2,-1,0,2.0,-1.0,0.6068625450134277,9.866068747318506,79,14,5,1287,348,902,551,11
2,-1,0,2.0,-1.0,0.6147785186767578,8.416407864998739,79,12,6,1287,348,902,551,11
2,-2,0,2.0,-2.0,0.622734546661377,7.806248474865697,79,10,8,1287,348,902,551,11
3,-3,0,3.0,-3.0,0.6307187080383301,8.038404810405298,79,7,11,1287,348,902,551,11
4,-2,0,4.0,-2.0,0.638669490814209,8.341664064126334,79,3,13,1287,348,902,551,11
3,-2,0,3.0,-2.0,0.6467046737670898,10.0,79,0,15,1287,348,902,551,11
4,-2,0,4.0,-2.0,0.654632568359375,12.464249196572979,79,-4,17,1287,348,902,551,11
3,-3,0,3.0,-3.0,0.662677526473999,16.18962010041709,79,-7,20,1287,348,902,551,11
2,-1,0,2.0,-1.0,0.6706326007843018,17.847319317591726,79,-9,21,1287,348,902,551,11
1,0,0,1.0,-0.0,0.6787307262420654,18.259406699226016,79,-10,21,1287,348,902,551,11
1,-1,0,1.0,-1.0,0.6868417263031006,19.596747752497688,79,-11,22,1287,348,902,551,11
1,0,0,1.0,-0.0,0.6947085857391357,20.059928172283335,79,-12,22,1287,348,902,551,11
1,0,0,1.0,-0.0,0.7107086181640625,20.553864678361276,79,-13,22,1287,348,902,551,11
1,0,0,1.0,-0.0,0.7267606258392334,21.076809620810597,79,-14,22,1287,348,902,551,11
0,0,1,-0.0,-0.0,0.748694658279419,21.076809620810597,79,-14,22,1287,348,902,551,11
0,0,0,-0.0,-0.0,0.8106236457824707,21.076809620810597,79,-14,22,1287,348,902,551,11
0,1,0,-0.0,1.0,0.8706614971160889,20.238858928247925,79,-14,21,1287,348,902,551,11
-1,2,0,-1.0,2.0,0.8786606788635254,18.021728866442675,79,-13,19,1287,348,902,551,11
-2,3,0,-2.0,3.0,0.8867206573486328,14.4164878389476,79,-11,16,1287,348,902,551,11
-1,3,0,-1.0,3.0,0.8947465419769287,11.401219466856727,79,-10,13,1287,348,902,551,11
-1,2,0,-1.0,2.0,0.9027285575866699,9.212670403551895,79,-9,11,1287,348,902,551,11
-1,2,0,-1.0,2.0,0.9107155799865723,7.041594578792296,79,-8,9,1287,348,902,551,11
-1,2,0,-1.0,2.0,0.918750524520874,4.899494936611665,79,-7,7,1287,348,902,551,11
-2,2,0,-2.0,2.0,0.926715612411499,2.0710678118654755,79,-5,5,1287,348,902,551,11
-1,1,0,-1.0,1.0,0.9347126483917236,0.6568542494923806,79,-4,4,1287,348,902,551,11
-1,1,0,-1.0,1.0,0.9425866603851318,-0.7573593128807152,79,-3,3,1287,348,902,551,11
-1,1,0,-1.0,1.0,0.9585955142974854,-2.1715728752538097,79,-2,2,1287,348,902,551,11
-1,0,0,-1.0,-0.0,0.9986636638641357,-2.76393202250021,79,-1,2,1287,348,902,551,11
0,0,1,-0.0,-0.0,1.0247256755828857,-2.76393202250021,79,-1,2,1287,348,902,551,11
0,0,0,-0.0,-0.0,0.10141992568969727,339.11003789627904,80,361,72,1649,418,1288,346,58
-3,1,0,-3.0,1.0,0.16436386108398438,341.85981178876744,80,364,71,1649,418,1288,346,58
-3,1,0,-3.0,1.0,0.17249798774719238,344.61611314288893,80,367,70,1649,418,1288,346,58
-3,2,0,-3.0,2.0,0.18046879768371582,347.19675703014775,80,370,68,1649,418,1288,346,58
-3,1,0,-3.0,1.0,0.18856191635131836,349.96965577734585,80,373,67,1649,418,1288,346,58
-2,1,0,-2.0,1.0,0.19648194313049316,351.76370625362915,80,375,66,1649,418,1288,346,58
-2,2,0,-2.0,2.0,0.20443487167358398,353.39377609997786,80,377,64,1649,418,1288,346,58
0,1,0,-0.0,1.0,0.21247100830078125,353.227680839575,80,377,63,1649,418,1288,346,58
-1,0,0,-1.0,-0.0,0.22038793563842773,354.2140394087878,80,378,63,1649,418,1288,346,58
4,2,0,4.0,2.0,0.26058387756347656,349.9419480606495,80,374,61,1649,418,1288,346,58
6,2,0,6.0,2.0,0.26833581924438477,343.6996109469394,80,368,59,1649,418,1288,346,58
9,2,0,9.0,2.0,0.27678489685058594,334.4969050762331,80,359,57,1649,418,1288,346,58
11,1,0,11.0,1.0,0.28437089920043945,323.4769496009633,80,348,56,1649,418,1288,346,58
12,2,0,12.0,2.0,0.2923409938812256,311.3116218996936,80,336,54,1649,418,1288,346,58
13,1,0,13.0,1.0,0.30044078826904297,298.319415861632,80,323,53,1649,418,1288,346,58
15,2,0,15.0,2.0,0.3085308074951172,283.1938500355188,80,308,51,1649,418,1288,346,58
18,2,0,18.0,2.0,0.3164408206939697,265.11052344314373,80,290,49,1649,418,1288,346,58
17,2,0,17.0,2.0,0.32446885108947754,248.01624501101014,80,273,47,1649,418,1288,346,58
17,3,0,17.0,3.0,0.3324899673461914,230.75372952086752,80,256,44,1649,418,1288,346,58
18,2,0,18.0,2.0,0.3405449390411377,212.67747102284898,80,238,42,1649,418,1288,346,58
19,3,0,19.0,3.0,0.34842681884765625,193.4454989429995,80,219,39,1649,418,1288,346,58
20,2,0,20.0,2.0,0.35637688636779785,173.41047403728888,80,199,37,1649,418,1288,346,58
20,3,0,20.0,3.0,0.36446285247802734,153.20043907740728,80,179,34,1649,418,1288,346,58
19,3,0,19.0,3.0,0.3724648952484131,133.97545827516484,80,160,31,1649,418,1288,346,58
21,4,0,21.0,4.0,0.3804769515991211,112.59802258506295,80,139,27,1649,418,1288,346,58
22,4,0,22.0,4.0,0.3886067867279053,90.23925528113634,80,117,23,1649,418,1288,346,58
22,4,0,22.0,4.0,0.39652490615844727,67.88137075826292,80,95,19,1649,418,1288,346,58
22,4,0,22.0,4.0,0.4045588970184326,45.52516353554684,80,73,15,1649,418,1288,346,58
19,3,0,19.0,3.0,0.41249680519104004,26.317266743757322,80,54,12,1649,418,1288,346,58
13,2,0,13.0,2.0,0.42067694664001465,13.201895692018383,80,41,10,1649,418,1288,346,58
11,2,0,11.0,2.0,0.42839598655700684,2.0483493925200484,80,30,8,1649,418,1288,346,58
8,1,0,8.0,1.0,0.43658900260925293,-5.913207238769608,80,22,7,1649,418,1288,346,58
2,1,0,2.0,1.0,0.44452691078186035,-8.119386982178899,80,20,6,1649,418,1288,346,58
1,0,0,1.0,-0.0,0.4524669647216797,-9.075141154828724,80,19,6,1649,418,1288,346,58
0,0,1,-0.0,-0.0,0.5343899726867676,-9.075141154828724,80,19,6,1649,418,1288,346,58
0,0,0,-0.0,-0.0,0.07503390312194824,804.0166466842378,81,-653,530,977,942,1630,412,75
-2,0,0,-2.0,-0.0,0.14516305923461914,802.464710395857,81,-651,530,977,942,1630,412,75
-3,0,0,-3.0,-0.0,0.1532740592956543,800.1403705472577,81,-648,530,977,942,1630,412,75
-5,0,0,-5.0,-0.0,0.16110706329345703,796.2760646988488,81,-643,530,977,942,1630,412,75
-5,0,0,-5.0,-0.0,0.16912102699279785,792.4238964486133,81,-638,530,977,942,1630,412,75
-4,0,0,-4.0,-0.0,0.17704486846923828,789.3510150051249,81,-634,530,977,942,1630,412,75
-7,1,0,-7.0,1.0,0.1850900650024414,783.3474873491111,81,-627,529,977,942,1630,412,75
-13,2,0,-13.0,2.0,0.1930830478668213,772.1507894082537,81,-614,527,977,942,1630,412,75
-15,2,0,-15.0,2.0,0.20110106468200684,759.5086314661003,81,-599,525,977,942,1630,412,75
-19,4,0,-19.0,4.0,0.20899295806884766,742.6415843193589,81,-580,521,977,942,1630,412,75
-21,6,0,-21.0,6.0,0.21706295013427734,723.0697336429073,81,-559,515,977,942,1630,412,75
-21,7,0,-21.0,7.0,0.22504687309265137,702.9378352267169,81,-538,508,977,942,1630,412,75
-23,8,0,-23.0,8.0,0.2330029010772705,680.7917525299382,81,-515,500,977,942,1630,412,75
-26,8,0,-26.0,8.0,0.24106907844543457,656.6749959455076,81,-489,492,977,942,1630,412,75
-25,11,0,-25.0,11.0,0.24911189079284668,631.3240232102988,81,-464,481,977,942,1630,412,75
-25,10,0,-25.0,10.0,0.2570788860321045,606.864892659943,81,-439,471,977,942,1630,412,75
-22,12,0,-22.0,12.0,0.2650718688964844,583.1370816198624,81,-417,459,977,942,1630,412,75
-22,11,0,-22.0,11.0,0.27309203147888184,560.2679465700465,81,-395,448,977,942,1630,412,75
-19,13,0,-19.0,13.0,0.28107595443725586,537.9791300560395,81,-376,435,977,942,1630,412,75
-19,15,0,-19.0,15.0,0.2895500659942627,514.2249994330808,81,-357,420,977,942,1630,412,75
-17,16,0,-17.0,16.0,0.2970728874206543,491.0303021607756,81,-340,404,977,942,1630,412,75
-19,20,0,-19.0,20.0,0.30506396293640137,463.4967532362223,81,-321,384,977,942,1630,412,75
-17,21,0,-17.0,21.0,0.31312108039855957,436.4817842325088,81,-304,363,977,942,1630,412,75
-17,22,0,-17.0,22.0,0.3209950923919678,408.70169396133105,81,-287,341,977,942,1630,412,75
-16,22,0,-16.0,22.0,0.32909107208251953,381.5713798147217,81,-271,319,977,942,1630,412,75
-15,23,0,-15.0,23.0,0.33707594871520996,354.3463938763203,81,-256,296,977,942,1630,412,75
-12,21,0,-12.0,21.0,0.34508800506591797,330.6424893833682,81,-244,275,977,942,1630,412,75
-12,21,0,-12.0,21.0,0.35306692123413086,307.0058139043583,81,-232,254,977,942,1630,412,75
-11,20,0,-11.0,20.0,0.36101698875427246,284.86487848163864,81,-221,234,977,942,1630,412,75
-11,20,0,-11.0,20.0,0.3690528869628906,262.82661656364,81,-210,214,977,942,1630,412,75
-13,20,0,-13.0,20.0,0.37702202796936035,239.48688938175712,81,-197,194,977,942,1630,412,75
-11,20,0,-11.0,20.0,0.38512587547302246,217.69982332149348,81,-186,174,977,942,1630,412,75
-15,21,0,-15.0,21.0,0.3931739330291748,192.4558781116753,81,-171,153,977,942,1630,412,75
-14,18,0,-14.0,18.0,0.4011199474334717,170.06037766796427,81,-157,135,977,942,1630,412,75
-15,17,0,-15.0,17.0,0.4091219902038574,147.62935844550833,81,-142,118,977,942,1630,412,75
-13,15,0,-13.0,15.0,0.4172079563140869,128.07574019219177,81,-129,103,977,942,1630,412,75
-14,12,0,-14.0,12.0,0.42513608932495117,109.64924138910504,81,-115,91,977,942,1630,412,75
-13,12,0,-13.0,12.0,0.4331319332122803,92.01550294441361,81,-102,79,977,942,1630,412,75
-11,10,0,-11.0,10.0,0.4409749507904053,77.20157617125956,81,-91,69,977,942,1630,412,75
-8,7,0,-8.0,7.0,0.4489419460296631,66.60019305001319,81,-83,62,977,942,1630,412,75
-5,4,0,-5.0,4.0,0.45705294609069824,60.20082304178294,81,-78,58,977,942,1630,412,75
-6,3,0,-6.0,3.0,0.46510791778564453,53.60353193998566,81,-72,55,977,942,1630,412,75
-5,3,0,-5.0,3.0,0.4731919765472412,47.811555816409836,81,-67,52,977,942,1630,412,75
-2,2,0,-2.0,2.0,0.48108887672424316,45.00609733428362,81,-65,50,977,942,1630,412,75
-2,0,0,-2.0,-0.0,0.489063024520874,43.43009387039157,81,-63,50,977,942,1630,412,75
-1,0,0,-1.0,-0.0,0.5209360122680664,42.64923100695951,81,-62,50,977,942,1630,412,75
-1,0,0,-1.0,-0.0,0.5291390419006348,41.87331614684399,81,-61,50,977,942,1630,412,75
-1,-1,0,-1.0,-1.0,0.5370528697967529,41.746428490440124,81,-60,51,977,942,1630,412,75
-2,-1,0,-2.0,-1.0,0.5450699329376221,40.89736837660179,81,-58,52,977,942,1630,412,75
-2,-1,0,-2.0,-1.0,0.5530688762664795,40.10382610480494,81,-56,53,977,942,1630,412,75
-2,-1,0,-2.0,-1.0,0.5609979629516602,39.36753236814714,81,-54,54,977,942,1630,412,75
-3,0,0,-3.0,-0.0,0.5690979957580566,37.27651041883968,81,-51,54,977,942,1630,412,75
-3,-1,0,-3.0,-1.0,0.5778470039367676,36.0,81,-48,55,977,942,1630,412,75
-4,-1,0,-4.0,-1.0,0.5850460529327393,34.21797525905943,81,-44,56,977,942,1630,412,75
-3,-1,0,-3.0,-1.0,0.5930778980255127,33.21395872616783,81,-41,57,977,942,1630,412,75
-3,0,0,-3.0,-0.0,0.6010720729827881,31.505474233815804,81,-38,57,977,942,1630,412,75
-3,0,0,-3.0,-0.0,0.6090788841247559,29.887966032762577,81,-35,57,977,942,1630,412,75
-2,0,0,-2.0,-0.0,0.6170780658721924,28.86349520030045,81,-33,57,977,942,1630,412,75
-2,0,0,-2.0,-0.0,0.6250660419464111,27.88451279003334,81,-31,57,977,942,1630,412,75
-1,0,0,-1.0,-0.0,0.6410810947418213,27.41273166075166,81,-30,57,977,942,1630,412,75
-2,0,0,-2.0,-0.0,0.6490259170532227,26.50590523722971,81,-28,57,977,942,1630,412,75
-1,1,0,-1.0,1.0,0.6569929122924805,25.16912416947821,81,-27,56,977,942,1630,412,75
-4,2,0,-4.0,2.0,0.6650419235229492,21.694122363316758,81,-23,54,977,942,1630,412,75
-4,3,0,-4.0,3.0,0.6729819774627686,17.42425929675111,81,-19,51,977,942,1630,412,75
-4,5,0,-4.0,5.0,0.681196928024292,11.383881613611777,81,-15,46,977,942,1630,412,75
-3,4,0,-3.0,4.0,0.6890809535980225,6.68065933568311,81,-12,42,977,942,1630,412,75
-3,5,0,-3.0,5.0,0.6970770359039307,1.0788655293195433,81,-9,37,977,942,1630,412,75
-4,5,0,-4.0,5.0,0.7051239013671875,-4.611730518596708,81,-5,32,977,942,1630,412,75
0,0,1,-0.0,-0.0,0.7082500457763672,-4.611730518596708,81,-5,32,977,942,1630,412,75
-3,4,1,-3.0,4.0,0.0010030269622802734,854.4712359316705,82,-114,-866,865,48,982,910,38
-3,3,1,-3.0,3.0,0.009067058563232422,857.0605001939078,82,-111,-869,865,48,982,910,38
-3,3,1,-3.0,3.0,0.01683807373046875,859.6626201221945,82,-108,-872,865,48,982,910,38
-2,1,1,-2.0,1.0,0.024885892868041992,860.41173519575,82,-106,-873,865,48,982,910,38
0,0,0,-0.0,-0.0,0.1082160472869873,860.41173519575,82,-106,-873,865,48,982,910,38
-2,-3,0,-2.0,-3.0,0.20097684860229492,857.1940424358065,82,-104,-870,865,48,982,910,38
-4,-8,0,-4.0,-8.0,0.20902490615844727,848.7810783832522,82,-100,-862,865,48,982,910,38
-9,-16,0,-9.0,-16.0,0.21699786186218262,831.8801325686245,82,-91,-846,865,48,982,910,38
-11,-21,0,-11.0,-21.0,0.22499895095825195,809.8697123191316,82,-80,-825,865,48,982,910,38
-15,-26,0,-15.0,-26.0,0.23319101333618164,782.639569881627,82,-65,-799,865,48,982,910,38
-14,-29,0,-14.0,-29.0,0.24094605445861816,752.6871127600875,82,-51,-770,865,48,982,910,38
-13,-34,0,-13.0,-34.0,0.2488858699798584,717.9803253818924,82,-38,-736,865,48,982,910,38
-12,-37,0,-12.0,-37.0,0.2569260597229004,680.4833807889935,82,-26,-699,865,48,982,910,38
-9,-39,0,-9.0,-39.0,0.2649219036102295,641.2189030919972,82,-17,-660,865,48,982,910,38
-7,-41,0,-7.0,-41.0,0.27298903465270996,600.0807701746195,82,-10,-619,865,48,982,910,38
-6,-38,0,-6.0,-38.0,0.28090500831604004,562.0137692000079,82,-4,-581,865,48,982,910,38
-4,-39,0,-4.0,-39.0,0.288970947265625,523.0,82,0,-542,865,48,982,910,38
-3,-39,0,-3.0,-39.0,0.29712891578674316,484.0089462425097,82,3,-503,865,48,982,910,38
-2,-39,0,-2.0,-39.0,0.3050260543823242,445.02693887316497,82,5,-464,865,48,982,910,38
-2,-36,0,-2.0,-36.0,0.31301188468933105,409.05723916317544,82,7,-428,865,48,982,910,38
-2,-33,0,-2.0,-33.0,0.32093000411987305,376.102518341759,82,9,-395,865,48,982,910,38
-1,-29,0,-1.0,-29.0,0.3289680480957031,347.1365865356807,82,10,-366,865,48,982,910,38
-1,-24,0,-1.0,-24.0,0.3370089530944824,323.1768548572507,82,11,-342,865,48,982,910,38
0,-22,0,-0.0,-22.0,0.34502100944519043,301.18900668199086,82,11,-320,865,48,982,910,38
1,-19,0,1.0,-19.0,0.35297703742980957,282.16606714568627,82,10,-301,865,48,982,910,38
3,-15,0,3.0,-15.0,0.36102890968322754,267.08565151017274,82,7,-286,865,48,982,910,38
3,-13,0,3.0,-13.0,0.36899805068969727,254.02930245671433,82,4,-273,865,48,982,910,38
4,-11,0,4.0,-11.0,0.3769199848175049,243.0,82,0,-262,865,48,982,910,38
3,-10,0,3.0,-10.0,0.38490986824035645,233.01785651020842,82,-3,-252,865,48,982,910,38
2,-10,0,2.0,-10.0,0.39284205436706543,223.05164738129753,82,-5,-242,865,48,982,910,38
3,-9,0,3.0,-9.0,0.4008769989013672,214.13729860320507,82,-8,-233,865,48,982,910,38
2,-9,0,2.0,-9.0,0.4091179370880127,205.22310318073826,82,-10,-224,865,48,982,910,38
2,-9,0,2.0,-9.0,0.41684985160827637,196.3346233191495,82,-12,-215,865,48,982,910,38
2,-8,0,2.0,-8.0,0.42499804496765137,188.4728897952694,82,-14,-207,865,48,982,910,38
2,-6,0,2.0,-6.0,0.43302488327026367,182.63581031156147,82,-16,-201,865,48,982,910,38
2,-7,0,2.0,-7.0,0.440993070602417,175.83326204732086,82,-18,-194,865,48,982,910,38
2,-7,0,2.0,-7.0,0.4490020275115967,169.06647760831805,82,-20,-187,865,48,982,910,38
2,-8,0,2.0,-8.0,0.45687103271484375,161.34688796871433,82,-22,-179,865,48,982,910,38
3,-8,0,3.0,-8.0,0.465069055557251,153.81782315490494,82,-25,-171,865,48,982,910,38
2,-8,0,2.0,-8.0,0.4728419780731201,146.22106403240477,82,-27,-163,865,48,982,910,38
2,-8,0,2.0,-8.0,0.4809088706970215,138.68956845650888,82,-29,-155,865,48,982,910,38
1,-7,0,1.0,-7.0,0.48885202407836914,132.00993344810135,82,-30,-148,865,48,982,910,38
1,-7,0,1.0,-7.0,0.49701499938964844,125.36758638974331,82,-31,-141,865,48,982,910,38
0,-6,0,-0.0,-6.0,0.5050039291381836,119.51353724455961,82,-31,-135,865,48,982,910,38
1,-6,0,1.0,-6.0,0.5129730701446533,113.90974381135493,82,-32,-129,865,48,982,910,38
0,-6,0,-0.0,-6.0,0.5210249423980713,108.09445306542689,82,-32,-123,865,48,982,910,38
1,-5,0,1.0,-5.0,0.5289449691772461,103.5275479229059,82,-33,-118,865,48,982,910,38
1,-5,0,1.0,-5.0,0.5369629859924316,99.00423721205946,82,-34,-113,865,48,982,910,38
0,-5,0,-0.0,-5.0,0.5448708534240723,94.22543883774529,82,-34,-108,865,48,982,910,38
1,-4,0,1.0,-4.0,0.5529458522796631,90.73149046650191,82,-35,-104,865,48,982,910,38
1,-3,0,1.0,-3.0,0.5609729290008545,88.2240644631605,82,-36,-101,865,48,982,910,38
0,-5,0,-0.0,-5.0,0.5691268444061279,83.52804494381037,82,-36,-96,865,48,982,910,38
1,-5,0,1.0,-5.0,0.5770349502563477,79.2344135219425,82,-37,-91,865,48,982,910,38
0,-6,0,-0.0,-6.0,0.5850310325622559,73.70382947861431,82,-37,-85,865,48,982,910,38
0,-6,0,-0.0,-6.0,0.5930919647216797,68.23531395025755,82,-37,-79,865,48,982,910,38
0,-6,0,-0.0,-6.0,0.6010580062866211,62.8413098624405,82,-37,-73,865,48,982,910,38
-1,-7,0,-1.0,-7.0,0.6089859008789062,56.179784516850006,82,-36,-66,865,48,982,910,38
-2,-7,0,-2.0,-7.0,0.6169350147247314,49.095521144932874,82,-34,-59,865,48,982,910,38
-1,-6,0,-1.0,-6.0,0.6248888969421387,43.433965115151864,82,-33,-53,865,48,982,910,38
-2,-6,0,-2.0,-6.0,0.6329479217529297,37.302753041036986,82,-31,-47,865,48,982,910,38
-1,-5,0,-1.0,-5.0,0.64096999168396,32.61395160225576,82,-30,-42,865,48,982,910,38
-1,-5,0,-1.0,-5.0,0.648921012878418,28.010637094172637,82,-29,-37,865,48,982,910,38
-1,-4,0,-1.0,-4.0,0.6569728851318359,24.278170016764804,82,-28,-33,865,48,982,910,38
-2,-5,0,-2.0,-5.0,0.6650478839874268,19.209946349085598,82,-26,-28,865,48,982,910,38
-1,-4,0,-1.0,-4.0,0.6729769706726074,15.655446902326915,82,-25,-24,865,48,982,910,38
-2,-5,0,-2.0,-5.0,0.6808450222015381,10.832867780352597,82,-23,-19,865,48,982,910,38
-2,-4,0,-2.0,-4.0,0.68892502784729,6.80697580112788,82,-21,-15,865,48,982,910,38
-2,-5,0,-2.0,-5.0,0.6968469619750977,2.470910553583888,82,-19,-10,865,48,982,910,38
-1,-3,0,-1.0,-3.0,0.7049038410186768,0.3132079158279666,82,-18,-7,865,48,982,910,38
-1,-2,0,-1.0,-2.0,0.7129659652709961,-1.2799548533306506,82,-17,-5,865,48,982,910,38
0,-1,0,-0.0,-1.0,0.7209689617156982,-1.535750803427021,82,-17,-4,865,48,982,910,38
-1,0,0,-1.0,-0.0,0.7289309501647949,-2.5075774975293577,82,-16,-4,865,48,982,910,38
0,-1,0,-0.0,-1.0,0.7369718551635742,-2.721179403900294,82,-16,-3,865,48,982,910,38
0,0,1,-0.0,-0.0,0.7419018745422363,-2.721179403900294,82,-16,-3,865,48,982,910,38
0,0,0,-0.0,-0.0,0.07516741752624512,909.8189388801229,83,95,934,976,985,881,51,59
-2,0,0,-2.0,-0.0,0.19210243225097656,910.0234288876928,83,97,934,976,985,881,51,59
-5,3,0,-5.0,3.0,0.20020151138305664,907.5708729188625,83,102,931,976,985,881,51,59
-7,5,0,-7.0,5.0,0.20813655853271484,903.3931574180497,83,109,926,976,985,881,51,59
-3,10,0,-3.0,10.0,0.21612548828125,893.8217596047463,83,112,916,976,985,881,51,59
0,13,0,-0.0,13.0,0.2240893840789795,880.9192271844793,83,112,903,976,985,881,51,59
2,18,0,2.0,18.0,0.2320084571838379,862.8099573339603,83,110,885,976,985,881,51,59
5,20,0,5.0,20.0,0.2400975227355957,842.3495280310881,83,105,865,976,985,881,51,59
6,20,0,6.0,20.0,0.248030424118042,821.7796424456806,83,99,845,976,985,881,51,59
5,20,0,5.0,20.0,0.25614452362060547,801.3378830331662,83,94,825,976,985,881,51,59
7,21,0,7.0,21.0,0.26413750648498535,779.6933905999232,83,87,804,976,985,881,51,59
5,22,0,5.0,22.0,0.27216458320617676,757.2874792338995,83,82,782,976,985,881,51,59
4,24,0,4.0,24.0,0.280193567276001,733.0026246673957,83,78,758,976,985,881,51,59
4,27,0,4.0,27.0,0.28811144828796387,705.7360070120424,83,74,731,976,985,881,51,59
2,29,0,2.0,29.0,0.29610753059387207,676.6826482208558,83,72,702,976,985,881,51,59
2,32,0,2.0,32.0,0.30403852462768555,644.6467917239717,83,70,670,976,985,881,51,59
2,33,0,2.0,33.0,0.31201744079589844,611.6192316813475,83,68,637,976,985,881,51,59
1,34,0,1.0,34.0,0.3200204372406006,577.7108042552069,83,67,603,976,985,881,51,59
3,36,0,3.0,36.0,0.32802438735961914,541.6005608129035,83,64,567,976,985,881,51,59
3,37,0,3.0,37.0,0.3361194133758545,504.4988284898103,83,61,530,976,985,881,51,59
4,36,0,4.0,36.0,0.3441305160522461,468.2775884754912,83,57,494,976,985,881,51,59
5,33,0,5.0,33.0,0.3522014617919922,434.9234850705448,83,52,461,976,985,881,51,59
5,31,0,5.0,31.0,0.36026740074157715,403.560978360277,83,47,430,976,985,881,51,59
3,31,0,3.0,31.0,0.3681066036224365,372.4187339923238,83,44,399,976,985,881,51,59
2,28,0,2.0,28.0,0.37612247467041016,344.36978988664845,83,42,371,976,985,881,51,59
1,25,0,1.0,25.0,0.3840055465698242,319.4207226902556,83,41,346,976,985,881,51,59
1,23,0,1.0,23.0,0.39203357696533203,296.46735627402023,83,40,323,976,985,881,51,59
0,21,0,-0.0,21.0,0.40006041526794434,275.63748948545384,83,40,302,976,985,881,51,59
0,23,0,-0.0,23.0,0.4081284999847412,252.85279846047297,83,40,279,976,985,881,51,59
0,22,0,-0.0,22.0,0.41620850563049316,231.09421369957465,83,40,257,976,985,881,51,59
0,21,0,-0.0,21.0,0.42423558235168457,210.3658288060349,83,40,236,976,985,881,51,59
1,19,0,1.0,19.0,0.43215346336364746,191.47675614449702,83,39,217,976,985,881,51,59
1,16,0,1.0,16.0,0.44004058837890625,175.56050449683585,83,38,201,976,985,881,51,59
1,14,0,1.0,14.0,0.44809937477111816,161.62528688503002,83,37,187,976,985,881,51,59
1,11,0,1.0,11.0,0.45602941513061523,150.64409258308496,83,36,176,976,985,881,51,59
0,12,0,-0.0,12.0,0.46407151222229004,138.90473489452285,83,36,164,976,985,881,51,59
0,11,0,-0.0,11.0,0.4721555709838867,128.17824276915684,83,36,153,976,985,881,51,59
0,12,0,-0.0,12.0,0.48015451431274414,116.52319402761884,83,36,141,976,985,881,51,59
-1,12,0,-1.0,12.0,0.48833537101745605,105.20134127496641,83,37,129,976,985,881,51,59
0,11,0,-0.0,11.0,0.4961094856262207,94.664869708418,83,37,118,976,985,881,51,59
1,14,0,1.0,14.0,0.5041365623474121,81.05453193758083,83,36,104,976,985,881,51,59
4,13,0,4.0,13.0,0.5122275352478027,67.46242791885346,83,32,91,976,985,881,51,59
4,12,0,4.0,12.0,0.5202593803405762,54.81527307120105,83,28,79,976,985,881,51,59
4,11,0,4.0,11.0,0.5282034873962402,43.111025509279784,83,24,68,976,985,881,51,59
6,10,0,6.0,10.0,0.5361275672912598,31.728905802755904,83,18,58,976,985,881,51,59
5,8,0,5.0,8.0,0.5440795421600342,22.662365412357957,83,13,50,976,985,881,51,59
5,7,0,5.0,7.0,0.552154541015625,14.737855457258078,83,8,43,976,985,881,51,59
3,5,0,3.0,5.0,0.5602025985717773,9.3275357934736,83,5,38,976,985,881,51,59
1,3,0,1.0,3.0,0.5681235790252686,6.227829907617071,83,4,35,976,985,881,51,59
1,3,0,1.0,3.0,0.5761353969573975,3.140317359976393,83,3,32,976,985,881,51,59
1,4,0,1.0,4.0,0.5840234756469727,-0.928662304763602,83,2,28,976,985,881,51,59
0,4,0,-0.0,4.0,0.5920333862304688,-4.9168108424154084,83,2,24,976,985,881,51,59
1,4,0,1.0,4.0,0.5999953746795654,-8.975015605499213,83,1,20,976,985,881,51,59
0,2,0,-0.0,2.0,0.6081874370574951,-10.972243622680054,83,1,18,976,985,881,51,59
0,2,0,-0.0,2.0,0.616269588470459,-12.968780458118601,83,1,16,976,985,881,51,59
0,1,0,-0.0,1.0,0.6241674423217773,-13.966703621627092,83,1,15,976,985,881,51,59
0,0,1,-0.0,-0.0,0.7051665782928467,-13.966703621627092,83,1,15,976,985,881,51,59
0,0,0,-0.0,-0.0,0.06159663200378418,867.7951230391823,84,-808,-363,167,607,975,970,37
0,-3,0,-0.0,-3.0,0.12975764274597168,866.5699520105801,84,-808,-360,167,607,975,970,37
0,-7,0,-0.0,-7.0,0.13774847984313965,863.7442939991163,84,-808,-353,167,607,975,970,37
2,-9,0,2.0,-9.0,0.14575648307800293,862.0204543077393,84,-810,-344,167,607,975,970,37
2,-9,0,2.0,-9.0,0.15372848510742188,860.3900044968635,84,-812,-335,167,607,975,970,37
2,-13,0,2.0,-13.0,0.1617755889892578,857.3742056971978,84,-814,-322,167,607,975,970,37
0,-17,0,-0.0,-17.0,0.16971564292907715,851.2646317434064,84,-814,-305,167,607,975,970,37
-2,-20,0,-2.0,-20.0,0.1776435375213623,842.5631876858317,84,-812,-285,167,607,975,970,37
-6,-21,0,-6.0,-21.0,0.18563342094421387,830.1344233080036,84,-806,-264,167,607,975,970,37
-9,-18,0,-9.0,-18.0,0.1937575340270996,816.1013127911981,84,-797,-246,167,607,975,970,37
-12,-18,0,-12.0,-18.0,0.20169353485107422,799.4405177136744,84,-785,-228,167,607,975,970,37
-14,-15,0,-14.0,-15.0,0.20978450775146484,781.8812411852149,84,-771,-213,167,607,975,970,37
-17,-14,0,-17.0,-14.0,0.2177424430847168,761.8185686427324,84,-754,-199,167,607,975,970,37
-18,-11,0,-18.0,-11.0,0.22570562362670898,741.6314896053217,84,-736,-188,167,607,975,970,37
-20,-10,0,-20.0,-10.0,0.23385262489318848,719.7940091922677,84,-716,-178,167,607,975,970,37
-23,-8,0,-23.0,-8.0,0.24169063568115234,695.5467749208877,84,-693,-170,167,607,975,970,37
-25,-8,0,-25.0,-8.0,0.2497246265411377,669.3630772743035,84,-668,-162,167,607,975,970,37
-30,-7,0,-30.0,-7.0,0.2576456069946289,638.5584513202157,84,-638,-155,167,607,975,970,37
-30,-5,0,-30.0,-5.0,0.26577162742614746,608.2299897002698,84,-608,-150,167,607,975,970,37
-35,-5,0,-35.0,-5.0,0.2737255096435547,573.0617565026517,84,-573,-145,167,607,975,970,37
-34,-4,0,-34.0,-4.0,0.28173255920410156,539.1373259798701,84,-539,-141,167,607,975,970,37
-36,-4,0,-36.0,-4.0,0.289717435836792,503.3233161867978,84,-503,-137,167,607,975,970,37
-34,-4,0,-34.0,-4.0,0.29772257804870605,469.4935897014442,84,-469,-133,167,607,975,970,37
-32,-5,0,-32.0,-5.0,0.3055715560913086,437.3602969078442,84,-437,-128,167,607,975,970,37
-30,-5,0,-30.0,-5.0,0.3137476444244385,407.17996189848833,84,-407,-123,167,607,975,970,37
-29,-6,0,-29.0,-6.0,0.3216235637664795,377.693062865651,84,-378,-117,167,607,975,970,37
-28,-6,0,-28.0,-6.0,0.3295705318450928,349.17979247229823,84,-350,-111,167,607,975,970,37
-27,-7,0,-27.0,-7.0,0.33766746520996094,321.3302226445502,84,-323,-104,167,607,975,970,37
-27,-6,0,-27.0,-6.0,0.3457155227661133,293.8012187275733,84,-296,-98,167,607,975,970,37
-24,-5,0,-24.0,-5.0,0.35365843772888184,269.4595623735624,84,-272,-93,167,607,975,970,37
-21,-5,0,-21.0,-5.0,0.36174464225769043,247.9793225045887,84,-251,-88,167,607,975,970,37
-19,-3,0,-19.0,-3.0,0.3697054386138916,229.08095839218367,84,-232,-85,167,607,975,970,37
-15,-1,0,-15.0,-1.0,0.37786149978637695,214.69078194032525,84,-217,-84,167,607,975,970,37
-13,-3,0,-13.0,-3.0,0.38562750816345215,201.49259668608414,84,-204,-81,167,607,975,970,37
-12,-2,0,-12.0,-2.0,0.3936126232147217,189.6174366473105,84,-192,-79,167,607,975,970,37
-11,-2,0,-11.0,-2.0,0.4016425609588623,178.69773765857096,84,-181,-77,167,607,975,970,37
-12,-2,0,-12.0,-2.0,0.4098374843597412,166.89456454963732,84,-169,-75,167,607,975,970,37
-14,-3,0,-14.0,-3.0,0.417682409286499,152.90640713560157,84,-155,-72,167,607,975,970,37
-13,-4,0,-13.0,-4.0,0.42568445205688477,139.4420528321452,84,-142,-68,167,607,975,970,37
-11,-4,0,-11.0,-4.0,0.4337046146392822,127.79780519610026,84,-131,-64,167,607,975,970,37
-9,-4,0,-9.0,-4.0,0.4417085647583008,117.95587519485872,84,-122,-60,167,607,975,970,37
-7,-5,0,-7.0,-5.0,0.44972944259643555,109.47548783981962,84,-115,-55,167,607,975,970,37
-7,-4,0,-7.0,-4.0,0.45764946937561035,101.4361754243663,84,-108,-51,167,607,975,970,37
-6,-4,0,-6.0,-4.0,0.46569156646728516,94.30761327710601,84,-102,-47,167,607,975,970,37
-6,-4,0,-6.0,-4.0,0.4735894203186035,87.19030373565806,84,-96,-43,167,607,975,970,37
-7,-4,0,-7.0,-4.0,0.48161864280700684,79.16995420396162,84,-89,-39,167,607,975,970,37
-5,-4,0,-5.0,-4.0,0.48967742919921875,73.0,84,-84,-35,167,607,975,970,37
-5,-3,0,-5.0,-3.0,0.49784064292907715,67.23496934944014,84,-79,-32,167,607,975,970,37
-3,-3,0,-3.0,-3.0,0.5057625770568848,63.344944526380985,84,-76,-29,167,607,975,970,37
-4,-2,0,-4.0,-2.0,0.5137584209442139,58.89603370785778,84,-72,-27,167,607,975,970,37
-2,-2,0,-2.0,-2.0,0.5217056274414062,56.330343736592525,84,-70,-25,167,607,975,970,37
-2,-2,0,-2.0,-2.0,0.5297136306762695,53.78439941937245,84,-68,-23,167,607,975,970,37
-3,-2,0,-3.0,-2.0,0.5376865863800049,50.30812543175226,84,-65,-21,167,607,975,970,37
-3,-2,0,-3.0,-2.0,0.5457205772399902,46.8459713474939,84,-62,-19,167,607,975,970,37
-2,-2,0,-2.0,-2.0,0.5537276268005371,44.36184731067546,84,-60,-17,167,607,975,970,37
-3,-1,0,-3.0,-1.0,0.5617566108703613,41.20304046246274,84,-57,-16,167,607,975,970,37
-2,-3,0,-2.0,-3.0,0.5695915222167969,38.515484603779164,84,-55,-13,167,607,975,970,37
-3,-2,0,-3.0,-2.0,0.5778124332427979,35.150729063673246,84,-52,-11,167,607,975,970,37
-3,-2,0,-3.0,-2.0,0.5857014656066895,31.8196748283246,84,-49,-9,167,607,975,970,37
-4,-2,0,-4.0,-2.0,0.5936124324798584,27.541190146942803,84,-45,-7,167,607,975,970,37
-3,-1,0,-3.0,-1.0,0.6017346382141113,24.426406871192853,84,-42,-6,167,607,975,970,37
-3,-1,0,-3.0,-1.0,0.6096775531768799,21.319206502675,84,-39,-5,167,607,975,970,37
-2,-1,0,-2.0,-1.0,0.6176955699920654,19.21558813185679,84,-37,-4,167,607,975,970,37
-3,-1,0,-3.0,-1.0,0.6257774829864502,16.132096331752024,84,-34,-3,167,607,975,970,37
-2,0,0,-2.0,-0.0,0.6338975429534912,14.140317359976393,84,-32,-3,167,607,975,970,37
-2,-1,0,-2.0,-1.0,0.6416184902191162,12.066592756745816,84,-30,-2,167,607,975,970,37
-3,0,0,-3.0,-0.0,0.6497986316680908,9.073972741361768,84,-27,-2,167,607,975,970,37
-2,-1,0,-2.0,-1.0,0.6576104164123535,7.019992006393608,84,-25,-1,167,607,975,970,37
-2,-1,0,-2.0,-1.0,0.6656036376953125,5.0,84,-23,0,167,607,975,970,37
-2,0,0,-2.0,-0.0,0.6736536026000977,3.0,84,-21,0,167,607,975,970,37
-1,0,0,-1.0,-0.0,0.6816534996032715,2.0,84,-20,0,167,607,975,970,37
-2,0,0,-2.0,-0.0,0.6896364688873291,0.0,84,-18,0,167,607,975,970,37
-1,-1,0,-1.0,-1.0,0.6976604461669922,-0.9706136340735974,84,-17,1,167,607,975,970,37
-2,0,0,-2.0,-0.0,0.7056314945220947,-2.966703621627092,84,-15,1,167,607,975,970,37
-2,-1,0,-2.0,-1.0,0.7138185501098633,-4.847053562034095,84,-13,2,167,607,975,970,37
-1,0,0,-1.0,-0.0,0.7216475009918213,-5.834474939403561,84,-12,2,167,607,975,970,37
-2,0,0,-2.0,-0.0,0.7295675277709961,-7.801960972814431,84,-10,2,167,607,975,970,37
-1,0,0,-1.0,-0.0,0.7376694679260254,-8.780455542707113,84,-9,2,167,607,975,970,37
-1,0,0,-1.0,-0.0,0.7456455230712891,-9.753788748764679,84,-8,2,167,607,975,970,37
0,0,1,-0.0,-0.0,0.750422477722168,-9.753788748764679,84,-8,2,167,607,975,970,37
0,0,0,-0.0,-0.0,0.07772088050842285,1533.8322614361525,85,1563,123,1738,728,175,605,68
3,0,0,3.0,-0.0,0.09473395347595215,1530.8415255226325,85,1560,123,1738,728,175,605,68
5,0,0,5.0,-0.0,0.10289883613586426,1525.8570447319844,85,1555,123,1738,728,175,605,68
7,0,0,7.0,-0.0,0.11081099510192871,1518.8789392608815,85,1548,123,1738,728,175,605,68
10,0,0,10.0,-0.0,0.11873292922973633,1508.910561244559,85,1538,123,1738,728,175,605,68
12,0,0,12.0,-0.0,0.12680983543395996,1496.9490520588854,85,1526,123,1738,728,175,605,68
15,-2,0,15.0,-2.0,0.13470888137817383,1482.161600885605,85,1511,125,1738,728,175,605,68
19,-1,0,19.0,-1.0,0.1428217887878418,1463.3109229548818,85,1492,126,1738,728,175,605,68
19,-2,0,19.0,-2.0,0.1507399082183838,1444.5509798447938,85,1473,128,1738,728,175,605,68
20,-1,0,20.0,-1.0,0.1587378978729248,1424.7151881021873,85,1453,129,1738,728,175,605,68
20,-1,0,20.0,-1.0,0.16681790351867676,1404.8846374883567,85,1433,130,1738,728,175,605,68
19,0,0,19.0,-0.0,0.17474985122680664,1385.9633798094935,85,1414,130,1738,728,175,605,68
20,0,0,20.0,-0.0,0.18283390998840332,1366.048570586035,85,1394,130,1738,728,175,605,68
19,2,0,19.0,2.0,0.1907198429107666,1346.944966318354,85,1375,128,1738,728,175,605,68
20,2,0,20.0,2.0,0.1987760066986084,1326.8456929424437,85,1355,126,1738,728,175,605,68
22,2,0,22.0,2.0,0.2068338394165039,1304.7550186647295,85,1333,124,1738,728,175,605,68
21,4,0,21.0,4.0,0.21483087539672852,1283.476375499766,85,1312,120,1738,728,175,605,68
23,3,0,23.0,3.0,0.222977876663208,1260.29903808973,85,1289,117,1738,728,175,605,68
27,5,0,27.0,5.0,0.2307579517364502,1232.9601414409215,85,1262,112,1738,728,175,605,68
29,6,0,29.0,6.0,0.23916888236999512,1203.5479788678902,85,1233,106,1738,728,175,605,68
29,5,0,29.0,5.0,0.24695777893066406,1174.2288690475823,85,1204,101,1738,728,175,605,68
34,6,0,34.0,6.0,0.2547118663787842,1139.850501554606,85,1170,95,1738,728,175,605,68
38,6,0,38.0,6.0,0.26277780532836914,1101.4932848766655,85,1132,89,1738,728,175,605,68
44,7,0,44.0,7.0,0.270953893661499,1057.085697825794,85,1088,82,1738,728,175,605,68
50,8,0,50.0,8.0,0.27881598472595215,1006.6344218792688,85,1038,74,1738,728,175,605,68
53,9,0,53.0,9.0,0.28687191009521484,953.142340293435,85,985,65,1738,728,175,605,68
52,8,0,52.0,8.0,0.2949669361114502,900.7395359136148,85,933,57,1738,728,175,605,68
53,8,0,53.0,8.0,0.30306482315063477,847.363148764458,85,880,49,1738,728,175,605,68
52,8,0,52.0,8.0,0.3108518123626709,795.0144751450363,85,828,41,1738,728,175,605,68
50,8,0,50.0,8.0,0.3188459873199463,744.6995569537714,85,778,33,1738,728,175,605,68
48,7,0,48.0,7.0,0.3268289566040039,696.4628669549193,85,730,26,1738,728,175,605,68
47,7,0,47.0,7.0,0.33512282371520996,649.2642241475841,85,683,19,1738,728,175,605,68
43,7,0,43.0,7.0,0.3428468704223633,606.1124901140424,85,640,12,1738,728,175,605,68
39,6,0,39.0,6.0,0.35085177421569824,567.0299493369694,85,601,6,1738,728,175,605,68
36,5,0,36.0,5.0,0.3588588237762451,531.0008849550592,85,565,1,1738,728,175,605,68
33,4,0,33.0,4.0,0.36704397201538086,498.0084585793726,85,532,-3,1738,728,175,605,68
30,4,0,30.0,4.0,0.3749709129333496,468.04880240869016,85,502,-7,1738,728,175,605,68
28,2,0,28.0,2.0,0.38294386863708496,440.08543533839975,85,474,-9,1738,728,175,605,68
26,2,0,26.0,2.0,0.3908388614654541,414.13502429513363,85,448,-11,1738,728,175,605,68
23,1,0,23.0,1.0,0.3988528251647949,391.1693780130455,85,425,-12,1738,728,175,605,68
19,0,0,19.0,-0.0,0.40687990188598633,372.1773011875479,85,406,-12,1738,728,175,605,68
16,0,0,16.0,-0.0,0.41484498977661133,356.1845717093386,85,390,-12,1738,728,175,605,68
14,0,0,14.0,-0.0,0.4227869510650635,342.19144062564743,85,376,-12,1738,728,175,605,68
12,0,0,12.0,-0.0,0.43093395233154297,330.1977484828812,85,364,-12,1738,728,175,605,68
12,0,0,12.0,-0.0,0.43892884254455566,318.20448605888026,85,352,-12,1738,728,175,605,68
11,0,0,11.0,-0.0,0.44691896438598633,307.2110783664563,85,341,-12,1738,728,175,605,68
12,0,0,12.0,-0.0,0.45494794845581055,295.21877224727024,85,329,-12,1738,728,175,605,68
12,-1,0,12.0,-1.0,0.4629678726196289,283.1907943178679,85,317,-11,1738,728,175,605,68
12,-1,0,12.0,-1.0,0.4708549976348877,271.16389039334257,85,305,-10,1738,728,175,605,68
11,-2,0,11.0,-2.0,0.47887682914733887,260.10882339705483,85,294,-8,1738,728,175,605,68
11,-1,0,11.0,-1.0,0.48691892623901367,249.08655920053855,85,283,-7,1738,728,175,605,68
9,-2,0,9.0,-2.0,0.49485278129577637,240.04561664073373,85,274,-5,1738,728,175,605,68
9,-1,0,9.0,-1.0,0.5028479099273682,231.03018695990085,85,265,-4,1738,728,175,605,68
10,0,0,10.0,-0.0,0.5108819007873535,221.03137061938085,85,255,-4,1738,728,175,605,68
11,0,0,11.0,-0.0,0.5188348293304443,210.0327846827143,85,244,-4,1738,728,175,605,68
13,0,0,13.0,-0.0,0.5268769264221191,197.03462943896528,85,231,-4,1738,728,175,605,68
12,1,0,12.0,1.0,0.5348269939422607,185.0570701894828,85,219,-5,1738,728,175,605,68
14,1,0,14.0,1.0,0.542853832244873,171.08778608196053,85,205,-6,1738,728,175,605,68
14,1,0,14.0,1.0,0.5509088039398193,157.12822920751398,85,191,-7,1738,728,175,605,68
14,1,0,14.0,1.0,0.5588588714599609,143.18069872308325,85,177,-8,1738,728,175,605,68
14,1,0,14.0,1.0,0.5669968128204346,129.24827717314508,85,163,-9,1738,728,175,605,68
11,0,0,11.0,-0.0,0.5749399662017822,118.26621424334422,85,152,-9,1738,728,175,605,68
10,0,0,10.0,-0.0,0.5827808380126953,108.28492541376264,85,142,-9,1738,728,175,605,68
9,0,0,9.0,-0.0,0.5908269882202148,99.30416347586447,85,133,-9,1738,728,175,605,68
7,0,0,7.0,-0.0,0.5988848209381104,92.3210196285638,85,126,-9,1738,728,175,605,68
7,0,0,7.0,-0.0,0.6069707870483398,85.33985084622823,85,119,-9,1738,728,175,605,68
6,0,0,6.0,-0.0,0.6148748397827148,79.35784048754634,85,113,-9,1738,728,175,605,68
5,0,0,5.0,-0.0,0.6228358745574951,74.37435120913067,85,108,-9,1738,728,175,605,68
4,0,0,4.0,-0.0,0.6309089660644531,70.38869670610895,85,104,-9,1738,728,175,605,68
6,0,0,6.0,-0.0,0.6389439105987549,64.41239759298622,85,98,-9,1738,728,175,605,68
5,0,0,5.0,-0.0,0.6468548774719238,59.43446901438462,85,93,-9,1738,728,175,605,68
4,0,0,4.0,-0.0,0.6548528671264648,55.453898741195175,85,89,-9,1738,728,175,605,68
3,0,0,3.0,-0.0,0.6628758907318115,52.469647854030256,85,86,-9,1738,728,175,605,68
2,0,0,2.0,-0.0,0.6708149909973145,50.48076704197234,85,84,-9,1738,728,175,605,68
4,-1,0,4.0,-1.0,0.678790807723999,46.39900496896712,85,80,-8,1738,728,175,605,68
5,-1,0,5.0,-1.0,0.6868569850921631,41.32595834106593,85,75,-7,1738,728,175,605,68
5,-1,0,5.0,-1.0,0.6948978900909424,36.25667228100119,85,70,-6,1738,728,175,605,68
7,-1,0,7.0,-1.0,0.7029359340667725,29.198101237299845,85,63,-5,1738,728,175,605,68
5,-1,0,5.0,-1.0,0.7108860015869141,24.137767414994535,85,58,-4,1738,728,175,605,68
5,-1,0,5.0,-1.0,0.7188618183135986,19.084837759947987,85,53,-3,1738,728,175,605,68
3,-1,0,3.0,-1.0,0.7269129753112793,16.039984012787215,85,50,-2,1738,728,175,605,68
4,-1,0,4.0,-1.0,0.7349469661712646,12.010868281309364,85,46,-1,1738,728,175,605,68
3,-1,0,3.0,-1.0,0.7428798675537109,9.0,85,43,0,1738,728,175,605,68
4,-1,0,4.0,-1.0,0.7511348724365234,5.012818406262319,85,39,1,1738,728,175,605,68
1,0,0,1.0,-0.0,0.7588849067687988,4.013155617496423,85,38,1,1738,728,175,605,68
0,0,1,-0.0,-0.0,0.8208038806915283,4.013155617496423,85,38,1,1738,728,175,605,68
0,0,0,-0.0,-0.0,0.0904853343963623,959.0251536793082,86,-937,-266,763,461,1700,727,31
-3,0,0,-3.0,-0.0,0.11158537864685059,956.1395368328899,86,-934,-266,763,461,1700,727,31
-5,-1,0,-5.0,-1.0,0.11953330039978027,951.0569341400122,86,-929,-265,763,461,1700,727,31
-7,0,0,-7.0,-0.0,0.1275324821472168,944.3273685244261,86,-922,-265,763,461,1700,727,31
-11,0,0,-11.0,-0.0,0.13564634323120117,933.7602436864647,86,-911,-265,763,461,1700,727,31
-12,-1,0,-12.0,-1.0,0.1435403823852539,921.9615787213476,86,-899,-264,763,461,1700,727,31
-15,-1,0,-15.0,-1.0,0.1515953540802002,907.2933372848358,86,-884,-263,763,461,1700,727,31
-17,-2,0,-17.0,-2.0,0.1595313549041748,890.4335977861657,86,-867,-261,763,461,1700,727,31
-16,-3,0,-16.0,-3.0,0.1676034927368164,874.2496837221815,86,-851,-258,763,461,1700,727,31
-17,-3,0,-17.0,-3.0,0.17555737495422363,857.1129514002185,86,-834,-255,763,461,1700,727,31
-16,-3,0,-16.0,-3.0,0.18358230590820312,840.9369135631434,86,-818,-252,763,461,1700,727,31
-18,-4,0,-18.0,-4.0,0.19161248207092285,822.5583561758548,86,-800,-248,763,461,1700,727,31
-18,-5,0,-18.0,-5.0,0.19965338706970215,803.8852178419146,86,-782,-243,763,461,1700,727,31
-20,-5,0,-20.0,-5.0,0.20766448974609375,783.3032005447554,86,-762,-238,763,461,1700,727,31
-20,-6,0,-20.0,-6.0,0.2155754566192627,762.423951264688,86,-742,-232,763,461,1700,727,31
-21,-6,0,-21.0,-6.0,0.22355341911315918,740.5904975580357,86,-721,-226,763,461,1700,727,31
-20,-6,0,-20.0,-6.0,0.231581449508667,719.7115080084155,86,-701,-220,763,461,1700,727,31
-17,-5,0,-17.0,-5.0,0.23955035209655762,701.9944211777383,86,-684,-215,763,461,1700,727,31
-16,-5,0,-16.0,-5.0,0.24758052825927734,685.2313903275117,86,-668,-210,763,461,1700,727,31
-16,-5,0,-16.0,-5.0,0.25571537017822266,668.4683606429782,86,-652,-205,763,461,1700,727,31
-16,-5,0,-16.0,-5.0,0.263796329498291,651.7053322120651,86,-636,-200,763,461,1700,727,31
-17,-5,0,-17.0,-5.0,0.2716383934020996,633.9884436567419,86,-619,-195,763,461,1700,727,31
-17,-7,0,-17.0,-7.0,0.2796473503112793,615.6726567721166,86,-602,-188,763,461,1700,727,31
-21,-8,0,-21.0,-8.0,0.2876143455505371,593.2441943824865,86,-581,-180,763,461,1700,727,31
-23,-8,0,-23.0,-8.0,0.29558253288269043,568.9075269252829,86,-558,-172,763,461,1700,727,31
-27,-9,0,-27.0,-9.0,0.3035123348236084,540.4547686355749,86,-531,-163,763,461,1700,727,31
-29,-10,0,-29.0,-10.0,0.3115553855895996,509.79805639884,86,-502,-153,763,461,1700,727,31
-32,-9,0,-32.0,-9.0,0.3195033073425293,476.5648482143531,86,-470,-144,763,461,1700,727,31
-31,-9,0,-31.0,-9.0,0.3275635242462158,444.2885803065432,86,-439,-135,763,461,1700,727,31
-30,-7,0,-30.0,-7.0,0.3355863094329834,413.5615475051396,86,-409,-128,763,461,1700,727,31
-30,-8,0,-30.0,-8.0,0.3435354232788086,382.5437082887868,86,-379,-120,763,461,1700,727,31
-28,-5,0,-28.0,-5.0,0.35149335861206055,354.3589040486232,86,-351,-115,763,461,1700,727,31
-29,-6,0,-29.0,-6.0,0.3594474792480469,324.94852551526094,86,-322,-109,763,461,1700,727,31
-26,-5,0,-26.0,-5.0,0.36751747131347656,298.73874481804125,86,-296,-104,763,461,1700,727,31
-26,-5,0,-26.0,-5.0,0.37551450729370117,272.57781555606823,86,-270,-99,763,461,1700,727,31
-26,-4,0,-26.0,-4.0,0.3834803104400635,246.84155514356388,86,-244,-95,763,461,1700,727,31
-23,-4,0,-23.0,-4.0,0.3914504051208496,224.00209204105306,86,-221,-91,763,461,1700,727,31
-20,-4,0,-20.0,-4.0,0.399463415145874,204.02054698132775,86,-201,-87,763,461,1700,727,31
-19,-4,0,-19.0,-4.0,0.4073824882507324,185.032497359804,86,-182,-83,763,461,1700,727,31
-18,-4,0,-18.0,-4.0,0.4155595302581787,167.03571078225283,86,-164,-79,763,461,1700,727,31
-17,-4,0,-17.0,-4.0,0.4235954284667969,150.0272704737008,86,-147,-75,763,461,1700,727,31
-16,-4,0,-16.0,-4.0,0.43160438537597656,134.00335566691106,86,-131,-71,763,461,1700,727,31
-17,-4,0,-17.0,-4.0,0.4395623207092285,117.23085872821065,86,-114,-67,763,461,1700,727,31
-16,-3,0,-16.0,-3.0,0.44752049446105957,102.04699910719626,86,-98,-64,763,461,1700,727,31
-14,-3,0,-14.0,-3.0,0.455599308013916,88.81233067415451,86,-84,-61,763,461,1700,727,31
-13,-2,0,-13.0,-2.0,0.46355748176574707,77.31467922275417,86,-71,-59,763,461,1700,727,31
-15,-4,0,-15.0,-4.0,0.47156834602355957,63.49203781276162,86,-56,-55,763,461,1700,727,31
-15,-2,0,-15.0,-2.0,0.4803504943847656,52.00746227100382,86,-41,-53,763,461,1700,727,31
-15,-3,0,-15.0,-3.0,0.48766231536865234,41.356011214421486,86,-26,-50,763,461,1700,727,31
-12,-3,0,-12.0,-3.0,0.49541735649108887,34.040799340956916,86,-14,-47,763,461,1700,727,31
-11,-4,0,-11.0,-4.0,0.5035593509674072,28.104524124504614,86,-3,-43,763,461,1700,727,31
-8,-2,0,-8.0,-2.0,0.5116264820098877,26.303752856126764,86,5,-41,763,461,1700,727,31
-6,-3,0,-6.0,-3.0,0.5195064544677734,24.560080889704963,86,11,-38,763,461,1700,727,31
-3,-2,0,-3.0,-2.0,0.5275604724884033,23.626415831655933,86,14,-36,763,461,1700,727,31
-2,0,0,-2.0,-0.0,0.5355944633483887,24.395431207184416,86,16,-36,763,461,1700,727,31
-1,-2,0,-1.0,-2.0,0.543555498123169,23.013155617496423,86,17,-34,763,461,1700,727,31
-2,0,0,-2.0,-0.0,0.5515894889831543,23.948684188300895,86,19,-34,763,461,1700,727,31
0,-2,0,-0.0,-2.0,0.5596673488616943,22.21558813185679,86,19,-32,763,461,1700,727,31
-1,-2,0,-1.0,-2.0,0.5676004886627197,21.055512754639892,86,20,-30,763,461,1700,727,31
0,-1,0,-0.0,-1.0,0.5755825042724609,20.22782990761707,86,20,-29,763,461,1700,727,31
0,-1,0,-0.0,-1.0,0.5835273265838623,19.409301068170507,86,20,-28,763,461,1700,727,31
0,-1,0,-0.0,-1.0,0.5915334224700928,18.600595232822883,86,20,-27,763,461,1700,727,31
0,-2,0,-0.0,-2.0,0.5997083187103271,17.015621187164243,86,20,-25,763,461,1700,727,31
0,-3,0,-0.0,-3.0,0.6075494289398193,14.732137494637012,86,20,-22,763,461,1700,727,31
1,-4,0,1.0,-4.0,0.6155505180358887,11.1725046566048,86,19,-18,763,461,1700,727,31
2,-3,0,2.0,-3.0,0.6235654354095459,7.671568097509269,86,17,-15,763,461,1700,727,31
2,-4,0,2.0,-4.0,0.631589412689209,3.601075237738275,86,15,-11,763,461,1700,727,31
1,-5,0,1.0,-5.0,0.6395394802093506,0.2315462117278173,86,14,-6,763,461,1700,727,31
1,-3,0,1.0,-3.0,0.6475894451141357,-1.6583359358736658,86,13,-3,763,461,1700,727,31
1,-3,0,1.0,-3.0,0.6555774211883545,-3.0,86,12,0,763,461,1700,727,31
0,-1,0,-0.0,-1.0,0.6635904312133789,-2.9584054212077042,86,12,1,763,461,1700,727,31
0,-3,0,-0.0,-3.0,0.6717023849487305,-2.350889359326482,86,12,4,763,461,1700,727,31
0,-2,0,-0.0,-2.0,0.6795873641967773,-1.5835921350012612,86,12,6,763,461,1700,727,31
0,-1,0,-0.0,-1.0,0.6875743865966797,-1.107556010550196,86,12,7,763,461,1700,727,31
0,-1,0,-0.0,-1.0,0.695610523223877,-0.5777948981440435,86,12,8,763,461,1700,727,31
-1,-1,0,-1.0,-1.0,0.7037463188171387,0.8113883008418963,86,13,9,763,461,1700,727,31
0,0,1,-0.0,-0.0,0.7724623680114746,0.8113883008418963,86,13,9,763,461,1700,727,31
0,0,0,-0.0,-0.0,0.0450282096862793,422.65238436166055,87,-433,48,317,500,750,452,27
5,0,0,5.0,-0.0,0.13606905937194824,427.62228722569176,87,-438,48,317,500,750,452,27
7,0,0,7.0,-0.0,0.14406108856201172,434.5812775351534,87,-445,48,317,500,750,452,27
9,-1,0,9.0,-1.0,0.15207815170288086,443.6366170162003,87,-454,49,317,500,750,452,27
12,0,0,12.0,-0.0,0.1601250171661377,455.569098426262,87,-466,49,317,500,750,452,27
16,0,0,16.0,-0.0,0.1680910587310791,471.48426187029025,87,-482,49,317,500,750,452,27
16,0,0,16.0,-0.0,0.17608022689819336,487.4048361077259,87,-498,49,317,500,750,452,27
13,1,0,13.0,1.0,0.18417716026306152,500.2494520211395,87,-511,48,317,500,750,452,27
12,1,0,12.0,1.0,0.1919870376586914,512.1076080195372,87,-523,47,317,500,750,452,27
13,2,0,13.0,2.0,0.20007920265197754,524.8856755854351,87,-536,45,317,500,750,452,27
9,2,0,9.0,2.0,0.20805907249450684,533.6936985186495,87,-545,43,317,500,750,452,27
5,1,0,5.0,1.0,0.21621012687683105,538.6013052921467,87,-550,42,317,500,750,452,27
1,0,0,1.0,-0.0,0.22408223152160645,539.5984075257546,87,-551,42,317,500,750,452,27
-2,1,0,-2.0,1.0,0.2481842041015625,537.5288366652559,87,-549,41,317,500,750,452,27
-6,3,0,-6.0,3.0,0.25618505477905273,531.3280261019086,87,-543,38,317,500,750,452,27
-10,3,0,-10.0,3.0,0.26415109634399414,521.1479195878236,87,-533,35,317,500,750,452,27
-14,3,0,-14.0,3.0,0.27208709716796875,506.9855767230472,87,-519,32,317,500,750,452,27
-19,3,0,-19.0,3.0,0.2800450325012207,487.84029390615126,87,-500,29,317,500,750,452,27
-20,1,0,-20.0,1.0,0.28803110122680664,467.8159731123749,87,-480,28,317,500,750,452,27
-23,3,0,-23.0,3.0,0.29613304138183594,444.68329661459137,87,-457,25,317,500,750,452,27
-26,2,0,-26.0,2.0,0.3041691780090332,418.6132528085763,87,-431,23,317,500,750,452,27
-25,1,0,-25.0,1.0,0.3120560646057129,393.59562220958554,87,-406,22,317,500,750,452,27
-24,1,0,-24.0,1.0,0.3200390338897705,369.57678967757573,87,-382,21,317,500,750,452,27
-24,2,0,-24.0,2.0,0.32813405990600586,345.50383540486706,87,-358,19,317,500,750,452,27
-22,1,0,-22.0,1.0,0.3360171318054199,323.48179742743883,87,-336,18,317,500,750,452,27
-21,0,0,-21.0,-0.0,0.344041109085083,302.5138665732459,87,-315,18,317,500,750,452,27
-19,1,0,-19.0,1.0,0.35199522972106934,283.4877737782791,87,-296,17,317,500,750,452,27
-19,0,0,-19.0,-0.0,0.3600001335144043,264.5211703636319,87,-277,17,317,500,750,452,27
-19,1,0,-19.0,1.0,0.3681471347808838,245.49564793241683,87,-258,16,317,500,750,452,27
-18,1,0,-18.0,1.0,0.37612318992614746,227.46829312822095,87,-240,15,317,500,750,452,27
-18,0,0,-18.0,-0.0,0.38411903381347656,209.50617968946392,87,-222,15,317,500,750,452,27
-19,1,0,-19.0,1.0,0.39202022552490234,190.48218595248088,87,-203,14,317,500,750,452,27
-16,1,0,-16.0,1.0,0.399975061416626,174.45132701584163,87,-187,13,317,500,750,452,27
-12,1,0,-12.0,1.0,0.4079761505126953,162.410946066658,87,-175,12,317,500,750,452,27
-11,2,0,-11.0,2.0,0.415971040725708,151.30459518832697,87,-164,10,317,500,750,452,27
-10,1,0,-10.0,1.0,0.4239621162414551,141.26276284314372,87,-154,9,317,500,750,452,27
-9,1,0,-9.0,1.0,0.43201208114624023,132.2205219657332,87,-145,8,317,500,750,452,27
-8,1,0,-8.0,1.0,0.4402461051940918,124.17871555019022,87,-137,7,317,500,750,452,27
-7,1,0,-7.0,1.0,0.44813013076782227,117.13838787997952,87,-130,6,317,500,750,452,27
-7,1,0,-7.0,1.0,0.45601511001586914,110.10158406779338,87,-123,5,317,500,750,452,27
-7,1,0,-7.0,1.0,0.46402907371520996,103.06894502837527,87,-116,4,317,500,750,452,27
-7,1,0,-7.0,1.0,0.4719531536102295,96.04127658827184,87,-109,3,317,500,750,452,27
-6,1,0,-6.0,1.0,0.48005104064941406,90.01941564578979,87,-103,2,317,500,750,452,27
-8,2,0,-8.0,2.0,0.4879941940307617,82.0,87,-95,0,317,500,750,452,27
-8,1,0,-8.0,1.0,0.4961421489715576,74.00574693662483,87,-87,-1,317,500,750,452,27
-6,1,0,-6.0,1.0,0.5043351650238037,68.02468759581859,87,-81,-2,317,500,750,452,27
-5,1,0,-5.0,1.0,0.5119330883026123,63.05918747922567,87,-76,-3,317,500,750,452,27
-4,0,0,-4.0,-0.0,0.5200631618499756,59.06247289678588,87,-72,-3,317,500,750,452,27
-2,0,0,-2.0,-0.0,0.5281600952148438,57.064256222413434,87,-70,-3,317,500,750,452,27
-2,0,0,-2.0,-0.0,0.5360221862792969,55.06614430096654,87,-68,-3,317,500,750,452,27
-1,0,0,-1.0,-0.0,0.5439400672912598,54.067130548428864,87,-67,-3,317,500,750,452,27
-1,0,0,-1.0,-0.0,0.552016019821167,53.06814663663572,87,-66,-3,317,500,750,452,27
-2,0,0,-2.0,-0.0,0.5599460601806641,51.07027391856539,87,-64,-3,317,500,750,452,27
-2,0,0,-2.0,-0.0,0.567986011505127,49.07253821135398,87,-62,-3,317,500,750,452,27
-4,0,0,-4.0,-0.0,0.5760560035705566,45.077534382926416,87,-58,-3,317,500,750,452,27
-4,1,0,-4.0,1.0,0.5840370655059814,41.147945482723536,87,-54,-4,317,500,750,452,27
-4,0,0,-4.0,-0.0,0.5919291973114014,37.15974481593781,87,-50,-4,317,500,750,452,27
-4,0,0,-4.0,-0.0,0.6000041961669922,33.17358552246078,87,-46,-4,317,500,750,452,27
-3,0,0,-3.0,-0.0,0.6080582141876221,30.185645763378368,87,-43,-4,317,500,750,452,27
-5,0,0,-5.0,-0.0,0.6161839962005615,25.209946349085598,87,-38,-4,317,500,750,452,27
-3,1,0,-3.0,1.0,0.6239371299743652,22.355339059327378,87,-35,-5,317,500,750,452,27
-3,0,0,-3.0,-0.0,0.6320371627807617,19.38826948140329,87,-32,-5,317,500,750,452,27
-4,0,0,-4.0,-0.0,0.6399750709533691,15.442925306655784,87,-28,-5,317,500,750,452,27
-4,0,0,-4.0,-0.0,0.6479330062866211,11.515301344262525,87,-24,-5,317,500,750,452,27
-2,0,0,-2.0,-0.0,0.6559290885925293,9.561028345356956,87,-22,-5,317,500,750,452,27
-2,0,0,-2.0,-0.0,0.6639540195465088,7.615528128088304,87,-20,-5,317,500,750,452,27
-2,-1,0,-2.0,-1.0,0.6719741821289062,5.439088914585774,87,-18,-4,317,500,750,452,27
-2,0,0,-2.0,-0.0,0.6800761222839355,3.4924225024706423,87,-16,-4,317,500,750,452,27
-2,0,0,-2.0,-0.0,0.6882610321044922,1.560219778561036,87,-14,-4,317,500,750,452,27
0,-1,0,-0.0,-1.0,0.6961522102355957,1.3178210632763534,87,-14,-3,317,500,750,452,27
0,0,1,-0.0,-0.0,0.7329950332641602,1.3178210632763534,87,-14,-3,317,500,750,452,27
0,0,0,-0.0,-0.0,0.07500624656677246,653.3795363686069,88,656,152,987,655,331,503,41
1,0,0,1.0,-0.0,0.1192171573638916,652.4053836786259,88,655,152,987,655,331,503,41
2,0,0,2.0,-0.0,0.12703227996826172,650.457306619892,88,653,152,987,655,331,503,41
3,0,0,3.0,-0.0,0.13516521453857422,647.5357668320103,88,650,152,987,655,331,503,41
2,0,0,2.0,-0.0,0.1430652141571045,645.5884614384477,88,648,152,987,655,331,503,41
3,0,0,3.0,-0.0,0.15106725692749023,642.6680918831086,88,645,152,987,655,331,503,41
4,0,0,4.0,-0.0,0.1590251922607422,638.7753790177651,88,641,152,987,655,331,503,41
5,0,0,5.0,-0.0,0.16697120666503906,633.9113089708726,88,636,152,987,655,331,503,41
7,0,0,7.0,-0.0,0.17510724067687988,627.1050919286604,88,629,152,987,655,331,503,41
10,0,0,10.0,-0.0,0.18307018280029297,617.3892060585903,88,619,152,987,655,331,503,41
13,0,0,13.0,-0.0,0.19106221199035645,604.771958397622,88,606,152,987,655,331,503,41
14,1,0,14.0,1.0,0.1989762783050537,590.9541717674084,88,592,151,987,655,331,503,41
15,2,0,15.0,2.0,0.20709729194641113,575.927847981616,88,577,149,987,655,331,503,41
14,2,0,14.0,2.0,0.21499037742614746,561.8745569278657,88,563,147,987,655,331,503,41
16,4,0,16.0,4.0,0.22297215461730957,545.3830559894769,88,547,143,987,655,331,503,41
16,4,0,16.0,4.0,0.23096227645874023,528.8916104296002,88,531,139,987,655,331,503,41
17,5,0,17.0,5.0,0.23901724815368652,511.1798188937528,88,514,134,987,655,331,503,41
16,5,0,16.0,5.0,0.24709033966064453,494.4365850131578,88,498,129,987,655,331,503,41
17,6,0,17.0,6.0,0.25508737564086914,476.47759264643554,88,481,123,987,655,331,503,41
17,6,0,17.0,6.0,0.2630603313446045,458.5237716143264,88,464,117,987,655,331,503,41
17,7,0,17.0,7.0,0.2710533142089844,440.3357470368774,88,447,110,987,655,331,503,41
21,9,0,21.0,9.0,0.2790791988372803,417.8093192247054,88,426,101,987,655,331,503,41
28,13,0,28.0,13.0,0.28700733184814453,387.6125611410914,88,398,88,987,655,331,503,41
29,12,0,29.0,12.0,0.2950572967529297,356.7452720340363,88,369,76,987,655,331,503,41
32,12,0,32.0,12.0,0.30306315422058105,323.02332282222443,88,337,64,987,655,331,503,41
33,11,0,33.0,11.0,0.31107425689697266,288.58548248418947,88,304,53,987,655,331,503,41
34,9,0,34.0,9.0,0.31906819343566895,253.5616932247642,88,270,44,987,655,331,503,41
34,9,0,34.0,9.0,0.3271212577819824,218.58122306669483,88,236,35,987,655,331,503,41
33,9,0,33.0,9.0,0.33505725860595703,184.65825172711703,88,203,26,987,655,331,503,41
32,10,0,32.0,10.0,0.3430771827697754,151.74690681348528,88,171,16,987,655,331,503,41
27,8,0,27.0,8.0,0.3510463237762451,124.22205101855957,88,144,8,987,655,331,503,41
26,9,0,26.0,9.0,0.3590221405029297,98.00423721205946,88,118,-1,987,655,331,503,41
23,8,0,23.0,8.0,0.36715221405029297,75.42536350467836,88,95,-9,987,655,331,503,41
21,7,0,21.0,7.0,0.37508726119995117,55.7099729229908,88,74,-16,987,655,331,503,41
16,6,0,16.0,6.0,0.383101224899292,42.03224967708329,88,58,-22,987,655,331,503,41
13,5,0,13.0,5.0,0.39104628562927246,32.478567053607705,88,45,-27,987,655,331,503,41
12,4,0,12.0,4.0,0.3991382122039795,25.276925690687087,88,33,-31,987,655,331,503,41
9,3,0,9.0,3.0,0.4071652889251709,21.617304093369626,88,24,-34,987,655,331,503,41
8,2,0,8.0,2.0,0.4151582717895508,19.395431207184416,88,16,-36,987,655,331,503,41
7,1,0,7.0,1.0,0.4230232238769531,18.078865529319543,88,9,-37,987,655,331,503,41
5,1,0,5.0,1.0,0.43099331855773926,18.209946349085598,88,4,-38,987,655,331,503,41
2,0,0,2.0,-0.0,0.4389472007751465,18.052595180880893,88,2,-38,987,655,331,503,41
2,0,0,2.0,-0.0,0.4470641613006592,18.0,88,0,-38,987,655,331,503,41
1,0,0,1.0,-0.0,0.46306633949279785,18.013155617496423,88,-1,-38,987,655,331,503,41
0,-1,0,-0.0,-1.0,0.47907423973083496,17.013511046643494,88,-1,-37,987,655,331,503,41
1,0,0,1.0,-0.0,0.4869222640991211,17.05401462729781,88,-2,-37,987,655,331,503,41
1,-1,0,1.0,-1.0,0.4950401782989502,16.124783736376884,88,-3,-36,987,655,331,503,41
0,-1,0,-0.0,-1.0,0.5030622482299805,15.128336140500593,88,-3,-35,987,655,331,503,41
1,-1,0,1.0,-1.0,0.5111193656921387,14.23448553724738,88,-4,-34,987,655,331,503,41
1,-2,0,1.0,-2.0,0.5191233158111572,12.388269481403292,88,-5,-32,987,655,331,503,41
0,-3,0,-0.0,-3.0,0.5270543098449707,9.427877939124322,88,-5,-29,987,655,331,503,41
0,-2,0,-0.0,-2.0,0.5350222587585449,7.459060435491963,88,-5,-27,987,655,331,503,41
0,-3,0,-0.0,-3.0,0.5430712699890137,4.515301344262525,88,-5,-24,987,655,331,503,41
0,-2,0,-0.0,-2.0,0.5510742664337158,2.561028345356956,88,-5,-22,987,655,331,503,41
-1,-4,0,-1.0,-4.0,0.5590271949768066,-1.5609110854142259,88,-4,-18,987,655,331,503,41
-2,-3,0,-2.0,-3.0,0.5669703483581543,-4.8672540495784435,88,-2,-15,987,655,331,503,41
-1,-2,0,-1.0,-2.0,0.5749263763427734,-6.961595189594702,88,-1,-13,987,655,331,503,41
-1,-2,0,-1.0,-2.0,0.5830333232879639,-9.0,88,0,-11,987,655,331,503,41
-1,-3,0,-1.0,-3.0,0.5911643505096436,-11.93774225170145,88,1,-8,987,655,331,503,41
0,-2,0,-0.0,-2.0,0.5991063117980957,-13.917237469701782,88,1,-6,987,655,331,503,41
0,-1,0,-0.0,-1.0,0.6071062088012695,-14.900980486407216,88,1,-5,987,655,331,503,41
1,-1,0,1.0,-1.0,0.6150562763214111,-16.0,88,0,-4,987,655,331,503,41
1,0,0,1.0,-0.0,0.6230971813201904,-15.876894374382339,88,-1,-4,987,655,331,503,41
0,0,1,-0.0,-0.0,0.6580431461334229,-15.876894374382339,88,-1,-4,987,655,331,503,41
0,0,0,-0.0,-0.0,0.07551741600036621,868.7453650350774,89,-869,36,119,695,988,659,3
-1,0,0,-1.0,-0.0,0.1154625415802002,867.7462230133723,89,-868,36,119,695,988,659,3
-3,0,0,-3.0,-0.0,0.12343955039978027,864.7488088354497,89,-865,36,119,695,988,659,3
-5,-1,0,-5.0,-1.0,0.13138341903686523,859.7955622562189,89,-860,37,119,695,988,659,3
-8,-1,0,-8.0,-1.0,0.1395573616027832,851.8469968288567,89,-852,38,119,695,988,659,3
-9,-2,0,-9.0,-2.0,0.1475083827972412,842.9484581418465,89,-843,40,119,695,988,659,3
-10,-2,0,-10.0,-2.0,0.15545153617858887,833.0581514498854,89,-833,42,119,695,988,659,3
-10,-2,0,-10.0,-2.0,0.16344332695007324,823.1753454211064,89,-823,44,119,695,988,659,3
-11,-2,0,-11.0,-2.0,0.17146754264831543,812.3019119613576,89,-812,46,119,695,988,659,3
-10,-3,0,-10.0,-3.0,0.17942237854003906,802.4954884751999,89,-802,49,119,695,988,659,3
-11,-4,0,-11.0,-4.0,0.18746542930603027,791.7736120734595,89,-791,53,119,695,988,659,3
-11,-4,0,-11.0,-4.0,0.19534039497375488,781.0799191898485,89,-780,57,119,695,988,659,3
-10,-5,0,-10.0,-5.0,0.2033984661102295,771.4920711567207,89,-770,62,119,695,988,659,3
-12,-4,0,-12.0,-4.0,0.21139049530029297,759.8679254640716,89,-758,66,119,695,988,659,3
-14,-5,0,-14.0,-5.0,0.21954345703125,746.3800907168988,89,-744,71,119,695,988,659,3
-17,-4,0,-17.0,-4.0,0.22746038436889648,729.8583994181089,89,-727,75,119,695,988,659,3
-18,-5,0,-18.0,-5.0,0.23552632331848145,712.4991240359024,89,-709,80,119,695,988,659,3
-20,-4,0,-20.0,-4.0,0.24348235130310059,693.1015775806881,89,-689,84,119,695,988,659,3
-22,-3,0,-22.0,-3.0,0.2516334056854248,671.6499832751057,89,-667,87,119,695,988,659,3
-24,-3,0,-24.0,-3.0,0.25944042205810547,648.2680494218085,89,-643,90,119,695,988,659,3
-23,-1,0,-23.0,-1.0,0.2674393653869629,625.6426413834283,89,-620,91,119,695,988,659,3
-21,0,0,-21.0,-0.0,0.27547335624694824,604.8729239700351,89,-599,91,119,695,988,659,3
-19,0,0,-19.0,-0.0,0.2835073471069336,586.095392589654,89,-580,91,119,695,988,659,3
-19,0,0,-19.0,-0.0,0.29167652130126953,567.3326490709468,89,-561,91,119,695,988,659,3
-18,1,0,-18.0,1.0,0.29950642585754395,549.4080304646726,89,-543,90,119,695,988,659,3
-18,0,0,-18.0,-0.0,0.30747246742248535,531.6584271369411,89,-525,90,119,695,988,659,3
-18,1,0,-18.0,1.0,0.3155534267425537,513.7523676487559,89,-507,89,119,695,988,659,3
-18,1,0,-18.0,1.0,0.32338833808898926,495.85510966477943,89,-489,88,119,695,988,659,3
-19,2,0,-19.0,2.0,0.3318054676055908,476.8033068114954,89,-470,86,119,695,988,659,3
-19,2,0,-19.0,2.0,0.3395364284515381,457.7559263922375,89,-451,84,119,695,988,659,3
-20,2,0,-20.0,2.0,0.3473653793334961,437.7311249501225,89,-431,82,119,695,988,659,3
-19,2,0,-19.0,2.0,0.3555183410644531,418.69512744371957,89,-412,80,119,695,988,659,3
-18,2,0,-18.0,2.0,0.3635275363922119,400.6466108409232,89,-394,78,119,695,988,659,3
-19,1,0,-19.0,1.0,0.37173938751220703,381.8237192233522,89,-375,77,119,695,988,659,3
-20,1,0,-20.0,1.0,0.37948155403137207,362.04407445928655,89,-355,76,119,695,988,659,3
-17,1,0,-17.0,1.0,0.38747453689575195,345.2210276687423,89,-338,75,119,695,988,659,3
-17,1,0,-17.0,1.0,0.3953545093536377,328.41918584077644,89,-321,74,119,695,988,659,3
-16,0,0,-16.0,-0.0,0.40349841117858887,312.84868965793055,89,-305,74,119,695,988,659,3
-15,1,0,-15.0,1.0,0.41133737564086914,298.0468190768797,89,-290,73,119,695,988,659,3
-15,0,0,-15.0,-0.0,0.4193713665008545,283.5241641759097,89,-275,73,119,695,988,659,3
-14,0,0,-14.0,-0.0,0.4275684356689453,270.01660465735307,89,-261,73,119,695,988,659,3
-13,0,0,-13.0,-0.0,0.43546533584594727,257.5207922005501,89,-248,73,119,695,988,659,3
-13,1,0,-13.0,1.0,0.4434654712677002,244.78242410717655,89,-235,72,119,695,988,659,3
-12,1,0,-12.0,1.0,0.4514775276184082,233.0299126180241,89,-223,71,119,695,988,659,3
-11,1,0,-11.0,1.0,0.45943450927734375,222.2576986354558,89,-212,70,119,695,988,659,3
-9,1,0,-9.0,1.0,0.4675304889678955,213.40615662802222,89,-203,69,119,695,988,659,3
-7,1,0,-7.0,1.0,0.4754314422607422,206.46083967823904,89,-196,68,119,695,988,659,3
-7,1,0,-7.0,1.0,0.4833683967590332,199.5243127403757,89,-189,67,119,695,988,659,3
-7,0,0,-7.0,-0.0,0.4914205074310303,192.94071259021402,89,-182,67,119,695,988,659,3
-6,1,0,-6.0,1.0,0.4994323253631592,186.9680823969857,89,-176,66,119,695,988,659,3
-7,1,0,-7.0,1.0,0.5074615478515625,180.06904760339356,89,-169,65,119,695,988,659,3
-6,2,0,-6.0,2.0,0.5154683589935303,173.7512517837855,89,-163,63,119,695,988,659,3
-6,0,0,-6.0,-0.0,0.5234644412994385,168.1685549976709,89,-157,63,119,695,988,659,3
-6,2,0,-6.0,2.0,0.5314414501190186,161.85576440519384,89,-151,61,119,695,988,659,3
-5,1,0,-5.0,1.0,0.5393774509429932,156.84802817900513,89,-146,60,119,695,988,659,3
-4,1,0,-4.0,1.0,0.5475153923034668,152.7693077307692,89,-142,59,119,695,988,659,3
-5,1,0,-5.0,1.0,0.5553874969482422,147.77163708180402,89,-137,58,119,695,988,659,3
-5,2,0,-5.0,2.0,0.5634503364562988,142.38758663147937,89,-132,56,119,695,988,659,3
-5,1,0,-5.0,1.0,0.571481466293335,137.3979768638256,89,-127,55,119,695,988,659,3
-4,2,0,-4.0,2.0,0.579465389251709,132.9328189802634,89,-123,53,119,695,988,659,3
-4,1,0,-4.0,1.0,0.5874714851379395,128.86531484580476,89,-119,52,119,695,988,659,3
-4,2,0,-4.0,2.0,0.5954544544219971,124.39936203984452,89,-115,50,119,695,988,659,3
-5,2,0,-5.0,2.0,0.6035423278808594,119.01666550941998,89,-110,48,119,695,988,659,3
-4,2,0,-4.0,2.0,0.6115474700927734,114.55085460523432,89,-106,46,119,695,988,659,3
-4,2,0,-4.0,2.0,0.6194214820861816,110.08555261599052,89,-102,44,119,695,988,659,3
-4,2,0,-4.0,2.0,0.6275303363800049,105.62082348209472,89,-98,42,119,695,988,659,3
-5,2,0,-5.0,2.0,0.6354944705963135,100.23734488813898,89,-93,40,119,695,988,659,3
-3,3,0,-3.0,3.0,0.6435043811798096,96.30878685915265,89,-90,37,119,695,988,659,3
-4,2,0,-4.0,2.0,0.6514585018157959,91.84934033152847,89,-86,35,119,695,988,659,3
-4,3,0,-4.0,3.0,0.6595554351806641,87.02272433866155,89,-82,32,119,695,988,659,3
-3,2,0,-3.0,2.0,0.6675844192504883,83.50443775329198,89,-79,30,119,695,988,659,3
-5,3,0,-5.0,3.0,0.6755244731903076,77.77182237323191,89,-74,27,119,695,988,659,3
-5,2,0,-5.0,2.0,0.6835415363311768,72.38937252763509,89,-69,25,119,695,988,659,3
-5,3,0,-5.0,3.0,0.6913654804229736,66.67569726275453,89,-64,22,119,695,988,659,3
-4,2,0,-4.0,2.0,0.6993753910064697,62.245553203367585,89,-60,20,119,695,988,659,3
-3,2,0,-3.0,2.0,0.7075915336608887,58.77457653551382,89,-57,18,119,695,988,659,3
-4,1,0,-4.0,1.0,0.7154104709625244,54.65968020030299,89,-53,17,119,695,988,659,3
-3,2,0,-3.0,2.0,0.723468542098999,51.20153254455275,89,-50,15,119,695,988,659,3
-4,1,0,-4.0,1.0,0.7315595149993896,47.08326112068523,89,-46,14,119,695,988,659,3
-2,1,0,-2.0,1.0,0.7394614219665527,44.880278987817846,89,-44,13,119,695,988,659,3
-3,2,0,-3.0,2.0,0.7474794387817383,41.44997055358225,89,-41,11,119,695,988,659,3
-2,1,0,-2.0,1.0,0.7554914951324463,39.26164427839479,89,-39,10,119,695,988,659,3
-3,0,0,-3.0,-0.0,0.763479471206665,36.36308338453881,89,-36,10,119,695,988,659,3
-1,1,0,-1.0,1.0,0.7714414596557617,35.138621999185304,89,-35,9,119,695,988,659,3
-3,1,0,-3.0,1.0,0.7793924808502197,31.984845004941285,89,-32,8,119,695,988,659,3
-2,1,0,-2.0,1.0,0.787447452545166,29.805843601498726,89,-30,7,119,695,988,659,3
-2,1,0,-2.0,1.0,0.7955374717712402,27.635642126552707,89,-28,6,119,695,988,659,3
-1,0,0,-1.0,-0.0,0.8034064769744873,26.65863337187866,89,-27,6,119,695,988,659,3
-1,1,0,-1.0,1.0,0.8114185333251953,25.476404589747453,89,-26,5,119,695,988,659,3
-1,0,0,-1.0,-0.0,0.8275513648986816,24.495097567963924,89,-25,5,119,695,988,659,3
-1,0,0,-1.0,-0.0,0.859499454498291,23.515301344262525,89,-24,5,119,695,988,659,3
-1,0,0,-1.0,-0.0,0.875434398651123,22.53720459187964,89,-23,5,119,695,988,659,3
-1,0,0,-1.0,-0.0,0.8834793567657471,21.561028345356956,89,-22,5,119,695,988,659,3
-1,0,0,-1.0,-0.0,0.8913223743438721,20.587033144922902,89,-21,5,119,695,988,659,3
-2,0,0,-2.0,-0.0,0.9073405265808105,18.6468827043885,89,-19,5,119,695,988,659,3
-1,0,0,-1.0,-0.0,0.9233684539794922,17.681541692269406,89,-18,5,119,695,988,659,3
-1,0,0,-1.0,-0.0,0.9316143989562988,16.72004514666935,89,-17,5,119,695,988,659,3
-1,0,0,-1.0,-0.0,0.9394965171813965,15.763054614240211,89,-16,5,119,695,988,659,3
-1,1,0,-1.0,1.0,0.9475283622741699,14.524174696260024,89,-15,4,119,695,988,659,3
-2,0,0,-2.0,-0.0,0.9555454254150391,12.601470508735444,89,-13,4,119,695,988,659,3
-1,0,0,-1.0,-0.0,0.9635984897613525,11.649110640673518,89,-12,4,119,695,988,659,3
-1,1,0,-1.0,1.0,0.9715723991394043,10.40175425099138,89,-11,3,119,695,988,659,3
-1,0,0,-1.0,-0.0,0.979379415512085,9.44030650891055,89,-10,3,119,695,988,659,3
-1,1,0,-1.0,1.0,0.995469331741333,8.219544457292887,89,-9,2,119,695,988,659,3
-1,0,0,-1.0,-0.0,1.0034444332122803,7.246211251235321,89,-8,2,119,695,988,659,3
-1,0,0,-1.0,-0.0,1.0115594863891602,6.280109889280518,89,-7,2,119,695,988,659,3
-1,1,0,-1.0,1.0,1.0194263458251953,5.082762530298219,89,-6,1,119,695,988,659,3
-1,0,0,-1.0,-0.0,1.0434494018554688,4.0990195135927845,89,-5,1,119,695,988,659,3
-1,0,0,-1.0,-0.0,1.1875083446502686,3.1231056256176606,89,-4,1,119,695,988,659,3
-1,0,0,-1.0,-0.0,1.1954245567321777,2.1622776601683795,89,-3,1,119,695,988,659,3
-1,0,0,-1.0,-0.0,1.2034904956817627,1.2360679774997898,89,-2,1,119,695,988,659,3
-1,0,0,-1.0,-0.0,1.2275464534759521,0.41421356237309515,89,-1,1,119,695,988,659,3
0,0,1,-0.0,-0.0,1.3114194869995117,0.41421356237309515,89,-1,1,119,695,988,659,3
0,0,0,-0.0,-0.0,0.10787796974182129,1085.2761598050377,90,1076,163,1196,857,120,694,7
6,0,0,6.0,-0.0,0.2339479923248291,1079.3442151182774,90,1070,163,1196,857,120,694,7
9,0,0,9.0,-0.0,0.2419569492340088,1070.4477164724885,90,1061,163,1196,857,120,694,7
13,1,0,13.0,1.0,0.2500479221343994,1057.447075529939,90,1048,162,1196,857,120,694,7
18,0,0,18.0,-0.0,0.25794196128845215,1039.6619778240693,90,1030,162,1196,857,120,694,7
22,2,0,22.0,2.0,0.2659618854522705,1017.6194197642919,90,1008,160,1196,857,120,694,7
26,3,0,26.0,3.0,0.273953914642334,991.4712162752626,90,982,157,1196,857,120,694,7
30,2,0,30.0,2.0,0.2820100784301758,961.5356395696325,90,952,155,1196,857,120,694,7
36,4,0,36.0,4.0,0.289963960647583,925.3625369434077,90,916,151,1196,857,120,694,7
38,4,0,38.0,4.0,0.2979860305786133,887.2207591378669,90,878,147,1196,857,120,694,7
41,6,0,41.0,6.0,0.30594897270202637,845.7932610477064,90,837,141,1196,857,120,694,7
44,6,0,44.0,6.0,0.3140289783477783,801.4090998988015,90,793,135,1196,857,120,694,7
46,6,0,46.0,6.0,0.3219749927520752,755.0567261095966,90,747,129,1196,857,120,694,7
51,7,0,51.0,7.0,0.32998085021972656,703.6116330771805,90,696,122,1196,857,120,694,7
48,8,0,48.0,8.0,0.33812499046325684,654.9513659838393,90,648,114,1196,857,120,694,7
44,7,0,44.0,7.0,0.346081018447876,610.4044342845917,90,604,107,1196,857,120,694,7
40,8,0,40.0,8.0,0.35412096977233887,569.6229125698692,90,564,99,1196,857,120,694,7
34,8,0,34.0,8.0,0.3620469570159912,534.755520659714,90,530,91,1196,857,120,694,7
33,8,0,33.0,8.0,0.37000393867492676,500.8829229096775,90,497,83,1196,857,120,694,7
32,9,0,32.0,9.0,0.37795305252075195,467.85135658719304,90,465,74,1196,857,120,694,7
33,9,0,33.0,9.0,0.38593387603759766,433.8626786531438,90,432,65,1196,857,120,694,7
32,7,0,32.0,7.0,0.3940420150756836,401.18312681258726,90,400,58,1196,857,120,694,7
31,9,0,31.0,9.0,0.4019608497619629,369.2391704267567,90,369,49,1196,857,120,694,7
29,7,0,29.0,7.0,0.4099440574645996,339.58429619584143,90,340,42,1196,857,120,694,7
30,7,0,30.0,7.0,0.4180030822753906,308.96954979612997,90,310,35,1196,857,120,694,7
26,5,0,26.0,5.0,0.4259989261627197,282.5801113523139,90,284,30,1196,857,120,694,7
27,5,0,27.0,5.0,0.43395304679870605,255.21309029559285,90,257,25,1196,857,120,694,7
25,5,0,25.0,5.0,0.4420809745788574,229.86047324524614,90,232,20,1196,857,120,694,7
22,4,0,22.0,4.0,0.4500889778137207,207.6086417980041,90,210,16,1196,857,120,694,7
20,1,0,20.0,1.0,0.457927942276001,187.59118552545917,90,190,15,1196,857,120,694,7
16,2,0,16.0,2.0,0.4659600257873535,171.4849563716024,90,174,13,1196,857,120,694,7
14,1,0,14.0,1.0,0.47391295433044434,157.44936896105264,90,160,12,1196,857,120,694,7
10,2,0,10.0,2.0,0.4818708896636963,147.33296378372907,90,150,10,1196,857,120,694,7
8,1,0,8.0,1.0,0.48999595642089844,139.28492541376264,90,142,9,1196,857,120,694,7
5,0,0,5.0,-0.0,0.49802207946777344,134.2953021774598,90,137,9,1196,857,120,694,7
3,0,0,3.0,-0.0,0.5060338973999023,131.30189872075525,90,134,9,1196,857,120,694,7
2,0,0,2.0,-0.0,0.513983964920044,129.30646242719968,90,132,9,1196,857,120,694,7
1,0,0,1.0,-0.0,0.5221149921417236,128.30879635424276,90,131,9,1196,857,120,694,7
1,0,0,1.0,-0.0,0.5621368885040283,127.31116606031887,90,130,9,1196,857,120,694,7
2,0,0,2.0,-0.0,0.5699138641357422,125.31601614763451,90,128,9,1196,857,120,694,7
2,0,0,2.0,-0.0,0.5780179500579834,123.3210196285638,90,126,9,1196,857,120,694,7
2,0,0,2.0,-0.0,0.5860378742218018,121.32618388738553,90,124,9,1196,857,120,694,7
4,0,0,4.0,-0.0,0.5940608978271484,117.33702672078948,90,120,9,1196,857,120,694,7
4,0,0,4.0,-0.0,0.6018719673156738,113.3486140871476,90,116,9,1196,857,120,694,7
5,0,0,5.0,-0.0,0.6099879741668701,108.36426715962351,90,111,9,1196,857,120,694,7
4,0,0,4.0,-0.0,0.6180250644683838,104.37783756436893,90,107,9,1196,857,120,694,7
4,0,0,4.0,-0.0,0.6259069442749023,100.39245620450265,90,103,9,1196,857,120,694,7
3,0,0,3.0,-0.0,0.6340110301971436,97.40418317978589,90,100,9,1196,857,120,694,7
4,0,0,4.0,-0.0,0.6419799327850342,93.42095207992918,90,96,9,1196,857,120,694,7
4,1,0,4.0,1.0,0.6500489711761475,89.34717104492157,90,92,8,1196,857,120,694,7
5,1,0,5.0,1.0,0.6580638885498047,84.28115489611719,90,87,7,1196,857,120,694,7
5,1,0,5.0,1.0,0.6659960746765137,79.21921916437786,90,82,6,1196,857,120,694,7
6,0,0,6.0,-0.0,0.6740679740905762,73.23647421018367,90,76,6,1196,857,120,694,7
6,1,0,6.0,1.0,0.6818480491638184,67.178344238091,90,70,5,1196,857,120,694,7
7,0,0,7.0,-0.0,0.6900038719177246,60.198101237299845,90,63,5,1196,857,120,694,7
7,0,0,7.0,-0.0,0.6978790760040283,53.22277118748239,90,56,5,1196,857,120,694,7
5,1,0,5.0,1.0,0.7059829235076904,48.15662224971465,90,51,4,1196,857,120,694,7
5,0,0,5.0,-0.0,0.7138979434967041,43.17358552246078,90,46,4,1196,857,120,694,7
2,1,0,2.0,1.0,0.7220139503479004,41.10215414239989,90,44,3,1196,857,120,694,7
2,0,0,2.0,-0.0,0.7300848960876465,39.1070065428546,90,42,3,1196,857,120,694,7
1,0,0,1.0,-0.0,0.7380208969116211,38.10960958218893,90,41,3,1196,857,120,694,7
1,0,0,1.0,-0.0,0.7460179328918457,37.11234224026316,90,40,3,1196,857,120,694,7
1,0,0,1.0,-0.0,0.7540280818939209,36.11521443121589,90,39,3,1196,857,120,694,7
1,0,0,1.0,-0.0,0.7700438499450684,35.118237105091836,90,38,3,1196,857,120,694,7
1,0,0,1.0,-0.0,0.793950080871582,34.12142238654117,90,37,3,1196,857,120,694,7
0,1,0,-0.0,1.0,0.8019719123840332,34.05401462729781,90,37,2,1196,857,120,694,7
1,0,0,1.0,-0.0,0.8099989891052246,33.05551275463989,90,36,2,1196,857,120,694,7
2,0,0,2.0,-0.0,0.8179559707641602,31.058772731852805,90,34,2,1196,857,120,694,7
1,0,0,1.0,-0.0,0.8260290622711182,30.06055050963308,90,33,2,1196,857,120,694,7
1,1,0,1.0,1.0,0.8341009616851807,29.015621187164243,90,32,1,1196,857,120,694,7
1,0,0,1.0,-0.0,0.8419880867004395,28.016124838541646,90,31,1,1196,857,120,694,7
1,0,0,1.0,-0.0,0.858043909072876,27.01666203960727,90,30,1,1196,857,120,694,7
1,0,0,1.0,-0.0,0.8660190105438232,26.017236257093817,90,29,1,1196,857,120,694,7
2,0,0,2.0,-0.0,0.874000072479248,24.018512172212592,90,27,1,1196,857,120,694,7
1,1,0,1.0,1.0,0.8820269107818604,23.0,90,26,0,1196,857,120,694,7
2,0,0,2.0,-0.0,0.8901779651641846,21.0,90,24,0,1196,857,120,694,7
1,0,0,1.0,-0.0,0.8979499340057373,20.0,90,23,0,1196,857,120,694,7
1,0,0,1.0,-0.0,0.9060149192810059,19.0,90,22,0,1196,857,120,694,7
1,0,0,1.0,-0.0,0.9139609336853027,18.0,90,21,0,1196,857,120,694,7
1,0,0,1.0,-0.0,0.9219698905944824,17.0,90,20,0,1196,857,120,694,7
1,0,0,1.0,-0.0,0.9301729202270508,16.0,90,19,0,1196,857,120,694,7
1,0,0,1.0,-0.0,0.9380009174346924,15.0,90,18,0,1196,857,120,694,7
1,1,0,1.0,1.0,0.9459948539733887,14.029386365926403,90,17,-1,1196,857,120,694,7
1,0,0,1.0,-0.0,0.961946964263916,13.031219541881399,90,16,-1,1196,857,120,694,7
1,0,0,1.0,-0.0,0.9700720310211182,12.033296378372908,90,15,-1,1196,857,120,694,7
1,0,0,1.0,-0.0,0.9860248565673828,11.035668847618199,90,14,-1,1196,857,120,694,7
0,0,1,-0.0,-0.0,1.076935052871704,11.035668847618199,90,14,-1,1196,857,120,694,7
1,0,1,1.0,-0.0,1.0980770587921143,10.038404810405298,90,13,-1,1196,857,120,694,7
0,0,0,-0.0,-0.0,1.1800470352172852,10.038404810405298,90,13,-1,1196,857,120,694,7
1,0,0,1.0,-0.0,1.2020609378814697,9.041594578792296,90,12,-1,1196,857,120,694,7
1,0,0,1.0,-0.0,1.2339999675750732,8.045361017187261,90,11,-1,1196,857,120,694,7
1,0,0,1.0,-0.0,1.2419829368591309,7.04987562112089,90,10,-1,1196,857,120,694,7
1,0,0,1.0,-0.0,1.250025987625122,6.055385138137417,90,9,-1,1196,857,120,694,7
2,0,0,2.0,-0.0,1.2580158710479736,4.0710678118654755,90,7,-1,1196,857,120,694,7
1,0,0,1.0,-0.0,1.273987054824829,3.0827625302982193,90,6,-1,1196,857,120,694,7
1,0,0,1.0,-0.0,1.282038927078247,2.0990195135927845,90,5,-1,1196,857,120,694,7
1,0,0,1.0,-0.0,1.3059980869293213,1.1231056256176606,90,4,-1,1196,857,120,694,7
0,0,1,-0.0,-0.0,1.3309509754180908,1.1231056256176606,90,4,-1,1196,857,120,694,7
0,0,0,-0.0,-0.0,0.07101750373840332,622.012698284725,91,-580,-246,612,612,1192,858,16
1,0,0,1.0,-0.0,0.11101961135864258,622.9334354747733,91,-581,-246,612,612,1192,858,16
-3,0,0,-3.0,-0.0,0.2071976661682129,620.1719509815764,91,-578,-246,612,612,1192,858,16
-5,0,0,-5.0,-0.0,0.21507954597473145,615.574374072572,91,-573,-246,612,612,1192,858,16
-5,-1,0,-5.0,-1.0,0.22308564186096191,610.5862914743585,91,-568,-245,612,612,1192,858,16
-6,-2,0,-6.0,-2.0,0.23105168342590332,604.2850643286997,91,-562,-243,612,612,1192,858,16
-8,-2,0,-8.0,-2.0,0.23926973342895508,596.1498158569611,91,-554,-241,612,612,1192,858,16
-11,-2,0,-11.0,-2.0,0.2471446990966797,585.2705959340982,91,-543,-239,612,612,1192,858,16
-14,-4,0,-14.0,-4.0,0.25511956214904785,570.8488576476592,91,-529,-235,612,612,1192,858,16
-19,-6,0,-19.0,-6.0,0.2631256580352783,551.0536646870316,91,-510,-229,612,612,1192,858,16
-19,-6,0,-19.0,-6.0,0.271134614944458,531.2680224155703,91,-491,-223,612,612,1192,858,16
-24,-9,0,-24.0,-9.0,0.2790565490722656,505.6973817336428,91,-467,-214,612,612,1192,858,16
-28,-11,0,-28.0,-11.0,0.28710269927978516,475.663105890867,91,-439,-203,612,612,1192,858,16
-28,-13,0,-28.0,-13.0,0.29508066177368164,444.79244693347084,91,-411,-190,612,612,1192,858,16
-28,-14,0,-28.0,-14.0,0.30302953720092773,413.50326214633264,91,-383,-176,612,612,1192,858,16
-27,-13,0,-27.0,-13.0,0.3111085891723633,383.54182407502776,91,-356,-163,612,612,1192,858,16
-22,-12,0,-22.0,-12.0,0.3191416263580322,358.5474048469038,91,-334,-151,612,612,1192,858,16
-20,-12,0,-20.0,-12.0,0.3271036148071289,335.39044832377033,91,-314,-139,612,612,1192,858,16
-18,-10,0,-18.0,-10.0,0.3351147174835205,314.88852565552713,91,-296,-129,612,612,1192,858,16
-17,-10,0,-17.0,-10.0,0.34313368797302246,295.3183146465112,91,-279,-119,612,612,1192,858,16
-17,-10,0,-17.0,-10.0,0.35118651390075684,275.7692724732542,91,-262,-109,612,612,1192,858,16
-18,-10,0,-18.0,-10.0,0.3591437339782715,255.31919793285107,91,-244,-99,612,612,1192,858,16
-19,-11,0,-19.0,-11.0,0.36716461181640625,233.5967715016076,91,-225,-88,612,612,1192,858,16
-20,-9,0,-20.0,-9.0,0.37507152557373047,211.69524346239268,91,-205,-79,612,612,1192,858,16
-20,-9,0,-20.0,-9.0,0.3830597400665283,189.80040444852483,91,-185,-70,612,612,1192,858,16
-19,-8,0,-19.0,-8.0,0.3911776542663574,169.2004514666935,91,-166,-62,612,612,1192,858,16
-17,-6,0,-17.0,-6.0,0.3991255760192871,151.17600321656528,91,-149,-56,612,612,1192,858,16
-13,-6,0,-13.0,-6.0,0.4071927070617676,136.89996549343965,91,-136,-50,612,612,1192,858,16
-12,-4,0,-12.0,-4.0,0.4152987003326416,124.25732493892352,91,-124,-46,612,612,1192,858,16
-10,-4,0,-10.0,-4.0,0.42313551902770996,113.49074038789952,91,-114,-42,612,612,1192,858,16
-7,-3,0,-7.0,-3.0,0.4312245845794678,105.8859078200635,91,-107,-39,612,612,1192,858,16
-6,-3,0,-6.0,-3.0,0.4391825199127197,99.2240644631605,91,-101,-36,612,612,1192,858,16
-5,-2,0,-5.0,-2.0,0.4470176696777344,93.84301645179212,91,-96,-34,612,612,1192,858,16
-6,-2,0,-6.0,-2.0,0.45511364936828613,87.51963149007642,91,-90,-32,612,612,1192,858,16
-5,-3,0,-5.0,-3.0,0.46309661865234375,81.81091247727082,91,-85,-29,612,612,1192,858,16
-6,-1,0,-6.0,-1.0,0.47110867500305176,75.81527307120105,91,-79,-28,612,612,1192,858,16
-7,-3,0,-7.0,-3.0,0.4792666435241699,68.21679604916491,91,-72,-25,612,612,1192,858,16
-6,-1,0,-6.0,-1.0,0.4871056079864502,62.228199464317754,91,-66,-24,612,612,1192,858,16
-6,-2,0,-6.0,-2.0,0.49515867233276367,55.90618123468183,91,-60,-22,612,612,1192,858,16
-6,-1,0,-6.0,-1.0,0.5031147003173828,49.9396237474839,91,-54,-21,612,612,1192,858,16
-7,-1,0,-7.0,-1.0,0.5111396312713623,43.07837115648854,91,-47,-20,612,612,1192,858,16
-7,-2,0,-7.0,-2.0,0.5190515518188477,35.86342439892262,91,-40,-18,612,612,1192,858,16
-5,-1,0,-5.0,-1.0,0.5270025730133057,30.910152916687437,91,-35,-17,612,612,1192,858,16
-4,-1,0,-4.0,-1.0,0.5352046489715576,26.88552708502482,91,-31,-16,612,612,1192,858,16
-2,0,0,-2.0,-0.0,0.5431296825408936,25.12099032335839,91,-29,-16,612,612,1192,858,16
-4,-1,0,-4.0,-1.0,0.5511186122894287,21.154759474226502,91,-25,-15,612,612,1192,858,16
-3,0,0,-3.0,-0.0,0.5591115951538086,18.627053911388696,91,-22,-15,612,612,1192,858,16
-2,-1,0,-2.0,-1.0,0.5672245025634766,16.413111231467404,91,-20,-14,612,612,1192,858,16
-2,0,0,-2.0,-0.0,0.5751185417175293,14.803508501982758,91,-18,-14,612,612,1192,858,16
-2,0,0,-2.0,-0.0,0.5830166339874268,13.2602916254693,91,-16,-14,612,612,1192,858,16
-2,-1,0,-2.0,-1.0,0.5910816192626953,11.104973174542799,91,-14,-13,612,612,1192,858,16
-2,0,0,-2.0,-0.0,0.5992035865783691,9.691806012954132,91,-12,-13,612,612,1192,858,16
-2,-1,0,-2.0,-1.0,0.6071786880493164,7.620499351813308,91,-10,-12,612,612,1192,858,16
-2,-1,0,-2.0,-1.0,0.6151556968688965,5.601470508735444,91,-8,-11,612,612,1192,858,16
-3,-2,0,-3.0,-2.0,0.6231076717376709,2.295630140987001,91,-5,-9,612,612,1192,858,16
-4,-2,0,-4.0,-2.0,0.631157636642456,-0.9289321881345245,91,-1,-7,612,612,1192,858,16
-3,-1,0,-3.0,-1.0,0.639251708984375,-1.675444679663241,91,2,-6,612,612,1192,858,16
-4,-3,0,-4.0,-3.0,0.647160530090332,-1.2917960675006306,91,6,-3,612,612,1192,858,16
-3,-1,0,-3.0,-1.0,0.6550736427307129,1.219544457292887,91,9,-2,612,612,1192,858,16
-3,-1,0,-3.0,-1.0,0.6631295680999756,4.041594578792296,91,12,-1,612,612,1192,858,16
-1,-1,0,-1.0,-1.0,0.6711866855621338,5.0,91,13,0,612,612,1192,858,16
-1,-1,0,-1.0,-1.0,0.6791596412658691,6.035668847618199,91,14,1,612,612,1192,858,16
0,-1,0,-0.0,-1.0,0.6950507164001465,6.142135623730951,91,14,2,612,612,1192,858,16
0,0,1,-0.0,-0.0,0.7900035381317139,6.142135623730951,91,14,2,612,612,1192,858,16
0,0,0,-0.0,-0.0,0.05413532257080078,1079.1175880489457,92,1103,157,1701,767,598,610,71
0,-1,0,-0.0,-1.0,0.15920519828796387,1079.2589465649355,92,1103,158,1701,767,598,610,71
1,-3,0,1.0,-3.0,0.16730523109436035,1078.6987923132538,92,1102,161,1701,767,598,610,71
3,-2,0,3.0,-2.0,0.17529821395874023,1076.022051986368,92,1099,163,1701,767,598,610,71
2,-2,0,2.0,-2.0,0.1831521987915039,1074.3394430921494,92,1097,165,1701,767,598,610,71
3,-3,0,3.0,-3.0,0.19118118286132812,1071.8242859641273,92,1094,168,1701,767,598,610,71
3,-1,0,3.0,-1.0,0.19912433624267578,1069.0117752995209,92,1091,169,1701,767,598,610,71
5,-1,0,5.0,-1.0,0.2074272632598877,1064.225181662065,92,1086,170,1701,767,598,610,71
5,-2,0,5.0,-2.0,0.2154092788696289,1059.5980997608208,92,1081,172,1701,767,598,610,71
8,0,0,8.0,-0.0,0.22324228286743164,1051.698210176128,92,1073,172,1701,767,598,610,71
10,0,0,10.0,-0.0,0.23122334480285645,1041.8254268914716,92,1063,172,1701,767,598,610,71
15,0,0,15.0,-0.0,0.23922133445739746,1027.020715428847,92,1048,172,1701,767,598,610,71
24,0,0,24.0,-0.0,0.2471942901611328,1003.3448367474073,92,1024,172,1701,767,598,610,71
29,2,0,29.0,2.0,0.2552213668823242,974.4181492325171,92,995,170,1701,767,598,610,71
36,5,0,36.0,5.0,0.2631862163543701,938.090951555917,92,959,165,1701,767,598,610,71
43,5,0,43.0,5.0,0.2713332176208496,894.8688079508851,92,916,160,1701,767,598,610,71
47,7,0,47.0,7.0,0.2792513370513916,847.366137156226,92,869,153,1701,767,598,610,71
51,7,0,51.0,7.0,0.287365198135376,795.9271929597683,92,818,146,1701,767,598,610,71
51,8,0,51.0,8.0,0.29526233673095703,744.3157254925632,92,767,138,1701,767,598,610,71
53,8,0,53.0,8.0,0.3032493591308594,690.7382448238483,92,714,130,1701,767,598,610,71
48,6,0,48.0,6.0,0.31122732162475586,642.4452007358234,92,666,124,1701,767,598,610,71
45,5,0,45.0,5.0,0.3191971778869629,597.2989799137747,92,621,119,1701,767,598,610,71
42,6,0,42.0,6.0,0.32727837562561035,554.9237238830118,92,579,113,1701,767,598,610,71
38,4,0,38.0,4.0,0.33524131774902344,516.8713618226625,92,541,109,1701,767,598,610,71
34,4,0,34.0,4.0,0.34322619438171387,482.75863102414814,92,507,105,1701,767,598,610,71
33,4,0,33.0,4.0,0.3511621952056885,449.6411043236015,92,474,101,1701,767,598,610,71
28,3,0,28.0,3.0,0.35918235778808594,421.6399018920707,92,446,98,1701,767,598,610,71
27,3,0,27.0,3.0,0.36709117889404297,394.6347285776605,92,419,95,1701,767,598,610,71
23,2,0,23.0,2.0,0.37529826164245605,371.77389296757974,92,396,93,1701,767,598,610,71
24,3,0,24.0,3.0,0.3831913471221924,347.7322824116095,92,372,90,1701,767,598,610,71
20,3,0,20.0,3.0,0.3914823532104492,327.59205727649356,92,352,87,1701,767,598,610,71
21,2,0,21.0,2.0,0.39924120903015137,306.73966699814054,92,331,85,1701,767,598,610,71
22,3,0,22.0,3.0,0.4072082042694092,284.69516730785904,92,309,82,1701,767,598,610,71
22,2,0,22.0,2.0,0.4153883457183838,262.9412693803932,92,287,80,1701,767,598,610,71
22,3,0,22.0,3.0,0.42322731018066406,240.96014204953582,92,265,77,1701,767,598,610,71
23,2,0,23.0,2.0,0.43123435974121094,218.3554814879678,92,242,75,1701,767,598,610,71
22,3,0,22.0,3.0,0.43929624557495117,196.4821807396846,92,220,72,1701,767,598,610,71
21,2,0,21.0,2.0,0.4473612308502197,175.95260131128984,92,199,70,1701,767,598,610,71
20,2,0,20.0,2.0,0.4552931785583496,156.48106956041372,92,179,68,1701,767,598,610,71
18,2,0,18.0,2.0,0.46322131156921387,139.0028735394907,92,161,66,1701,767,598,610,71
15,2,0,15.0,2.0,0.47130537033081055,124.4114174079134,92,146,64,1701,767,598,610,71
12,2,0,12.0,2.0,0.47933030128479004,112.648230602334,92,134,62,1701,767,598,610,71
11,3,0,11.0,3.0,0.4873201847076416,101.41847382227965,92,123,59,1701,767,598,610,71
11,3,0,11.0,3.0,0.49521827697753906,90.21980673998823,92,112,56,1701,767,598,610,71
10,3,0,10.0,3.0,0.5032732486724854,79.94781424629178,92,102,53,1701,767,598,610,71
10,3,0,10.0,3.0,0.5111823081970215,69.70912090166739,92,92,50,1701,767,598,610,71
10,3,0,10.0,3.0,0.5193703174591064,59.51454914456292,92,82,47,1701,767,598,610,71
9,3,0,9.0,3.0,0.5272033214569092,50.234969349440135,92,73,44,1701,767,598,610,71
7,3,0,7.0,3.0,0.5352272987365723,42.69813382572325,92,66,41,1701,767,598,610,71
6,2,0,6.0,2.0,0.5432343482971191,36.56116265125938,92,60,39,1701,767,598,610,71
3,1,0,3.0,1.0,0.5512213706970215,33.505474233815804,92,57,38,1701,767,598,610,71
2,1,0,2.0,1.0,0.5592303276062012,31.2872536767062,92,55,37,1701,767,598,610,71
2,2,0,2.0,2.0,0.5671932697296143,28.513778032801667,92,53,35,1701,767,598,610,71
2,1,0,2.0,1.0,0.5751223564147949,26.29437168288782,92,51,34,1701,767,598,610,71
3,3,0,3.0,3.0,0.5833122730255127,22.140178508646613,92,48,31,1701,767,598,610,71
4,3,0,4.0,3.0,0.5913941860198975,17.153619241621193,92,44,28,1701,767,598,610,71
5,3,0,5.0,3.0,0.5992612838745117,11.324939287601879,92,39,25,1701,767,598,610,71
7,4,0,7.0,4.0,0.6072561740875244,3.2753184180092774,92,32,21,1701,767,598,610,71
5,3,0,5.0,3.0,0.6152641773223877,-2.5500385208240957,92,27,18,1701,767,598,610,71
5,3,0,5.0,3.0,0.6232712268829346,-8.372946088611304,92,22,15,1701,767,598,610,71
5,1,0,5.0,1.0,0.6311872005462646,-12.977284454454761,92,17,14,1701,767,598,610,71
2,2,0,2.0,2.0,0.6391491889953613,-15.790627287701454,92,15,12,1701,767,598,610,71
3,1,0,3.0,1.0,0.6472282409667969,-18.721179403900294,92,12,11,1701,767,598,610,71
2,1,0,2.0,1.0,0.655205249786377,-20.85786437626905,92,10,10,1701,767,598,610,71
2,1,0,2.0,1.0,0.6631581783294678,-22.958405421207704,92,8,9,1701,767,598,610,71
2,0,0,2.0,-0.0,0.6712543964385986,-24.18334617360803,92,6,9,1701,767,598,610,71
0,1,0,-0.0,1.0,0.6792523860931396,-25.0,92,6,8,1701,767,598,610,71
0,0,1,-0.0,-0.0,0.724196195602417,-25.0,92,6,8,1701,767,598,610,71
0,0,0,-0.0,-0.0,0.05502963066101074,1313.3239144788633,93,-1269,-346,426,413,1695,759,5
-2,0,0,-2.0,-0.0,0.07722353935241699,1311.3944571224595,93,-1267,-346,426,413,1695,759,5
-3,0,0,-3.0,-0.0,0.08515167236328125,1308.50066768392,93,-1264,-346,426,413,1695,759,5
-3,1,0,-3.0,1.0,0.0931406021118164,1305.872317927098,93,-1261,-347,426,413,1695,759,5
-3,0,0,-3.0,-0.0,0.10111570358276367,1302.9800764762656,93,-1258,-347,426,413,1695,759,5
-6,0,0,-6.0,-0.0,0.10913348197937012,1297.1970597257368,93,-1252,-347,426,413,1695,759,5
-9,0,0,-9.0,-0.0,0.11724352836608887,1288.5262492487318,93,-1243,-347,426,413,1695,759,5
-11,-2,0,-11.0,-2.0,0.1249995231628418,1277.3939971720986,93,-1232,-345,426,413,1695,759,5
-13,-2,0,-13.0,-2.0,0.13303256034851074,1264.3372378635954,93,-1219,-343,426,413,1695,759,5
-13,-2,0,-13.0,-2.0,0.14098262786865234,1251.2824901034883,93,-1206,-341,426,413,1695,759,5
-15,-2,0,-15.0,-2.0,0.14901947975158691,1236.3061010913254,93,-1191,-339,426,413,1695,759,5
-19,-4,0,-19.0,-4.0,0.15707755088806152,1216.9376522201617,93,-1172,-335,426,413,1695,759,5
-17,-2,0,-17.0,-2.0,0.1652836799621582,1200.0457562006532,93,-1155,-333,426,413,1695,759,5
-19,-4,0,-19.0,-4.0,0.1731715202331543,1180.6821212819614,93,-1136,-329,426,413,1695,759,5
-16,-3,0,-16.0,-3.0,0.18109750747680664,1164.4801755709352,93,-1120,-326,426,413,1695,759,5
-17,-3,0,-17.0,-3.0,0.18937969207763672,1147.3206689170781,93,-1103,-323,426,413,1695,759,5
-17,-3,0,-17.0,-3.0,0.1971886157989502,1130.164299030843,93,-1086,-320,426,413,1695,759,5
-15,-2,0,-15.0,-2.0,0.2051255702972412,1115.213050407128,93,-1071,-318,426,413,1695,759,5
-17,-4,0,-17.0,-4.0,0.21309351921081543,1097.7781594485316,93,-1054,-314,426,413,1695,759,5
-18,-3,0,-18.0,-3.0,0.22117066383361816,1079.6732408634318,93,-1036,-311,426,413,1695,759,5
-20,-4,0,-20.0,-4.0,0.22911357879638672,1059.3693984659628,93,-1016,-307,426,413,1695,759,5
-23,-5,0,-23.0,-5.0,0.23717164993286133,1035.907992068661,93,-993,-302,426,413,1695,759,5
-23,-5,0,-23.0,-5.0,0.24525666236877441,1012.4500973433834,93,-970,-297,426,413,1695,759,5
-24,-5,0,-24.0,-5.0,0.2530674934387207,988.0404032159496,93,-946,-292,426,413,1695,759,5
-26,-5,0,-26.0,-5.0,0.26129651069641113,961.726620987508,93,-920,-287,426,413,1695,759,5
-26,-7,0,-26.0,-7.0,0.26910948753356934,934.8222883770433,93,-894,-280,426,413,1695,759,5
-29,-7,0,-29.0,-7.0,0.27713656425476074,905.0578812843203,93,-865,-273,426,413,1695,759,5
-31,-9,0,-31.0,-9.0,0.2852165699005127,872.7868311766016,93,-834,-264,426,413,1695,759,5
-37,-9,0,-37.0,-9.0,0.2932276725769043,834.7998565965461,93,-797,-255,426,413,1695,759,5
-39,-11,0,-39.0,-11.0,0.30109548568725586,794.3039620647382,93,-758,-244,426,413,1695,759,5
-41,-10,0,-41.0,-10.0,0.30903053283691406,752.2181382067128,93,-717,-234,426,413,1695,759,5
-43,-10,0,-43.0,-10.0,0.3171086311340332,708.2478440657177,93,-674,-224,426,413,1695,759,5
-44,-10,0,-44.0,-10.0,0.325089693069458,663.3540410939127,93,-630,-214,426,413,1695,759,5
-44,-10,0,-44.0,-10.0,0.33316659927368164,618.4933520997627,93,-586,-204,426,413,1695,759,5
-43,-10,0,-43.0,-10.0,0.34110069274902344,574.6151229373021,93,-543,-194,426,413,1695,759,5
-41,-10,0,-41.0,-10.0,0.349184513092041,532.658769683992,93,-502,-184,426,413,1695,759,5
-38,-9,0,-38.0,-9.0,0.35718750953674316,493.9042246240699,93,-464,-175,426,413,1695,759,5
-37,-10,0,-37.0,-10.0,0.36501264572143555,455.77068495044546,93,-427,-165,426,413,1695,759,5
-31,-8,0,-31.0,-8.0,0.37305665016174316,423.98708900622796,93,-396,-157,426,413,1695,759,5
-30,-7,0,-30.0,-7.0,0.38112950325012207,393.5451933723882,93,-366,-150,426,413,1695,759,5
-25,-7,0,-25.0,-7.0,0.38912153244018555,367.77019890737546,93,-341,-143,426,413,1695,759,5
-23,-6,0,-23.0,-6.0,0.39711451530456543,344.2556858738929,93,-318,-137,426,413,1695,759,5
-22,-4,0,-22.0,-4.0,0.40503954887390137,322.5073188696982,93,-296,-133,426,413,1695,759,5
-21,-4,0,-21.0,-4.0,0.41297459602355957,301.75318928366823,93,-275,-129,426,413,1695,759,5
-18,-4,0,-18.0,-4.0,0.42107248306274414,283.78663369723927,93,-257,-125,426,413,1695,759,5
-18,-2,0,-18.0,-2.0,0.42907261848449707,266.79360111431225,93,-239,-123,426,413,1695,759,5
-14,-3,0,-14.0,-3.0,0.4370555877685547,253.0,93,-225,-120,426,413,1695,759,5
-12,-2,0,-12.0,-2.0,0.44504451751708984,241.50154003619772,93,-213,-118,426,413,1695,759,5
-11,-2,0,-11.0,-2.0,0.4531126022338867,230.93775992741064,93,-202,-116,426,413,1695,759,5
-9,-2,0,-9.0,-2.0,0.4611055850982666,222.1539649437413,93,-193,-114,426,413,1695,759,5
-6,-2,0,-6.0,-2.0,0.4691126346588135,215.97476918212345,93,-187,-112,426,413,1695,759,5
-4,-1,0,-4.0,-1.0,0.47722768783569336,212.03270778084362,93,-183,-111,426,413,1695,759,5
-4,-2,0,-4.0,-2.0,0.4851114749908447,207.57576195734086,93,-179,-109,426,413,1695,759,5
-4,-2,0,-4.0,-2.0,0.49302053451538086,203.11947737842937,93,-175,-107,426,413,1695,759,5
-5,-2,0,-5.0,-2.0,0.5010986328125,197.81241202688085,93,-170,-105,426,413,1695,759,5
-5,-4,0,-5.0,-4.0,0.5090415477752686,191.45800577903205,93,-165,-101,426,413,1695,759,5
-7,-3,0,-7.0,-3.0,0.5171515941619873,183.9247159470736,93,-158,-98,426,413,1695,759,5
-7,-4,0,-7.0,-4.0,0.525078535079956,175.867928531256,93,-151,-94,426,413,1695,759,5
-5,-3,0,-5.0,-3.0,0.5331296920776367,170.03778654702577,93,-146,-91,426,413,1695,759,5
-4,-5,0,-4.0,-5.0,0.5411906242370605,164.01204775557707,93,-142,-86,426,413,1695,759,5
-5,-4,0,-5.0,-4.0,0.5493745803833008,157.66527487215245,93,-137,-82,426,413,1695,759,5
-4,-3,0,-4.0,-3.0,0.5570766925811768,152.69324484281788,93,-133,-79,426,413,1695,759,5
-3,-4,0,-3.0,-4.0,0.5650246143341064,148.08331019803634,93,-130,-75,426,413,1695,759,5
-4,-4,0,-4.0,-4.0,0.5731706619262695,142.62710672622887,93,-126,-71,426,413,1695,759,5
-5,-5,0,-5.0,-5.0,0.5811316967010498,135.82960494755835,93,-121,-66,426,413,1695,759,5
-5,-5,0,-5.0,-5.0,0.5890576839447021,129.06105447462264,93,-116,-61,426,413,1695,759,5
-5,-3,0,-5.0,-3.0,0.5971264839172363,123.23977004130916,93,-111,-58,426,413,1695,759,5
-4,-2,0,-4.0,-2.0,0.6051785945892334,118.7683733433551,93,-107,-56,426,413,1695,759,5
-4,-2,0,-4.0,-2.0,0.6131625175476074,114.29703349613007,93,-103,-54,426,413,1695,759,5
-4,-2,0,-4.0,-2.0,0.6212425231933594,109.8257573191436,93,-99,-52,426,413,1695,759,5
-3,-1,0,-3.0,-1.0,0.6289784908294678,106.70602559196064,93,-96,-51,426,413,1695,759,5
-2,0,0,-2.0,-0.0,0.6370265483856201,104.94391053257777,93,-94,-51,426,413,1695,759,5
-2,0,0,-2.0,-0.0,0.6450936794281006,103.19030373565806,93,-92,-51,426,413,1695,759,5
-2,-1,0,-2.0,-1.0,0.6529896259307861,100.95630140987001,93,-90,-50,426,413,1695,759,5
-3,-2,0,-3.0,-2.0,0.6611526012420654,97.36297097007517,93,-87,-48,426,413,1695,759,5
-5,-1,0,-5.0,-1.0,0.6691126823425293,92.51454914456292,93,-82,-47,426,413,1695,759,5
-6,-2,0,-6.0,-2.0,0.6770834922790527,86.32326986700618,93,-76,-45,426,413,1695,759,5
-5,-2,0,-5.0,-2.0,0.6851186752319336,81.00602387778854,93,-71,-43,426,413,1695,759,5
-5,-2,0,-5.0,-2.0,0.6931896209716797,75.69813382572325,93,-66,-41,426,413,1695,759,5
-4,-1,0,-4.0,-1.0,0.701136589050293,71.78346698278686,93,-62,-40,426,413,1695,759,5
-4,-1,0,-4.0,-1.0,0.7092466354370117,67.8927750200262,93,-58,-39,426,413,1695,759,5
-4,-1,0,-4.0,-1.0,0.7170026302337646,64.03029607687671,93,-54,-38,426,413,1695,759,5
-3,-1,0,-3.0,-1.0,0.7250666618347168,61.00793600809346,93,-51,-37,426,413,1695,759,5
-3,-1,0,-3.0,-1.0,0.733102560043335,58.0,93,-48,-36,426,413,1695,759,5
-3,-1,0,-3.0,-1.0,0.7410666942596436,55.0087712549569,93,-45,-35,426,413,1695,759,5
-2,-1,0,-2.0,-1.0,0.7491195201873779,52.817880294662984,93,-43,-34,426,413,1695,759,5
-3,-2,0,-3.0,-2.0,0.757178544998169,49.22499389946279,93,-40,-32,426,413,1695,759,5
-3,-1,0,-3.0,-1.0,0.7650885581970215,46.27007354458868,93,-37,-31,426,413,1695,759,5
-3,-2,0,-3.0,-2.0,0.7730836868286133,42.68780594300866,93,-34,-29,426,413,1695,759,5
-3,-1,0,-3.0,-1.0,0.7810075283050537,39.773197148410844,93,-31,-28,426,413,1695,759,5
-3,-2,0,-3.0,-2.0,0.7890136241912842,36.2099463490856,93,-28,-26,426,413,1695,759,5
-2,-1,0,-2.0,-1.0,0.7971224784851074,34.069377593742864,93,-26,-25,426,413,1695,759,5
-2,-1,0,-2.0,-1.0,0.8051185607910156,31.941125496954278,93,-24,-24,426,413,1695,759,5
-1,-1,0,-1.0,-1.0,0.8131036758422852,30.526911934581186,93,-23,-23,426,413,1695,759,5
-2,-1,0,-2.0,-1.0,0.821129560470581,28.4138126514911,93,-21,-22,426,413,1695,759,5
-2,-1,0,-2.0,-1.0,0.8293366432189941,26.319604517012593,93,-19,-21,426,413,1695,759,5
-1,-1,0,-1.0,-1.0,0.8370215892791748,24.90724809414742,93,-18,-20,426,413,1695,759,5
-2,-1,0,-2.0,-1.0,0.8450336456298828,22.839484696748443,93,-16,-19,426,413,1695,759,5
-2,-2,0,-2.0,-2.0,0.8530106544494629,20.02271554554524,93,-14,-17,426,413,1695,759,5
-2,-2,0,-2.0,-2.0,0.8610565662384033,17.209372712298546,93,-12,-15,426,413,1695,759,5
-1,-1,0,-1.0,-1.0,0.8692526817321777,15.804493814764857,93,-11,-14,426,413,1695,759,5
-2,-2,0,-2.0,-2.0,0.8771755695343018,13.0,93,-9,-12,426,413,1695,759,5
-1,-2,0,-1.0,-2.0,0.885183572769165,10.806248474865697,93,-8,-10,426,413,1695,759,5
-2,-2,0,-2.0,-2.0,0.8932106494903564,8.0,93,-6,-8,426,413,1695,759,5
-3,-2,0,-3.0,-2.0,0.9011585712432861,4.708203932499369,93,-3,-6,426,413,1695,759,5
-2,-2,0,-2.0,-2.0,0.909233570098877,2.1231056256176606,93,-1,-4,426,413,1695,759,5
-2,-1,0,-2.0,-1.0,0.9170126914978027,1.1622776601683795,93,1,-3,426,413,1695,759,5
-1,-2,0,-1.0,-2.0,0.9250106811523438,0.2360679774997898,93,2,-1,426,413,1695,759,5
-2,-1,0,-2.0,-1.0,0.9329805374145508,2.0,93,4,0,426,413,1695,759,5
-1,-2,0,-1.0,-2.0,0.9410185813903809,3.3851648071345037,93,5,2,426,413,1695,759,5
-1,-1,0,-1.0,-1.0,0.9491105079650879,4.708203932499369,93,6,3,426,413,1695,759,5
-1,-1,0,-1.0,-1.0,0.9571585655212402,6.062257748298549,93,7,4,426,413,1695,759,5
-1,-1,0,-1.0,-1.0,0.965125560760498,7.433981132056603,93,8,5,426,413,1695,759,5
0,-1,0,-0.0,-1.0,0.9731245040893555,8.0,93,8,6,426,413,1695,759,5
0,-1,0,-0.0,-1.0,1.045116662979126,8.63014581273465,93,8,7,426,413,1695,759,5
2,-1,0,2.0,-1.0,1.068988561630249,8.0,93,6,8,426,413,1695,759,5
1,-1,0,1.0,-1.0,1.0770506858825684,8.295630140987,93,5,9,426,413,1695,759,5
1,0,0,1.0,-0.0,1.1170744895935059,7.848857801796104,93,4,9,426,413,1695,759,5
0,0,1,-0.0,-0.0,1.125314474105835,7.848857801796104,93,4,9,426,413,1695,759,5
0,0,0,-0.0,-0.0,1.230022668838501,7.848857801796104,93,4,9,426,413,1695,759,5
1,0,0,1.0,-0.0,1.3651516437530518,7.486832980505138,93,3,9,426,413,1695,759,5
1,1,0,1.0,1.0,1.3730545043945312,6.246211251235321,93,2,8,426,413,1695,759,5
0,1,0,-0.0,1.0,1.3811686038970947,5.280109889280518,93,2,7,426,413,1695,759,5
0,1,0,-0.0,1.0,1.389103651046753,4.324555320336759,93,2,6,426,413,1695,759,5
0,1,0,-0.0,1.0,1.4131755828857422,3.3851648071345037,93,2,5,426,413,1695,759,5
0,0,1,-0.0,-0.0,1.4171876907348633,3.3851648071345037,93,2,5,426,413,1695,759,5
1,1,1,1.0,1.0,1.4211466312408447,2.1231056256176606,93,1,4,426,413,1695,759,5
0,1,1,-0.0,1.0,1.4291834831237793,1.1622776601683795,93,1,3,426,413,1695,759,5
0,1,1,-0.0,1.0,1.4531965255737305,0.2360679774997898,93,1,2,426,413,1695,759,5
0,0,0,-0.0,-0.0,1.5072236061096191,0.2360679774997898,93,1,2,426,413,1695,759,5
0,0,1,-0.0,-0.0,1.6530065536499023,0.2360679774997898,93,1,2,426,413,1695,759,5
0,0,0,-0.0,-0.0,0.09766888618469238,757.3084636451524,94,-325,716,100,1127,425,411,58
1,0,0,1.0,-0.0,0.21261096000671387,757.722314415957,94,-326,716,100,1127,425,411,58
0,1,0,-0.0,1.0,0.26868391036987305,756.812318559591,94,-326,715,100,1127,425,411,58
0,5,0,-0.0,5.0,0.2767519950866699,752.265639843453,94,-326,710,100,1127,425,411,58
0,6,0,-0.0,6.0,0.2846379280090332,746.8169887286563,94,-326,704,100,1127,425,411,58
-1,5,0,-1.0,5.0,0.2928049564361572,741.8605580777888,94,-325,699,100,1127,425,411,58
-2,7,0,-2.0,7.0,0.30071592330932617,734.6707405682112,94,-323,692,100,1127,425,411,58
-4,8,0,-4.0,8.0,0.3087189197540283,725.7297529579711,94,-319,684,100,1127,425,411,58
-3,9,0,-3.0,9.0,0.3166840076446533,716.3059774347714,94,-316,675,100,1127,425,411,58
-4,11,0,-4.0,11.0,0.32473087310791016,704.648417159064,94,-312,664,100,1127,425,411,58
-5,11,0,-5.0,11.0,0.3327808380126953,692.56635176538,94,-307,653,100,1127,425,411,58
-7,14,0,-7.0,14.0,0.3406548500061035,676.9185505424829,94,-300,639,100,1127,425,411,58
-9,18,0,-9.0,18.0,0.3488149642944336,656.8002624671414,94,-291,621,100,1127,425,411,58
-8,20,0,-8.0,20.0,0.3565819263458252,635.2966204941886,94,-283,601,100,1127,425,411,58
-10,23,0,-10.0,23.0,0.36463189125061035,610.2284411695086,94,-273,578,100,1127,425,411,58
-11,23,0,-11.0,23.0,0.37280797958374023,584.7336555868515,94,-262,555,100,1127,425,411,58
-11,23,0,-11.0,23.0,0.3807849884033203,559.2388970477896,94,-251,532,100,1127,425,411,58
-12,24,0,-12.0,24.0,0.38875579833984375,532.4133949239188,94,-239,508,100,1127,425,411,58
-11,22,0,-11.0,22.0,0.3966858386993408,507.8239935025259,94,-228,486,100,1127,425,411,58
-10,22,0,-10.0,22.0,0.40465402603149414,483.659731205797,94,-218,464,100,1127,425,411,58
-10,23,0,-10.0,23.0,0.41257691383361816,458.5910171444917,94,-208,441,100,1127,425,411,58
-9,22,0,-9.0,22.0,0.4206228256225586,434.85558097321626,94,-199,419,100,1127,425,411,58
-9,22,0,-9.0,22.0,0.4285709857940674,411.12384620695116,94,-190,397,100,1127,425,411,58
-10,21,0,-10.0,21.0,0.4367239475250244,387.8644863741693,94,-180,376,100,1127,425,411,58
-9,22,0,-9.0,22.0,0.4447169303894043,364.1373805681673,94,-171,354,100,1127,425,411,58
-9,22,0,-9.0,22.0,0.4527018070220947,340.4157549428557,94,-162,332,100,1127,425,411,58
-9,21,0,-9.0,21.0,0.46082496643066406,317.5977495599185,94,-153,311,100,1127,425,411,58
-8,20,0,-8.0,20.0,0.4687309265136719,296.12459150301135,94,-145,291,100,1127,425,411,58
-7,19,0,-7.0,19.0,0.4767148494720459,276.00491799313664,94,-138,272,100,1127,425,411,58
-6,18,0,-6.0,18.0,0.4846818447113037,257.2516375499012,94,-132,254,100,1127,425,411,58
-5,17,0,-5.0,17.0,0.492628812789917,239.88287412923864,94,-127,237,100,1127,425,411,58
-5,17,0,-5.0,17.0,0.5005819797515869,222.56311335328954,94,-122,220,100,1127,425,411,58
-3,15,0,-3.0,15.0,0.5086119174957275,208.0358622656074,94,-119,205,100,1127,425,411,58
-3,12,0,-3.0,12.0,0.5167748928070068,196.17770760001977,94,-116,193,100,1127,425,411,58
-3,12,0,-3.0,12.0,0.5247678756713867,184.37759957408838,94,-113,181,100,1127,425,411,58
-2,9,0,-2.0,9.0,0.5327270030975342,175.70710783946902,94,-111,172,100,1127,425,411,58
-1,10,0,-1.0,10.0,0.5407319068908691,166.816240388789,94,-110,162,100,1127,425,411,58
-2,10,0,-2.0,10.0,0.5487978458404541,157.46179233290664,94,-108,152,100,1127,425,411,58
-1,10,0,-1.0,10.0,0.5566098690032959,148.80044994318772,94,-107,142,100,1127,425,411,58
-2,10,0,-2.0,10.0,0.5647339820861816,139.66831356244717,94,-105,132,100,1127,425,411,58
-2,11,0,-2.0,11.0,0.572645902633667,129.90248582070703,94,-103,121,100,1127,425,411,58
-2,9,0,-2.0,9.0,0.5808048248291016,121.81445554057476,94,-101,112,100,1127,425,411,58
-3,8,0,-3.0,8.0,0.5888559818267822,113.89856542317,94,-98,104,100,1127,425,411,58
-2,7,0,-2.0,7.0,0.5967488288879395,107.4734406395618,94,-96,97,100,1127,425,411,58
-3,6,0,-3.0,6.0,0.6047399044036865,101.11533345459327,94,-93,91,100,1127,425,411,58
-2,4,0,-2.0,4.0,0.6128149032592773,96.89678312014172,94,-91,87,100,1127,425,411,58
-2,4,0,-2.0,4.0,0.6209108829498291,92.69634341261039,94,-89,83,100,1127,425,411,58
-1,2,0,-1.0,2.0,0.6288058757781982,90.60351165413162,94,-88,81,100,1127,425,411,58
-2,2,0,-2.0,2.0,0.6367928981781006,87.77756633874505,94,-86,79,100,1127,425,411,58
-2,2,0,-2.0,2.0,0.6447458267211914,84.95174417269794,94,-84,77,100,1127,425,411,58
-2,1,0,-2.0,1.0,0.6527979373931885,82.80339887498948,94,-82,76,100,1127,425,411,58
-2,3,0,-2.0,3.0,0.660714864730835,79.30050784737807,94,-80,73,100,1127,425,411,58
-3,4,0,-3.0,4.0,0.6686649322509766,74.39245620450265,94,-77,69,100,1127,425,411,58
-4,3,0,-4.0,3.0,0.6766388416290283,69.41239759298622,94,-73,66,100,1127,425,411,58
-3,3,0,-3.0,3.0,0.6847009658813477,65.17536832951598,94,-70,63,100,1127,425,411,58
-3,2,0,-3.0,2.0,0.6927199363708496,61.60905032059435,94,-67,61,100,1127,425,411,58
-2,3,0,-2.0,3.0,0.7011640071868896,58.114866699088736,94,-65,58,100,1127,425,411,58
-3,3,0,-3.0,3.0,0.7087099552154541,53.87943049997388,94,-62,55,100,1127,425,411,58
-4,3,0,-4.0,3.0,0.7166938781738281,48.89736837660179,94,-58,52,100,1127,425,411,58
-3,3,0,-3.0,3.0,0.7245779037475586,44.66138744281159,94,-55,49,100,1127,425,411,58
-3,3,0,-3.0,3.0,0.7326979637145996,40.42621983083913,94,-52,46,100,1127,425,411,58
-3,4,0,-3.0,4.0,0.740710973739624,35.53681120105021,94,-49,42,100,1127,425,411,58
-2,2,0,-2.0,2.0,0.7487180233001709,32.71709649683789,94,-47,40,100,1127,425,411,58
-2,2,0,-2.0,2.0,0.7566728591918945,29.89821729050889,94,-45,38,100,1127,425,411,58
-3,4,0,-3.0,4.0,0.7646768093109131,25.037024344425184,94,-42,34,100,1127,425,411,58
-4,3,0,-4.0,3.0,0.7727909088134766,20.040799340956916,94,-38,31,100,1127,425,411,58
-3,4,0,-3.0,4.0,0.7807168960571289,15.204072210600685,94,-35,27,100,1127,425,411,58
-4,4,0,-4.0,4.0,0.7887468338012695,9.600518131237564,94,-31,23,100,1127,425,411,58
-2,3,0,-2.0,3.0,0.7967729568481445,6.227829907617071,94,-29,20,100,1127,425,411,58
-2,2,0,-2.0,2.0,0.8046278953552246,3.4499614791759043,94,-27,18,100,1127,425,411,58
-2,1,0,-2.0,1.0,0.8127808570861816,1.2324329156619491,94,-25,17,100,1127,425,411,58
-2,2,0,-2.0,2.0,0.8208208084106445,-1.5409395645080366,94,-23,15,100,1127,425,411,58
-2,2,0,-2.0,2.0,0.8287179470062256,-4.301821929543063,94,-21,13,100,1127,425,411,58
-1,1,0,-1.0,1.0,0.8367359638214111,-5.676192420618797,94,-20,12,100,1127,425,411,58
-2,1,0,-2.0,1.0,0.8447129726409912,-7.904976890271012,94,-18,11,100,1127,425,411,58
0,1,0,-0.0,1.0,0.8526289463043213,-8.408739718025998,94,-18,10,100,1127,425,411,58
-1,0,0,-1.0,-0.0,0.8607180118560791,-9.27691707668398,94,-17,10,100,1127,425,411,58
0,0,1,-0.0,-0.0,0.903662919998169,-9.27691707668398,94,-17,10,100,1127,425,411,58
0,0,0,-0.0,-0.0,0.0560610294342041,1474.7680166061234,95,1274,-812,1391,305,117,1117,73
1,0,0,1.0,-0.0,0.0651700496673584,1473.9248325661779,95,1273,-812,1391,305,117,1117,73
2,0,0,2.0,-0.0,0.07329416275024414,1472.2390394098675,95,1271,-812,1391,305,117,1117,73
4,0,0,4.0,-0.0,0.0816810131072998,1468.8697618066487,95,1267,-812,1391,305,117,1117,73
3,-1,0,3.0,-1.0,0.0891420841217041,1465.8045811622762,95,1264,-811,1391,305,117,1117,73
4,-1,0,4.0,-1.0,0.09708309173583984,1461.8985279383915,95,1260,-810,1391,305,117,1117,73
3,-1,0,3.0,-1.0,0.10525918006896973,1458.8344389931615,95,1257,-809,1391,305,117,1117,73
5,-3,0,5.0,-3.0,0.1132972240447998,1453.0063801072176,95,1252,-806,1391,305,117,1117,73
6,-3,0,6.0,-3.0,0.12117314338684082,1446.3376808271455,95,1246,-803,1391,305,117,1117,73
9,-4,0,9.0,-4.0,0.12914514541625977,1436.6065326488267,95,1237,-799,1391,305,117,1117,73
9,-4,0,9.0,-4.0,0.13714814186096191,1426.8769599662166,95,1228,-795,1391,305,117,1117,73
13,-4,0,13.0,-4.0,0.14516401290893555,1413.7951579447354,95,1215,-791,1391,305,117,1117,73
15,-6,0,15.0,-6.0,0.15314722061157227,1397.954322842956,95,1200,-785,1391,305,117,1117,73
16,-6,0,16.0,-6.0,0.16122102737426758,1381.2850807088882,95,1184,-779,1391,305,117,1117,73
19,-8,0,19.0,-8.0,0.16919302940368652,1361.0204007100253,95,1165,-771,1391,305,117,1117,73
20,-9,0,20.0,-9.0,0.17705321311950684,1339.3795839694583,95,1145,-762,1391,305,117,1117,73
23,-11,0,23.0,-11.0,0.18518805503845215,1314.1425850627777,95,1122,-751,1391,305,117,1117,73
25,-13,0,25.0,-13.0,0.1931440830230713,1286.1395539049574,95,1097,-738,1391,305,117,1117,73
26,-12,0,26.0,-12.0,0.20119619369506836,1257.8767329231946,95,1071,-726,1391,305,117,1117,73
28,-12,0,28.0,-12.0,0.20913410186767578,1227.9798257883708,95,1043,-714,1391,305,117,1117,73
29,-13,0,29.0,-13.0,0.21712422370910645,1196.7193516774205,95,1014,-701,1391,305,117,1117,73
30,-15,0,30.0,-15.0,0.2251601219177246,1163.5215712941556,95,984,-686,1391,305,117,1117,73
31,-17,0,31.0,-17.0,0.2331562042236328,1128.3753690283902,95,953,-669,1391,305,117,1117,73
31,-20,0,31.0,-20.0,0.2410881519317627,1091.5127493735936,95,922,-649,1391,305,117,1117,73
32,-24,0,32.0,-24.0,0.24900507926940918,1051.5316087360404,95,890,-625,1391,305,117,1117,73
33,-26,0,33.0,-26.0,0.25710511207580566,1009.5859601199702,95,857,-599,1391,305,117,1117,73
34,-30,0,34.0,-30.0,0.2651669979095459,964.5448515683842,95,823,-569,1391,305,117,1117,73
33,-28,0,33.0,-28.0,0.27306509017944336,921.4868145306232,95,790,-541,1391,305,117,1117,73
31,-25,0,31.0,-25.0,0.2811460494995117,881.7891914813554,95,759,-516,1391,305,117,1117,73
27,-23,0,27.0,-23.0,0.2891402244567871,846.5378178865765,95,732,-493,1391,305,117,1117,73
24,-20,0,24.0,-20.0,0.29716920852661133,815.4652077448615,95,708,-473,1391,305,117,1117,73
23,-18,0,23.0,-18.0,0.30526018142700195,786.3442101699263,95,685,-455,1391,305,117,1117,73
21,-17,0,21.0,-17.0,0.3132941722869873,759.4495584259256,95,664,-438,1391,305,117,1117,73
22,-18,0,22.0,-18.0,0.32112908363342285,731.1792489373001,95,642,-420,1391,305,117,1117,73
22,-17,0,22.0,-17.0,0.3290870189666748,703.4653473963469,95,620,-403,1391,305,117,1117,73
21,-17,0,21.0,-17.0,0.3370320796966553,676.598765084532,95,599,-386,1391,305,117,1117,73
23,-16,0,23.0,-16.0,0.34514522552490234,648.5991527894261,95,576,-370,1391,305,117,1117,73
22,-16,0,22.0,-16.0,0.3530580997467041,621.4435336970013,95,554,-354,1391,305,117,1117,73
22,-14,0,22.0,-14.0,0.36113405227661133,595.3667713777785,95,532,-340,1391,305,117,1117,73
24,-14,0,24.0,-14.0,0.3691220283508301,567.6058316484359,95,508,-326,1391,305,117,1117,73
23,-13,0,23.0,-13.0,0.37712621688842773,541.2295903711105,95,485,-313,1391,305,117,1117,73
24,-13,0,24.0,-13.0,0.38515305519104004,514.0190905777725,95,461,-300,1391,305,117,1117,73
23,-14,0,23.0,-14.0,0.3932220935821533,487.106107783115,95,438,-286,1391,305,117,1117,73
21,-12,0,21.0,-12.0,0.40106201171875,462.96392655180995,95,417,-274,1391,305,117,1117,73
20,-12,0,20.0,-12.0,0.40912914276123047,439.66059328054496,95,397,-262,1391,305,117,1117,73
19,-12,0,19.0,-12.0,0.4171562194824219,417.19311556995217,95,378,-250,1391,305,117,1117,73
18,-11,0,18.0,-11.0,0.425137996673584,396.11225393409063,95,360,-239,1391,305,117,1117,73
17,-10,0,17.0,-10.0,0.43318819999694824,376.4196891517184,95,343,-229,1391,305,117,1117,73
17,-10,0,17.0,-10.0,0.44113612174987793,356.7301872787474,95,326,-219,1391,305,117,1117,73
15,-9,0,15.0,-9.0,0.4491121768951416,339.26124233658874,95,311,-210,1391,305,117,1117,73
16,-9,0,16.0,-9.0,0.45708322525024414,320.9677856613955,95,295,-201,1391,305,117,1117,73
17,-9,0,17.0,-9.0,0.4651961326599121,301.8579583197649,95,278,-192,1391,305,117,1117,73
15,-10,0,15.0,-10.0,0.4731872081756592,283.8327688026979,95,263,-182,1391,305,117,1117,73
14,-9,0,14.0,-9.0,0.4810349941253662,267.19960422137757,95,249,-173,1391,305,117,1117,73
11,-7,0,11.0,-7.0,0.4891071319580078,254.17236257093816,95,238,-166,1391,305,117,1117,73
9,-6,0,9.0,-6.0,0.49706411361694336,243.3581930067561,95,229,-160,1391,305,117,1117,73
6,-5,0,6.0,-5.0,0.5051560401916504,235.57687677709237,95,223,-155,1391,305,117,1117,73
7,-5,0,7.0,-5.0,0.5131940841674805,226.9752840097335,95,216,-150,1391,305,117,1117,73
8,-7,0,8.0,-7.0,0.5211310386657715,216.41434190631878,95,208,-143,1391,305,117,1117,73
10,-6,0,10.0,-6.0,0.5290281772613525,204.77582935170216,95,198,-137,1391,305,117,1117,73
8,-7,0,8.0,-7.0,0.5372371673583984,194.21728866442677,95,190,-130,1391,305,117,1117,73
9,-6,0,9.0,-6.0,0.5452251434326172,183.40145851839728,95,181,-124,1391,305,117,1117,73
8,-7,0,8.0,-7.0,0.553185224533081,172.84922791334424,95,173,-117,1391,305,117,1117,73
9,-6,0,9.0,-6.0,0.56113600730896,162.03282556182447,95,164,-111,1391,305,117,1117,73
7,-6,0,7.0,-6.0,0.5691540241241455,152.875620449014,95,157,-105,1391,305,117,1117,73
6,-5,0,6.0,-5.0,0.5771510601043701,145.11046352985792,95,151,-100,1391,305,117,1117,73
5,-4,0,5.0,-4.0,0.5850911140441895,138.73408368146153,95,146,-96,1391,305,117,1117,73
6,-6,0,6.0,-6.0,0.5931301116943359,130.43316977093238,95,140,-90,1391,305,117,1117,73
5,-3,0,5.0,-3.0,0.6011321544647217,124.60510577189007,95,135,-87,1391,305,117,1117,73
5,-4,0,5.0,-4.0,0.6091451644897461,118.23683088030563,95,130,-83,1391,305,117,1117,73
6,-4,0,6.0,-4.0,0.6172680854797363,111.02720836634285,95,124,-79,1391,305,117,1117,73
7,-5,0,7.0,-5.0,0.6252222061157227,102.43771162512041,95,117,-74,1391,305,117,1117,73
7,-4,0,7.0,-4.0,0.6331210136413574,94.38404810405297,95,110,-70,1391,305,117,1117,73
7,-5,0,7.0,-5.0,0.641139030456543,85.79490958164057,95,103,-65,1391,305,117,1117,73
8,-5,0,8.0,-5.0,0.649151086807251,76.36102527122117,95,95,-60,1391,305,117,1117,73
7,-5,0,7.0,-5.0,0.657142162322998,67.77379245262264,95,88,-55,1391,305,117,1117,73
7,-5,0,7.0,-5.0,0.6650950908660889,59.189285111298105,95,81,-50,1391,305,117,1117,73
5,-3,0,5.0,-3.0,0.6732151508331299,53.35882720806042,95,76,-47,1391,305,117,1117,73
4,-4,0,4.0,-4.0,0.6810920238494873,47.86298349093002,95,72,-43,1391,305,117,1117,73
3,-3,0,3.0,-3.0,0.6891610622406006,43.75587752636166,95,69,-40,1391,305,117,1117,73
4,-4,0,4.0,-4.0,0.6972560882568359,38.30343195303969,95,65,-36,1391,305,117,1117,73
4,-3,0,4.0,-3.0,0.705254077911377,33.35416353759881,95,61,-33,1391,305,117,1117,73
4,-3,0,4.0,-3.0,0.7131400108337402,28.41273166075166,95,57,-30,1391,305,117,1117,73
3,-3,0,3.0,-3.0,0.7211000919342041,24.37383539249432,95,54,-27,1391,305,117,1117,73
3,-2,0,3.0,-2.0,0.7292220592498779,20.797887284651708,95,51,-25,1391,305,117,1117,73
3,-2,0,3.0,-2.0,0.7371230125427246,17.225933528685054,95,48,-23,1391,305,117,1117,73
2,-1,0,2.0,-1.0,0.7450079917907715,14.990195135927848,95,46,-22,1391,305,117,1117,73
1,0,0,1.0,-0.0,0.7530720233917236,14.089919145472777,95,45,-22,1391,305,117,1117,73
0,-1,0,-0.0,-1.0,0.7613041400909424,13.658836071740545,95,45,-21,1391,305,117,1117,73
0,0,1,-0.0,-0.0,0.7711601257324219,13.658836071740545,95,45,-21,1391,305,117,1117,73
0,0,0,-0.0,-0.0,0.07927870750427246,1311.1071385868017,96,-1260,468,86,794,1346,326,67
-1,0,0,-1.0,-0.0,0.15442967414855957,1310.1697584445535,96,-1259,468,86,794,1346,326,67
-5,2,0,-5.0,2.0,0.162367582321167,1304.7862310548721,96,-1254,466,86,794,1346,326,67
-8,3,0,-8.0,3.0,0.1704566478729248,1296.2422653527083,96,-1246,463,86,794,1346,326,67
-11,6,0,-11.0,6.0,0.17823147773742676,1283.8424355252225,96,-1235,457,86,794,1346,326,67
-15,10,0,-15.0,10.0,0.1863846778869629,1266.3109712459138,96,-1220,447,86,794,1346,326,67
-18,13,0,-18.0,13.0,0.1942884922027588,1244.95148577714,96,-1202,434,86,794,1346,326,67
-20,16,0,-20.0,16.0,0.20235753059387207,1220.733624020669,96,-1182,418,86,794,1346,326,67
-23,18,0,-23.0,18.0,0.21039652824401855,1193.0836023697568,96,-1159,400,86,794,1346,326,67
-24,17,0,-24.0,17.0,0.21837663650512695,1164.878958826809,96,-1135,383,86,794,1346,326,67
-29,18,0,-29.0,18.0,0.22641849517822266,1131.672056846905,96,-1106,365,86,794,1346,326,67
-30,18,0,-30.0,18.0,0.23424267768859863,1097.5684410950096,96,-1076,347,86,794,1346,326,67
-34,16,0,-34.0,16.0,0.24232268333435059,1060.3091968880533,96,-1042,331,86,794,1346,326,67
-34,15,0,-34.0,15.0,0.25035858154296875,1023.3711468986646,96,-1008,316,86,794,1346,326,67
-33,12,0,-33.0,12.0,0.2583286762237549,988.2937873109775,96,-975,304,86,794,1346,326,67
-31,9,0,-31.0,9.0,0.2665276527404785,956.0202222401724,96,-944,295,86,794,1346,326,67
-30,6,0,-30.0,6.0,0.2744426727294922,925.6015856444219,96,-914,289,86,794,1346,326,67
-33,6,0,-33.0,6.0,0.2823464870452881,892.3377761660873,96,-881,283,86,794,1346,326,67
-31,5,0,-31.0,5.0,0.2904675006866455,861.3064351775627,96,-850,278,86,794,1346,326,67
-33,5,0,-33.0,5.0,0.2985045909881592,828.4046668088117,96,-817,273,86,794,1346,326,67
-36,5,0,-36.0,5.0,0.30640649795532227,792.7027310115911,96,-781,268,86,794,1346,326,67
-40,6,0,-40.0,6.0,0.31447649002075195,752.9548333078689,96,-741,262,86,794,1346,326,67
-42,5,0,-42.0,5.0,0.32233166694641113,711.7482796220479,96,-699,257,86,794,1346,326,67
-44,6,0,-44.0,6.0,0.33023762702941895,668.4456500684853,96,-655,251,86,794,1346,326,67
-46,7,0,-46.0,7.0,0.3383216857910156,623.0617349000016,96,-609,244,86,794,1346,326,67
-41,6,0,-41.0,6.0,0.346388578414917,582.8473836917715,96,-568,238,86,794,1346,326,67
-41,7,0,-41.0,7.0,0.35440754890441895,542.4042057545287,96,-527,231,86,794,1346,326,67
-38,6,0,-38.0,6.0,0.36241769790649414,505.2805959720265,96,-489,225,86,794,1346,326,67
-34,6,0,-34.0,6.0,0.3703315258026123,471.96138466223334,96,-455,219,86,794,1346,326,67
-33,7,0,-33.0,7.0,0.37854766845703125,439.25840384264205,96,-422,212,86,794,1346,326,67
-32,6,0,-32.0,6.0,0.38681459426879883,408.06235386847516,96,-390,206,86,794,1346,326,67
-30,8,0,-30.0,8.0,0.39434051513671875,377.8576395784798,96,-360,198,86,794,1346,326,67
-29,9,0,-29.0,9.0,0.40223050117492676,348.15875957401266,96,-331,189,86,794,1346,326,67
-23,7,0,-23.0,7.0,0.41040563583374023,324.7541054970579,96,-308,182,86,794,1346,326,67
-20,7,0,-20.0,7.0,0.41847848892211914,304.0,96,-288,175,86,794,1346,326,67
-17,7,0,-17.0,7.0,0.4264345169067383,285.8494942759044,96,-271,168,86,794,1346,326,67
-14,6,0,-14.0,6.0,0.4344146251678467,270.7976300105055,96,-257,162,86,794,1346,326,67
-12,5,0,-12.0,5.0,0.4423706531524658,257.9879722600231,96,-245,157,86,794,1346,326,67
-11,7,0,-11.0,7.0,0.45046067237854004,244.94963572561124,96,-234,150,86,794,1346,326,67
-11,7,0,-11.0,7.0,0.45835351943969727,231.91130591199766,96,-223,143,86,794,1346,326,67
-9,7,0,-9.0,7.0,0.466322660446167,220.55867171130237,96,-214,136,86,794,1346,326,67
-9,8,0,-9.0,8.0,0.4745316505432129,208.6795398870165,96,-205,128,86,794,1346,326,67
-9,7,0,-9.0,7.0,0.48235654830932617,197.3410514867031,96,-196,121,86,794,1346,326,67
-9,7,0,-9.0,7.0,0.49040865898132324,186.0091322296858,96,-187,114,86,794,1346,326,67
-8,8,0,-8.0,8.0,0.49848365783691406,175.03124765284662,96,-179,106,86,794,1346,326,67
-8,8,0,-8.0,8.0,0.5064096450805664,164.0913493789111,96,-171,98,86,794,1346,326,67
-7,7,0,-7.0,7.0,0.514319658279419,154.55532517100121,96,-164,91,86,794,1346,326,67
-8,5,0,-8.0,5.0,0.5223956108093262,145.13478043324386,96,-156,86,86,794,1346,326,67
-6,6,0,-6.0,6.0,0.5303785800933838,137.0,96,-150,80,86,794,1346,326,67
-7,7,0,-7.0,7.0,0.5383696556091309,127.55528642807124,96,-143,73,86,794,1346,326,67
-6,6,0,-6.0,6.0,0.5463535785675049,119.50573759698355,96,-137,67,86,794,1346,326,67
-9,7,0,-9.0,7.0,0.5543045997619629,108.36477637657833,96,-128,60,86,794,1346,326,67
-6,6,0,-6.0,6.0,0.5623915195465088,100.41664064126334,96,-122,54,86,794,1346,326,67
-6,5,0,-6.0,5.0,0.5703155994415283,92.92458060283545,96,-116,49,86,794,1346,326,67
-5,5,0,-5.0,5.0,0.5783636569976807,86.4026800369238,96,-111,44,86,794,1346,326,67
-5,5,0,-5.0,5.0,0.5864176750183105,79.94689017409908,96,-106,39,86,794,1346,326,67
-6,5,0,-6.0,5.0,0.5943746566772461,72.62196741208714,96,-100,34,86,794,1346,326,67
-3,3,0,-3.0,3.0,0.6023585796356201,68.83319694480774,96,-97,31,86,794,1346,326,67
-4,3,0,-4.0,3.0,0.6103966236114502,64.12363255150623,96,-93,28,86,794,1346,326,67
-3,3,0,-3.0,3.0,0.6182596683502197,60.40770846134703,96,-90,25,86,794,1346,326,67
-3,4,0,-3.0,4.0,0.626347541809082,56.49860334105779,96,-87,21,86,794,1346,326,67
-4,3,0,-4.0,3.0,0.6343135833740234,51.92938243034621,96,-83,18,86,794,1346,326,67
-3,3,0,-3.0,3.0,0.6423966884613037,48.39410298049853,96,-80,15,86,794,1346,326,67
-4,3,0,-4.0,3.0,0.6503934860229492,43.941536246685374,96,-76,12,86,794,1346,326,67
-4,4,0,-4.0,4.0,0.658421516418457,39.44308110509934,96,-72,8,86,794,1346,326,67
-3,3,0,-3.0,3.0,0.6664085388183594,36.18092222571191,96,-69,5,86,794,1346,326,67
-4,3,0,-4.0,3.0,0.67433762550354,32.03076195155643,96,-65,2,86,794,1346,326,67
-3,3,0,-3.0,3.0,0.6823935508728027,29.00806399170998,96,-62,-1,86,794,1346,326,67
-4,3,0,-4.0,3.0,0.6902825832366943,25.137767414994535,96,-58,-4,86,794,1346,326,67
-5,2,0,-5.0,2.0,0.6982505321502686,20.338541412378348,96,-53,-6,86,794,1346,326,67
-4,3,0,-4.0,3.0,0.7062854766845703,16.8196748283246,96,-49,-9,86,794,1346,326,67
-3,2,0,-3.0,2.0,0.7142934799194336,14.296934361541872,96,-46,-11,86,794,1346,326,67
-2,2,0,-2.0,2.0,0.7223865985870361,12.880278987817846,96,-44,-13,86,794,1346,326,67
-2,1,0,-2.0,1.0,0.7310645580291748,11.271887242357309,96,-42,-14,86,794,1346,326,67
-3,1,0,-3.0,1.0,0.7383894920349121,8.785164831552358,96,-39,-15,86,794,1346,326,67
-3,3,0,-3.0,3.0,0.7463886737823486,7.2492235949962165,96,-36,-18,86,794,1346,326,67
-4,2,0,-4.0,2.0,0.7544145584106445,4.735924528226413,96,-32,-20,86,794,1346,326,67
-3,2,0,-3.0,2.0,0.7623565196990967,3.400549446402593,96,-29,-22,86,794,1346,326,67
-3,2,0,-3.0,2.0,0.7702865600585938,2.3836120259082634,96,-26,-24,86,794,1346,326,67
0,0,1,-0.0,-0.0,0.7773275375366211,2.3836120259082634,96,-26,-24,86,794,1346,326,67
0,2,1,-0.0,2.0,0.778254508972168,3.76955262170047,96,-26,-26,86,794,1346,326,67
-1,0,1,-1.0,-0.0,0.7864696979522705,3.069377593742864,96,-25,-26,86,794,1346,326,67
2,0,1,2.0,-0.0,0.8424005508422852,4.483329627982627,96,-27,-26,86,794,1346,326,67
1,0,1,1.0,-0.0,0.850440502166748,5.209946349085598,96,-28,-26,86,794,1346,326,67
0,0,0,-0.0,-0.0,0.8564615249633789,5.209946349085598,96,-28,-26,86,794,1346,326,67
1,0,0,1.0,-0.0,0.8583815097808838,5.948684188300895,96,-29,-26,86,794,1346,326,67
2,0,0,2.0,-0.0,0.866356611251831,7.459856648287818,96,-31,-26,86,794,1346,326,67
3,0,0,3.0,-0.0,0.8743956089019775,9.80186911806539,96,-34,-26,86,794,1346,326,67
5,-1,0,5.0,-1.0,0.8823466300964355,13.324939287601879,96,-39,-25,86,794,1346,326,67
5,0,0,5.0,-0.0,0.8903706073760986,17.606323715519977,96,-44,-25,86,794,1346,326,67
6,-2,0,6.0,-2.0,0.8984506130218506,22.036351623268054,96,-50,-23,86,794,1346,326,67
7,-1,0,7.0,-1.0,0.9064066410064697,28.098281481560512,96,-57,-22,86,794,1346,326,67
10,-3,0,10.0,-3.0,0.9142847061157227,36.6419413859206,96,-67,-19,86,794,1346,326,67
12,-3,0,12.0,-3.0,0.922337532043457,47.60397012554654,96,-79,-16,86,794,1346,326,67
15,-4,0,15.0,-4.0,0.9303414821624756,61.76286192385707,96,-94,-12,86,794,1346,326,67
17,-5,0,17.0,-5.0,0.9384415149688721,78.22050170719426,96,-111,-7,86,794,1346,326,67
18,-6,0,18.0,-6.0,0.9464936256408691,96.00387591076478,96,-129,-1,86,794,1346,326,67
18,-5,0,18.0,-5.0,0.9543516635894775,114.05441169852742,96,-147,4,86,794,1346,326,67
18,-4,0,18.0,-4.0,0.9623515605926514,132.19382555047267,96,-165,8,86,794,1346,326,67
17,-5,0,17.0,-5.0,0.9703805446624756,149.4636950190366,96,-182,13,86,794,1346,326,67
17,-4,0,17.0,-4.0,0.9783365726470947,166.7248106770914,96,-199,17,86,794,1346,326,67
16,-3,0,16.0,-3.0,0.9863026142120361,182.92822881689185,96,-215,20,86,794,1346,326,67
18,-4,0,18.0,-4.0,0.9943575859069824,201.23279018958897,96,-233,24,86,794,1346,326,67
14,-3,0,14.0,-3.0,1.0023314952850342,215.47132631352054,96,-247,27,86,794,1346,326,67
14,-3,0,14.0,-3.0,1.0104076862335205,229.7184805071771,96,-261,30,86,794,1346,326,67
10,-4,0,10.0,-4.0,1.0183775424957275,240.12451372954422,96,-271,34,86,794,1346,326,67
6,-2,0,6.0,-2.0,1.0263605117797852,246.32955446926843,96,-277,36,86,794,1346,326,67
1,-2,0,1.0,-2.0,1.034348487854004,247.58510295452254,96,-278,38,86,794,1346,326,67
1,0,0,1.0,-0.0,1.0424857139587402,248.57592226609148,96,-279,38,86,794,1346,326,67
-1,-1,0,-1.0,-1.0,1.130373477935791,247.72228269234347,96,-278,39,86,794,1346,326,67
-6,0,0,-6.0,-0.0,1.1382997035980225,241.78173156161603,96,-272,39,86,794,1346,326,67
-9,1,0,-9.0,1.0,1.146338701248169,232.73106705840775,96,-263,38,86,794,1346,326,67
-13,2,0,-13.0,2.0,1.154355525970459,219.57870060636546,96,-250,36,86,794,1346,326,67
-17,3,0,-17.0,3.0,1.1624486446380615,202.32530675641326,96,-233,33,86,794,1346,326,67
-20,3,0,-20.0,3.0,1.170419692993164,182.10230124292022,96,-213,30,86,794,1346,326,67
-23,3,0,-23.0,3.0,1.178365707397461,158.9088325221119,96,-190,27,86,794,1346,326,67
-24,4,0,-24.0,4.0,1.186490535736084,134.5857989210303,96,-166,23,86,794,1346,326,67
-21,3,0,-21.0,3.0,1.1943025588989258,113.37281168304446,96,-145,20,86,794,1346,326,67
-23,2,0,-23.0,2.0,1.202324628829956,90.32072007574396,96,-122,18,86,794,1346,326,67
-22,2,0,-22.0,2.0,1.2103157043457031,68.27191120937731,96,-100,16,86,794,1346,326,67
-19,2,0,-19.0,2.0,1.2184646129608154,49.20097323024831,96,-81,14,86,794,1346,326,67
-16,1,0,-16.0,1.0,1.226393699645996,33.2872536767062,96,-65,13,86,794,1346,326,67
-14,2,0,-14.0,2.0,1.2344574928283691,19.172789842982326,96,-51,11,86,794,1346,326,67
-11,2,0,-11.0,2.0,1.2423696517944336,8.0,96,-40,9,86,794,1346,326,67
-9,1,0,-9.0,1.0,1.250401496887207,-0.9843788128357573,96,-31,8,86,794,1346,326,67
-5,1,0,-5.0,1.0,1.2583136558532715,-6.07417596432748,96,-26,7,86,794,1346,326,67
-2,0,0,-2.0,-0.0,1.2662606239318848,-8.0,96,-24,7,86,794,1346,326,67
0,0,1,-0.0,-0.0,1.3382205963134766,-8.0,96,-24,7,86,794,1346,326,67
0,0,0,-0.0,-0.0,0.07444334030151367,991.1966044422509,97,954,323,1064,1110,110,787,33
1,0,0,1.0,-0.0,0.15050840377807617,990.249472049551,97,953,323,1064,1110,110,787,33
3,0,0,3.0,-0.0,0.1585693359375,987.4086904148279,97,950,323,1064,1110,110,787,33
7,0,0,7.0,-0.0,0.1664295196533203,980.7838281192167,97,943,323,1064,1110,110,787,33
11,-2,0,11.0,-2.0,0.1745455265045166,971.0405260170426,97,932,325,1064,1110,110,787,33
16,-1,0,16.0,-1.0,0.1824944019317627,956.2818521395943,97,916,326,1064,1110,110,787,33
19,-2,0,19.0,-2.0,0.1905684471130371,939.0879540649646,97,897,328,1064,1110,110,787,33
25,-1,0,25.0,-1.0,0.19849753379821777,916.0005364805323,97,872,329,1064,1110,110,787,33
31,-1,0,31.0,-1.0,0.20644044876098633,887.4273628798278,97,841,330,1064,1110,110,787,33
33,0,0,33.0,-0.0,0.21435141563415527,856.7909257090154,97,808,330,1064,1110,110,787,33
35,0,0,35.0,-0.0,0.22242045402526855,824.4933075283824,97,773,330,1064,1110,110,787,33
37,1,0,37.0,1.0,0.23052644729614258,790.1867029416945,97,736,329,1064,1110,110,787,33
36,3,0,36.0,3.0,0.23840546607971191,756.1890960121102,97,700,326,1064,1110,110,787,33
33,3,0,33.0,3.0,0.24645733833312988,725.0924368795029,97,667,323,1064,1110,110,787,33
28,4,0,28.0,4.0,0.2547035217285156,698.2002520301992,97,639,319,1064,1110,110,787,33
27,5,0,27.0,5.0,0.26252055168151855,671.8517282089215,97,612,314,1064,1110,110,787,33
23,5,0,23.0,5.0,0.27050042152404785,649.1330693928847,97,589,309,1064,1110,110,787,33
17,5,0,17.0,5.0,0.2787463665008545,631.7653896280659,97,572,304,1064,1110,110,787,33
14,5,0,14.0,5.0,0.286468505859375,617.060028749249,97,558,299,1064,1110,110,787,33
13,6,0,13.0,6.0,0.29451847076416016,602.7681310474869,97,545,293,1064,1110,110,787,33
13,6,0,13.0,6.0,0.3023693561553955,588.4774602911178,97,532,287,1064,1110,110,787,33
13,6,0,13.0,6.0,0.31049442291259766,574.1881056070175,97,519,281,1064,1110,110,787,33
18,10,0,18.0,10.0,0.3184983730316162,553.5981039294285,97,501,271,1064,1110,110,787,33
21,10,0,21.0,10.0,0.326479434967041,530.3707532436193,97,480,261,1064,1110,110,787,33
21,11,0,21.0,11.0,0.33457350730895996,506.66719812898145,97,459,250,1064,1110,110,787,33
22,12,0,22.0,12.0,0.3424553871154785,481.6072748664352,97,437,238,1064,1110,110,787,33
22,12,0,22.0,12.0,0.3505544662475586,456.547352124631,97,415,226,1064,1110,110,787,33
23,10,0,23.0,10.0,0.35842251777648926,431.5712233823797,97,392,216,1064,1110,110,787,33
24,12,0,24.0,12.0,0.3664684295654297,404.76121494263225,97,368,204,1064,1110,110,787,33
23,11,0,23.0,11.0,0.37452149391174316,379.3150642209325,97,345,193,1064,1110,110,787,33
23,11,0,23.0,11.0,0.38248443603515625,353.87565478144137,97,322,182,1064,1110,110,787,33
23,12,0,23.0,12.0,0.39040541648864746,327.9491241448363,97,299,170,1064,1110,110,787,33
22,11,0,22.0,11.0,0.398517370223999,303.3900436770063,97,277,159,1064,1110,110,787,33
22,11,0,22.0,11.0,0.4064514636993408,278.83724323768865,97,255,148,1064,1110,110,787,33
22,11,0,22.0,11.0,0.41448450088500977,254.29243422633937,97,233,137,1064,1110,110,787,33
21,10,0,21.0,10.0,0.42250847816467285,231.12952069714376,97,212,127,1064,1110,110,787,33
20,9,0,20.0,9.0,0.430483341217041,209.3619311241364,97,192,118,1064,1110,110,787,33
19,10,0,19.0,10.0,0.4384884834289551,187.94361965994426,97,173,108,1064,1110,110,787,33
18,8,0,18.0,8.0,0.44650745391845703,168.45866745696716,97,155,100,1064,1110,110,787,33
16,9,0,16.0,9.0,0.4545564651489258,150.13849644197458,97,139,91,1064,1110,110,787,33
18,9,0,18.0,9.0,0.46253538131713867,130.16771189288008,97,121,82,1064,1110,110,787,33
18,8,0,18.0,8.0,0.470550537109375,110.82665335015349,97,103,74,1064,1110,110,787,33
17,7,0,17.0,7.0,0.47850656509399414,93.01834707974616,97,86,67,1064,1110,110,787,33
14,6,0,14.0,6.0,0.4865455627441406,78.36630754670864,97,72,61,1064,1110,110,787,33
12,5,0,12.0,5.0,0.49450135231018066,66.07313811473277,97,60,56,1064,1110,110,787,33
9,4,0,9.0,4.0,0.5024473667144775,56.835430938520574,97,51,52,1064,1110,110,787,33
9,3,0,9.0,3.0,0.5104844570159912,48.53681120105021,97,42,49,1064,1110,110,787,33
6,4,0,6.0,4.0,0.5183813571929932,41.62811813689564,97,36,45,1064,1110,110,787,33
5,2,0,5.0,2.0,0.526498556137085,37.009433122794285,97,31,43,1064,1110,110,787,33
5,3,0,5.0,3.0,0.5345673561096191,31.707441767506253,97,26,40,1064,1110,110,787,33
4,3,0,4.0,3.0,0.5425014495849609,27.046486500061768,97,22,37,1064,1110,110,787,33
4,2,0,4.0,2.0,0.5505094528198242,23.357337308308857,97,18,35,1064,1110,110,787,33
3,2,0,3.0,2.0,0.5584864616394043,20.249137920783717,97,15,33,1064,1110,110,787,33
3,3,0,3.0,3.0,0.5665004253387451,16.31098884280702,97,12,30,1064,1110,110,787,33
3,3,0,3.0,3.0,0.5745434761047363,12.460498941515414,97,9,27,1064,1110,110,787,33
2,2,0,2.0,2.0,0.5826563835144043,9.96150997149434,97,7,25,1064,1110,110,787,33
2,2,0,2.0,2.0,0.5905344486236572,7.5372045918796395,97,5,23,1064,1110,110,787,33
3,2,0,3.0,2.0,0.5985524654388428,5.095023109728988,97,2,21,1064,1110,110,787,33
2,3,0,2.0,3.0,0.6066384315490723,2.0,97,0,18,1064,1110,110,787,33
2,4,0,2.0,4.0,0.6144413948059082,-1.857864376269049,97,-2,14,1064,1110,110,787,33
4,3,0,4.0,3.0,0.6226303577423096,-3.4700359138583323,97,-6,11,1064,1110,110,787,33
3,3,0,3.0,3.0,0.6305274963378906,-3.9584054212077042,97,-9,8,1064,1110,110,787,33
2,2,0,2.0,2.0,0.6385765075683594,-3.4700359138583323,97,-11,6,1064,1110,110,787,33
1,2,0,1.0,2.0,0.6466643810272217,-3.350889359326482,97,-12,4,1064,1110,110,787,33
1,1,0,1.0,1.0,0.6544914245605469,-2.658335935873666,97,-13,3,1064,1110,110,787,33
0,1,0,-0.0,1.0,0.6704914569854736,-2.8470535620340947,97,-13,2,1064,1110,110,787,33
1,0,0,1.0,-0.0,0.6787495613098145,-1.857864376269049,97,-14,2,1064,1110,110,787,33
0,0,1,-0.0,-0.0,0.7464413642883301,-1.857864376269049,97,-14,2,1064,1110,110,787,33
0,0,0,-0.0,-0.0,0.07344484329223633,438.95877198758035,98,-351,-317,727,791,1078,1108,68
1,-2,0,1.0,-2.0,0.12341690063476562,438.36532472229584,98,-352,-315,727,791,1078,1108,68
2,-5,0,2.0,-5.0,0.13146376609802246,436.5486159792631,98,-354,-310,727,791,1078,1108,68
4,-6,0,4.0,-6.0,0.13964295387268066,435.6594510919588,98,-358,-304,727,791,1078,1108,68
6,-6,0,6.0,-6.0,0.14752793312072754,436.425339453563,98,-364,-298,727,791,1078,1108,68
5,-7,0,5.0,-7.0,0.15549993515014648,435.9382938216463,98,-369,-291,727,791,1078,1108,68
5,-8,0,5.0,-8.0,0.1635289192199707,435.00426437293726,98,-374,-283,727,791,1078,1108,68
4,-9,0,4.0,-9.0,0.1715857982635498,432.8618639383603,98,-378,-274,727,791,1078,1108,68
3,-12,0,3.0,-12.0,0.1796097755432129,428.3905275846381,98,-381,-262,727,791,1078,1108,68
0,-15,0,-0.0,-15.0,0.1874377727508545,420.059467470947,98,-381,-247,727,791,1078,1108,68
-2,-17,0,-2.0,-17.0,0.19541382789611816,409.3294486045338,98,-379,-230,727,791,1078,1108,68
-7,-18,0,-7.0,-18.0,0.20353984832763672,394.1681912519892,98,-372,-212,727,791,1078,1108,68
-10,-17,0,-10.0,-17.0,0.211561918258667,377.1800092416945,98,-362,-195,727,791,1078,1108,68
-14,-15,0,-14.0,-15.0,0.21959376335144043,357.7958652155482,98,-348,-180,727,791,1078,1108,68
-17,-14,0,-17.0,-14.0,0.22754788398742676,336.2931271303857,98,-331,-166,727,791,1078,1108,68
-18,-12,0,-18.0,-12.0,0.2356419563293457,314.8337713008877,98,-313,-154,727,791,1078,1108,68
-20,-11,0,-20.0,-11.0,0.24353384971618652,292.0337405852345,98,-293,-143,727,791,1078,1108,68
-21,-10,0,-21.0,-10.0,0.2516007423400879,268.77549438486597,98,-272,-133,727,791,1078,1108,68
-20,-9,0,-20.0,-9.0,0.25946593284606934,246.85583490467133,98,-252,-124,727,791,1078,1108,68
-20,-10,0,-20.0,-10.0,0.2674269676208496,224.49564793241683,98,-232,-114,727,791,1078,1108,68
-21,-9,0,-21.0,-9.0,0.2754509449005127,201.6819891294199,98,-211,-105,727,791,1078,1108,68
-20,-9,0,-20.0,-9.0,0.2834608554840088,179.76856644511605,98,-191,-96,727,791,1078,1108,68
-20,-9,0,-20.0,-9.0,0.29151391983032227,157.8593234638338,98,-171,-87,727,791,1078,1108,68
-18,-8,0,-18.0,-8.0,0.29955291748046875,138.19175357722565,98,-153,-79,727,791,1078,1108,68
-16,-8,0,-16.0,-8.0,0.3074498176574707,120.30489298787643,98,-137,-71,727,791,1078,1108,68
-15,-7,0,-15.0,-7.0,0.31547093391418457,103.7679207943562,98,-122,-64,727,791,1078,1108,68
-12,-7,0,-12.0,-7.0,0.32352280616760254,89.89108119634763,98,-110,-57,727,791,1078,1108,68
-12,-7,0,-12.0,-7.0,0.33152294158935547,76.01818031580054,98,-98,-50,727,791,1078,1108,68
-10,-7,0,-10.0,-7.0,0.33948493003845215,63.94386147176351,98,-88,-43,727,791,1078,1108,68
-9,-5,0,-9.0,-5.0,0.3474898338317871,53.66413177577246,98,-79,-38,727,791,1078,1108,68
-9,-4,0,-9.0,-4.0,0.3554868698120117,43.820305833374874,98,-70,-34,727,791,1078,1108,68
-7,-4,0,-7.0,-4.0,0.36353087425231934,35.778220097678044,98,-63,-30,727,791,1078,1108,68
-8,-3,0,-8.0,-3.0,0.3716728687286377,27.26989472816156,98,-55,-27,727,791,1078,1108,68
-9,-4,0,-9.0,-4.0,0.37954092025756836,17.429563482495162,98,-46,-23,727,791,1078,1108,68
-8,-3,0,-8.0,-3.0,0.38751792907714844,8.941821107167776,98,-38,-20,727,791,1078,1108,68
-9,-3,0,-9.0,-3.0,0.39554381370544434,-0.38452737205678034,98,-29,-17,727,791,1078,1108,68
-8,-3,0,-8.0,-3.0,0.4034087657928467,-8.761141071752075,98,-21,-14,727,791,1078,1108,68
-8,-2,0,-8.0,-2.0,0.4115407466888428,-16.30819398704587,98,-13,-12,727,791,1078,1108,68
-8,-3,0,-8.0,-3.0,0.41951775550842285,-23.704369859013,98,-5,-9,727,791,1078,1108,68
-7,-3,0,-7.0,-3.0,0.427548885345459,-27.67544467966324,98,2,-6,727,791,1078,1108,68
-8,-3,0,-8.0,-3.0,0.4356088638305664,-23.559693491089448,98,10,-3,727,791,1078,1108,68
-6,-3,0,-6.0,-3.0,0.4435398578643799,-18.0,98,16,0,727,791,1078,1108,68
-3,-2,0,-3.0,-2.0,0.45153284072875977,-14.895026825457201,98,19,2,727,791,1078,1108,68
-2,0,0,-2.0,-0.0,0.4596529006958008,-12.904976890271012,98,21,2,727,791,1078,1108,68
0,-1,0,-0.0,-1.0,0.46760988235473633,-12.786796564403573,98,21,3,727,791,1078,1108,68
0,0,1,-0.0,-0.0,0.5065538883209229,-12.786796564403573,98,21,3,727,791,1078,1108,68
0,0,0,-0.0,-0.0,0.07317733764648438,601.5770903637721,99,-613,-44,93,744,706,788,27
0,-1,0,-0.0,-1.0,0.15608453750610352,601.5063059074333,99,-613,-43,93,744,706,788,27
0,-1,0,-0.0,-1.0,0.16413331031799316,601.4371408044927,99,-613,-42,93,744,706,788,27
2,-2,0,2.0,-2.0,0.17206931114196777,603.2994402074369,99,-615,-40,93,744,706,788,27
2,-5,0,2.0,-5.0,0.18004941940307617,604.991909332153,99,-617,-35,93,744,706,788,27
3,-5,0,3.0,-5.0,0.18807244300842285,607.7253821135398,99,-620,-30,93,744,706,788,27
1,-6,0,1.0,-6.0,0.19593453407287598,608.463595072149,99,-621,-24,93,744,706,788,27
1,-7,0,1.0,-7.0,0.2040543556213379,609.2322717442419,99,-622,-17,93,744,706,788,27
0,-5,0,-0.0,-5.0,0.2121284008026123,609.1157448578199,99,-622,-12,93,744,706,788,27
0,-6,0,-0.0,-6.0,0.22011351585388184,609.0289382335841,99,-622,-6,93,744,706,788,27
-2,-7,0,-2.0,-7.0,0.2281184196472168,607.0008064510885,99,-620,1,93,744,706,788,27
-4,-7,0,-4.0,-7.0,0.23608851432800293,603.0519458617106,99,-616,8,93,744,706,788,27
-7,-7,0,-7.0,-7.0,0.24423742294311523,596.1847010554352,99,-609,15,93,744,706,788,27
-10,-6,0,-10.0,-6.0,0.25196051597595215,586.3680004805061,99,-599,21,93,744,706,788,27
-11,-4,0,-11.0,-4.0,0.259946346282959,575.5312226211962,99,-588,25,93,744,706,788,27
-13,-3,0,-13.0,-3.0,0.26804137229919434,562.6813354625978,99,-575,28,93,744,706,788,27
-16,-3,0,-16.0,-3.0,0.2759373188018799,546.8589107980688,99,-559,31,93,744,706,788,27
-17,-1,0,-17.0,-1.0,0.2841064929962158,529.943827665441,99,-542,32,93,744,706,788,27
-21,0,0,-21.0,-0.0,0.29210352897644043,508.9818004490195,99,-521,32,93,744,706,788,27
-20,0,0,-20.0,-0.0,0.30011534690856934,489.02091589892945,99,-501,32,93,744,706,788,27
-20,2,0,-20.0,2.0,0.3080863952636719,468.9346428718317,99,-481,30,93,744,706,788,27
-21,2,0,-21.0,2.0,0.31611037254333496,447.8513860237376,99,-460,28,93,744,706,788,27
-21,3,0,-21.0,3.0,0.324047327041626,426.71126890267436,99,-439,25,93,744,706,788,27
-21,4,0,-21.0,4.0,0.3320603370666504,405.5271795236242,99,-418,21,93,744,706,788,27
-19,3,0,-19.0,3.0,0.34001851081848145,386.4058086708304,99,-399,18,93,744,706,788,27
-20,2,0,-20.0,2.0,0.34798431396484375,366.3375805268969,99,-379,16,93,744,706,788,27
-19,3,0,-19.0,3.0,0.3561263084411621,347.23464575190434,99,-360,13,93,744,706,788,27
-18,1,0,-18.0,1.0,0.36410045623779297,329.21046155838076,99,-342,12,93,744,706,788,27
-18,1,0,-18.0,1.0,0.3721044063568115,311.18667461818967,99,-324,11,93,744,706,788,27
-18,1,0,-18.0,1.0,0.38010644912719727,293.1633550900565,99,-306,10,93,744,706,788,27
-17,0,0,-17.0,-0.0,0.3880925178527832,276.1729586251107,99,-289,10,93,744,706,788,27
-15,0,0,-15.0,-0.0,0.3960413932800293,261.18242102658587,99,-274,10,93,744,706,788,27
-15,-1,0,-15.0,-1.0,0.4041123390197754,246.23348549136165,99,-259,11,93,744,706,788,27
-13,-1,0,-13.0,-1.0,0.4120614528656006,233.2925090212855,99,-246,12,93,744,706,788,27
-12,-1,0,-12.0,-1.0,0.4200584888458252,221.3608329051593,99,-234,13,93,744,706,788,27
-11,-1,0,-11.0,-1.0,0.4280564785003662,210.4390297150433,99,-223,14,93,744,706,788,27
-13,0,0,-13.0,-0.0,0.4361603260040283,197.4661492972207,99,-210,14,93,744,706,788,27
-11,-1,0,-11.0,-1.0,0.4441075325012207,186.56452590578317,99,-199,15,93,744,706,788,27
-9,0,0,-9.0,-0.0,0.4521644115447998,177.59118552545917,99,-190,15,93,744,706,788,27
-7,-1,0,-7.0,-1.0,0.46008753776550293,170.69812192834198,99,-183,16,93,744,706,788,27
-9,-1,0,-9.0,-1.0,0.4682924747467041,161.82848738120455,99,-174,17,93,744,706,788,27
-7,0,0,-7.0,-0.0,0.47610044479370117,154.86303941010956,99,-167,17,93,744,706,788,27
-8,-1,0,-8.0,-1.0,0.4840095043182373,147.01562423713506,99,-159,18,93,744,706,788,27
-7,0,0,-7.0,-0.0,0.49211931228637695,140.06207890917986,99,-152,18,93,744,706,788,27
-8,-1,0,-8.0,-1.0,0.49998044967651367,132.24806367039804,99,-144,19,93,744,706,788,27
-7,-1,0,-7.0,-1.0,0.5080814361572266,125.45215780189199,99,-137,20,93,744,706,788,27
-7,-1,0,-7.0,-1.0,0.5160694122314453,118.68523075880606,99,-130,21,93,744,706,788,27
-7,0,0,-7.0,-0.0,0.5241093635559082,111.77980605851253,99,-123,21,93,744,706,788,27
