dx,dy,button,rx,ry,time,distance,targetID,directionX,directionY,targetX,targetY,initMouseX,initMouseY,targetSize,score
0,0,0,-0.0,-0.0,0.009904146194458008,977.8103088022748,1,-823,-528,137,72,960,600,20,203.01
-2,-1,0,-2.0,-1.0,0.3090531826019287,975.5870027834525,1,-821,-527,137,72,960,600,20,23.4
-4,-4,0,-4.0,-4.0,0.3171372413635254,970.0608228353519,1,-817,-523,137,72,960,600,20,45.15
-7,-6,0,-7.0,-6.0,0.3251302242279053,960.9313190858127,1,-810,-517,137,72,960,600,20,64.27
-13,-10,0,-13.0,-10.0,0.3332080841064453,944.5940927191955,1,-797,-507,137,72,960,600,20,90.36
-18,-13,0,-18.0,-13.0,0.3411252498626709,922.429943139315,1,-779,-494,137,72,960,600,20,103.98
-20,-14,0,-20.0,-14.0,0.34910106658935547,898.0428720278336,1,-759,-480,137,72,960,600,20,107.09
-23,-15,0,-23.0,-15.0,0.3570401668548584,870.5865838617087,1,-736,-465,137,72,960,600,20,111.6
-24,-17,0,-24.0,-17.0,0.36513805389404297,841.218164330752,1,-712,-448,137,72,960,600,20,111.04
-27,-18,0,-27.0,-18.0,0.37343907356262207,808.7799453497843,1,-685,-430,137,72,960,600,20,113.37
-26,-15,0,-26.0,-15.0,0.3810391426086426,778.784951061588,1,-659,-415,137,72,960,600,20,107.35
-26,-15,0,-26.0,-15.0,0.3890380859375,748.7916933299941,1,-633,-400,137,72,960,600,20,104.82
-26,-15,0,-26.0,-15.0,0.39700818061828613,718.8003895380135,1,-607,-385,137,72,960,600,20,102.24
-26,-16,0,-26.0,-16.0,0.4049971103668213,688.2746544803172,1,-581,-369,137,72,960,600,20,101.28
-23,-13,0,-23.0,-13.0,0.41301512718200684,661.8912297349165,1,-558,-356,137,72,960,600,20,92.21
-23,-13,0,-23.0,-13.0,0.42107725143432617,635.5108181612646,1,-535,-343,137,72,960,600,20,89.89
-19,-11,0,-19.0,-11.0,0.4290652275085449,613.5796606798501,1,-516,-332,137,72,960,600,20,81.47
-19,-10,0,-19.0,-10.0,0.43709421157836914,592.1933805776623,1,-497,-322,137,72,960,600,20,78.03
-17,-9,0,-17.0,-9.0,0.4450101852416992,573.0349029509459,1,-480,-313,137,72,960,600,20,72.6
-15,-9,0,-15.0,-9.0,0.4531071186065674,555.5546777770843,1,-465,-304,137,72,960,600,20,69.07
-13,-9,0,-13.0,-9.0,0.4610881805419922,539.7490157471341,1,-452,-295,137,72,960,600,20,64.85
-10,-8,0,-10.0,-8.0,0.46903109550476074,527.0037950527491,1,-442,-287,137,72,960,600,20,55.54
-9,-8,0,-9.0,-8.0,0.4770781993865967,515.1019316601327,1,-433,-279,137,72,960,600,20,52.08
-7,-7,0,-7.0,-7.0,0.48507213592529297,505.4305095658552,1,-426,-272,137,72,960,600,20,44.93
-8,-6,0,-8.0,-6.0,0.49306821823120117,495.4593827954013,1,-418,-266,137,72,960,600,20,46.57
-6,-6,0,-6.0,-6.0,0.5010621547698975,487.17963832656227,1,-412,-260,137,72,960,600,20,39.7
-6,-4,0,-6.0,-4.0,0.5090441703796387,479.97083244713946,1,-406,-256,137,72,960,600,20,38.41
-4,-4,0,-4.0,-4.0,0.5170450210571289,474.45547736326114,1,-402,-252,137,72,960,600,20,29.57
-3,-3,0,-3.0,-3.0,0.5249910354614258,470.3211668636656,1,-399,-249,137,72,960,600,20,23.89
-3,-3,0,-3.0,-3.0,0.5330090522766113,466.1888029543395,1,-396,-246,137,72,960,600,20,23.74
-4,-4,0,-4.0,-4.0,0.5410232543945312,460.6821029734062,1,-392,-242,137,72,960,600,20,28.96
-5,-4,0,-5.0,-4.0,0.5488982200622559,454.32697476597184,1,-387,-238,137,72,960,600,20,32.57
-7,-5,0,-7.0,-5.0,0.5569422245025635,445.7454430501786,1,-380,-233,137,72,960,600,20,39.89
-7,-4,0,-7.0,-4.0,0.5649380683898926,437.6871028485989,1,-373,-229,137,72,960,600,20,38.79
-6,-5,0,-6.0,-5.0,0.5729200839996338,429.959300399468,1,-367,-224,137,72,960,600,20,35.6
-6,-4,0,-6.0,-4.0,0.5809941291809082,422.75406562208246,1,-361,-220,137,72,960,600,20,35.18
-6,-4,0,-6.0,-4.0,0.5889861583709717,415.5490344111029,1,-355,-216,137,72,960,600,20,34.8
-6,-5,0,-6.0,-5.0,0.5969882011413574,407.82594326501595,1,-349,-211,137,72,960,600,20,34.38
-7,-4,0,-7.0,-4.0,0.6049191951751709,399.7661816612306,1,-342,-207,137,72,960,600,20,36.95
-7,-5,0,-7.0,-5.0,0.6130151748657227,391.18921253020255,1,-335,-202,137,72,960,600,20,36.66
-8,-6,0,-8.0,-6.0,0.6210670471191406,381.24139334547607,1,-327,-196,137,72,960,600,20,39.11
-8,-5,0,-8.0,-5.0,0.629061222076416,371.80909079795236,1,-319,-191,137,72,960,600,20,39.09
-7,-5,0,-7.0,-5.0,0.6370251178741455,363.23546082396746,1,-312,-186,137,72,960,600,20,34.91
-6,-4,0,-6.0,-4.0,0.6449401378631592,356.03370626950476,1,-306,-182,137,72,960,600,20,31.46
-5,-4,0,-5.0,-4.0,0.6531710624694824,349.6927222576987,1,-301,-178,137,72,960,600,20,27.49
-5,-5,0,-5.0,-5.0,0.6610100269317627,342.84836298282073,1,-296,-173,137,72,960,600,20,27.75
-5,-5,0,-5.0,-5.0,0.6690940856933594,336.0133925902359,1,-291,-168,137,72,960,600,20,27.33
-6,-4,0,-6.0,-4.0,0.6770520210266113,328.8175786055241,1,-285,-164,137,72,960,600,20,29.67
-7,-7,0,-7.0,-7.0,0.6850271224975586,319.2694786540048,1,-278,-157,137,72,960,600,20,32.75
-9,-5,0,-9.0,-5.0,0.6930222511291504,308.97410894765926,1,-269,-152,137,72,960,600,20,37.34
-9,-6,0,-9.0,-6.0,0.7010931968688965,298.187860249206,1,-260,-146,137,72,960,600,20,35.36
-8,-5,0,-8.0,-5.0,0.7091002464294434,288.76461001999536,1,-252,-141,137,72,960,600,20,32.56
-10,-6,0,-10.0,-6.0,0.7176182270050049,277.1082820848197,1,-242,-135,137,72,960,600,20,36.22
-8,-6,0,-8.0,-6.0,0.7251720428466797,267.20217064986576,1,-234,-129,137,72,960,600,20,30.59
-10,-6,0,-10.0,-6.0,0.7330820560455322,255.54842985234717,1,-224,-123,137,72,960,600,20,34.2
-10,-5,0,-10.0,-5.0,0.7409570217132568,244.37675830569486,1,-214,-118,137,72,960,600,20,32.43
-8,-4,0,-8.0,-4.0,0.7491710186004639,235.44001359157284,1,-206,-114,137,72,960,600,20,27.94
-7,-3,0,-7.0,-3.0,0.7571282386779785,227.86399452304877,1,-199,-111,137,72,960,600,20,23.81
-6,-3,0,-6.0,-3.0,0.7651150226593018,221.16283593768642,1,-193,-108,137,72,960,600,20,22.65
-8,-5,0,-8.0,-5.0,0.7731380462646484,211.74040710265956,1,-185,-103,137,72,960,600,20,26.72
-7,-4,0,-7.0,-4.0,0.7811381816864014,203.67866849525504,1,-178,-99,137,72,960,600,20,25.25
-8,-4,0,-8.0,-4.0,0.7890372276306152,194.74342094150447,1,-170,-95,137,72,960,600,20,24.73
-6,-4,0,-6.0,-4.0,0.7970471382141113,187.55532517100121,1,-164,-91,137,72,960,600,20,20.7
-7,-5,0,-7.0,-5.0,0.8049881458282471,179.0111728356641,1,-157,-86,137,72,960,600,20,21.72
-7,-5,0,-7.0,-5.0,0.8131411075592041,170.47287174210447,1,-150,-81,137,72,960,600,20,20.97
-7,-5,0,-7.0,-5.0,0.8211371898651123,161.94134740701648,1,-143,-76,137,72,960,600,20,20.21
-8,-5,0,-8.0,-5.0,0.8292410373687744,152.5319638633162,1,-135,-71,137,72,960,600,20,21.29
-8,-5,0,-8.0,-5.0,0.8370652198791504,143.1258187749506,1,-127,-66,137,72,960,600,20,20.37
-8,-4,0,-8.0,-4.0,0.8452332019805908,134.18271125595876,1,-119,-62,137,72,960,600,20,20.74
-7,-4,0,-7.0,-4.0,0.8531942367553711,126.1269202034205,1,-112,-58,137,72,960,600,20,18.12
-5,-3,0,-5.0,-3.0,0.8611562252044678,120.30793822520607,1,-107,-55,137,72,960,600,20,14.36
-6,-3,0,-6.0,-3.0,0.8693132400512695,113.6001760562016,1,-101,-52,137,72,960,600,20,16.73
-4,-2,0,-4.0,-2.0,0.8772192001342773,109.12836478203089,1,-97,-50,137,72,960,600,20,13.52
-5,-2,0,-5.0,-2.0,0.885202169418335,103.76897416858277,1,-92,-48,137,72,960,600,20,12.17
-5,-2,0,-5.0,-2.0,0.893153190612793,98.41239759298622,1,-87,-46,137,72,960,600,20,11.75
-4,-2,0,-4.0,-2.0,0.9011192321777344,93.94147114027967,1,-83,-44,137,72,960,600,20,12.14
-4,-2,0,-4.0,-2.0,0.9091122150421143,89.47066558375433,1,-79,-42,137,72,960,600,20,11.84
-3,-2,0,-3.0,-2.0,0.9171490669250488,85.88364221433555,1,-76,-40,137,72,960,600,20,8.96
-3,-1,0,-3.0,-1.0,0.9251761436462402,82.76472678623425,1,-73,-39,137,72,960,600,20,7.61
-2,0,0,-2.0,-0.0,0.9336042404174805,81.00617260431454,1,-71,-39,137,72,960,600,20,4.29
-2,-1,0,-2.0,-1.0,0.9412021636962891,78.77182237323191,1,-69,-38,137,72,960,600,20,8.13
-3,-1,0,-3.0,-1.0,0.9491791725158691,75.66372975210778,1,-66,-37,137,72,960,600,20,7.13
-1,0,0,-1.0,-0.0,0.9572322368621826,74.79304780526061,1,-65,-37,137,72,960,600,20,2.93
-2,-1,0,-2.0,-1.0,0.9651591777801514,72.56031973468694,1,-63,-36,137,72,960,600,20,7.55
-1,0,0,-1.0,-0.0,0.973048210144043,71.69379331573968,1,-62,-36,137,72,960,600,20,2.85
-2,0,0,-2.0,-0.0,0.981107234954834,69.9714227381436,1,-60,-36,137,72,960,600,20,3.84
-1,-1,0,-1.0,-1.0,0.9891211986541748,68.60029154456998,1,-59,-35,137,72,960,600,20,4.47
-2,-1,0,-2.0,-1.0,0.9971780776977539,66.37017402418047,1,-57,-34,137,72,960,600,20,6.99
-1,0,0,-1.0,-0.0,1.0051732063293457,65.5133574166368,1,-56,-34,137,72,960,600,20,2.7
-3,-1,0,-3.0,-1.0,1.0131971836090088,62.433965115151864,1,-53,-33,137,72,960,600,20,6.2
-2,-1,0,-2.0,-1.0,1.0213160514831543,60.207972893961475,1,-51,-32,137,72,960,600,20,6.44
-3,-2,0,-3.0,-2.0,1.0291192531585693,56.60388679233962,1,-48,-30,137,72,960,600,20,8.99
-3,-1,0,-3.0,-1.0,1.0371332168579102,53.53503525729669,1,-45,-29,137,72,960,600,20,5.68
-3,-1,0,-3.0,-1.0,1.0450432300567627,50.47771785649585,1,-42,-28,137,72,960,600,20,5.43
-3,-2,0,-3.0,-2.0,1.053110122680664,46.87216658103186,1,-39,-26,137,72,960,600,20,10.38
-3,-1,0,-3.0,-1.0,1.0610542297363281,43.829214001622255,1,-36,-25,137,72,960,600,20,4.99
-2,0,0,-2.0,-0.0,1.0690951347351074,42.20189569201838,1,-34,-25,137,72,960,600,20,2.7
-1,-1,0,-1.0,-1.0,1.0772461891174316,40.80441152620633,1,-33,-24,137,72,960,600,20,4.46
-2,-1,0,-2.0,-1.0,1.085278034210205,38.600518131237564,1,-31,-23,137,72,960,600,20,4.83
-2,0,0,-2.0,-0.0,1.0940442085266113,37.013511046643494,1,-29,-23,137,72,960,600,20,2.41
-1,-1,0,-1.0,-1.0,1.1014320850372314,35.608987629529715,1,-28,-22,137,72,960,600,20,4.67
-2,0,0,-2.0,-0.0,1.1092822551727295,34.058772731852805,1,-26,-22,137,72,960,600,20,2.22
-1,-1,0,-1.0,-1.0,1.1172161102294922,32.64965543462902,1,-25,-21,137,72,960,600,20,5.0
-1,0,0,-1.0,-0.0,1.1250131130218506,31.89043743820395,1,-24,-21,137,72,960,600,20,1.65
0,-1,0,-0.0,-1.0,1.133167028427124,31.240998703626616,1,-24,-20,137,72,960,600,20,1.27
-1,0,0,-1.0,-0.0,1.1410441398620605,30.479501308256342,1,-23,-20,137,72,960,600,20,1.63
-1,0,0,-1.0,-0.0,1.1501882076263428,29.732137494637012,1,-22,-20,137,72,960,600,20,1.56
-1,0,0,-1.0,-0.0,1.157264232635498,29.0,1,-21,-20,137,72,960,600,20,1.49
-1,-1,0,-1.0,-1.0,1.165532112121582,27.586228448267445,1,-20,-19,137,72,960,600,20,6.23
-1,0,0,-1.0,-0.0,1.1729810237884521,26.870057685088806,1,-19,-19,137,72,960,600,20,1.39
-1,-1,0,-1.0,-1.0,1.1811182498931885,25.45584412271571,1,-18,-18,137,72,960,600,20,7.83
-1,-1,0,-1.0,-1.0,1.1890721321105957,24.041630560342615,1,-17,-17,137,72,960,600,20,7.8
-2,-1,0,-2.0,-1.0,1.1980812549591064,21.93171219946131,1,-15,-16,137,72,960,600,20,3.01
-2,-1,0,-2.0,-1.0,1.206308126449585,19.849433241279208,1,-13,-15,137,72,960,600,20,2.72
-1,-1,0,-1.0,-1.0,1.2131550312042236,18.439088914585774,1,-12,-14,137,72,960,600,20,4.64
-1,0,0,-1.0,-0.0,1.2213211059570312,17.804493814764857,1,-11,-14,137,72,960,600,20,0.9
-1,-1,0,-1.0,-1.0,1.2291710376739502,16.401219466856727,1,-10,-13,137,72,960,600,20,3.86
-1,0,0,-1.0,-0.0,1.2371351718902588,15.811388300841896,1,-9,-13,137,72,960,600,20,0.71
-1,-1,0,-1.0,-1.0,1.2451860904693604,14.422205101855956,1,-8,-12,137,72,960,600,20,3.17
-1,0,0,-1.0,-0.0,1.2529962062835693,13.892443989449804,1,-7,-12,137,72,960,600,20,0.5
0,0,1,-0.0,-0.0,1.292079210281372,13.892443989449804,1,-7,-12,137,72,960,600,20,31.05
0,0,0,-0.0,-0.0,0.053200721740722656,1544.6957629255023,2,1322,799,1466,883,144,84,36,260.72
-1,0,0,-1.0,-0.0,0.06242775917053223,1545.5516814393493,2,1323,799,1466,883,144,84,36,9.62
0,-1,0,-0.0,-1.0,0.07035565376281738,1546.0688859167951,2,1323,800,1466,883,144,84,36,13.69
0,1,0,-0.0,1.0,0.2065887451171875,1545.5516814393493,2,1323,799,1466,883,144,84,36,4.33
2,3,0,2.0,3.0,0.21442770957946777,1542.2895318324636,2,1321,796,1466,883,144,84,36,23.0
5,6,0,5.0,6.0,0.22248458862304688,1534.91237534916,2,1316,790,1466,883,144,84,36,45.31
9,8,0,9.0,8.0,0.23038172721862793,1523.0801029492834,2,1307,782,1466,883,144,84,36,65.38
12,8,0,12.0,8.0,0.2384166717529297,1508.6752466982416,2,1295,774,1466,883,144,84,36,76.32
15,10,0,15.0,10.0,0.2464447021484375,1490.6696481782944,2,1280,764,1466,883,144,84,36,87.69
19,10,0,19.0,10.0,0.25440359115600586,1469.2300704790928,2,1261,754,1466,883,144,84,36,96.77
22,12,0,22.0,12.0,0.26225757598876953,1444.1900844417953,2,1239,742,1466,883,144,84,36,105.28
25,13,0,25.0,13.0,0.270338773727417,1416.0639109870713,2,1214,729,1466,883,144,84,36,110.6
31,15,0,31.0,15.0,0.27822375297546387,1381.768793973869,2,1183,714,1466,883,144,84,36,120.42
33,18,0,33.0,18.0,0.28666067123413086,1344.2157564914942,2,1150,696,1466,883,144,84,36,124.83
36,21,0,36.0,21.0,0.294663667678833,1302.544049159183,2,1114,675,1466,883,144,84,36,129.67
36,21,0,36.0,21.0,0.30231261253356934,1260.8727136392476,2,1078,654,1466,883,144,84,36,127.4
36,22,0,36.0,22.0,0.3103957176208496,1218.6828955885119,2,1042,632,1466,883,144,84,36,126.64
36,23,0,36.0,23.0,0.3183736801147461,1175.9749146984386,2,1006,609,1466,883,144,84,36,123.72
36,23,0,36.0,23.0,0.3265066146850586,1133.2678412449548,2,970,586,1466,883,144,84,36,121.2
36,22,0,36.0,22.0,0.3343336582183838,1091.078365654823,2,934,564,1466,883,144,84,36,119.11
36,22,0,36.0,22.0,0.34228062629699707,1048.8889359698671,2,898,542,1466,883,144,84,36,116.54
36,21,0,36.0,21.0,0.35030555725097656,1007.2164613428437,2,862,521,1466,883,144,84,36,112.71
37,23,0,37.0,23.0,0.35828471183776855,963.6539835438859,2,825,498,1466,883,144,84,36,112.21
36,21,0,36.0,21.0,0.366269588470459,921.9815616377585,2,789,477,1466,883,144,84,36,107.22
35,23,0,35.0,23.0,0.3743007183074951,880.1318083105507,2,754,454,1466,883,144,84,36,103.72
34,23,0,34.0,23.0,0.38238978385925293,839.143015224461,2,720,431,1466,883,144,84,36,99.58
34,22,0,34.0,22.0,0.3904397487640381,798.6720227978441,2,686,409,1466,883,144,84,36,96.64
34,23,0,34.0,23.0,0.3983187675476074,757.6938695805846,2,652,386,1466,883,144,84,36,93.63
34,21,0,34.0,21.0,0.4062526226043701,717.7388104317614,2,618,365,1466,883,144,84,36,90.8
34,19,0,34.0,19.0,0.414400577545166,678.8018856779937,2,584,346,1466,883,144,84,36,86.6
34,19,0,34.0,19.0,0.4223897457122803,639.8663923038933,2,550,327,1466,883,144,84,36,83.5
35,19,0,35.0,19.0,0.4302506446838379,600.0741620833212,2,515,308,1466,883,144,84,36,80.6
33,19,0,33.0,19.0,0.4382336139678955,562.0008896790112,2,482,289,1466,883,144,84,36,76.74
31,16,0,31.0,16.0,0.4462575912475586,527.1906675957001,2,451,273,1466,883,144,84,36,69.36
30,16,0,30.0,16.0,0.4542396068572998,493.24436134638177,2,421,257,1466,883,144,84,36,65.89
28,14,0,28.0,14.0,0.46224164962768555,462.0584378625717,2,393,243,1466,883,144,84,36,60.1
29,14,0,29.0,14.0,0.47023868560791016,430.04302110370304,2,364,229,1466,883,144,84,36,57.83
25,14,0,25.0,14.0,0.4783596992492676,401.42994407492824,2,339,215,1466,883,144,84,36,53.13
22,12,0,22.0,12.0,0.4863467216491699,376.4279479528586,2,317,203,1466,883,144,84,36,47.21
21,10,0,21.0,10.0,0.49441075325012207,353.3624201864143,2,296,193,1466,883,144,84,36,42.54
16,10,0,16.0,10.0,0.5023245811462402,334.4981315343929,2,280,183,1466,883,144,84,36,38.73
15,8,0,15.0,8.0,0.5102887153625488,317.56889016400834,2,265,175,1466,883,144,84,36,33.56
12,8,0,12.0,8.0,0.5182735919952393,303.1468291109112,2,253,167,1466,883,144,84,36,32.19
10,8,0,10.0,8.0,0.5262715816497803,290.3962809679215,2,243,159,1466,883,144,84,36,26.6
9,6,0,9.0,6.0,0.5342507362365723,279.5800422061632,2,234,153,1466,883,144,84,36,25.7
6,6,0,6.0,6.0,0.5421757698059082,271.28029784707917,2,228,147,1466,883,144,84,36,18.32
5,5,0,5.0,5.0,0.550398588180542,264.372842780797,2,223,142,1466,883,144,84,36,15.86
5,4,0,5.0,4.0,0.5582606792449951,258.00775182152955,2,218,138,1466,883,144,84,36,15.68
5,5,0,5.0,5.0,0.5663325786590576,251.11352014576994,2,213,133,1466,883,144,84,36,15.29
5,6,0,5.0,6.0,0.5743556022644043,243.70679104202247,2,208,127,1466,883,144,84,36,15.24
7,6,0,7.0,6.0,0.5822737216949463,234.61031520374377,2,201,121,1466,883,144,84,36,18.08
7,6,0,7.0,6.0,0.5903277397155762,225.523834660552,2,194,115,1466,883,144,84,36,17.56
8,7,0,8.0,7.0,0.5983777046203613,215.08137994721903,2,186,108,1466,883,144,84,36,18.49
8,6,0,8.0,6.0,0.6063017845153809,205.15360099203718,2,178,102,1466,883,144,84,36,17.96
7,5,0,7.0,5.0,0.6142575740814209,196.596032513375,2,171,97,1466,883,144,84,36,16.16
7,5,0,7.0,5.0,0.622321605682373,188.04254837669055,2,164,92,1466,883,144,84,36,15.67
6,4,0,6.0,4.0,0.6303195953369141,180.8535318980528,2,158,88,1466,883,144,84,36,14.17
8,5,0,8.0,5.0,0.6383447647094727,171.4322023425004,2,150,83,1466,883,144,84,36,16.6
8,5,0,8.0,5.0,0.6462857723236084,162.01234520862909,2,142,78,1466,883,144,84,36,16.0
8,6,0,8.0,6.0,0.6543395519256592,152.11837495845134,2,134,72,1466,883,144,84,36,14.6
8,4,0,8.0,4.0,0.6622786521911621,143.17821063276352,2,126,68,1466,883,144,84,36,15.16
7,4,0,7.0,4.0,0.6702346801757812,135.1184665395519,2,119,64,1466,883,144,84,36,14.13
6,4,0,6.0,4.0,0.6784427165985107,127.94139283281233,2,113,60,1466,883,144,84,36,11.41
4,3,0,4.0,3.0,0.6865506172180176,123.00406497347964,2,109,57,1466,883,144,84,36,8.53
5,3,0,5.0,3.0,0.6941747665405273,117.18361660232202,2,104,54,1466,883,144,84,36,10.34
4,3,0,4.0,3.0,0.7022576332092285,112.25417586887359,2,100,51,1466,883,144,84,36,8.05
5,5,0,5.0,5.0,0.7103056907653809,105.55093557141026,2,95,46,1466,883,144,84,36,8.27
7,5,0,7.0,5.0,0.7183117866516113,97.082439194738,2,88,41,1466,883,144,84,36,9.89
6,5,0,6.0,5.0,0.7263047695159912,89.55445270895244,2,82,36,1466,883,144,84,36,8.25
7,5,0,7.0,5.0,0.7343587875366211,81.15417426109393,2,75,31,1466,883,144,84,36,8.56
8,5,0,8.0,5.0,0.7423267364501953,71.8679344353238,2,67,26,1466,883,144,84,36,8.69
6,4,0,6.0,4.0,0.7507767677307129,64.8459713474939,2,61,22,1466,883,144,84,36,6.76
5,3,0,5.0,3.0,0.7583427429199219,59.135437767890075,2,56,19,1466,883,144,84,36,5.98
4,4,0,4.0,4.0,0.7662405967712402,54.120236510939236,2,52,15,1466,883,144,84,36,4.16
5,2,0,5.0,2.0,0.7743597030639648,48.76474136094644,2,47,13,1466,883,144,84,36,6.19
5,3,0,5.0,3.0,0.7823617458343506,43.174066289845804,2,42,10,1466,883,144,84,36,4.56
4,3,0,4.0,3.0,0.7902767658233643,38.63935817272331,2,38,7,1466,883,144,84,36,3.34
4,2,0,4.0,2.0,0.7983577251434326,34.36568055487916,2,34,5,1466,883,144,84,36,3.59
2,2,0,2.0,2.0,0.8061957359313965,32.14031735997639,2,32,3,1466,883,144,84,36,1.72
2,0,0,2.0,-0.0,0.8142485618591309,30.14962686336267,2,30,3,1466,883,144,84,36,4.35
2,2,0,2.0,2.0,0.8222217559814453,28.0178514522438,2,28,1,1466,883,144,84,36,1.42
1,0,0,1.0,-0.0,0.8302936553955078,27.018512172212592,2,27,1,1466,883,144,84,36,5.21
0,1,0,-0.0,1.0,0.8383445739746094,27.0,2,27,0,1466,883,144,84,36,-0.13
1,0,0,1.0,-0.0,0.8462376594543457,26.0,2,26,0,1466,883,144,84,36,7.13
1,1,0,1.0,1.0,0.8624267578125,25.019992006393608,2,25,-1,1466,883,144,84,36,1.01
0,1,0,-0.0,1.0,0.8704156875610352,25.079872407968907,2,25,-2,1466,883,144,84,36,5.48
1,1,0,1.0,1.0,0.8782577514648438,24.186773244895647,2,24,-3,1466,883,144,84,36,0.82
1,0,0,1.0,-0.0,0.8862636089324951,23.194827009486403,2,23,-3,1466,883,144,84,36,3.62
1,1,0,1.0,1.0,0.8943006992340088,22.360679774997898,2,22,-4,1466,883,144,84,36,0.67
1,0,0,1.0,-0.0,0.9022767543792725,21.37755832643195,2,21,-4,1466,883,144,84,36,3.08
0,1,0,-0.0,1.0,0.9343767166137695,21.587033144922902,2,21,-5,1466,883,144,84,36,1.87
1,0,0,1.0,-0.0,0.9423136711120605,20.615528128088304,2,20,-5,1466,883,144,84,36,2.7
0,0,1,-0.0,-0.0,0.9583237171173096,20.615528128088304,2,20,-5,1466,883,144,84,36,33.09
0,0,0,-0.0,-0.0,0.08504557609558105,462.71481497786516,3,-452,-99,994,789,1446,888,63,128.79
-1,0,0,-1.0,-0.0,0.1609666347503662,461.73802095993784,3,-451,-99,994,789,1446,888,63,4.74
-3,0,0,-3.0,-0.0,0.1687157154083252,458.80823881007194,3,-448,-99,994,789,1446,888,63,8.21
-4,0,0,-4.0,-0.0,0.17679476737976074,454.9032864247081,3,-444,-99,994,789,1446,888,63,9.83
-4,0,0,-4.0,-0.0,0.18470978736877441,451.0,3,-440,-99,994,789,1446,888,63,9.77
-7,0,0,-7.0,-0.0,0.19269371032714844,444.1733895676327,3,-433,-99,994,789,1446,888,63,14.29
-9,-1,0,-9.0,-1.0,0.20070266723632812,435.1781244502072,3,-424,-98,994,789,1446,888,63,18.13
-11,-2,0,-11.0,-2.0,0.20874261856079102,424.0106130747201,3,-413,-96,994,789,1446,888,63,21.83
-14,-1,0,-14.0,-1.0,0.21672272682189941,410.15362975353514,3,-399,-95,994,789,1446,888,63,23.22
-15,-2,0,-15.0,-2.0,0.2247447967529297,395.1012528453941,3,-384,-93,994,789,1446,888,63,24.61
-18,-2,0,-18.0,-2.0,0.23272061347961426,377.1432088742949,3,-366,-91,994,789,1446,888,63,26.63
-19,-3,0,-19.0,-3.0,0.24070358276367188,357.9846365418494,3,-347,-88,994,789,1446,888,63,27.38
-20,-4,0,-20.0,-4.0,0.2487177848815918,337.6166465090251,3,-327,-84,994,789,1446,888,63,28.12
-19,-3,0,-19.0,-3.0,0.2567417621612549,318.47291878588356,3,-308,-81,994,789,1446,888,63,25.31
-20,-4,0,-20.0,-4.0,0.26473379135131836,298.1157493323692,3,-288,-77,994,789,1446,888,63,25.82
-19,-3,0,-19.0,-3.0,0.2728297710418701,278.9928314491252,3,-269,-74,994,789,1446,888,63,23.1
-18,-4,0,-18.0,-4.0,0.28072261810302734,260.5782032327339,3,-251,-70,994,789,1446,888,63,22.52
-17,-3,0,-17.0,-3.0,0.2887556552886963,243.402958075698,3,-234,-67,994,789,1446,888,63,19.85
-16,-3,0,-16.0,-3.0,0.29677271842956543,227.2003521124032,3,-218,-64,994,789,1446,888,63,18.37
-16,-3,0,-16.0,-3.0,0.30471158027648926,211.00947846009194,3,-202,-61,994,789,1446,888,63,17.43
-13,-2,0,-13.0,-2.0,0.31284570693969727,197.99494943053472,3,-189,-59,994,789,1446,888,63,14.19
-12,-2,0,-12.0,-2.0,0.3207356929779053,185.9516066077408,3,-177,-57,994,789,1446,888,63,13.03
-11,-2,0,-11.0,-2.0,0.32869672775268555,174.8742405273001,3,-166,-55,994,789,1446,888,63,11.98
-10,-3,0,-10.0,-3.0,0.33667659759521484,164.43843832875572,3,-156,-52,994,789,1446,888,63,13.01
-11,-3,0,-11.0,-3.0,0.3446846008300781,153.05554547287727,3,-145,-49,994,789,1446,888,63,12.35
-10,-2,0,-10.0,-2.0,0.3528785705566406,142.9475428260311,3,-135,-47,994,789,1446,888,63,10.11
-7,-1,0,-7.0,-1.0,0.3606147766113281,136.01470508735443,3,-128,-46,994,789,1446,888,63,7.49
-7,-1,0,-7.0,-1.0,0.36871767044067383,129.0968628588627,3,-121,-45,994,789,1446,888,63,7.2
-5,-2,0,-5.0,-2.0,0.37679457664489746,123.71337841963576,3,-116,-43,994,789,1446,888,63,8.75
-7,-2,0,-7.0,-2.0,0.38466477394104004,116.45600027478189,3,-109,-41,994,789,1446,888,63,8.26
-7,-2,0,-7.0,-2.0,0.39279961585998535,109.20164833920778,3,-102,-39,994,789,1446,888,63,7.94
-8,-3,0,-8.0,-3.0,0.4007077217102051,100.65783625729296,3,-94,-36,994,789,1446,888,63,10.73
-6,-1,0,-6.0,-1.0,0.4086465835571289,94.70480452437458,3,-88,-35,994,789,1446,888,63,5.68
-7,-3,0,-7.0,-3.0,0.4167656898498535,87.09190547921202,3,-81,-32,994,789,1446,888,63,8.65
-7,-2,0,-7.0,-2.0,0.42471766471862793,79.84985911070852,3,-74,-30,994,789,1446,888,63,6.64
-7,-2,0,-7.0,-2.0,0.43279576301574707,72.61542535852834,3,-67,-28,994,789,1446,888,63,6.24
-6,-2,0,-6.0,-2.0,0.44067978858947754,66.30987860040162,3,-61,-26,994,789,1446,888,63,6.19
-6,-2,0,-6.0,-2.0,0.44869065284729004,60.00833275470999,3,-55,-24,994,789,1446,888,63,5.83
-5,-2,0,-5.0,-2.0,0.4566476345062256,54.62600113499065,3,-50,-22,994,789,1446,888,63,6.58
-5,-2,0,-5.0,-2.0,0.46483659744262695,49.24428900898052,3,-45,-20,994,789,1446,888,63,6.28
-3,-2,0,-3.0,-2.0,0.47275471687316895,45.69463863518345,3,-42,-18,994,789,1446,888,63,3.73
-2,0,0,-2.0,-0.0,0.48077869415283203,43.86342439892262,3,-40,-18,994,789,1446,888,63,2.2
-2,-1,0,-2.0,-1.0,0.48867368698120117,41.6293165929973,3,-38,-17,994,789,1446,888,63,5.23
0,-1,0,-0.0,-1.0,0.4966926574707031,41.23105625617661,3,-38,-16,994,789,1446,888,63,0.47
-1,0,0,-1.0,-0.0,0.5046896934509277,40.311288741492746,3,-37,-16,994,789,1446,888,63,2.09
0,0,1,-0.0,-0.0,0.5427145957946777,40.311288741492746,3,-37,-16,994,789,1446,888,63,39.11
-1,0,1,-1.0,-0.0,0.019292354583740234,924.5204162158886,4,-923,53,107,858,1031,805,51,8.18
0,0,0,-0.0,-0.0,0.09919333457946777,924.5204162158886,4,-923,53,107,858,1031,805,51,196.59
-3,1,0,-3.0,1.0,0.18725323677062988,921.4683933809124,4,-920,52,107,858,1031,805,51,13.29
-5,2,0,-5.0,2.0,0.1952221393585205,916.365101910805,4,-915,50,107,858,1031,805,51,19.46
-7,1,0,-7.0,1.0,0.20321321487426758,909.3211753830436,4,-908,49,107,858,1031,805,51,26.79
-11,2,0,-11.0,2.0,0.21112632751464844,898.2304826713464,4,-897,47,107,858,1031,805,51,36.8
-15,2,0,-15.0,2.0,0.2191762924194336,883.147213096435,4,-882,45,107,858,1031,805,51,46.15
-18,1,0,-18.0,1.0,0.22723627090454102,865.1196449046802,4,-864,44,107,858,1031,805,51,53.92
-19,1,0,-19.0,1.0,0.23524737358093262,846.0933754615976,4,-845,43,107,858,1031,805,51,55.41
-21,1,0,-21.0,1.0,0.24329113960266113,825.0696940259047,4,-824,42,107,858,1031,805,51,58.1
-23,1,0,-23.0,1.0,0.251514196395874,802.0486269547501,4,-801,41,107,858,1031,805,51,60.22
-26,0,0,-26.0,-0.0,0.25908637046813965,776.0837583663248,4,-775,41,107,858,1031,805,51,61.97
-28,0,0,-28.0,-0.0,0.26713132858276367,748.124321219408,4,-747,41,107,858,1031,805,51,63.39
-32,0,0,-32.0,-0.0,0.275226354598999,716.1745597268867,4,-715,41,107,858,1031,805,51,66.75
-34,2,0,-34.0,2.0,0.28316426277160645,682.1158259416065,4,-681,39,107,858,1031,805,51,69.56
-36,1,0,-36.0,1.0,0.29113030433654785,646.1184102004833,4,-645,38,107,858,1031,805,51,67.76
-35,2,0,-35.0,2.0,0.29930830001831055,611.0613717131856,4,-610,36,107,858,1031,805,51,66.25
-34,2,0,-34.0,2.0,0.30719518661499023,577.0025996475232,4,-576,34,107,858,1031,805,51,63.27
-28,2,0,-28.0,2.0,0.3151543140411377,548.9335114565333,4,-548,32,107,858,1031,805,51,54.2
-26,2,0,-26.0,2.0,0.3232543468475342,522.8613582968243,4,-522,30,107,858,1031,805,51,50.13
-24,2,0,-24.0,2.0,0.3312222957611084,498.78652748445404,4,-498,28,107,858,1031,805,51,46.17
-24,1,0,-24.0,1.0,0.33919620513916016,474.768364573715,4,-474,27,107,858,1031,805,51,45.27
-22,2,0,-22.0,2.0,0.3472113609313965,452.6908437333364,4,-452,25,107,858,1031,805,51,41.05
-24,2,0,-24.0,2.0,0.35523319244384766,428.61754513785365,4,-428,23,107,858,1031,805,51,42.02
-21,2,0,-21.0,2.0,0.38356518745422363,407.54140893901814,4,-407,21,107,858,1031,805,51,37.19
-19,3,0,-19.0,3.0,0.3837292194366455,388.41730136542577,4,-388,18,107,858,1031,805,51,32.86
-16,3,0,-16.0,3.0,0.38379716873168945,372.3022965279693,4,-372,15,107,858,1031,805,51,28.26
-15,3,0,-15.0,3.0,0.38712120056152344,357.201623736511,4,-357,12,107,858,1031,805,51,26.19
-13,3,0,-13.0,3.0,0.39516615867614746,344.11771241829445,4,-344,9,107,858,1031,805,51,22.93
-14,3,0,-14.0,3.0,0.40325927734375,330.0545409474016,4,-330,6,107,858,1031,805,51,23.51
-13,3,0,-13.0,3.0,0.411102294921875,317.0141952657641,4,-317,3,107,858,1031,805,51,21.59
-12,4,0,-12.0,4.0,0.41925716400146484,305.00163933985664,4,-305,-1,107,858,1031,805,51,19.34
-9,2,0,-9.0,2.0,0.4271583557128906,296.0152023123137,4,-296,-3,107,858,1031,805,51,15.89
-10,2,0,-10.0,2.0,0.4352543354034424,286.04370295463593,4,-286,-5,107,858,1031,805,51,16.8
-10,1,0,-10.0,1.0,0.4431421756744385,276.06520968785617,4,-276,-6,107,858,1031,805,51,17.2
-9,2,0,-9.0,2.0,0.4511752128601074,267.1198233003309,4,-267,-8,107,858,1031,805,51,14.74
-10,1,0,-10.0,1.0,0.45923924446105957,257.1575392633862,4,-257,-9,107,858,1031,805,51,16.33
-10,1,0,-10.0,1.0,0.4672813415527344,247.2023462671825,4,-247,-10,107,858,1031,805,51,15.88
-10,1,0,-10.0,1.0,0.4751012325286865,237.25513693068902,4,-237,-11,107,858,1031,805,51,15.43
-9,0,0,-9.0,-0.0,0.48310232162475586,228.26519664635694,4,-228,-11,107,858,1031,805,51,15.49
-10,1,0,-10.0,1.0,0.4911923408508301,218.33002542023394,4,-218,-12,107,858,1031,805,51,14.57
-10,0,0,-10.0,-0.0,0.4992103576660156,208.34586628968668,4,-208,-12,107,858,1031,805,51,15.46
-9,0,0,-9.0,-0.0,0.5073761940002441,199.36148073286373,4,-199,-12,107,858,1031,805,51,14.13
-10,0,0,-10.0,-0.0,0.5151762962341309,189.38056922503955,4,-189,-12,107,858,1031,805,51,14.54
-8,0,0,-8.0,-0.0,0.5231292247772217,181.39735389470266,4,-181,-12,107,858,1031,805,51,12.45
-8,0,0,-8.0,-0.0,0.5310373306274414,173.4156855650607,4,-173,-12,107,858,1031,805,51,12.1
-9,0,0,-9.0,-0.0,0.5391671657562256,164.43843832875572,4,-164,-12,107,858,1031,805,51,12.49
-8,0,0,-8.0,-0.0,0.5472073554992676,156.46085772486356,4,-156,-12,107,858,1031,805,51,11.33
-8,0,0,-8.0,-0.0,0.5551283359527588,148.48568954616468,4,-148,-12,107,858,1031,805,51,10.96
-9,0,0,-9.0,-0.0,0.5631992816925049,139.51702405083043,4,-139,-12,107,858,1031,805,51,11.22
-9,0,0,-9.0,-0.0,0.57118821144104,130.5526713629407,4,-130,-12,107,858,1031,805,51,10.73
-8,0,0,-8.0,-0.0,0.5792863368988037,122.58874336577564,4,-122,-12,107,858,1031,805,51,9.67
-8,0,0,-8.0,-0.0,0.5871632099151611,114.6298390472568,4,-114,-12,107,858,1031,805,51,9.25
-7,0,0,-7.0,-0.0,0.5951712131500244,107.67079455451233,4,-107,-12,107,858,1031,805,51,8.3
-6,0,0,-6.0,-0.0,0.6032793521881104,101.71037311896953,4,-101,-12,107,858,1031,805,51,7.43
-4,0,0,-4.0,-0.0,0.6111283302307129,97.73944955850733,4,-97,-12,107,858,1031,805,51,6.11
-4,0,0,-4.0,-0.0,0.619260311126709,93.7709976485267,4,-93,-12,107,858,1031,805,51,5.96
-2,0,0,-2.0,-0.0,0.6271803379058838,91.7877987534291,4,-91,-12,107,858,1031,805,51,4.75
-3,0,0,-3.0,-0.0,0.6351971626281738,88.81441324469807,4,-88,-12,107,858,1031,805,51,5.22
-3,0,0,-3.0,-0.0,0.6431143283843994,85.84287972802403,4,-85,-12,107,858,1031,805,51,5.12
-2,0,0,-2.0,-0.0,0.6511852741241455,83.86298349093002,4,-83,-12,107,858,1031,805,51,4.52
-2,0,0,-2.0,-0.0,0.6591613292694092,81.88406438373708,4,-81,-12,107,858,1031,805,51,4.46
-2,0,0,-2.0,-0.0,0.6671762466430664,79.90619500389191,4,-79,-12,107,858,1031,805,51,4.4
-2,0,0,-2.0,-0.0,0.6751582622528076,77.92945527847606,4,-77,-12,107,858,1031,805,51,4.34
-2,0,0,-2.0,-0.0,0.683157205581665,75.95393340703298,4,-75,-12,107,858,1031,805,51,4.28
-1,0,0,-1.0,-0.0,0.6913113594055176,74.96665925596525,4,-74,-12,107,858,1031,805,51,3.77
-2,0,0,-2.0,-0.0,0.699303150177002,72.99315036357864,4,-72,-12,107,858,1031,805,51,4.18
-3,0,0,-3.0,-0.0,0.7072122097015381,70.03570517957252,4,-69,-12,107,858,1031,805,51,4.51
-4,0,0,-4.0,-0.0,0.715062141418457,66.09841147864296,4,-65,-12,107,858,1031,805,51,4.74
-7,0,0,-7.0,-0.0,0.7231273651123047,59.22837157984339,4,-58,-12,107,858,1031,805,51,5.42
-8,1,0,-8.0,1.0,0.7312052249908447,51.66236541235796,4,-50,-13,107,858,1031,805,51,4.39
-8,0,0,-8.0,-0.0,0.7392532825469971,43.965895873961216,4,-42,-13,107,858,1031,805,51,4.35
-7,0,0,-7.0,-0.0,0.7472753524780273,37.33630940518894,4,-35,-13,107,858,1031,805,51,3.48
-8,0,0,-8.0,-0.0,0.7551543712615967,29.966648127543394,4,-27,-13,107,858,1031,805,51,2.86
-7,0,0,-7.0,-0.0,0.7632832527160645,23.853720883753127,4,-20,-13,107,858,1031,805,51,1.87
-5,0,0,-5.0,-0.0,0.7712161540985107,19.849433241279208,4,-15,-13,107,858,1031,805,51,1.0
-6,0,0,-6.0,-0.0,0.7792103290557861,15.811388300841896,4,-9,-13,107,858,1031,805,51,0.21
-5,0,0,-5.0,-0.0,0.7871663570404053,13.601470508735444,4,-4,-13,107,858,1031,805,51,-0.62
-6,0,0,-6.0,-0.0,0.7951233386993408,13.152946437965905,4,2,-13,107,858,1031,805,51,-1.61
-4,-1,0,-4.0,-1.0,0.8032293319702148,13.416407864998739,4,6,-12,107,858,1031,805,51,-0.41
-2,-1,0,-2.0,-1.0,0.8112962245941162,13.601470508735444,4,8,-11,107,858,1031,805,51,0.48
-1,0,0,-1.0,-0.0,0.8192782402038574,14.212670403551895,4,9,-11,107,858,1031,805,51,0.64
0,0,1,-0.0,-0.0,0.8562521934509277,14.212670403551895,4,9,-11,107,858,1031,805,51,31.15
0,0,0,-0.0,-0.0,0.07682585716247559,1090.5723268082681,5,1062,-248,1160,621,98,869,41,215.93
1,0,0,1.0,-0.0,0.08596062660217285,1089.5985499256137,5,1061,-248,1160,621,98,869,41,7.66
2,0,0,2.0,-0.0,0.0939188003540039,1087.6511389227705,5,1059,-248,1160,621,98,869,41,12.27
2,-1,0,2.0,-1.0,0.10197067260742188,1085.4759324830745,5,1057,-247,1160,621,98,869,41,13.29
4,-1,0,4.0,-1.0,0.10991978645324707,1081.3533187631135,5,1053,-246,1160,621,98,869,41,24.73
6,-2,0,6.0,-2.0,0.11798381805419922,1075.0558125046346,5,1047,-244,1160,621,98,869,41,31.56
10,-2,0,10.0,-2.0,0.12595868110656738,1064.8629019737705,5,1037,-242,1160,621,98,869,41,46.17
10,-2,0,10.0,-2.0,0.13400864601135254,1054.670090597055,5,1027,-240,1160,621,98,869,41,45.93
12,-3,0,12.0,-3.0,0.1420598030090332,1042.30225942382,5,1015,-237,1160,621,98,869,41,52.9
13,-3,0,13.0,-3.0,0.14998173713684082,1028.9606406466673,5,1002,-234,1160,621,98,869,41,56.1
17,-2,0,17.0,-2.0,0.15801167488098145,1011.9530621525881,5,985,-232,1160,621,98,869,41,62.3
17,-3,0,17.0,-3.0,0.16605281829833984,994.7185531596363,5,968,-229,1160,621,98,869,41,63.08
18,-2,0,18.0,-2.0,0.17391681671142578,976.7440811184882,5,950,-227,1160,621,98,869,41,63.25
18,-3,0,18.0,-3.0,0.18198370933532715,958.5405573057407,5,932,-224,1160,621,98,869,41,63.8
18,-2,0,18.0,-2.0,0.1899857521057129,940.5742926531641,5,914,-222,1160,621,98,869,41,61.86
17,-2,0,17.0,-2.0,0.19804763793945312,923.5848634532725,5,897,-220,1160,621,98,869,41,59.05
19,-2,0,19.0,-2.0,0.20610880851745605,904.6590517979688,5,878,-218,1160,621,98,869,41,62.48
20,-3,0,20.0,-3.0,0.21392178535461426,884.5275575130489,5,858,-215,1160,621,98,869,41,64.62
24,-2,0,24.0,-2.0,0.22191166877746582,860.7700041242143,5,834,-213,1160,621,98,869,41,69.71
27,-5,0,27.0,-5.0,0.23004770278930664,833.3744656515461,5,807,-208,1160,621,98,869,41,75.5
29,-4,0,29.0,-4.0,0.2380506992340088,804.3009387039157,5,778,-204,1160,621,98,869,41,75.76
33,-6,0,33.0,-6.0,0.24592971801757812,770.8625039525531,5,745,-198,1160,621,98,869,41,80.18
32,-9,0,32.0,-9.0,0.2540607452392578,737.6245657514397,5,713,-189,1160,621,98,869,41,79.6
32,-8,0,32.0,-8.0,0.2619178295135498,704.6431721091179,5,681,-181,1160,621,98,869,41,77.2
33,-8,0,33.0,-8.0,0.2700037956237793,670.6959072485831,5,648,-173,1160,621,98,869,41,75.71
33,-6,0,33.0,-6.0,0.2780947685241699,637.270743091192,5,615,-167,1160,621,98,869,41,71.38
33,-7,0,33.0,-7.0,0.2859208583831787,603.592577820503,5,582,-160,1160,621,98,869,41,69.75
31,-8,0,31.0,-8.0,0.29395365715026855,571.5811403466703,5,551,-152,1160,621,98,869,41,67.02
30,-8,0,30.0,-8.0,0.3018808364868164,540.5339952306423,5,521,-144,1160,621,98,869,41,64.22
31,-7,0,31.0,-7.0,0.30994462966918945,508.7917059072406,5,490,-137,1160,621,98,869,41,61.02
28,-6,0,28.0,-6.0,0.3180217742919922,480.21349418774145,5,462,-131,1160,621,98,869,41,55.36
26,-7,0,26.0,-7.0,0.3260376453399658,453.290194025858,5,436,-124,1160,621,98,869,41,53.24
27,-8,0,27.0,-8.0,0.3339216709136963,425.13174428640355,5,409,-116,1160,621,98,869,41,52.55
24,-9,0,24.0,-9.0,0.34191179275512695,399.59229221795556,5,385,-107,1160,621,98,869,41,45.91
23,-8,0,23.0,-8.0,0.3499157428741455,375.2932186970609,5,362,-99,1160,621,98,869,41,43.18
21,-7,0,21.0,-7.0,0.3579416275024414,353.1925820285585,5,341,-92,1160,621,98,869,41,39.53
20,-6,0,20.0,-6.0,0.36594271659851074,332.32062830946865,5,321,-86,1160,621,98,869,41,37.54
16,-5,0,16.0,-5.0,0.3742218017578125,315.5724956329369,5,305,-81,1160,621,98,869,41,31.57
14,-4,0,14.0,-4.0,0.38193178176879883,301.01494979485653,5,291,-77,1160,621,98,869,41,28.97
13,-5,0,13.0,-5.0,0.3898496627807617,287.17242207426534,5,278,-72,1160,621,98,869,41,25.36
12,-5,0,12.0,-5.0,0.3979837894439697,274.3082208028042,5,266,-67,1160,621,98,869,41,23.15
11,-5,0,11.0,-5.0,0.40581464767456055,262.42903802742563,5,255,-62,1160,621,98,869,41,21.04
10,-4,0,10.0,-4.0,0.41388463973999023,251.7717220022932,5,245,-58,1160,621,98,869,41,19.38
12,-5,0,12.0,-5.0,0.4218757152557373,238.9518780005715,5,233,-53,1160,621,98,869,41,20.92
11,-4,0,11.0,-4.0,0.4299917221069336,227.343352662883,5,222,-49,1160,621,98,869,41,19.34
12,-3,0,12.0,-3.0,0.43805480003356934,214.97906874856446,5,210,-46,1160,621,98,869,41,21.23
14,-2,0,14.0,-2.0,0.4460437297821045,200.8780724718355,5,196,-44,1160,621,98,869,41,20.83
13,-2,0,13.0,-2.0,0.45395684242248535,187.7578227398262,5,183,-42,1160,621,98,869,41,19.23
14,-1,0,14.0,-1.0,0.461925745010376,173.90227140552247,5,169,-41,1160,621,98,869,41,17.83
14,-1,0,14.0,-1.0,0.4700906276702881,160.0781059358212,5,155,-40,1160,621,98,869,41,16.74
13,0,0,13.0,-0.0,0.47812867164611816,147.52626884728022,5,142,-40,1160,621,98,869,41,14.38
12,-2,0,12.0,-2.0,0.48597264289855957,135.4400236266961,5,130,-38,1160,621,98,869,41,14.39
10,0,0,10.0,-0.0,0.49405884742736816,125.8729518204765,5,120,-38,1160,621,98,869,41,10.74
11,0,0,11.0,-0.0,0.5019807815551758,115.43396380615195,5,109,-38,1160,621,98,869,41,10.58
11,0,0,11.0,-0.0,0.510077714920044,105.1094667477673,5,98,-38,1160,621,98,869,41,9.72
12,0,0,12.0,-0.0,0.5179886817932129,94.02127418834527,5,86,-38,1160,621,98,869,41,9.25
12,-1,0,12.0,-1.0,0.5260016918182373,82.73451516749222,5,74,-37,1160,621,98,869,41,8.69
11,0,0,11.0,-0.0,0.5339157581329346,73.06161783043132,5,63,-37,1160,621,98,869,41,6.78
10,-1,0,10.0,-1.0,0.5419938564300537,64.07027391856539,5,53,-36,1160,621,98,869,41,6.0
7,-1,0,7.0,-1.0,0.5499918460845947,57.8013840664737,5,46,-35,1160,621,98,869,41,4.48
7,-1,0,7.0,-1.0,0.557957649230957,51.73973328110612,5,39,-34,1160,621,98,869,41,3.89
5,-1,0,5.0,-1.0,0.5659496784210205,47.38143096192854,5,34,-33,1160,621,98,869,41,3.07
5,0,0,5.0,-0.0,0.5739808082580566,43.93176527297759,5,29,-33,1160,621,98,869,41,1.97
3,-1,0,3.0,-1.0,0.582047700881958,41.23105625617661,5,26,-32,1160,621,98,869,41,2.31
3,-2,0,3.0,-2.0,0.5899407863616943,37.8021163428716,5,23,-30,1160,621,98,869,41,3.21
2,0,0,2.0,-0.0,0.5980267524719238,36.61966684720111,5,21,-30,1160,621,98,869,41,0.95
3,-1,0,3.0,-1.0,0.6059486865997314,34.132096331752024,5,18,-29,1160,621,98,869,41,1.71
2,-1,0,2.0,-1.0,0.6138126850128174,32.2490309931942,5,16,-28,1160,621,98,869,41,1.78
3,-1,0,3.0,-1.0,0.6218078136444092,29.966648127543394,5,13,-27,1160,621,98,869,41,1.28
3,-1,0,3.0,-1.0,0.6299786567687988,27.85677655436824,5,10,-26,1160,621,98,869,41,1.01
1,-1,0,1.0,-1.0,0.6379227638244629,26.570660511172846,5,9,-25,1160,621,98,869,41,1.98
2,-1,0,2.0,-1.0,0.6460118293762207,25.0,5,7,-24,1160,621,98,869,41,0.98
2,-1,0,2.0,-1.0,0.6539757251739502,23.53720459187964,5,5,-23,1160,621,98,869,41,0.78
2,-1,0,2.0,-1.0,0.6619746685028076,22.20360331117452,5,3,-22,1160,621,98,869,41,0.57
2,-1,0,2.0,-1.0,0.6699416637420654,21.02379604162864,5,1,-21,1160,621,98,869,41,0.37
1,-1,0,1.0,-1.0,0.6779677867889404,20.0,5,0,-20,1160,621,98,869,41,0.9
1,-1,0,1.0,-1.0,0.6860888004302979,19.026297590440446,5,-1,-19,1160,621,98,869,41,0.76
2,0,0,2.0,-0.0,0.693901777267456,19.235384061671343,5,-3,-19,1160,621,98,869,41,1.11
1,-1,0,1.0,-1.0,0.7019426822662354,18.439088914585774,5,-4,-18,1160,621,98,869,41,0.44
1,0,0,1.0,-0.0,0.7099466323852539,18.681541692269406,5,-5,-18,1160,621,98,869,41,1.33
0,0,1,-0.0,-0.0,0.7479007244110107,18.681541692269406,5,-5,-18,1160,621,98,869,41,32.5
0,0,0,-0.0,-0.0,0.07092165946960449,423.4489343474606,6,-422,35,743,674,1165,639,22,121.62
-1,0,0,-1.0,-0.0,0.08085775375366211,422.45236417849526,6,-421,35,743,674,1165,639,22,9.07
-2,0,0,-2.0,-0.0,0.08903765678405762,420.4592727006981,6,-419,35,743,674,1165,639,22,13.57
-2,2,0,-2.0,2.0,0.09703373908996582,418.3037174111653,6,-417,33,743,674,1165,639,22,11.37
-2,1,0,-2.0,1.0,0.10489273071289062,416.23190651366457,6,-415,32,743,674,1165,639,22,11.83
-2,2,0,-2.0,2.0,0.11282157897949219,414.0881548656035,6,-413,30,743,674,1165,639,22,11.23
-2,1,0,-2.0,1.0,0.12080574035644531,412.0218440811118,6,-411,29,743,674,1165,639,22,11.71
-2,2,0,-2.0,2.0,0.1295607089996338,409.89022920777217,6,-409,27,743,674,1165,639,22,11.1
-1,1,0,-1.0,1.0,0.13686871528625488,408.8275920238261,6,-408,26,743,674,1165,639,22,6.37
-2,1,0,-2.0,1.0,0.14485979080200195,406.76897620147975,6,-406,25,743,674,1165,639,22,11.56
-1,1,0,-1.0,1.0,0.15293169021606445,405.7104879097902,6,-405,24,743,674,1165,639,22,6.32
-1,1,0,-1.0,1.0,0.16088271141052246,404.6541733381728,6,-404,23,743,674,1165,639,22,6.29
-1,0,0,-1.0,-0.0,0.1689906120300293,403.655793963124,6,-403,23,743,674,1165,639,22,9.36
-3,1,0,-3.0,1.0,0.17717361450195312,400.60454315946043,6,-400,22,743,674,1165,639,22,16.01
-4,1,0,-4.0,1.0,0.18501067161560059,396.55642725846724,6,-396,21,743,674,1165,639,22,20.02
-7,2,0,-7.0,2.0,0.19302868843078613,389.46373387004854,6,-389,19,743,674,1165,639,22,29.07
-10,1,0,-10.0,1.0,0.2010176181793213,379.42719986843326,6,-379,18,743,674,1165,639,22,37.8
-16,3,0,-16.0,3.0,0.20898175239562988,363.30978516962625,6,-363,15,743,674,1165,639,22,46.72
-21,2,0,-21.0,2.0,0.21696972846984863,342.2469868384527,6,-342,13,743,674,1165,639,22,52.54
-25,4,0,-25.0,4.0,0.22496867179870605,317.1277345171816,6,-317,9,743,674,1165,639,22,52.94
-24,2,0,-24.0,2.0,0.2329847812652588,293.08360581922693,6,-293,7,743,674,1165,639,22,50.22
-22,2,0,-22.0,2.0,0.24094772338867188,271.0461215365385,6,-271,5,743,674,1165,639,22,45.61
-20,2,0,-20.0,2.0,0.2490537166595459,251.01792764661252,6,-251,3,743,674,1165,639,22,41.19
-19,2,0,-19.0,2.0,0.2571237087249756,232.0021551624036,6,-232,1,743,674,1165,639,22,37.92
-18,1,0,-18.0,1.0,0.2649877071380615,214.0,6,-214,0,743,674,1165,639,22,35.7
-17,2,0,-17.0,2.0,0.2729916572570801,197.0101520226813,6,-197,-2,743,674,1165,639,22,31.79
-15,2,0,-15.0,2.0,0.2810497283935547,182.04395073717774,6,-182,-4,743,674,1165,639,22,27.97
-14,1,0,-14.0,1.0,0.2890126705169678,168.07438829280326,6,-168,-5,743,674,1165,639,22,26.11
-13,2,0,-13.0,2.0,0.2969636917114258,155.15798400340216,6,-155,-7,743,674,1165,639,22,22.85
-13,2,0,-13.0,2.0,0.30552172660827637,142.28492541376264,6,-142,-9,743,674,1165,639,22,21.37
-13,2,0,-13.0,2.0,0.31294870376586914,129.46814279968643,6,-129,-11,743,674,1165,639,22,19.84
-12,2,0,-12.0,2.0,0.32137060165405273,117.72000679578642,6,-117,-13,743,674,1165,639,22,17.52
-10,1,0,-10.0,1.0,0.32895660400390625,107.91200118615167,6,-107,-14,743,674,1165,639,22,15.17
-9,2,0,-9.0,2.0,0.3370068073272705,99.29753269845128,6,-98,-16,743,674,1165,639,22,12.63
-7,1,0,-7.0,1.0,0.3448326587677002,92.57429448826494,6,-91,-17,743,674,1165,639,22,10.59
-8,1,0,-8.0,1.0,0.3529856204986572,84.92938243034621,6,-83,-18,743,674,1165,639,22,10.76
-8,1,0,-8.0,1.0,0.36087679862976074,77.3692445355388,6,-75,-19,743,674,1165,639,22,9.93
-7,1,0,-7.0,1.0,0.36893272399902344,70.8801805866774,6,-68,-20,743,674,1165,639,22,8.38
-7,1,0,-7.0,1.0,0.3770327568054199,64.51356446515724,6,-61,-21,743,674,1165,639,22,7.65
-7,1,0,-7.0,1.0,0.3849766254425049,58.309518948453004,6,-54,-22,743,674,1165,639,22,6.89
-5,0,0,-5.0,-0.0,0.3930206298828125,53.71219600798314,6,-49,-22,743,674,1165,639,22,5.8
-5,0,0,-5.0,-0.0,0.4010586738586426,49.193495504995376,6,-44,-22,743,674,1165,639,22,5.32
-3,0,0,-3.0,-0.0,0.40888166427612305,46.52956049652737,6,-41,-22,743,674,1165,639,22,3.81
-5,0,0,-5.0,-0.0,0.41700077056884766,42.190046219457976,6,-36,-22,743,674,1165,639,22,4.5
-4,-1,0,-4.0,-1.0,0.42498159408569336,38.27531841800928,6,-32,-21,743,674,1165,639,22,4.74
-3,0,0,-3.0,-0.0,0.4329967498779297,35.805027579936315,6,-29,-21,743,674,1165,639,22,2.85
-3,-1,0,-3.0,-1.0,0.4410367012023926,32.802438933713454,6,-26,-20,743,674,1165,639,22,3.93
-2,-1,0,-2.0,-1.0,0.4490675926208496,30.610455730027933,6,-24,-19,743,674,1165,639,22,4.09
-2,-1,0,-2.0,-1.0,0.45686960220336914,28.42534080710379,6,-22,-18,743,674,1165,639,22,3.88
-2,-1,0,-2.0,-1.0,0.46494078636169434,26.248809496813376,6,-20,-17,743,674,1165,639,22,3.67
-1,-1,0,-1.0,-1.0,0.47304463386535645,24.839484696748443,6,-19,-16,743,674,1165,639,22,4.66
-1,0,0,-1.0,-0.0,0.4810636043548584,24.08318915758459,6,-18,-16,743,674,1165,639,22,1.41
-2,-2,0,-2.0,-2.0,0.4889078140258789,21.2602916254693,6,-16,-14,743,674,1165,639,22,5.39
-1,-2,0,-1.0,-2.0,0.4969637393951416,19.209372712298546,6,-15,-12,743,674,1165,639,22,2.41
-1,-2,0,-1.0,-2.0,0.5048167705535889,17.204650534085253,6,-14,-10,743,674,1165,639,22,2.1
-1,-1,0,-1.0,-1.0,0.5129966735839844,15.811388300841896,6,-13,-9,743,674,1165,639,22,3.3
-2,-2,0,-2.0,-2.0,0.5211727619171143,13.038404810405298,6,-11,-7,743,674,1165,639,22,3.16
-1,-2,0,-1.0,-2.0,0.5289287567138672,11.180339887498949,6,-10,-5,743,674,1165,639,22,1.19
-1,-1,0,-1.0,-1.0,0.5369346141815186,9.848857801796104,6,-9,-4,743,674,1165,639,22,1.89
-2,-2,0,-2.0,-2.0,0.5448195934295654,7.280109889280518,6,-7,-2,743,674,1165,639,22,1.27
-2,-1,0,-2.0,-1.0,0.5609326362609863,5.0990195135927845,6,-5,-1,743,674,1165,639,22,1.85
-1,-1,0,-1.0,-1.0,0.5690906047821045,4.0,6,-4,0,743,674,1165,639,22,-0.02
-1,0,0,-1.0,-0.0,0.576927661895752,3.0,6,-3,0,743,674,1165,639,22,7.13
-1,0,0,-1.0,-0.0,0.6009676456451416,2.0,6,-2,0,743,674,1165,639,22,7.12
0,0,1,-0.0,-0.0,0.6310267448425293,2.0,6,-2,0,743,674,1165,639,22,27.51
0,0,0,-0.0,-0.0,0.08400392532348633,463.76826109599176,7,416,205,1161,879,745,674,72,128.98
0,-1,0,-0.0,-1.0,0.13106703758239746,464.2111588490738,7,416,206,1161,879,745,674,72,4.32
1,0,0,1.0,-0.0,0.1389930248260498,463.31522746398053,7,415,206,1161,879,745,674,72,3.34
2,-1,0,2.0,-1.0,0.14707612991333008,461.971860614908,7,413,207,1161,879,745,674,72,3.07
1,-1,0,1.0,-1.0,0.15703606605529785,461.5278973149944,7,412,208,1161,879,745,674,72,1.18
2,-2,0,2.0,-2.0,0.16288304328918457,460.65171225124084,7,410,210,1161,879,745,674,72,1.86
2,-1,0,2.0,-1.0,0.17214703559875488,459.3310353111359,7,408,211,1161,879,745,674,72,3.0
2,-1,0,2.0,-1.0,0.17905211448669434,458.0174669158372,7,406,212,1161,879,745,674,72,2.98
1,0,0,1.0,-0.0,0.18763399124145508,457.1312721746348,7,405,212,1161,879,745,674,72,3.25
3,-1,0,3.0,-1.0,0.19492602348327637,454.9428535541579,7,402,213,1161,879,745,674,72,4.56
2,0,0,2.0,-0.0,0.20286202430725098,453.1765660313869,7,400,213,1161,879,745,674,72,4.62
6,1,0,6.0,1.0,0.21147608757019043,447.4147963579211,7,394,212,1161,879,745,674,72,11.03
10,4,0,10.0,4.0,0.22174906730651855,436.7150100465978,7,384,208,1161,879,745,674,72,18.66
12,6,0,12.0,6.0,0.22694897651672363,423.30603586530634,7,372,202,1161,879,745,674,72,22.89
18,8,0,18.0,8.0,0.23496198654174805,403.6731350981881,7,354,194,1161,879,745,674,72,27.52
21,10,0,21.0,10.0,0.24349498748779297,380.4536765494585,7,333,184,1161,879,745,674,72,30.03
24,11,0,24.0,11.0,0.2512941360473633,354.13274347340433,7,309,173,1161,879,745,674,72,30.73
28,13,0,28.0,13.0,0.25890302658081055,323.35893369443187,7,281,160,1161,879,745,674,72,31.9
33,15,0,33.0,15.0,0.26696109771728516,287.27861041156547,7,248,145,1161,879,745,674,72,32.16
34,15,0,34.0,15.0,0.2748379707336426,250.39169315294788,7,214,130,1161,879,745,674,72,29.35
32,14,0,32.0,14.0,0.28289794921875,215.82400237230334,7,182,116,1161,879,745,674,72,25.27
31,15,0,31.0,15.0,0.2909080982208252,181.6645259812713,7,151,101,1161,879,745,674,72,22.39
30,15,0,30.0,15.0,0.29895591735839844,148.44864431849825,7,121,86,1161,879,745,674,72,19.0
29,14,0,29.0,14.0,0.3076210021972656,116.82465493208187,7,92,72,1161,879,745,674,72,15.19
25,13,0,25.0,13.0,0.31483006477355957,89.27485648266257,7,67,59,1161,879,745,674,72,11.45
23,10,0,23.0,10.0,0.3233211040496826,65.85590330410783,7,44,49,1161,879,745,674,72,7.64
17,8,0,17.0,8.0,0.3308749198913574,49.09175083453431,7,27,41,1161,879,745,674,72,4.62
13,6,0,13.0,6.0,0.3388240337371826,37.69615364994153,7,14,35,1161,879,745,674,72,2.39
11,4,0,11.0,4.0,0.34685301780700684,31.144823004794873,7,3,31,1161,879,745,674,72,0.56
8,3,0,8.0,3.0,0.3548729419708252,28.442925306655784,7,-5,28,1161,879,745,674,72,-0.47
4,2,0,4.0,2.0,0.3658769130706787,27.51363298439521,7,-9,26,1161,879,745,674,72,-0.48
3,1,0,3.0,1.0,0.3708620071411133,27.730849247724095,7,-12,25,1161,879,745,674,72,0.48
2,0,0,2.0,-0.0,0.37885594367980957,28.653097563788805,7,-14,25,1161,879,745,674,72,0.26
0,-1,0,-0.0,-1.0,0.3868229389190674,29.5296461204668,7,-14,26,1161,879,745,674,72,1.63
-2,-1,0,-2.0,-1.0,0.3948519229888916,29.546573405388315,7,-12,27,1161,879,745,674,72,8.23
-3,-2,0,-3.0,-2.0,0.40288400650024414,30.364452901377952,7,-9,29,1161,879,745,674,72,-0.25
-3,-2,0,-3.0,-2.0,0.41083812713623047,31.575306807693888,7,-6,31,1161,879,745,674,72,-0.23
-3,-2,0,-3.0,-2.0,0.4188411235809326,33.13608305156178,7,-3,33,1161,879,745,674,72,-0.15
-2,-1,0,-2.0,-1.0,0.42690610885620117,34.0147027033899,7,-1,34,1161,879,745,674,72,0.25
-2,0,0,-2.0,-0.0,0.43483710289001465,34.0147027033899,7,1,34,1161,879,745,674,72,20.24
-2,-1,0,-2.0,-1.0,0.4428260326385498,35.12833614050059,7,3,35,1161,879,745,674,72,0.33
-1,0,0,-1.0,-0.0,0.4508249759674072,35.22782990761707,7,4,35,1161,879,745,674,72,2.53
-2,-1,0,-2.0,-1.0,0.45946502685546875,36.49657518178932,7,6,36,1161,879,745,674,72,0.43
-2,0,0,-2.0,-0.0,0.46683311462402344,36.87817782917155,7,8,36,1161,879,745,674,72,0.59
0,-1,0,-0.0,-1.0,0.4829540252685547,37.8549864614954,7,8,37,1161,879,745,674,72,2.88
-1,0,0,-1.0,-0.0,0.4908261299133301,38.07886552931954,7,9,37,1161,879,745,674,72,1.37
-1,0,0,-1.0,-0.0,0.5068600177764893,38.3275357934736,7,10,37,1161,879,745,674,72,1.28
0,1,0,-0.0,1.0,0.5229010581970215,37.36308338453881,7,10,36,1161,879,745,674,72,2.6
0,1,0,-0.0,1.0,0.5388240814208984,36.40054944640259,7,10,35,1161,879,745,674,72,2.55
0,1,0,-0.0,1.0,0.554893970489502,35.4400902933387,7,10,34,1161,879,1151,844,72,2.5
0,0,1,-0.0,-0.0,0.5590131282806396,35.4400902933387,7,10,34,1161,879,1151,844,72,37.620000000000005
0,1,1,-0.0,1.0,0.006832122802734375,431.9317075649807,8,378,209,1529,1055,1151,844,26,2.8
0,1,1,-0.0,1.0,0.018810272216796875,431.4487223297805,8,378,208,1529,1055,1151,844,26,2.79
0,0,0,-0.0,-0.0,0.0908203125,431.4487223297805,8,378,208,1529,1055,1151,844,26,123.11
0,1,0,-0.0,1.0,0.11485528945922852,430.96751617726363,8,378,207,1529,1055,1151,844,26,2.77
-1,0,0,-1.0,-0.0,0.15485024452209473,431.84487955746334,8,379,207,1529,1055,1151,844,26,6.61
-1,0,0,-1.0,-0.0,0.16292428970336914,432.722774995724,8,380,207,1529,1055,1151,844,26,6.62
-2,0,0,-2.0,-0.0,0.17736220359802246,434.4801491437785,8,382,207,1529,1055,1151,844,26,4.2
-2,0,0,-2.0,-0.0,0.17883825302124023,436.23961305686123,8,384,207,1529,1055,1151,844,26,4.21
-2,-1,0,-2.0,-1.0,0.18682432174682617,438.47462868448844,8,386,208,1529,1055,1151,844,26,7.12
-1,0,0,-1.0,-0.0,0.19506216049194336,439.35520936936666,8,387,208,1529,1055,1151,844,26,6.67
-1,0,0,-1.0,-0.0,0.20282530784606934,440.2363001843442,8,388,208,1529,1055,1151,844,26,6.68
-1,0,0,-1.0,-0.0,0.21082329750061035,441.1178980726128,8,389,208,1529,1055,1151,844,26,6.69
0,-1,0,-0.0,-1.0,0.21883821487426758,441.5903078646541,8,389,209,1529,1055,1151,844,26,9.55
5,0,0,5.0,-0.0,0.2508411407470703,437.1921774231556,8,384,209,1529,1055,1151,844,26,18.63
10,2,0,10.0,2.0,0.26027822494506836,427.46344872983,8,374,207,1529,1055,1151,844,26,33.68
14,4,0,14.0,4.0,0.26717519760131836,413.29045476516876,8,360,203,1529,1055,1151,844,26,42.32
17,5,0,17.0,5.0,0.2748391628265381,396.0467144163678,8,343,198,1529,1055,1151,844,26,46.11
24,7,0,24.0,7.0,0.2828032970428467,371.80909079795236,8,319,191,1529,1055,1151,844,26,52.75
26,9,0,26.0,9.0,0.29083728790283203,344.92462944823177,8,293,182,1529,1055,1151,844,26,52.83
28,11,0,28.0,11.0,0.29997825622558594,315.38230768386484,8,265,171,1529,1055,1151,844,26,51.97
28,10,0,28.0,10.0,0.3068382740020752,286.5135249861689,8,237,161,1529,1055,1151,844,26,47.77
27,11,0,27.0,11.0,0.3148193359375,258.0697580112788,8,210,150,1529,1055,1151,844,26,44.18
25,11,0,25.0,11.0,0.32281017303466797,231.40008643040736,8,185,139,1529,1055,1151,844,26,39.73
22,11,0,22.0,11.0,0.3308231830596924,207.2510554858527,8,163,128,1529,1055,1151,844,26,35.24
22,12,0,22.0,12.0,0.3388402462005615,182.58422713914803,8,141,116,1529,1055,1151,844,26,32.61
19,12,0,19.0,12.0,0.3468332290649414,160.31219541881399,8,122,104,1529,1055,1151,844,26,28.72
17,9,0,17.0,9.0,0.35480833053588867,141.59802258506295,8,105,95,1529,1055,1151,844,26,23.44
14,10,0,14.0,10.0,0.3628711700439453,124.52309022827855,8,91,85,1529,1055,1151,844,26,21.3
12,10,0,12.0,10.0,0.3708312511444092,108.93117092916977,8,79,75,1529,1055,1151,844,26,19.55
10,9,0,10.0,9.0,0.3816952705383301,95.4829827770373,8,69,66,1529,1055,1151,844,26,17.71
9,7,0,9.0,7.0,0.3868892192840576,84.1486779456457,8,60,59,1529,1055,1151,844,26,13.59
7,7,0,7.0,7.0,0.39481425285339355,74.24957912338628,8,53,52,1529,1055,1151,844,26,14.59
7,5,0,7.0,5.0,0.40282225608825684,65.76473218982953,8,46,47,1529,1055,1151,844,26,9.65
6,6,0,6.0,6.0,0.4117431640625,57.28001396647874,8,40,41,1529,1055,1151,844,26,12.11
5,4,0,5.0,4.0,0.4218273162841797,50.93132631298737,8,35,37,1529,1055,1151,844,26,7.61
4,5,0,4.0,5.0,0.4268202781677246,44.553338819890925,8,31,32,1529,1055,1151,844,26,7.67
4,3,0,4.0,3.0,0.4349381923675537,39.6232255123179,8,27,29,1529,1055,1151,844,26,5.77
3,3,0,3.0,3.0,0.44579124450683594,35.38361202590826,8,24,26,1529,1055,1151,844,26,7.12
3,2,0,3.0,2.0,0.45084118843078613,31.89043743820395,8,21,24,1529,1055,1151,844,26,4.1
2,2,0,2.0,2.0,0.4589262008666992,29.068883707497267,8,19,22,1529,1055,1151,844,26,5.41
1,1,0,1.0,1.0,0.4668142795562744,27.65863337187866,8,18,21,1529,1055,1151,844,26,4.73
1,1,0,1.0,1.0,0.4748363494873047,26.248809496813376,8,17,20,1529,1055,1151,844,26,4.62
1,0,0,1.0,-0.0,0.4838902950286865,25.612496949731394,8,16,20,1529,1055,1151,844,26,0.99
0,1,0,-0.0,1.0,0.4908013343811035,24.839484696748443,8,16,19,1529,1055,1151,844,26,1.4
0,2,0,-0.0,2.0,0.49890923500061035,23.345235059857504,8,16,17,1529,1055,1151,844,26,1.4
1,1,0,1.0,1.0,0.5085141658782959,21.93171219946131,8,15,16,1529,1055,1151,844,26,5.57
1,2,0,1.0,2.0,0.516754150390625,19.79898987322333,8,14,14,1529,1055,1151,844,26,2.7
1,1,0,1.0,1.0,0.5228431224822998,18.384776310850235,8,13,13,1529,1055,1151,844,26,7.46
1,2,0,1.0,2.0,0.5312721729278564,16.278820596099706,8,12,11,1529,1055,1151,844,26,2.31
1,3,0,1.0,3.0,0.5388033390045166,13.601470508735444,8,11,8,1529,1055,1151,844,26,1.41
2,2,0,2.0,2.0,0.5468282699584961,10.816653826391969,8,9,6,1529,1055,1151,844,26,2.89
2,3,0,2.0,3.0,0.5548381805419922,7.615773105863909,8,7,3,1529,1055,1151,844,26,1.01
2,2,0,2.0,2.0,0.5639572143554688,5.0990195135927845,8,5,1,1529,1055,1151,844,26,0.54
1,3,0,1.0,3.0,0.5708522796630859,4.47213595499958,8,4,-2,1529,1055,1151,844,26,-1.86
2,2,0,2.0,2.0,0.5788061618804932,4.47213595499958,8,2,-4,1529,1055,1151,844,26,9.45
1,2,0,1.0,2.0,0.586799144744873,6.082762530298219,8,1,-6,1529,1055,1151,844,26,-0.89
2,2,0,2.0,2.0,0.5950973033905029,8.06225774829855,8,-1,-8,1529,1055,1151,844,26,-0.9
2,1,0,2.0,1.0,0.6028151512145996,9.486832980505138,8,-3,-9,1529,1055,1151,844,26,-0.43
1,1,0,1.0,1.0,0.6112992763519287,10.770329614269007,8,-4,-10,1529,1055,1151,844,26,1.1
2,2,0,2.0,2.0,0.6195452213287354,13.416407864998739,8,-6,-12,1529,1055,1151,844,26,0.68
2,1,0,2.0,1.0,0.626838207244873,15.264337522473747,8,-8,-13,1529,1055,1151,844,26,0.48
1,1,0,1.0,1.0,0.6348152160644531,16.64331697709324,8,-9,-14,1529,1055,1151,844,26,2.38
2,1,0,2.0,1.0,0.6428341865539551,18.601075237738275,8,-11,-15,1529,1055,1151,844,26,0.89
1,0,0,1.0,-0.0,0.6509511470794678,19.209372712298546,8,-12,-15,1529,1055,1151,844,26,1.3
0,1,0,-0.0,1.0,0.6588163375854492,20.0,8,-12,-16,1529,1055,1151,844,26,1.55
1,0,0,1.0,-0.0,0.6668403148651123,20.615528128088304,8,-13,-16,1529,1055,1151,844,26,1.36
0,0,1,-0.0,-0.0,0.692866325378418,20.615528128088304,8,-13,-16,1529,1055,1151,844,26,33.09
0,0,0,-0.0,-0.0,0.08118534088134766,1010.2366059493191,9,-613,-803,929,268,1542,1071,44,206.82
-1,0,0,-1.0,-0.0,0.09753942489624023,1009.6301302952483,9,-612,-803,929,268,1542,1071,44,3.61
-1,0,0,-1.0,-0.0,0.09776425361633301,1009.0242811746405,9,-611,-803,929,268,1542,1071,44,3.6
-1,0,0,-1.0,-0.0,0.10616421699523926,1008.4190597167429,9,-610,-803,929,268,1542,1071,44,3.6
-2,0,0,-2.0,-0.0,0.11533522605895996,1007.2105043137706,9,-608,-803,929,268,1542,1071,44,6.21
-1,0,0,-1.0,-0.0,0.12217020988464355,1006.6071726348864,9,-607,-803,929,268,1542,1071,44,3.58
-1,0,0,-1.0,-0.0,0.13036036491394043,1006.004473151089,9,-606,-803,929,268,1542,1071,44,3.58
-1,0,0,-1.0,-0.0,0.13824129104614258,1005.4024069993069,9,-605,-803,929,268,1542,1071,44,3.57
-1,0,0,-1.0,-0.0,0.15085434913635254,1004.800975317998,9,-604,-803,929,268,1542,1071,44,3.57
-2,-1,0,-2.0,-1.0,0.15428733825683594,1002.8000797766223,9,-602,-802,929,268,1542,1071,44,10.5
-1,-1,0,-1.0,-1.0,0.16388320922851562,1001.400019972039,9,-601,-801,929,268,1542,1071,44,9.58
-2,-1,0,-2.0,-1.0,0.17020225524902344,999.400320192064,9,-599,-800,929,268,1542,1071,44,10.48
-1,-2,0,-1.0,-2.0,0.1781933307647705,997.2000802246257,9,-598,-798,929,268,1542,1071,44,12.58
-2,-2,0,-2.0,-2.0,0.18749523162841797,994.4003218020397,9,-596,-796,929,268,1542,1071,44,15.28
-3,-3,0,-3.0,-3.0,0.194169282913208,990.2009896985561,9,-593,-793,929,268,1542,1071,44,20.63
-3,-3,0,-3.0,-3.0,0.2041943073272705,986.0020283954796,9,-590,-790,929,268,1542,1071,44,20.58
-5,-6,0,-5.0,-6.0,0.21016526222229004,978.2029441787629,9,-585,-784,929,268,1542,1071,44,34.11
-7,-7,0,-7.0,-7.0,0.21830534934997559,968.4074555681611,9,-578,-777,929,268,1542,1071,44,38.86
-12,-11,0,-12.0,-11.0,0.22753238677978516,952.4242752051209,9,-566,-766,929,268,1542,1071,44,54.39
-14,-12,0,-14.0,-12.0,0.2341783046722412,934.4624122991786,9,-552,-754,929,268,1542,1071,44,58.02
-17,-15,0,-17.0,-15.0,0.2428112030029297,912.3299841614327,9,-535,-739,929,268,1542,1071,44,65.67
-19,-18,0,-19.0,-18.0,0.25106120109558105,886.6211141180883,9,-516,-721,929,268,1542,1071,44,71.08
-25,-21,0,-25.0,-21.0,0.25820422172546387,855.0327479108622,9,-491,-700,929,268,1542,1071,44,78.0
-26,-24,0,-26.0,-24.0,0.26630735397338867,820.4882692641011,9,-465,-676,929,268,1542,1071,44,80.16
-28,-23,0,-28.0,-23.0,0.27506542205810547,785.7340516994284,9,-437,-653,929,268,1542,1071,44,77.98
-29,-24,0,-29.0,-24.0,0.28215527534484863,749.7366204207982,9,-408,-629,929,268,1542,1071,44,77.18
-27,-26,0,-27.0,-26.0,0.2902042865753174,713.2811507393141,9,-381,-603,929,268,1542,1071,44,75.68
-27,-26,0,-27.0,-26.0,0.2981693744659424,676.937958752499,9,-354,-577,929,268,1542,1071,44,73.08
-25,-25,0,-25.0,-25.0,0.30739426612854004,642.6079675821021,9,-329,-552,929,268,1542,1071,44,68.67
-21,-21,0,-21.0,-21.0,0.3152282238006592,613.8607333915405,9,-308,-531,929,268,1542,1071,44,60.38
-20,-20,0,-20.0,-20.0,0.32216334342956543,586.5705413673619,9,-288,-511,929,268,1542,1071,44,56.86
-15,-18,0,-15.0,-18.0,0.3302474021911621,563.540593036562,9,-273,-493,929,268,1542,1071,44,50.53
-15,-17,0,-15.0,-17.0,0.3381783962249756,541.4240482283734,9,-258,-476,929,268,1542,1071,44,47.81
-12,-16,0,-12.0,-16.0,0.3463113307952881,521.6473904851821,9,-246,-460,929,268,1542,1071,44,44.04
-11,-16,0,-11.0,-16.0,0.354445219039917,502.3554518465984,9,-235,-444,929,268,1542,1071,44,42.7
-9,-16,0,-9.0,-16.0,0.36286330223083496,484.0041322137653,9,-226,-428,929,268,1542,1071,44,42.11
-7,-16,0,-7.0,-16.0,0.37020325660705566,466.5886839605093,9,-219,-412,929,268,1542,1071,44,38.72
-7,-17,0,-7.0,-17.0,0.378251314163208,448.2956613664692,9,-212,-395,929,268,1542,1071,44,38.6
-7,-17,0,-7.0,-17.0,0.38686633110046387,430.01046498893487,9,-205,-378,929,268,1542,1071,44,37.53
-6,-16,0,-6.0,-16.0,0.39417123794555664,413.0919994383818,9,-199,-362,929,268,1542,1071,44,34.43
-5,-15,0,-5.0,-15.0,0.4022064208984375,397.54873915030845,9,-194,-347,929,268,1542,1071,44,31.43
-5,-15,0,-5.0,-15.0,0.410170316696167,382.0274859221519,9,-189,-332,929,268,1542,1071,44,30.54
-4,-13,0,-4.0,-13.0,0.4181783199310303,368.7627963881389,9,-185,-319,929,268,1542,1071,44,26.66
-5,-12,0,-5.0,-12.0,0.426180362701416,355.87778801155883,9,-180,-307,929,268,1542,1071,44,26.23
-2,-12,0,-2.0,-12.0,0.434232234954834,344.5417246140154,9,-178,-295,929,268,1542,1071,44,22.18
-4,-14,0,-4.0,-14.0,0.44373035430908203,330.5102116425452,9,-174,-281,929,268,1542,1071,44,25.51
-4,-14,0,-4.0,-14.0,0.4501802921295166,316.52646018934973,9,-170,-267,929,268,1542,1071,44,24.67
-5,-14,0,-5.0,-14.0,0.4581732749938965,302.04966479041155,9,-165,-253,929,268,1542,1071,44,24.76
-4,-13,0,-4.0,-13.0,0.46616125106811523,289.0,9,-161,-240,929,268,1542,1071,44,22.12
-4,-14,0,-4.0,-14.0,0.47418832778930664,275.1817581163403,9,-157,-226,929,268,1542,1071,44,22.08
-4,-13,0,-4.0,-13.0,0.4821813106536865,262.25560051217207,9,-153,-213,929,268,1542,1071,44,20.44
-4,-13,0,-4.0,-13.0,0.49016523361206055,249.40128307609004,9,-149,-200,929,268,1542,1071,44,19.6
-3,-12,0,-3.0,-12.0,0.49816441535949707,238.03361107205006,9,-146,-188,929,268,1542,1071,44,17.17
-3,-11,0,-3.0,-11.0,0.5062432289123535,227.547797176769,9,-143,-177,929,268,1542,1071,44,15.73
-3,-11,0,-3.0,-11.0,0.5167162418365479,217.1543230055529,9,-140,-166,929,268,1542,1071,44,15.06
-3,-10,0,-3.0,-10.0,0.5224032402038574,207.6174366473105,9,-137,-156,929,268,1542,1071,44,13.76
-5,-11,0,-5.0,-11.0,0.5301902294158936,196.08416560242696,9,-132,-145,929,268,1542,1071,44,15.56
-5,-10,0,-5.0,-10.0,0.538163423538208,185.34832073693033,9,-127,-135,929,268,1542,1071,44,14.37
-5,-10,0,-5.0,-10.0,0.5464003086090088,174.6682569902156,9,-122,-125,929,268,1542,1071,44,13.67
-6,-8,0,-6.0,-8.0,0.5542562007904053,164.7573974060042,9,-116,-117,929,268,1542,1071,44,13.63
-5,-7,0,-5.0,-7.0,0.5647192001342773,156.27219842313605,9,-111,-110,929,268,1542,1071,44,11.74
-5,-7,0,-5.0,-7.0,0.5701873302459717,147.80054127099805,9,-106,-103,929,268,1542,1071,44,11.26
-4,-7,0,-4.0,-7.0,0.5782003402709961,140.07141035914503,9,-102,-96,929,268,1542,1071,44,9.63
-6,-6,0,-6.0,-6.0,0.5888392925262451,131.59027319676784,9,-96,-90,929,268,1542,1071,44,12.65
-4,-6,0,-4.0,-6.0,0.5941832065582275,124.57929201917949,9,-92,-84,929,268,1542,1071,44,8.7
-5,-6,0,-5.0,-6.0,0.6023213863372803,116.84605256490268,9,-87,-78,929,268,1542,1071,44,9.58
-5,-6,0,-5.0,-6.0,0.6105992794036865,109.12378292562992,9,-82,-72,929,268,1542,1071,44,9.12
-6,-7,0,-6.0,-7.0,0.618171215057373,100.00499987500625,9,-76,-65,929,268,1542,1071,44,9.51
-5,-5,0,-5.0,-5.0,0.6263232231140137,92.9569792968769,9,-71,-60,929,268,1542,1071,44,8.78
-7,-5,0,-7.0,-5.0,0.6342082023620605,84.38601779915912,9,-64,-55,929,268,1542,1071,44,9.09
-6,-5,0,-6.0,-5.0,0.6422042846679688,76.57675887630658,9,-58,-50,929,268,1542,1071,44,10.22
-5,-4,0,-5.0,-4.0,0.6501822471618652,70.178344238091,9,-53,-46,929,268,1542,1071,44,8.32
-6,-5,0,-6.0,-5.0,0.6582162380218506,62.369864518050704,9,-47,-41,929,268,1542,1071,44,9.2
-6,-4,0,-6.0,-4.0,0.666168212890625,55.226805085936306,9,-41,-37,929,268,1542,1071,44,6.24
-6,-5,0,-6.0,-5.0,0.6741893291473389,47.4236228055175,9,-35,-32,929,268,1542,1071,44,7.55
-6,-4,0,-6.0,-4.0,0.6823282241821289,40.311288741492746,9,-29,-28,929,268,1542,1071,44,5.11
-3,-3,0,-3.0,-3.0,0.6927483081817627,36.069377593742864,9,-26,-25,929,268,1542,1071,44,6.83
-4,-3,0,-4.0,-3.0,0.6982283592224121,31.11269837220809,9,-22,-22,929,268,1542,1071,44,4.37
-3,-3,0,-3.0,-3.0,0.7064564228057861,26.870057685088806,9,-19,-19,929,268,1542,1071,44,8.26
-2,-2,0,-2.0,-2.0,0.714442253112793,24.041630560342615,9,-17,-17,929,268,1542,1071,44,7.7
-2,-4,0,-2.0,-4.0,0.7230854034423828,19.849433241279208,9,-15,-13,929,268,1542,1071,44,2.14
-3,-3,0,-3.0,-3.0,0.7307312488555908,15.620499351813308,9,-12,-10,929,268,1542,1071,44,3.94
-3,-4,0,-3.0,-4.0,0.7405872344970703,10.816653826391969,9,-9,-6,929,268,1542,1071,44,1.73
-2,-3,0,-2.0,-3.0,0.7462084293365479,7.615773105863909,9,-7,-3,929,268,1542,1071,44,0.49
-2,-4,0,-2.0,-4.0,0.75455641746521,5.0990195135927845,9,-5,1,929,268,1542,1071,44,-1.31
-2,-2,0,-2.0,-2.0,0.7621562480926514,4.242640687119285,9,-3,3,929,268,1542,1071,44,-1.76
-1,-2,0,-1.0,-2.0,0.7705192565917969,5.385164807134504,9,-2,5,929,268,1542,1071,44,-1.38
0,-1,0,-0.0,-1.0,0.8021543025970459,6.324555320336759,9,-2,6,929,268,1542,1071,44,1.11
0,0,1,-0.0,-0.0,0.8102023601531982,6.324555320336759,9,-2,6,929,268,1542,1071,44,28.79
0,0,0,-0.0,-0.0,0.08885598182678223,584.199452242126,10,-480,333,451,595,931,262,71,149.27
-1,1,0,-1.0,1.0,0.16988587379455566,582.8078585606066,10,-479,332,451,595,931,262,71,5.86
-2,3,0,-2.0,3.0,0.17784380912780762,579.4566420363132,10,-477,329,451,595,931,262,71,8.46
-5,6,0,-5.0,6.0,0.18583393096923828,571.9379336956065,10,-472,323,451,595,931,262,71,15.89
-6,7,0,-6.0,7.0,0.1938779354095459,563.0381869820199,10,-466,316,451,595,931,262,71,17.95
-9,8,0,-9.0,8.0,0.201826810836792,551.101624022285,10,-457,308,451,595,931,262,71,23.06
-12,11,0,-12.0,11.0,0.2099897861480713,535.0084111488342,10,-445,297,451,595,931,262,71,27.92
-19,13,0,-19.0,13.0,0.2178668975830078,511.9882811158865,10,-426,284,451,595,931,262,71,37.69
-21,14,0,-21.0,14.0,0.2258319854736328,486.7494221876386,10,-405,270,451,595,931,262,71,39.79
-21,15,0,-21.0,15.0,0.23397493362426758,460.9566140104728,10,-384,255,451,595,931,262,71,37.15
-22,16,0,-22.0,16.0,0.2418217658996582,433.7798981050182,10,-362,239,451,595,931,262,71,36.69
-23,16,0,-23.0,16.0,0.2501537799835205,405.77087130546965,10,-339,223,451,595,931,262,71,36.48
-21,16,0,-21.0,16.0,0.2578308582305908,379.4377419287649,10,-318,207,451,595,931,262,71,32.52
-18,14,0,-18.0,14.0,0.26581883430480957,356.7197779770558,10,-300,193,451,595,931,262,71,28.23
-17,13,0,-17.0,13.0,0.27385497093200684,335.393798392278,10,-283,180,451,595,931,262,71,26.1
-13,11,0,-13.0,11.0,0.28183698654174805,318.5294334908471,10,-270,169,451,595,931,262,71,21.03
-12,10,0,-12.0,10.0,0.28989195823669434,303.0594001181947,10,-258,159,451,595,931,262,71,19.23
-9,9,0,-9.0,9.0,0.2983858585357666,290.69055712217414,10,-249,150,451,595,931,262,71,15.4
-10,8,0,-10.0,8.0,0.3058347702026367,278.0017985553331,10,-239,142,451,595,931,262,71,16.0
-9,8,0,-9.0,8.0,0.31525278091430664,266.1879035568671,10,-230,134,451,595,931,262,71,14.38
-8,8,0,-8.0,8.0,0.3218379020690918,255.26456863419176,10,-222,126,451,595,931,262,71,12.87
-11,7,0,-11.0,7.0,0.3301849365234375,242.24367896810023,10,-211,119,451,595,931,262,71,16.17
-11,8,0,-11.0,8.0,0.3378567695617676,228.7378412069153,10,-200,111,451,595,931,262,71,14.95
-13,7,0,-13.0,7.0,0.34583187103271484,213.974297521922,10,-187,104,451,595,931,262,71,17.62
-12,7,0,-12.0,7.0,0.3538548946380615,200.08498194517247,10,-175,97,451,595,931,262,71,16.04
-12,6,0,-12.0,6.0,0.3624138832092285,186.6815470259447,10,-163,91,451,595,931,262,71,14.39
-11,6,0,-11.0,6.0,0.37264180183410645,174.15223225672418,10,-152,85,451,595,931,262,71,14.75
-10,5,0,-10.0,5.0,0.3778507709503174,162.9846618550347,10,-142,80,451,595,931,262,71,12.02
-10,4,0,-10.0,4.0,0.38651585578918457,152.31546211727817,10,-132,76,451,595,931,262,71,10.0
-11,6,0,-11.0,6.0,0.39646387100219727,139.7891269019161,10,-121,70,451,595,931,262,71,12.55
-10,5,0,-10.0,5.0,0.4024078845977783,128.63125592172378,10,-111,65,451,595,931,262,71,10.3
-10,5,0,-10.0,5.0,0.40985584259033203,117.47765745025733,10,-101,60,451,595,931,262,71,9.72
-7,6,0,-7.0,6.0,0.4198877811431885,108.40664186294121,10,-94,54,451,595,931,262,71,7.21
-7,5,0,-7.0,5.0,0.4260079860687256,99.84988733093293,10,-87,49,451,595,931,262,71,7.44
-6,4,0,-6.0,4.0,0.4339749813079834,92.66067126888301,10,-81,45,451,595,931,262,71,7.04
-5,4,0,-5.0,4.0,0.4420809745788574,86.35392289873113,10,-76,41,451,595,931,262,71,5.46
-3,3,0,-3.0,3.0,0.4498298168182373,82.29823813423954,10,-73,38,451,595,931,262,71,3.83
-3,3,0,-3.0,3.0,0.45789599418640137,78.26237921249263,10,-70,35,451,595,931,262,71,3.67
-1,1,0,-1.0,1.0,0.4696469306945801,76.92203845452875,10,-69,34,451,595,931,262,71,2.76
-2,3,0,-2.0,3.0,0.4738428592681885,73.824115301167,10,-67,31,451,595,931,262,71,2.51
-2,2,0,-2.0,2.0,0.481921911239624,71.17583859709698,10,-65,29,451,595,931,262,71,2.93
-3,2,0,-3.0,2.0,0.4898228645324707,67.62396025078685,10,-62,27,451,595,931,262,71,4.13
-4,3,0,-4.0,3.0,0.49793291091918945,62.76941930590086,10,-58,24,451,595,931,262,71,3.88
-3,3,0,-3.0,3.0,0.506004810333252,58.872744118140105,10,-55,21,451,595,931,262,71,2.81
-5,3,0,-5.0,3.0,0.5138278007507324,53.14132102234569,10,-50,18,451,595,931,262,71,4.15
-6,3,0,-6.0,3.0,0.5220937728881836,46.486557196677836,10,-44,15,451,595,931,262,71,4.6
-5,2,0,-5.0,2.0,0.5298588275909424,41.10960958218893,10,-39,13,451,595,931,262,71,5.27
-3,2,0,-3.0,2.0,0.5378148555755615,37.64306044943742,10,-36,11,451,595,931,262,71,2.71
-2,2,0,-2.0,2.0,0.5460407733917236,35.17101079013795,10,-34,9,451,595,931,262,71,1.68
-3,1,0,-3.0,1.0,0.5538198947906494,32.01562118716424,10,-31,8,451,595,931,262,71,4.46
-1,1,0,-1.0,1.0,0.5618338584899902,30.805843601498726,10,-30,7,451,595,931,262,71,1.48
-2,1,0,-2.0,1.0,0.5699248313903809,28.635642126552707,10,-28,6,451,595,931,262,71,2.57
-1,1,0,-1.0,1.0,0.5812239646911621,27.459060435491963,10,-27,5,451,595,931,262,71,1.3
0,0,1,-0.0,-0.0,0.5949349403381348,27.459060435491963,10,-27,5,451,595,931,262,71,35.18
0,0,0,-0.0,-0.0,0.0962822437286377,371.24789561693143,11,-329,172,149,762,478,590,71,111.59
0,1,0,-0.0,1.0,0.1582803726196289,370.78565236535246,11,-329,171,149,762,478,590,71,1.3
1,0,0,1.0,-0.0,0.16661739349365234,371.6732435890429,11,-330,171,149,762,478,590,71,3.42
1,0,0,1.0,-0.0,0.17728042602539062,372.5614043349096,11,-331,171,149,762,478,590,71,3.42
1,0,0,1.0,-0.0,0.18228840827941895,373.45013053954074,11,-332,171,149,762,478,590,71,3.43
1,0,0,1.0,-0.0,0.1982743740081787,374.33941817553756,11,-333,171,149,762,478,590,71,3.43
0,1,0,-0.0,1.0,0.2302863597869873,373.8836717483126,11,-333,170,149,762,478,590,71,1.29
0,1,0,-0.0,1.0,0.23825740814208984,373.4300469967568,11,-333,169,149,762,478,590,71,1.28
-4,2,0,-4.0,2.0,0.2462782859802246,368.95799218881274,11,-329,167,149,762,478,590,71,12.37
-7,2,0,-7.0,2.0,0.25475120544433594,361.8134878635676,11,-322,165,149,762,478,590,71,12.24
-9,3,0,-9.0,3.0,0.2622952461242676,352.4386471430169,11,-313,162,149,762,478,590,71,14.86
-13,5,0,-13.0,5.0,0.27039432525634766,338.59858239514233,11,-300,157,149,762,478,590,71,19.38
-17,6,0,-17.0,6.0,0.2787632942199707,320.764711276038,11,-283,151,149,762,478,590,71,21.86
-21,7,0,-21.0,7.0,0.2862703800201416,298.9648808806814,11,-262,144,149,762,478,590,71,23.63
-19,7,0,-19.0,7.0,0.29471731185913086,278.9587783167972,11,-243,137,149,762,478,590,71,21.48
-18,7,0,-18.0,7.0,0.302288293838501,259.8557292037257,11,-225,130,149,762,478,590,71,19.95
-16,7,0,-16.0,7.0,0.31025123596191406,242.5077318355025,11,-209,123,149,762,478,590,71,18.24
-14,6,0,-14.0,6.0,0.31835222244262695,227.40712389896672,11,-195,117,149,762,478,590,71,15.86
-11,5,0,-11.0,5.0,0.32629823684692383,215.40659228538016,11,-184,112,149,762,478,590,71,13.41
-11,5,0,-11.0,5.0,0.33426737785339355,203.4158302591025,11,-173,107,149,762,478,590,71,12.88
-9,5,0,-9.0,5.0,0.34232139587402344,193.13207915827965,11,-164,102,149,762,478,590,71,12.56
-8,5,0,-8.0,5.0,0.3502652645111084,183.69812192834198,11,-156,97,149,762,478,590,71,13.78
-6,4,0,-6.0,4.0,0.3584604263305664,176.49079296099274,11,-150,93,149,762,478,590,71,10.45
-7,4,0,-7.0,4.0,0.3662693500518799,168.4339633209407,11,-143,89,149,762,478,590,71,10.65
-7,5,0,-7.0,5.0,0.37452220916748047,159.84992962150469,11,-136,84,149,762,478,590,71,10.05
-7,4,0,-7.0,4.0,0.3829472064971924,151.7926216915697,11,-129,80,149,762,478,590,71,10.22
-6,4,0,-6.0,4.0,0.39136624336242676,144.5856147754679,11,-123,76,149,762,478,590,71,9.57
-7,4,0,-7.0,4.0,0.3982963562011719,136.5283853270081,11,-116,72,149,762,478,590,71,9.75
-6,4,0,-6.0,4.0,0.40683722496032715,129.3213052826177,11,-110,68,149,762,478,590,71,9.16
-8,5,0,-8.0,5.0,0.41427135467529297,119.8874472161285,11,-102,63,149,762,478,590,71,11.44
-8,4,0,-8.0,4.0,0.42238426208496094,110.98198051936178,11,-94,59,149,762,478,590,71,8.12
-8,5,0,-8.0,5.0,0.43027424812316895,101.54801819828883,11,-86,54,149,762,478,590,71,11.15
-6,4,0,-6.0,4.0,0.4399852752685547,94.33981132056604,11,-80,50,149,762,478,590,71,8.29
-7,4,0,-7.0,4.0,0.44629836082458496,86.28441342444185,11,-73,46,149,762,478,590,71,7.92
-7,4,0,-7.0,4.0,0.4542872905731201,78.23042886243178,11,-66,42,149,762,478,590,71,7.51
-5,5,0,-5.0,5.0,0.4623093605041504,71.34423592694787,11,-61,37,149,762,478,590,71,4.77
-5,3,0,-5.0,3.0,0.4703793525695801,65.5133574166368,11,-56,34,149,762,478,590,71,8.33
-4,3,0,-4.0,3.0,0.47829341888427734,60.53924347066124,11,-52,31,149,762,478,590,71,5.03
-3,3,0,-3.0,3.0,0.48812437057495117,56.43580423808985,11,-49,28,149,762,478,590,71,3.45
-3,3,0,-3.0,3.0,0.4942772388458252,52.354560450833695,11,-46,25,149,762,478,590,71,3.23
-2,2,0,-2.0,2.0,0.5022802352905273,49.64876634922564,11,-44,23,149,762,478,590,71,2.83
-1,1,0,-1.0,1.0,0.5116772651672363,48.30113870293329,11,-43,22,149,762,478,590,71,2.56
-1,2,0,-1.0,2.0,0.5183022022247314,46.51881339845203,11,-42,20,149,762,478,590,71,1.49
-1,1,0,-1.0,1.0,0.5263292789459229,45.18849411078001,11,-41,19,149,762,478,590,71,2.35
-1,1,0,-1.0,1.0,0.5342612266540527,43.86342439892262,11,-40,18,149,762,478,590,71,2.29
-1,1,0,-1.0,1.0,0.5422592163085938,42.5440947723653,11,-39,17,149,762,478,590,71,2.23
-2,2,0,-2.0,2.0,0.5504112243652344,39.92492955535426,11,-37,15,149,762,478,590,71,2.22
-2,2,0,-2.0,2.0,0.5585002899169922,37.33630940518894,11,-35,13,149,762,478,590,71,2.05
-2,2,0,-2.0,2.0,0.5662782192230225,34.785054261852174,11,-33,11,149,762,478,590,71,1.87
-2,2,0,-2.0,2.0,0.5744562149047852,32.28002478313795,11,-31,9,149,762,478,590,71,1.68
-2,0,0,-2.0,-0.0,0.582491397857666,30.364452901377952,11,-29,9,149,762,478,590,71,2.36
0,0,1,-0.0,-0.0,0.5872843265533447,30.364452901377952,11,-29,9,149,762,478,590,71,36.06
-1,2,1,-1.0,2.0,0.004947185516357422,749.2829905983452,12,280,-695,457,60,178,753,47,5.69
-2,2,1,-2.0,2.0,0.008834123611450195,751.8862945951336,12,282,-697,457,60,178,753,47,3.36
-1,2,1,-1.0,2.0,0.0168612003326416,754.1153757880819,12,283,-699,457,60,178,753,47,5.73
-1,1,1,-1.0,1.0,0.024845123291015625,755.417765213395,12,284,-700,457,60,178,753,47,4.74
-1,1,1,-1.0,1.0,0.0328371524810791,756.7205560839483,12,285,-701,457,60,178,753,47,4.74
-1,1,1,-1.0,1.0,0.040894269943237305,758.023746329889,12,286,-702,457,60,178,753,47,4.75
0,0,0,-0.0,-0.0,0.10190510749816895,758.023746329889,12,286,-702,457,60,178,753,47,174.97
2,-1,0,2.0,-1.0,0.14481830596923828,756.3444982281553,12,284,-701,457,60,178,753,47,7.0
3,-2,0,3.0,-2.0,0.15287113189697266,753.367108387405,12,281,-699,457,60,178,753,47,11.43
2,-1,0,2.0,-1.0,0.16090130805969238,751.6947518773827,12,279,-698,457,60,178,753,47,6.95
4,-3,0,4.0,-3.0,0.17145514488220215,747.4289263869844,12,275,-695,457,60,178,753,47,15.43
3,-3,0,3.0,-3.0,0.17688226699829102,743.5374906485886,12,272,-692,457,60,178,753,47,14.68
6,-3,0,6.0,-3.0,0.18485021591186523,738.5641475186837,12,266,-689,457,60,178,753,47,16.95
8,-5,0,8.0,-5.0,0.19281721115112305,731.0403545632759,12,258,-684,457,60,178,753,47,23.95
9,-5,0,9.0,-5.0,0.20081615447998047,723.2164268045908,12,249,-679,457,60,178,753,47,24.43
13,-8,0,13.0,-8.0,0.20884323120117188,711.2924855500725,12,236,-671,457,60,178,753,47,33.83
17,-7,0,17.0,-7.0,0.217177152633667,699.1830947613079,12,219,-664,457,60,178,753,47,33.51
18,-10,0,18.0,-10.0,0.2268540859222412,684.1907628724609,12,201,-654,457,60,178,753,47,39.03
17,-10,0,17.0,-10.0,0.23282718658447266,669.7701098138077,12,184,-644,457,60,178,753,47,37.43
14,-13,0,14.0,-13.0,0.24083614349365234,653.4990436106239,12,170,-631,457,60,178,753,47,40.72
14,-15,0,14.0,-15.0,0.24881219863891602,635.4462998554637,12,156,-616,457,60,178,753,47,43.2
11,-18,0,11.0,-18.0,0.2569773197174072,615.3283676217114,12,145,-598,457,60,178,753,47,46.27
9,-17,0,9.0,-17.0,0.26497817039489746,596.7051198037436,12,136,-581,457,60,178,753,47,43.37
9,-20,0,9.0,-20.0,0.2752981185913086,575.1956188984752,12,127,-561,457,60,178,753,47,46.95
8,-21,0,8.0,-21.0,0.28127431869506836,552.9565986585204,12,119,-540,457,60,178,753,47,47.2
7,-22,0,7.0,-22.0,0.28885316848754883,529.9698104609356,12,112,-518,457,60,178,753,47,47.5
4,-21,0,4.0,-21.0,0.2994382381439209,508.59905623192026,12,108,-497,457,60,178,753,47,45.74
4,-23,0,4.0,-23.0,0.30632615089416504,485.2751796661354,12,104,-474,457,60,178,753,47,46.29
3,-26,0,3.0,-26.0,0.3153243064880371,459.24394389039037,12,101,-448,457,60,178,753,47,46.63
1,-23,0,1.0,-23.0,0.32152509689331055,436.6062299143245,12,100,-425,457,60,178,753,47,40.76
1,-19,0,1.0,-19.0,0.32883715629577637,417.8959200566572,12,99,-406,457,60,178,753,47,35.1
0,-17,0,-0.0,-17.0,0.33686208724975586,401.40004982560725,12,99,-389,457,60,178,753,47,31.08
1,-17,0,1.0,-17.0,0.3448293209075928,384.6920846599264,12,98,-372,457,60,178,753,47,30.8
0,-15,0,-0.0,-15.0,0.3528110980987549,370.20669902096586,12,98,-357,457,60,178,753,47,26.88
0,-15,0,-0.0,-15.0,0.3609182834625244,355.7639666970223,12,98,-342,457,60,178,753,47,26.08
0,-13,0,-0.0,-13.0,0.36881017684936523,343.2855953866984,12,98,-329,457,60,178,753,47,22.96
1,-16,0,1.0,-16.0,0.37689709663391113,327.6858251435359,12,97,-313,457,60,178,753,47,26.25
1,-17,0,1.0,-17.0,0.3850071430206299,311.17840542042757,12,96,-296,457,60,178,753,47,26.23
1,-17,0,1.0,-17.0,0.3957231044769287,294.7303852676205,12,95,-279,457,60,178,753,47,25.15
2,-13,0,2.0,-13.0,0.40083909034729004,281.78892810044897,12,93,-266,457,60,178,753,47,21.29
1,-13,0,1.0,-13.0,0.40886831283569336,269.2080979465514,12,92,-253,457,60,178,753,47,19.74
1,-11,0,1.0,-11.0,0.4168131351470947,258.54400012377005,12,91,-242,457,60,178,753,47,17.16
1,-11,0,1.0,-11.0,0.4248542785644531,247.91329129354884,12,90,-231,457,60,178,753,47,16.6
1,-11,0,1.0,-11.0,0.43282628059387207,237.32045845227924,12,89,-220,457,60,178,753,47,16.02
1,-9,0,1.0,-9.0,0.440845251083374,228.61539755668252,12,88,-211,457,60,178,753,47,13.7
2,-9,0,2.0,-9.0,0.4488551616668701,219.5449840010015,12,86,-202,457,60,178,753,47,14.33
0,-7,0,-0.0,-7.0,0.45685815811157227,213.12203077110541,12,86,-195,457,60,178,753,47,10.12
1,-7,0,1.0,-7.0,0.4669511318206787,206.3225629929989,12,85,-188,457,60,178,753,47,10.86
1,-7,0,1.0,-7.0,0.4730851650238037,199.5419755339713,12,84,-181,457,60,178,753,47,10.57
1,-7,0,1.0,-7.0,0.48083925247192383,192.78226059469267,12,83,-174,457,60,178,753,47,10.28
1,-6,0,1.0,-6.0,0.49106717109680176,186.9438418349211,12,82,-168,457,60,178,753,47,9.22
1,-6,0,1.0,-6.0,0.49682116508483887,181.12150617748296,12,81,-162,457,60,178,753,47,8.99
1,-7,0,1.0,-7.0,0.5058832168579102,174.42763542512407,12,80,-155,457,60,178,753,47,9.46
1,-6,0,1.0,-6.0,0.5144052505493164,168.6475615003075,12,79,-149,457,60,178,753,47,8.46
2,-6,0,2.0,-6.0,0.5208733081817627,162.4130536625674,12,77,-143,457,60,178,753,47,9.55
1,-7,0,1.0,-7.0,0.5288331508636475,155.79473675320358,12,76,-136,457,60,178,753,47,8.61
1,-5,0,1.0,-5.0,0.5368242263793945,150.95032295427526,12,75,-131,457,60,178,753,47,7.1
1,-5,0,1.0,-5.0,0.5448591709136963,146.12323566086263,12,74,-126,457,60,178,753,47,6.9
2,-4,0,2.0,-4.0,0.5528292655944824,141.66156853571826,12,72,-122,457,60,178,753,47,8.54
2,-4,0,2.0,-4.0,0.5615313053131104,137.20058308913997,12,70,-118,457,60,178,753,47,8.39
2,-4,0,2.0,-4.0,0.5688111782073975,132.74034804836094,12,68,-114,457,60,178,753,47,8.23
1,-3,0,1.0,-3.0,0.5768942832946777,129.65338406690356,12,67,-111,457,60,178,753,47,5.61
3,-4,0,3.0,-4.0,0.5900521278381348,124.67958934805648,12,64,-107,457,60,178,753,47,7.99
2,-5,0,2.0,-5.0,0.5928342342376709,119.36498649101419,12,62,-102,457,60,178,753,47,7.47
3,-3,0,3.0,-3.0,0.6023752689361572,115.24755962709145,12,59,-99,457,60,178,753,47,5.94
3,-5,0,3.0,-5.0,0.6088430881500244,109.41663493271945,12,56,-94,457,60,178,753,47,11.05
4,-4,0,4.0,-4.0,0.6168332099914551,103.94229168149026,12,52,-90,457,60,178,753,47,6.45
3,-5,0,3.0,-5.0,0.6252892017364502,98.11218069128827,12,49,-85,457,60,178,753,47,9.7
4,-4,0,4.0,-4.0,0.632878303527832,92.66067126888301,12,45,-81,457,60,178,753,47,5.96
3,-4,0,3.0,-4.0,0.6408171653747559,87.70974860299168,12,42,-77,457,60,178,753,47,6.41
3,-5,0,3.0,-5.0,0.6488182544708252,81.88406438373708,12,39,-72,457,60,178,753,47,8.17
3,-3,0,3.0,-3.0,0.6568303108215332,77.82673062643708,12,36,-69,457,60,178,753,47,4.6
4,-5,0,4.0,-5.0,0.6651811599731445,71.55417527999327,12,32,-64,457,60,178,753,47,5.95
4,-5,0,4.0,-5.0,0.672816276550293,65.30696746902278,12,28,-59,457,60,178,753,47,5.53
4,-4,0,4.0,-4.0,0.6808202266693115,60.00833275470999,12,24,-55,457,60,178,753,47,4.25
3,-4,0,3.0,-4.0,0.6888523101806641,55.154328932550705,12,21,-51,457,60,178,753,47,4.46
2,-4,0,2.0,-4.0,0.6968340873718262,50.695167422546305,12,19,-47,457,60,178,753,47,5.72
3,-4,0,3.0,-4.0,0.704808235168457,45.880278987817846,12,16,-43,457,60,178,753,47,3.9
3,-3,0,3.0,-3.0,0.7131862640380859,42.05948168962618,12,13,-40,457,60,178,753,47,2.74
3,-4,0,3.0,-4.0,0.7211241722106934,37.36308338453881,12,10,-36,457,60,178,753,47,3.12
2,-5,0,2.0,-5.0,0.7288162708282471,32.01562118716424,12,8,-31,457,60,178,753,47,4.52
2,-3,0,2.0,-3.0,0.7371222972869873,28.635642126552707,12,6,-28,457,60,178,753,47,2.45
2,-4,0,2.0,-4.0,0.7454380989074707,24.331050121192877,12,4,-24,457,60,178,753,47,2.73
1,-3,0,1.0,-3.0,0.7547402381896973,21.213203435596427,12,3,-21,457,60,178,753,47,3.14
1,-3,0,1.0,-3.0,0.761101245880127,18.110770276274835,12,2,-18,457,60,178,753,47,2.75
1,-4,0,1.0,-4.0,0.7688403129577637,14.035668847618199,12,1,-14,457,60,178,753,47,2.83
1,-2,0,1.0,-2.0,0.7782461643218994,12.0,12,0,-12,457,60,178,753,47,1.21
0,-2,0,-0.0,-2.0,0.7848532199859619,10.0,12,0,-10,457,60,178,753,47,7.18
1,-1,0,1.0,-1.0,0.793377161026001,9.055385138137417,12,-1,-9,457,60,178,753,47,0.13
0,0,1,-0.0,-0.0,0.8308391571044922,9.055385138137417,12,-1,-9,457,60,178,753,47,29.6
0,0,0,-0.0,-0.0,0.08724212646484375,1554.154754199208,13,1359,754,1817,823,458,69,52,261.56
0,1,0,-0.0,1.0,0.15725302696228027,1553.6698490992223,13,1359,753,1817,823,458,69,52,3.04
0,4,0,-0.0,4.0,0.16634297370910645,1551.7351578152761,13,1359,749,1817,823,458,69,52,9.8
0,4,0,-0.0,4.0,0.17326998710632324,1549.8083752515986,13,1359,745,1817,823,458,69,52,9.75
0,6,0,-0.0,6.0,0.1812591552734375,1546.9330948686825,13,1359,739,1817,823,458,69,52,13.96
0,7,0,-0.0,7.0,0.18966412544250488,1543.6013086286239,13,1359,732,1817,823,458,69,52,15.92
1,8,0,1.0,8.0,0.1972510814666748,1538.94119445806,13,1358,724,1817,823,458,69,52,21.64
3,10,0,3.0,10.0,0.20526814460754395,1531.60732565498,13,1355,714,1817,823,458,69,52,32.29
3,10,0,3.0,10.0,0.21325016021728516,1524.3096798223123,13,1352,704,1817,823,458,69,52,32.07
5,10,0,5.0,10.0,0.22125697135925293,1515.2706028957336,13,1347,694,1817,823,458,69,52,38.58
7,12,0,7.0,12.0,0.22945809364318848,1503.5704173732602,13,1340,682,1817,823,458,69,52,47.46
8,12,0,8.0,12.0,0.23743295669555664,1491.0144197827196,13,1332,670,1817,823,458,69,52,50.08
14,13,0,14.0,13.0,0.24776601791381836,1472.675456439741,13,1318,657,1817,823,458,69,52,66.94
20,16,0,20.0,16.0,0.2535400390625,1447.6480925970925,13,1298,641,1817,823,458,69,52,82.42
25,16,0,25.0,16.0,0.26128101348876953,1418.1516138974705,13,1273,625,1817,823,458,69,52,91.33
30,17,0,30.0,17.0,0.27074313163757324,1383.7315491091472,13,1243,608,1817,823,458,69,52,99.58
30,17,0,30.0,17.0,0.27730298042297363,1349.3146408454922,13,1213,591,1817,823,458,69,52,98.22
32,17,0,32.0,17.0,0.28552794456481934,1313.1020523934917,13,1181,574,1817,823,458,69,52,100.26
35,17,0,35.0,17.0,0.2937591075897217,1274.1919007747617,13,1146,557,1817,823,458,69,52,104.47
35,18,0,35.0,18.0,0.3012380599975586,1234.8449295356886,13,1111,539,1817,823,458,69,52,101.97
36,18,0,36.0,18.0,0.3092930316925049,1194.5986773808181,13,1075,521,1817,823,458,69,52,101.9
37,18,0,37.0,18.0,0.3172590732574463,1153.4526431544557,13,1038,503,1817,823,458,69,52,101.96
33,17,0,33.0,17.0,0.3252711296081543,1116.3426893208018,13,1005,486,1817,823,458,69,52,93.46
34,18,0,34.0,18.0,0.33333802223205566,1077.8984182194536,13,971,468,1817,823,458,69,52,93.07
33,16,0,33.0,16.0,0.3413410186767578,1041.224279394214,13,938,452,1817,823,458,69,52,90.67
30,16,0,30.0,16.0,0.3492400646209717,1007.2536919763561,13,908,436,1817,823,458,69,52,83.56
29,16,0,29.0,16.0,0.35765910148620605,974.1873536440513,13,879,420,1817,823,458,69,52,80.39
28,17,0,28.0,17.0,0.36528801918029785,941.5997026337678,13,851,403,1817,823,458,69,52,77.5
30,16,0,30.0,16.0,0.373258113861084,907.6397963950236,13,821,387,1817,823,458,69,52,78.61
30,16,0,30.0,16.0,0.38140296936035156,873.6830088767894,13,791,371,1817,823,458,69,52,76.87
32,15,0,32.0,15.0,0.39534902572631836,838.3418157291213,13,759,356,1817,823,458,69,52,79.07
33,15,0,33.0,15.0,0.39761805534362793,802.0953808619022,13,726,341,1817,823,458,69,52,77.24
31,12,0,31.0,12.0,0.40703797340393066,768.938228988519,13,695,329,1817,823,458,69,52,70.02
29,13,0,29.0,13.0,0.4132730960845947,737.1648390963855,13,666,316,1817,823,458,69,52,67.95
28,11,0,28.0,11.0,0.42125606536865234,707.1555698712979,13,638,305,1817,823,458,69,52,62.9
25,10,0,25.0,10.0,0.4299590587615967,680.2896441957646,13,613,295,1817,823,458,69,52,57.58
23,9,0,23.0,9.0,0.43723607063293457,655.6645483782085,13,590,286,1817,823,458,69,52,53.22
22,9,0,22.0,9.0,0.44525814056396484,631.9438266175246,13,568,277,1817,823,458,69,52,51.07
22,9,0,22.0,9.0,0.45327210426330566,608.2269313340211,13,546,268,1817,823,458,69,52,49.87
21,8,0,21.0,8.0,0.4612400531768799,585.8540773947042,13,525,260,1817,823,458,69,52,46.57
21,10,0,21.0,10.0,0.46925806999206543,562.59754709739,13,504,250,1817,823,458,69,52,48.48
20,8,0,20.0,8.0,0.47728800773620605,541.1284505549492,13,484,242,1817,823,458,69,52,43.39
18,8,0,18.0,8.0,0.4852430820465088,521.451819442602,13,466,234,1817,823,458,69,52,40.78
17,7,0,17.0,7.0,0.4932730197906494,503.12026395286443,13,449,227,1817,823,458,69,52,37.55
15,7,0,15.0,7.0,0.5016591548919678,486.5757906020397,13,434,220,1817,823,458,69,52,35.37
14,7,0,14.0,7.0,0.5113730430603027,470.9235606762524,13,420,213,1817,823,458,69,52,34.74
14,7,0,14.0,7.0,0.5172760486602783,455.27134765983243,13,406,206,1817,823,458,69,52,34.07
13,5,0,13.0,5.0,0.5253219604492188,441.41816908686485,13,393,201,1817,823,458,69,52,28.41
13,6,0,13.0,6.0,0.5346381664276123,427.1123973850443,13,380,195,1817,823,458,69,52,29.57
14,6,0,14.0,6.0,0.5417220592498779,411.91868129522845,13,366,189,1817,823,458,69,52,29.47
14,5,0,14.0,5.0,0.5495109558105469,397.1901307938051,13,352,184,1817,823,458,69,52,27.4
15,6,0,15.0,6.0,0.5587170124053955,381.1207157843824,13,337,178,1817,823,458,69,52,28.67
13,5,0,13.0,5.0,0.5657451152801514,367.29416004069543,13,324,173,1817,823,458,69,52,25.15
13,5,0,13.0,5.0,0.5732829570770264,353.47560028946833,13,311,168,1817,823,458,69,52,24.49
11,4,0,11.0,4.0,0.5812489986419678,341.90057034172963,13,300,164,1817,823,458,69,52,21.06
10,4,0,10.0,4.0,0.5893139839172363,331.2099032335839,13,290,160,1817,823,458,69,52,19.82
9,4,0,9.0,4.0,0.5985291004180908,321.39850653044425,13,281,156,1817,823,458,69,52,18.79
8,4,0,8.0,4.0,0.6053290367126465,312.4627977855924,13,273,152,1817,823,458,69,52,18.2
9,4,0,9.0,4.0,0.6132831573486328,302.65491900843114,13,264,148,1817,823,458,69,52,18.08
9,4,0,9.0,4.0,0.6225030422210693,292.8497908484826,13,255,144,1817,823,458,69,52,17.69
7,3,0,7.0,3.0,0.629263162612915,285.2805636562014,13,248,141,1817,823,458,69,52,14.54
9,5,0,9.0,5.0,0.6372621059417725,274.98545416076104,13,239,136,1817,823,458,69,52,19.82
10,4,0,10.0,4.0,0.6452450752258301,264.31988196123274,13,229,132,1817,823,458,69,52,17.07
10,5,0,10.0,5.0,0.6535329818725586,253.16002844051033,13,219,127,1817,823,458,69,52,18.18
10,6,0,10.0,6.0,0.6612999439239502,241.49948240110163,13,209,121,1817,823,458,69,52,19.58
10,6,0,10.0,6.0,0.6695530414581299,229.83907413666634,13,199,115,1817,823,458,69,52,19.02
9,6,0,9.0,6.0,0.6773190498352051,219.04565734111233,13,190,109,1817,823,458,69,52,16.28
8,5,0,8.0,5.0,0.6852591037750244,209.61870145576228,13,182,104,1817,823,458,69,52,15.25
8,5,0,8.0,5.0,0.6941490173339844,200.19240744843447,13,174,99,1817,823,458,69,52,14.83
6,4,0,6.0,4.0,0.7013039588928223,193.0,13,168,95,1817,823,458,69,52,11.87
8,5,0,8.0,5.0,0.7093601226806641,183.5755975068582,13,160,90,1817,823,458,69,52,14.03
9,6,0,9.0,6.0,0.718264102935791,172.7917822120022,13,151,84,1817,823,458,69,52,13.97
9,6,0,9.0,6.0,0.7253129482269287,162.01234520862909,13,142,78,1817,823,458,69,52,13.38
9,6,0,9.0,6.0,0.7345240116119385,151.23822268196622,13,133,72,1817,823,458,69,52,12.76
11,6,0,11.0,6.0,0.7419919967651367,138.70832707519762,13,122,66,1817,823,458,69,52,16.14
10,5,0,10.0,5.0,0.7493009567260742,127.534309109353,13,112,61,1817,823,458,69,52,12.99
11,7,0,11.0,7.0,0.7577431201934814,114.5294721894762,13,101,54,1817,823,458,69,52,12.31
12,6,0,12.0,6.0,0.7667360305786133,101.11874208078342,13,89,48,1817,823,458,69,52,12.75
13,6,0,13.0,6.0,0.7733030319213867,86.83317338436964,13,76,42,1817,823,458,69,52,11.12
13,7,0,13.0,7.0,0.7813479900360107,72.069410986909,13,63,35,1817,823,458,69,52,12.2
11,5,0,11.0,5.0,0.7894959449768066,60.03332407921454,13,52,30,1817,823,458,69,52,8.1
11,5,0,11.0,5.0,0.7972390651702881,48.02082881417188,13,41,25,1817,823,458,69,52,6.95
9,4,0,9.0,4.0,0.8053491115570068,38.27531841800928,13,32,21,1817,823,458,69,52,5.31
9,4,0,9.0,4.0,0.8142399787902832,28.600699292150182,13,23,17,1817,823,458,69,52,4.2
9,4,0,9.0,4.0,0.8212680816650391,19.1049731745428,13,14,13,1817,823,458,69,52,2.83
11,5,0,11.0,5.0,0.8308451175689697,8.54400374531753,13,3,8,1817,823,458,69,52,0.65
13,5,0,13.0,5.0,0.8372459411621094,10.44030650891055,13,-10,3,1817,823,458,69,52,-3.05
14,5,0,14.0,5.0,0.8452630043029785,24.08318915758459,13,-24,-2,1817,823,458,69,52,-1.31
14,5,0,14.0,5.0,0.85402512550354,38.63935817272331,13,-38,-7,1817,823,458,69,52,0.49
13,5,0,13.0,5.0,0.8612880706787109,52.392747589718944,13,-51,-12,1817,823,458,69,52,1.37
11,4,0,11.0,4.0,0.8692910671234131,64.03124237432849,13,-62,-16,1817,823,458,69,52,2.37
8,3,0,8.0,3.0,0.8839061260223389,72.53275122315436,13,-70,-19,1817,823,458,69,52,2.88
6,2,0,6.0,2.0,0.8852579593658447,78.84795495128583,13,-76,-21,1817,823,458,69,52,3.97
4,2,0,4.0,2.0,0.8933091163635254,83.24061508662703,13,-80,-23,1817,823,458,69,52,2.62
2,1,0,2.0,1.0,0.9014520645141602,85.44003745317531,13,-82,-24,1817,823,458,69,52,3.12
1,1,0,1.0,1.0,0.9092509746551514,86.68333173107735,13,-83,-25,1817,823,458,69,52,2.1
-1,0,0,-1.0,-0.0,0.9332530498504639,85.72630868059116,13,-82,-25,1817,823,458,69,52,3.0
-1,1,0,-1.0,1.0,0.9413051605224609,85.07055894961546,13,-81,-26,1817,823,458,69,52,0.93
-1,0,0,-1.0,-0.0,0.9492709636688232,84.11896337925236,13,-80,-26,1817,823,458,69,52,2.9
-1,0,0,-1.0,-0.0,0.959705114364624,83.16850365372699,13,-79,-26,1817,823,458,69,52,2.88
-1,0,0,-1.0,-0.0,0.9652669429779053,82.21921916437786,13,-78,-26,1817,823,458,69,52,2.85
-1,0,0,-1.0,-0.0,0.9734170436859131,81.27115109311545,13,-77,-26,1817,823,458,69,52,2.83
0,0,1,-0.0,-0.0,0.9832689762115479,81.27115109311545,13,-77,-26,1817,823,458,69,52,41.47
-1,0,1,-1.0,-0.0,1.0132629871368408,80.32434251209281,13,-76,-26,1817,823,458,69,52,2.81
-2,0,1,-2.0,-0.0,1.0212500095367432,78.43468620451031,13,-74,-26,1817,823,458,69,52,3.21
-1,0,1,-1.0,-0.0,1.0292589664459229,77.4919350642375,13,-73,-26,1817,823,458,69,52,2.73
-3,-1,1,-3.0,-1.0,1.0372731685638428,74.33034373659252,13,-70,-25,1817,823,458,69,52,7.11
0,0,0,-0.0,-0.0,1.041443109512329,74.33034373659252,13,-70,-25,1817,823,458,69,52,39.41
-3,0,0,-3.0,-0.0,1.045746088027954,71.5122367151245,13,-67,-25,1817,823,458,69,52,3.44
-3,0,0,-3.0,-0.0,1.0532481670379639,68.70953354520753,13,-64,-25,1817,823,458,69,52,3.32
-1,-1,0,-1.0,-1.0,1.061290979385376,67.4166151627327,13,-63,-24,1817,823,458,69,52,2.51
-1,0,0,-1.0,-0.0,1.069256067276001,66.48308055437865,13,-62,-24,1817,823,458,69,52,2.54
-1,0,0,-1.0,-0.0,1.0775620937347412,65.55150646628954,13,-61,-24,1817,823,458,69,52,2.51
-1,2,0,-1.0,2.0,1.085252046585083,65.39113089708727,13,-60,-26,1817,823,458,69,52,0.02
0,2,0,-0.0,2.0,1.09330415725708,66.2117814289874,13,-60,-28,1817,823,458,69,52,0.96
-1,1,0,-1.0,1.0,1.1014299392700195,65.7419196555744,13,-59,-29,1817,823,458,69,52,0.55
-2,0,0,-2.0,-0.0,1.1332521438598633,63.953107821277925,13,-57,-29,1817,823,458,69,52,2.5
-3,0,0,-3.0,-0.0,1.1412770748138428,61.29437168288782,13,-54,-29,1817,823,458,69,52,2.7
-3,0,0,-3.0,-0.0,1.149259090423584,58.66856057549052,13,-51,-29,1817,823,458,69,52,2.56
-4,-1,0,-4.0,-1.0,1.157660961151123,54.70831746635972,13,-47,-28,1817,823,458,69,52,3.73
-4,-1,0,-4.0,-1.0,1.165243148803711,50.774009099144415,13,-43,-27,1817,823,458,69,52,3.49
-3,0,0,-3.0,-0.0,1.173835039138794,48.25971404805462,13,-40,-27,1817,823,458,69,52,2.09
-2,0,0,-2.0,-0.0,1.181265115737915,46.61544808322666,13,-38,-27,1817,823,458,69,52,1.78
-4,0,0,-4.0,-0.0,1.1893579959869385,43.41658669218482,13,-34,-27,1817,823,458,69,52,1.94
-3,-1,0,-3.0,-1.0,1.1989140510559082,40.45985664828782,13,-31,-26,1817,823,458,69,52,2.67
-2,0,0,-2.0,-0.0,1.2054259777069092,38.948684188300895,13,-29,-26,1817,823,458,69,52,1.36
-2,0,0,-2.0,-0.0,1.21327805519104,37.48332962798263,13,-27,-26,1817,823,458,69,52,1.25
-2,0,0,-2.0,-0.0,1.2221100330352783,36.069377593742864,13,-25,-26,1817,823,458,69,52,1.14
-3,0,0,-3.0,-0.0,1.229262113571167,34.058772731852805,13,-22,-26,1817,823,458,69,52,1.02
0,0,1,-0.0,-0.0,1.2345240116119385,34.058772731852805,13,-22,-26,1817,823,458,69,52,37.2
-2,0,1,-2.0,-0.0,1.2372541427612305,731.322774156528,14,-428,-593,1409,256,1839,849,51,4.53
-3,0,1,-3.0,-0.0,0.004988908767700195,729.5711068840377,14,-425,-593,1409,256,1839,849,51,6.27
-1,0,1,-1.0,-0.0,0.013017892837524414,728.9890259805013,14,-424,-593,1409,256,1839,849,51,2.69
-1,0,1,-1.0,-0.0,0.09300589561462402,728.4078527857865,14,-423,-593,1409,256,1839,849,51,2.68
0,0,0,-0.0,-0.0,0.1200408935546875,728.4078527857865,14,-423,-593,1409,256,1839,849,51,170.84
-1,0,0,-1.0,-0.0,0.12700796127319336,727.8275894743205,14,-422,-593,1409,256,1839,849,51,2.68
-1,0,0,-1.0,-0.0,0.22098493576049805,727.2482382240606,14,-421,-593,1409,256,1839,849,51,2.67
-3,0,0,-3.0,-0.0,0.2293379306793213,725.5156786727631,14,-418,-593,1409,256,1839,849,51,6.18
-3,0,0,-3.0,-0.0,0.2375020980834961,723.7914064148592,14,-415,-593,1409,256,1839,849,51,6.14
-4,-2,0,-4.0,-2.0,0.24633288383483887,719.8624868681518,14,-411,-591,1409,256,1839,849,51,13.34
-5,-3,0,-5.0,-3.0,0.25319790840148926,714.5488086897914,14,-406,-588,1409,256,1839,849,51,17.19
-8,-7,0,-8.0,-7.0,0.2610030174255371,704.247825697744,14,-398,-581,1409,256,1839,849,51,29.54
-9,-9,0,-9.0,-9.0,0.26923608779907227,691.740558302027,14,-389,-572,1409,256,1839,849,51,34.19
-8,-12,0,-8.0,-12.0,0.27698397636413574,677.3189795067018,14,-381,-560,1409,256,1839,849,51,40.5
-10,-14,0,-10.0,-14.0,0.28504490852355957,660.1189286787646,14,-371,-546,1409,256,1839,849,51,44.15
-11,-16,0,-11.0,-16.0,0.29329490661621094,640.7027391856539,14,-360,-530,1409,256,1839,849,51,47.89
-13,-20,0,-13.0,-20.0,0.3045361042022705,616.8541156545849,14,-347,-510,1409,256,1839,849,51,52.33
-17,-23,0,-17.0,-23.0,0.3090798854827881,588.2762956298682,14,-330,-487,1409,256,1839,849,51,55.98
-19,-23,0,-19.0,-23.0,0.3170499801635742,558.5848189845477,14,-311,-464,1409,256,1839,849,51,54.38
-21,-23,0,-21.0,-23.0,0.32500195503234863,527.807730144226,14,-290,-441,1409,256,1839,849,51,52.99
-19,-21,0,-19.0,-21.0,0.33299803733825684,499.8409747109574,14,-271,-420,1409,256,1839,849,51,48.33
-17,-19,0,-17.0,-19.0,0.34097790718078613,474.6756787533989,14,-254,-401,1409,256,1839,849,51,43.82
-13,-18,0,-13.0,-18.0,0.3489699363708496,452.5151931151041,14,-241,-383,1409,256,1839,849,51,40.46
-12,-17,0,-12.0,-17.0,0.35748291015625,431.7371885765691,14,-229,-366,1409,256,1839,849,51,37.91
-9,-16,0,-9.0,-16.0,0.3683509826660156,413.40053217188773,14,-220,-350,1409,256,1839,849,51,34.27
-7,-15,0,-7.0,-15.0,0.37332987785339355,396.9811078628302,14,-213,-335,1409,256,1839,849,51,29.95
-6,-16,0,-6.0,-16.0,0.3843379020690918,380.27621540138426,14,-207,-319,1409,256,1839,849,51,28.79
-5,-16,0,-5.0,-16.0,0.38941287994384766,364.1606788218629,14,-202,-303,1409,256,1839,849,51,26.94
-3,-15,0,-3.0,-15.0,0.3972599506378174,350.06427981157975,14,-199,-288,1409,256,1839,849,51,23.41
-5,-15,0,-5.0,-15.0,0.40496110916137695,334.91043578843585,14,-194,-273,1409,256,1839,849,51,24.37
-4,-14,0,-4.0,-14.0,0.41319799423217773,321.21799451462863,14,-190,-259,1409,256,1839,849,51,21.83
-4,-12,0,-4.0,-12.0,0.420989990234375,309.2005821469293,14,-186,-247,1409,256,1839,849,51,19.52
-3,-11,0,-3.0,-11.0,0.43116307258605957,298.63857754817946,14,-183,-236,1409,256,1839,849,51,17.13
-3,-8,0,-3.0,-8.0,0.43697404861450195,290.4892424858449,14,-180,-228,1409,256,1839,849,51,14.25
-4,-9,0,-4.0,-9.0,0.44536900520324707,280.95729212818094,14,-176,-219,1409,256,1839,849,51,15.85
-4,-8,0,-4.0,-8.0,0.45298194885253906,272.2223356008834,14,-172,-211,1409,256,1839,849,51,14.84
-3,-7,0,-3.0,-7.0,0.46100687980651855,264.90941848111027,14,-169,-204,1409,256,1839,849,51,12.56
-3,-6,0,-3.0,-6.0,0.4691019058227539,258.37956575549856,14,-166,-198,1409,256,1839,849,51,11.71
-5,-6,0,-5.0,-6.0,0.47695493698120117,250.56935167733502,14,-161,-192,1409,256,1839,849,51,16.87
-4,-7,0,-4.0,-7.0,0.4849860668182373,242.63965051079347,14,-157,-185,1409,256,1839,849,51,13.18
-5,-7,0,-5.0,-7.0,0.4930419921875,234.0683660813652,14,-152,-178,1409,256,1839,849,51,14.57
-6,-6,0,-6.0,-6.0,0.5009610652923584,225.61028345356956,14,-146,-172,1409,256,1839,849,51,14.22
-6,-7,0,-6.0,-7.0,0.5091009140014648,216.390850083824,14,-140,-165,1409,256,1839,849,51,17.05
-7,-7,0,-7.0,-7.0,0.517021894454956,206.52602741543257,14,-133,-158,1409,256,1839,849,51,14.79
-7,-8,0,-7.0,-8.0,0.5249619483947754,195.8979326077741,14,-126,-150,1409,256,1839,849,51,16.61
-6,-5,0,-6.0,-5.0,0.5329620838165283,188.2153022471871,14,-120,-145,1409,256,1839,849,51,11.1
-6,-7,0,-6.0,-7.0,0.5410900115966797,178.99720668211557,14,-114,-138,1409,256,1839,849,51,14.78
-5,-5,0,-5.0,-5.0,0.5493330955505371,171.95929750961417,14,-109,-133,1409,256,1839,849,51,10.8
-5,-4,0,-5.0,-4.0,0.5606660842895508,165.7015389186232,14,-104,-129,1409,256,1839,849,51,8.88
-5,-3,0,-5.0,-3.0,0.5649740695953369,160.2404443328837,14,-99,-126,1409,256,1839,849,51,7.32
-5,-4,0,-5.0,-4.0,0.5734639167785645,154.01298646542764,14,-94,-122,1409,256,1839,849,51,8.36
-5,-5,0,-5.0,-5.0,0.5809729099273682,147.00340132119393,14,-89,-117,1409,256,1839,849,51,9.52
-6,-4,0,-6.0,-4.0,0.5892078876495361,140.2069898400219,14,-83,-113,1409,256,1839,849,51,7.81
-7,-5,0,-7.0,-5.0,0.5970499515533447,132.06059215375342,14,-76,-108,1409,256,1839,849,51,8.49
-7,-4,0,-7.0,-4.0,0.6113579273223877,124.80785231707178,14,-69,-104,1409,256,1839,849,51,7.15
-7,-5,0,-7.0,-5.0,0.6129899024963379,116.81181447096864,14,-62,-99,1409,256,1839,849,51,7.55
-6,-5,0,-6.0,-5.0,0.6232450008392334,109.41663493271945,14,-56,-94,1409,256,1839,849,51,7.09
-4,-3,0,-4.0,-3.0,0.6289849281311035,104.80935072788114,14,-52,-91,1409,256,1839,849,51,5.02
-5,-4,0,-5.0,-4.0,0.6373960971832275,98.88377015466189,14,-47,-87,1409,256,1839,849,51,5.62
-5,-5,0,-5.0,-5.0,0.6457240581512451,92.13034245024816,14,-42,-82,1409,256,1839,849,51,6.17
-5,-5,0,-5.0,-5.0,0.6529700756072998,85.42833253669417,14,-37,-77,1409,256,1839,849,51,5.77
-4,-5,0,-4.0,-5.0,0.6613509654998779,79.20227269466452,14,-33,-72,1409,256,1839,849,51,5.76
-3,-4,0,-3.0,-4.0,0.6689929962158203,74.32361670424818,14,-30,-68,1409,256,1839,849,51,5.08
-3,-3,0,-3.0,-3.0,0.6769731044769287,70.3846574190711,14,-27,-65,1409,256,1839,849,51,3.79
-2,-3,0,-2.0,-3.0,0.685034990310669,66.85057965343307,14,-25,-62,1409,256,1839,849,51,4.44
-2,-2,0,-2.0,-2.0,0.693397045135498,64.25729530566937,14,-23,-60,1409,256,1839,849,51,3.0
-2,-2,0,-2.0,-2.0,0.7009611129760742,61.68468205316454,14,-21,-58,1409,256,1839,849,51,2.88
-2,-2,0,-2.0,-2.0,0.7091100215911865,59.135437767890075,14,-19,-56,1409,256,1839,849,51,2.75
-2,-2,0,-2.0,-2.0,0.7234768867492676,56.61271941887264,14,-17,-54,1409,256,1839,849,51,2.62
-3,-3,0,-3.0,-3.0,0.7249650955200195,52.88667128870941,14,-14,-51,1409,256,1839,849,51,2.8
-3,-3,0,-3.0,-3.0,0.7408239841461182,49.24428900898052,14,-11,-48,1409,256,1839,849,51,2.54
-2,-1,0,-2.0,-1.0,0.7412168979644775,47.853944456021594,14,-9,-47,1409,256,1839,849,51,1.13
-3,-3,0,-3.0,-3.0,0.7489759922027588,44.40720662234904,14,-6,-44,1409,256,1839,849,51,2.1
-2,-3,0,-2.0,-3.0,0.7570691108703613,41.19465984809196,14,-4,-41,1409,256,1839,849,51,2.38
-2,-2,0,-2.0,-2.0,0.7650339603424072,39.05124837953327,14,-2,-39,1409,256,1839,849,51,1.47
-2,-2,0,-2.0,-2.0,0.77298903465271,37.0,14,0,-37,1409,256,1839,849,51,1.29
-2,-3,0,-2.0,-3.0,0.7812850475311279,34.058772731852805,14,2,-34,1409,256,1839,849,51,1.67
-2,-2,0,-2.0,-2.0,0.789452075958252,32.2490309931942,14,4,-32,1409,256,1839,849,51,0.89
-3,-2,0,-3.0,-2.0,0.7969539165496826,30.805843601498726,14,7,-30,1409,256,1839,849,51,0.22
-2,-2,0,-2.0,-2.0,0.8056418895721436,29.410882339705484,14,9,-28,1409,256,1839,849,51,0.43
-2,-2,0,-2.0,-2.0,0.8136439323425293,28.231188426986208,14,11,-26,1409,256,1839,849,51,0.22
-1,-2,0,-1.0,-2.0,0.8209719657897949,26.832815729997478,14,12,-24,1409,256,1839,849,51,0.69
-2,-1,0,-2.0,-1.0,0.828995943069458,26.92582403567252,14,14,-23,1409,256,1839,849,51,2.73
-1,-1,0,-1.0,-1.0,0.8369851112365723,26.627053911388696,14,15,-22,1409,256,1839,849,51,0.01
0,-1,0,-0.0,-1.0,0.8449928760528564,25.80697580112788,14,15,-21,1409,256,1839,849,51,1.35
0,0,1,-0.0,-0.0,0.8519949913024902,25.80697580112788,14,15,-21,1409,256,1839,849,51,34.67
-1,-1,1,-1.0,-1.0,0.8535048961639404,25.612496949731394,14,16,-20,1409,256,1839,849,51,9.9
0,0,0,-0.0,-0.0,0.07120633125305176,871.1836775330447,15,-840,231,553,507,1393,276,45,189.93
-1,0,0,-1.0,-0.0,0.0932002067565918,870.219512536923,15,-839,231,553,507,1393,276,45,6.44
-1,0,0,-1.0,-0.0,0.10122323036193848,869.2554285133916,15,-838,231,553,507,1393,276,45,6.43
-1,0,0,-1.0,-0.0,0.10934829711914062,868.2914257321675,15,-837,231,553,507,1393,276,45,6.43
-2,0,0,-2.0,-0.0,0.1172323226928711,866.363664981398,15,-835,231,553,507,1393,276,45,10.08
-3,0,0,-3.0,-0.0,0.12523531913757324,863.4726399834566,15,-832,231,553,507,1393,276,45,13.56
-3,0,0,-3.0,-0.0,0.1337902545928955,860.5823609626217,15,-829,231,553,507,1393,276,45,13.53
-3,1,0,-3.0,1.0,0.14220428466796875,857.4240491145557,15,-826,230,553,507,1393,276,45,16.56
-5,2,0,-5.0,2.0,0.1492452621459961,852.0710064308021,15,-821,228,553,507,1393,276,45,22.94
-6,2,0,-6.0,2.0,0.15723633766174316,845.7546925675317,15,-815,226,553,507,1393,276,45,26.76
-8,2,0,-8.0,2.0,0.16521739959716797,837.511193955042,15,-807,224,553,507,1393,276,45,32.97
-8,0,0,-8.0,-0.0,0.17325234413146973,829.805398873736,15,-799,224,553,507,1393,276,45,28.49
-6,-1,0,-6.0,-1.0,0.1812744140625,824.3021290764691,15,-793,225,553,507,1393,276,45,21.15
-8,-3,0,-8.0,-3.0,0.19502043724060059,817.4405177136744,15,-785,228,553,507,1393,276,45,24.62
-11,-3,0,-11.0,-3.0,0.19723033905029297,807.7357241078297,15,-774,231,553,507,1393,276,45,32.5
-16,0,0,-16.0,-0.0,0.2063002586364746,792.4171881023278,15,-758,231,553,507,1393,276,45,46.19
-20,0,0,-20.0,-0.0,0.21321630477905273,773.3078300392413,15,-738,231,553,507,1393,276,45,52.96
-25,4,0,-25.0,4.0,0.22127032279968262,748.2633226344855,15,-713,227,553,507,1393,276,45,62.75
-30,8,0,-30.0,8.0,0.23290324211120605,717.2516991963142,15,-683,219,553,507,1393,276,45,70.69
-28,8,0,-28.0,8.0,0.2372584342956543,688.1467866669145,15,-655,211,553,507,1393,276,45,67.02
-29,11,0,-29.0,11.0,0.24533843994140625,657.1727322401623,15,-626,200,553,507,1393,276,45,66.97
-24,9,0,-24.0,9.0,0.256453275680542,631.5734319934619,15,-602,191,553,507,1393,276,45,58.71
-22,9,0,-22.0,9.0,0.26120734214782715,607.8848575182639,15,-580,182,553,507,1393,276,45,54.22
-19,7,0,-19.0,7.0,0.26920223236083984,587.6614671730656,15,-561,175,553,507,1393,276,45,48.78
-18,7,0,-18.0,7.0,0.2771952152252197,568.3951090570713,15,-543,168,553,507,1393,276,45,46.0
-16,7,0,-16.0,7.0,0.28608226776123047,551.0444628158422,15,-527,161,553,507,1393,276,45,41.6
-18,8,0,-18.0,8.0,0.2952563762664795,531.4978833447975,15,-509,153,553,507,1393,276,45,43.83
-18,8,0,-18.0,8.0,0.3012664318084717,511.9628892800727,15,-491,145,553,507,1393,276,45,42.76
-17,7,0,-17.0,7.0,0.3099193572998047,493.68005833738107,15,-474,138,553,507,1393,276,45,40.32
-18,7,0,-18.0,7.0,0.3193073272705078,474.4438849853584,15,-456,131,553,507,1393,276,45,40.84
-18,7,0,-18.0,7.0,0.32530736923217773,455.2142352782918,15,-438,124,553,507,1393,276,45,39.73
-16,6,0,-16.0,6.0,0.33327722549438477,438.1871746183359,15,-422,118,553,507,1393,276,45,36.03
-17,7,0,-17.0,7.0,0.34237027168273926,419.935709365136,15,-405,111,553,507,1393,276,45,36.21
-17,5,0,-17.0,5.0,0.3492012023925781,402.21884590357024,15,-388,106,553,507,1393,276,45,36.65
-18,6,0,-18.0,6.0,0.3572053909301758,383.275357934736,15,-370,100,553,507,1393,276,45,35.92
-20,6,0,-20.0,6.0,0.3667564392089844,362.4030904945486,15,-350,94,553,507,1393,276,45,37.54
-21,6,0,-21.0,6.0,0.3732154369354248,340.5657058483722,15,-329,88,553,507,1393,276,45,37.59
-21,6,0,-21.0,6.0,0.38126420974731445,318.7287247801804,15,-308,82,553,507,1393,276,45,36.03
-20,6,0,-20.0,6.0,0.38930726051330566,297.85902705810344,15,-288,76,553,507,1393,276,45,33.06
-20,6,0,-20.0,6.0,0.3989074230194092,276.99097458220547,15,-268,70,553,507,1393,276,45,31.5
-15,5,0,-15.0,5.0,0.40523838996887207,261.21638539724114,15,-253,65,553,507,1393,276,45,25.0
-15,4,0,-15.0,4.0,0.41354942321777344,245.69289774024807,15,-238,61,553,507,1393,276,45,25.77
-12,4,0,-12.0,4.0,0.4211874008178711,233.0772404161333,15,-226,57,553,507,1393,276,45,20.22
-12,3,0,-12.0,3.0,0.42919421195983887,220.70795182774907,15,-214,54,553,507,1393,276,45,21.95
-9,2,0,-9.0,2.0,0.43926024436950684,211.49231664530984,15,-205,52,553,507,1393,276,45,16.78
-10,2,0,-10.0,2.0,0.4452402591705322,201.30822139197394,15,-195,50,553,507,1393,276,45,16.65
-8,2,0,-8.0,2.0,0.4532303810119629,193.06216615380654,15,-187,48,553,507,1393,276,45,16.18
-8,2,0,-8.0,2.0,0.4630413055419922,184.81612483763422,15,-179,46,553,507,1393,276,45,15.84
-8,2,0,-8.0,2.0,0.46951842308044434,176.57009939398006,15,-171,44,553,507,1393,276,45,15.48
-9,2,0,-9.0,2.0,0.47724127769470215,167.35590817177624,15,-162,42,553,507,1393,276,45,14.65
-9,1,0,-9.0,1.0,0.4856903553009033,158.39823231336896,15,-153,41,553,507,1393,276,45,12.22
-7,1,0,-7.0,1.0,0.4932522773742676,151.38031576133008,15,-146,40,553,507,1393,276,45,10.53
-7,1,0,-7.0,1.0,0.5012152194976807,144.3675863897433,15,-139,39,553,507,1393,276,45,10.2
-7,2,0,-7.0,2.0,0.5091993808746338,137.0875632579411,15,-132,37,553,507,1393,276,45,13.2
-8,0,0,-8.0,-0.0,0.5172262191772461,129.40247292845683,15,-124,37,553,507,1393,276,45,9.02
-5,1,0,-5.0,1.0,0.5252213478088379,124.32618388738553,15,-119,36,553,507,1393,276,45,8.34
-5,0,0,-5.0,-0.0,0.5333452224731445,119.54915307102765,15,-114,36,553,507,1393,276,45,6.41
-4,1,0,-4.0,1.0,0.541196346282959,115.43396380615195,15,-110,35,553,507,1393,276,45,7.87
-4,1,0,-4.0,1.0,0.5492773056030273,111.31936040060597,15,-106,34,553,507,1393,276,45,7.72
-7,1,0,-7.0,1.0,0.5615112781524658,104.35516278555652,15,-99,33,553,507,1393,276,45,8.11
-7,2,0,-7.0,2.0,0.5652272701263428,97.082439194738,15,-92,31,553,507,1393,276,45,9.71
-8,2,0,-8.0,2.0,0.5738482475280762,88.86506625215557,15,-84,29,553,507,1393,276,45,9.07
-8,2,0,-8.0,2.0,0.5812492370605469,80.65358020571685,15,-76,27,553,507,1393,276,45,8.51
-6,1,0,-6.0,1.0,0.5895442962646484,74.67261881037788,15,-70,26,553,507,1393,276,45,6.23
-6,2,0,-6.0,2.0,0.5985634326934814,68.35202996254024,15,-64,24,553,507,1393,276,45,8.21
-7,2,0,-7.0,2.0,0.6052372455596924,61.09828148156051,15,-57,22,553,507,1393,276,45,7.17
-7,2,0,-7.0,2.0,0.6135342121124268,53.85164807134504,15,-50,20,553,507,1393,276,45,6.62
-6,2,0,-6.0,2.0,0.6230044364929199,47.53945729601885,15,-44,18,553,507,1393,276,45,6.53
-4,2,0,-4.0,2.0,0.629277229309082,43.08131845707603,15,-40,16,553,507,1393,276,45,5.45
-4,2,0,-4.0,2.0,0.6372363567352295,38.62641583165593,15,-36,14,553,507,1393,276,45,5.13
-4,2,0,-4.0,2.0,0.6462783813476562,34.17601498127012,15,-32,12,553,507,1393,276,45,4.77
-6,2,0,-6.0,2.0,0.6535212993621826,27.85677655436824,15,-26,10,553,507,1393,276,45,5.95
-7,3,0,-7.0,3.0,0.6612253189086914,20.248456731316587,15,-19,7,553,507,1393,276,45,5.51
-6,2,0,-6.0,2.0,0.6694753170013428,13.92838827718412,15,-13,5,553,507,1393,276,45,4.97
-6,2,0,-6.0,2.0,0.6772463321685791,7.615773105863909,15,-7,3,553,507,1393,276,45,3.53
-5,2,0,-5.0,2.0,0.6852352619171143,2.23606797749979,15,-2,1,553,507,1393,276,45,2.64
-3,1,0,-3.0,1.0,0.7001402378082275,1.0,15,1,0,553,507,1393,276,45,-1.18
-2,1,0,-2.0,1.0,0.7039873600006104,3.1622776601683795,15,3,-1,553,507,1393,276,45,-0.97
0,0,1,-0.0,-0.0,0.7522222995758057,3.1622776601683795,15,3,-1,553,507,1393,276,45,27.86
0,0,0,-0.0,-0.0,0.09025216102600098,587.3636011875438,16,40,586,590,1094,550,508,6,149.77
-1,0,0,-1.0,-0.0,0.11339116096496582,587.4325493194942,16,41,586,590,1094,550,508,6,101.43
-1,0,0,-1.0,-0.0,0.12122416496276855,587.5031914806932,16,42,586,590,1094,550,508,6,100.72
-2,0,0,-2.0,-0.0,0.12920928001403809,587.6495554324873,16,44,586,590,1094,550,508,6,76.4
-1,0,0,-1.0,-0.0,0.13865208625793457,587.7252759580789,16,45,586,590,1094,550,508,6,98.64
2,0,0,2.0,-0.0,0.19323515892028809,587.5755270601389,16,43,586,590,1094,550,508,6,3.66
2,1,0,2.0,1.0,0.20238208770751953,586.4349921346782,16,41,585,590,1094,550,508,6,23.52
3,0,0,3.0,-0.0,0.20929527282714844,586.2328888760848,16,38,585,590,1094,550,508,6,4.81
3,1,0,3.0,1.0,0.2172222137451172,585.0478612899974,16,35,584,590,1094,550,508,6,24.02
3,2,0,3.0,2.0,0.22571516036987305,582.8790612125298,16,32,582,590,1094,550,508,6,38.63
4,3,0,4.0,3.0,0.23322629928588867,579.6766339951956,16,28,579,590,1094,550,508,6,50.25
3,3,0,3.0,3.0,0.2426142692565918,576.5422794557221,16,25,576,590,1094,550,508,6,49.64
3,4,0,3.0,4.0,0.24926018714904785,572.4229205753383,16,22,572,590,1094,550,508,6,58.68
2,5,0,2.0,5.0,0.25722813606262207,567.3526240355287,16,20,567,590,1094,550,508,6,66.24
3,6,0,3.0,6.0,0.2652730941772461,561.2575166534521,16,17,561,590,1094,550,508,6,71.83
4,8,0,4.0,8.0,0.27321815490722656,553.1527817881783,16,13,553,590,1094,550,508,6,80.82
4,9,0,4.0,9.0,0.2815062999725342,544.0744434358224,16,9,544,590,1094,550,508,6,83.81
6,13,0,6.0,13.0,0.2892441749572754,531.0084745086466,16,3,531,590,1094,550,508,6,93.48
6,17,0,6.0,17.0,0.297687292098999,514.0087547892546,16,-3,514,590,1094,550,508,6,98.8
5,16,0,5.0,16.0,0.3061060905456543,498.0642528830994,16,-8,498,590,1094,550,508,6,95.29
4,18,0,4.0,18.0,0.31333231925964355,480.1499765698214,16,-12,480,590,1094,550,508,6,96.17
3,18,0,3.0,18.0,0.32122111320495605,462.24344235478344,16,-15,462,590,1094,550,508,6,94.06
3,20,0,3.0,20.0,0.3292381763458252,442.36636400160444,16,-18,442,590,1094,550,508,6,93.63
3,20,0,3.0,20.0,0.3372211456298828,422.5221887664599,16,-21,422,590,1094,550,508,6,90.7
3,23,0,3.0,23.0,0.34566831588745117,399.7211528053025,16,-24,399,590,1094,550,508,6,90.01
2,23,0,2.0,23.0,0.3532092571258545,376.8978641488964,16,-26,376,590,1094,550,508,6,86.76
2,23,0,2.0,23.0,0.36159825325012207,354.1087403609236,16,-28,353,590,1094,550,508,6,83.03
2,24,0,2.0,24.0,0.3692171573638916,330.3649497147057,16,-30,329,590,1094,550,508,6,79.71
1,20,0,1.0,20.0,0.37722325325012207,310.55112300553674,16,-31,309,590,1094,550,508,6,73.8
0,18,0,-0.0,18.0,0.38524413108825684,292.6465444866896,16,-31,291,590,1094,550,508,6,69.66
1,15,0,1.0,15.0,0.3949263095855713,277.8488797889961,16,-32,276,590,1094,550,508,6,63.36
1,14,0,1.0,14.0,0.4012172222137451,264.0700664596425,16,-33,262,590,1094,550,508,6,59.84
1,13,0,1.0,13.0,0.41031908988952637,251.3105648396024,16,-34,249,590,1094,550,508,6,56.4
0,14,0,-0.0,14.0,0.4172072410583496,237.44683615495913,16,-34,235,590,1094,550,508,6,56.03
1,12,0,1.0,12.0,0.4252901077270508,225.72992712531496,16,-35,223,590,1094,550,508,6,50.76
0,11,0,-0.0,11.0,0.43324828147888184,214.8697279748825,16,-35,212,590,1094,550,508,6,48.34
0,9,0,-0.0,9.0,0.44172024726867676,205.99514557387025,16,-35,203,590,1094,550,508,6,43.69
0,8,0,-0.0,8.0,0.44921112060546875,198.11612756158948,16,-35,195,590,1094,550,508,6,40.57
-1,7,0,-1.0,7.0,0.457247257232666,191.049731745428,16,-34,188,590,1094,550,508,6,39.78
0,7,0,-0.0,7.0,0.4652271270751953,184.16568627190028,16,-34,181,590,1094,550,508,6,36.44
0,7,0,-0.0,7.0,0.4732050895690918,177.29072169744248,16,-34,174,590,1094,550,508,6,35.41
0,6,0,-0.0,6.0,0.48124122619628906,171.40595088852663,16,-34,168,590,1094,550,508,6,32.27
-1,6,0,-1.0,6.0,0.4892692565917969,165.32694880145826,16,-33,162,590,1094,550,508,6,34.06
-2,5,0,-2.0,5.0,0.4972240924835205,160.0312469488381,16,-31,157,590,1094,550,508,6,29.41
-2,5,0,-2.0,5.0,0.5054001808166504,154.74172029546526,16,-29,152,590,1094,550,508,6,28.69
-2,5,0,-2.0,5.0,0.5184171199798584,149.4590244849738,16,-27,147,590,1094,550,508,6,27.95
-2,5,0,-2.0,5.0,0.521226167678833,144.183910336764,16,-25,142,590,1094,550,508,6,27.21
-2,5,0,-2.0,5.0,0.5292162895202637,138.91724155050014,16,-23,137,590,1094,550,508,6,26.46
-2,5,0,-2.0,5.0,0.5372393131256104,133.6600164596728,16,-21,132,590,1094,550,508,6,25.7
-2,4,0,-2.0,4.0,0.5452382564544678,129.40247292845683,16,-19,128,590,1094,550,508,6,22.19
-2,4,0,-2.0,4.0,0.5534982681274414,125.15989773086265,16,-17,124,590,1094,550,508,6,21.61
-1,5,0,-1.0,5.0,0.5635592937469482,120.07081243999309,16,-16,119,590,1094,550,508,6,25.17
-3,5,0,-3.0,5.0,0.5693881511688232,114.73883387938018,16,-13,114,590,1094,550,508,6,22.41
-2,5,0,-2.0,5.0,0.5778710842132568,109.55363982999378,16,-11,109,590,1094,550,508,6,22.02
-2,5,0,-2.0,5.0,0.5864162445068359,104.38869670610895,16,-9,104,590,1094,550,508,6,21.21
-1,5,0,-1.0,5.0,0.5932130813598633,99.32270636667126,16,-8,99,590,1094,550,508,6,21.59
-2,4,0,-2.0,4.0,0.601215124130249,95.1892851112981,16,-6,95,590,1094,550,508,6,17.47
-3,5,0,-3.0,5.0,0.6101052761077881,90.0499861188218,16,-3,90,590,1094,550,508,6,18.4
-2,5,0,-2.0,5.0,0.6172511577606201,85.00588214941364,16,-1,85,590,1094,550,508,6,18.0
-2,4,0,-2.0,4.0,0.6252472400665283,81.00617260431454,16,1,81,590,1094,550,508,6,15.19
-2,4,0,-2.0,4.0,0.6335442066192627,77.05841939723393,16,3,77,590,1094,550,508,6,14.52
-2,4,0,-2.0,4.0,0.6412792205810547,73.17103251970687,16,5,73,590,1094,550,508,6,13.85
-2,3,0,-2.0,3.0,0.6492481231689453,70.34912934784623,16,7,70,590,1094,550,508,6,10.92
-1,3,0,-1.0,3.0,0.6572372913360596,67.47592163134935,16,8,67,590,1094,550,508,6,11.41
-2,4,0,-2.0,4.0,0.6652092933654785,63.788713735268246,16,10,63,590,1094,550,508,6,12.09
-1,4,0,-1.0,4.0,0.6733722686767578,60.01666435249463,16,11,59,590,1094,550,508,6,12.33
-2,5,0,-2.0,5.0,0.6812102794647217,55.54277630799526,16,13,54,590,1094,550,508,6,12.24
-1,4,0,-1.0,4.0,0.6892151832580566,51.92301994298868,16,14,50,590,1094,550,508,6,10.8
0,3,0,-0.0,3.0,0.6972172260284424,49.040799340956916,16,14,47,590,1094,550,508,6,10.09
0,4,0,-0.0,4.0,0.7052412033081055,45.221676218380054,16,14,43,590,1094,550,508,6,10.96
0,2,0,-0.0,2.0,0.7153482437133789,43.32435804486894,16,14,41,590,1094,550,508,6,7.5
0,4,0,-0.0,4.0,0.7212412357330322,39.56008088970496,16,14,37,590,1094,550,508,6,9.95
0,3,0,-0.0,3.0,0.7300901412963867,36.76955262170047,16,14,34,590,1094,550,508,6,8.17
0,3,0,-0.0,3.0,0.7372090816497803,34.0147027033899,16,14,31,590,1094,550,508,6,7.69
0,3,0,-0.0,3.0,0.7452383041381836,31.304951684997057,16,14,28,590,1094,550,508,6,7.19
1,4,0,1.0,4.0,0.7534623146057129,27.294688127912362,16,13,24,590,1094,550,508,6,9.03
0,3,0,-0.0,3.0,0.7612411975860596,24.698178070456937,16,13,21,590,1094,550,508,6,6.02
0,3,0,-0.0,3.0,0.7700161933898926,22.20360331117452,16,13,18,590,1094,550,508,6,5.41
0,3,0,-0.0,3.0,0.7774262428283691,19.849433241279208,16,13,15,590,1094,550,508,6,4.76
1,2,0,1.0,2.0,0.7853002548217773,17.69180601295413,16,12,13,590,1094,550,508,6,5.7
0,2,0,-0.0,2.0,0.7932882308959961,16.278820596099706,16,12,11,590,1094,550,508,6,3.01
0,3,0,-0.0,3.0,0.8012311458587646,14.422205101855956,16,12,8,590,1094,550,508,6,2.99
1,2,0,1.0,2.0,0.8097591400146484,12.529964086141668,16,11,6,590,1094,550,508,6,3.65
0,3,0,-0.0,3.0,0.8172461986541748,11.40175425099138,16,11,3,590,1094,550,508,6,1.19
1,2,0,1.0,2.0,0.8252100944519043,10.04987562112089,16,10,1,590,1094,550,508,6,1.9
1,2,0,1.0,2.0,0.8333621025085449,9.055385138137417,16,9,-1,590,1094,550,508,6,1.0
0,1,0,-0.0,1.0,0.8412172794342041,9.219544457292887,16,9,-2,590,1094,550,508,6,6.0
1,2,0,1.0,2.0,0.8492202758789062,8.94427190999916,16,8,-4,590,1094,550,508,6,-0.55
0,1,0,-0.0,1.0,0.8572731018066406,9.433981132056603,16,8,-5,590,1094,550,508,6,3.07
1,2,0,1.0,2.0,0.8660521507263184,9.899494936611665,16,7,-7,590,1094,550,508,6,2.37
1,1,0,1.0,1.0,0.8735930919647217,10.0,16,6,-8,590,1094,550,508,6,7.47
0,1,0,-0.0,1.0,0.8812522888183594,10.816653826391969,16,6,-9,590,1094,550,508,6,2.81
1,1,0,1.0,1.0,0.8892712593078613,11.180339887498949,16,5,-10,590,1094,550,508,6,3.68
0,1,0,-0.0,1.0,0.8972082138061523,12.083045973594572,16,5,-11,590,1094,550,508,6,3.2
0,1,0,-0.0,1.0,0.9053001403808594,13.0,16,5,-12,590,1094,550,508,6,3.37
1,0,0,1.0,-0.0,0.9132282733917236,12.649110640673518,16,4,-12,590,1094,550,508,6,0.63
1,0,0,1.0,-0.0,0.9772202968597412,12.36931687685298,16,3,-12,590,1094,550,508,6,0.4
1,0,0,1.0,-0.0,0.9852612018585205,12.165525060596439,16,2,-12,590,1094,550,508,6,0.16
-1,-1,0,-1.0,-1.0,1.0172092914581299,11.40175425099138,16,3,-11,590,1094,550,508,6,1.36
-1,-1,0,-1.0,-1.0,1.033203125,10.770329614269007,16,4,-10,590,1094,550,508,6,0.94
-1,-2,0,-1.0,-2.0,1.0412392616271973,9.433981132056603,16,5,-8,590,1094,550,508,6,1.78
0,-1,0,-0.0,-1.0,1.0492522716522217,8.602325267042627,16,5,-7,590,1094,550,508,6,2.11
0,-1,0,-0.0,-1.0,1.05721116065979,7.810249675906654,16,5,-6,590,1094,550,508,6,1.8
0,-1,0,-0.0,-1.0,1.0652391910552979,7.0710678118654755,16,5,-5,590,1094,550,508,6,1.46
-1,0,0,-1.0,-0.0,1.0812721252441406,7.810249675906654,16,6,-5,590,1094,550,508,6,2.35
0,0,1,-0.0,-0.0,1.135228157043457,7.810249675906654,16,6,-5,590,1094,550,508,6,19.23
0,0,0,-0.0,-0.0,1.239220142364502,7.810249675906654,16,6,-5,590,1094,550,508,6,19.23
1,0,0,1.0,-0.0,1.2492163181304932,7.0710678118654755,16,5,-5,590,1094,550,508,6,1.46
1,0,0,1.0,-0.0,1.273226261138916,6.4031242374328485,16,4,-5,590,1094,550,508,6,1.09
1,0,0,1.0,-0.0,1.297215223312378,5.830951894845301,16,3,-5,590,1094,550,508,6,0.67
1,0,0,1.0,-0.0,1.3132071495056152,5.385164807134504,16,2,-5,590,1094,550,508,6,0.22
1,0,0,1.0,-0.0,1.3452560901641846,5.0990195135927845,16,1,-5,590,1094,550,508,6,-0.26
0,-1,0,-0.0,-1.0,1.3534181118011475,4.123105625617661,16,1,-4,590,1094,550,508,6,2.95
1,0,0,1.0,-0.0,1.3634202480316162,4.0,16,0,-4,590,1094,550,508,6,-0.89
0,-1,0,-0.0,-1.0,1.3695073127746582,3.0,16,0,-3,590,1094,550,508,6,8.24
1,0,0,1.0,-0.0,1.3772411346435547,3.1622776601683795,16,-1,-3,590,1094,550,508,6,4.22
1,-1,0,1.0,-1.0,1.3868021965026855,2.8284271247461903,16,-2,-2,590,1094,550,508,6,-1.14
1,-1,0,1.0,-1.0,1.4012463092803955,3.1622776601683795,16,-3,-1,590,1094,550,508,6,1.9
1,0,0,1.0,-0.0,1.4111793041229248,4.123105625617661,16,-4,-1,590,1094,550,508,6,2.36
0,0,1,-0.0,-0.0,1.4202191829681396,4.123105625617661,16,-4,-1,590,1094,550,508,6,28.14
0,0,0,-0.0,-0.0,0.10812115669250488,938.3330965067789,17,662,-665,1256,430,594,1095,53,198.28
1,-1,0,1.0,-1.0,0.18816304206848145,936.9188865638263,17,661,-664,1256,430,594,1095,53,11.44
0,-2,0,-0.0,-2.0,0.19608116149902344,935.5025387458871,17,661,-662,1256,430,594,1095,53,6.08
2,-3,0,2.0,-3.0,0.20435714721679688,931.9667376038697,17,659,-659,1256,430,594,1095,53,14.91
4,-5,0,4.0,-5.0,0.21490716934204102,925.6030466674146,17,655,-654,1256,430,594,1095,53,24.06
5,-5,0,5.0,-5.0,0.22010326385498047,918.5319809347958,17,650,-649,1256,430,594,1095,53,28.85
5,-7,0,5.0,-7.0,0.22808003425598145,910.048899785061,17,645,-642,1256,430,594,1095,53,29.09
6,-9,0,6.0,-9.0,0.23606204986572266,899.4498318416653,17,639,-633,1256,430,594,1095,53,33.99
8,-9,0,8.0,-9.0,0.244218111038208,887.4328143583604,17,631,-624,1256,430,594,1095,53,38.54
9,-12,0,9.0,-12.0,0.2521030902862549,872.5984185179343,17,622,-612,1256,430,594,1095,53,43.32
11,-14,0,11.0,-14.0,0.2606842517852783,854.9415184677839,17,611,-598,1256,430,594,1095,53,48.63
17,-17,0,17.0,-17.0,0.26809024810791016,830.9013178470714,17,594,-581,1256,430,594,1095,53,61.38
23,-20,0,23.0,-20.0,0.27631616592407227,800.4761083255389,17,571,-561,1256,430,594,1095,53,67.64
25,-20,0,25.0,-20.0,0.28980326652526855,768.6332025094935,17,546,-541,1256,430,594,1095,53,67.15
31,-21,0,31.0,-21.0,0.29207825660705566,731.8640584152223,17,515,-520,1256,430,594,1095,53,70.01
33,-20,0,33.0,-20.0,0.3000812530517578,694.4955003453946,17,482,-500,1256,430,594,1095,53,68.03
32,-18,0,32.0,-18.0,0.3081040382385254,659.4118591593573,17,450,-482,1256,430,594,1095,53,63.31
31,-22,0,31.0,-22.0,0.3161001205444336,622.2226289681211,17,419,-460,1256,430,594,1095,53,63.61
31,-25,0,31.0,-25.0,0.32515716552734375,582.8970749626386,17,388,-435,1256,430,594,1095,53,63.33
28,-21,0,28.0,-21.0,0.3320901393890381,548.6310235486142,17,360,-414,1256,430,594,1095,53,56.09
23,-19,0,23.0,-19.0,0.34008216857910156,519.2244216136218,17,337,-395,1256,430,594,1095,53,49.75
22,-18,0,22.0,-18.0,0.34808826446533203,491.2779254149325,17,315,-377,1256,430,594,1095,53,46.45
18,-16,0,18.0,-16.0,0.35623812675476074,467.4719242906466,17,297,-361,1256,430,594,1095,53,40.98
17,-18,0,17.0,-18.0,0.36470723152160645,442.77420882431716,17,280,-343,1256,430,594,1095,53,41.5
16,-19,0,16.0,-19.0,0.3720881938934326,417.93779441443195,17,264,-324,1256,430,594,1095,53,41.74
14,-18,0,14.0,-18.0,0.38049912452697754,395.1404813480897,17,250,-306,1256,430,594,1095,53,38.0
15,-18,0,15.0,-18.0,0.38809823989868164,371.7109091753967,17,235,-288,1256,430,594,1095,53,37.91
13,-17,0,13.0,-17.0,0.3961200714111328,350.3212811120672,17,222,-271,1256,430,594,1095,53,33.65
13,-15,0,13.0,-15.0,0.4043302536010742,330.47995400629065,17,209,-256,1256,430,594,1095,53,31.15
12,-14,0,12.0,-14.0,0.412121057510376,312.04647089816604,17,197,-242,1256,430,594,1095,53,28.92
10,-11,0,10.0,-11.0,0.4215362071990967,297.2036338943385,17,187,-231,1256,430,594,1095,53,23.74
11,-11,0,11.0,-11.0,0.4280891418457031,281.73746644704534,17,176,-220,1256,430,594,1095,53,22.75
11,-9,0,11.0,-9.0,0.43608522415161133,267.8544380815819,17,165,-211,1256,430,594,1095,53,19.62
9,-9,0,9.0,-9.0,0.4440610408782959,255.22539058643832,17,156,-202,1256,430,594,1095,53,18.57
9,-8,0,9.0,-8.0,0.4521191120147705,243.402958075698,17,147,-194,1256,430,594,1095,53,16.7
10,-9,0,10.0,-9.0,0.46024203300476074,230.20425712831639,17,137,-185,1256,430,594,1095,53,17.3
9,-8,0,9.0,-8.0,0.4685661792755127,218.4330561064419,17,128,-177,1256,430,594,1095,53,15.38
7,-8,0,7.0,-8.0,0.4790761470794678,207.85090810482401,17,121,-169,1256,430,594,1095,53,14.95
7,-7,0,7.0,-7.0,0.4841182231903076,198.09088823063013,17,114,-162,1256,430,594,1095,53,13.09
6,-7,0,6.0,-7.0,0.4920930862426758,188.91532494744834,17,108,-155,1256,430,594,1095,53,12.94
6,-5,0,6.0,-5.0,0.5025620460510254,181.3945974939717,17,102,-150,1256,430,594,1095,53,9.88
5,-4,0,5.0,-4.0,0.5080831050872803,175.28548142958104,17,97,-146,1256,430,594,1095,53,8.33
4,-5,0,4.0,-5.0,0.5161001682281494,168.90825912311098,17,93,-141,1256,430,594,1095,53,10.0
4,-5,0,4.0,-5.0,0.525921106338501,162.53307355735325,17,89,-136,1256,430,594,1095,53,9.76
4,-5,0,4.0,-5.0,0.532095193862915,156.16017418023074,17,85,-131,1256,430,594,1095,53,9.52
5,-5,0,5.0,-5.0,0.5404551029205322,149.25146565444507,17,80,-126,1256,430,594,1095,53,8.65
4,-5,0,4.0,-5.0,0.5502381324768066,142.88806808127822,17,76,-121,1256,430,594,1095,53,8.92
3,-5,0,3.0,-5.0,0.5561010837554932,137.05838172107534,17,73,-116,1256,430,594,1095,53,10.25
3,-3,0,3.0,-3.0,0.56479811668396,132.92479076530458,17,70,-113,1256,430,594,1095,53,6.07
2,-4,0,2.0,-4.0,0.5728271007537842,128.47178678604885,17,68,-109,1256,430,594,1095,53,7.39
3,-3,0,3.0,-3.0,0.5800931453704834,124.34226956268733,17,65,-106,1256,430,594,1095,53,5.85
1,-3,0,1.0,-3.0,0.5881142616271973,121.26417442921878,17,64,-103,1256,430,594,1095,53,5.06
2,-3,0,2.0,-3.0,0.5960662364959717,117.66052864066182,17,62,-100,1256,430,594,1095,53,7.76
1,-2,0,1.0,-2.0,0.60408616065979,115.43396380615195,17,61,-98,1256,430,594,1095,53,5.59
2,-2,0,2.0,-2.0,0.6121671199798584,112.6809655620682,17,59,-96,1256,430,594,1095,53,4.69
2,-1,0,2.0,-1.0,0.6234440803527832,110.78808600206071,17,57,-95,1256,430,594,1095,53,2.86
1,-2,0,1.0,-2.0,0.6281371116638184,108.55873986004075,17,56,-93,1256,430,594,1095,53,5.71
4,-3,0,4.0,-3.0,0.6362922191619873,103.94229168149026,17,52,-90,1256,430,594,1095,53,4.9
4,-3,0,4.0,-3.0,0.6466231346130371,99.36297097007517,17,48,-87,1256,430,594,1095,53,4.69
2,-3,0,2.0,-3.0,0.6521022319793701,95.77055915050303,17,46,-84,1256,430,594,1095,53,6.2
3,-3,0,3.0,-3.0,0.6609361171722412,91.706052144883,17,43,-81,1256,430,594,1095,53,4.71
1,-2,0,1.0,-2.0,0.6680600643157959,89.47066558375433,17,42,-79,1256,430,594,1095,53,6.69
2,-3,0,2.0,-3.0,0.6760952472686768,85.88364221433555,17,40,-76,1256,430,594,1095,53,5.75
3,-4,0,3.0,-4.0,0.6847951412200928,80.95060222135473,17,37,-72,1256,430,594,1095,53,5.63
3,-4,0,3.0,-4.0,0.6945211887359619,76.02631123499285,17,34,-68,1256,430,594,1095,53,5.38
3,-4,0,3.0,-4.0,0.7001092433929443,71.11258679024411,17,31,-64,1256,430,594,1095,53,5.13
2,-5,0,2.0,-5.0,0.7091541290283203,65.7419196555744,17,29,-59,1256,430,594,1095,53,6.36
2,-3,0,2.0,-3.0,0.7160770893096924,62.16912416947821,17,27,-56,1256,430,594,1095,53,4.8
2,-3,0,2.0,-3.0,0.724088191986084,58.60034129593445,17,25,-53,1256,430,594,1095,53,4.62
1,-3,0,1.0,-3.0,0.7321722507476807,55.46169849544819,17,24,-50,1256,430,594,1095,53,4.61
1,-4,0,1.0,-4.0,0.7400951385498047,51.42956348249516,17,23,-46,1256,430,594,1095,53,4.02
1,-3,0,1.0,-3.0,0.7480971813201904,48.30113870293329,17,22,-43,1256,430,594,1095,53,4.18
2,-4,0,2.0,-4.0,0.7560691833496094,43.829214001622255,17,20,-39,1256,430,594,1095,53,7.42
1,-3,0,1.0,-3.0,0.7641091346740723,40.70626487409524,17,19,-36,1256,430,594,1095,53,3.86
2,-3,0,2.0,-3.0,0.7720820903778076,37.12142238654117,17,17,-33,1256,430,594,1095,53,4.36
1,-3,0,1.0,-3.0,0.7803530693054199,34.0,17,16,-30,1256,430,594,1095,53,3.62
1,-3,0,1.0,-3.0,0.788114070892334,30.886890422961002,17,15,-27,1256,430,594,1095,53,3.38
1,-3,0,1.0,-3.0,0.796079158782959,27.784887978899608,17,14,-24,1256,430,594,1095,53,3.11
1,-2,0,1.0,-2.0,0.8041181564331055,25.553864678361276,17,13,-22,1256,430,594,1095,53,4.38
1,-3,0,1.0,-3.0,0.812143087387085,22.47220505424423,17,12,-19,1256,430,594,1095,53,2.67
0,-2,0,-0.0,-2.0,0.8200662136077881,20.808652046684813,17,12,-17,1256,430,594,1095,53,1.18
1,-2,0,1.0,-2.0,0.8283140659332275,18.601075237738275,17,11,-15,1256,430,594,1095,53,2.95
0,-1,0,-0.0,-1.0,0.8360691070556641,17.804493814764857,17,11,-14,1256,430,594,1095,53,1.06
1,-1,0,1.0,-1.0,0.8444011211395264,16.401219466856727,17,10,-13,1256,430,594,1095,53,3.26
0,-1,0,-0.0,-1.0,0.854992151260376,15.620499351813308,17,10,-12,1256,430,594,1095,53,0.93
0,0,1,-0.0,-0.0,0.8770701885223389,15.620499351813308,17,10,-12,1256,430,594,1095,53,31.57
0,0,0,-0.0,-0.0,0.08200359344482422,314.83964172257595,18,282,140,1528,582,1246,442,20,100.04
-1,0,0,-1.0,-0.0,0.08722758293151855,315.7356489216889,18,283,140,1528,582,1246,442,20,6.77
-2,1,0,-2.0,1.0,0.09547543525695801,317.08989261721985,18,285,139,1528,582,1246,442,20,4.15
-1,1,0,-1.0,1.0,0.10482048988342285,317.5531451584128,18,286,138,1528,582,1246,442,20,9.58
-2,2,0,-2.0,2.0,0.11099457740783691,318.4964677983101,18,288,136,1528,582,1246,442,20,5.13
-3,3,0,-3.0,3.0,0.11901044845581055,319.95312156626943,18,291,133,1528,582,1246,442,20,3.49
-3,4,0,-3.0,4.0,0.12700843811035156,321.05606986942325,18,294,129,1528,582,1246,442,20,4.3
-4,3,0,-4.0,3.0,0.1352555751800537,323.5428874198906,18,298,126,1528,582,1246,442,20,2.41
-2,4,0,-2.0,4.0,0.1429915428161621,323.8579935712565,18,300,122,1528,582,1246,442,20,13.12
-3,3,0,-3.0,3.0,0.1509864330291748,325.53033652794943,18,303,119,1528,582,1246,442,20,3.19
-2,4,0,-2.0,4.0,0.15899443626403809,325.96012026013244,18,305,115,1528,582,1246,442,20,10.07
-2,4,0,-2.0,4.0,0.1671915054321289,326.4506088216103,18,307,111,1528,582,1246,442,20,8.97
-1,5,0,-1.0,5.0,0.17511439323425293,325.7299494980466,18,308,106,1528,582,1246,442,20,3.46
0,4,0,-0.0,4.0,0.1829996109008789,324.4503043610839,18,308,102,1528,582,1246,442,20,6.08
1,4,0,1.0,4.0,0.19100451469421387,322.2623155133098,18,307,98,1528,582,1246,442,20,9.99
3,3,0,3.0,3.0,0.1991405487060547,318.498037670564,18,304,95,1528,582,1246,442,20,16.57
4,3,0,4.0,3.0,0.20920753479003906,313.789738519283,18,300,92,1528,582,1246,442,20,19.84
6,3,0,6.0,3.0,0.21562647819519043,307.17584540455,18,294,89,1528,582,1246,442,20,25.79
6,4,0,6.0,4.0,0.22300148010253906,300.2815345638156,18,288,85,1528,582,1246,442,20,25.34
8,3,0,8.0,3.0,0.23223161697387695,291.7601754866486,18,280,82,1528,582,1246,442,20,30.4
8,2,0,8.0,2.0,0.23922443389892578,283.5207223467096,18,272,80,1528,582,1246,442,20,29.93
8,2,0,8.0,2.0,0.24698853492736816,275.2816739269071,18,264,78,1528,582,1246,442,20,29.36
10,2,0,10.0,2.0,0.2549734115600586,265.1263849563072,18,254,76,1528,582,1246,442,20,31.41
10,2,0,10.0,2.0,0.26300644874572754,254.9745085297744,18,244,74,1528,582,1246,442,20,30.56
13,3,0,13.0,3.0,0.2709834575653076,241.66505746590673,18,231,71,1528,582,1246,442,20,34.64
13,3,0,13.0,3.0,0.2790036201477051,228.35936591258962,18,218,68,1528,582,1246,442,20,33.29
15,3,0,15.0,3.0,0.28737950325012207,213.15252754776333,18,203,65,1528,582,1246,442,20,33.51
15,4,0,15.0,4.0,0.2949795722961426,197.6486782146544,18,188,61,1528,582,1246,442,20,33.08
17,4,0,17.0,4.0,0.3036034107208252,180.24982662959764,18,171,57,1528,582,1246,442,20,32.16
16,4,0,16.0,4.0,0.31104159355163574,163.8108665504215,18,155,53,1528,582,1246,442,20,29.44
16,4,0,16.0,4.0,0.3218674659729004,147.38385257551113,18,139,49,1528,582,1246,442,20,27.27
14,4,0,14.0,4.0,0.32772159576416016,132.85330255586422,18,125,45,1528,582,1246,442,20,24.44
15,4,0,15.0,4.0,0.33499646186828613,117.39250401963491,18,110,41,1528,582,1246,442,20,22.75
14,5,0,14.0,5.0,0.3432955741882324,102.52804494381037,18,96,36,1528,582,1246,442,20,22.58
14,4,0,14.0,4.0,0.35097241401672363,88.02272433866155,18,82,32,1528,582,1246,442,20,18.39
12,4,0,12.0,4.0,0.35904955863952637,75.39230729988306,18,70,28,1528,582,1246,442,20,16.32
10,4,0,10.0,4.0,0.3670485019683838,64.62197768561404,18,60,24,1528,582,1246,442,20,17.09
8,2,0,8.0,2.0,0.3755486011505127,56.462376853972415,18,52,22,1528,582,1246,442,20,10.25
6,3,0,6.0,3.0,0.38298940658569336,49.76946855251722,18,46,19,1528,582,1246,442,20,9.75
3,1,0,3.0,1.0,0.391216516494751,46.61544808322666,18,43,18,1528,582,1246,442,20,7.02
1,1,0,1.0,1.0,0.3998854160308838,45.31004303683677,18,42,17,1528,582,1246,442,20,3.2
1,0,0,1.0,-0.0,0.4149785041809082,44.384682042344295,18,41,17,1528,582,1246,442,20,2.89
0,1,0,-0.0,1.0,0.42297959327697754,44.01136216933077,18,41,16,1528,582,1246,442,20,0.75
1,0,0,1.0,-0.0,0.4471275806427002,43.08131845707603,18,40,16,1528,582,1246,442,20,2.92
1,0,0,1.0,-0.0,0.45520544052124023,42.15447781671598,18,39,16,1528,582,1246,442,20,2.86
2,1,0,2.0,1.0,0.4630105495452881,39.92492955535426,18,37,15,1528,582,1246,442,20,5.95
1,0,0,1.0,-0.0,0.47099947929382324,39.0,18,36,15,1528,582,1246,442,20,2.78
2,1,0,2.0,1.0,0.47898054122924805,36.76955262170047,18,34,14,1528,582,1246,442,20,5.91
1,0,0,1.0,-0.0,0.48705148696899414,35.84689665786984,18,33,14,1528,582,1246,442,20,2.69
1,2,0,1.0,2.0,0.49535250663757324,34.17601498127012,18,32,12,1528,582,1246,442,20,2.19
1,0,0,1.0,-0.0,0.5061185359954834,33.24154027718932,18,31,12,1528,582,1246,442,20,2.76
2,2,0,2.0,2.0,0.5109875202178955,30.675723300355934,18,29,10,1528,582,1246,442,20,3.33
1,1,0,1.0,1.0,0.519141435623169,29.410882339705484,18,28,9,1528,582,1246,442,20,2.49
1,0,0,1.0,-0.0,0.5269744396209717,28.460498941515414,18,27,9,1528,582,1246,442,20,2.86
1,1,0,1.0,1.0,0.5350985527038574,27.202941017470888,18,26,8,1528,582,1246,442,20,2.38
1,1,0,1.0,1.0,0.5429964065551758,25.96150997149434,18,25,7,1528,582,1246,442,20,2.26
2,2,0,2.0,2.0,0.5536766052246094,23.53720459187964,18,23,5,1528,582,1246,442,20,2.51
1,0,0,1.0,-0.0,0.559004545211792,22.561028345356956,18,22,5,1528,582,1246,442,20,3.21
2,1,0,2.0,1.0,0.5677413940429688,20.396078054371138,18,20,4,1528,582,1246,442,20,3.35
2,1,0,2.0,1.0,0.57503342628479,18.24828759089466,18,18,3,1528,582,1246,442,20,3.05
2,1,0,2.0,1.0,0.5830614566802979,16.1245154965971,18,16,2,1528,582,1246,442,20,2.72
1,0,0,1.0,-0.0,0.5965924263000488,15.132745950421556,18,15,2,1528,582,1246,442,20,3.66
2,1,0,2.0,1.0,0.5993773937225342,13.038404810405298,18,13,1,1528,582,1246,442,20,2.29
2,1,0,2.0,1.0,0.6069915294647217,11.0,18,11,0,1528,582,1246,442,20,1.83
1,0,0,1.0,-0.0,0.6152465343475342,10.0,18,10,0,1528,582,1246,442,20,7.27
1,0,0,1.0,-0.0,0.6309854984283447,9.0,18,9,0,1528,582,1246,442,20,7.26
1,1,0,1.0,1.0,0.6404595375061035,8.06225774829855,18,8,-1,1528,582,1246,442,20,0.34
1,0,0,1.0,-0.0,0.6550085544586182,7.0710678118654755,18,7,-1,1528,582,1246,442,20,3.04
1,1,0,1.0,1.0,0.6709704399108887,6.324555320336759,18,6,-2,1528,582,1246,442,20,-0.22
1,0,0,1.0,-0.0,0.6869714260101318,5.385164807134504,18,5,-2,1528,582,1246,442,20,1.45
0,0,1,-0.0,-0.0,0.6990025043487549,5.385164807134504,18,5,-2,1528,582,1246,442,20,28.51
0,0,0,-0.0,-0.0,0.0979311466217041,1479.20823415772,19,-1456,261,67,845,1523,584,15,254.85
-2,0,0,-2.0,-0.0,0.113861083984375,1477.239655573868,19,-1454,261,67,845,1523,584,15,31.92
-2,1,0,-2.0,1.0,0.12247419357299805,1475.094573239289,19,-1452,260,67,845,1523,584,15,33.51
-1,0,0,-1.0,-0.0,0.12987303733825684,1474.1102401109626,19,-1451,260,67,845,1523,584,15,18.41
-2,0,0,-2.0,-0.0,0.13799023628234863,1472.1416372075073,19,-1449,260,67,845,1523,584,15,31.87
-3,0,0,-3.0,-0.0,0.14588713645935059,1469.1888918719744,19,-1446,260,67,845,1523,584,15,43.81
-4,0,0,-4.0,-0.0,0.15387725830078125,1465.2521967224618,19,-1442,260,67,845,1523,584,15,54.46
-3,0,0,-3.0,-0.0,0.1618971824645996,1462.2999008411373,19,-1439,260,67,845,1523,584,15,43.69
-2,0,0,-2.0,-0.0,0.16993308067321777,1460.3318116099506,19,-1437,260,67,845,1523,584,15,31.72
-2,0,0,-2.0,-0.0,0.1794900894165039,1458.3638092053711,19,-1435,260,67,845,1523,584,15,31.7
-2,0,0,-2.0,-0.0,0.18589425086975098,1456.3958939793808,19,-1433,260,67,845,1523,584,15,31.68
-2,0,0,-2.0,-0.0,0.1940140724182129,1454.4280662858512,19,-1431,260,67,845,1523,584,15,31.65
-2,0,0,-2.0,-0.0,0.2018580436706543,1452.4603264805548,19,-1429,260,67,845,1523,584,15,31.63
-3,0,0,-3.0,-0.0,0.2103590965270996,1449.5088823460171,19,-1426,260,67,845,1523,584,15,43.48
-5,0,0,-5.0,-0.0,0.22030925750732422,1444.5902533244505,19,-1421,260,67,845,1523,584,15,63.6
-8,0,0,-8.0,-0.0,0.2258760929107666,1436.721615345158,19,-1413,260,67,845,1523,584,15,87.13
-11,0,0,-11.0,-0.0,0.23401808738708496,1425.9046251415275,19,-1402,260,67,845,1523,584,15,104.97
-12,1,0,-12.0,1.0,0.24185705184936523,1413.9239724963998,19,-1390,259,67,845,1523,584,15,111.33
-14,2,0,-14.0,2.0,0.25038623809814453,1399.7946277936633,19,-1376,257,67,845,1523,584,15,121.59
-19,3,0,-19.0,3.0,0.2618372440338135,1380.5669125399174,19,-1357,254,67,845,1523,584,15,139.42
-26,4,0,-26.0,4.0,0.26598024368286133,1354.2750828395242,19,-1331,250,67,845,1523,584,15,155.55
-27,5,0,-27.0,5.0,0.273881196975708,1326.8161138605456,19,-1304,245,67,845,1523,584,15,157.64
-29,4,0,-29.0,4.0,0.2819192409515381,1297.5769726686738,19,-1275,241,67,845,1523,584,15,157.15
-31,5,0,-31.0,5.0,0.2898862361907959,1266.1879797249696,19,-1244,236,67,845,1523,584,15,159.26
-33,5,0,-33.0,5.0,0.2978861331939697,1232.8349443457546,19,-1211,231,67,845,1523,584,15,159.57
-35,5,0,-35.0,5.0,0.30593419075012207,1197.5191021440953,19,-1176,226,67,845,1523,584,15,159.45
-38,6,0,-38.0,6.0,0.3139171600341797,1159.0703171076377,19,-1138,220,67,845,1523,584,15,160.73
-38,5,0,-38.0,5.0,0.321918249130249,1120.8144360240906,19,-1100,215,67,845,1523,584,15,156.88
-39,6,0,-39.0,6.0,0.3298830986022949,1081.3889217113333,19,-1061,209,67,845,1523,584,15,155.46
-36,5,0,-36.0,5.0,0.33846020698547363,1045.1033441722402,19,-1025,204,67,845,1523,584,15,148.69
-35,6,0,-35.0,6.0,0.3459901809692383,1009.6058636913714,19,-990,198,67,845,1523,584,15,145.69
-34,6,0,-34.0,6.0,0.35387110710144043,975.0897394599125,19,-956,192,67,845,1523,584,15,141.84
-32,5,0,-32.0,5.0,0.36190223693847656,942.7327298868964,19,-924,187,67,845,1523,584,15,135.83
-32,6,0,-32.0,6.0,0.37030625343322754,910.1785539112642,19,-892,181,67,845,1523,584,15,134.39
-31,6,0,-31.0,6.0,0.37785816192626953,878.6045754490469,19,-861,175,67,845,1523,584,15,130.77
-30,5,0,-30.0,5.0,0.38590502738952637,848.210469164346,19,-831,170,67,845,1523,584,15,125.49
-29,4,0,-29.0,4.0,0.3939681053161621,818.9993894991619,19,-802,166,67,845,1523,584,15,120.69
-27,5,0,-27.0,5.0,0.401853084564209,791.5465873844697,19,-775,161,67,845,1523,584,15,117.05
-27,5,0,-27.0,5.0,0.40987420082092285,764.0942350260209,19,-748,156,67,845,1523,584,15,114.6
-26,5,0,-26.0,5.0,0.4191582202911377,737.6211764855996,19,-722,151,67,845,1523,584,15,111.13
-25,5,0,-25.0,5.0,0.425861120223999,712.1270953980055,19,-697,146,67,845,1523,584,15,107.81
-24,4,0,-24.0,4.0,0.4341092109680176,687.8175630208929,19,-673,142,67,845,1523,584,15,102.52
-24,4,0,-24.0,4.0,0.44248318672180176,663.509608069092,19,-649,138,67,845,1523,584,15,100.25
-25,4,0,-25.0,4.0,0.45561718940734863,638.2256654193719,19,-624,134,67,845,1523,584,15,99.08
-25,3,0,-25.0,3.0,0.4579031467437744,613.1574023038456,19,-599,131,67,845,1523,584,15,95.64
-23,3,0,-23.0,3.0,0.46587610244750977,590.0508452667448,19,-576,128,67,845,1523,584,15,90.72
-27,3,0,-27.0,3.0,0.4738941192626953,563.0506193940292,19,-549,125,67,845,1523,584,15,92.8
-24,3,0,-24.0,3.0,0.4818751811981201,538.9888681596309,19,-525,122,67,845,1523,584,15,86.77
-23,2,0,-23.0,2.0,0.4898650646209717,516.1433909293037,19,-502,120,67,845,1523,584,15,82.32
-21,2,0,-21.0,2.0,0.4979691505432129,495.26255663031907,19,-481,118,67,845,1523,584,15,77.43
-20,2,0,-20.0,2.0,0.5093531608581543,475.37038191288275,19,-461,116,67,845,1523,584,15,73.92
-19,1,0,-19.0,1.0,0.513897180557251,456.7154475162845,19,-442,115,67,845,1523,584,15,69.69
-17,2,0,-17.0,2.0,0.5218682289123535,439.76584678667354,19,-425,113,67,845,1523,584,15,65.66
-16,2,0,-16.0,2.0,0.5298700332641602,423.7947616476636,19,-409,111,67,845,1523,584,15,62.42
-16,2,0,-16.0,2.0,0.5380432605743408,407.83575125287877,19,-393,109,67,845,1523,584,15,60.78
-16,2,0,-16.0,2.0,0.5458860397338867,391.89029077026134,19,-377,107,67,845,1523,584,15,59.12
-16,1,0,-16.0,1.0,0.5538792610168457,376.24061450088027,19,-361,106,67,845,1523,584,15,56.53
-15,2,0,-15.0,2.0,0.5618910789489746,361.292125571538,19,-346,104,67,845,1523,584,15,54.29
-13,2,0,-13.0,2.0,0.5709102153778076,348.2714458579687,19,-333,102,67,845,1523,584,15,49.68
-13,2,0,-13.0,2.0,0.5778601169586182,335.2610922848042,19,-320,100,67,845,1523,584,15,48.36
-13,3,0,-13.0,3.0,0.5860381126403809,321.95962479789296,19,-307,97,67,845,1523,584,15,48.4
-14,2,0,-14.0,2.0,0.5938870906829834,308.01623333843946,19,-293,95,67,845,1523,584,15,47.06
-14,3,0,-14.0,3.0,0.6028151512145996,293.7771264070775,19,-279,92,67,845,1523,584,15,46.64
-12,2,0,-12.0,2.0,0.609929084777832,281.7605366264055,19,-267,90,67,845,1523,584,15,41.23
-13,3,0,-13.0,3.0,0.617894172668457,268.48649872945197,19,-254,87,67,845,1523,584,15,42.5
-12,2,0,-12.0,2.0,0.6258711814880371,256.49366463910957,19,-242,85,67,845,1523,584,15,38.53
-12,2,0,-12.0,2.0,0.633904218673706,244.51789300580847,19,-230,83,67,845,1523,584,15,37.19
-11,3,0,-11.0,3.0,0.6418581008911133,233.15445524372893,19,-219,80,67,845,1523,584,15,36.05
-12,2,0,-12.0,2.0,0.6498711109161377,221.2080468699093,19,-207,78,67,845,1523,584,15,34.56
-12,3,0,-12.0,3.0,0.6578640937805176,208.92582415776178,19,-195,75,67,845,1523,584,15,34.3
-11,2,0,-11.0,2.0,0.6676042079925537,197.9520143873257,19,-184,73,67,845,1523,584,15,30.61
-9,3,0,-9.0,3.0,0.6739010810852051,188.48076824970764,19,-175,70,67,845,1523,584,15,28.95
-7,2,0,-7.0,2.0,0.6818921566009521,181.24017214734707,19,-168,68,67,845,1523,584,15,23.74
-7,2,0,-7.0,2.0,0.6924252510070801,174.0028735394907,19,-161,66,67,845,1523,584,15,23.06
-6,2,0,-6.0,2.0,0.6978702545166016,167.69317219254933,19,-155,64,67,845,1523,584,15,21.41
-5,2,0,-5.0,2.0,0.7060191631317139,162.30834852218786,19,-150,62,67,845,1523,584,15,20.93
-5,2,0,-5.0,2.0,0.7138671875,156.92354826475216,19,-145,60,67,845,1523,584,15,20.53
-4,2,0,-4.0,2.0,0.7218620777130127,152.46311029229332,19,-141,58,67,845,1523,584,15,16.56
-3,1,0,-3.0,1.0,0.729985237121582,149.30840565755165,19,-138,57,67,845,1523,584,15,13.5
-3,3,0,-3.0,3.0,0.739166259765625,145.3994497926316,19,-135,54,67,845,1523,584,15,12.68
-4,3,0,-4.0,3.0,0.7459032535552979,140.57738082636197,19,-131,51,67,845,1523,584,15,14.79
-4,3,0,-4.0,3.0,0.7538740634918213,135.76818478568535,19,-127,48,67,845,1523,584,15,14.39
-7,4,0,-7.0,4.0,0.7618510723114014,127.81236246936366,19,-120,44,67,845,1523,584,15,19.35
-7,4,0,-7.0,4.0,0.7698662281036377,119.87076374162301,19,-113,40,67,845,1523,584,15,18.45
-6,4,0,-6.0,4.0,0.777874231338501,112.89375536317321,19,-107,36,67,845,1523,584,15,16.01
-5,3,0,-5.0,3.0,0.7859251499176025,107.20541031123382,19,-102,33,67,845,1523,584,15,13.96
-5,3,0,-5.0,3.0,0.7939021587371826,101.53324578678651,19,-97,30,67,845,1523,584,15,13.4
-5,3,0,-5.0,3.0,0.8037021160125732,95.88013350011565,19,-92,27,67,845,1523,584,15,12.82
-7,4,0,-7.0,4.0,0.8098680973052979,88.05679985100527,19,-85,23,67,845,1523,584,15,14.53
-7,3,0,-7.0,3.0,0.8178942203521729,80.52328855678958,19,-78,20,67,845,1523,584,15,14.15
-6,3,0,-6.0,3.0,0.8278241157531738,73.97972695272672,19,-72,17,67,845,1523,584,15,11.97
-4,3,0,-4.0,3.0,0.8339121341705322,69.42621983083913,19,-68,14,67,845,1523,584,15,8.57
-4,1,0,-4.0,1.0,0.8418700695037842,65.30696746902278,19,-64,13,67,845,1523,584,15,10.82
-4,3,0,-4.0,3.0,0.8498501777648926,60.8276253029822,19,-60,10,67,845,1523,584,15,7.7
-4,2,0,-4.0,2.0,0.8579292297363281,56.568542494923804,19,-56,8,67,845,1523,584,15,7.73
-2,1,0,-2.0,1.0,0.8658740520477295,54.45181356024793,19,-54,7,67,845,1523,584,15,5.21
-1,1,0,-1.0,1.0,0.8746201992034912,53.33854141237835,19,-53,6,67,845,1523,584,15,2.89
-1,1,0,-1.0,1.0,0.8819310665130615,52.23983154643591,19,-52,5,67,845,1523,584,15,2.8
-1,1,0,-1.0,1.0,0.889862060546875,51.15662224971465,19,-51,4,67,845,1523,584,15,2.72
-1,0,0,-1.0,-0.0,0.8984692096710205,50.15974481593781,19,-50,4,67,845,1523,584,15,5.56
0,1,0,-0.0,1.0,0.9058680534362793,50.08991914547278,19,-50,3,67,845,1523,584,15,0.15
-1,0,0,-1.0,-0.0,0.9138610363006592,49.09175083453431,19,-49,3,67,845,1523,584,15,5.85
-1,1,0,-1.0,1.0,0.9222621917724609,48.041648597857254,19,-48,2,67,845,1523,584,15,2.52
-1,0,0,-1.0,-0.0,0.9317450523376465,47.042533945356304,19,-47,2,67,845,1523,584,15,6.21
-1,0,0,-1.0,-0.0,0.9378890991210938,46.04345773288535,19,-46,2,67,845,1523,584,15,6.17
-2,0,0,-2.0,-0.0,0.9467151165008545,44.04543109109048,19,-44,2,67,845,1523,584,15,7.21
-2,1,0,-2.0,1.0,0.9539132118225098,42.01190307520001,19,-42,1,67,845,1523,584,15,4.17
-2,1,0,-2.0,1.0,0.962130069732666,40.0,19,-40,0,67,845,1523,584,15,3.97
-3,1,0,-3.0,1.0,0.969879150390625,37.013511046643494,19,-37,-1,67,845,1523,584,15,5.08
-3,1,0,-3.0,1.0,0.977851152420044,34.058772731852805,19,-34,-2,67,845,1523,584,15,4.73
-3,1,0,-3.0,1.0,0.985889196395874,31.144823004794873,19,-31,-3,67,845,1523,584,15,4.37
-3,1,0,-3.0,1.0,0.9938712120056152,28.284271247461902,19,-28,-4,67,845,1523,584,15,3.98
-4,0,0,-4.0,-0.0,1.0018541812896729,24.331050121192877,19,-24,-4,67,845,1523,584,15,5.82
-3,1,0,-3.0,1.0,1.0098762512207031,21.587033144922902,19,-21,-5,67,845,1523,584,15,3.14
-3,1,0,-3.0,1.0,1.017881155014038,18.973665961010276,19,-18,-6,67,845,1523,584,15,2.63
-3,0,0,-3.0,-0.0,1.028536081314087,16.15549442140351,19,-15,-6,67,845,1523,584,15,3.3
-3,1,0,-3.0,1.0,1.0339851379394531,13.892443989449804,19,-12,-7,67,845,1523,584,15,1.56
-2,0,0,-2.0,-0.0,1.0419120788574219,12.206555615733702,19,-10,-7,67,845,1523,584,15,1.75
-1,0,0,-1.0,-0.0,1.0498652458190918,11.40175425099138,19,-9,-7,67,845,1523,584,15,1.32
-2,0,0,-2.0,-0.0,1.0578641891479492,9.899494936611665,19,-7,-7,67,845,1523,584,15,1.06
-1,0,0,-1.0,-0.0,1.065892219543457,9.219544457292887,19,-6,-7,67,845,1523,584,15,0.72
-2,0,0,-2.0,-0.0,1.073946237564087,8.06225774829855,19,-4,-7,67,845,1523,584,15,0.24
-1,0,0,-1.0,-0.0,1.0818850994110107,7.615773105863909,19,-3,-7,67,845,1523,584,15,0.02
-1,-1,0,-1.0,-1.0,1.0908331871032715,6.324555320336759,19,-2,-6,67,845,1523,584,15,1.47
-2,0,0,-2.0,-0.0,1.0986011028289795,6.0,19,0,-6,67,845,1523,584,15,-1.11
-1,0,0,-1.0,-0.0,1.1068992614746094,6.082762530298219,19,1,-6,67,845,1523,584,15,4.49
-2,-1,0,-2.0,-1.0,1.1165790557861328,5.830951894845301,19,3,-5,67,845,1523,584,15,-1.33
-1,0,0,-1.0,-0.0,1.121934175491333,6.4031242374328485,19,4,-5,67,845,1523,584,15,0.82
-2,0,0,-2.0,-0.0,1.1298880577087402,7.810249675906654,19,6,-5,67,845,1523,584,15,-0.18
-1,-1,0,-1.0,-1.0,1.1417262554168701,8.06225774829855,19,7,-4,67,845,1523,584,15,1.75
-1,0,0,-1.0,-0.0,1.154473066329956,8.94427190999916,19,8,-4,67,845,1523,584,15,1.59
0,-1,0,-0.0,-1.0,1.1698720455169678,8.54400374531753,19,8,-3,67,845,1523,584,15,0.02
0,0,1,-0.0,-0.0,1.1818890571594238,8.54400374531753,19,8,-3,67,845,1523,584,15,29.45
0,0,0,-0.0,-0.0,0.08293414115905762,1616.5633300307168,20,1611,-134,1670,714,59,848,72,266.98
1,0,0,1.0,-0.0,0.10591626167297363,1615.5667736122825,20,1610,-134,1670,714,59,848,72,7.66
1,-1,0,1.0,-1.0,0.1138920783996582,1614.4875347923874,20,1609,-133,1670,714,59,848,72,5.11
1,-1,0,1.0,-1.0,0.12189912796020508,1613.4088136613113,20,1608,-132,1670,714,59,848,72,5.1
1,0,0,1.0,-0.0,0.13062119483947754,1612.4121681505633,20,1607,-132,1670,714,59,848,72,7.68
3,-2,0,3.0,-2.0,0.13790512084960938,1609.2594570174197,20,1604,-130,1670,714,59,848,72,12.6
2,-2,0,2.0,-2.0,0.14593029022216797,1607.1054725810625,20,1602,-128,1670,714,59,848,72,8.79
3,-3,0,3.0,-3.0,0.15394926071166992,1603.8784243202476,20,1599,-125,1670,714,59,848,72,12.36
4,-3,0,4.0,-3.0,0.16223812103271484,1599.6590261677643,20,1595,-122,1670,714,59,848,72,15.87
5,-3,0,5.0,-3.0,0.17354726791381836,1594.4469260530436,20,1590,-119,1670,714,59,848,72,19.25
7,-4,0,7.0,-4.0,0.17794013023376465,1587.1716983363835,20,1583,-115,1670,714,59,848,72,25.51
11,-5,0,11.0,-5.0,0.18601417541503906,1575.8439008988169,20,1572,-110,1670,714,59,848,72,37.04
13,-5,0,13.0,-5.0,0.1960611343383789,1562.531919673963,20,1559,-105,1670,714,59,848,72,42.25
15,-5,0,15.0,-5.0,0.20200109481811523,1547.2349530695071,20,1544,-100,1670,714,59,848,72,47.11
17,-6,0,17.0,-6.0,0.2099132537841797,1529.8905189587913,20,1527,-94,1670,714,59,848,72,51.5
21,-5,0,21.0,-5.0,0.21789312362670898,1508.627521954972,20,1506,-89,1670,714,59,848,72,60.22
24,-6,0,24.0,-6.0,0.2259821891784668,1484.32240433135,20,1482,-83,1670,714,59,848,72,65.66
26,-5,0,26.0,-5.0,0.2341310977935791,1458.087788852235,20,1456,-78,1670,714,59,848,72,69.08
27,-4,0,27.0,-4.0,0.24190807342529297,1430.9147423938298,20,1429,-74,1670,714,59,848,72,70.55
30,-5,0,30.0,-5.0,0.24988317489624023,1400.7005390161025,20,1399,-69,1670,714,59,848,72,74.71
32,-3,0,32.0,-3.0,0.25792908668518066,1368.5923425183994,20,1367,-66,1670,714,59,848,72,77.97
34,-4,0,34.0,-4.0,0.2668182849884033,1334.4410815019148,20,1333,-62,1670,714,59,848,72,79.54
36,-3,0,36.0,-3.0,0.27390027046203613,1298.3412494409934,20,1297,-59,1670,714,59,848,72,81.92
37,-3,0,37.0,-3.0,0.28258323669433594,1261.2438305101832,20,1260,-56,1670,714,59,848,72,82.09
37,-4,0,37.0,-4.0,0.2919471263885498,1224.104979158242,20,1223,-52,1670,714,59,848,72,80.2
39,-4,0,39.0,-4.0,0.30178213119506836,1184.9725735222735,20,1184,-48,1670,714,59,848,72,81.45
42,-3,0,42.0,-3.0,0.30593109130859375,1142.8862585576921,20,1142,-45,1670,714,59,848,72,84.18
51,-4,0,51.0,-4.0,0.31394219398498535,1091.7701223242923,20,1091,-41,1670,714,59,848,72,91.5
51,-5,0,51.0,-5.0,0.3218991756439209,1040.622890388252,20,1040,-36,1670,714,59,848,72,88.62
50,-4,0,50.0,-4.0,0.32999515533447266,990.5170367035591,20,990,-32,1670,714,59,848,72,85.55
49,-2,0,49.0,-2.0,0.33841824531555176,941.4780932130072,20,941,-30,1670,714,59,848,72,83.64
51,0,0,51.0,-0.0,0.345933198928833,890.5054744357275,20,890,-30,1670,714,59,848,72,81.68
51,0,0,51.0,-0.0,0.3539912700653076,839.5361814716505,20,839,-30,1670,714,59,848,72,78.89
44,0,0,44.0,-0.0,0.36197423934936523,795.5658363705671,20,795,-30,1670,714,59,848,72,70.33
41,-1,0,41.0,-1.0,0.3721632957458496,754.5574862129458,20,754,-29,1670,714,59,848,72,66.43
36,-2,0,36.0,-2.0,0.37801218032836914,718.5074808239647,20,718,-27,1670,714,59,848,72,59.66
33,0,0,33.0,-0.0,0.3864462375640869,685.5319102711412,20,685,-27,1670,714,59,848,72,54.22
32,0,0,32.0,-0.0,0.39391016960144043,653.5579545839834,20,653,-27,1670,714,59,848,72,51.67
32,0,0,32.0,-0.0,0.40193819999694824,621.5866793939523,20,621,-27,1670,714,59,848,72,50.1
30,0,0,30.0,-0.0,0.4099111557006836,591.6164297921416,20,591,-27,1670,714,59,848,72,46.66
31,-1,0,31.0,-1.0,0.42342114448547363,560.6032465121835,20,560,-26,1670,714,59,848,72,47.31
27,-2,0,27.0,-2.0,0.42596912384033203,533.5400641001573,20,533,-24,1670,714,59,848,72,41.6
26,-2,0,26.0,-2.0,0.43865013122558594,507.47709307908667,20,507,-22,1670,714,59,848,72,39.28
23,-2,0,23.0,-2.0,0.4419102668762207,484.41304689283504,20,484,-20,1670,714,59,848,72,34.99
22,-2,0,22.0,-2.0,0.4500560760498047,462.35051638340366,20,462,-18,1670,714,59,848,72,32.91
21,-1,0,21.0,-1.0,0.45793724060058594,441.3275427616092,20,441,-17,1670,714,59,848,72,32.58
21,-2,0,21.0,-2.0,0.46709108352661133,420.267771783657,20,420,-15,1670,714,59,848,72,29.98
20,-1,0,20.0,-1.0,0.47395825386047363,400.2449250146715,20,400,-14,1670,714,59,848,72,29.55
19,-1,0,19.0,-1.0,0.481931209564209,381.22172026263144,20,381,-13,1670,714,59,848,72,27.66
19,-1,0,19.0,-1.0,0.489882230758667,362.1988404178014,20,362,-12,1670,714,59,848,72,26.81
18,-2,0,18.0,-2.0,0.4979512691497803,344.14531814336806,20,344,-10,1670,714,59,848,72,23.63
18,-1,0,18.0,-1.0,0.505913257598877,326.1242094662707,20,326,-9,1670,714,59,848,72,24.07
18,0,0,18.0,-0.0,0.5139102935791016,308.13146544940844,20,308,-9,1670,714,59,848,72,23.22
16,-2,0,16.0,-2.0,0.5219032764434814,292.083892058429,20,292,-7,1670,714,59,848,72,19.53
16,-1,0,16.0,-1.0,0.5299222469329834,276.06520968785617,20,276,-6,1670,714,59,848,72,19.94
14,0,0,14.0,-0.0,0.5379452705383301,262.0686932847951,20,262,-6,1670,714,59,848,72,18.42
13,-2,0,13.0,-2.0,0.5459063053131104,249.0321264415497,20,249,-4,1670,714,59,848,72,15.1
12,0,0,12.0,-0.0,0.55436110496521,237.03375287076733,20,237,-4,1670,714,59,848,72,16.25
9,-1,0,9.0,-1.0,0.5626652240753174,228.01973598791838,20,228,-3,1670,714,59,848,72,11.78
8,-1,0,8.0,-1.0,0.5699131488800049,220.00909072126996,20,220,-2,1670,714,59,848,72,10.57
7,0,0,7.0,-0.0,0.5779321193695068,213.00938946440834,20,213,-2,1670,714,59,848,72,12.11
6,-1,0,6.0,-1.0,0.58591628074646,207.0024154448445,20,207,-1,1670,714,59,848,72,8.29
7,-1,0,7.0,-1.0,0.5939152240753174,200.0,20,200,0,1670,714,59,848,72,9.05
5,-2,0,5.0,-2.0,0.6019132137298584,195.0102561405425,20,195,2,1670,714,59,848,72,6.07
5,-2,0,5.0,-2.0,0.610072135925293,190.04210059878838,20,190,4,1670,714,59,848,72,5.93
5,-1,0,5.0,-1.0,0.6203052997589111,185.06755523321746,20,185,5,1670,714,59,848,72,6.65
5,-1,0,5.0,-1.0,0.6259300708770752,180.0999722376436,20,180,6,1670,714,59,848,72,6.52
5,-2,0,5.0,-2.0,0.6339242458343506,175.18276170902203,20,175,8,1670,714,59,848,72,5.54
6,0,0,6.0,-0.0,0.6419100761413574,169.1892431568863,20,169,8,1670,714,59,848,72,9.01
6,-1,0,6.0,-1.0,0.6499261856079102,163.24827717314508,20,163,9,1670,714,59,848,72,6.9
7,-1,0,7.0,-1.0,0.6579210758209229,156.32018423735306,20,156,10,1670,714,59,848,72,7.43
7,-1,0,7.0,-1.0,0.6679661273956299,149.40548852033515,20,149,11,1670,714,59,848,72,7.18
7,0,0,7.0,-0.0,0.6741271018981934,142.42541907960108,20,142,11,1670,714,59,848,72,8.39
7,-2,0,7.0,-2.0,0.682152271270752,135.6244815658294,20,135,13,1670,714,59,848,72,5.98
8,0,0,8.0,-0.0,0.6910262107849121,127.66362050325849,20,127,13,1670,714,59,848,72,8.12
9,0,0,9.0,-0.0,0.6980621814727783,118.71394189394942,20,118,13,1670,714,59,848,72,8.19
9,0,0,9.0,-0.0,0.7059412002563477,109.77249200050075,20,109,13,1670,714,59,848,72,7.77
10,0,0,10.0,-0.0,0.7139091491699219,99.84988733093293,20,99,13,1670,714,59,848,72,7.65
9,0,0,9.0,-0.0,0.7219271659851074,90.93404203047393,20,90,13,1670,714,59,848,72,6.81
9,-1,0,9.0,-1.0,0.7299392223358154,82.20097323024831,20,81,14,1670,714,59,848,72,5.47
7,0,0,7.0,-0.0,0.7380120754241943,75.31268153505093,20,74,14,1670,714,59,848,72,5.22
6,-1,0,6.0,-1.0,0.7464041709899902,69.63476143421474,20,68,15,1670,714,59,848,72,3.67
4,0,0,4.0,-0.0,0.754021167755127,65.73431371817918,20,64,15,1670,714,59,848,72,3.81
3,0,0,3.0,-0.0,0.7619302272796631,62.81719509815764,20,61,15,1670,714,59,848,72,3.43
3,0,0,3.0,-0.0,0.7699201107025146,59.90826320300064,20,58,15,1670,714,59,848,72,3.31
3,0,0,3.0,-0.0,0.7778892517089844,57.0087712549569,20,55,15,1670,714,59,848,72,3.18
4,-1,0,4.0,-1.0,0.785912275314331,53.45091205957107,20,51,16,1670,714,59,848,72,2.19
4,0,0,4.0,-0.0,0.7939291000366211,49.64876634922564,20,47,16,1670,714,59,848,72,2.9
3,-1,0,3.0,-1.0,0.8019061088562012,47.16990566028302,20,44,17,1670,714,59,848,72,1.52
2,0,0,2.0,-0.0,0.8099112510681152,45.31004303683677,20,42,17,1670,714,59,848,72,2.28
2,0,0,2.0,-0.0,0.8179042339324951,43.46262762420146,20,40,17,1670,714,59,848,72,2.19
2,0,0,2.0,-0.0,0.8266491889953613,41.6293165929973,20,38,17,1670,714,59,848,72,2.09
1,0,0,1.0,-0.0,0.8339402675628662,40.718546143004666,20,37,17,1670,714,59,848,72,1.98
1,0,0,1.0,-0.0,0.8419122695922852,39.81205847478876,20,36,17,1670,714,59,848,72,1.94
0,0,1,-0.0,-0.0,0.8539061546325684,39.81205847478876,20,36,17,1670,714,59,848,72,38.96
1,0,1,1.0,-0.0,0.004395008087158203,494.8343157057724,21,-490,69,1145,766,1634,697,47,6.13
0,0,0,-0.0,-0.0,0.10854387283325195,494.8343157057724,21,-490,69,1145,766,1634,697,47,134.44
-3,1,0,-3.0,1.0,0.12853097915649414,491.7245163707012,21,-487,68,1145,766,1634,697,47,10.95
-2,0,0,-2.0,-0.0,0.1365067958831787,489.74381057855135,21,-485,68,1145,766,1634,697,47,8.56
-4,2,0,-4.0,2.0,0.14452886581420898,485.5069515465252,21,-481,66,1145,766,1634,697,47,12.67
-4,1,0,-4.0,1.0,0.15349793434143066,481.40835057152884,21,-477,65,1145,766,1634,697,47,13.75
-5,2,0,-5.0,2.0,0.16058588027954102,476.1858880731347,21,-472,63,1145,766,1634,697,47,15.04
-4,1,0,-4.0,1.0,0.1685948371887207,472.08897466473417,21,-468,62,1145,766,1634,697,47,13.57
-6,1,0,-6.0,1.0,0.17711997032165527,466.00965655230794,21,-462,61,1145,766,1634,697,47,19.04
-7,1,0,-7.0,1.0,0.18457698822021484,458.93899376714546,21,-455,60,1145,766,1634,697,47,21.76
-7,0,0,-7.0,-0.0,0.1925339698791504,452.0,21,-448,60,1145,766,1634,697,47,18.84
-8,0,0,-8.0,-0.0,0.20051789283752441,444.07206622349037,21,-440,60,1145,766,1634,697,47,20.47
-9,0,0,-9.0,-0.0,0.2085437774658203,435.15629376121865,21,-431,60,1145,766,1634,697,47,21.95
-11,0,0,-11.0,-0.0,0.21660494804382324,424.26406871192853,21,-420,60,1145,766,1634,697,47,24.85
-15,-1,0,-15.0,-1.0,0.22723793983459473,409.56806516133554,21,-405,61,1145,766,1634,697,47,29.3
-19,0,0,-19.0,-0.0,0.23253393173217773,390.7902250568711,21,-386,61,1145,766,1634,697,47,33.92
-18,0,0,-18.0,-0.0,0.24063682556152344,373.02144710458674,21,-368,61,1145,766,1634,697,47,31.69
-18,-1,0,-18.0,-1.0,0.25076985359191895,355.4490118146343,21,-350,62,1145,766,1634,697,47,30.03
-17,0,0,-17.0,-0.0,0.25653791427612305,338.7226003679117,21,-333,62,1145,766,1634,697,47,28.46
-15,0,0,-15.0,-0.0,0.2655758857727051,323.9876540857691,21,-318,62,1145,766,1634,697,47,25.36
-16,0,0,-16.0,-0.0,0.2741508483886719,308.2985565973347,21,-302,62,1145,766,1634,697,47,25.52
-15,0,0,-15.0,-0.0,0.28056883811950684,293.62050337127346,21,-287,62,1145,766,1634,697,47,23.58
-14,0,0,-14.0,-0.0,0.28853583335876465,279.95178156246834,21,-273,62,1145,766,1634,697,47,21.71
-15,1,0,-15.0,1.0,0.29807186126708984,265.11318337645906,21,-258,61,1145,766,1634,697,47,22.53
-16,1,0,-16.0,1.0,0.3045158386230469,249.32709439609647,21,-242,60,1145,766,1634,697,47,22.4
-15,1,0,-15.0,1.0,0.31260180473327637,234.54210709380095,21,-227,59,1145,766,1634,697,47,20.56
-12,1,0,-12.0,1.0,0.3215317726135254,222.6858774148015,21,-215,58,1145,766,1634,697,47,17.26
-11,1,0,-11.0,1.0,0.32853078842163086,211.81359729724625,21,-204,57,1145,766,1634,697,47,15.79
-11,1,0,-11.0,1.0,0.3365437984466553,200.9601950635996,21,-193,56,1145,766,1634,697,47,15.17
-11,0,0,-11.0,-0.0,0.34451985359191895,190.4205871222962,21,-182,56,1145,766,1634,697,47,13.77
-8,1,0,-8.0,1.0,0.35259294509887695,182.48561587149823,21,-174,55,1145,766,1634,697,47,11.75
-8,1,0,-8.0,1.0,0.36052894592285156,174.56230979223437,21,-166,54,1145,766,1634,697,47,11.37
-9,2,0,-9.0,2.0,0.3687629699707031,165.38742394752995,21,-157,52,1145,766,1634,697,47,12.9
-8,2,0,-8.0,2.0,0.3777749538421631,157.16551784663199,21,-149,50,1145,766,1634,697,47,12.08
-8,3,0,-8.0,3.0,0.38457584381103516,148.62705002791384,21,-141,47,1145,766,1634,697,47,12.86
-9,2,0,-9.0,2.0,0.39260292053222656,139.4596715900335,21,-132,45,1145,766,1634,697,47,11.59
-8,2,0,-8.0,2.0,0.4006028175354004,131.24404748406687,21,-124,43,1145,766,1634,697,47,10.81
-8,2,0,-8.0,2.0,0.40999388694763184,123.03251602726817,21,-116,41,1145,766,1634,697,47,10.36
-8,2,0,-8.0,2.0,0.4165639877319336,114.82595525402782,21,-108,39,1145,766,1634,697,47,9.89
-7,2,0,-7.0,2.0,0.42478299140930176,107.56393447619885,21,-101,37,1145,766,1634,697,47,9.41
-9,2,0,-9.0,2.0,0.4325089454650879,98.43271813782245,21,-92,35,1145,766,1634,697,47,9.15
-8,2,0,-8.0,2.0,0.44051694869995117,90.24965373894794,21,-84,33,1145,766,1634,697,47,8.39
-8,2,0,-8.0,2.0,0.4485487937927246,82.0792300158816,21,-76,31,1145,766,1634,697,47,7.85
-7,2,0,-7.0,2.0,0.45662689208984375,74.84650960465692,21,-69,29,1145,766,1634,697,47,7.3
-7,1,0,-7.0,1.0,0.46709585189819336,68.0294054067798,21,-62,28,1145,766,1634,697,47,5.61
-7,2,0,-7.0,2.0,0.47261595726013184,60.83584469702052,21,-55,26,1145,766,1634,697,47,6.18
-6,2,0,-6.0,2.0,0.4815948009490967,54.56189146281496,21,-49,24,1145,766,1634,697,47,5.82
-5,2,0,-5.0,2.0,0.49150586128234863,49.193495504995376,21,-44,22,1145,766,1634,697,47,5.9
-5,2,0,-5.0,2.0,0.49654483795166016,43.829214001622255,21,-39,20,1145,766,1634,697,47,5.52
-4,2,0,-4.0,2.0,0.5049829483032227,39.35733730830886,21,-35,18,1145,766,1634,697,47,7.4
-3,1,0,-3.0,1.0,0.5146429538726807,36.235341863986875,21,-32,17,1145,766,1634,697,47,3.84
-3,1,0,-3.0,1.0,0.5205378532409668,33.12099032335839,21,-29,16,1145,766,1634,697,47,3.61
-1,1,0,-1.0,1.0,0.5285217761993408,31.76476034853718,21,-28,15,1145,766,1634,697,47,2.6
-1,0,0,-1.0,-0.0,0.536517858505249,30.886890422961002,21,-27,15,1145,766,1634,697,47,1.76
-1,1,0,-1.0,1.0,0.5445849895477295,29.5296461204668,21,-26,14,1145,766,1634,697,47,2.57
-1,0,0,-1.0,-0.0,0.5525908470153809,28.653097563788805,21,-25,14,1145,766,1634,697,47,1.71
-2,1,0,-2.0,1.0,0.5605289936065674,26.419689627245813,21,-23,13,1145,766,1634,697,47,4.9
-2,0,0,-2.0,-0.0,0.5693199634552002,24.698178070456937,21,-21,13,1145,766,1634,697,47,1.53
-2,2,0,-2.0,2.0,0.5769369602203369,21.95449840010015,21,-19,11,1145,766,1634,697,47,2.61
-3,1,0,-3.0,1.0,0.5845329761505127,18.867962264113206,21,-16,10,1145,766,1634,697,47,2.62
-2,1,0,-2.0,1.0,0.5927319526672363,16.64331697709324,21,-14,9,1145,766,1634,697,47,3.55
-2,1,0,-2.0,1.0,0.6039979457855225,14.422205101855956,21,-12,8,1145,766,1634,697,47,3.24
-2,1,0,-2.0,1.0,0.6085529327392578,12.206555615733702,21,-10,7,1145,766,1634,697,47,2.87
-3,1,0,-3.0,1.0,0.6177499294281006,9.219544457292887,21,-7,6,1145,766,1634,697,47,1.22
-3,1,0,-3.0,1.0,0.6270477771759033,6.4031242374328485,21,-4,5,1145,766,1634,697,47,0.3
-1,1,0,-1.0,1.0,0.6326348781585693,5.0,21,-3,4,1145,766,1634,697,47,2.33
-1,0,0,-1.0,-0.0,0.6410470008850098,4.47213595499958,21,-2,4,1145,766,1634,697,47,-0.52
-1,1,0,-1.0,1.0,0.6485128402709961,3.1622776601683795,21,-1,3,1145,766,1634,697,47,0.29
-1,1,0,-1.0,1.0,0.6565959453582764,2.0,21,0,2,1145,766,1634,697,47,-0.82
0,0,1,-0.0,-0.0,0.6705207824707031,2.0,21,0,2,1145,766,1634,697,47,27.51
-1,0,1,-1.0,-0.0,0.6726298332214355,2.23606797749979,21,1,2,1145,766,1634,697,47,9.07
0,0,0,-0.0,-0.0,0.08736252784729004,1123.161609030508,22,-1084,-294,60,470,1144,764,37,219.51
-1,-1,0,-1.0,-1.0,0.18465566635131836,1121.934935724884,22,-1083,-293,60,470,1144,764,37,8.51
-4,-2,0,-4.0,-2.0,0.19492864608764648,1117.5517885091501,22,-1079,-291,60,470,1144,764,37,25.44
-5,-3,0,-5.0,-3.0,0.20038366317749023,1111.944243206466,22,-1074,-288,60,470,1144,764,37,30.35
-8,-4,0,-8.0,-4.0,0.20921945571899414,1103.1826684642938,22,-1066,-284,60,470,1144,764,37,43.23
-13,-4,0,-13.0,-4.0,0.21837854385375977,1089.5912077471992,22,-1053,-280,60,470,1144,764,37,61.05
-16,-4,0,-16.0,-4.0,0.2244856357574463,1073.1006476561274,22,-1037,-276,60,470,1144,764,37,69.58
-18,-4,0,-18.0,-4.0,0.2323465347290039,1054.6776758801714,22,-1019,-272,60,470,1144,764,37,72.95
-20,-3,0,-20.0,-3.0,0.24031567573547363,1034.5830077862288,22,-999,-269,60,470,1144,764,37,74.97
-21,-3,0,-21.0,-3.0,0.24833464622497559,1013.5284899794382,22,-978,-266,60,470,1144,764,37,76.15
-22,-3,0,-22.0,-3.0,0.26061367988586426,991.5165152431905,22,-956,-263,60,470,1144,764,37,77.16
-23,-3,0,-23.0,-3.0,0.26433658599853516,968.5499470858485,22,-933,-260,60,470,1144,764,37,77.99
-23,-3,0,-23.0,-3.0,0.2723515033721924,945.5945219807484,22,-910,-257,60,470,1144,764,37,76.88
-24,-4,0,-24.0,-4.0,0.28034257888793945,921.4146732063691,22,-886,-253,60,470,1144,764,37,78.4
-25,-5,0,-25.0,-5.0,0.28835368156433105,896.0050223073529,22,-861,-248,60,470,1144,764,37,79.75
-25,-6,0,-25.0,-6.0,0.2963864803314209,870.3217795735093,22,-836,-242,60,470,1144,764,37,79.58
-25,-6,0,-25.0,-6.0,0.3043346405029297,844.6401600681795,22,-811,-236,60,470,1144,764,37,78.19
-25,-8,0,-25.0,-8.0,0.3145296573638916,818.400879764923,22,-786,-228,60,470,1144,764,37,78.27
-25,-8,0,-25.0,-8.0,0.32034945487976074,792.1622308593107,22,-761,-220,60,470,1144,764,37,76.78
-23,-10,0,-23.0,-10.0,0.3283545970916748,767.2965528399043,22,-738,-210,60,470,1144,764,37,71.38
-24,-11,0,-24.0,-11.0,0.33872365951538086,741.2131947017673,22,-714,-199,60,470,1144,764,37,71.59
-24,-11,0,-24.0,-11.0,0.34447646141052246,715.1531304552893,22,-690,-188,60,470,1144,764,37,69.98
-22,-11,0,-22.0,-11.0,0.35247063636779785,691.0520964442551,22,-668,-177,60,470,1144,764,37,65.27
-23,-10,0,-23.0,-10.0,0.3622424602508545,666.2687145589233,22,-645,-167,60,470,1144,764,37,65.22
-20,-9,0,-20.0,-9.0,0.3684544563293457,644.6619269043272,22,-625,-158,60,470,1144,764,37,58.87
-18,-8,0,-18.0,-8.0,0.3763465881347656,625.2591462745667,22,-607,-150,60,470,1144,764,37,54.12
-18,-8,0,-18.0,-8.0,0.3851795196533203,605.875399731661,22,-589,-142,60,470,1144,764,37,53.01
-16,-6,0,-16.0,-6.0,0.39233851432800293,588.9185003037347,22,-573,-136,60,470,1144,764,37,48.37
-15,-6,0,-15.0,-6.0,0.40032958984375,572.9432781698376,22,-558,-130,60,470,1144,764,37,45.55
-12,-6,0,-12.0,-6.0,0.408374547958374,559.9035631249367,22,-546,-124,60,470,1144,764,37,38.65
-12,-7,0,-12.0,-7.0,0.41633152961730957,546.6671747965119,22,-534,-117,60,470,1144,764,37,38.11
-14,-7,0,-14.0,-7.0,0.4243204593658447,531.5072906367325,22,-520,-110,60,470,1144,764,37,41.33
-16,-9,0,-16.0,-9.0,0.43245553970336914,514.0204276096428,22,-504,-101,60,470,1144,764,37,44.1
-16,-7,0,-16.0,-7.0,0.4403505325317383,496.9708240933264,22,-488,-94,60,470,1144,764,37,42.94
-17,-7,0,-17.0,-7.0,0.44832468032836914,478.9676398254897,22,-471,-87,60,470,1144,764,37,43.49
-17,-7,0,-17.0,-7.0,0.45637059211730957,460.9945769746104,22,-454,-80,60,470,1144,764,37,42.34
-18,-6,0,-18.0,-6.0,0.46433258056640625,442.23523152277227,22,-436,-74,60,470,1144,764,37,42.79
-17,-4,0,-17.0,-4.0,0.47233057022094727,424.8070150079916,22,-419,-70,60,470,1144,764,37,40.93
-16,-5,0,-16.0,-5.0,0.4803495407104492,408.20828017079714,22,-403,-65,60,470,1144,764,37,37.77
-17,-5,0,-17.0,-5.0,0.4887394905090332,390.6353798620908,22,-386,-60,60,470,1144,764,37,38.14
-16,-5,0,-16.0,-5.0,0.5028054714202881,374.0655022853618,22,-370,-55,60,470,1144,764,37,35.54
-17,-5,0,-17.0,-5.0,0.5050544738769531,356.52349151213025,22,-353,-50,60,470,1144,764,37,35.77
-17,-5,0,-17.0,-5.0,0.5150525569915771,339.0,22,-336,-45,60,470,1144,764,37,34.51
-16,-4,0,-16.0,-4.0,0.520350456237793,322.61587065735,22,-320,-41,60,470,1144,764,37,32.39
-17,-4,0,-17.0,-4.0,0.5283546447753906,305.25071662487545,22,-303,-37,60,470,1144,764,37,32.45
-15,-3,0,-15.0,-3.0,0.5363254547119141,290.0,22,-288,-34,60,470,1144,764,37,29.41
-15,-4,0,-15.0,-4.0,0.5444815158843994,274.6434051638597,22,-273,-30,60,470,1144,764,37,27.68
-15,-2,0,-15.0,-2.0,0.55263352394104,259.5149321330085,22,-258,-28,60,470,1144,764,37,28.59
-16,-3,0,-16.0,-3.0,0.5603175163269043,243.28789530101986,22,-242,-25,60,470,1144,764,37,27.2
-12,-2,0,-12.0,-2.0,0.56888747215271,231.14713928578047,22,-230,-23,60,470,1144,764,37,22.39
-15,-2,0,-15.0,-2.0,0.5774335861206055,216.02314690791817,22,-215,-21,60,470,1144,764,37,25.17
-14,-2,0,-14.0,-2.0,0.5855066776275635,201.89601283829256,22,-201,-19,60,470,1144,764,37,22.89
-13,-1,0,-13.0,-1.0,0.5923466682434082,188.85973631242842,22,-188,-18,60,470,1144,764,37,21.96
-13,-2,0,-13.0,-2.0,0.6003744602203369,175.72990639046048,22,-175,-16,60,470,1144,764,37,19.85
-11,0,0,-11.0,-0.0,0.6083335876464844,164.77863939236784,22,-164,-16,60,470,1144,764,37,16.63
-11,0,0,-11.0,-0.0,0.6165616512298584,153.83432646844463,22,-153,-16,60,470,1144,764,37,15.85
-10,0,0,-10.0,-0.0,0.6243515014648438,143.8923208513922,22,-143,-16,60,470,1144,764,37,14.3
-10,-1,0,-10.0,-1.0,0.6344316005706787,133.843191832831,22,-133,-15,60,470,1144,764,37,16.16
-11,0,0,-11.0,-0.0,0.6403536796569824,122.9186723000212,22,-122,-15,60,470,1144,764,37,13.59
-11,0,0,-11.0,-0.0,0.6483325958251953,112.00892821556681,22,-111,-15,60,470,1144,764,37,12.7
-9,0,0,-9.0,-0.0,0.6563205718994141,103.0970416646375,22,-102,-15,60,470,1144,764,37,10.69
-9,0,0,-9.0,-0.0,0.6643404960632324,94.2019108086455,22,-93,-15,60,470,1144,764,37,10.01
-9,0,0,-9.0,-0.0,0.6728236675262451,85.32877591996736,22,-84,-15,60,470,1144,764,37,9.3
-10,1,0,-10.0,1.0,0.6805856227874756,75.7099729229908,22,-74,-16,60,470,1144,764,37,8.26
-10,0,0,-10.0,-0.0,0.6883184909820557,65.96969000988257,22,-64,-16,60,470,1144,764,37,7.97
-10,0,0,-10.0,-0.0,0.6963605880737305,56.32051136131489,22,-54,-16,60,470,1144,764,37,6.99
-8,-1,0,-8.0,-1.0,0.70432448387146,48.38388161361178,22,-46,-15,60,470,1144,764,37,6.35
-4,0,0,-4.0,-0.0,0.7123124599456787,44.598206241955516,22,-42,-15,60,470,1144,764,37,3.72
-4,-1,0,-4.0,-1.0,0.7203695774078369,40.496913462633174,22,-38,-14,60,470,1144,764,37,5.27
-3,-1,0,-3.0,-1.0,0.7283535003662109,37.33630940518894,22,-35,-13,60,470,1144,764,37,6.23
-2,0,0,-2.0,-0.0,0.7363605499267578,35.4682957019364,22,-33,-13,60,470,1144,764,37,2.62
-1,0,0,-1.0,-0.0,0.7843315601348877,34.539832078341085,22,-32,-13,60,470,1144,764,37,2.31
0,0,1,-0.0,-0.0,0.8434066772460938,34.539832078341085,22,-32,-13,60,470,1144,764,37,37.34
-1,-1,1,-1.0,-1.0,0.038254737854003906,1491.2199703598394,23,1451,-344,1542,138,92,483,54,6.81
-2,0,1,-2.0,-0.0,0.04628777503967285,1493.1660992669235,23,1453,-344,1542,138,92,483,54,5.14
-1,0,1,-1.0,-0.0,0.054689645767211914,1494.1392170745,23,1454,-344,1542,138,92,483,54,7.46
-1,0,1,-1.0,-0.0,0.07025480270385742,1495.1123703588303,23,1455,-344,1542,138,92,483,54,7.46
0,0,0,-0.0,-0.0,0.11732268333435059,1495.1123703588303,23,1455,-344,1542,138,92,483,54,256.29
1,0,0,1.0,-0.0,0.18225669860839844,1494.1392170745,23,1454,-344,1542,138,92,483,54,7.21
4,0,0,4.0,-0.0,0.19028472900390625,1490.246959399683,23,1450,-344,1542,138,92,483,54,19.52
8,0,0,8.0,-0.0,0.19825482368469238,1482.4641648282768,23,1442,-344,1542,138,92,483,54,34.04
11,-1,0,11.0,-1.0,0.2065446376800537,1471.5332140322216,23,1431,-343,1542,138,92,483,54,45.01
16,0,0,16.0,-0.0,0.21427273750305176,1455.978708635535,23,1415,-343,1542,138,92,483,54,57.68
22,-1,0,22.0,-1.0,0.22257065773010254,1434.3685021639315,23,1393,-342,1542,138,92,483,54,72.63
33,0,0,33.0,-0.0,0.23022985458374023,1402.3423262527592,23,1360,-342,1542,138,92,483,54,92.23
37,0,0,37.0,-0.0,0.23827672004699707,1366.48929743339,23,1323,-342,1542,138,92,483,54,97.24
45,-1,0,45.0,-1.0,0.2462778091430664,1322.7112307680766,23,1278,-341,1542,138,92,483,54,106.94
39,-2,0,39.0,-2.0,0.2542457580566406,1284.5396062403058,23,1239,-339,1542,138,92,483,54,97.7
37,-4,0,37.0,-4.0,0.2625856399536133,1247.8096810010732,23,1202,-335,1542,138,92,483,54,94.44
33,-4,0,33.0,-4.0,0.27031683921813965,1214.957612429339,23,1169,-331,1542,138,92,483,54,87.25
31,-4,0,31.0,-4.0,0.2796776294708252,1184.0494077529029,23,1138,-327,1542,138,92,483,54,82.95
28,-6,0,28.0,-6.0,0.28653764724731445,1155.4830158855646,23,1110,-321,1542,138,92,483,54,78.93
29,-5,0,29.0,-5.0,0.29433774948120117,1126.2402052848229,23,1081,-316,1542,138,92,483,54,78.37
30,-7,0,30.0,-7.0,0.3046267032623291,1095.4825420790603,23,1051,-309,1542,138,92,483,54,80.45
28,-8,0,28.0,-8.0,0.31050562858581543,1066.3629776019045,23,1023,-301,1542,138,92,483,54,78.38
29,-9,0,29.0,-9.0,0.31875181198120117,1036.001930500132,23,994,-292,1542,138,92,483,54,78.69
30,-9,0,30.0,-9.0,0.3285248279571533,1004.6815415841977,23,964,-283,1542,138,92,483,54,79.37
32,-12,0,32.0,-12.0,0.33454275131225586,970.6003296929174,23,932,-271,1542,138,92,483,54,79.56
34,-13,0,34.0,-13.0,0.34325265884399414,934.3275656856111,23,898,-258,1542,138,92,483,54,80.53
36,-13,0,36.0,-13.0,0.3504326343536377,896.1411719143363,23,862,-245,1542,138,92,483,54,81.18
36,-15,0,36.0,-15.0,0.35828280448913574,857.4240491145557,23,826,-230,1542,138,92,483,54,79.01
36,-15,0,36.0,-15.0,0.3662757873535156,818.7337784652591,23,790,-215,1542,138,92,483,54,76.81
36,-14,0,36.0,-14.0,0.37425875663757324,780.3313398806945,23,754,-201,1542,138,92,483,54,74.54
33,-15,0,33.0,-15.0,0.38223767280578613,744.605264552971,23,721,-186,1542,138,92,483,54,69.0
29,-11,0,29.0,-11.0,0.39026665687561035,713.7849816296222,23,692,-175,1542,138,92,483,54,62.22
26,-12,0,26.0,-12.0,0.39824962615966797,685.6566195990526,23,666,-163,1542,138,92,483,54,56.78
24,-10,0,24.0,-10.0,0.4062516689300537,659.9795451375747,23,642,-153,1542,138,92,483,54,52.62
23,-11,0,23.0,-11.0,0.4142458438873291,635.0787352761861,23,619,-142,1542,138,92,483,54,49.98
21,-8,0,21.0,-8.0,0.42223167419433594,612.8295032062343,23,598,-134,1542,138,92,483,54,46.01
19,-10,0,19.0,-10.0,0.43029165267944336,592.129208872523,23,579,-124,1542,138,92,483,54,42.08
18,-9,0,18.0,-9.0,0.4385697841644287,572.6656965455501,23,561,-115,1542,138,92,483,54,39.58
16,-7,0,16.0,-7.0,0.44957971572875977,555.5978761658471,23,545,-108,1542,138,92,483,54,35.72
14,-8,0,14.0,-8.0,0.45458269119262695,540.3341558702356,23,531,-100,1542,138,92,483,54,31.86
12,-5,0,12.0,-5.0,0.46245765686035156,527.6229714483629,23,519,-95,1542,138,92,483,54,28.07
13,-6,0,13.0,-6.0,0.4702458381652832,513.7674571243298,23,506,-89,1542,138,92,483,54,29.13
12,-6,0,12.0,-6.0,0.4783308506011963,500.9241459542552,23,494,-83,1542,138,92,483,54,26.94
13,-4,0,13.0,-4.0,0.4876596927642822,487.44435579869014,23,481,-79,1542,138,92,483,54,28.5
14,-5,0,14.0,-5.0,0.4974348545074463,472.826606696366,23,467,-74,1542,138,92,483,54,29.18
14,-3,0,14.0,-3.0,0.5023696422576904,458.53026072441503,23,453,-71,1542,138,92,483,54,29.72
14,-3,0,14.0,-3.0,0.5105156898498535,444.2352980122133,23,439,-68,1542,138,92,483,54,29.13
15,-2,0,15.0,-2.0,0.5182528495788574,429.10604749875057,23,424,-66,1542,138,92,483,54,30.64
14,-2,0,14.0,-2.0,0.526660680770874,414.9650587700126,23,410,-64,1542,138,92,483,54,29.2
14,-2,0,14.0,-2.0,0.534794807434082,400.8241509689754,23,396,-62,1542,138,92,483,54,28.61
13,-2,0,13.0,-2.0,0.5445828437805176,387.6712524807585,23,383,-60,1542,138,92,483,54,27.56
16,-2,0,16.0,-2.0,0.5502626895904541,371.5548411742202,23,367,-58,1542,138,92,483,54,28.95
18,-1,0,18.0,-1.0,0.5582587718963623,353.62409420173844,23,349,-57,1542,138,92,483,54,28.64
17,-2,0,17.0,-2.0,0.5662658214569092,336.5248876383439,23,332,-55,1542,138,92,483,54,27.91
17,-2,0,17.0,-2.0,0.574312686920166,319.4276130831522,23,315,-53,1542,138,92,483,54,26.97
16,-2,0,16.0,-2.0,0.5831577777862549,303.3183146465112,23,299,-51,1542,138,92,483,54,25.3
15,-2,0,15.0,-2.0,0.5902566909790039,288.19611378365255,23,284,-49,1542,138,92,483,54,23.76
15,-3,0,15.0,-3.0,0.5991637706756592,272.90474528670256,23,269,-46,1542,138,92,483,54,23.48
15,-1,0,15.0,-1.0,0.6062698364257812,257.9554225055174,23,254,-45,1542,138,92,483,54,20.81
14,-2,0,14.0,-2.0,0.6142797470092773,243.82165613415063,23,240,-43,1542,138,92,483,54,20.73
13,-1,0,13.0,-1.0,0.6222326755523682,230.85276693165278,23,227,-42,1542,138,92,483,54,17.76
15,-1,0,15.0,-1.0,0.6302938461303711,215.92822881689185,23,212,-41,1542,138,92,483,54,18.39
15,0,0,15.0,-0.0,0.6382787227630615,201.2212712413874,23,197,-41,1542,138,92,483,54,16.74
17,0,0,17.0,-0.0,0.6471056938171387,184.61040057374882,23,180,-41,1542,138,92,483,54,16.96
15,0,0,15.0,-0.0,0.6542477607727051,170.01764614298128,23,165,-41,1542,138,92,483,54,14.65
16,0,0,16.0,-0.0,0.662254810333252,154.53802121160993,23,149,-41,1542,138,92,483,54,14.11
15,0,0,15.0,-0.0,0.6704926490783691,140.13208055259867,23,134,-41,1542,138,92,483,54,12.46
13,0,0,13.0,-0.0,0.6811497211456299,127.75758294520134,23,121,-41,1542,138,92,483,54,10.48
15,0,0,15.0,-0.0,0.6863768100738525,113.65298060323803,23,106,-41,1542,138,92,483,54,10.34
13,0,0,13.0,-0.0,0.6954348087310791,101.6366075781753,23,93,-41,1542,138,92,483,54,8.46
12,0,0,12.0,-0.0,0.70223069190979,90.78546139112804,23,81,-41,1542,138,92,483,54,7.15
9,0,0,9.0,-0.0,0.7103626728057861,82.85529554590944,23,72,-41,1542,138,92,483,54,5.36
8,0,0,8.0,-0.0,0.7182557582855225,76.00657866263946,23,64,-41,1542,138,92,483,54,4.47
7,-1,0,7.0,-1.0,0.7262527942657471,69.63476143421474,23,57,-40,1542,138,92,483,54,4.32
6,-1,0,6.0,-1.0,0.735177755355835,64.20280367709809,23,51,-39,1542,138,92,483,54,3.72
4,0,0,4.0,-0.0,0.7422606945037842,61.07372593840988,23,47,-39,1542,138,92,483,54,2.28
4,-1,0,4.0,-1.0,0.7502486705780029,57.38466694161429,23,43,-38,1542,138,92,483,54,2.94
4,-1,0,4.0,-1.0,0.7621257305145264,53.75872022286245,23,39,-37,1542,138,92,483,54,2.71
4,-1,0,4.0,-1.0,0.7663016319274902,50.20956084253277,23,35,-36,1542,138,92,483,54,2.47
3,-1,0,3.0,-1.0,0.7743556499481201,47.4236228055175,23,32,-35,1542,138,92,483,54,2.33
3,-2,0,3.0,-2.0,0.7822327613830566,43.93176527297759,23,29,-33,1542,138,92,483,54,3.37
2,-1,0,2.0,-1.0,0.7910218238830566,41.86884283091664,23,27,-32,1542,138,92,483,54,2.37
2,-1,0,2.0,-1.0,0.800055742263794,39.824615503479755,23,25,-31,1542,138,92,483,54,2.25
2,-1,0,2.0,-1.0,0.8063406944274902,37.8021163428716,23,23,-30,1542,138,92,483,54,2.12
1,-1,0,1.0,-1.0,0.8142516613006592,36.40054944640259,23,22,-29,1542,138,92,483,54,3.67
2,-1,0,2.0,-1.0,0.8222558498382568,34.40930106817051,23,20,-28,1542,138,92,483,54,1.93
3,-2,0,3.0,-2.0,0.8302466869354248,31.064449134018133,23,17,-26,1542,138,92,483,54,2.29
2,-1,0,2.0,-1.0,0.8383698463439941,29.154759474226502,23,15,-25,1542,138,92,483,54,1.56
2,-2,0,2.0,-2.0,0.8462917804718018,26.419689627245813,23,13,-23,1542,138,92,483,54,2.62
3,-2,0,3.0,-2.0,0.8606047630310059,23.259406699226016,23,10,-21,1542,138,92,483,54,1.51
1,0,0,1.0,-0.0,0.8633837699890137,22.847319317591726,23,9,-21,1542,138,92,483,54,0.31
1,-1,0,1.0,-1.0,0.8702406883239746,21.540659228538015,23,8,-20,1542,138,92,483,54,1.84
1,-1,0,1.0,-1.0,0.878300666809082,20.248456731316587,23,7,-19,1542,138,92,483,54,1.7
0,0,1,-0.0,-0.0,0.9083046913146973,20.248456731316587,23,7,-19,1542,138,92,483,54,32.980000000000004
0,0,0,-0.0,-0.0,0.0707085132598877,917.511852784475,24,-168,902,1367,1059,1535,157,44,195.73
0,2,0,-0.0,2.0,0.08170366287231445,915.5457388901988,24,-168,900,1367,1059,1535,157,44,11.16
-2,4,0,-2.0,4.0,0.08967971801757812,911.247496567206,24,-166,896,1367,1059,1535,157,44,19.25
-2,4,0,-2.0,4.0,0.09769272804260254,906.9509358283942,24,-164,892,1367,1059,1535,157,44,19.19
-4,5,0,-4.0,5.0,0.10615253448486328,901.3151502110679,24,-160,887,1367,1059,1535,157,44,22.92
-3,5,0,-3.0,5.0,0.11370253562927246,895.8643870586664,24,-157,882,1367,1059,1535,157,44,22.66
-5,6,0,-5.0,6.0,0.12171649932861328,889.0894218243742,24,-152,876,1367,1059,1535,157,44,26.35
-6,6,0,-6.0,6.0,0.12967562675476074,882.1655173492104,24,-146,870,1367,1059,1535,157,44,26.46
-7,7,0,-7.0,7.0,0.13768458366394043,874.1224170561009,24,-139,863,1367,1059,1535,157,44,29.7
-9,8,0,-9.0,8.0,0.14577364921569824,864.8265722097119,24,-130,855,1367,1059,1535,157,44,32.97
-10,8,0,-10.0,8.0,0.15376067161560059,855.4583566720241,24,-120,847,1367,1059,1535,157,44,32.84
-11,8,0,-11.0,8.0,0.16373658180236816,846.0508258964115,24,-109,839,1367,1059,1535,157,44,32.62
-11,9,0,-11.0,9.0,0.17020249366760254,835.765517355197,24,-98,830,1367,1059,1535,157,44,34.84
-12,9,0,-12.0,9.0,0.17771267890930176,825.4919745218605,24,-86,821,1367,1059,1535,157,44,34.44
-14,13,0,-14.0,13.0,0.18631458282470703,811.2015779077356,24,-72,808,1367,1059,1535,157,44,44.0
-12,14,0,-12.0,14.0,0.19369268417358398,796.2637753910446,24,-60,794,1367,1059,1535,157,44,45.16
-11,14,0,-11.0,14.0,0.2018125057220459,781.5375870679542,24,-49,780,1367,1059,1535,157,44,44.26
-10,17,0,-10.0,17.0,0.21007061004638672,763.9960732883383,24,-39,763,1367,1059,1535,157,44,49.74
-9,16,0,-9.0,16.0,0.21768665313720703,747.6021669310489,24,-30,747,1367,1059,1535,157,44,46.87
-7,16,0,-7.0,16.0,0.22571659088134766,731.3617435988842,24,-23,731,1367,1059,1535,157,44,46.25
-7,16,0,-7.0,16.0,0.23366856575012207,715.1789985730845,24,-16,715,1367,1059,1535,157,44,45.48
-5,16,0,-5.0,16.0,0.24167466163635254,699.086546859543,24,-11,699,1367,1059,1535,157,44,45.11
-5,17,0,-5.0,17.0,0.24973368644714355,682.0263924512012,24,-6,682,1367,1059,1535,157,44,46.3
-5,16,0,-5.0,16.0,0.2577517032623291,666.0007507503276,24,-1,666,1367,1059,1535,157,44,43.61
-5,15,0,-5.0,15.0,0.26569151878356934,651.0122886704982,24,4,651,1367,1059,1535,157,44,40.94
-4,17,0,-4.0,17.0,0.27370452880859375,634.0504711771769,24,8,634,1367,1059,1535,157,44,44.29
-4,17,0,-4.0,17.0,0.282970666885376,617.1166826459969,24,12,617,1367,1059,1535,157,44,43.47
-2,18,0,-2.0,18.0,0.291245698928833,599.1635836731067,24,14,599,1367,1059,1535,157,44,45.24
-2,18,0,-2.0,18.0,0.29782867431640625,581.2202680567841,24,16,581,1367,1059,1535,157,44,44.35
-2,19,0,-2.0,19.0,0.3056905269622803,562.2881823406926,24,18,562,1367,1059,1535,157,44,45.01
-1,20,0,-1.0,20.0,0.31367969512939453,542.3329235810786,24,19,542,1367,1059,1535,157,44,46.13
-2,20,0,-2.0,20.0,0.32172465324401855,522.4222430180399,24,21,522,1367,1059,1535,157,44,44.38
-3,21,0,-3.0,21.0,0.3298037052154541,501.5745208839859,24,24,501,1367,1059,1535,157,44,44.12
-2,22,0,-2.0,22.0,0.3376796245574951,479.7051177546473,24,26,479,1367,1059,1535,157,44,44.55
-3,23,0,-3.0,23.0,0.34609556198120117,456.92121859243963,24,29,456,1367,1059,1535,157,44,43.89
-4,24,0,-4.0,24.0,0.35369157791137695,433.2585832963959,24,33,432,1367,1059,1535,157,44,43.07
-4,26,0,-4.0,26.0,0.36168861389160156,407.6824744822863,24,37,406,1367,1059,1535,157,44,43.33
-4,24,0,-4.0,24.0,0.3698115348815918,384.1939614309418,24,41,382,1367,1059,1535,157,44,39.42
-3,23,0,-3.0,23.0,0.380908727645874,361.6863281906022,24,44,359,1367,1059,1535,157,44,36.98
-3,22,0,-3.0,22.0,0.3857405185699463,340.26166401756166,24,47,337,1367,1059,1535,157,44,34.31
-3,22,0,-3.0,22.0,0.3937675952911377,318.9435686763412,24,50,315,1367,1059,1535,157,44,32.63
-2,20,0,-2.0,20.0,0.4042634963989258,299.54799281584246,24,52,295,1367,1059,1535,157,44,29.54
-1,19,0,-1.0,19.0,0.40975069999694824,281.04270138183625,24,53,276,1367,1059,1535,157,44,27.62
-1,17,0,-1.0,17.0,0.418102502822876,264.5694615786183,24,54,259,1367,1059,1535,157,44,24.48
1,16,0,1.0,16.0,0.4256775379180908,248.71268564349506,24,53,243,1367,1059,1535,157,44,23.65
2,15,0,2.0,15.0,0.43370866775512695,233.63432966925043,24,51,228,1367,1059,1535,157,44,22.71
2,15,0,2.0,15.0,0.44180870056152344,218.56349191939628,24,49,213,1367,1059,1535,157,44,21.67
2,14,0,2.0,14.0,0.45219850540161133,204.47493733951845,24,47,199,1367,1059,1535,157,44,19.98
2,14,0,2.0,14.0,0.4577205181121826,190.3943276465977,24,45,185,1367,1059,1535,157,44,19.0
1,12,0,1.0,12.0,0.46569156646728516,178.5077029150283,24,44,173,1367,1059,1535,157,44,15.77
2,11,0,2.0,11.0,0.47366762161254883,167.35590817177624,24,42,162,1367,1059,1535,157,44,15.6
2,11,0,2.0,11.0,0.48171472549438477,156.20819440733575,24,40,151,1367,1059,1535,157,44,14.89
2,9,0,2.0,9.0,0.4908745288848877,146.99659860010368,24,38,142,1367,1059,1535,157,44,13.63
2,10,0,2.0,10.0,0.4977145195007324,136.82105101189657,24,36,132,1367,1059,1535,157,44,13.26
2,9,0,2.0,9.0,0.506070613861084,127.61269529321916,24,34,123,1367,1059,1535,157,44,12.46
3,10,0,3.0,10.0,0.5153636932373047,117.17508267545622,24,31,113,1367,1059,1535,157,44,13.56
4,10,0,4.0,10.0,0.5234496593475342,106.48004507887852,24,27,103,1367,1059,1535,157,44,11.08
4,9,0,4.0,9.0,0.5297026634216309,96.77293009927931,24,23,94,1367,1059,1535,157,44,9.46
3,9,0,3.0,9.0,0.5388426780700684,87.32124598286491,24,20,85,1367,1059,1535,157,44,9.69
3,8,0,3.0,8.0,0.5462934970855713,78.85429601486528,24,17,77,1367,1059,1535,157,44,8.13
1,7,0,1.0,7.0,0.5536916255950928,71.80529228406496,24,16,70,1367,1059,1535,157,44,7.81
2,6,0,2.0,6.0,0.5618326663970947,65.5133574166368,24,14,64,1367,1059,1535,157,44,6.84
1,5,0,1.0,5.0,0.5700147151947021,60.41522986797286,24,13,59,1367,1059,1535,157,44,8.08
1,5,0,1.0,5.0,0.5777196884155273,55.31726674375732,24,12,54,1367,1059,1535,157,44,7.8
0,5,0,-0.0,5.0,0.5860316753387451,50.44799302251776,24,12,49,1367,1059,1535,157,44,4.5
1,4,0,1.0,4.0,0.5938675403594971,46.32493928760188,24,11,45,1367,1059,1535,157,44,8.12
1,5,0,1.0,5.0,0.601677656173706,41.23105625617661,24,10,40,1367,1059,1535,157,44,6.32
0,3,0,-0.0,3.0,0.6097686290740967,38.3275357934736,24,10,37,1367,1059,1535,157,44,3.3
0,3,0,-0.0,3.0,0.6178655624389648,35.4400902933387,24,10,34,1367,1059,1535,157,44,3.09
0,3,0,-0.0,3.0,0.6291797161102295,32.57299494980466,24,10,31,1367,1059,1535,157,44,2.86
1,2,0,1.0,2.0,0.6336925029754639,30.364452901377952,24,9,29,1367,1059,1535,157,44,3.57
0,1,0,-0.0,1.0,0.6417045593261719,29.410882339705484,24,9,28,1367,1059,1535,157,44,2.46
1,1,0,1.0,1.0,0.6541056632995605,28.160255680657446,24,8,27,1367,1059,1535,157,44,1.79
0,1,0,-0.0,1.0,0.657719612121582,27.202941017470888,24,8,26,1367,1059,1535,157,44,2.48
0,1,0,-0.0,1.0,0.6736845970153809,26.248809496813376,24,8,25,1367,1059,1535,157,44,2.41
0,1,0,-0.0,1.0,0.7138755321502686,25.298221281347036,24,8,24,1367,1059,1535,157,44,2.34
0,1,0,-0.0,1.0,0.7297224998474121,24.351591323771842,24,8,23,1367,1059,1535,157,44,2.27
0,1,0,-0.0,1.0,0.7376875877380371,23.40939982143925,24,8,22,1367,1059,1535,157,44,2.19
0,2,0,-0.0,2.0,0.7536675930023193,21.540659228538015,24,8,20,1367,1059,1535,157,44,2.03
0,1,0,-0.0,1.0,0.7617535591125488,20.615528128088304,24,8,19,1367,1059,1535,157,44,1.93
0,1,0,-0.0,1.0,0.7749395370483398,19.697715603592208,24,8,18,1367,1059,1535,157,44,1.84
1,2,0,1.0,2.0,0.7780966758728027,17.46424919657298,24,7,16,1367,1059,1535,157,44,4.6
0,3,0,-0.0,3.0,0.7856817245483398,14.7648230602334,24,7,13,1367,1059,1535,157,44,1.34
1,1,0,1.0,1.0,0.793717622756958,13.416407864998739,24,6,12,1367,1059,1535,157,44,1.94
0,2,0,-0.0,2.0,0.8017125129699707,11.661903789690601,24,6,10,1367,1059,1535,157,44,1.01
0,1,0,-0.0,1.0,0.8107776641845703,10.816653826391969,24,6,9,1367,1059,1535,157,44,1.01
0,0,1,-0.0,-0.0,0.8287415504455566,10.816653826391969,24,6,9,1367,1059,1535,157,44,30.13
0,0,0,-0.0,-0.0,0.09150362014770508,1066.0154783116425,25,-1042,-225,319,825,1361,1050,28,213.19
-1,0,0,-1.0,-0.0,0.1155238151550293,1065.0380274900986,25,-1041,-225,319,825,1361,1050,28,9.87
-1,0,0,-1.0,-0.0,0.1235036849975586,1064.0606185739607,25,-1040,-225,319,825,1361,1050,28,9.87
-2,-1,0,-2.0,-1.0,0.13260173797607422,1061.8945333694867,25,-1038,-224,319,825,1361,1050,28,17.47
-2,-2,0,-2.0,-2.0,0.13947367668151855,1059.5187586824502,25,-1036,-222,319,825,1361,1050,28,17.63
-2,-4,0,-2.0,-4.0,0.14748883247375488,1056.730807727304,25,-1034,-218,319,825,1361,1050,28,19.49
-2,-3,0,-2.0,-3.0,0.1555616855621338,1054.1579578032886,25,-1032,-215,319,825,1361,1050,28,18.37
-3,-4,0,-3.0,-4.0,0.16350078582763672,1050.4103959881586,25,-1029,-211,319,825,1361,1050,28,25.35
-3,-5,0,-3.0,-5.0,0.17164874076843262,1046.4759911244978,25,-1026,-206,319,825,1361,1050,28,26.15
-4,-5,0,-4.0,-5.0,0.17950177192687988,1041.578129570701,25,-1022,-201,319,825,1361,1050,28,31.55
-4,-5,0,-4.0,-5.0,0.18747472763061523,1036.696676950399,25,-1018,-196,319,825,1361,1050,28,31.37
-7,-7,0,-7.0,-7.0,0.19551968574523926,1028.5144627082304,25,-1011,-189,319,825,1361,1050,28,47.13
-11,-10,0,-11.0,-10.0,0.2036428451538086,1015.894187403393,25,-1000,-179,319,825,1361,1050,28,63.83
-19,-12,0,-19.0,-12.0,0.21152663230895996,995.1130589033589,25,-981,-167,319,825,1361,1050,28,86.36
-23,-14,0,-23.0,-14.0,0.21950483322143555,970.1407114434483,25,-958,-153,319,825,1361,1050,28,93.95
-27,-13,0,-27.0,-13.0,0.2274796962738037,941.4674715570369,25,-931,-140,319,825,1361,1050,28,99.28
-28,-12,0,-28.0,-12.0,0.23549675941467285,912.0268636394435,25,-903,-128,319,825,1361,1050,28,98.85
-28,-11,0,-28.0,-11.0,0.24350666999816895,882.7876301806681,25,-875,-117,319,825,1361,1050,28,96.78
-29,-10,0,-29.0,-10.0,0.25147461891174316,852.739702371128,25,-846,-107,319,825,1361,1050,28,96.26
-29,-8,0,-29.0,-8.0,0.25983166694641113,822.9763058557639,25,-817,-99,319,825,1361,1050,28,94.27
-29,-8,0,-29.0,-8.0,0.2676358222961426,793.2370389738493,25,-788,-91,319,825,1361,1050,28,92.14
-31,-8,0,-31.0,-8.0,0.27546072006225586,761.5366045043403,25,-757,-83,319,825,1361,1050,28,92.67
-31,-7,0,-31.0,-7.0,0.28380870819091797,729.9671225473104,25,-726,-76,319,825,1361,1050,28,90.42
-32,-6,0,-32.0,-6.0,0.2915058135986328,697.5213258388592,25,-694,-70,319,825,1361,1050,28,89.45
-33,-5,0,-33.0,-5.0,0.2995796203613281,664.1882263334694,25,-661,-65,319,825,1361,1050,28,88.43
-32,-5,0,-32.0,-5.0,0.3074817657470703,631.8552049322693,25,-629,-60,319,825,1361,1050,28,84.48
-33,-5,0,-33.0,-5.0,0.31546664237976074,598.5323717226997,25,-596,-55,319,825,1361,1050,28,82.81
-32,-4,0,-32.0,-4.0,0.3235127925872803,566.30115662958,25,-564,-51,319,825,1361,1050,28,79.46
-30,-3,0,-30.0,-3.0,0.3314847946166992,536.1529632483625,25,-534,-48,319,825,1361,1050,28,75.65
-29,-2,0,-29.0,-2.0,0.33948469161987305,507.09072166625174,25,-505,-46,319,825,1361,1050,28,71.28
-26,-2,0,-26.0,-2.0,0.3474998474121094,481.01663172909105,25,-479,-44,319,825,1361,1050,28,65.94
-25,-2,0,-25.0,-2.0,0.355501651763916,455.93859235647074,25,-454,-42,319,825,1361,1050,28,62.75
-24,-2,0,-24.0,-2.0,0.3637547492980957,431.8564576337837,25,-430,-40,319,825,1361,1050,28,59.67
-21,-1,0,-21.0,-1.0,0.3714938163757324,410.85520563819074,25,-409,-39,319,825,1361,1050,28,52.61
-21,-1,0,-21.0,-1.0,0.3795156478881836,389.8563838133217,25,-388,-38,319,825,1361,1050,28,50.81
-18,-1,0,-18.0,-1.0,0.38748979568481445,371.84539798147296,25,-370,-37,319,825,1361,1050,28,45.57
-17,0,0,-17.0,-0.0,0.39545464515686035,354.93379664382485,25,-353,-37,319,825,1361,1050,28,41.7
-15,-1,0,-15.0,-1.0,0.4034886360168457,339.91175325369375,25,-338,-36,319,825,1361,1050,28,39.04
-13,0,0,-13.0,-0.0,0.4114978313446045,326.9877673552942,25,-325,-36,319,825,1361,1050,28,33.7
-13,-1,0,-13.0,-1.0,0.4195287227630615,313.95700342562833,25,-312,-35,319,825,1361,1050,28,34.35
-12,-1,0,-12.0,-1.0,0.42748165130615234,301.9205193424256,25,-300,-34,319,825,1361,1050,28,32.17
-11,-2,0,-11.0,-2.0,0.43560266494750977,290.766229125736,25,-289,-32,319,825,1361,1050,28,29.11
-12,-2,0,-12.0,-2.0,0.4435107707977295,278.6198126479881,25,-277,-30,319,825,1361,1050,28,30.06
-11,-2,0,-11.0,-2.0,0.4514896869659424,267.46962444359923,25,-266,-28,319,825,1361,1050,28,27.52
-13,-3,0,-13.0,-3.0,0.45958375930786133,254.23217734976035,25,-253,-25,319,825,1361,1050,28,28.79
-15,-2,0,-15.0,-2.0,0.4675006866455078,239.10876186371758,25,-238,-23,319,825,1361,1050,28,31.41
-13,-3,0,-13.0,-3.0,0.4754936695098877,225.88713996153035,25,-225,-20,319,825,1361,1050,28,26.49
-13,-1,0,-13.0,-1.0,0.4834747314453125,212.8497122384712,25,-212,-19,319,825,1361,1050,28,27.89
-10,-2,0,-10.0,-2.0,0.4914836883544922,202.71408436514716,25,-202,-17,319,825,1361,1050,28,21.28
-10,-1,0,-10.0,-1.0,0.4995076656341553,192.66551326067673,25,-192,-16,319,825,1361,1050,28,22.63
-11,-1,0,-11.0,-1.0,0.5075316429138184,181.62048342629197,25,-181,-15,319,825,1361,1050,28,23.55
-11,0,0,-11.0,-0.0,0.5155007839202881,170.66048165876012,25,-170,-15,319,825,1361,1050,28,20.28
-9,0,0,-9.0,-0.0,0.5235047340393066,161.69724796668618,25,-161,-15,319,825,1361,1050,28,17.39
-9,-1,0,-9.0,-1.0,0.5326488018035889,152.64337522473747,25,-152,-14,319,825,1361,1050,28,18.67
-8,0,0,-8.0,-0.0,0.5394847393035889,144.6789549312546,25,-144,-14,319,825,1361,1050,28,15.13
-8,0,0,-8.0,-0.0,0.5479927062988281,136.7186892857008,25,-136,-14,319,825,1361,1050,28,14.55
-7,0,0,-7.0,-0.0,0.5554728507995605,129.75746606650424,25,-129,-14,319,825,1361,1050,28,13.01
-7,0,0,-7.0,-0.0,0.5635266304016113,122.80065146407001,25,-122,-14,319,825,1361,1050,28,12.53
-7,0,0,-7.0,-0.0,0.571516752243042,115.84903970253703,25,-115,-14,319,825,1361,1050,28,12.03
-6,0,0,-6.0,-0.0,0.5794768333435059,109.89540481748998,25,-109,-14,319,825,1361,1050,28,10.65
-7,0,0,-7.0,-0.0,0.5875437259674072,102.95630140987001,25,-102,-14,319,825,1361,1050,28,11.08
-9,1,0,-9.0,1.0,0.595531702041626,94.2019108086455,25,-93,-15,319,825,1361,1050,28,11.0
-8,0,0,-8.0,-0.0,0.6034796237945557,86.31338250816034,25,-85,-15,319,825,1361,1050,28,10.41
-8,1,0,-8.0,1.0,0.6114966869354248,78.64477096412705,25,-77,-16,319,825,1361,1050,28,8.82
-7,0,0,-7.0,-0.0,0.6195106506347656,71.80529228406496,25,-70,-16,319,825,1361,1050,28,8.34
-8,1,0,-8.0,1.0,0.6306467056274414,64.28841264178172,25,-62,-17,319,825,1361,1050,28,7.43
-9,0,0,-9.0,-0.0,0.6356716156005859,55.65968020030299,25,-53,-17,319,825,1361,1050,28,7.69
-8,0,0,-8.0,-0.0,0.6435556411743164,48.104053883222775,25,-45,-17,319,825,1361,1050,28,6.34
-8,0,0,-8.0,-0.0,0.6514906883239746,40.718546143004666,25,-37,-17,319,825,1361,1050,28,5.42
-5,0,0,-5.0,-0.0,0.6595888137817383,36.235341863986875,25,-32,-17,319,825,1361,1050,28,3.7
-4,0,0,-4.0,-0.0,0.667489767074585,32.7566787083184,25,-28,-17,319,825,1361,1050,28,2.92
-3,1,0,-3.0,1.0,0.6754786968231201,30.805843601498726,25,-25,-18,319,825,1361,1050,28,1.34
-2,0,0,-2.0,-0.0,0.6835358142852783,29.206163733020468,25,-23,-18,319,825,1361,1050,28,1.77
-2,0,0,-2.0,-0.0,0.6914746761322021,27.65863337187866,25,-21,-18,319,825,1361,1050,28,1.6
-1,0,0,-1.0,-0.0,0.7023117542266846,26.90724809414742,25,-20,-18,319,825,1361,1050,28,1.33
-1,0,0,-1.0,-0.0,0.7076277732849121,26.1725046566048,25,-19,-18,319,825,1361,1050,28,1.26
-1,0,0,-1.0,-0.0,0.7166357040405273,25.45584412271571,25,-18,-18,319,825,1361,1050,28,1.19
-1,0,0,-1.0,-0.0,0.7245116233825684,24.758836806279895,25,-17,-18,319,825,1361,1050,28,1.11
-1,0,0,-1.0,-0.0,0.7315127849578857,24.08318915758459,25,-16,-18,319,825,1361,1050,28,1.04
-1,-1,0,-1.0,-1.0,0.739494800567627,22.67156809750927,25,-15,-17,319,825,1361,1050,28,4.77
-1,0,0,-1.0,-0.0,0.7474677562713623,22.02271554554524,25,-14,-17,319,825,1361,1050,28,0.92
-1,0,0,-1.0,-0.0,0.7554776668548584,21.400934559032695,25,-13,-17,319,825,1361,1050,28,0.83
-1,0,0,-1.0,-0.0,0.7878127098083496,20.808652046684813,25,-12,-17,319,825,1361,1050,28,0.75
-1,0,0,-1.0,-0.0,0.8195128440856934,20.248456731316587,25,-11,-17,319,825,1361,1050,28,0.66
0,0,1,-0.0,-0.0,0.8474907875061035,20.248456731316587,25,-11,-17,319,825,330,842,28,32.980000000000004
0,0,0,-0.0,-0.0,0.08222842216491699,738.9215113934632,26,454,-583,784,259,330,842,16,172.31
1,0,0,1.0,-0.0,0.09028458595275879,738.307524003379,26,453,-583,784,259,330,842,16,7.02
2,-1,0,2.0,-1.0,0.09866547584533691,736.2913825381905,26,451,-582,784,259,330,842,16,20.37
2,0,0,2.0,-0.0,0.1062314510345459,735.0680240630795,26,449,-582,784,259,330,842,16,12.61
2,0,0,2.0,-0.0,0.11459851264953613,733.8480769205572,26,447,-582,784,259,330,842,16,12.56
2,-1,0,2.0,-1.0,0.1223454475402832,731.8374136377561,26,445,-581,784,259,330,842,16,20.24
3,0,0,3.0,-0.0,0.13692641258239746,730.0171230868492,26,442,-581,784,259,330,842,16,17.65
2,-1,0,2.0,-1.0,0.1382904052734375,728.0109889280518,26,440,-580,784,259,330,842,16,20.13
3,-1,0,3.0,-1.0,0.14889836311340332,725.4033360827616,26,437,-579,784,259,330,842,16,24.39
5,-1,0,5.0,-1.0,0.15424156188964844,721.6009977820153,26,432,-578,784,259,330,842,16,32.48
5,-2,0,5.0,-2.0,0.16346454620361328,717.0111575143026,26,427,-576,784,259,330,842,16,37.77
8,-2,0,8.0,-2.0,0.17665553092956543,710.6595528099232,26,419,-574,784,259,330,842,16,47.11
9,-4,0,9.0,-4.0,0.17824840545654297,702.1395872616783,26,410,-570,784,259,330,842,16,57.27
9,-4,0,9.0,-4.0,0.18622851371765137,693.6548132897227,26,401,-566,784,259,330,842,16,56.67
12,-6,0,12.0,-6.0,0.19423651695251465,681.851156778369,26,389,-560,784,259,330,842,16,68.41
14,-8,0,14.0,-8.0,0.20226740837097168,667.3297535701522,26,375,-552,784,259,330,842,16,75.55
13,-10,0,13.0,-10.0,0.21041536331176758,651.7729666072381,26,362,-542,784,259,330,842,16,77.53
13,-9,0,13.0,-9.0,0.21823549270629883,637.0949693726988,26,349,-533,784,259,330,842,16,74.02
11,-10,0,11.0,-10.0,0.22623944282531738,622.7142201684493,26,338,-523,784,259,330,842,16,72.76
11,-11,0,11.0,-11.0,0.23527836799621582,607.5137858518109,26,327,-512,784,259,330,842,16,73.9
11,-12,0,11.0,-12.0,0.2447655200958252,591.486263576763,26,316,-500,784,259,330,842,16,74.82
12,-14,0,12.0,-14.0,0.25029444694519043,573.2468927085432,26,304,-486,784,259,330,842,16,78.1
11,-17,0,11.0,-17.0,0.2582523822784424,553.0009041583928,26,293,-469,784,259,330,842,16,82.36
14,-25,0,14.0,-25.0,0.26937437057495117,524.3824939869751,26,279,-444,784,259,330,842,16,89.46
13,-28,0,13.0,-28.0,0.27428436279296875,493.7732273017645,26,266,-416,784,259,330,842,16,86.78
14,-28,0,14.0,-28.0,0.2822554111480713,462.6532178640931,26,252,-388,784,259,330,842,16,83.84
12,-23,0,12.0,-23.0,0.2939743995666504,436.83520920365385,26,240,-365,784,259,330,842,16,75.88
13,-20,0,13.0,-20.0,0.29879236221313477,412.9818397944394,26,227,-345,784,259,330,842,16,73.72
11,-19,0,11.0,-19.0,0.3062245845794678,391.0652119531984,26,216,-326,784,259,330,842,16,66.93
13,-20,0,13.0,-20.0,0.31423044204711914,367.21247255505904,26,203,-306,784,259,330,842,16,68.1
14,-19,0,14.0,-19.0,0.3222813606262207,343.64225584174017,26,189,-287,784,259,330,842,16,63.32
13,-18,0,13.0,-18.0,0.33026957511901855,321.4607285501605,26,176,-269,784,259,330,842,16,59.34
14,-18,0,14.0,-18.0,0.3394603729248047,298.73901653449957,26,162,-251,784,259,330,842,16,56.21
11,-15,0,11.0,-15.0,0.3462674617767334,280.17316074170986,26,151,-236,784,259,330,842,16,50.03
10,-13,0,10.0,-13.0,0.35424041748046875,263.8370709358334,26,141,-223,784,259,330,842,16,45.0
8,-12,0,8.0,-12.0,0.3622305393218994,249.41932563456265,26,133,-211,784,259,330,842,16,42.37
8,-11,0,8.0,-11.0,0.3702833652496338,235.8495283014151,26,125,-200,784,259,330,842,16,38.6
7,-12,0,7.0,-12.0,0.37824058532714844,221.96396103872357,26,118,-188,784,259,330,842,16,38.36
7,-10,0,7.0,-10.0,0.3862583637237549,209.77368757782756,26,111,-178,784,259,330,842,16,34.22
7,-9,0,7.0,-9.0,0.39421653747558594,198.4363877921587,26,104,-169,784,259,330,842,16,30.93
5,-8,0,5.0,-8.0,0.4022793769836426,189.0026454841307,26,99,-161,784,259,330,842,16,29.82
6,-8,0,6.0,-8.0,0.4102354049682617,179.0474797365213,26,93,-153,784,259,330,842,16,27.14
5,-7,0,5.0,-7.0,0.42167043685913086,170.46993869888027,26,88,-146,784,259,330,842,16,24.55
4,-5,0,4.0,-5.0,0.4265613555908203,164.12495239907915,26,84,-141,784,259,330,842,16,19.56
4,-5,0,4.0,-5.0,0.4342653751373291,157.78466338652817,26,80,-136,784,259,330,842,16,19.02
3,-4,0,3.0,-4.0,0.4449653625488281,152.81688388394784,26,77,-132,784,259,330,842,16,16.41
3,-4,0,3.0,-4.0,0.4504694938659668,147.85127662620977,26,74,-128,784,259,330,842,16,16.04
3,-4,0,3.0,-4.0,0.45833754539489746,142.88806808127822,26,71,-124,784,259,330,842,16,15.66
3,-4,0,3.0,-4.0,0.46850156784057617,137.92751719653333,26,68,-120,784,259,330,842,16,15.28
4,-4,0,4.0,-4.0,0.47449541091918945,132.48396129343357,26,64,-116,784,259,330,842,16,14.67
3,-5,0,3.0,-5.0,0.48259854316711426,126.65701717630967,26,61,-111,784,259,330,842,16,17.4
3,-6,0,3.0,-6.0,0.4902315139770508,119.95415791042844,26,58,-105,784,259,330,842,16,18.05
3,-4,0,3.0,-4.0,0.4982414245605469,115.00434774390054,26,55,-101,784,259,330,842,16,13.54
3,-5,0,3.0,-5.0,0.5062453746795654,109.17875251164945,26,52,-96,784,259,330,842,16,15.88
4,-5,0,4.0,-5.0,0.5168304443359375,102.88342918079665,26,48,-91,784,259,330,842,16,14.12
3,-5,0,3.0,-5.0,0.5223605632781982,97.06183596038146,26,45,-86,784,259,330,842,16,14.57
4,-5,0,4.0,-5.0,0.530259370803833,90.78546139112804,26,41,-81,784,259,330,842,16,12.94
4,-5,0,4.0,-5.0,0.5382213592529297,84.52810183601665,26,37,-76,784,259,330,842,16,12.26
5,-6,0,5.0,-6.0,0.546229362487793,76.96752561957543,26,32,-70,784,259,330,842,16,12.56
5,-6,0,5.0,-6.0,0.554227352142334,69.46221994724903,26,27,-64,784,259,330,842,16,11.59
4,-4,0,4.0,-4.0,0.5624165534973145,64.25729530566937,26,23,-60,784,259,330,842,16,8.55
4,-5,0,4.0,-5.0,0.5702614784240723,58.18934610390462,26,19,-55,784,259,330,842,16,9.08
4,-3,0,4.0,-3.0,0.5782375335693359,54.120236510939236,26,15,-52,784,259,330,842,16,6.04
4,-4,0,4.0,-4.0,0.5870823860168457,49.24428900898052,26,11,-48,784,259,330,842,16,6.58
3,-4,0,3.0,-4.0,0.5942504405975342,44.721359549995796,26,8,-44,784,259,330,842,16,6.22
4,-3,0,4.0,-3.0,0.6022624969482422,41.19465984809196,26,4,-41,784,259,330,842,16,4.24
4,-4,0,4.0,-4.0,0.6102595329284668,37.0,26,0,-37,784,259,330,842,16,4.51
4,-4,0,4.0,-4.0,0.6191165447235107,33.24154027718932,26,-4,-33,784,259,330,842,16,3.66
4,-3,0,4.0,-3.0,0.6262285709381104,31.04834939252005,26,-8,-30,784,259,330,842,16,1.87
2,-3,0,2.0,-3.0,0.6342465877532959,28.792360097775937,26,-10,-27,784,259,330,842,16,2.29
3,-2,0,3.0,-2.0,0.6422395706176758,28.178005607210743,26,-13,-25,784,259,330,842,16,0.12
2,-3,0,2.0,-3.0,0.6502664089202881,26.627053911388696,26,-15,-22,784,259,330,842,16,1.23
1,-1,0,1.0,-1.0,0.6582295894622803,26.40075756488817,26,-16,-21,784,259,330,842,16,0.11
1,-2,0,1.0,-2.0,0.6662275791168213,25.495097567963924,26,-17,-19,784,259,330,842,16,0.82
1,-1,0,1.0,-1.0,0.6751434803009033,25.45584412271571,26,-18,-18,784,259,330,842,16,-0.21
1,-2,0,1.0,-2.0,0.6822834014892578,24.839484696748443,26,-19,-16,784,259,330,842,16,0.38
1,-1,0,1.0,-1.0,0.6902585029602051,25.0,26,-20,-15,784,259,330,842,16,4.74
0,-2,0,-0.0,-2.0,0.698223352432251,23.853720883753127,26,-20,-13,784,259,330,842,16,1.28
2,-1,0,2.0,-1.0,0.7062413692474365,25.059928172283335,26,-22,-12,784,259,330,842,16,0.81
0,-2,0,-0.0,-2.0,0.7178065776824951,24.166091947189145,26,-22,-10,784,259,330,842,16,0.87
0,-1,0,-0.0,-1.0,0.7223553657531738,23.769728648009426,26,-22,-9,784,259,330,842,16,0.6
1,-2,0,1.0,-2.0,0.730271577835083,24.041630560342615,26,-23,-7,784,259,330,842,16,2.78
0,-2,0,-0.0,-2.0,0.7382135391235352,23.53720459187964,26,-23,-5,784,259,330,842,16,0.26
0,-2,0,-0.0,-2.0,0.7464454174041748,23.194827009486403,26,-23,-3,784,259,330,842,16,0.02
0,-1,0,-0.0,-1.0,0.7542705535888672,23.08679276123039,26,-23,-2,784,259,330,842,16,0.0
0,-1,0,-0.0,-1.0,0.7622385025024414,23.021728866442675,26,-23,-1,784,259,330,842,16,-0.08
0,-1,0,-0.0,-1.0,0.77030348777771,23.0,26,-23,0,784,259,330,842,16,-0.16
0,-1,0,-0.0,-1.0,0.7785303592681885,23.021728866442675,26,-23,1,784,259,330,842,16,12.53
-1,0,0,-1.0,-0.0,0.7942395210266113,22.02271554554524,26,-22,1,784,259,330,842,16,5.43
-1,0,0,-1.0,-0.0,0.8102943897247314,21.02379604162864,26,-21,1,784,259,330,842,16,5.34
-1,0,0,-1.0,-0.0,0.8182344436645508,20.024984394500787,26,-20,1,784,259,330,842,16,5.25
-1,0,0,-1.0,-0.0,0.8262295722961426,19.026297590440446,26,-19,1,784,259,330,842,16,5.16
-1,0,0,-1.0,-0.0,0.8345344066619873,18.027756377319946,26,-18,1,784,259,330,842,16,5.06
-2,0,0,-2.0,-0.0,0.8449444770812988,16.0312195418814,26,-16,1,784,259,330,842,16,5.29
-2,0,0,-2.0,-0.0,0.8502514362335205,14.035668847618199,26,-14,1,784,259,330,842,16,4.97
-2,0,0,-2.0,-0.0,0.8584384918212891,12.041594578792296,26,-12,1,784,259,330,842,16,4.61
-3,0,0,-3.0,-0.0,0.8662264347076416,9.055385138137417,26,-9,1,784,259,330,842,16,4.25
-1,0,0,-1.0,-0.0,0.8742294311523438,8.06225774829855,26,-8,1,784,259,330,842,16,3.46
-1,0,0,-1.0,-0.0,0.8822555541992188,7.0710678118654755,26,-7,1,784,259,330,842,16,3.18
-2,0,0,-2.0,-0.0,0.8922693729400635,5.0990195135927845,26,-5,1,784,259,330,842,16,2.58
-2,0,0,-2.0,-0.0,0.8982734680175781,3.1622776601683795,26,-3,1,784,259,330,842,16,1.47
-1,0,0,-1.0,-0.0,0.9062345027923584,2.23606797749979,26,-2,1,784,259,330,842,16,0.59
-1,0,0,-1.0,-0.0,0.9222395420074463,1.4142135623730951,26,-1,1,784,259,330,842,16,-0.56
0,0,1,-0.0,-0.0,0.9274303913116455,1.4142135623730951,26,-1,1,784,259,330,842,16,27.34
0,0,0,-0.0,-0.0,0.10172581672668457,862.2418454238926,27,625,594,1410,852,785,258,70,188.79
1,0,0,1.0,-0.0,0.16377782821655273,861.517266222796,27,624,594,1410,852,785,258,70,3.02
2,2,0,2.0,2.0,0.17175984382629395,858.6896994840453,27,622,592,1410,852,785,258,70,12.4
3,4,0,3.0,4.0,0.1798839569091797,853.7593337703547,27,619,588,1410,852,785,258,70,15.08
4,5,0,4.0,5.0,0.18873190879821777,847.4160725405201,27,615,583,1410,852,785,258,70,18.39
5,7,0,5.0,7.0,0.1958017349243164,838.9731819313416,27,610,576,1410,852,785,258,70,22.21
7,7,0,7.0,7.0,0.203826904296875,829.0778009330608,27,603,569,1410,852,785,258,70,27.17
7,9,0,7.0,9.0,0.21170282363891602,817.8117142716898,27,596,560,1410,852,785,258,70,27.64
11,11,0,11.0,11.0,0.21970391273498535,802.2630491303959,27,585,549,1410,852,785,258,70,36.68
18,14,0,18.0,14.0,0.22774291038513184,779.5601323823583,27,567,535,1410,852,785,258,70,45.61
26,19,0,26.0,19.0,0.23633384704589844,747.6208932339973,27,541,516,1410,852,785,258,70,55.44
28,19,0,28.0,19.0,0.24370479583740234,714.2674569095249,27,513,497,1410,852,785,258,70,55.08
31,19,0,31.0,19.0,0.2517268657684326,678.8284024700204,27,482,478,1410,852,785,258,70,55.09
31,19,0,31.0,19.0,0.2598838806152344,643.4920356927504,27,451,459,1410,852,785,258,70,53.13
31,20,0,31.0,20.0,0.2705118656158447,607.5532898437799,27,420,439,1410,852,785,258,70,51.86
29,20,0,29.0,20.0,0.2760138511657715,573.0985953568548,27,391,419,1410,852,785,258,70,48.8
30,22,0,30.0,22.0,0.2843637466430664,536.5910919871853,27,361,397,1410,852,785,258,70,48.62
30,23,0,30.0,23.0,0.29169678688049316,499.43668267358976,27,331,374,1410,852,785,258,70,46.99
29,22,0,29.0,22.0,0.299724817276001,463.7973695483837,27,302,352,1410,852,785,258,70,43.52
28,23,0,28.0,23.0,0.3077857494354248,428.15534563987404,27,274,329,1410,852,785,258,70,41.45
26,22,0,26.0,22.0,0.31617093086242676,394.65554601449605,27,248,307,1410,852,785,258,70,37.8
24,21,0,24.0,21.0,0.3237159252166748,363.27950671624734,27,224,286,1410,852,785,258,70,34.35
21,22,0,21.0,22.0,0.33202385902404785,333.02402315748935,27,203,264,1410,852,785,258,70,32.43
20,20,0,20.0,20.0,0.34217190742492676,305.0,27,183,244,1410,852,785,258,70,28.81
16,18,0,16.0,18.0,0.34773993492126465,281.0071173475861,27,167,226,1410,852,785,258,70,25.31
15,18,0,15.0,18.0,0.35594773292541504,257.6198750096739,27,152,208,1410,852,785,258,70,23.99
11,15,0,11.0,15.0,0.3637077808380127,239.0188277102873,27,141,193,1410,852,785,258,70,22.47
11,14,0,11.0,14.0,0.3720438480377197,221.22612865572637,27,130,179,1410,852,785,258,70,19.08
9,13,0,9.0,13.0,0.37987184524536133,205.41908382621125,27,121,166,1410,852,785,258,70,17.53
9,12,0,9.0,12.0,0.3877067565917969,190.4205871222962,27,112,154,1410,852,785,258,70,16.8
6,8,0,6.0,8.0,0.39603281021118164,180.42172818150257,27,106,146,1410,852,785,258,70,13.2
6,8,0,6.0,8.0,0.40686988830566406,170.42300314218147,27,100,138,1410,852,785,258,70,12.82
5,6,0,5.0,6.0,0.4118928909301758,162.63148526653748,27,95,132,1410,852,785,258,70,9.65
3,5,0,3.0,5.0,0.4197249412536621,156.82155464093577,27,92,127,1410,852,785,258,70,8.02
1,4,0,1.0,4.0,0.43013882637023926,153.00326793895613,27,91,123,1410,852,785,258,70,4.65
2,3,0,2.0,3.0,0.43578481674194336,149.40214188558343,27,89,120,1410,852,785,258,70,7.12
2,3,0,2.0,3.0,0.4442267417907715,145.8012345626744,27,87,117,1410,852,785,258,70,7.04
2,3,0,2.0,3.0,0.451779842376709,142.20056258679148,27,85,114,1410,852,785,258,70,6.96
2,4,0,2.0,4.0,0.45970988273620605,137.80058055030102,27,83,110,1410,852,785,258,70,5.8
3,4,0,3.0,4.0,0.4677407741546631,132.80060240827223,27,80,106,1410,852,785,258,70,9.65
2,2,0,2.0,2.0,0.4760608673095703,130.0,27,78,104,1410,852,785,258,70,5.1
1,1,0,1.0,1.0,0.4867417812347412,128.6001555209013,27,77,103,1410,852,785,258,70,4.27
1,1,0,1.0,1.0,0.4927678108215332,127.20062892926276,27,76,102,1410,852,785,258,70,4.24
0,1,0,-0.0,1.0,0.5717658996582031,126.40015822774906,27,76,101,1410,852,785,258,70,1.85
1,2,0,1.0,2.0,0.5877208709716797,124.2014492669067,27,75,99,1410,852,785,258,70,4.35
1,1,0,1.0,1.0,0.595714807510376,122.80065146407001,27,74,98,1410,852,785,258,70,4.27
1,3,0,1.0,3.0,0.604050874710083,119.80818002123227,27,73,95,1410,852,785,258,70,3.91
2,2,0,2.0,2.0,0.6119787693023682,117.00427342623003,27,71,93,1410,852,785,258,70,5.02
3,4,0,3.0,4.0,0.6197078227996826,112.0044641967453,27,68,89,1410,852,785,258,70,8.79
4,5,0,4.0,5.0,0.6277768611907959,105.60303025955268,27,64,84,1410,852,785,258,70,8.54
5,5,0,5.0,5.0,0.635739803314209,98.60020283954795,27,59,79,1410,852,785,258,70,6.44
6,6,0,6.0,6.0,0.6458897590637207,90.21086409075129,27,53,73,1410,852,785,258,70,6.57
8,7,0,8.0,7.0,0.6518328189849854,79.88116173416608,27,45,66,1410,852,785,258,70,6.13
8,8,0,8.0,8.0,0.6598148345947266,68.79680225126747,27,37,58,1410,852,785,258,70,6.03
7,7,0,7.0,7.0,0.6677079200744629,59.16924876994806,27,30,51,1410,852,785,258,70,4.96
8,6,0,8.0,6.0,0.6758148670196533,50.08991914547278,27,22,45,1410,852,785,258,70,3.48
7,6,0,7.0,6.0,0.6838817596435547,41.78516483155236,27,15,39,1410,852,785,258,70,2.86
7,6,0,7.0,6.0,0.6924779415130615,33.95585369269929,27,8,33,1410,852,785,258,70,2.02
6,5,0,6.0,5.0,0.6997349262237549,28.071337695236398,27,2,28,1410,852,785,258,70,1.04
5,3,0,5.0,3.0,0.7088828086853027,25.179356624028344,27,-3,25,1410,852,785,258,70,-0.02
2,2,0,2.0,2.0,0.7157437801361084,23.53720459187964,27,-5,23,1410,852,785,258,70,0.3
2,1,0,2.0,1.0,0.7237088680267334,23.08679276123039,27,-7,22,1410,852,785,258,70,-0.27
0,0,1,-0.0,-0.0,0.7597198486328125,23.08679276123039,27,-7,22,1410,852,785,258,70,33.84
0,0,0,-0.0,-0.0,0.10440421104431152,703.9602261491767,28,-158,-686,1259,144,1417,830,16,167.36
-1,1,0,-1.0,1.0,0.12240314483642578,704.7112884011437,28,-157,-687,1259,144,1417,830,16,13.09
-1,0,0,-1.0,-0.0,0.13039922714233398,704.4891766379382,28,-156,-687,1259,144,1417,830,16,2.54
-1,0,0,-1.0,-0.0,0.14637017250061035,704.2684147397213,28,-155,-687,1259,144,1417,830,16,2.53
-1,1,0,-1.0,1.0,0.15454721450805664,705.0248222580535,28,-154,-688,1259,144,1417,830,16,13.02
-2,0,0,-2.0,-0.0,0.16241216659545898,704.5906613062651,28,-152,-688,1259,144,1417,830,16,4.57
-1,0,0,-1.0,-0.0,0.17836308479309082,704.3756100263552,28,-151,-688,1259,144,1417,830,16,2.47
-1,0,0,-1.0,-0.0,0.18637824058532715,704.1619131989461,28,-150,-688,1259,144,1417,830,16,2.45
-2,0,0,-2.0,-0.0,0.19440007209777832,703.7385878293161,28,-148,-688,1259,144,1417,830,16,4.46
-2,-2,0,-2.0,-2.0,0.202362060546875,701.3643846104534,28,-146,-686,1259,144,1417,830,16,22.23
-1,-3,0,-1.0,-3.0,0.2103731632232666,698.2220277247059,28,-145,-683,1259,144,1417,830,16,29.94
-3,-6,0,-3.0,-6.0,0.21846222877502441,691.7318844754809,28,-142,-677,1259,144,1417,830,16,48.43
-3,-9,0,-3.0,-9.0,0.2316141128540039,682.3085812152739,28,-139,-668,1259,144,1417,830,16,61.96
-4,-15,0,-4.0,-15.0,0.23440313339233398,666.8088181780442,28,-135,-653,1259,144,1417,830,16,80.76
-6,-19,0,-6.0,-19.0,0.24235820770263672,646.9907263632145,28,-129,-634,1259,144,1417,830,16,87.82
-9,-22,0,-9.0,-22.0,0.2503671646118164,623.6537500889416,28,-120,-612,1259,144,1417,830,16,90.93
-11,-25,0,-11.0,-25.0,0.2585151195526123,597.0343373709757,28,-109,-587,1259,144,1417,830,16,92.71
-11,-26,0,-11.0,-26.0,0.266416072845459,569.4953906749378,28,-98,-561,1259,144,1417,830,16,91.08
-12,-28,0,-12.0,-28.0,0.274367094039917,539.8935080180164,28,-86,-533,1259,144,1417,830,16,90.12
-11,-30,0,-11.0,-30.0,0.2823772430419922,508.56071417285074,28,-75,-503,1259,144,1417,830,16,88.57
-9,-30,0,-9.0,-30.0,0.2904021739959717,477.582453614033,28,-66,-473,1259,144,1417,830,16,85.06
-9,-33,0,-9.0,-33.0,0.29979920387268066,443.6766840842552,28,-57,-440,1259,144,1417,830,16,83.49
-9,-32,0,-9.0,-32.0,0.30651116371154785,410.81382644696856,28,-48,-408,1259,144,1417,830,16,78.37
-8,-30,0,-8.0,-30.0,0.31488704681396484,380.11051024669126,28,-40,-378,1259,144,1417,830,16,72.79
-9,-30,0,-9.0,-30.0,0.3265371322631836,349.3780187705002,28,-31,-348,1259,144,1417,830,16,68.37
-7,-27,0,-7.0,-27.0,0.33039021492004395,321.895945920417,28,-24,-321,1259,144,1417,830,16,62.4
-4,-24,0,-4.0,-24.0,0.3388540744781494,297.6726389845059,28,-20,-297,1259,144,1417,830,16,57.29
-3,-22,0,-3.0,-22.0,0.34641504287719727,275.5249534978638,28,-17,-275,1259,144,1417,830,16,52.89
0,-19,0,-0.0,-19.0,0.35438108444213867,256.56383221335,28,-17,-256,1259,144,1417,830,16,47.49
0,-17,0,-0.0,-17.0,0.36252808570861816,239.60383970212163,28,-17,-239,1259,144,1417,830,16,43.17
2,-14,0,2.0,-14.0,0.3703601360321045,225.80079716422614,28,-19,-225,1259,144,1417,830,16,36.24
3,-16,0,3.0,-16.0,0.37839722633361816,210.1547049199708,28,-22,-209,1259,144,1417,830,16,36.22
2,-13,0,2.0,-13.0,0.3863801956176758,197.46392075515973,28,-24,-196,1259,144,1417,830,16,31.36
2,-11,0,2.0,-11.0,0.39443325996398926,186.81809334215998,28,-26,-185,1259,144,1417,830,16,27.29
2,-12,0,2.0,-12.0,0.4023771286010742,175.2512482123879,28,-28,-173,1259,144,1417,830,16,27.23
2,-11,0,2.0,-11.0,0.41036415100097656,164.75436261295178,28,-30,-162,1259,144,1417,830,16,24.59
2,-9,0,2.0,-9.0,0.4183821678161621,156.31058825300352,28,-32,-153,1259,144,1417,830,16,20.72
2,-10,0,2.0,-10.0,0.4271571636199951,146.98639392814562,28,-34,-143,1259,144,1417,830,16,20.98
2,-10,0,2.0,-10.0,0.4343690872192383,137.78606605894515,28,-36,-133,1259,144,1417,830,16,19.78
2,-10,0,2.0,-10.0,0.4423642158508301,128.73616430514,28,-38,-123,1259,144,1417,830,16,18.55
2,-10,0,2.0,-10.0,0.4503810405731201,119.87076374162301,28,-40,-113,1259,144,1417,830,16,17.3
2,-11,0,2.0,-11.0,0.45842814445495605,110.30865786510141,28,-42,-102,1259,144,1417,830,16,16.92
1,-8,0,1.0,-8.0,0.4693591594696045,103.36827366266692,28,-43,-94,1259,144,1417,830,16,13.41
1,-8,0,1.0,-8.0,0.47440624237060547,96.60227740586657,28,-44,-86,1259,144,1417,830,16,12.47
1,-6,0,1.0,-6.0,0.4823920726776123,91.7877987534291,28,-45,-80,1259,144,1417,830,16,9.5
0,-4,0,-0.0,-4.0,0.4927692413330078,88.32326986700618,28,-45,-76,1259,144,1417,830,16,7.78
1,-5,0,1.0,-5.0,0.4985160827636719,84.59905436823747,28,-46,-71,1259,144,1417,830,16,7.36
0,-5,0,-0.0,-5.0,0.5063700675964355,80.44874144447506,28,-46,-66,1259,144,1417,830,16,8.03
0,-5,0,-0.0,-5.0,0.5143861770629883,76.40026177965623,28,-46,-61,1259,144,1417,830,16,7.54
0,-4,0,-0.0,-4.0,0.5248091220855713,73.24616030891995,28,-46,-57,1259,144,1417,830,16,6.16
0,-5,0,-0.0,-5.0,0.5304832458496094,69.42621983083913,28,-46,-52,1259,144,1417,830,16,6.64
0,-4,0,-0.0,-4.0,0.5385282039642334,66.48308055437865,28,-46,-48,1259,144,1417,830,16,5.34
-1,-3,0,-1.0,-3.0,0.546363115310669,63.63961030678928,28,-45,-45,1259,144,1417,830,16,5.84
0,-2,0,-0.0,-2.0,0.5544161796569824,62.24146527838174,28,-45,-43,1259,144,1417,830,16,3.1
-1,-2,0,-1.0,-2.0,0.5624780654907227,60.14149981501958,28,-44,-41,1259,144,1417,830,16,5.15
-1,-2,0,-1.0,-2.0,0.5722551345825195,58.05170109479997,28,-43,-39,1259,144,1417,830,16,5.0
-1,-1,0,-1.0,-1.0,0.5784001350402832,56.639209034025185,28,-42,-38,1259,144,1417,830,16,6.7
-1,-1,0,-1.0,-1.0,0.5863971710205078,55.226805085936306,28,-41,-37,1259,144,1417,830,16,6.64
-1,0,0,-1.0,-0.0,0.5971190929412842,54.48853090330111,28,-40,-37,1259,144,1417,830,16,2.18
-1,-1,0,-1.0,-1.0,0.6026022434234619,53.075418038862395,28,-39,-36,1259,144,1417,830,16,6.85
-3,-1,0,-3.0,-1.0,0.6117181777954102,50.20956084253277,28,-36,-35,1259,144,1417,830,16,5.19
-2,0,0,-2.0,-0.0,0.6211321353912354,48.79549159502341,28,-34,-35,1259,144,1417,830,16,2.73
-2,-2,0,-2.0,-2.0,0.6263821125030518,45.967379738244816,28,-32,-33,1259,144,1417,830,16,9.05
-1,0,0,-1.0,-0.0,0.634418249130249,45.27692569068709,28,-31,-33,1259,144,1417,830,16,1.83
-2,-1,0,-2.0,-1.0,0.6441781520843506,43.18564576337837,28,-29,-32,1259,144,1417,830,16,4.37
-2,-2,0,-2.0,-2.0,0.6503782272338867,40.36087214122113,28,-27,-30,1259,144,1417,830,16,7.48
-1,-1,0,-1.0,-1.0,0.6584031581878662,38.948684188300895,28,-26,-29,1259,144,1417,830,16,6.08
-1,-2,0,-1.0,-2.0,0.6678910255432129,36.796738985948195,28,-25,-27,1259,144,1417,830,16,4.51
-1,-1,0,-1.0,-1.0,0.6743931770324707,35.38361202590826,28,-24,-26,1259,144,1417,830,16,6.32
0,-1,0,-0.0,-1.0,0.6823770999908447,34.655446902326915,28,-24,-25,1259,144,1417,830,16,1.77
0,-1,0,-0.0,-1.0,0.6913940906524658,33.94112549695428,28,-24,-24,1259,144,1417,830,16,1.7
-1,-2,0,-1.0,-2.0,0.6984100341796875,31.827660925679098,28,-23,-22,1259,144,1417,830,16,3.95
-1,-2,0,-1.0,-2.0,0.7064981460571289,29.732137494637012,28,-22,-20,1259,144,1417,830,16,3.73
-1,-2,0,-1.0,-2.0,0.7161030769348145,27.65863337187866,28,-21,-18,1259,144,1417,830,16,3.5
-1,-1,0,-1.0,-1.0,0.7251551151275635,26.248809496813376,28,-20,-17,1259,144,1417,830,16,5.16
-2,-2,0,-2.0,-2.0,0.7308461666107178,23.430749027719962,28,-18,-15,1259,144,1417,830,16,5.75
-3,-1,0,-3.0,-1.0,0.7383921146392822,20.518284528683193,28,-15,-14,1259,144,1417,830,16,3.4
-2,-2,0,-2.0,-2.0,0.748690128326416,17.69180601295413,28,-13,-12,1259,144,1417,830,16,6.36
-1,-2,0,-1.0,-2.0,0.7543861865997314,15.620499351813308,28,-12,-10,1259,144,1417,830,16,2.69
-2,-1,0,-2.0,-1.0,0.762869119644165,13.45362404707371,28,-10,-9,1259,144,1417,830,16,3.17
0,-1,0,-0.0,-1.0,0.7703711986541748,12.806248474865697,28,-10,-8,1259,144,1417,830,16,0.83
-1,-1,0,-1.0,-1.0,0.7785501480102539,11.40175425099138,28,-9,-7,1259,144,1417,830,16,3.82
-1,-2,0,-1.0,-2.0,0.7897400856018066,9.433981132056603,28,-8,-5,1259,144,1417,830,16,1.66
-1,0,0,-1.0,-0.0,0.7948782444000244,8.602325267042627,28,-7,-5,1259,144,1417,830,16,1.18
-1,-1,0,-1.0,-1.0,0.8023641109466553,7.211102550927978,28,-6,-4,1259,144,1417,830,16,2.78
-1,-2,0,-1.0,-2.0,0.8104052543640137,5.385164807134504,28,-5,-2,1259,144,1417,830,16,0.63
-1,0,0,-1.0,-0.0,0.8185491561889648,4.47213595499958,28,-4,-2,1259,144,1417,830,16,1.13
-2,-1,0,-2.0,-1.0,0.8264162540435791,2.23606797749979,28,-2,-1,1259,144,1417,830,16,7.99
-1,-1,0,-1.0,-1.0,0.8424110412597656,1.0,28,-1,0,1259,144,1417,830,16,-0.75
-1,0,0,-1.0,-0.0,0.8503620624542236,0.0,28,0,0,1259,144,1417,830,16,7.25
0,0,1,-0.0,-0.0,0.8764021396636963,0.0,28,0,0,1259,144,1417,830,16,26.93
0,0,0,-0.0,-0.0,0.09672713279724121,328.6959080974389,29,-304,125,955,269,1259,144,30,102.95
-2,3,0,-2.0,3.0,0.18074727058410645,325.7115288103877,29,-302,122,955,269,1259,144,30,10.03
-2,3,0,-2.0,3.0,0.18870925903320312,322.7398333023056,29,-300,119,955,269,1259,144,30,9.93
-3,5,0,-3.0,5.0,0.19674015045166016,318.1273329973393,29,-297,114,955,269,1259,144,30,13.7
-5,6,0,-5.0,6.0,0.20472407341003418,311.33261955664074,29,-292,108,955,269,1259,144,30,18.54
-7,7,0,-7.0,7.0,0.21279621124267578,302.3673262771624,29,-285,101,955,269,1259,144,30,22.45
-9,9,0,-9.0,9.0,0.2209150791168213,290.9295447354909,29,-276,92,955,269,1259,144,30,25.78
-10,8,0,-10.0,8.0,0.2286972999572754,278.94802383239784,29,-266,84,955,269,1259,144,30,26.15
-9,7,0,-9.0,7.0,0.23673319816589355,268.28715958837836,29,-257,77,955,269,1259,144,30,23.56
-10,8,0,-10.0,8.0,0.24475717544555664,256.4566240127168,29,-247,69,955,269,1259,144,30,24.34
-12,7,0,-12.0,7.0,0.2593262195587158,243.04114877937852,29,-235,62,955,269,1259,144,30,25.99
-14,7,0,-14.0,7.0,0.26089930534362793,227.74108105478027,29,-221,55,955,269,1259,144,30,27.2
-13,4,0,-13.0,4.0,0.268740177154541,214.1611542740653,29,-208,51,955,269,1259,144,30,26.02
-11,5,0,-11.0,5.0,0.2770371437072754,202.2992832414391,29,-197,46,955,269,1259,144,30,21.64
-11,4,0,-11.0,4.0,0.2880442142486572,190.68298298484845,29,-186,42,955,269,1259,144,30,21.13
-10,4,0,-10.0,4.0,0.2927412986755371,180.05554698481245,29,-176,38,955,269,1259,144,30,18.92
-9,4,0,-9.0,4.0,0.30081915855407715,170.42593699317015,29,-167,34,955,269,1259,144,30,16.83
-11,5,0,-11.0,5.0,0.30869126319885254,158.67261893597143,29,-156,29,955,269,1259,144,30,17.98
-12,5,0,-12.0,5.0,0.31673216819763184,145.98630072715727,29,-144,24,955,269,1259,144,30,17.85
-11,4,0,-11.0,4.0,0.32485008239746094,134.4953530795767,29,-133,20,955,269,1259,144,30,16.12
-9,3,0,-9.0,3.0,0.3360402584075928,125.15989773086265,29,-124,17,955,269,1259,144,30,13.7
-9,4,0,-9.0,4.0,0.3415191173553467,115.73245007343446,29,-115,13,955,269,1259,144,30,12.41
-7,2,0,-7.0,2.0,0.3487513065338135,108.55873986004075,29,-108,11,955,269,1259,144,30,10.82
-6,3,0,-6.0,3.0,0.35861921310424805,102.3132444994293,29,-102,8,955,269,1259,144,30,8.57
-5,1,0,-5.0,1.0,0.3649780750274658,97.25224933131366,29,-97,7,955,269,1259,144,30,8.83
-4,2,0,-4.0,2.0,0.37296414375305176,93.13431161500041,29,-93,5,955,269,1259,144,30,6.18
-5,2,0,-5.0,2.0,0.3828432559967041,88.05112151472007,29,-88,3,955,269,1259,144,30,7.03
-5,2,0,-5.0,2.0,0.389052152633667,83.00602387778854,29,-83,1,955,269,1259,144,30,6.67
-5,1,0,-5.0,1.0,0.39707016944885254,78.0,29,-78,0,955,269,1259,144,30,7.27
-4,1,0,-4.0,1.0,0.4066281318664551,74.00675644831355,29,-74,-1,955,269,1259,144,30,5.97
-2,1,0,-2.0,1.0,0.41272830963134766,72.02777242147643,29,-72,-2,955,269,1259,144,30,3.44
-2,0,0,-2.0,-0.0,0.4210991859436035,70.02856560004639,29,-70,-2,955,269,1259,144,30,7.0
-4,0,0,-4.0,-0.0,0.42984819412231445,66.03029607687671,29,-66,-2,955,269,1259,144,30,8.35
-5,1,0,-5.0,1.0,0.43679213523864746,61.07372593840988,29,-61,-3,955,269,1259,144,30,6.09
-6,1,0,-6.0,1.0,0.444730281829834,55.14526271584895,29,-55,-4,955,269,1259,144,30,6.36
-7,2,0,-7.0,2.0,0.4585411548614502,48.373546489791295,29,-48,-6,955,269,1259,144,30,5.57
-8,3,0,-8.0,3.0,0.46071624755859375,41.0,29,-40,-9,955,269,1259,144,30,4.72
-9,2,0,-9.0,2.0,0.4728713035583496,32.89376840679705,29,-31,-11,955,269,1259,144,30,4.37
-8,2,0,-8.0,2.0,0.4768662452697754,26.419689627245813,29,-23,-13,955,269,1259,144,30,2.81
-8,2,0,-8.0,2.0,0.4853792190551758,21.213203435596427,29,-15,-15,955,269,1259,144,30,1.46
-7,1,0,-7.0,1.0,0.4927182197570801,17.88854381999832,29,-8,-16,955,269,1259,144,30,0.3
-6,1,0,-6.0,1.0,0.5011301040649414,17.11724276862369,29,-2,-17,955,269,1259,144,30,-1.06
-6,1,0,-6.0,1.0,0.5087010860443115,18.439088914585774,29,4,-18,955,269,1259,144,30,-1.1
-4,0,0,-4.0,-0.0,0.5167112350463867,19.697715603592208,29,8,-18,955,269,1259,144,30,-0.53
-2,0,0,-2.0,-0.0,0.5249712467193604,20.591260281974,29,10,-18,955,269,1259,144,30,0.35
-2,0,0,-2.0,-0.0,0.5326902866363525,21.633307652783937,29,12,-18,955,269,1259,144,30,0.4
-2,0,0,-2.0,-0.0,0.5407512187957764,22.80350850198276,29,14,-18,955,269,1259,144,30,0.49
0,-1,0,-0.0,-1.0,0.6449182033538818,22.02271554554524,29,14,-17,955,269,1259,144,30,1.29
0,0,1,-0.0,-0.0,0.6516892910003662,22.02271554554524,29,14,-17,955,269,1259,144,30,33.519999999999996
0,0,0,-0.0,-0.0,0.08996319770812988,715.964384589066,30,714,53,1655,339,941,286,51,169.07
1,1,0,1.0,1.0,0.20096206665039062,714.8936983915861,30,713,52,1655,339,941,286,51,4.57
4,1,0,4.0,1.0,0.21096110343933105,710.8319069934888,30,709,51,1655,339,941,286,51,15.06
6,1,0,6.0,1.0,0.21726608276367188,704.775850891615,30,703,50,1655,339,941,286,51,20.95
9,2,0,9.0,2.0,0.2253251075744629,695.6579619324427,30,694,48,1655,339,941,286,51,27.43
13,0,0,13.0,-0.0,0.23488521575927734,682.6895341222099,30,681,48,1655,339,941,286,51,36.09
17,0,0,17.0,-0.0,0.24095606803894043,665.7326790837295,30,664,48,1655,339,941,286,51,42.75
18,-1,0,18.0,-1.0,0.24898505210876465,647.8556938084283,30,646,49,1655,339,941,286,51,42.85
25,-2,0,25.0,-2.0,0.2569410800933838,623.0906836087345,30,621,51,1655,339,941,286,51,51.5
29,-2,0,29.0,-2.0,0.2653942108154297,594.3677312909913,30,592,53,1655,339,941,286,51,54.82
29,-1,0,29.0,-1.0,0.27295422554016113,565.5837692154894,30,563,54,1655,339,941,286,51,53.47
33,-1,0,33.0,-1.0,0.28176021575927734,532.8461316365166,30,530,55,1655,339,941,286,51,55.47
33,-1,0,33.0,-1.0,0.2890031337738037,500.14497898109505,30,497,56,1655,339,941,286,51,53.16
32,1,0,32.0,1.0,0.29698801040649414,468.2413907377262,30,465,55,1655,339,941,286,51,50.89
31,2,0,31.0,2.0,0.30495119094848633,437.2241987813575,30,434,53,1655,339,941,286,51,48.45
31,4,0,31.0,4.0,0.3130052089691162,405.96797903282965,30,403,49,1655,339,941,286,51,48.32
32,6,0,32.0,6.0,0.3212451934814453,373.48360071092816,30,371,43,1655,339,941,286,51,44.67
33,6,0,33.0,6.0,0.32936620712280273,340.01911710961195,30,338,37,1655,339,941,286,51,42.67
32,6,0,32.0,6.0,0.33695220947265625,307.5662530252628,30,306,31,1655,339,941,286,51,39.04
30,6,0,30.0,6.0,0.345156192779541,277.1299334247385,30,276,25,1655,339,941,286,51,34.83
27,7,0,27.0,7.0,0.3558821678161621,249.64975465639858,30,249,18,1655,339,941,286,51,29.92
26,6,0,26.0,6.0,0.3610811233520508,223.32263655975405,30,223,12,1655,339,941,286,51,27.07
23,6,0,23.0,6.0,0.3690052032470703,200.08997975910736,30,200,6,1655,339,941,286,51,22.93
20,4,0,20.0,4.0,0.37700414657592773,180.01111076819674,30,180,2,1655,339,941,286,51,19.75
19,4,0,19.0,4.0,0.385221004486084,161.01242188104618,30,161,-2,1655,339,941,286,51,17.46
16,2,0,16.0,2.0,0.3983421325683594,145.0551619212498,30,145,-4,1655,339,941,286,51,15.11
14,1,0,14.0,1.0,0.4015841484069824,131.0953851209111,30,131,-5,1655,339,941,286,51,13.52
11,0,0,11.0,-0.0,0.41549110412597656,120.10412149464314,30,120,-5,1655,339,941,286,51,12.42
8,0,0,8.0,-0.0,0.4174489974975586,112.11155159036913,30,112,-5,1655,339,941,286,51,10.22
6,0,0,6.0,-0.0,0.42496609687805176,106.1178590059185,30,106,-5,1655,339,941,286,51,8.74
4,0,0,4.0,-0.0,0.43329501152038574,102.12247548899312,30,102,-5,1655,339,941,286,51,7.36
2,0,0,2.0,-0.0,0.4426391124725342,100.12492197250393,30,100,-5,1655,339,941,286,51,6.04
0,-1,0,-0.0,-1.0,0.4890141487121582,100.07996802557443,30,100,-4,1655,339,941,286,51,0.13
1,0,0,1.0,-0.0,0.49701809883117676,99.08077512817509,30,99,-4,1655,339,941,286,51,5.6
2,0,0,2.0,-0.0,0.5049631595611572,97.082439194738,30,97,-4,1655,339,941,286,51,6.21
2,0,0,2.0,-0.0,0.5135722160339355,95.08417323613851,30,95,-4,1655,339,941,286,51,6.16
2,0,0,2.0,-0.0,0.5209500789642334,93.08598175880189,30,93,-4,1655,339,941,286,51,6.11
1,0,0,1.0,-0.0,0.5289762020111084,92.0869154657707,30,92,-4,1655,339,941,286,51,5.47
2,0,0,2.0,-0.0,0.543269157409668,90.08884503644167,30,90,-4,1655,339,941,286,51,6.04
2,0,0,2.0,-0.0,0.5463240146636963,88.09086218218096,30,88,-4,1655,339,941,286,51,5.99
2,0,0,2.0,-0.0,0.5558919906616211,86.09297300012354,30,86,-4,1655,339,941,286,51,5.94
2,0,0,2.0,-0.0,0.5609850883483887,84.09518416651456,30,84,-4,1655,339,941,286,51,5.88
4,1,0,4.0,1.0,0.5690500736236572,80.15609770940699,30,80,-5,1655,339,941,286,51,4.4
3,0,0,3.0,-0.0,0.5769491195678711,77.1621668954417,30,77,-5,1655,339,941,286,51,5.93
2,0,0,2.0,-0.0,0.5852231979370117,75.16648189186454,30,75,-5,1655,339,941,286,51,5.38
3,0,0,3.0,-0.0,0.5938360691070557,72.17340230306452,30,72,-5,1655,339,941,286,51,5.75
3,0,0,3.0,-0.0,0.6009440422058105,69.18092222571191,30,69,-5,1655,339,941,286,51,5.63
3,0,0,3.0,-0.0,0.6093041896820068,66.18912297349165,30,66,-5,1655,339,941,286,51,5.51
4,0,0,4.0,-0.0,0.6169941425323486,62.20128616033595,30,62,-5,1655,339,941,286,51,5.74
3,-1,0,3.0,-1.0,0.6249401569366455,59.135437767890075,30,59,-4,1655,339,941,286,51,3.77
4,0,0,4.0,-0.0,0.632972002029419,55.14526271584895,30,55,-4,1655,339,941,286,51,5.66
3,-1,0,3.0,-1.0,0.6429359912872314,52.08646657242167,30,52,-3,1655,339,941,286,51,3.54
3,0,0,3.0,-0.0,0.6491990089416504,49.09175083453431,30,49,-3,1655,339,941,286,51,5.38
3,0,0,3.0,-0.0,0.6571199893951416,46.09772228646444,30,46,-3,1655,339,941,286,51,5.23
4,-1,0,4.0,-1.0,0.6662042140960693,42.04759208325728,30,42,-2,1655,339,941,286,51,3.92
3,0,0,3.0,-0.0,0.6729710102081299,39.05124837953327,30,39,-2,1655,339,941,286,51,5.33
3,0,0,3.0,-0.0,0.6809790134429932,36.05551275463989,30,36,-2,1655,339,941,286,51,5.15
3,-1,0,3.0,-1.0,0.688988208770752,33.015148038438355,30,33,-1,1655,339,941,286,51,2.84
3,0,0,3.0,-0.0,0.6969890594482422,30.01666203960727,30,30,-1,1655,339,941,286,51,5.56
2,0,0,2.0,-0.0,0.7050302028656006,28.0178514522438,30,28,-1,1655,339,941,286,51,5.25
3,0,0,3.0,-0.0,0.7130060195922852,25.019992006393608,30,25,-1,1655,339,941,286,51,5.17
0,0,1,-0.0,-0.0,0.7199621200561523,25.019992006393608,30,25,-1,1655,339,941,286,51,34.43
1,0,1,1.0,-0.0,0.7210512161254883,24.020824298928627,30,24,-1,1655,339,941,286,51,14.89
1,0,1,1.0,-0.0,0.007359743118286133,1123.7953550357822,31,-1104,-210,528,130,1631,340,71,6.08
1,0,1,1.0,-0.0,0.015383720397949219,1124.7777558255675,31,-1105,-210,528,130,1631,340,71,6.09
0,0,0,-0.0,-0.0,0.07937073707580566,1124.7777558255675,31,-1105,-210,528,130,1631,340,71,219.68
-3,0,0,-3.0,-0.0,0.13535666465759277,1121.8306467555608,31,-1102,-210,528,130,1631,340,71,11.53
-3,1,0,-3.0,1.0,0.14334678649902344,1119.0719369191597,31,-1099,-211,528,130,1631,340,71,9.63
-5,1,0,-5.0,1.0,0.15143156051635742,1114.3518295403835,31,-1094,-212,528,130,1631,340,71,15.26
-5,2,0,-5.0,2.0,0.15945863723754883,1109.8274640681766,31,-1089,-214,528,130,1631,340,71,14.17
-5,1,0,-5.0,1.0,0.16734957695007324,1105.1158310331093,31,-1084,-215,528,130,1631,340,71,15.16
-7,2,0,-7.0,2.0,0.17540764808654785,1098.643709307071,31,-1077,-217,528,130,1631,340,71,19.3
-12,2,0,-12.0,2.0,0.1855316162109375,1087.2837716070262,31,-1065,-219,528,130,1631,340,71,30.87
-15,3,0,-15.0,3.0,0.19161558151245117,1073.2120014237635,31,-1050,-222,528,130,1631,340,71,36.18
-16,2,0,-16.0,2.0,0.19934463500976562,1057.9848770185706,31,-1034,-224,528,130,1631,340,71,38.44
-17,2,0,-17.0,2.0,0.20737576484680176,1041.8085236740963,31,-1017,-226,528,130,1631,340,71,39.94
-17,1,0,-17.0,1.0,0.21612763404846191,1025.440880792257,31,-1000,-227,528,130,1631,340,71,40.19
-18,0,0,-18.0,-0.0,0.2233426570892334,1007.8953318673522,31,-982,-227,528,130,1631,340,71,42.25
-27,1,0,-27.0,1.0,0.23143267631530762,981.8395999347348,31,-955,-228,528,130,1631,340,71,55.15
-33,-1,0,-33.0,-1.0,0.2397317886352539,949.5330431322545,31,-922,-227,528,130,1631,340,71,62.93
-37,-4,0,-37.0,-4.0,0.24734759330749512,912.6631361022532,31,-885,-223,528,130,1631,340,71,67.51
-37,-5,0,-37.0,-5.0,0.25551462173461914,875.5729552698622,31,-848,-218,528,130,1631,340,71,66.38
-38,-6,0,-38.0,-6.0,0.2637786865234375,837.2837034124096,31,-810,-212,528,130,1631,340,71,66.17
-35,-8,0,-35.0,-8.0,0.2713356018066406,801.3994010479419,31,-775,-204,528,130,1631,340,71,63.28
-34,-9,0,-34.0,-9.0,0.2796797752380371,766.2284254711515,31,-741,-195,528,130,1631,340,71,62.62
-36,-11,0,-36.0,-11.0,0.28742361068725586,728.6158109731081,31,-705,-184,528,130,1631,340,71,61.37
-33,-11,0,-33.0,-11.0,0.29537367820739746,693.9113776268551,31,-672,-173,528,130,1631,340,71,56.19
-33,-12,0,-33.0,-12.0,0.30345773696899414,658.9704090473259,31,-639,-161,528,130,1631,340,71,54.23
-32,-12,0,-32.0,-12.0,0.3114316463470459,625.0199996800102,31,-607,-149,528,130,1631,340,71,51.39
-29,-11,0,-29.0,-11.0,0.32184863090515137,594.245740413846,31,-578,-138,528,130,1631,340,71,46.71
-29,-11,0,-29.0,-11.0,0.327392578125,563.4980035457091,31,-549,-127,528,130,1631,340,71,45.11
-27,-11,0,-27.0,-11.0,0.3355097770690918,534.7335785229875,31,-522,-116,528,130,1631,340,71,41.53
-24,-9,0,-24.0,-9.0,0.34496259689331055,509.36529131851927,31,-498,-107,528,130,1631,340,71,37.24
-23,-10,0,-23.0,-10.0,0.35137176513671875,484.80305279566875,31,-475,-97,528,130,1631,340,71,34.86
-21,-8,0,-21.0,-8.0,0.35957765579223633,462.6413297577293,31,-454,-89,528,130,1631,340,71,31.81
-20,-8,0,-20.0,-8.0,0.36734771728515625,441.49405432010064,31,-434,-81,528,130,1631,340,71,29.72
-17,-7,0,-17.0,-7.0,0.37537574768066406,423.51505286117043,31,-417,-74,528,130,1631,340,71,25.72
-17,-6,0,-17.0,-6.0,0.3833746910095215,405.73883225543005,31,-400,-68,528,130,1631,340,71,25.14
-15,-4,0,-15.0,-4.0,0.39305663108825684,390.2832304878087,31,-385,-64,528,130,1631,340,71,23.0
-14,-5,0,-14.0,-5.0,0.4002697467803955,375.6620821962206,31,-371,-59,528,130,1631,340,71,20.78
-15,-3,0,-15.0,-3.0,0.40735769271850586,360.3775797687753,31,-356,-56,528,130,1631,340,71,22.77
-13,-4,0,-13.0,-4.0,0.4153575897216797,346.91929897311854,31,-343,-52,528,130,1631,340,71,18.96
-14,-3,0,-14.0,-3.0,0.42346978187561035,332.62892237446823,31,-329,-49,528,130,1631,340,71,20.34
-14,-3,0,-14.0,-3.0,0.4313626289367676,318.34101212379153,31,-315,-46,528,130,1631,340,71,19.77
-13,-2,0,-13.0,-2.0,0.4402596950531006,305.1884663613617,31,-302,-44,528,130,1631,340,71,20.22
-13,-2,0,-13.0,-2.0,0.44735264778137207,292.0359566902678,31,-289,-42,528,130,1631,340,71,19.74
-13,-2,0,-13.0,-2.0,0.4554286003112793,278.8834882168537,31,-276,-40,528,130,1631,340,71,19.25
-11,-1,0,-11.0,-1.0,0.46393370628356934,267.8544380815819,31,-265,-39,528,130,1631,340,71,15.41
-12,-1,0,-12.0,-1.0,0.47135376930236816,255.8378392654222,31,-253,-38,528,130,1631,340,71,15.62
-11,-1,0,-11.0,-1.0,0.4793846607208252,244.8121728999602,31,-242,-37,528,130,1631,340,71,14.56
-11,-1,0,-11.0,-1.0,0.4873526096343994,233.78836583542818,31,-231,-36,528,130,1631,340,71,14.14
-11,-1,0,-11.0,-1.0,0.49552178382873535,222.76669409945464,31,-220,-35,528,130,1631,340,71,13.71
-12,0,0,-12.0,-0.0,0.5037627220153809,210.92415698539605,31,-208,-35,528,130,1631,340,71,12.69
-12,-1,0,-12.0,-1.0,0.5113396644592285,198.92712233378333,31,-196,-34,528,130,1631,340,71,13.18
-12,0,0,-12.0,-0.0,0.5194187164306641,187.11493793922494,31,-184,-34,528,130,1631,340,71,11.65
-13,-1,0,-13.0,-1.0,0.5273475646972656,174.1551032843999,31,-171,-33,528,130,1631,340,71,12.45
-12,0,0,-12.0,-0.0,0.5353395938873291,162.3884232326923,31,-159,-33,528,130,1631,340,71,10.5
-12,-1,0,-12.0,-1.0,0.5434045791625977,150.44268011438774,31,-147,-32,528,130,1631,340,71,10.71
-8,0,0,-8.0,-0.0,0.5571186542510986,142.63590010933433,31,-139,-32,528,130,1631,340,71,7.48
-9,-1,0,-9.0,-1.0,0.5601627826690674,133.64505228402584,31,-130,-31,528,130,1631,340,71,8.64
-5,0,0,-5.0,-0.0,0.5692915916442871,128.7866452703851,31,-125,-31,528,130,1631,340,71,5.45
-7,0,0,-7.0,-0.0,0.5753657817840576,122.00409829181969,31,-118,-31,528,130,1631,340,71,6.19
-5,-1,0,-5.0,-1.0,0.583979606628418,116.91449867317569,31,-113,-30,528,130,1631,340,71,7.1
-6,0,0,-6.0,-0.0,0.5966706275939941,111.12605455067681,31,-107,-30,528,130,1631,340,71,5.35
-6,-1,0,-6.0,-1.0,0.5996427536010742,105.08092119885512,31,-101,-29,528,130,1631,340,71,6.49
-7,-1,0,-7.0,-1.0,0.6073787212371826,98.08159868191383,31,-94,-28,528,130,1631,340,71,6.35
-6,0,0,-6.0,-0.0,0.6154875755310059,92.34717104492157,31,-88,-28,528,130,1631,340,71,4.67
-5,-2,0,-5.0,-2.0,0.6234066486358643,86.97700845625813,31,-83,-26,528,130,1631,340,71,6.26
-7,-1,0,-7.0,-1.0,0.6372525691986084,80.00624975587844,31,-76,-25,528,130,1631,340,71,5.52
-8,-2,0,-8.0,-2.0,0.6393716335296631,71.78439941937245,31,-68,-23,528,130,1631,340,71,6.65
-8,-2,0,-8.0,-2.0,0.6490757465362549,63.56886030125127,31,-60,-21,528,130,1631,340,71,6.16
-9,-2,0,-9.0,-2.0,0.6562557220458984,54.42425929675111,31,-51,-19,528,130,1631,340,71,5.44
-7,-2,0,-7.0,-2.0,0.6633627414703369,47.16990566028302,31,-44,-17,528,130,1631,340,71,5.29
-6,-1,0,-6.0,-1.0,0.672142744064331,41.23105625617661,31,-38,-16,528,130,1631,340,71,3.5
-6,-1,0,-6.0,-1.0,0.6793627738952637,35.34119409414458,31,-32,-15,528,130,1631,340,71,3.03
-3,-1,0,-3.0,-1.0,0.6873846054077148,32.202484376209235,31,-29,-14,528,130,1631,340,71,3.66
-1,0,0,-1.0,-0.0,0.695584774017334,31.304951684997057,31,-28,-14,528,130,1631,340,71,1.77
0,0,1,-0.0,-0.0,0.7270817756652832,31.304951684997057,31,-28,-14,528,130,1631,340,71,36.35
1,0,1,1.0,-0.0,0.011771202087402344,1353.2024977807275,32,1081,814,1638,958,556,144,19,10.93
1,0,1,1.0,-0.0,0.01981520652770996,1352.403785856872,32,1080,814,1638,958,556,144,19,10.92
1,0,1,1.0,-0.0,0.02793121337890625,1351.6053418065496,32,1079,814,1638,958,556,144,19,10.91
0,0,0,-0.0,-0.0,0.0697791576385498,1351.6053418065496,32,1079,814,1638,958,556,144,19,242.9
0,2,0,-0.0,2.0,0.11578822135925293,1350.4017920604224,32,1079,812,1638,958,556,144,19,14.94
-1,2,0,-1.0,2.0,0.12380838394165039,1350.0,32,1080,810,1638,958,556,144,19,5.18
-1,2,0,-1.0,2.0,0.13206219673156738,1349.6017931226975,32,1081,808,1638,958,556,144,19,5.14
0,2,0,-0.0,2.0,0.1397721767425537,1348.405354483584,32,1081,806,1638,958,556,144,19,14.84
1,3,0,1.0,3.0,0.14777016639709473,1345.8116510121317,32,1080,803,1638,958,556,144,19,29.76
4,4,0,4.0,4.0,0.15592026710510254,1340.2152812141787,32,1076,799,1638,958,556,144,19,56.87
7,6,0,7.0,6.0,0.16379618644714355,1331.0184070853416,32,1069,793,1638,958,556,144,19,80.65
10,6,0,10.0,6.0,0.17837738990783691,1319.4127481573005,32,1059,787,1638,958,556,144,19,92.21
13,7,0,13.0,7.0,0.18112826347351074,1304.8049662689057,32,1046,780,1638,958,556,144,19,103.99
14,7,0,14.0,7.0,0.18778133392333984,1289.400248177423,32,1032,773,1638,958,556,144,19,106.07
16,8,0,16.0,8.0,0.1958143711090088,1271.8022645049818,32,1016,765,1638,958,556,144,19,112.8
17,7,0,17.0,7.0,0.20428729057312012,1254.019537327868,32,999,758,1638,958,556,144,19,112.05
19,9,0,19.0,9.0,0.21339726448059082,1233.450850257115,32,980,749,1638,958,556,144,19,119.45
22,10,0,22.0,10.0,0.21976923942565918,1209.911153762953,32,958,739,1638,958,556,144,19,125.49
23,11,0,23.0,11.0,0.22784924507141113,1184.993248925917,32,935,728,1638,958,556,144,19,127.2
26,14,0,26.0,14.0,0.2357633113861084,1155.8879703500681,32,909,714,1638,958,556,144,19,133.86
31,14,0,31.0,14.0,0.2438793182373047,1122.8909118877043,32,878,700,1638,958,556,144,19,137.46
31,17,0,31.0,17.0,0.2517523765563965,1088.0707697571881,32,847,683,1638,958,556,144,19,138.06
37,22,0,37.0,22.0,0.26076221466064453,1045.4764464109176,32,810,661,1638,958,556,144,19,144.23
38,25,0,38.0,25.0,0.26781725883483887,1000.2399712069099,32,772,636,1638,958,556,144,19,143.54
40,24,0,40.0,24.0,0.2757852077484131,954.1320663304425,32,732,612,1638,958,556,144,19,139.93
39,24,0,39.0,24.0,0.28380322456359863,908.8415703520609,32,693,588,1638,958,556,144,19,135.34
37,23,0,37.0,23.0,0.29219627380371094,865.771909916232,32,656,565,1638,958,556,144,19,129.57
35,22,0,35.0,22.0,0.3037283420562744,824.9181777606794,32,621,543,1638,958,556,144,19,123.88
32,22,0,32.0,22.0,0.3077843189239502,786.3599684622812,32,589,521,1638,958,556,144,19,118.54
30,22,0,30.0,22.0,0.3158411979675293,749.3210259962015,32,559,499,1638,958,556,144,19,113.96
27,21,0,27.0,21.0,0.32376623153686523,715.1978747172002,32,532,478,1638,958,556,144,19,108.16
25,20,0,25.0,20.0,0.3319082260131836,683.2371477020259,32,507,458,1638,958,556,144,19,103.01
23,18,0,23.0,18.0,0.33992624282836914,654.1070248820142,32,484,440,1638,958,556,144,19,96.71
23,20,0,23.0,20.0,0.3526911735534668,623.6353100971753,32,461,420,1638,958,556,144,19,96.76
23,19,0,23.0,19.0,0.3564422130584717,593.8392038254127,32,438,401,1638,958,556,144,19,92.29
22,19,0,22.0,19.0,0.3648362159729004,564.7831442244005,32,416,382,1638,958,556,144,19,89.18
23,17,0,23.0,17.0,0.3717942237854004,536.3524960322269,32,393,365,1638,958,556,144,19,84.1
21,17,0,21.0,17.0,0.3798103332519531,509.39964664298697,32,372,348,1638,958,556,144,19,80.27
20,15,0,20.0,15.0,0.38831329345703125,484.55443450658873,32,352,333,1638,958,556,144,19,74.67
20,14,0,20.0,14.0,0.39578819274902344,460.41828808160955,32,332,319,1638,958,556,144,19,70.97
19,13,0,19.0,13.0,0.4038233757019043,437.72708392330486,32,313,306,1638,958,556,144,19,66.71
18,12,0,18.0,12.0,0.4117922782897949,416.4864943788694,32,295,294,1638,958,556,144,19,62.54
16,12,0,16.0,12.0,0.419783353805542,396.69257618463195,32,279,282,1638,958,556,144,19,59.01
16,11,0,16.0,11.0,0.4277822971343994,377.6373922163959,32,263,271,1638,958,556,144,19,55.71
15,10,0,15.0,10.0,0.435833215713501,360.0347205478938,32,248,261,1638,958,556,144,19,51.78
13,10,0,13.0,10.0,0.44382429122924805,343.8400791065521,32,235,251,1638,958,556,144,19,48.58
12,9,0,12.0,9.0,0.4522373676300049,329.07901786653,32,223,242,1638,958,556,144,19,44.83
10,9,0,10.0,9.0,0.46001338958740234,315.6865534038471,32,213,233,1638,958,556,144,19,42.22
10,9,0,10.0,9.0,0.4677703380584717,302.29952034364857,32,203,224,1638,958,556,144,19,40.96
9,8,0,9.0,8.0,0.4757852554321289,290.33084576048753,32,194,216,1638,958,556,144,19,37.41
9,10,0,9.0,10.0,0.48401427268981934,276.87722911066555,32,185,206,1638,958,556,144,19,41.82
8,9,0,8.0,9.0,0.4949033260345459,264.83579818446,32,177,197,1638,958,556,144,19,38.11
7,8,0,7.0,8.0,0.49979233741760254,254.20660888340413,32,170,189,1638,958,556,144,19,34.3
5,7,0,5.0,7.0,0.5077931880950928,245.66033460858105,32,165,182,1638,958,556,144,19,27.58
5,8,0,5.0,8.0,0.5185263156890869,236.3810483097154,32,160,174,1638,958,556,144,19,27.61
4,6,0,4.0,6.0,0.5238091945648193,229.2596780945136,32,156,168,1638,958,556,144,19,23.2
3,7,0,3.0,7.0,0.5317883491516113,222.10357943986403,32,153,161,1638,958,556,144,19,21.7
2,6,0,2.0,6.0,0.5397732257843018,216.39316070523117,32,151,155,1638,958,556,144,19,18.02
3,5,0,3.0,5.0,0.5477821826934814,210.7225664232476,32,148,150,1638,958,556,144,19,18.5
2,6,0,2.0,6.0,0.5565292835235596,205.06584308460538,32,146,144,1638,958,556,144,19,17.19
3,6,0,3.0,6.0,0.5655312538146973,198.72845795205075,32,143,138,1638,958,556,144,19,18.64
3,6,0,3.0,6.0,0.5717682838439941,192.4162155328911,32,140,132,1638,958,556,144,19,18.14
3,5,0,3.0,5.0,0.5797991752624512,186.81006396872735,32,137,127,1638,958,556,144,19,16.74
3,6,0,3.0,6.0,0.588104248046875,180.54639292990598,32,134,121,1638,958,556,144,19,17.19
4,6,0,4.0,6.0,0.5957763195037842,173.5655495770978,32,130,115,1638,958,556,144,19,18.47
2,4,0,2.0,4.0,0.6039142608642578,169.42549985170473,32,128,111,1638,958,556,144,19,12.42
2,4,0,2.0,4.0,0.6118223667144775,165.3027525481654,32,126,107,1638,958,556,144,19,12.15
0,2,0,-0.0,2.0,0.61977219581604,164.01524319403975,32,126,105,1638,958,556,144,19,4.51
1,3,0,1.0,3.0,0.6279842853546143,161.33505508723144,32,125,102,1638,958,556,144,19,8.44
0,2,0,-0.0,2.0,0.6364853382110596,160.0781059358212,32,125,100,1638,958,556,144,19,4.33
1,4,0,1.0,4.0,0.6464202404022217,156.81836627130127,32,124,96,1638,958,556,144,19,9.28
2,4,0,2.0,4.0,0.6518323421478271,152.80052355931247,32,122,92,1638,958,556,144,19,11.15
2,4,0,2.0,4.0,0.6597743034362793,148.8086019019062,32,120,88,1638,958,556,144,19,10.86
3,4,0,3.0,4.0,0.6701061725616455,144.03124660989366,32,117,84,1638,958,556,144,19,12.64
4,2,0,4.0,2.0,0.6759452819824219,139.61733416735902,32,113,82,1638,958,556,144,19,12.63
3,3,0,3.0,3.0,0.6838483810424805,135.4289481610191,32,110,79,1638,958,556,144,19,12.03
4,2,0,4.0,2.0,0.6983413696289062,131.01526628603247,32,106,77,1638,958,556,144,19,12.16
6,3,0,6.0,3.0,0.7000043392181396,124.4025723206719,32,100,74,1638,958,556,144,19,14.88
5,3,0,5.0,3.0,0.7100121974945068,118.6001686339442,32,95,71,1638,958,556,144,19,14.1
5,3,0,5.0,3.0,0.7157871723175049,112.8007092176286,32,90,68,1638,958,556,144,19,13.63
5,3,0,5.0,3.0,0.723790168762207,107.00467279516349,32,85,65,1638,958,556,144,19,13.15
6,3,0,6.0,3.0,0.7317593097686768,100.42410069301094,32,79,62,1638,958,556,144,19,12.79
6,4,0,6.0,4.0,0.7397933006286621,93.23625904121208,32,73,58,1638,958,556,144,19,14.02
7,4,0,7.0,4.0,0.7482702732086182,85.27602242131137,32,66,54,1638,958,556,144,19,13.11
8,4,0,8.0,4.0,0.7618253231048584,76.57675887630658,32,58,50,1638,958,556,144,19,12.31
7,4,0,7.0,4.0,0.7639663219451904,68.6804193347711,32,51,46,1638,958,556,144,19,11.13
7,3,0,7.0,3.0,0.7717592716217041,61.5223536610881,32,44,43,1638,958,556,144,19,9.14
5,3,0,5.0,3.0,0.7797951698303223,55.86591089385369,32,39,40,1638,958,556,144,19,8.07
4,2,0,4.0,2.0,0.7877833843231201,51.66236541235796,32,35,38,1638,958,556,144,19,6.15
3,4,0,3.0,4.0,0.7974472045898438,46.69047011971501,32,32,34,1638,958,556,144,19,8.01
2,2,0,2.0,2.0,0.8037943840026855,43.86342439892262,32,30,32,1638,958,556,144,19,7.75
2,2,0,2.0,2.0,0.8117752075195312,41.036569057366385,32,28,30,1638,958,556,144,19,7.54
2,3,0,2.0,3.0,0.819810152053833,37.48332962798263,32,26,27,1638,958,556,144,19,5.78
1,2,0,1.0,2.0,0.8277943134307861,35.35533905932738,32,25,25,1638,958,556,144,19,3.89
2,2,0,2.0,2.0,0.8361623287200928,32.526911934581186,32,23,23,1638,958,556,144,19,9.25
2,1,0,2.0,1.0,0.8438572883605957,30.4138126514911,32,21,22,1638,958,556,144,19,3.56
2,2,0,2.0,2.0,0.8517963886260986,27.586228448267445,32,19,20,1638,958,556,144,19,7.16
1,1,0,1.0,1.0,0.8597793579101562,26.1725046566048,32,18,19,1638,958,556,144,19,6.19
2,1,0,2.0,1.0,0.8677823543548584,24.08318915758459,32,16,18,1638,958,556,144,19,3.09
1,1,0,1.0,1.0,0.8760013580322266,22.67156809750927,32,15,17,1638,958,556,144,19,5.13
1,1,0,1.0,1.0,0.8838043212890625,21.2602916254693,32,14,16,1638,958,556,144,19,5.0
1,0,0,1.0,-0.0,0.8917572498321533,20.615528128088304,32,13,16,1638,958,556,144,19,1.04
0,1,0,-0.0,1.0,0.8998053073883057,19.849433241279208,32,13,15,1638,958,556,144,19,1.41
1,1,0,1.0,1.0,0.9158341884613037,18.439088914585774,32,12,14,1638,958,556,144,19,4.7
1,1,0,1.0,1.0,0.9330732822418213,17.029386365926403,32,11,13,1638,958,556,144,19,4.53
1,1,0,1.0,1.0,0.9414823055267334,15.620499351813308,32,10,12,1638,958,556,144,19,4.34
1,1,0,1.0,1.0,0.9481782913208008,14.212670403551895,32,9,11,1638,958,556,144,19,4.14
0,1,0,-0.0,1.0,0.9557983875274658,13.45362404707371,32,9,10,1638,958,556,144,19,1.12
1,1,0,1.0,1.0,0.9637713432312012,12.041594578792296,32,8,9,1638,958,556,144,19,4.69
2,1,0,2.0,1.0,0.9718012809753418,10.0,32,6,8,1638,958,556,144,19,1.79
1,0,0,1.0,-0.0,0.9798543453216553,9.433981132056603,32,5,8,1638,958,556,144,19,0.34
1,1,0,1.0,1.0,0.989105224609375,8.06225774829855,32,4,7,1638,958,556,144,19,2.3
1,1,0,1.0,1.0,0.995812177658081,6.708203932499369,32,3,6,1638,958,556,144,19,1.87
0,1,0,-0.0,1.0,1.0037941932678223,5.830951894845301,32,3,5,1638,958,556,144,19,1.01
1,0,0,1.0,-0.0,1.0117661952972412,5.385164807134504,32,2,5,1638,958,556,144,19,-0.33
0,0,1,-0.0,-0.0,1.0557732582092285,5.385164807134504,32,2,5,1638,958,556,144,19,28.51
0,0,0,-0.0,-0.0,0.08293676376342773,279.30807363912703,33,-197,198,1439,1151,1636,953,42,92.33
-1,0,0,-1.0,-0.0,0.11597561836242676,278.60366113890177,33,-196,198,1439,1151,1636,953,42,2.48
-1,0,0,-1.0,-0.0,0.12394571304321289,277.90106153089806,33,-195,198,1439,1151,1636,953,42,2.47
-1,0,0,-1.0,-0.0,0.13295674324035645,277.2002886001384,33,-194,198,1439,1151,1636,953,42,2.46
-3,0,0,-3.0,-0.0,0.13994979858398438,275.10906927980403,33,-191,198,1439,1151,1636,953,42,4.99
-4,0,0,-4.0,-0.0,0.14792180061340332,272.34720486907884,33,-187,198,1439,1151,1636,953,42,6.1
-5,-1,0,-5.0,-1.0,0.15593481063842773,269.675731203236,33,-182,199,1439,1151,1636,953,42,5.55
-6,-1,0,-6.0,-1.0,0.16397571563720703,266.4132128855474,33,-176,200,1439,1151,1636,953,42,6.5
-6,-2,0,-6.0,-2.0,0.17191171646118164,264.0151510803878,33,-170,202,1439,1151,1636,953,42,4.75
-7,-1,0,-7.0,-1.0,0.1800217628479004,260.3420826528051,33,-163,203,1439,1151,1636,953,42,7.02
-7,-2,0,-7.0,-2.0,0.18791460990905762,257.60628874311277,33,-156,205,1439,1151,1636,953,42,5.21
-10,-4,0,-10.0,-4.0,0.19593477249145508,254.94509212769717,33,-146,209,1439,1151,1636,953,42,4.79
-11,-4,0,-11.0,-4.0,0.204270601272583,252.17850820401011,33,-135,213,1439,1151,1636,953,42,4.89
-17,-4,0,-17.0,-4.0,0.2119896411895752,247.00809703327542,33,-118,217,1439,1151,1636,953,42,8.45
-21,-4,0,-21.0,-4.0,0.22013473510742188,241.3503677229434,33,-97,221,1439,1151,1636,953,42,8.86
-20,-3,0,-20.0,-3.0,0.22794365882873535,236.86494041964082,33,-77,224,1439,1151,1636,953,42,7.03
-17,-1,0,-17.0,-1.0,0.23685169219970703,232.86262044390037,33,-60,225,1439,1151,1636,953,42,6.32
-11,0,0,-11.0,-0.0,0.24398064613342285,230.27375013231534,33,-49,225,1439,1151,1636,953,42,4.29
-8,1,0,-8.0,1.0,0.2519397735595703,227.72132091659753,33,-41,224,1439,1151,1636,953,42,4.37
-5,2,0,-5.0,2.0,0.259934663772583,224.89997776789573,33,-36,222,1439,1151,1636,953,42,5.11
-2,2,0,-2.0,2.0,0.26801562309265137,222.61176967986216,33,-34,220,1439,1151,1636,953,42,5.04
-2,4,0,-2.0,4.0,0.27600979804992676,218.3575050232989,33,-32,216,1439,1151,1636,953,42,8.74
-2,5,0,-2.0,5.0,0.28433775901794434,213.12203077110541,33,-30,211,1439,1151,1636,953,42,10.29
-2,6,0,-2.0,6.0,0.29195380210876465,206.90335908341362,33,-28,205,1439,1151,1636,953,42,11.66
-1,6,0,-1.0,6.0,0.2999427318572998,200.8233054204616,33,-27,199,1439,1151,1636,953,42,13.48
0,6,0,-0.0,6.0,0.30799269676208496,194.87944991712183,33,-27,193,1439,1151,1636,953,42,11.33
0,7,0,-0.0,7.0,0.31592369079589844,187.94946129212502,33,-27,186,1439,1151,1636,953,42,12.14
0,6,0,-0.0,6.0,0.3239936828613281,182.01373574541017,33,-27,180,1439,1151,1636,953,42,10.81
2,8,0,2.0,8.0,0.3339087963104248,174.42763542512407,33,-29,172,1439,1151,1636,953,42,10.83
1,8,0,1.0,8.0,0.3428816795349121,166.7213243709394,33,-30,164,1439,1151,1636,953,42,11.05
1,8,0,1.0,8.0,0.3479807376861572,159.05030650709227,33,-31,156,1439,1151,1636,953,42,10.62
0,8,0,-0.0,8.0,0.35592079162597656,151.21177202850313,33,-31,148,1439,1151,1636,953,42,11.03
0,7,0,-0.0,7.0,0.3639097213745117,144.3675863897433,33,-31,141,1439,1151,1636,953,42,9.81
1,8,0,1.0,8.0,0.372147798538208,136.79546776117988,33,-32,133,1439,1151,1636,953,42,9.38
1,8,0,1.0,8.0,0.3803136348724365,129.28263611173776,33,-33,125,1439,1151,1636,953,42,8.91
0,8,0,-0.0,8.0,0.39122867584228516,121.56479753612885,33,-33,117,1439,1151,1636,953,42,9.18
0,8,0,-0.0,8.0,0.3963346481323242,113.8859078200635,33,-33,109,1439,1151,1636,953,42,8.69
0,8,0,-0.0,8.0,0.4039907455444336,106.25441167311595,33,-33,101,1439,1151,1636,953,42,8.19
0,7,0,-0.0,7.0,0.41431760787963867,99.62429422585637,33,-33,94,1439,1151,1636,953,42,7.14
0,7,0,-0.0,7.0,0.42029571533203125,93.04837451562494,33,-33,87,1439,1151,1636,953,42,6.71
-1,8,0,-1.0,8.0,0.42804670333862305,85.23496934944014,33,-32,79,1439,1151,1636,953,42,7.51
-2,6,0,-2.0,6.0,0.43592071533203125,78.92401408950256,33,-30,73,1439,1151,1636,953,42,8.19
-1,7,0,-1.0,7.0,0.444199800491333,72.09022125087424,33,-29,66,1439,1151,1636,953,42,6.28
-3,5,0,-3.0,5.0,0.45197582244873047,66.30987860040162,33,-26,61,1439,1151,1636,953,42,6.45
-2,6,0,-2.0,6.0,0.462904691696167,60.00833275470999,33,-24,55,1439,1151,1636,953,42,6.96
-3,5,0,-3.0,5.0,0.46793270111083984,54.230987451824994,33,-21,50,1439,1151,1636,953,42,5.85
-4,6,0,-4.0,6.0,0.47682762145996094,47.16990566028302,33,-17,44,1439,1151,1636,953,42,5.35
-4,5,0,-4.0,5.0,0.48391175270080566,41.10960958218893,33,-13,39,1439,1151,1636,953,42,4.0
-4,5,0,-4.0,5.0,0.4919126033782959,35.17101079013795,33,-9,34,1439,1151,1636,953,42,3.39
-5,4,0,-5.0,4.0,0.4999227523803711,30.265491900843113,33,-4,30,1439,1151,1636,953,42,1.89
-4,4,0,-4.0,4.0,0.5079026222229004,26.0,33,0,26,1439,1151,1636,953,42,1.47
-4,2,0,-4.0,2.0,0.5159127712249756,24.331050121192877,33,4,24,1439,1151,1636,953,42,0.0
-2,2,0,-2.0,2.0,0.523932695388794,22.80350850198276,33,6,22,1439,1151,1636,953,42,0.42
-3,2,0,-3.0,2.0,0.5342886447906494,21.93171219946131,33,9,20,1439,1151,1636,953,42,-0.36
-3,1,0,-3.0,1.0,0.5399367809295654,22.47220505424423,33,12,19,1439,1151,1636,953,42,-0.01
-3,3,0,-3.0,3.0,0.5479767322540283,21.93171219946131,33,15,16,1439,1151,1636,953,42,-0.69
-2,2,0,-2.0,2.0,0.5576517581939697,22.02271554554524,33,17,14,1439,1151,1636,953,42,2.79
-2,1,0,-2.0,1.0,0.5639777183532715,23.021728866442675,33,19,13,1439,1151,1636,953,42,0.16
-1,2,0,-1.0,2.0,0.5719788074493408,22.825424421026653,33,20,11,1439,1151,1636,953,42,-0.39
0,1,0,-0.0,1.0,0.5799486637115479,22.360679774997898,33,20,10,1439,1151,1636,953,42,0.43
-1,1,0,-1.0,1.0,0.5889987945556641,22.847319317591726,33,21,9,1439,1151,1636,953,42,0.71
0,1,0,-0.0,1.0,0.5994527339935303,22.47220505424423,33,21,8,1439,1151,1636,953,42,0.28
0,1,0,-0.0,1.0,0.6119687557220459,22.135943621178654,33,21,7,1439,1151,1636,953,42,0.22
0,1,0,-0.0,1.0,0.6227226257324219,21.840329667841555,33,21,6,1439,1151,1636,953,42,0.15
0,0,1,-0.0,-0.0,0.6229116916656494,21.840329667841555,33,21,6,1439,1151,1636,953,42,33.46
1,0,1,1.0,-0.0,0.6599926948547363,20.8806130178211,33,20,6,1439,1151,1636,953,42,12.4
0,0,0,-0.0,-0.0,0.7199327945709229,20.8806130178211,33,20,6,1439,1151,1636,953,42,23.17
0,-1,0,-0.0,-1.0,0.772573709487915,21.18962010041709,33,20,7,1439,1151,1636,953,42,1.19
-1,-2,0,-1.0,-2.0,0.7799208164215088,22.847319317591726,33,21,9,1439,1151,1636,953,42,0.49
-1,-3,0,-1.0,-3.0,0.7879388332366943,25.059928172283335,33,22,12,1439,1151,1636,953,42,0.14
-1,-2,0,-1.0,-2.0,0.7959616184234619,26.92582403567252,33,23,14,1439,1151,1636,953,42,0.9
-1,-2,0,-1.0,-2.0,0.804722785949707,28.844410203711913,33,24,16,1439,1151,1636,953,42,1.05
-1,-4,0,-1.0,-4.0,0.8119256496429443,32.01562118716424,33,25,20,1439,1151,1636,953,42,0.25
-2,-2,0,-2.0,-2.0,0.8199286460876465,34.828149534535996,33,27,22,1439,1151,1636,953,42,3.18
-1,-4,0,-1.0,-4.0,0.8287308216094971,38.2099463490856,33,28,26,1439,1151,1636,953,42,0.57
-1,-3,0,-1.0,-3.0,0.8359227180480957,41.012193308819754,33,29,29,1439,1151,1636,953,42,1.17
0,-4,0,-0.0,-4.0,0.8439207077026367,43.93176527297759,33,29,33,1439,1151,1636,953,42,0.46
0,-1,0,-0.0,-1.0,0.8519127368927002,44.68780594300866,33,29,34,1439,1151,1636,953,42,1.7
0,-2,0,-0.0,-2.0,0.8599147796630859,46.22769732530488,33,29,36,1439,1151,1636,953,42,1.17
0,-2,0,-0.0,-2.0,0.8681466579437256,47.80167361086848,33,29,38,1439,1151,1636,953,42,1.23
0,-1,0,-0.0,-1.0,0.8839206695556641,48.60041152089147,33,29,39,1439,1151,1636,953,42,1.86
0,0,1,-0.0,-0.0,0.9389486312866211,48.60041152089147,33,29,39,1439,1151,1636,953,42,31.64
0,0,0,-0.0,-0.0,1.0099427700042725,48.60041152089147,33,29,39,1439,1151,1636,953,42,31.64
0,1,0,-0.0,1.0,1.0439856052398682,47.80167361086848,33,29,38,1439,1151,1636,953,42,1.62
0,1,0,-0.0,1.0,1.075899600982666,47.01063709417264,33,29,37,1439,1151,1636,953,42,1.58
0,1,0,-0.0,1.0,1.0999267101287842,46.22769732530488,33,29,36,1439,1151,1636,953,42,1.54
0,1,0,-0.0,1.0,1.1162707805633545,45.45327270945405,33,29,35,1439,1151,1636,953,42,1.5
0,1,0,-0.0,1.0,1.1319167613983154,44.68780594300866,33,29,34,1439,1151,1636,953,42,1.46
0,1,0,-0.0,1.0,1.1399507522583008,43.93176527297759,33,29,33,1439,1151,1636,953,42,1.42
0,1,0,-0.0,1.0,1.1559116840362549,43.18564576337837,33,29,32,1439,1151,1636,953,42,1.38
0,1,0,-0.0,1.0,1.163954734802246,42.44997055358225,33,29,31,1439,1151,1636,953,42,1.33
1,2,0,1.0,2.0,1.1719436645507812,40.311288741492746,33,28,29,1439,1151,1636,953,42,3.0
1,1,0,1.0,1.0,1.1803367137908936,38.897300677553446,33,27,28,1439,1151,1636,953,42,6.12
1,2,0,1.0,2.0,1.1879146099090576,36.76955262170047,33,26,26,1439,1151,1636,953,42,2.83
1,2,0,1.0,2.0,1.196253776550293,34.655446902326915,33,25,24,1439,1151,1636,953,42,2.68
0,2,0,-0.0,2.0,1.2043476104736328,33.301651610693426,33,25,22,1439,1151,1636,953,42,1.11
2,2,0,2.0,2.0,1.2119126319885254,30.479501308256342,33,23,20,1439,1151,1636,953,42,4.86
2,2,0,2.0,2.0,1.2200887203216553,27.65863337187866,33,21,18,1439,1151,1636,953,42,4.63
1,2,0,1.0,2.0,1.2279345989227295,25.612496949731394,33,20,16,1439,1151,1636,953,42,2.04
1,1,0,1.0,1.0,1.2359037399291992,24.20743687382041,33,19,15,1439,1151,1636,953,42,3.75
1,1,0,1.0,1.0,1.244018793106079,22.80350850198276,33,18,14,1439,1151,1636,953,42,3.63
0,1,0,-0.0,1.0,1.252140760421753,22.20360331117452,33,18,13,1439,1151,1636,953,42,0.68
0,0,1,-0.0,-0.0,1.2641546726226807,22.20360331117452,33,18,13,1439,1151,1636,953,42,33.57
0,0,0,-0.0,-0.0,1.334932804107666,22.20360331117452,33,18,13,1439,1151,1636,953,42,23.57
0,0,1,-0.0,-0.0,1.5339527130126953,22.20360331117452,33,18,13,1439,1151,1636,953,42,33.57
0,0,0,-0.0,-0.0,0.0600433349609375,1114.406119868336,34,-435,-1026,986,112,1421,1138,68,218.55
-1,0,0,-1.0,-0.0,0.24427247047424316,1114.016157872048,34,-434,-1026,986,112,1421,1138,68,1.75
-2,-3,0,-2.0,-3.0,0.2568643093109131,1110.4742230236593,34,-432,-1023,986,112,1421,1138,68,13.52
-2,-4,0,-2.0,-4.0,0.2600975036621094,1106.0113019314042,34,-430,-1019,986,112,1421,1138,68,17.37
-3,-5,0,-3.0,-5.0,0.26844143867492676,1100.2386104841078,34,-427,-1014,986,112,1421,1138,68,19.85
-3,-7,0,-3.0,-7.0,0.2760324478149414,1092.62299078868,34,-424,-1007,986,112,1421,1138,68,27.27
-5,-12,0,-5.0,-12.0,0.2844502925872803,1079.6230823764374,34,-419,-995,986,112,1421,1138,68,39.73
-10,-16,0,-10.0,-16.0,0.2920854091644287,1061.0004712534299,34,-409,-979,986,112,1421,1138,68,47.37
-16,-21,0,-16.0,-21.0,0.300060510635376,1035.4771846834676,34,-393,-958,986,112,1421,1138,68,57.8
-20,-26,0,-20.0,-26.0,0.30809450149536133,1003.8690153600718,34,-373,-932,986,112,1421,1138,68,65.52
-23,-28,0,-23.0,-28.0,0.3166203498840332,969.3894986020841,34,-350,-904,986,112,1421,1138,68,67.73
-25,-30,0,-25.0,-30.0,0.32404041290283203,932.4703748645315,34,-325,-874,986,112,1421,1138,68,69.05
-25,-32,0,-25.0,-32.0,0.3320624828338623,893.8478617751457,34,-300,-842,986,112,1421,1138,68,69.35
-27,-35,0,-27.0,-35.0,0.3400914669036865,851.926053129026,34,-273,-807,986,112,1421,1138,68,70.79
-27,-36,0,-27.0,-36.0,0.3480794429779053,809.2941368872013,34,-246,-771,986,112,1421,1138,68,69.31
-26,-36,0,-26.0,-36.0,0.3560473918914795,767.2190039356428,34,-220,-735,986,112,1421,1138,68,66.58
-26,-36,0,-26.0,-36.0,0.36493444442749023,725.4219461802903,34,-194,-699,986,112,1421,1138,68,64.0
-21,-35,0,-21.0,-35.0,0.37207841873168945,686.1668893206667,34,-173,-664,986,112,1421,1138,68,59.85
-18,-30,0,-18.0,-30.0,0.38100647926330566,652.6721994998715,34,-155,-634,986,112,1421,1138,68,52.5
-13,-29,0,-13.0,-29.0,0.38829636573791504,621.4410671978478,34,-142,-605,986,112,1421,1138,68,49.3
-9,-28,0,-9.0,-28.0,0.3960423469543457,592.1300532822161,34,-133,-577,986,112,1421,1138,68,47.0
-8,-28,0,-8.0,-28.0,0.404064416885376,563.0506193940292,34,-125,-549,986,112,1421,1138,68,45.89
-5,-25,0,-5.0,-25.0,0.41202545166015625,537.5648798052194,34,-120,-524,986,112,1421,1138,68,41.76
-5,-27,0,-5.0,-27.0,0.42007946968078613,510.13135563303695,34,-115,-497,986,112,1421,1138,68,41.9
-4,-23,0,-4.0,-23.0,0.4280703067779541,486.8233765956602,34,-111,-474,986,112,1421,1138,68,36.41
-5,-20,0,-5.0,-20.0,0.4362354278564453,466.21025299750755,34,-106,-454,986,112,1421,1138,68,34.04
-4,-18,0,-4.0,-18.0,0.44402551651000977,447.7722635447622,34,-102,-436,986,112,1421,1138,68,31.22
-4,-19,0,-4.0,-19.0,0.4520573616027832,428.3608292082739,34,-98,-417,986,112,1421,1138,68,30.86
-3,-16,0,-3.0,-16.0,0.46007847785949707,412.09950254762504,34,-95,-401,986,112,1421,1138,68,26.21
-3,-14,0,-3.0,-14.0,0.46804332733154297,397.7851178714458,34,-92,-387,986,112,1421,1138,68,24.37
-4,-14,0,-4.0,-14.0,0.4760453701019287,383.24013359772226,34,-88,-373,986,112,1421,1138,68,23.37
-3,-13,0,-3.0,-13.0,0.48412036895751953,369.8986347636336,34,-85,-360,986,112,1421,1138,68,23.35
-4,-14,0,-4.0,-14.0,0.49204230308532715,355.3547523250533,34,-81,-346,986,112,1421,1138,68,22.33
-5,-13,0,-5.0,-13.0,0.5000665187835693,341.5625857730908,34,-76,-333,986,112,1421,1138,68,19.74
-4,-11,0,-4.0,-11.0,0.5087482929229736,329.95151158920305,34,-72,-322,986,112,1421,1138,68,17.32
-4,-12,0,-4.0,-12.0,0.5161044597625732,317.37044600907626,34,-68,-310,986,112,1421,1138,68,18.12
-4,-10,0,-4.0,-10.0,0.5251164436340332,306.7507131206055,34,-64,-300,986,112,1421,1138,68,15.25
-4,-10,0,-4.0,-10.0,0.533968448638916,296.1418578992169,34,-60,-290,986,112,1421,1138,68,14.87
-4,-10,0,-4.0,-10.0,0.5401673316955566,285.545092761196,34,-56,-280,986,112,1421,1138,68,14.48
-4,-10,0,-4.0,-10.0,0.5485513210296631,274.96181553081146,34,-52,-270,986,112,1421,1138,68,14.09
-4,-11,0,-4.0,-11.0,0.5588715076446533,263.41032629720496,34,-48,-259,986,112,1421,1138,68,14.75
-4,-10,0,-4.0,-10.0,0.5641903877258301,252.85766747322495,34,-44,-249,986,112,1421,1138,68,13.26
-3,-10,0,-3.0,-10.0,0.57208251953125,242.4912369550702,34,-41,-239,986,112,1421,1138,68,13.47
-5,-10,0,-5.0,-10.0,0.580052375793457,231.81242417092315,34,-36,-229,986,112,1421,1138,68,12.1
-4,-10,0,-4.0,-10.0,0.5881505012512207,221.32555207205516,34,-32,-219,986,112,1421,1138,68,11.97
-4,-10,0,-4.0,-10.0,0.5960533618927002,210.86725682286476,34,-28,-209,986,112,1421,1138,68,11.53
-3,-9,0,-3.0,-9.0,0.6068823337554932,201.55644370746373,34,-25,-200,986,112,1421,1138,68,10.69
-3,-8,0,-3.0,-8.0,0.6122653484344482,193.25630649476875,34,-22,-192,986,112,1421,1138,68,9.41
-3,-9,0,-3.0,-9.0,0.6201143264770508,183.98369492974098,34,-19,-183,986,112,1421,1138,68,9.96
-2,-9,0,-2.0,-9.0,0.6280553340911865,174.82848738120455,34,-17,-174,986,112,1421,1138,68,10.38
-2,-10,0,-2.0,-10.0,0.6361052989959717,164.68454693747074,34,-15,-164,986,112,1421,1138,68,10.82
-2,-9,0,-2.0,-9.0,0.6488723754882812,155.54420593516173,34,-13,-155,986,112,1421,1138,68,9.58
-1,-8,0,-1.0,-8.0,0.6523993015289307,147.48898263938224,34,-12,-147,986,112,1421,1138,68,10.11
-1,-8,0,-1.0,-8.0,0.6619844436645508,139.43457247038842,34,-11,-139,986,112,1421,1138,68,9.79
-1,-8,0,-1.0,-8.0,0.6680514812469482,131.38112497615478,34,-10,-131,986,112,1421,1138,68,9.47
-2,-8,0,-2.0,-8.0,0.6760733127593994,123.25988804148737,34,-8,-123,986,112,1421,1138,68,7.55
-1,-7,0,-1.0,-7.0,0.6840252876281738,116.21101496846157,34,-7,-116,986,112,1421,1138,68,7.85
-2,-7,0,-2.0,-7.0,0.6922504901885986,109.1146186356347,34,-5,-109,986,112,1421,1138,68,6.25
-2,-6,0,-2.0,-6.0,0.7002873420715332,103.04368005850722,34,-3,-103,986,112,1421,1138,68,5.3
-1,-5,0,-1.0,-5.0,0.7080643177032471,98.02040603874276,34,-2,-98,986,112,1421,1138,68,5.41
-1,-4,0,-1.0,-4.0,0.7173624038696289,94.00531899844816,34,-1,-94,986,112,1421,1138,68,4.51
0,-4,0,-0.0,-4.0,0.7240543365478516,90.00555538409837,34,-1,-90,986,112,1421,1138,68,7.81
-1,-5,0,-1.0,-5.0,0.7324173450469971,85.0,34,0,-85,986,112,1421,1138,68,4.93
-1,-4,0,-1.0,-4.0,0.7441074848175049,81.00617260431454,34,1,-81,986,112,1421,1138,68,4.1
-1,-4,0,-1.0,-4.0,0.7487494945526123,77.02596964660685,34,2,-77,986,112,1421,1138,68,3.94
0,-4,0,-0.0,-4.0,0.7567684650421143,73.02739212103907,34,2,-73,986,112,1421,1138,68,6.72
-1,-3,0,-1.0,-3.0,0.7640573978424072,70.06425622241343,34,3,-70,986,112,1421,1138,68,3.06
-1,-3,0,-1.0,-3.0,0.7720553874969482,67.11929677819934,34,4,-67,986,112,1421,1138,68,2.94
0,-3,0,-0.0,-3.0,0.7814123630523682,64.1248781675256,34,4,-64,986,112,1421,1138,68,5.31
-1,-3,0,-1.0,-3.0,0.7885873317718506,61.204574992397426,34,5,-61,986,112,1421,1138,68,2.74
0,-3,0,-0.0,-3.0,0.7960703372955322,58.215118311311535,34,5,-58,986,112,1421,1138,68,4.8
0,-4,0,-0.0,-4.0,0.8040604591369629,54.230987451824994,34,5,-54,986,112,1421,1138,68,4.87
0,-3,0,-0.0,-3.0,0.8121933937072754,51.24451190127583,34,5,-51,986,112,1421,1138,68,4.5
0,-3,0,-0.0,-3.0,0.820392370223999,48.25971404805462,34,5,-48,986,112,1421,1138,68,4.36
0,-2,0,-0.0,-2.0,0.8280603885650635,46.2709412050371,34,5,-46,986,112,1421,1138,68,4.08
1,-1,0,1.0,-1.0,0.8364465236663818,45.17742799230607,34,4,-45,986,112,1421,1138,68,1.35
0,-2,0,-0.0,-2.0,0.844036340713501,43.18564576337837,34,4,-43,986,112,1421,1138,68,4.23
1,-1,0,1.0,-1.0,0.8520293235778809,42.1070065428546,34,3,-42,986,112,1421,1138,68,1.28
0,-1,0,-0.0,-1.0,-0.0031223297119140625,852.1502214985337,35,848,84,1831,237,983,154,73,22.4
0,0,1,-0.0,-0.0,0.00484466552734375,852.1502214985337,35,848,84,1831,237,983,154,73,187.5
0,-1,1,-0.0,-1.0,0.0050466060638427734,852.249376649816,35,848,85,1831,237,983,154,73,22.17
1,-1,1,1.0,-1.0,0.012833595275878906,851.354802652807,35,847,86,1831,237,983,154,73,3.12
0,0,0,-0.0,-0.0,0.08386874198913574,851.354802652807,35,847,86,1831,237,983,154,73,187.4
-1,0,0,-1.0,-0.0,0.22096657752990723,852.3496934944014,35,848,86,1831,237,983,154,73,6.32
-1,0,0,-1.0,-0.0,0.2291557788848877,853.3445962798381,35,849,86,1831,237,983,154,73,6.32
-1,0,0,-1.0,-0.0,0.24526071548461914,854.3395109673905,35,850,86,1831,237,983,154,73,6.33
5,0,0,5.0,-0.0,0.5488395690917969,849.3650569690279,35,845,86,1831,237,983,154,73,15.33
8,1,0,8.0,1.0,0.5568866729736328,841.3049387707171,35,837,85,1831,237,983,154,73,23.2
8,1,0,8.0,1.0,0.5648276805877686,833.2448619703574,35,829,84,1831,237,983,154,73,23.09
10,0,0,10.0,-0.0,0.5728867053985596,823.2964229243316,35,819,84,1831,237,983,154,73,24.98
10,0,0,10.0,-0.0,0.5808568000793457,813.3492484781676,35,809,84,1831,237,983,154,73,24.8
11,0,0,11.0,-0.0,0.5911297798156738,802.4088733307976,35,798,84,1831,237,983,154,73,26.41
12,0,0,12.0,-0.0,0.5968647003173828,790.4758060813753,35,786,84,1831,237,983,154,73,27.93
10,0,0,10.0,-0.0,0.6050965785980225,780.5331511217189,35,776,84,1831,237,983,154,73,24.21
9,1,0,9.0,1.0,0.6156947612762451,771.4778026618783,35,767,83,1831,237,983,154,73,25.18
10,2,0,10.0,2.0,0.620957612991333,761.3212199853621,35,757,81,1831,237,983,154,73,24.49
12,1,0,12.0,1.0,0.6288397312164307,749.2829905983452,35,745,80,1831,237,983,154,73,28.94
12,2,0,12.0,2.0,0.6368246078491211,737.1383859222093,35,733,78,1831,237,983,154,73,27.95
12,2,0,12.0,2.0,0.6448616981506348,724.9944827376274,35,721,76,1831,237,983,154,73,27.68
11,2,0,11.0,2.0,0.652857780456543,713.8459217506254,35,710,74,1831,237,983,154,73,25.55
11,2,0,11.0,2.0,0.6623847484588623,702.6983705687669,35,699,72,1831,237,983,154,73,25.31
14,3,0,14.0,3.0,0.6688327789306641,688.4664116716225,35,685,69,1831,237,983,154,73,29.41
13,3,0,13.0,3.0,0.6768877506256104,675.2332930180502,35,672,66,1831,237,983,154,73,27.39
14,3,0,14.0,3.0,0.6851515769958496,661.0090770934995,35,658,63,1831,237,983,154,73,28.68
10,3,0,10.0,3.0,0.6928355693817139,650.7718494218999,35,648,60,1831,237,983,154,73,21.64
12,4,0,12.0,4.0,0.7010586261749268,638.4606487482216,35,636,56,1831,237,983,154,73,24.38
12,4,0,12.0,4.0,0.7090167999267578,626.1629180971994,35,624,52,1831,237,983,154,73,24.06
10,4,0,10.0,4.0,0.7192106246948242,615.8733636065128,35,614,48,1831,237,983,154,73,20.49
12,3,0,12.0,3.0,0.724942684173584,603.6795507551999,35,602,45,1831,237,983,154,73,23.85
12,4,0,12.0,4.0,0.732865571975708,591.4228605659406,35,590,41,1831,237,983,154,73,23.13
13,4,0,13.0,4.0,0.7427055835723877,578.1850914715806,35,577,37,1831,237,983,154,73,24.29
12,4,0,12.0,4.0,0.7488856315612793,565.9628963103501,35,565,33,1831,237,983,154,73,22.43
14,4,0,14.0,4.0,0.7568585872650146,551.762630122773,35,551,29,1831,237,983,154,73,24.94
15,4,0,15.0,4.0,0.7665607929229736,536.5827056475079,35,536,25,1831,237,983,154,73,25.83
16,3,0,16.0,3.0,0.7728557586669922,520.4651765488254,35,520,22,1831,237,983,154,73,27.04
16,4,0,16.0,4.0,0.7808465957641602,504.3213261403884,35,504,18,1831,237,983,154,73,26.05
17,4,0,17.0,4.0,0.788827657699585,487.201190474736,35,487,14,1831,237,983,154,73,26.65
17,4,0,17.0,4.0,0.7972795963287354,470.1063709417263,35,470,10,1831,237,983,154,73,25.99
17,4,0,17.0,4.0,0.8048436641693115,453.0397333567995,35,453,6,1831,237,983,154,73,25.32
18,4,0,18.0,4.0,0.8141217231750488,435.00459767685214,35,435,2,1831,237,983,154,73,25.7
18,3,0,18.0,3.0,0.8208866119384766,417.0011990390435,35,417,-1,1831,237,983,154,73,25.32
19,4,0,19.0,4.0,0.8288676738739014,398.0314057960753,35,398,-5,1831,237,983,154,73,25.13
19,3,0,19.0,3.0,0.8376696109771729,379.0844233149128,35,379,-8,1831,237,983,154,73,24.63
18,4,0,18.0,4.0,0.8448746204376221,361.19939091864484,35,361,-12,1831,237,983,154,73,22.46
19,2,0,19.0,2.0,0.8528537750244141,342.28642976314444,35,342,-14,1831,237,983,154,73,23.3
18,3,0,18.0,3.0,0.8608217239379883,324.4456811239749,35,324,-17,1831,237,983,154,73,21.11
19,2,0,19.0,2.0,0.8697636127471924,305.5912302406599,35,305,-19,1831,237,983,154,73,21.44
20,2,0,20.0,2.0,0.8790426254272461,285.7726368986366,35,285,-21,1831,237,983,154,73,21.18
18,2,0,18.0,2.0,0.8848977088928223,267.9888057363591,35,267,-23,1831,237,983,154,73,18.71
18,1,0,18.0,1.0,0.8938117027282715,250.15395259719563,35,249,-24,1831,237,983,154,73,18.27
19,1,0,19.0,1.0,0.9024286270141602,231.3547060251855,35,230,-25,1831,237,983,154,73,17.89
16,1,0,16.0,1.0,0.9090406894683838,215.5736533067063,35,214,-26,1831,237,983,154,73,15.07
15,1,0,15.0,1.0,0.9176266193389893,200.8233054204616,35,199,-27,1831,237,983,154,73,13.65
14,1,0,14.0,1.0,0.926093578338623,187.1069213043708,35,185,-28,1831,237,983,154,73,12.31
15,0,0,15.0,-0.0,0.9329726696014404,172.29045243425418,35,170,-28,1831,237,983,154,73,12.68
15,1,0,15.0,1.0,0.9411277770996094,157.68956845650888,35,155,-29,1831,237,983,154,73,11.28
13,2,0,13.0,2.0,0.9492807388305664,145.34441853748632,35,142,-31,1831,237,983,154,73,9.07
12,1,0,12.0,1.0,0.9568226337432861,133.88054376943649,35,130,-32,1831,237,983,154,73,8.35
12,1,0,12.0,1.0,0.9652516841888428,122.5275479229059,35,118,-33,1831,237,983,154,73,7.7
12,2,0,12.0,2.0,0.9728286266326904,111.6288493177279,35,106,-35,1831,237,983,154,73,6.59
10,2,0,10.0,2.0,0.9808735847473145,102.88342918079665,35,96,-37,1831,237,983,154,73,5.17
10,1,0,10.0,1.0,0.9889156818389893,94.02127418834527,35,86,-38,1831,237,983,154,73,5.03
8,1,0,8.0,1.0,0.9968557357788086,87.20665112249179,35,78,-39,1831,237,983,154,73,3.88
9,2,0,9.0,2.0,1.0084266662597656,80.26207074328447,35,69,-41,1831,237,983,154,73,3.29
9,1,0,9.0,1.0,1.0128445625305176,73.23933369440222,35,60,-42,1831,237,983,154,73,3.15
8,0,0,8.0,-0.0,1.0226006507873535,66.84309986827361,35,52,-42,1831,237,983,154,73,2.87
8,0,0,8.0,-0.0,1.0307447910308838,60.8276253029822,35,44,-42,1831,237,983,154,73,2.38
6,0,0,6.0,-0.0,1.036881685256958,56.639209034025185,35,38,-42,1831,237,983,154,73,1.7
4,0,0,4.0,-0.0,1.0448577404022217,54.037024344425184,35,34,-42,1831,237,983,154,73,1.23
4,-1,0,4.0,-1.0,1.052842617034912,50.80354318352215,35,30,-41,1831,237,983,154,73,1.69
2,-1,0,2.0,-1.0,1.0608506202697754,48.82622246293481,35,28,-40,1831,237,983,154,73,1.97
2,-1,0,2.0,-1.0,1.0690677165985107,46.87216658103186,35,26,-39,1831,237,983,154,73,1.87
3,-1,0,3.0,-1.0,1.0803327560424805,44.41846462902562,35,23,-38,1831,237,983,154,73,1.42
3,-2,0,3.0,-2.0,1.0851876735687256,41.182520563948,35,20,-36,1831,237,983,154,73,2.04
3,-1,0,3.0,-1.0,1.095491647720337,38.91015291668744,35,17,-35,1831,237,983,154,73,1.08
3,-2,0,3.0,-2.0,1.1008667945861816,35.84689665786984,35,14,-33,1831,237,983,154,73,1.57
3,-1,0,3.0,-1.0,1.1096906661987305,33.83784863137726,35,11,-32,1831,237,983,154,73,0.7
2,-2,0,2.0,-2.0,1.1192667484283447,31.32091952673165,35,9,-30,1831,237,983,154,73,1.66
3,-1,0,3.0,-1.0,1.1250646114349365,29.614185789921695,35,6,-29,1831,237,983,154,73,0.35
4,-1,0,4.0,-1.0,1.133441686630249,28.071337695236398,35,2,-28,1831,237,983,154,73,-0.11
3,-2,0,3.0,-2.0,1.1424567699432373,26.019223662515376,35,-1,-26,1831,237,983,154,73,0.28
4,-1,0,4.0,-1.0,1.149000644683838,25.495097567963924,35,-5,-25,1831,237,983,154,73,-0.64
4,-2,0,4.0,-2.0,1.1568396091461182,24.698178070456937,35,-9,-23,1831,237,983,154,73,-0.63
3,-1,0,3.0,-1.0,1.1653575897216797,25.059928172283335,35,-12,-22,1831,237,983,154,73,-0.03
3,-1,0,3.0,-1.0,1.1728546619415283,25.80697580112788,35,-15,-21,1831,237,983,154,73,-0.26
1,-1,0,1.0,-1.0,1.1808497905731201,25.612496949731394,35,-16,-20,1831,237,983,154,73,-0.13
1,0,0,1.0,-0.0,1.1945955753326416,26.248809496813376,35,-17,-20,1831,237,983,154,73,0.91
0,0,1,-0.0,-0.0,1.2098755836486816,26.248809496813376,35,-17,-20,1831,237,983,154,73,34.81
0,0,0,-0.0,-0.0,0.08958601951599121,1217.0903828393355,36,-1078,565,770,822,1848,257,45,229.46
-2,1,0,-2.0,1.0,0.09755301475524902,1214.8547238250342,36,-1076,564,770,822,1848,257,45,16.1
-1,1,0,-1.0,1.0,0.10559296607971191,1213.5048413582865,36,-1075,563,770,822,1848,257,45,8.91
-1,1,0,-1.0,1.0,0.12154603004455566,1212.1551055867396,36,-1074,562,770,822,1848,257,45,8.9
-1,0,0,-1.0,-0.0,0.26557111740112305,1211.269169094962,36,-1073,562,770,822,1848,257,45,6.08
-2,1,0,-2.0,1.0,0.27380990982055664,1209.0334982952293,36,-1071,561,770,822,1848,257,45,16.08
-3,1,0,-3.0,1.0,0.2815709114074707,1205.9121029328796,36,-1068,560,770,822,1848,257,45,17.64
-4,1,0,-4.0,1.0,0.2924211025238037,1201.9055703340425,36,-1064,559,770,822,1848,257,45,20.82
-5,1,0,-5.0,1.0,0.2976799011230469,1197.0150374995294,36,-1059,558,770,822,1848,257,45,24.1
-7,1,0,-7.0,1.0,0.30675506591796875,1190.3583494057577,36,-1052,557,770,822,1848,257,45,30.55
-8,2,0,-8.0,2.0,0.31499195098876953,1182.3540079011868,36,-1044,555,770,822,1848,257,45,35.76
-9,2,0,-9.0,2.0,0.3218650817871094,1173.4709199635072,36,-1035,553,770,822,1848,257,45,38.48
-11,2,0,-11.0,2.0,0.32960009574890137,1162.8314581228012,36,-1024,551,770,822,1848,257,45,43.81
-13,4,0,-13.0,4.0,0.33781909942626953,1149.4911917887844,36,-1011,547,770,822,1848,257,45,52.21
-14,4,0,-14.0,4.0,0.3455679416656494,1135.2788203785008,36,-997,543,770,822,1848,257,45,54.14
-18,6,0,-18.0,6.0,0.3535780906677246,1116.6064660389532,36,-979,537,770,822,1848,257,45,65.17
-21,8,0,-21.0,8.0,0.3615689277648926,1094.351406084901,36,-958,529,770,822,1848,257,45,72.64
-26,8,0,-26.0,8.0,0.36954593658447266,1067.7382638081301,36,-932,521,770,822,1848,257,45,79.49
-31,12,0,-31.0,12.0,0.3775670528411865,1034.834286250702,36,-901,509,770,822,1848,257,45,88.85
-33,13,0,-33.0,13.0,0.38558506965637207,999.7199607890202,36,-868,496,770,822,1848,257,45,90.29
-35,16,0,-35.0,16.0,0.39354801177978516,961.3995007279752,36,-833,480,770,822,1848,257,45,93.01
-39,17,0,-39.0,17.0,0.4015629291534424,919.1327434054343,36,-794,463,770,822,1848,257,45,94.95
-40,19,0,-40.0,19.0,0.4100339412689209,875.0154284354077,36,-754,444,770,822,1848,257,45,94.57
-41,18,0,-41.0,18.0,0.417604923248291,830.5690820154576,36,-713,426,770,822,1848,257,45,91.6
-41,19,0,-41.0,19.0,0.42556309700012207,785.6417758749849,36,-672,407,770,822,1848,257,45,89.24
-41,20,0,-41.0,20.0,0.4345700740814209,740.2229393905595,36,-631,387,770,822,1848,257,45,86.72
-40,20,0,-40.0,20.0,0.4415919780731201,695.6795239188804,36,-591,367,770,822,1848,257,45,82.81
-39,20,0,-39.0,20.0,0.4561769962310791,652.006901803961,36,-552,347,770,822,1848,257,45,78.9
-36,20,0,-36.0,20.0,0.45789504051208496,610.8886968998526,36,-516,327,770,822,1848,257,45,74.11
-36,20,0,-36.0,20.0,0.46815991401672363,569.7797820210893,36,-480,307,770,822,1848,257,45,70.89
-33,19,0,-33.0,19.0,0.4735739231109619,531.745239753023,36,-447,288,770,822,1848,257,45,65.58
-31,19,0,-31.0,19.0,0.4819529056549072,495.3958013548359,36,-416,269,770,822,1848,257,45,62.1
-27,17,0,-27.0,17.0,0.49245691299438477,463.49217900629134,36,-389,252,770,822,1848,257,45,56.26
-25,16,0,-25.0,16.0,0.4976339340209961,433.81101876277876,36,-364,236,770,822,1848,257,45,52.49
-21,15,0,-21.0,15.0,0.5055880546569824,408.0318615010352,36,-343,221,770,822,1848,257,45,45.08
-17,13,0,-17.0,13.0,0.5158069133758545,386.7040211841609,36,-326,208,770,822,1848,257,45,38.34
-14,11,0,-14.0,11.0,0.5216529369354248,368.9891597323694,36,-312,197,770,822,1848,257,45,32.94
-11,10,0,-11.0,10.0,0.5320730209350586,354.3585754571208,36,-301,187,770,822,1848,257,45,27.64
-10,9,0,-10.0,9.0,0.5375750064849854,341.1231449198368,36,-291,178,770,822,1848,257,45,25.2
-7,7,0,-7.0,7.0,0.5456469058990479,331.50716432680605,36,-284,171,770,822,1848,257,45,19.49
-8,9,0,-8.0,9.0,0.556102991104126,320.0312484742701,36,-276,162,770,822,1848,257,45,21.22
-7,8,0,-7.0,8.0,0.5616650581359863,309.9629010059107,36,-269,154,770,822,1848,257,45,18.85
-7,7,0,-7.0,7.0,0.5697770118713379,300.42137074449283,36,-262,147,770,822,1848,257,45,18.04
-7,9,0,-7.0,9.0,0.5795509815216064,289.9465467978538,36,-255,138,770,822,1848,257,45,18.24
-7,7,0,-7.0,7.0,0.5856130123138428,280.4728150819612,36,-248,131,770,822,1848,257,45,17.04
-8,9,0,-8.0,9.0,0.5936129093170166,269.2285274631944,36,-240,122,770,822,1848,257,45,18.39
-8,8,0,-8.0,8.0,0.6026880741119385,258.49564793241683,36,-232,114,770,822,1848,257,45,17.5
-9,8,0,-9.0,8.0,0.6095860004425049,246.9109151090733,36,-223,106,770,822,1848,257,45,18.1
-8,7,0,-8.0,7.0,0.6175589561462402,236.6981199756348,36,-215,99,770,822,1848,257,45,16.12
-7,7,0,-7.0,7.0,0.6260209083557129,227.437903613272,36,-208,92,770,822,1848,257,45,14.33
-6,5,0,-6.0,5.0,0.633652925491333,219.93862780330335,36,-202,87,770,822,1848,257,45,12.43
-5,5,0,-5.0,5.0,0.6415679454803467,213.3846292496252,36,-197,82,770,822,1848,257,45,10.7
-6,4,0,-6.0,4.0,0.6495449542999268,206.31286920597077,36,-191,78,770,822,1848,257,45,11.97
-7,6,0,-7.0,6.0,0.6576080322265625,197.5854245636555,36,-184,72,770,822,1848,257,45,12.64
-6,4,0,-6.0,4.0,0.6655569076538086,190.5465822312224,36,-178,68,770,822,1848,257,45,11.23
-8,5,0,-8.0,5.0,0.6736619472503662,181.29809706668186,36,-170,63,770,822,1848,257,45,13.12
-8,3,0,-8.0,3.0,0.6823759078979492,172.75416058665562,36,-162,60,770,822,1848,257,45,15.83
-7,4,0,-7.0,4.0,0.6895930767059326,164.80594649465777,36,-155,56,770,822,1848,257,45,11.46
-6,4,0,-6.0,4.0,0.6975860595703125,157.8131806916013,36,-149,52,770,822,1848,257,45,9.81
-4,2,0,-4.0,2.0,0.7055881023406982,153.37861650177967,36,-145,50,770,822,1848,257,45,8.2
-4,3,0,-4.0,3.0,0.7135570049285889,148.62705002791384,36,-141,47,770,822,1848,257,45,7.15
-5,2,0,-5.0,2.0,0.721642017364502,143.2515270424717,36,-136,45,770,822,1848,257,45,9.74
-6,3,0,-6.0,3.0,0.7295660972595215,136.61625086350452,36,-130,42,770,822,1848,257,45,9.41
-5,4,0,-5.0,4.0,0.7375481128692627,130.64838307457157,36,-125,38,770,822,1848,257,45,7.39
-7,3,0,-7.0,3.0,0.7456350326538086,123.08127396155761,36,-118,35,770,822,1848,257,45,9.9
-6,5,0,-6.0,5.0,0.7535529136657715,115.94826432508596,36,-112,30,770,822,1848,257,45,7.47
-7,4,0,-7.0,4.0,0.7615489959716797,108.17116066678771,36,-105,26,770,822,1848,257,45,8.19
-8,5,0,-8.0,5.0,0.7695620059967041,99.24716620639605,36,-97,21,770,822,1848,257,45,8.1
-6,3,0,-6.0,3.0,0.7775769233703613,92.76313923105448,36,-91,18,770,822,1848,257,45,6.77
-7,5,0,-7.0,5.0,0.7855899333953857,85.0,36,-84,13,770,822,1848,257,45,6.31
-8,4,0,-8.0,4.0,0.7935669422149658,76.53103945458993,36,-76,9,770,822,1848,257,45,6.64
-8,4,0,-8.0,4.0,0.8015999794006348,68.18357573492314,36,-68,5,770,822,1848,257,45,5.95
-8,4,0,-8.0,4.0,0.8116099834442139,60.00833275470999,36,-60,1,770,822,1848,257,45,5.22
-8,4,0,-8.0,4.0,0.8180310726165771,52.08646657242167,36,-52,-3,770,822,1848,257,45,4.43
-7,3,0,-7.0,3.0,0.8255860805511475,45.39823785126467,36,-45,-6,770,822,1848,257,45,3.61
-5,2,0,-5.0,2.0,0.8345649242401123,40.792156108742276,36,-40,-8,770,822,1848,257,45,2.67
-5,3,0,-5.0,3.0,0.8415899276733398,36.68787265568828,36,-35,-11,770,822,1848,257,45,1.72
-3,2,0,-3.0,2.0,0.8497579097747803,34.539832078341085,36,-32,-13,770,822,1848,257,45,0.96
-3,1,0,-3.0,1.0,0.8578860759735107,32.202484376209235,36,-29,-14,770,822,1848,257,45,1.34
-1,1,0,-1.0,1.0,0.8655869960784912,31.76476034853718,36,-28,-15,770,822,1848,257,45,0.25
-1,0,0,-1.0,-0.0,0.8735980987548828,30.886890422961002,36,-27,-15,770,822,1848,257,45,1.77
-1,0,0,-1.0,-0.0,0.8895649909973145,30.01666203960727,36,-26,-15,770,822,1848,257,45,1.71
-1,0,0,-1.0,-0.0,0.9135499000549316,29.154759474226502,36,-25,-15,770,822,1848,257,45,1.65
0,0,1,-0.0,-0.0,0.9225759506225586,29.154759474226502,36,-25,-15,770,822,1848,257,45,35.69
-1,0,1,-1.0,-0.0,0.013028860092163086,323.484157262763,37,311,-89,1105,748,795,837,31,5.61
-1,0,1,-1.0,-0.0,0.04503488540649414,324.4456811239749,37,312,-89,1105,748,795,837,31,5.62
-1,0,1,-1.0,-0.0,0.0691378116607666,325.40743691563046,37,313,-89,1105,748,795,837,31,5.63
0,0,0,-0.0,-0.0,0.07901787757873535,325.40743691563046,37,313,-89,1105,748,795,837,31,102.26
-1,0,0,-1.0,-0.0,0.09308695793151855,326.3694225873496,37,314,-89,1105,748,795,837,31,5.64
-1,0,0,-1.0,-0.0,0.11707282066345215,327.33163611236847,37,315,-89,1105,748,795,837,31,5.65
-1,0,0,-1.0,-0.0,0.12501287460327148,328.29407548720707,37,316,-89,1105,748,795,837,31,5.66
1,0,0,1.0,-0.0,0.21301484107971191,327.33163611236847,37,315,-89,1105,748,795,837,31,5.43
4,-3,0,4.0,-3.0,0.22103190422058105,322.6716597409819,37,311,-86,1105,748,795,837,31,14.4
6,-3,0,6.0,-3.0,0.2292308807373047,316.0917588296158,37,305,-83,1105,748,795,837,31,19.19
8,-3,0,8.0,-3.0,0.23702478408813477,307.5857603986244,37,297,-80,1105,748,795,837,31,23.45
9,-4,0,9.0,-4.0,0.24578094482421875,297.85902705810344,37,288,-76,1105,748,795,837,31,24.4
11,-3,0,11.0,-3.0,0.2530088424682617,286.457675756821,37,277,-73,1105,748,795,837,31,29.38
11,-3,0,11.0,-3.0,0.26105594635009766,275.056357861439,37,266,-70,1105,748,795,837,31,28.67
12,-3,0,12.0,-3.0,0.26902174949645996,262.68802789621,37,254,-67,1105,748,795,837,31,28.99
11,-3,0,11.0,-3.0,0.2769949436187744,251.2866888635369,37,243,-64,1105,748,795,837,31,27.22
12,-4,0,12.0,-4.0,0.2850658893585205,238.66503723838562,37,231,-60,1105,748,795,837,31,26.02
11,-2,0,11.0,-2.0,0.2930309772491455,227.51703232945002,37,220,-58,1105,748,795,837,31,23.28
10,-3,0,10.0,-3.0,0.30146288871765137,217.0829334609241,37,210,-55,1105,748,795,837,31,22.64
10,-1,0,10.0,-1.0,0.30901575088500977,207.16177253537873,37,200,-54,1105,748,795,837,31,19.5
10,-2,0,10.0,-2.0,0.31782984733581543,196.98730923589977,37,190,-52,1105,748,795,837,31,20.27
9,-1,0,9.0,-1.0,0.3249928951263428,188.04786624686813,37,181,-51,1105,748,795,837,31,17.15
10,-2,0,10.0,-2.0,0.33300089836120605,177.88198334851114,37,171,-49,1105,748,795,837,31,18.83
9,-1,0,9.0,-1.0,0.34103894233703613,168.96153408394468,37,162,-48,1105,748,795,837,31,15.89
10,-1,0,10.0,-1.0,0.3536388874053955,159.10059710761615,37,152,-47,1105,748,795,837,31,16.09
10,-1,0,10.0,-1.0,0.35707783699035645,149.26486525636233,37,142,-46,1105,748,795,837,31,15.31
10,-1,0,10.0,-1.0,0.36499476432800293,139.4596715900335,37,132,-45,1105,748,795,837,31,14.52
9,0,0,9.0,-0.0,0.372999906539917,130.97327971765844,37,123,-45,1105,748,795,837,31,12.15
11,-1,0,11.0,-1.0,0.3810157775878906,120.33287165193059,37,112,-44,1105,748,795,837,31,13.54
11,0,0,11.0,-0.0,0.38899993896484375,110.16805344563369,37,101,-44,1105,748,795,837,31,11.87
11,0,0,11.0,-0.0,0.3970067501068115,100.17983829094555,37,90,-44,1105,748,795,837,31,10.84
8,0,0,8.0,-0.0,0.40538597106933594,93.05912099305473,37,82,-44,1105,748,795,837,31,8.19
7,-1,0,7.0,-1.0,0.41300296783447266,86.45229898620394,37,75,-43,1105,748,795,837,31,7.81
6,0,0,6.0,-0.0,0.4210348129272461,81.30190649671138,37,69,-43,1105,748,795,837,31,5.91
6,-2,0,6.0,-2.0,0.42964887619018555,75.16648189186454,37,63,-41,1105,748,795,837,31,7.41
4,0,0,4.0,-0.0,0.43702197074890137,71.84705978674423,37,59,-41,1105,748,795,837,31,4.06
5,-2,0,5.0,-2.0,0.4451258182525635,66.61080993352356,37,54,-39,1105,748,795,837,31,6.44
4,-1,0,4.0,-1.0,0.453021764755249,62.80127387243033,37,50,-38,1105,748,795,837,31,4.65
4,-2,0,4.0,-2.0,0.4610729217529297,58.412327466040935,37,46,-36,1105,748,795,837,31,5.81
3,-1,0,3.0,-1.0,0.4691159725189209,55.44366510251645,37,43,-35,1105,748,795,837,31,4.03
4,-1,0,4.0,-1.0,0.47855281829833984,51.73973328110612,37,39,-34,1105,748,795,837,31,3.91
3,-2,0,3.0,-2.0,0.4863708019256592,48.16637831516918,37,36,-32,1105,748,795,837,31,5.42
4,-2,0,4.0,-2.0,0.49303174018859863,43.86342439892262,37,32,-30,1105,748,795,837,31,4.55
2,-1,0,2.0,-1.0,0.5016238689422607,41.72529209005013,37,30,-29,1105,748,795,837,31,3.4
2,-1,0,2.0,-1.0,0.5093948841094971,39.59797974644666,37,28,-28,1105,748,795,837,31,3.26
2,-1,0,2.0,-1.0,0.5170128345489502,37.48332962798263,37,26,-27,1105,748,795,837,31,3.1
2,-1,0,2.0,-1.0,0.5250189304351807,35.38361202590826,37,24,-26,1105,748,795,837,31,2.95
1,-2,0,1.0,-2.0,0.5347268581390381,33.24154027718932,37,23,-24,1105,748,795,837,31,3.16
1,-1,0,1.0,-1.0,0.5410609245300293,31.827660925679098,37,22,-23,1105,748,795,837,31,6.05
1,-1,0,1.0,-1.0,0.5510997772216797,30.4138126514911,37,21,-22,1105,748,795,837,31,5.97
1,0,0,1.0,-0.0,0.5570187568664551,29.732137494637012,37,20,-22,1105,748,795,837,31,1.12
1,-1,0,1.0,-1.0,0.5650718212127686,28.319604517012593,37,19,-21,1105,748,795,837,31,5.12
1,-1,0,1.0,-1.0,0.5729949474334717,26.90724809414742,37,18,-20,1105,748,795,837,31,5.02
1,0,0,1.0,-0.0,0.5810277462005615,26.248809496813376,37,17,-20,1105,748,795,837,31,0.99
0,-1,0,-0.0,-1.0,0.5970048904418945,25.495097567963924,37,17,-19,1105,748,795,837,31,1.26
1,-1,0,1.0,-1.0,0.6050019264221191,24.08318915758459,37,16,-18,1105,748,795,837,31,4.81
1,0,0,1.0,-0.0,0.6210107803344727,23.430749027719962,37,15,-18,1105,748,795,837,31,0.92
0,-1,0,-0.0,-1.0,0.6290237903594971,22.67156809750927,37,15,-17,1105,748,795,837,31,1.22
0,0,1,-0.0,-0.0,0.6610238552093506,22.67156809750927,37,15,-17,1105,748,795,837,31,33.71
0,0,0,-0.0,-0.0,0.10983562469482422,542.6766993339588,38,-513,-177,577,588,1090,765,58,142.53
-1,1,0,-1.0,1.0,0.11077475547790527,542.0590373750815,38,-512,-178,577,588,1090,765,58,2.02
0,1,0,-0.0,1.0,0.12211155891418457,542.3882373355823,38,-512,-179,577,588,1090,765,58,7.22
-1,1,0,-1.0,1.0,0.12682676315307617,541.7757838811181,38,-511,-180,577,588,1090,765,58,2.0
-1,0,0,-1.0,-0.0,0.13492059707641602,540.8326913195984,38,-510,-180,577,588,1090,765,58,4.44
0,1,0,-0.0,1.0,0.14595270156860352,541.1663330252538,38,-510,-181,577,588,1090,765,58,7.13
-1,0,0,-1.0,-0.0,0.15079855918884277,540.2240276033639,38,-509,-181,577,588,1090,765,58,4.42
-1,1,0,-1.0,1.0,0.16681957244873047,539.6183836749819,38,-508,-182,577,588,1090,765,58,1.98
-1,0,0,-1.0,-0.0,0.18279075622558594,538.6770832326172,38,-507,-182,577,588,1090,765,58,4.41
-1,0,0,-1.0,-0.0,0.19125056266784668,537.7359947037207,38,-506,-182,577,588,1090,765,58,4.4
-3,0,0,-3.0,-0.0,0.20071959495544434,534.914011781333,38,-503,-182,577,588,1090,765,58,8.44
-3,0,0,-3.0,-0.0,0.21071076393127441,532.0939766620179,38,-500,-182,577,588,1090,765,58,8.4
-5,-1,0,-5.0,-1.0,0.21479463577270508,527.0540769219037,38,-495,-181,577,588,1090,765,58,13.9
-7,-2,0,-7.0,-2.0,0.22277164459228516,519.7932281205672,38,-488,-179,577,588,1090,765,58,18.82
-8,-2,0,-8.0,-2.0,0.2307906150817871,511.59456603838163,38,-480,-177,577,588,1090,765,58,19.81
-10,-3,0,-10.0,-3.0,0.23881077766418457,501.1746202672278,38,-470,-174,577,588,1090,765,58,23.87
-11,-3,0,-11.0,-3.0,0.24679064750671387,489.81833367076,38,-459,-171,577,588,1090,765,58,24.57
-13,-3,0,-13.0,-3.0,0.2547745704650879,476.59206875482096,38,-446,-168,577,588,1090,765,58,26.39
-18,-6,0,-18.0,-6.0,0.2628366947174072,457.6330407651965,38,-428,-162,577,588,1090,765,58,34.47
-21,-6,0,-21.0,-6.0,0.27506065368652344,435.872687834418,38,-407,-156,577,588,1090,765,58,35.61
-25,-6,0,-25.0,-6.0,0.2787916660308838,410.39493174258376,38,-382,-150,577,588,1090,765,58,37.27
-27,-6,0,-27.0,-6.0,0.28684258460998535,383.0939832469312,38,-355,-144,577,588,1090,765,58,36.95
-29,-8,0,-29.0,-8.0,0.29477763175964355,353.23080273384994,38,-326,-136,577,588,1090,765,58,37.35
-30,-8,0,-30.0,-8.0,0.30280375480651855,322.49030993194197,38,-296,-128,577,588,1090,765,58,35.54
-29,-7,0,-29.0,-7.0,0.31298375129699707,293.1381926668717,38,-267,-121,577,588,1090,765,58,32.08
-28,-7,0,-28.0,-7.0,0.31876564025878906,264.7961480082367,38,-239,-114,577,588,1090,765,58,29.21
-26,-7,0,-26.0,-7.0,0.3268086910247803,238.36526592605728,38,-213,-107,577,588,1090,765,58,26.01
-25,-8,0,-25.0,-8.0,0.3348655700683594,212.47352776287215,38,-188,-99,577,588,1090,765,58,23.9
-21,-7,0,-21.0,-7.0,0.3427846431732178,190.66462702871763,38,-167,-92,577,588,1090,765,58,19.93
-18,-7,0,-18.0,-7.0,0.3508896827697754,171.54008277950666,38,-149,-85,577,588,1090,765,58,17.39
-16,-7,0,-16.0,-7.0,0.3596155643463135,154.18495387034366,38,-133,-78,577,588,1090,765,58,15.58
-14,-5,0,-14.0,-5.0,0.36894774436950684,139.60659010233005,38,-119,-73,577,588,1090,765,58,12.43
-14,-4,0,-14.0,-4.0,0.37479162216186523,125.64234954823155,38,-105,-69,577,588,1090,765,58,10.76
-11,-4,0,-11.0,-4.0,0.38318657875061035,114.28473213863697,38,-94,-65,577,588,1090,765,58,9.11
-9,-3,0,-9.0,-3.0,0.39249372482299805,105.20931517693668,38,-85,-62,577,588,1090,765,58,7.31
-8,-4,0,-8.0,-4.0,0.39879775047302246,96.40020746865642,38,-77,-58,577,588,1090,765,58,7.54
-5,-2,0,-5.0,-2.0,0.4074077606201172,91.21403400793103,38,-72,-56,577,588,1090,765,58,5.09
-3,-1,0,-3.0,-1.0,0.4164307117462158,88.23831367382311,38,-69,-55,577,588,1090,765,58,3.67
-2,-1,0,-2.0,-1.0,0.42281365394592285,86.05230967266364,38,-67,-54,577,588,1090,765,58,3.95
-2,-1,0,-2.0,-1.0,0.43080973625183105,83.86894538504703,38,-65,-53,577,588,1090,765,58,3.89
-1,-1,0,-1.0,-1.0,0.43997669219970703,82.46211251235322,38,-64,-52,577,588,1090,765,58,4.51
-1,-1,0,-1.0,-1.0,0.44737672805786133,81.05553651663777,38,-63,-51,577,588,1090,765,58,4.48
-1,-1,0,-1.0,-1.0,0.4563577175140381,79.64923100695951,38,-62,-50,577,588,1090,765,58,4.44
-1,-1,0,-1.0,-1.0,0.4630775451660156,78.24321056807422,38,-61,-49,577,588,1090,765,58,4.41
-1,0,0,-1.0,-0.0,0.470808744430542,77.46612162745726,38,-60,-49,577,588,1090,765,58,1.62
0,-1,0,-0.0,-1.0,0.47877955436706543,76.83749084919418,38,-60,-48,577,588,1090,765,58,1.16
-1,-1,0,-1.0,-1.0,0.4867715835571289,75.43208866258443,38,-59,-47,577,588,1090,765,58,4.33
-1,-1,0,-1.0,-1.0,0.50327467918396,74.02702209328699,38,-58,-46,577,588,1090,765,58,4.3
-1,-1,0,-1.0,-1.0,0.5188136100769043,72.62231062146122,38,-57,-45,577,588,1090,765,58,4.26
-1,0,0,-1.0,-0.0,0.5347785949707031,71.84010022264724,38,-56,-45,577,588,1090,765,58,1.6
0,-1,0,-0.0,-1.0,0.5427536964416504,71.21797525905943,38,-56,-44,577,588,1090,765,58,1.11
-1,-1,0,-1.0,-1.0,0.5508646965026855,69.81403870282824,38,-55,-43,577,588,1090,765,58,4.18
-1,-1,0,-1.0,-1.0,0.5588066577911377,68.41052550594829,38,-54,-42,577,588,1090,765,58,4.14
-1,-1,0,-1.0,-1.0,0.5667767524719238,67.00746227100382,38,-53,-41,577,588,1090,765,58,4.1
-1,-1,0,-1.0,-1.0,0.5747747421264648,65.60487786742691,38,-52,-40,577,588,1090,765,58,4.06
-1,-1,0,-1.0,-1.0,0.5857276916503906,64.20280367709809,38,-51,-39,577,588,1090,765,58,4.01
-1,-1,0,-1.0,-1.0,0.5907917022705078,62.80127387243033,38,-50,-38,577,588,1090,765,58,3.97
-2,-1,0,-2.0,-1.0,0.5995306968688965,60.60528029800704,38,-48,-37,577,588,1090,765,58,3.73
-2,0,0,-2.0,-0.0,0.6093237400054932,59.033888572581766,38,-46,-37,577,588,1090,765,58,1.73
-2,-1,0,-2.0,-1.0,0.614851713180542,56.85068161420758,38,-44,-36,577,588,1090,765,58,3.47
-2,-1,0,-2.0,-1.0,0.6228146553039551,54.67174773134658,38,-42,-35,577,588,1090,765,58,3.38
-1,0,0,-1.0,-0.0,0.6374266147613525,53.907327887774215,38,-41,-35,577,588,1090,765,58,1.42
-1,0,0,-1.0,-0.0,0.6387856006622314,53.150729063673246,38,-40,-35,577,588,1090,765,58,1.38
-2,-1,0,-2.0,-1.0,0.6501367092132568,50.99019513592785,38,-38,-34,577,588,1090,765,58,3.11
-2,0,0,-2.0,-0.0,0.6549005508422852,49.51767361255979,38,-36,-34,577,588,1090,765,58,1.41
-2,0,0,-2.0,-0.0,0.6627986431121826,48.08326112068523,38,-34,-34,577,588,613,622,58,1.32
0,0,1,-0.0,-0.0,0.670325756072998,240.7862122298534,39,-123,207,488,829,613,622,69,83.54
-1,0,1,-1.0,-0.0,0.004540443420410156,240.2769235694514,39,-122,207,488,829,613,622,69,1.24
-1,-1,1,-1.0,-1.0,0.00792837142944336,240.63457773146402,39,-121,208,488,829,613,622,69,3.32
0,1,1,-0.0,1.0,0.15192842483520508,239.77072381756702,39,-121,207,488,829,613,622,69,2.57
0,0,0,-0.0,-0.0,0.15595030784606934,239.77072381756702,39,-121,207,488,829,613,622,69,83.31
1,1,0,1.0,1.0,0.16142034530639648,239.4159560263267,39,-122,206,488,829,613,622,69,0.72
2,2,0,2.0,2.0,0.16793441772460938,238.72997298202839,39,-124,204,488,829,613,622,69,1.02
2,2,0,2.0,2.0,0.17594432830810547,238.0756182392477,39,-126,202,488,829,613,622,69,0.97
3,3,0,3.0,3.0,0.18507647514343262,237.15395843207003,39,-129,199,488,829,613,622,69,1.19
3,3,0,3.0,3.0,0.19194841384887695,236.30488780387088,39,-132,196,488,829,613,622,69,1.09
5,4,0,5.0,4.0,0.19995546340942383,235.8664876577425,39,-137,192,488,829,613,622,69,0.45
4,6,0,4.0,6.0,0.20917749404907227,233.40308481251913,39,-141,186,488,829,613,622,69,2.8
6,7,0,6.0,7.0,0.21596431732177734,231.62469643800938,39,-147,179,488,829,613,622,69,1.86
5,7,0,5.0,7.0,0.22392034530639648,229.53866776645717,39,-152,172,488,829,613,622,69,2.23
4,7,0,4.0,7.0,0.23191547393798828,227.0704736419951,39,-156,165,488,829,613,622,69,2.67
4,7,0,4.0,7.0,0.24010848999023438,224.86440358580546,39,-160,158,488,829,613,622,69,2.36
1,6,0,1.0,6.0,0.2503843307495117,221.41589825484527,39,-161,152,488,829,613,622,69,3.98
1,6,0,1.0,6.0,0.25600433349609375,218.08255317654368,39,-162,146,488,829,613,622,69,3.8
0,6,0,-0.0,6.0,0.26394128799438477,214.11212016137713,39,-162,140,488,829,613,622,69,4.55
-2,7,0,-2.0,7.0,0.2739133834838867,208.0600874747485,39,-160,133,488,829,613,622,69,6.71
-4,8,0,-4.0,8.0,0.27993226051330566,199.90247622278218,39,-156,125,488,829,613,622,69,8.6
-6,9,0,-6.0,9.0,0.2891073226928711,189.62067397834025,39,-150,116,488,829,613,622,69,10.17
-7,9,0,-7.0,9.0,0.29591846466064453,178.60011198204776,39,-143,107,488,829,613,622,69,10.52
-9,10,0,-9.0,10.0,0.3049964904785156,165.42369842317032,39,-134,97,488,829,613,622,69,11.58
-10,10,0,-10.0,10.0,0.3132603168487549,151.47607071745688,39,-124,87,488,829,613,622,69,11.61
-10,10,0,-10.0,10.0,0.32242441177368164,137.56816492197603,39,-114,77,488,829,613,622,69,10.77
-8,8,0,-8.0,8.0,0.3279714584350586,126.4792473095883,39,-106,69,488,829,613,622,69,8.82
-9,9,0,-9.0,9.0,0.33618640899658203,114.0570032922135,39,-97,60,488,829,613,622,69,8.69
-9,8,0,-9.0,8.0,0.34572434425354004,102.2154587134451,39,-88,52,488,829,613,622,69,8.15
-8,9,0,-8.0,9.0,0.3521304130554199,90.82400563727631,39,-80,43,488,829,613,622,69,6.58
-9,8,0,-9.0,8.0,0.36052727699279785,79.1580697086532,39,-71,35,488,829,613,622,69,6.48
-7,8,0,-7.0,8.0,0.3679544925689697,69.46221994724903,39,-64,27,488,829,613,622,69,4.66
-7,7,0,-7.0,7.0,0.37592434883117676,60.40695324215582,39,-57,20,488,829,613,622,69,4.09
-6,7,0,-6.0,7.0,0.3860743045806885,52.630789467763066,39,-51,13,488,829,613,622,69,2.95
-6,6,0,-6.0,6.0,0.39504027366638184,45.5411901469428,39,-45,7,488,829,613,622,69,2.46
-6,6,0,-6.0,6.0,0.399930477142334,39.01281840626232,39,-39,1,488,829,613,622,69,1.76
-5,6,0,-5.0,6.0,0.4090273380279541,34.36568055487916,39,-34,-5,488,829,613,622,69,0.74
-4,5,0,-4.0,5.0,0.41712045669555664,31.622776601683793,39,-30,-10,488,829,613,622,69,0.07
-2,3,0,-2.0,3.0,0.4239964485168457,30.870698080866262,39,-28,-13,488,829,613,622,69,-0.28
-2,3,0,-2.0,3.0,0.4319944381713867,30.528675044947494,39,-26,-16,488,829,613,622,69,-0.48
-1,2,0,-1.0,2.0,0.43991541862487793,30.805843601498726,39,-25,-18,488,829,613,622,69,0.62
-1,1,0,-1.0,1.0,0.44843029975891113,30.610455730027933,39,-24,-19,488,829,613,622,69,-0.05
-1,1,0,-1.0,1.0,0.4559354782104492,30.479501308256342,39,-23,-20,488,829,613,622,69,-0.11
0,0,1,-0.0,-0.0,0.4939744472503662,30.479501308256342,39,-23,-20,488,829,613,622,69,36.1
0,1,1,-0.0,1.0,0.06939864158630371,1305.7047905250251,40,1303,84,1814,934,511,849,2,7.45
0,1,1,-0.0,1.0,0.07725358009338379,1305.6408388220705,40,1303,83,1814,934,511,849,2,7.37
0,1,1,-0.0,1.0,0.08499765396118164,1305.5776499312478,40,1303,82,1814,934,511,849,2,7.29
0,0,0,-0.0,-0.0,0.09799957275390625,1305.5776499312478,40,1303,82,1814,934,511,849,2,238.4
0,1,0,-0.0,1.0,0.11696767807006836,1305.515223963321,40,1303,81,1814,934,511,849,2,7.2
0,1,0,-0.0,1.0,0.13295960426330566,1305.4535610277371,40,1303,80,1814,934,511,849,2,7.12
1,0,0,1.0,-0.0,0.14099860191345215,1304.4554419373626,40,1302,80,1814,934,511,849,2,81.58
2,1,0,2.0,1.0,0.14897871017456055,1302.3981726031407,40,1300,79,1814,934,511,849,2,119.39
3,0,0,3.0,-0.0,0.15695571899414062,1299.4037093990457,40,1297,79,1814,934,511,849,2,143.04
2,0,0,2.0,-0.0,0.1649787425994873,1297.407414808471,40,1295,79,1814,934,511,849,2,119.83
3,1,0,3.0,1.0,0.17298555374145508,1294.3523477013514,40,1292,78,1814,934,511,849,2,142.01
3,1,0,3.0,1.0,0.1818556785583496,1291.297796792049,40,1289,77,1814,934,511,849,2,141.81
3,0,0,3.0,-0.0,0.18898463249206543,1288.3031475549533,40,1286,77,1814,934,511,849,2,142.4
4,0,0,4.0,-0.0,0.1969597339630127,1284.3103207558522,40,1282,77,1814,934,511,849,2,157.47
3,1,0,3.0,1.0,0.20545363426208496,1281.2560243760806,40,1279,76,1814,934,511,849,2,141.2
6,1,0,6.0,1.0,0.2129507064819336,1275.2074341063103,40,1273,75,1814,934,511,849,2,175.66
7,0,0,7.0,-0.0,0.2210066318511963,1268.2196182049859,40,1266,75,1814,934,511,849,2,181.75
9,2,0,9.0,2.0,0.22899150848388672,1259.1179452299136,40,1257,73,1814,934,511,849,2,189.41
12,1,0,12.0,1.0,0.23695063591003418,1247.0801898835537,40,1245,72,1814,934,511,849,2,198.99
16,1,0,16.0,1.0,0.2455127239227295,1231.0491460538851,40,1229,71,1814,934,511,849,2,205.65
18,2,0,18.0,2.0,0.2531285285949707,1212.964137969462,40,1211,69,1814,934,511,849,2,204.73
22,1,0,22.0,1.0,0.26093459129333496,1190.9429037531563,40,1189,68,1814,934,511,849,2,207.59
25,0,0,25.0,-0.0,0.26895856857299805,1165.9845625050102,40,1164,68,1814,934,511,849,2,205.66
26,1,0,26.0,1.0,0.2773556709289551,1139.9706136563345,40,1138,67,1814,934,511,849,2,204.74
28,0,0,28.0,-0.0,0.2882685661315918,1112.0202336288671,40,1110,67,1814,934,511,849,2,201.78
28,1,0,28.0,1.0,0.2930116653442383,1084.0110700541761,40,1082,66,1814,934,511,849,2,199.83
28,0,0,28.0,-0.0,0.30103564262390137,1056.064391976171,40,1054,66,1814,934,511,849,2,195.91
29,0,0,29.0,-0.0,0.30895352363586426,1027.122680111777,40,1025,66,1814,934,511,849,2,193.22
27,0,0,27.0,-0.0,0.3173515796661377,1000.1799838029153,40,998,66,1814,934,511,849,2,189.39
28,0,0,28.0,-0.0,0.3249397277832031,972.2427680368726,40,970,66,1814,934,511,849,2,186.72
28,0,0,28.0,-0.0,0.3329455852508545,944.3092713724673,40,942,66,1814,934,511,849,2,183.55
28,0,0,28.0,-0.0,0.3409607410430908,916.379833911681,40,914,66,1814,934,511,849,2,180.32
29,0,0,29.0,-0.0,0.3489856719970703,887.4576046212011,40,885,66,1814,934,511,849,2,177.31
30,0,0,30.0,-0.0,0.3589897155761719,857.5435848981672,40,855,66,1814,934,511,849,2,174.06
32,0,0,32.0,-0.0,0.3664236068725586,825.642174310397,40,823,66,1814,934,511,849,2,170.76
32,0,0,32.0,-0.0,0.3730306625366211,793.7487007863383,40,791,66,1814,934,511,849,2,166.71
32,0,0,32.0,-0.0,0.3832275867462158,761.864161120603,40,759,66,1814,934,511,849,2,162.57
32,0,0,32.0,-0.0,0.3889615535736084,729.9897259550986,40,727,66,1814,934,511,849,2,158.33
36,0,0,36.0,-0.0,0.3969767093658447,694.1447975746847,40,691,66,1814,934,511,849,2,154.37
35,0,0,35.0,-0.0,0.40694761276245117,659.3117623704283,40,656,66,1814,934,511,849,2,149.23
30,-1,0,30.0,-1.0,0.4130105972290039,629.5752536432798,40,626,67,1814,934,511,849,2,143.28
28,-1,0,28.0,-1.0,0.4209706783294678,601.8538028458406,40,598,68,1814,934,511,849,2,138.57
25,0,0,25.0,-0.0,0.42964863777160645,577.0207968522452,40,573,68,1814,934,511,849,2,134.21
25,1,0,25.0,1.0,0.4369995594024658,552.0806100561765,40,548,67,1814,934,511,849,2,130.97
23,2,0,23.0,2.0,0.44495654106140137,529.0085065478626,40,525,65,1814,934,511,849,2,127.65
22,2,0,22.0,2.0,0.4529457092285156,506.92997544039554,40,503,63,1814,934,511,849,2,123.86
20,1,0,20.0,1.0,0.46106553077697754,486.96303761168565,40,483,62,1814,934,511,849,2,118.75
17,2,0,17.0,2.0,0.4693427085876465,469.8467835369313,40,466,60,1814,934,511,849,2,116.28
17,2,0,17.0,2.0,0.4769287109375,452.73060422286454,40,449,58,1814,934,511,849,2,113.51
16,2,0,16.0,2.0,0.48525452613830566,436.6062299143245,40,433,56,1814,934,511,849,2,110.7
15,2,0,15.0,2.0,0.4929995536804199,421.473605342019,40,418,54,1814,934,511,849,2,107.49
15,3,0,15.0,3.0,0.503225564956665,406.21422919439937,40,403,51,1814,934,511,849,2,102.74
15,2,0,15.0,2.0,0.5091166496276855,391.0818328687744,40,388,49,1814,934,511,849,2,102.15
15,2,0,15.0,2.0,0.5179755687713623,375.9494646890723,40,373,47,1814,934,511,849,2,99.52
13,3,0,13.0,3.0,0.5265955924987793,362.6789213615812,40,360,44,1814,934,511,849,2,93.2
12,2,0,12.0,2.0,0.5332815647125244,350.5253200554847,40,348,42,1814,934,511,849,2,91.07
12,3,0,12.0,3.0,0.5409696102142334,338.25582034903704,40,336,39,1814,934,511,849,2,87.73
12,2,0,12.0,2.0,0.5515825748443604,326.1058110491133,40,324,37,1814,934,511,849,2,86.58
11,3,0,11.0,3.0,0.5569636821746826,314.8412298286233,40,313,34,1814,934,511,849,2,82.27
10,2,0,10.0,2.0,0.5651595592498779,304.6850833237492,40,303,32,1814,934,511,849,2,79.89
11,3,0,11.0,3.0,0.5729625225067139,293.43653487594213,40,292,29,1814,934,511,849,2,78.25
11,2,0,11.0,2.0,0.5809667110443115,282.29417280560364,40,281,27,1814,934,511,849,2,76.95
12,3,0,12.0,3.0,0.5889785289764404,270.06850982667345,40,269,24,1814,934,511,849,2,74.76
12,3,0,12.0,3.0,0.5969617366790771,257.8565492672234,40,257,21,1814,934,511,849,2,72.29
12,3,0,12.0,3.0,0.6050176620483398,245.66033460858105,40,245,18,1814,934,511,849,2,69.77
13,3,0,13.0,3.0,0.6162295341491699,232.48440807933767,40,232,15,1814,934,511,849,2,67.82
14,3,0,14.0,3.0,0.6210815906524658,218.33002542023394,40,218,12,1814,934,511,849,2,65.45
13,2,0,13.0,2.0,0.6291935443878174,205.24375751773792,40,205,10,1814,934,511,849,2,62.6
13,3,0,13.0,3.0,0.6394665241241455,192.12756179163884,40,192,7,1814,934,511,849,2,58.94
11,3,0,11.0,3.0,0.6450145244598389,181.04419349981927,40,181,4,1814,934,511,849,2,54.93
11,2,0,11.0,2.0,0.6543266773223877,170.01176429882727,40,170,2,1814,934,511,849,2,52.98
9,2,0,9.0,2.0,0.6625766754150391,161.0,40,161,0,1814,934,511,849,2,49.08
9,3,0,9.0,3.0,0.6690235137939453,152.029602380589,40,152,-3,1814,934,511,849,2,46.45
9,1,0,9.0,1.0,0.6769576072692871,143.05593311708537,40,143,-4,1814,934,511,849,2,45.7
8,2,0,8.0,2.0,0.6849515438079834,135.1332675546625,40,135,-6,1814,934,511,849,2,41.99
7,1,0,7.0,1.0,0.6929967403411865,128.191263352851,40,128,-7,1814,934,511,849,2,39.97
6,1,0,6.0,1.0,0.7009575366973877,122.2620137246234,40,122,-8,1814,934,511,849,2,37.18
5,0,0,5.0,-0.0,0.7093696594238281,117.27318534089538,40,117,-8,1814,934,511,849,2,36.25
5,1,0,5.0,1.0,0.7169606685638428,112.36102527122117,40,112,-9,1814,934,511,849,2,33.26
4,0,0,4.0,-0.0,0.7250115871429443,108.37435120913067,40,108,-9,1814,934,511,849,2,32.2
6,1,0,6.0,1.0,0.7379167079925537,102.48902380255166,40,102,-10,1814,934,511,849,2,32.69
5,0,0,5.0,-0.0,0.7409465312957764,97.51410154434076,40,97,-10,1814,934,511,849,2,31.63
4,1,0,4.0,1.0,0.7489585876464844,93.64827814754524,40,93,-11,1814,934,511,849,2,27.1
5,1,0,5.0,1.0,0.7570195198059082,88.81441324469807,40,88,-12,1814,934,511,849,2,27.97
6,0,0,6.0,-0.0,0.7649545669555664,82.87339742040264,40,82,-12,1814,934,511,849,2,29.21
5,1,0,5.0,1.0,0.772979736328125,78.08969202141856,40,77,-13,1814,934,511,849,2,25.48
5,0,0,5.0,-0.0,0.780951738357544,73.16419889536138,40,72,-13,1814,934,511,849,2,25.6
4,1,0,4.0,1.0,0.7889566421508789,69.42621983083913,40,68,-14,1814,934,511,849,2,21.74
5,0,0,5.0,-0.0,0.7969627380371094,64.53681120105021,40,63,-14,1814,934,511,849,2,23.38
4,0,0,4.0,-0.0,0.8049325942993164,60.63827174318213,40,59,-14,1814,934,511,849,2,21.14
5,0,0,5.0,-0.0,0.8132166862487793,55.78530272392541,40,54,-14,1814,934,511,849,2,21.18
5,1,0,5.0,1.0,0.8211185932159424,51.24451190127583,40,49,-15,1814,934,511,849,2,18.87
4,0,0,4.0,-0.0,0.8317575454711914,47.43416490252569,40,45,-15,1814,934,511,849,2,17.8
4,0,0,4.0,-0.0,0.8369665145874023,43.657759905886145,40,41,-15,1814,934,511,849,2,16.83
3,0,0,3.0,-0.0,0.8456597328186035,40.85339643163099,40,38,-15,1814,934,511,849,2,14.7
4,0,0,4.0,-0.0,0.8554337024688721,37.16180835212409,40,34,-15,1814,934,511,849,2,15.09
3,0,0,3.0,-0.0,0.8610396385192871,34.438350715445125,40,31,-15,1814,934,511,849,2,13.07
3,0,0,3.0,-0.0,0.8689725399017334,31.76476034853718,40,28,-15,1814,934,511,849,2,12.34
3,0,0,3.0,-0.0,0.8769335746765137,29.154759474226502,40,25,-15,1814,934,511,849,2,11.6
2,0,0,2.0,-0.0,0.8851635456085205,27.459060435491963,40,23,-15,1814,934,511,849,2,9.41
2,-1,0,2.0,-1.0,0.8972556591033936,25.238858928247925,40,21,-14,1814,934,511,849,2,12.3
2,0,0,2.0,-0.0,0.9010016918182373,23.600847442411894,40,19,-14,1814,934,511,849,2,8.51
2,-1,0,2.0,-1.0,0.9093575477600098,21.400934559032695,40,17,-13,1814,934,511,849,2,10.99
1,-1,0,1.0,-1.0,0.9169626235961914,20.0,40,16,-12,1814,934,511,849,2,9.54
1,0,0,1.0,-0.0,0.9250025749206543,19.209372712298546,40,15,-12,1814,934,511,849,2,5.38
1,0,0,1.0,-0.0,0.9329655170440674,18.439088914585774,40,14,-12,1814,934,511,849,2,5.15
1,0,0,1.0,-0.0,0.9490087032318115,17.69180601295413,40,13,-12,1814,934,511,849,2,4.91
1,-1,0,1.0,-1.0,0.9649596214294434,16.278820596099706,40,12,-11,1814,934,511,849,2,10.51
1,0,0,1.0,-0.0,0.9889607429504395,15.556349186104045,40,11,-11,1814,934,511,849,2,4.5
0,-1,0,-0.0,-1.0,1.0007176399230957,14.866068747318506,40,11,-10,1814,934,511,849,2,4.22
1,-1,0,1.0,-1.0,1.0052626132965088,13.45362404707371,40,10,-9,1814,934,511,849,2,9.83
1,-1,0,1.0,-1.0,1.0129776000976562,12.041594578792296,40,9,-8,1814,934,511,849,2,9.46
1,0,0,1.0,-0.0,1.0209417343139648,11.313708498984761,40,8,-8,1814,934,511,849,2,4.03
0,-1,0,-0.0,-1.0,1.029113531112671,10.63014581273465,40,8,-7,1814,934,511,849,2,3.67
2,-1,0,2.0,-1.0,1.040433645248413,8.48528137423857,40,6,-6,1814,934,511,849,2,7.51
0,-1,0,-0.0,-1.0,1.0609476566314697,7.810249675906654,40,6,-5,1814,934,511,849,2,3.21
1,-1,0,1.0,-1.0,1.0691285133361816,6.4031242374328485,40,5,-4,1814,934,511,849,2,7.53
1,0,0,1.0,-0.0,1.084946632385254,5.656854249492381,40,4,-4,1814,934,511,849,2,3.2
1,-1,0,1.0,-1.0,1.092949628829956,4.242640687119285,40,3,-3,1814,934,511,849,2,11.42
1,-1,0,1.0,-1.0,1.1011786460876465,2.8284271247461903,40,2,-2,1814,934,511,849,2,11.25
1,0,0,1.0,-0.0,1.1090726852416992,2.23606797749979,40,1,-2,1814,934,511,849,2,1.3
0,-1,0,-0.0,-1.0,1.1249315738677979,1.4142135623730951,40,1,-1,1814,934,511,849,2,2.03
0,0,1,-0.0,-0.0,1.250957727432251,1.4142135623730951,40,1,-1,1814,934,511,849,2,27.34
1,0,1,1.0,-0.0,0.03233695030212402,648.1543026162828,41,-502,-410,1312,525,1813,935,51,5.06
1,0,1,1.0,-0.0,0.048707008361816406,648.9291178549472,41,-503,-410,1312,525,1813,935,51,5.06
1,0,1,1.0,-0.0,0.06433296203613281,649.7045482371199,41,-504,-410,1312,525,1813,935,51,5.06
1,0,1,1.0,-0.0,0.07421708106994629,650.4805915628843,41,-505,-410,1312,525,1813,935,51,5.06
1,0,1,1.0,-0.0,0.08038616180419922,651.2572456410754,41,-506,-410,1312,525,1813,935,51,5.07
1,0,1,1.0,-0.0,0.09630608558654785,652.0345082892469,41,-507,-410,1312,525,1813,935,51,5.07
0,0,0,-0.0,-0.0,0.10232901573181152,652.0345082892469,41,-507,-410,1312,525,1813,935,51,159.74
-1,0,0,-1.0,-0.0,0.23232197761535645,651.2572456410754,41,-506,-410,1312,525,1813,935,51,3.6
-2,0,0,-2.0,-0.0,0.24073314666748047,649.7045482371199,41,-504,-410,1312,525,1813,935,51,5.79
-4,0,0,-4.0,-0.0,0.24832916259765625,646.6065264130884,41,-500,-410,1312,525,1813,935,51,9.96
-5,-1,0,-5.0,-1.0,0.256458044052124,642.1105823765872,41,-495,-409,1312,525,1813,935,51,13.96
-6,-1,0,-6.0,-1.0,0.2647380828857422,636.8555566217508,41,-489,-408,1312,525,1813,935,51,15.65
-8,-2,0,-8.0,-2.0,0.2723090648651123,629.4418162149699,41,-481,-406,1312,525,1813,935,51,20.73
-11,-5,0,-11.0,-5.0,0.28035998344421387,617.8195529440615,41,-470,-401,1312,525,1813,935,51,29.79
-14,-5,0,-14.0,-5.0,0.2886350154876709,603.9470175437577,41,-456,-396,1312,525,1813,935,51,33.06
-20,-10,0,-20.0,-10.0,0.2993931770324707,582.3160653803053,41,-436,-386,1312,525,1813,935,51,44.65
-26,-12,0,-26.0,-12.0,0.30433106422424316,554.9558541001257,41,-410,-374,1312,525,1813,935,51,50.08
-25,-12,0,-25.0,-12.0,0.3123500347137451,528.4590807243263,41,-385,-362,1312,525,1813,935,51,47.58
-25,-13,0,-25.0,-13.0,0.32030606269836426,501.3990426795807,41,-360,-349,1312,525,1813,935,51,46.67
-22,-14,0,-22.0,-14.0,0.328402042388916,475.8875917693169,41,-338,-335,1312,525,1813,935,51,43.91
-20,-13,0,-20.0,-13.0,0.3363480567932129,452.5571787078402,41,-318,-322,1312,525,1813,935,51,40.17
-17,-13,0,-17.0,-13.0,0.3443140983581543,431.3722290551398,41,-301,-309,1312,525,1813,935,51,37.13
-18,-14,0,-18.0,-14.0,0.3523249626159668,408.79579254194874,41,-283,-295,1312,525,1813,935,51,37.35
-19,-15,0,-19.0,-15.0,0.3603250980377197,384.8324310657822,41,-264,-280,1312,525,1813,935,51,37.25
-17,-14,0,-17.0,-14.0,0.3683300018310547,362.9944903163132,41,-247,-266,1312,525,1813,935,51,33.96
-15,-11,0,-15.0,-11.0,0.37636709213256836,344.7448331737548,41,-232,-255,1312,525,1813,935,51,28.75
-14,-10,0,-14.0,-10.0,0.3844950199127197,327.9466420014085,41,-218,-245,1312,525,1813,935,51,26.18
-12,-10,0,-12.0,-10.0,0.3941969871520996,312.50759990758627,41,-206,-235,1312,525,1813,935,51,24.45
-14,-10,0,-14.0,-10.0,0.4003901481628418,295.78539517697624,41,-192,-225,1312,525,1813,935,51,24.25
-11,-9,0,-11.0,-9.0,0.40972304344177246,281.81021982887705,41,-181,-216,1312,525,1813,935,51,21.16
-9,-7,0,-9.0,-7.0,0.41633105278015137,270.675081970986,41,-172,-209,1312,525,1813,935,51,17.46
-8,-6,0,-8.0,-6.0,0.42432498931884766,260.969346858975,41,-164,-203,1312,525,1813,935,51,15.37
-6,-6,0,-6.0,-6.0,0.4370110034942627,252.53316613862822,41,-158,-197,1312,525,1813,935,51,14.76
-7,-8,0,-7.0,-8.0,0.4403209686279297,241.91320757660174,41,-151,-189,1312,525,1813,935,51,17.76
-7,-8,0,-7.0,-8.0,0.4483070373535156,231.29418496797535,41,-144,-181,1312,525,1813,935,51,17.27
-6,-9,0,-6.0,-9.0,0.4563751220703125,220.51757299589528,41,-138,-172,1312,525,1813,935,51,16.19
-7,-8,0,-7.0,-8.0,0.4643549919128418,209.89759407863636,41,-131,-164,1312,525,1813,935,51,16.4
-6,-8,0,-6.0,-8.0,0.47231316566467285,199.90247622278218,41,-125,-156,1312,525,1813,935,51,15.77
-6,-8,0,-6.0,-8.0,0.4804551601409912,189.90787240133042,41,-119,-148,1312,525,1813,935,51,15.29
-5,-7,0,-5.0,-7.0,0.4888019561767578,181.3201588351389,41,-114,-141,1312,525,1813,935,51,13.09
-4,-5,0,-4.0,-5.0,0.49630212783813477,174.91712323268982,41,-110,-136,1312,525,1813,935,51,12.93
-4,-4,0,-4.0,-4.0,0.5043351650238037,169.29264603047588,41,-106,-132,1312,525,1813,935,51,9.35
-3,-4,0,-3.0,-4.0,0.5123200416564941,164.2954655491137,41,-103,-128,1312,525,1813,935,51,10.02
-2,-3,0,-2.0,-3.0,0.5229711532592773,160.70469812671936,41,-101,-125,1312,525,1813,935,51,7.53
-3,-5,0,-3.0,-5.0,0.5283429622650146,154.9322432549145,41,-98,-120,1312,525,1813,935,51,8.71
-4,-4,0,-4.0,-4.0,0.5365190505981445,149.30505684671232,41,-94,-116,1312,525,1813,935,51,8.85
-2,-4,0,-2.0,-4.0,0.5477609634399414,144.9413674559475,41,-92,-112,1312,525,1813,935,51,6.7
-2,-3,0,-2.0,-3.0,0.5523929595947266,141.35416513141735,41,-90,-109,1312,525,1813,935,51,7.02
-2,-3,0,-2.0,-3.0,0.560373067855835,137.7679207943562,41,-88,-106,1312,525,1813,935,51,6.92
-3,-4,0,-3.0,-4.0,0.5725300312042236,132.7742444904131,41,-85,-102,1312,525,1813,935,51,8.77
-3,-4,0,-3.0,-4.0,0.5763611793518066,127.7810627597063,41,-82,-98,1312,525,1813,935,51,8.59
-4,-2,0,-4.0,-2.0,0.5850651264190674,123.69316876852982,41,-78,-96,1312,525,1813,935,51,5.1
-4,-4,0,-4.0,-4.0,0.592318058013916,118.06777714516353,41,-74,-92,1312,525,1813,935,51,7.87
-4,-2,0,-4.0,-2.0,0.6012110710144043,114.0175425099138,41,-70,-90,1312,525,1813,935,51,4.77
-5,-4,0,-5.0,-4.0,0.6083090305328369,107.80074211247342,41,-65,-86,1312,525,1813,935,51,6.78
-6,-4,0,-6.0,-4.0,0.616314172744751,101.01980003939822,41,-59,-82,1312,525,1813,935,51,6.33
-6,-4,0,-6.0,-4.0,0.6249020099639893,94.30270409696638,41,-53,-78,1312,525,1813,935,51,5.93
-5,-4,0,-5.0,-4.0,0.6323270797729492,88.20430828479978,41,-48,-74,1312,525,1813,935,51,5.65
-6,-5,0,-6.0,-5.0,0.6403820514678955,80.77747210701756,41,-42,-69,1312,525,1813,935,51,5.94
-6,-4,0,-6.0,-4.0,0.6483111381530762,74.30343195303969,41,-36,-65,1312,525,1813,935,51,4.71
-6,-5,0,-6.0,-5.0,0.6563320159912109,67.08203932499369,41,-30,-60,1312,525,1813,935,51,4.9
-5,-4,0,-5.0,-4.0,0.6643819808959961,61.326992425847855,41,-25,-56,1312,525,1813,935,51,3.9
-5,-4,0,-5.0,-4.0,0.6723160743713379,55.71355310873648,41,-20,-52,1312,525,1813,935,51,3.47
-5,-3,0,-5.0,-3.0,0.6812059879302979,51.24451190127583,41,-15,-49,1312,525,1813,935,51,2.42
-4,-3,0,-4.0,-3.0,0.688866138458252,47.29693436154187,41,-11,-46,1312,525,1813,935,51,2.22
-4,-3,0,-4.0,-3.0,0.6988310813903809,43.56604182158393,41,-7,-43,1312,525,1813,935,51,1.87
-3,-3,0,-3.0,-3.0,0.7043290138244629,40.19950248448356,41,-4,-40,1312,525,1813,935,51,1.86
-2,-2,0,-2.0,-2.0,0.7124271392822266,38.05259518088089,41,-2,-38,1312,525,1813,935,51,1.45
-2,0,0,-2.0,-0.0,0.7227010726928711,38.0,41,0,-38,1312,525,1813,935,51,-0.22
-1,-1,0,-1.0,-1.0,0.7283899784088135,37.013511046643494,41,1,-37,1312,525,1813,935,51,1.11
-1,0,0,-1.0,-0.0,0.7443041801452637,37.05401462729781,41,2,-37,1312,525,1813,935,51,6.93
0,0,1,-0.0,-0.0,0.7543540000915527,37.05401462729781,41,2,-37,1312,525,1813,935,51,38.11
-1,0,1,-1.0,-0.0,0.08236503601074219,477.3531187705806,42,421,225,1730,787,1310,562,57,4.18
0,0,0,-0.0,-0.0,0.08739018440246582,477.3531187705806,42,421,225,1730,787,1310,562,57,131.39
-1,0,0,-1.0,-0.0,0.09254217147827148,478.2352977353303,42,422,225,1730,787,1310,562,57,4.19
-1,0,0,-1.0,-0.0,0.09833908081054688,479.11793955142196,42,423,225,1730,787,1310,562,57,4.19
-1,0,0,-1.0,-0.0,0.10636210441589355,480.0010416655364,42,424,225,1730,787,1310,562,57,4.2
-3,1,0,-3.0,1.0,0.1154789924621582,482.18772278024665,42,427,224,1730,787,1310,562,57,2.0
-2,2,0,-2.0,2.0,0.12234902381896973,483.03726564313854,42,429,222,1730,787,1310,562,57,2.92
-4,2,0,-4.0,2.0,0.13037610054016113,485.68405368099127,42,433,220,1730,787,1310,562,57,1.59
-5,3,0,-5.0,3.0,0.13983511924743652,488.8077331630505,42,438,217,1730,787,1310,562,57,1.34
-6,3,0,-6.0,3.0,0.1463789939880371,492.88132445853535,42,444,214,1730,787,1310,562,57,1.28
-6,2,0,-6.0,2.0,0.1548750400543213,497.4374332516603,42,450,212,1730,787,1310,562,57,1.48
-4,3,0,-4.0,3.0,0.1639080047607422,499.79695877426064,42,454,209,1730,787,1310,562,57,1.5
-4,2,0,-4.0,2.0,0.17036700248718262,502.6062076815208,42,458,207,1730,787,1310,562,57,1.63
-3,3,0,-3.0,3.0,0.17850112915039062,504.12002539077935,42,461,204,1730,787,1310,562,57,1.9
-2,4,0,-2.0,4.0,0.18799614906311035,504.35007683155953,42,463,200,1730,787,1310,562,57,9.27
-1,6,0,-1.0,6.0,0.19440507888793945,502.9234534201005,42,464,194,1730,787,1310,562,57,3.41
-1,4,0,-1.0,4.0,0.20566415786743164,502.3196193659969,42,465,190,1730,787,1310,562,57,1.55
0,4,0,-0.0,4.0,0.2103559970855713,500.8203270635089,42,465,186,1730,787,1310,562,57,3.76
0,3,0,-0.0,3.0,0.21834707260131836,499.7139181571792,42,465,183,1730,787,1310,562,57,2.92
2,3,0,2.0,3.0,0.22633099555969238,496.75849262997,42,463,180,1730,787,1310,562,57,7.7
2,3,0,2.0,3.0,0.2343912124633789,493.81170500505556,42,461,177,1730,787,1310,562,57,7.65
4,3,0,4.0,3.0,0.24246811866760254,489.004089962446,42,457,174,1730,787,1310,562,57,12.3
5,4,0,5.0,4.0,0.2503230571746826,482.9120002650586,42,452,170,1730,787,1310,562,57,14.38
8,6,0,8.0,6.0,0.25841808319091797,473.3201876108814,42,444,164,1730,787,1310,562,57,20.14
12,5,0,12.0,5.0,0.26633119583129883,460.3314023613857,42,432,159,1730,787,1310,562,57,27.23
13,6,0,13.0,6.0,0.2743380069732666,446.0605340085581,42,419,153,1730,787,1310,562,57,27.69
13,4,0,13.0,4.0,0.282804012298584,432.4777450921608,42,406,149,1730,787,1310,562,57,26.8
12,5,0,12.0,5.0,0.2903602123260498,419.49016675006817,42,394,144,1730,787,1310,562,57,25.76
14,4,0,14.0,4.0,0.3059110641479492,404.96913462633177,42,380,140,1730,787,1310,562,57,26.55
14,5,0,14.0,5.0,0.30698299407958984,390.10383233185496,42,366,135,1730,787,1310,562,57,28.28
17,5,0,17.0,5.0,0.3143341541290283,372.4258315423354,42,349,130,1730,787,1310,562,57,28.8
17,5,0,17.0,5.0,0.3223609924316406,354.7520260689148,42,332,125,1730,787,1310,562,57,27.88
18,5,0,18.0,5.0,0.33034420013427734,336.1487765856065,42,314,120,1730,787,1310,562,57,27.56
17,5,0,17.0,5.0,0.33995699882507324,318.4870484022859,42,297,115,1730,787,1310,562,57,25.91
19,5,0,19.0,5.0,0.34633803367614746,298.97157055479374,42,278,110,1730,787,1310,562,57,26.06
18,5,0,18.0,5.0,0.35436201095581055,280.40149785619906,42,260,105,1730,787,1310,562,57,24.29
17,7,0,17.0,7.0,0.36234116554260254,262.01717500957835,42,243,98,1730,787,1310,562,57,25.86
16,7,0,16.0,7.0,0.3703451156616211,244.56083087853622,42,227,91,1730,787,1310,562,57,22.93
15,5,0,15.0,5.0,0.37858009338378906,228.77936969928035,42,212,86,1730,787,1310,562,57,19.95
14,6,0,14.0,6.0,0.3865470886230469,213.55093069335942,42,198,80,1730,787,1310,562,57,19.94
13,6,0,13.0,6.0,0.40296006202697754,199.25109786397664,42,185,74,1730,787,1310,562,57,17.53
12,4,0,12.0,4.0,0.4035639762878418,186.62529303392935,42,173,70,1730,787,1310,562,57,15.47
9,4,0,9.0,4.0,0.41042399406433105,176.7823520603796,42,164,66,1730,787,1310,562,57,13.65
8,5,0,8.0,5.0,0.4183380603790283,167.5022387910084,42,156,61,1730,787,1310,562,57,10.81
5,3,0,5.0,3.0,0.4263181686401367,161.75598906995685,42,151,58,1730,787,1310,562,57,8.08
4,2,0,4.0,2.0,0.43434810638427734,157.30543537970962,42,147,56,1730,787,1310,562,57,7.69
3,2,0,3.0,2.0,0.44235920906066895,153.79206741571556,42,144,54,1730,787,1310,562,57,5.78
3,3,0,3.0,3.0,0.45032501220703125,149.9399879951976,42,141,51,1730,787,1310,562,57,5.07
3,2,0,3.0,2.0,0.4583611488342285,146.44111444536333,42,138,49,1730,787,1310,562,57,5.54
4,3,0,4.0,3.0,0.46634912490844727,141.6756859873987,42,134,46,1730,787,1310,562,57,6.05
4,3,0,4.0,3.0,0.4764821529388428,136.92698784388708,42,130,43,1730,787,1310,562,57,5.87
4,3,0,4.0,3.0,0.48237109184265137,132.19682295728592,42,126,40,1730,787,1310,562,57,5.7
4,3,0,4.0,3.0,0.49274420738220215,127.4872542648872,42,122,37,1730,787,1310,562,57,5.52
4,2,0,4.0,2.0,0.49832916259765625,123.08127396155761,42,118,35,1730,787,1310,562,57,6.18
5,4,0,5.0,4.0,0.5063650608062744,117.17508267545622,42,113,31,1730,787,1310,562,57,5.76
5,3,0,5.0,3.0,0.5151281356811523,111.57060544785082,42,108,28,1730,787,1310,562,57,5.92
4,2,0,4.0,2.0,0.5223801136016846,107.20074626605917,42,104,26,1730,787,1310,562,57,5.49
3,2,0,3.0,2.0,0.530358076095581,103.81233067415451,42,101,24,1730,787,1310,562,57,4.19
3,1,0,3.0,1.0,0.5397601127624512,100.66280345788111,42,98,23,1730,787,1310,562,57,5.83
2,2,0,2.0,2.0,0.5463581085205078,98.2700361249552,42,96,21,1730,787,1310,562,57,2.87
2,1,0,2.0,1.0,0.5543739795684814,96.1041102138717,42,94,20,1730,787,1310,562,57,3.87
1,0,0,1.0,-0.0,0.5640950202941895,95.12623192369179,42,93,20,1730,787,1310,562,57,3.47
2,1,0,2.0,1.0,0.5703690052032471,92.9623579735368,42,91,19,1730,787,1310,562,57,3.81
1,1,0,1.0,1.0,0.5792381763458252,91.78235124467012,42,90,18,1730,787,1310,562,57,2.13
1,0,0,1.0,-0.0,0.5871710777282715,90.80198235721508,42,89,18,1730,787,1310,562,57,3.52
1,0,0,1.0,-0.0,0.6183559894561768,89.82204629154248,42,88,18,1730,787,1310,562,57,3.5
1,1,0,1.0,1.0,0.6263279914855957,88.64536084872124,42,87,17,1730,787,1310,562,57,2.09
1,0,0,1.0,-0.0,0.6348609924316406,87.66413177577246,42,86,17,1730,787,1310,562,57,3.53
2,0,0,2.0,-0.0,0.6423699855804443,85.70297544426332,42,84,17,1730,787,1310,562,57,3.96
1,1,0,1.0,1.0,0.6504831314086914,84.52810183601665,42,83,16,1730,787,1310,562,57,2.05
2,0,0,2.0,-0.0,0.658318042755127,82.56512580987206,42,81,16,1730,787,1310,562,57,3.95
2,0,0,2.0,-0.0,0.6663169860839844,80.60397012554654,42,79,16,1730,787,1310,562,57,3.9
1,0,0,1.0,-0.0,0.6747710704803467,79.62411694957753,42,78,16,1730,787,1310,562,57,3.43
2,0,0,2.0,-0.0,0.6825871467590332,77.6659513557904,42,76,16,1730,787,1310,562,57,3.81
1,1,0,1.0,1.0,0.6903212070465088,76.48529270389177,42,75,15,1730,787,1310,562,57,2.0
2,0,0,2.0,-0.0,0.6983320713043213,74.52516353554684,42,73,15,1730,787,1310,562,57,3.8
0,0,1,-0.0,-0.0,0.7060229778289795,74.52516353554684,42,73,15,1730,787,1310,562,57,39.47
1,0,1,1.0,-0.0,0.7065131664276123,73.54590403278758,42,72,15,1730,787,1310,562,57,3.37
1,1,1,1.0,1.0,0.7143270969390869,72.3671196055225,42,71,14,1730,787,1310,562,57,1.96
1,0,1,1.0,-0.0,0.7224090099334717,71.386273190299,42,70,14,1730,787,1310,562,57,3.41
2,0,1,2.0,-0.0,0.7303671836853027,69.42621983083913,42,68,14,1730,787,1310,562,57,3.73
1,0,1,1.0,-0.0,0.7383360862731934,68.4470598345904,42,67,14,1730,787,1310,562,57,3.33
1,0,1,1.0,-0.0,0.746345043182373,67.468511173732,42,66,14,1730,787,1310,562,57,3.3
1,1,1,1.0,1.0,0.7546291351318359,66.2872536767062,42,65,13,1730,787,1310,562,57,1.91
3,0,1,3.0,-0.0,0.7626991271972656,63.34824385884742,42,62,13,1730,787,1310,562,57,3.95
1,0,1,1.0,-0.0,0.7706270217895508,62.369864518050704,42,61,13,1730,787,1310,562,57,3.26
1,0,1,1.0,-0.0,0.778331995010376,61.39218191268331,42,60,13,1730,787,1310,562,57,3.23
2,1,1,2.0,1.0,0.78702712059021,59.22837157984339,42,58,12,1730,787,1310,562,57,3.3
1,0,1,1.0,-0.0,0.7944071292877197,58.249463516842795,42,57,12,1730,787,1310,562,57,3.24
2,0,1,2.0,-0.0,0.8024530410766602,56.293871780150276,42,55,12,1730,787,1310,562,57,13.46
1,1,1,1.0,1.0,0.8183372020721436,55.10898293381942,42,54,11,1730,787,1310,562,57,11.81
0,0,0,-0.0,-0.0,0.8222870826721191,55.10898293381942,42,54,11,1730,787,1310,562,57,33.62
1,0,0,1.0,-0.0,0.8423709869384766,54.12947441089743,42,53,11,1730,787,1310,562,57,3.22
1,0,0,1.0,-0.0,0.898341178894043,53.150729063673246,42,52,11,1730,787,1310,562,57,3.19
1,0,0,1.0,-0.0,0.9063379764556885,52.172789842982326,42,51,11,1730,787,1310,562,57,3.16
1,0,0,1.0,-0.0,0.9156930446624756,51.19570294468082,42,50,11,1730,787,1310,562,57,3.12
1,1,0,1.0,1.0,0.9226100444793701,50.00999900019995,42,49,10,1730,787,1310,562,57,1.76
1,0,0,1.0,-0.0,0.9320051670074463,49.03060268852505,42,48,10,1730,787,1310,562,57,3.17
1,1,0,1.0,1.0,0.938345193862915,47.853944456021594,42,47,9,1730,787,1310,562,57,1.7
0,0,1,-0.0,-0.0,0.9436399936676025,47.853944456021594,42,47,9,1730,787,1310,562,57,41.42
1,0,1,1.0,-0.0,0.9463520050048828,46.87216658103186,42,46,9,1730,787,1310,562,57,13.24
1,1,1,1.0,1.0,0.9624340534210205,45.70557952810576,42,45,8,1730,787,1310,562,57,11.64
1,0,1,1.0,-0.0,0.970365047454834,44.721359549995796,42,44,8,1730,787,1310,562,57,13.31
0,1,1,-0.0,1.0,0.9793460369110107,44.553338819890925,42,44,7,1730,787,1310,562,57,10.17
1,0,1,1.0,-0.0,0.9864180088043213,43.56604182158393,42,43,7,1730,787,1310,562,57,13.45
1,0,1,1.0,-0.0,0.9954061508178711,42.579337712087536,42,42,7,1730,787,1310,562,57,13.4
1,0,1,1.0,-0.0,1.002906084060669,41.593268686170845,42,41,7,1730,787,1310,562,57,13.36
0,1,1,-0.0,1.0,1.0103340148925781,41.43669871020132,42,41,6,1730,787,1310,562,57,10.14
0,0,0,-0.0,-0.0,1.0803511142730713,41.43669871020132,42,41,6,1730,787,1310,562,57,29.45
0,0,1,-0.0,-0.0,1.2273380756378174,41.43669871020132,42,41,6,1730,787,1310,562,57,39.45
0,0,0,-0.0,-0.0,0.07914614677429199,1627.8925025934604,43,-1625,97,64,878,1689,781,53,267.95
-2,1,0,-2.0,1.0,0.1551361083984375,1625.836707667778,43,-1623,96,64,878,1689,781,53,11.78
-1,0,0,-1.0,-0.0,0.16315412521362305,1624.8384535085327,43,-1622,96,64,878,1689,781,53,9.33
-1,0,0,-1.0,-0.0,0.17160415649414062,1623.840201497672,43,-1621,96,64,878,1689,781,53,9.33
-2,0,0,-2.0,-0.0,0.18115806579589844,1621.843703936973,43,-1619,96,64,878,1689,781,53,13.96
-3,0,0,-3.0,-0.0,0.1871349811553955,1618.8489738082426,43,-1616,96,64,878,1689,781,53,18.42
-2,-1,0,-2.0,-1.0,0.1951611042022705,1616.9121806703047,43,-1614,97,64,878,1689,781,53,10.85
-5,-1,0,-5.0,-1.0,0.2036430835723877,1611.981699647983,43,-1609,98,64,878,1689,781,53,24.75
-7,-1,0,-7.0,-1.0,0.21117401123046875,1605.0560737868318,43,-1602,99,64,878,1689,781,53,32.9
-10,-3,0,-10.0,-3.0,0.2195601463317871,1595.2642414346283,43,-1592,102,64,878,1689,781,53,42.46
-12,-2,0,-12.0,-2.0,0.22712111473083496,1583.4190853971668,43,-1580,104,64,878,1689,781,53,49.76
-15,-3,0,-15.0,-3.0,0.2351851463317871,1568.6535627728642,43,-1565,107,64,878,1689,781,53,58.33
-23,-5,0,-23.0,-5.0,0.24381208419799805,1546.0620944839181,43,-1542,112,64,878,1689,781,53,78.32
-28,-5,0,-28.0,-5.0,0.2517240047454834,1518.5140763259326,43,-1514,117,64,878,1689,781,53,88.58
-31,-4,0,-31.0,-4.0,0.25911808013916016,1487.9280896602497,43,-1483,121,64,878,1689,781,53,93.83
-31,-4,0,-31.0,-4.0,0.26715612411499023,1457.370577444186,43,-1452,125,64,878,1689,781,53,92.72
-32,-2,0,-32.0,-2.0,0.27513599395751953,1425.6679136460916,43,-1420,127,64,878,1689,781,53,94.19
-34,-2,0,-34.0,-2.0,0.2831730842590332,1391.990301690353,43,-1386,129,64,878,1689,781,53,96.41
-33,-2,0,-33.0,-2.0,0.2911550998687744,1359.3270393838268,43,-1353,131,64,878,1689,781,53,93.44
-35,-2,0,-35.0,-2.0,0.30042409896850586,1324.6935494671966,43,-1318,133,64,878,1689,781,53,95.38
-36,-2,0,-36.0,-2.0,0.30716896057128906,1289.0884376178385,43,-1282,135,64,878,1689,781,53,95.48
-36,0,0,-36.0,-0.0,0.3151509761810303,1253.292064923416,43,-1246,135,64,878,1689,781,53,94.84
-36,0,0,-36.0,-0.0,0.32459306716918945,1217.5077001809886,43,-1210,135,64,878,1689,781,53,93.3
-38,0,0,-38.0,-0.0,0.3311481475830078,1179.7495496926456,43,-1172,135,64,878,1689,781,53,94.49
-34,1,0,-34.0,1.0,0.33951711654663086,1145.8621208504974,43,-1138,134,64,878,1689,781,53,87.75
-37,2,0,-37.0,2.0,0.3475680351257324,1108.8845746965733,43,-1101,132,64,878,1689,781,53,90.94
-36,2,0,-36.0,2.0,0.35539913177490234,1072.9049352109441,43,-1065,130,64,878,1689,781,53,87.92
-34,2,0,-34.0,2.0,0.36354899406433105,1038.915299723707,43,-1031,128,64,878,1689,781,53,83.62
-33,3,0,-33.0,3.0,0.37113404273986816,1005.7976933757603,43,-998,125,64,878,1689,781,53,81.62
-32,3,0,-32.0,3.0,0.3791220188140869,973.6734565551225,43,-966,122,64,878,1689,781,53,78.81
-32,3,0,-32.0,3.0,0.3872640132904053,941.5503172958947,43,-934,119,64,878,1689,781,53,77.31
-32,3,0,-32.0,3.0,0.3978590965270996,909.4283919033977,43,-902,116,64,878,1689,781,53,75.78
-30,2,0,-30.0,2.0,0.40317296981811523,879.4202635827764,43,-872,114,64,878,1689,781,53,70.77
-30,3,0,-30.0,3.0,0.4111201763153076,849.2849933914999,43,-842,111,64,878,1689,781,53,70.32
-28,3,0,-28.0,3.0,0.419281005859375,821.1333631024866,43,-814,108,64,878,1689,781,53,66.46
-29,2,0,-29.0,2.0,0.4272890090942383,792.1243589235215,43,-785,106,64,878,1689,781,53,65.26
-28,3,0,-28.0,3.0,0.43511295318603516,763.9751304852796,43,-757,103,64,878,1689,781,53,63.66
-28,3,0,-28.0,3.0,0.4437720775604248,735.8267459123784,43,-729,100,64,878,1689,781,53,62.26
-27,3,0,-27.0,3.0,0.4512171745300293,708.6698808330999,43,-702,97,64,878,1689,781,53,59.72
-25,3,0,-25.0,3.0,0.4618079662322998,683.4946963949318,43,-677,94,64,878,1689,781,53,56.18
-24,3,0,-24.0,3.0,0.46720409393310547,659.310245635543,43,-653,91,64,878,1689,781,53,53.91
-24,2,0,-24.0,2.0,0.477053165435791,635.2652989106205,43,-629,89,64,878,1689,781,53,51.21
-24,3,0,-24.0,3.0,0.48613500595092773,611.0818275812168,43,-605,86,64,878,1689,781,53,51.45
-23,3,0,-23.0,3.0,0.4911661148071289,587.8885948885214,43,-582,83,64,878,1689,781,53,49.3
-24,3,0,-24.0,3.0,0.4992401599884033,563.7055969209459,43,-558,80,64,878,1689,781,53,49.03
-23,3,0,-23.0,3.0,0.5071220397949219,540.5127195543135,43,-535,77,64,878,1689,781,53,46.87
-24,3,0,-24.0,3.0,0.5151381492614746,516.3303206281809,43,-511,74,64,878,1689,781,53,46.48
-23,2,0,-23.0,2.0,0.5232491493225098,493.28288030297585,43,-488,72,64,878,1689,781,53,42.76
-21,3,0,-21.0,3.0,0.5311241149902344,472.0699100768868,43,-467,69,64,878,1689,781,53,41.57
-18,2,0,-18.0,2.0,0.5391910076141357,453.97136473570663,43,-449,67,64,878,1689,781,53,35.38
-17,3,0,-17.0,3.0,0.5471310615539551,436.7150100465978,43,-432,64,64,878,1689,781,53,33.85
-13,3,0,-13.0,3.0,0.5566141605377197,423.4170520893083,43,-419,61,64,878,1689,781,53,26.9
-13,3,0,-13.0,3.0,0.5631699562072754,410.1219330881976,43,-406,58,64,878,1689,781,53,26.34
-14,3,0,-14.0,3.0,0.571134090423584,395.8396139852604,43,-392,55,64,878,1689,781,53,27.26
-13,2,0,-13.0,2.0,0.5808420181274414,382.6878623630491,43,-379,53,64,878,1689,781,53,26.94
-12,2,0,-12.0,2.0,0.5872249603271484,370.52665221276595,43,-367,51,64,878,1689,781,53,24.62
-13,2,0,-13.0,2.0,0.5951900482177734,357.37515302550065,43,-354,49,64,878,1689,781,53,25.86
-13,1,0,-13.0,1.0,0.6031229496002197,344.3617284194049,43,-341,48,64,878,1689,781,53,23.73
-12,2,0,-12.0,2.0,0.6113011837005615,332.20024081869656,43,-329,46,64,878,1689,781,53,23.18
-13,2,0,-13.0,2.0,0.6191949844360352,319.0485856417483,43,-316,44,64,878,1689,781,53,24.31
-14,2,0,-14.0,2.0,0.6271109580993652,304.9065430586887,43,-302,42,64,878,1689,781,53,25.49
-14,1,0,-14.0,1.0,0.6351439952850342,290.90376415577714,43,-288,41,64,878,1689,781,53,22.34
-15,1,0,-15.0,1.0,0.6491351127624512,275.9148419349709,43,-273,40,64,878,1689,781,53,22.44
-13,2,0,-13.0,2.0,0.6515231132507324,262.76224995230956,43,-260,38,64,878,1689,781,53,22.25
-14,1,0,-14.0,1.0,0.6603920459747314,248.766959220874,43,-246,37,64,878,1689,781,53,20.17
-14,1,0,-14.0,1.0,0.6677250862121582,234.77648945326703,43,-232,36,64,878,1689,781,53,19.38
-12,0,0,-12.0,-0.0,0.6755781173706055,222.92599668948438,43,-220,36,64,878,1689,781,53,16.06
-14,0,0,-14.0,-0.0,0.6831700801849365,209.1219739769114,43,-206,36,64,878,1689,781,53,16.92
-14,0,0,-14.0,-0.0,0.6912519931793213,195.34584715319647,43,-192,36,64,878,1689,781,53,16.07
-13,-1,0,-13.0,-1.0,0.6991190910339355,182.7840255602223,43,-179,37,64,878,1689,781,53,13.93
-11,0,0,-11.0,-0.0,0.7071759700775146,172.02616080119907,43,-168,37,64,878,1689,781,53,12.44
-12,0,0,-12.0,-0.0,0.715162992477417,160.3277892319357,43,-156,37,64,878,1689,781,53,12.44
-11,0,0,-11.0,-0.0,0.7244880199432373,149.64624953536256,43,-145,37,64,878,1689,781,53,11.13
-10,0,0,-10.0,-0.0,0.7311320304870605,139.97856978837868,43,-135,37,64,878,1689,781,53,9.92
-9,0,0,-9.0,-0.0,0.7391600608825684,131.3202193114221,43,-126,37,64,878,1689,781,53,8.8
-10,1,0,-10.0,1.0,0.7483949661254883,121.45781160551181,43,-116,36,64,878,1689,781,53,9.57
-12,1,0,-12.0,1.0,0.7551641464233398,109.73149046650191,43,-104,35,64,878,1689,781,53,9.69
-10,1,0,-10.0,1.0,0.7631299495697021,99.9599919967984,43,-94,34,64,878,1689,781,53,8.17
-10,1,0,-10.0,1.0,0.7711181640625,90.24965373894794,43,-84,33,64,878,1689,781,53,7.5
-11,1,0,-11.0,1.0,0.7791361808776855,79.7057087039567,43,-73,32,64,878,1689,781,53,7.04
-11,1,0,-11.0,1.0,0.7875561714172363,69.31810730249349,43,-62,31,64,878,1689,781,53,6.17
-9,1,0,-9.0,1.0,0.7956149578094482,60.90155991434045,43,-53,30,64,878,1689,781,53,4.92
-7,1,0,-7.0,1.0,0.8031330108642578,54.378304497290095,43,-46,29,64,878,1689,781,53,3.95
-7,1,0,-7.0,1.0,0.8112659454345703,48.010415536631214,43,-39,28,64,878,1689,781,53,3.41
-7,1,0,-7.0,1.0,0.8191759586334229,41.86884283091664,43,-32,27,64,878,1689,781,53,2.83
-6,0,0,-6.0,-0.0,0.8271059989929199,37.48332962798263,43,-26,27,64,878,1689,781,53,1.64
-6,1,0,-6.0,1.0,0.8354330062866211,32.802438933713454,43,-20,26,64,878,1689,781,53,1.62
-6,0,0,-6.0,-0.0,0.8431639671325684,29.5296461204668,43,-14,26,64,878,1689,781,53,0.57
-5,1,0,-5.0,1.0,0.8539750576019287,26.570660511172846,43,-9,25,64,878,1689,781,53,0.52
-4,2,0,-4.0,2.0,0.8595831394195557,23.53720459187964,43,-5,23,64,878,1689,781,53,0.68
-2,0,0,-2.0,-0.0,0.8703069686889648,23.194827009486403,43,-3,23,64,878,1689,781,53,-0.24
-2,1,0,-2.0,1.0,0.8751511573791504,22.02271554554524,43,-1,22,64,878,1689,781,53,0.29
-1,0,0,-1.0,-0.0,0.8846890926361084,22.0,43,0,22,64,878,1689,781,53,-0.19
0,0,1,-0.0,-0.0,0.9531681537628174,22.0,43,0,22,64,878,1689,781,53,33.510000000000005
0,0,0,-0.0,-0.0,0.030089855194091797,1456.4219855522642,44,1374,-483,1438,373,64,856,3,252.77
2,0,0,2.0,-0.0,0.062120914459228516,1454.535320987428,44,1372,-483,1438,373,64,856,3,97.23
3,0,0,3.0,-0.0,0.07310676574707031,1451.7058930788978,44,1369,-483,1438,373,64,856,3,121.52
5,-1,0,5.0,-1.0,0.07815384864807129,1446.6582181012902,44,1364,-482,1438,373,64,856,3,157.22
4,-1,0,4.0,-1.0,0.08647584915161133,1442.553638517473,44,1360,-481,1438,373,64,856,3,145.38
4,-1,0,4.0,-1.0,0.0955207347869873,1438.449164899476,44,1356,-480,1438,373,64,856,3,145.16
2,-1,0,2.0,-1.0,0.1021268367767334,1436.2301347625316,44,1354,-479,1438,373,64,856,3,107.47
3,-1,0,3.0,-1.0,0.11013174057006836,1433.068386365424,44,1351,-478,1438,373,64,856,3,130.78
3,-1,0,3.0,-1.0,0.11878371238708496,1429.9066403090796,44,1348,-477,1438,373,64,856,3,130.63
2,-1,0,2.0,-1.0,0.12609076499938965,1427.687640907492,44,1346,-476,1438,373,64,856,3,107.13
3,-1,0,3.0,-1.0,0.1342027187347412,1424.5258860406855,44,1343,-475,1438,373,64,856,3,130.38
3,0,0,3.0,-0.0,0.14307188987731934,1421.6979285347504,44,1340,-475,1438,373,64,856,3,120.13
4,0,0,4.0,-0.0,0.15257787704467773,1417.9284185035576,44,1336,-475,1438,373,64,856,3,137.31
7,-1,0,7.0,-1.0,0.15823078155517578,1410.9985825648444,44,1329,-474,1438,373,64,856,3,171.76
9,-1,0,9.0,-1.0,0.16612887382507324,1402.1872200244873,44,1320,-473,1438,373,64,856,3,182.57
13,-2,0,13.0,-2.0,0.1747887134552002,1389.2767902761493,44,1307,-471,1438,373,64,856,3,197.57
15,-1,0,15.0,-1.0,0.18210291862487793,1374.8323534162266,44,1292,-470,1438,373,64,856,3,199.89
20,-2,0,20.0,-2.0,0.1902477741241455,1355.362682089189,44,1272,-468,1438,373,64,856,3,207.55
25,-2,0,25.0,-2.0,0.1994938850402832,1331.2268777334689,44,1247,-466,1438,373,64,856,3,210.73
30,-4,0,30.0,-4.0,0.2060868740081787,1301.7422940044623,44,1217,-462,1438,373,64,856,3,212.58
33,-4,0,33.0,-4.0,0.21419787406921387,1269.4959629711313,44,1184,-458,1438,373,64,856,3,211.18
37,-6,0,37.0,-6.0,0.22206377983093262,1232.8475169298108,44,1147,-452,1438,373,64,856,3,210.05
40,-5,0,40.0,-5.0,0.23025774955749512,1193.8416980487823,44,1107,-447,1438,373,64,856,3,206.97
39,-6,0,39.0,-6.0,0.23811674118041992,1155.4674378795796,44,1068,-441,1438,373,64,856,3,203.08
36,-8,0,36.0,-8.0,0.24651479721069336,1119.15727223657,44,1032,-433,1438,373,64,856,3,199.04
36,-10,0,36.0,-10.0,0.25585079193115234,1082.1021208739958,44,996,-423,1438,373,64,856,3,195.96
34,-12,0,34.0,-12.0,0.2621028423309326,1046.1190180854185,44,962,-411,1438,373,64,856,3,192.68
34,-13,0,34.0,-13.0,0.2700676918029785,1009.7465028411834,44,928,-398,1438,373,64,856,3,189.51
34,-13,0,34.0,-13.0,0.2783536911010742,973.3760835360606,44,894,-385,1438,373,64,856,3,185.51
34,-16,0,34.0,-16.0,0.2864527702331543,935.8210298983455,44,860,-369,1438,373,64,856,3,181.94
36,-17,0,36.0,-17.0,0.295853853225708,896.0357135739624,44,824,-352,1438,373,64,856,3,178.0
35,-18,0,35.0,-18.0,0.3024919033050537,856.7829363380202,44,789,-334,1438,373,64,856,3,172.41
39,-21,0,39.0,-21.0,0.3106718063354492,812.6924387491248,44,750,-313,1438,373,64,856,3,167.94
39,-22,0,39.0,-22.0,0.31810569763183594,768.2460543341567,44,711,-291,1438,373,64,856,3,162.09
40,-22,0,40.0,-22.0,0.32610273361206055,722.9121661723505,44,671,-269,1438,373,64,856,3,156.37
37,-20,0,37.0,-20.0,0.33408689498901367,681.1438908189664,44,634,-249,1438,373,64,856,3,149.97
37,-18,0,37.0,-18.0,0.3422129154205322,640.1327987222651,44,597,-231,1438,373,64,856,3,144.56
34,-17,0,34.0,-17.0,0.35015273094177246,602.2997592561366,44,563,-214,1438,373,64,856,3,138.14
30,-14,0,30.0,-14.0,0.3612387180328369,569.2881519933469,44,533,-200,1438,373,64,856,3,132.26
28,-14,0,28.0,-14.0,0.36611175537109375,538.1644730005875,44,505,-186,1438,373,64,856,3,126.52
23,-12,0,23.0,-12.0,0.37503480911254883,512.4451190127583,44,482,-174,1438,373,64,856,3,120.21
20,-9,0,20.0,-9.0,0.38208675384521484,490.5802686615107,44,462,-165,1438,373,64,856,3,115.5
18,-9,0,18.0,-9.0,0.3901078701019287,470.6081172270619,44,444,-156,1438,373,64,856,3,110.62
16,-8,0,16.0,-8.0,0.40053391456604004,452.86642622300894,44,428,-148,1438,373,64,856,3,106.14
17,-7,0,17.0,-7.0,0.409099817276001,434.5135210784585,44,411,-141,1438,373,64,856,3,104.72
16,-7,0,16.0,-7.0,0.41411876678466797,417.11029716371183,44,395,-134,1438,373,64,856,3,100.76
16,-7,0,16.0,-7.0,0.42215991020202637,399.71239660535923,44,379,-127,1438,373,64,856,3,97.88
17,-8,0,17.0,-8.0,0.43007373809814453,381.0577384071868,44,362,-119,1438,373,64,856,3,95.26
17,-8,0,17.0,-8.0,0.4382038116455078,362.4168870237699,44,345,-111,1438,373,64,856,3,91.99
15,-6,0,15.0,-6.0,0.4461097717285156,346.30189141845585,44,330,-105,1438,373,64,856,3,88.13
15,-5,0,15.0,-5.0,0.45406675338745117,330.49205739321485,44,315,-100,1438,373,64,856,3,86.79
14,-5,0,14.0,-5.0,0.46210670471191406,315.635866149587,44,301,-95,1438,373,64,856,3,82.49
14,-4,0,14.0,-4.0,0.4701418876647949,301.0813843464919,44,287,-91,1438,373,64,856,3,79.9
15,-4,0,15.0,-4.0,0.47809481620788574,285.5748588373984,44,272,-87,1438,373,64,856,3,77.25
14,-3,0,14.0,-3.0,0.4860877990722656,271.3300573102803,44,258,-84,1438,373,64,856,3,72.68
15,-3,0,15.0,-3.0,0.4956507682800293,256.1444904736387,44,243,-81,1438,373,64,856,3,70.28
15,-2,0,15.0,-2.0,0.5020837783813477,241.29857024027308,44,228,-79,1438,373,64,856,3,66.5
14,-3,0,14.0,-3.0,0.5101296901702881,227.09469390542793,44,214,-76,1438,373,64,856,3,63.83
13,-2,0,13.0,-2.0,0.5180888175964355,214.18916872708573,44,201,-74,1438,373,64,856,3,59.69
11,-2,0,11.0,-2.0,0.5266637802124023,203.18464508914053,44,190,-72,1438,373,64,856,3,55.94
11,-2,0,11.0,-2.0,0.5340747833251953,192.20041623263984,44,179,-70,1438,373,64,856,3,53.67
11,-2,0,11.0,-2.0,0.5420787334442139,181.24017214734707,44,168,-68,1438,373,64,856,3,51.36
12,-2,0,12.0,-2.0,0.5506477355957031,169.38713056191725,44,156,-66,1438,373,64,856,3,49.47
10,-1,0,10.0,-1.0,0.5580759048461914,159.8155186457185,44,146,-65,1438,373,64,856,3,45.03
8,-1,0,8.0,-1.0,0.5662257671356201,152.11837495845134,44,138,-64,1438,373,64,856,3,41.3
8,-1,0,8.0,-1.0,0.5740997791290283,144.46106741956464,44,130,-63,1438,373,64,856,3,39.67
7,-1,0,7.0,-1.0,0.5845468044281006,137.7425134081704,44,123,-62,1438,373,64,856,3,37.02
6,-1,0,6.0,-1.0,0.5907866954803467,131.94695904036593,44,117,-61,1438,373,64,856,3,34.41
4,-1,0,4.0,-1.0,0.5981078147888184,127.94139283281233,44,113,-60,1438,373,64,856,3,29.96
5,-1,0,5.0,-1.0,0.6073427200317383,123.06502346320826,44,108,-59,1438,373,64,856,3,31.02
4,-1,0,4.0,-1.0,0.6140878200531006,119.07980517283357,44,104,-58,1438,373,64,856,3,28.36
5,-1,0,5.0,-1.0,0.6222066879272461,114.23659658795863,44,99,-57,1438,373,64,856,3,29.29
4,-1,0,4.0,-1.0,0.6300919055938721,110.27692415006868,44,95,-56,1438,373,64,856,3,26.73
4,-1,0,4.0,-1.0,0.638110876083374,106.3296760081587,44,91,-55,1438,373,64,856,3,25.99
4,-2,0,4.0,-2.0,0.6462717056274414,101.87246929372037,44,87,-53,1438,373,64,856,3,28.12
4,-2,0,4.0,-2.0,0.654876708984375,97.41663102366043,44,83,-51,1438,373,64,856,3,27.28
4,-3,0,4.0,-3.0,0.6621189117431641,92.43916918709297,44,79,-48,1438,373,64,856,3,27.22
3,-2,0,3.0,-2.0,0.6701128482818604,88.83692925805124,44,76,-46,1438,373,64,856,3,24.72
3,-2,0,3.0,-2.0,0.6780927181243896,85.23496934944014,44,73,-44,1438,373,64,856,3,24.09
2,-3,0,2.0,-3.0,0.6885519027709961,81.98780397107853,44,71,-41,1438,373,64,856,3,19.65
3,-2,0,3.0,-2.0,0.6942367553710938,78.39005038906404,44,68,-39,1438,373,64,856,3,22.49
2,-3,0,2.0,-3.0,0.7022178173065186,75.17978451685,44,66,-36,1438,373,64,856,3,18.4
2,-2,0,2.0,-2.0,0.7135047912597656,72.47068372797375,44,64,-34,1438,373,64,856,3,17.36
3,-2,0,3.0,-2.0,0.7184317111968994,68.8839603971781,44,61,-32,1438,373,64,856,3,20.32
2,-2,0,2.0,-2.0,0.7261278629302979,66.18912297349165,44,59,-30,1438,373,64,856,3,16.32
2,-1,0,2.0,-1.0,0.7340738773345947,63.953107821277925,44,57,-29,1438,373,64,856,3,18.7
3,-2,0,3.0,-2.0,0.7426629066467285,60.37383539249432,44,54,-27,1438,373,64,856,3,18.64
2,-2,0,2.0,-2.0,0.7502927780151367,57.697486947006624,44,52,-25,1438,373,64,856,3,14.91
2,-1,0,2.0,-1.0,0.7580747604370117,55.46169849544819,44,50,-24,1438,373,64,856,3,17.04
2,-2,0,2.0,-2.0,0.7661447525024414,52.80151512977634,44,48,-22,1438,373,64,856,3,14.06
3,-1,0,3.0,-1.0,0.774176836013794,49.658836071740545,44,45,-21,1438,373,64,856,3,16.12
2,-2,0,2.0,-2.0,0.7836408615112305,47.01063709417264,44,43,-19,1438,373,64,856,3,13.1
4,-3,0,4.0,-3.0,0.7901008129119873,42.15447781671598,44,39,-16,1438,373,64,856,3,16.0
3,-3,0,3.0,-3.0,0.7986478805541992,38.27531841800928,44,36,-13,1438,373,64,856,3,13.37
3,-2,0,3.0,-2.0,0.806830883026123,34.785054261852174,44,33,-11,1438,373,64,856,3,12.96
4,-3,0,4.0,-3.0,0.8140857219696045,30.083217912982647,44,29,-8,1438,373,64,856,3,12.82
4,-2,0,4.0,-2.0,0.8220958709716797,25.709920264364882,44,25,-6,1438,373,64,856,3,12.35
3,-1,0,3.0,-1.0,0.8305227756500244,22.561028345356956,44,22,-5,1438,373,64,856,3,11.68
3,-1,0,3.0,-1.0,0.8381078243255615,19.4164878389476,44,19,-4,1438,373,64,856,3,10.89
3,-1,0,3.0,-1.0,0.8460967540740967,16.278820596099706,44,16,-3,1438,373,64,856,3,10.04
2,-1,0,2.0,-1.0,0.8544368743896484,14.142135623730951,44,14,-2,1438,373,64,856,3,7.28
2,0,0,2.0,-0.0,0.8620758056640625,12.165525060596439,44,12,-2,1438,373,64,856,3,7.67
2,-1,0,2.0,-1.0,0.8701179027557373,10.04987562112089,44,10,-1,1438,373,64,856,3,6.33
2,-1,0,2.0,-1.0,0.8783998489379883,8.0,44,8,0,1438,373,64,856,3,5.47
2,0,0,2.0,-0.0,0.8896157741546631,6.0,44,6,0,1438,373,64,856,3,11.46
1,0,0,1.0,-0.0,0.8941307067871094,5.0,44,5,0,1438,373,64,856,3,9.58
1,0,0,1.0,-0.0,0.9022977352142334,4.0,44,4,0,1438,373,64,856,3,9.51
1,0,0,1.0,-0.0,0.9146227836608887,3.0,44,3,0,1438,373,64,856,3,9.43
1,-1,0,1.0,-1.0,0.9180917739868164,2.23606797749979,44,2,1,1438,373,64,856,3,0.58
1,0,0,1.0,-0.0,0.9268267154693604,1.4142135623730951,44,1,1,1438,373,64,856,3,1.22
1,0,0,1.0,-0.0,0.9430458545684814,1.0,44,0,1,1438,373,64,856,3,-1.03
1,0,0,1.0,-0.0,0.9501857757568359,1.4142135623730951,44,-1,1,1438,373,64,856,3,2.34
1,0,0,1.0,-0.0,0.9581377506256104,2.23606797749979,44,-2,1,1438,373,64,856,3,1.95
0,-1,0,-0.0,-1.0,0.9661197662353516,2.8284271247461903,44,-2,2,1438,373,64,856,3,2.69
1,0,0,1.0,-0.0,0.9744987487792969,3.605551275463989,44,-3,2,1438,373,64,856,3,2.73
0,0,1,-0.0,-0.0,1.1231088638305664,3.605551275463989,44,-3,2,1438,373,64,856,3,17.99
0,0,0,-0.0,-0.0,1.2180967330932617,3.605551275463989,44,-3,2,1438,373,64,856,3,17.99
-1,0,0,-1.0,-0.0,1.42209792137146,2.8284271247461903,44,-2,2,1438,373,64,856,3,1.72
-1,0,0,-1.0,-0.0,1.446089744567871,2.23606797749979,44,-1,2,1438,373,64,856,3,0.6
0,0,1,-0.0,-0.0,1.4931087493896484,2.23606797749979,44,-1,2,1438,373,64,856,3,27.58
0,0,0,-0.0,-0.0,0.12656784057617188,759.9743416721383,45,-744,-155,695,216,1439,371,29,175.23
-2,0,0,-2.0,-0.0,0.23160386085510254,758.016490585792,45,-742,-155,695,216,1439,371,29,13.58
-2,1,0,-2.0,1.0,0.24194693565368652,756.2645039931466,45,-740,-156,695,216,1439,371,29,10.88
-4,2,0,-4.0,2.0,0.24773097038269043,752.7682246216294,45,-736,-158,695,216,1439,371,29,19.3
-5,1,0,-5.0,1.0,0.25557398796081543,748.0922403019564,45,-731,-159,695,216,1439,371,29,25.13
-7,2,0,-7.0,2.0,0.26519083976745605,741.6852432130493,45,-724,-161,695,216,1439,371,29,31.7
-8,1,0,-8.0,1.0,0.271575927734375,734.0980860893181,45,-716,-162,695,216,1439,371,29,36.35
-8,0,0,-8.0,-0.0,0.27957987785339355,726.297459722943,45,-708,-162,695,216,1439,371,29,37.46
-7,0,0,-7.0,-0.0,0.28755688667297363,719.4755034050846,45,-701,-162,695,216,1439,371,29,33.75
-9,0,0,-9.0,-0.0,0.2959120273590088,710.7095046501066,45,-692,-162,695,216,1439,371,29,40.2
-11,0,0,-11.0,-0.0,0.3035609722137451,700.0035714194607,45,-681,-162,695,216,1439,371,29,45.8
-10,-2,0,-10.0,-2.0,0.31440091133117676,689.8122933088392,45,-671,-160,695,216,1439,371,29,46.15
-10,-2,0,-10.0,-2.0,0.3199880123138428,679.6212180325156,45,-661,-158,695,216,1439,371,29,45.74
-13,-3,0,-13.0,-3.0,0.3276069164276123,666.2799711832857,45,-648,-155,695,216,1439,371,29,54.93
-16,-5,0,-16.0,-5.0,0.335568904876709,649.5567719606963,45,-632,-150,695,216,1439,371,29,59.94
-25,-6,0,-25.0,-6.0,0.34355688095092773,623.8469363553852,45,-607,-144,695,216,1439,371,29,76.31
-27,-8,0,-27.0,-8.0,0.3516359329223633,595.7314831364882,45,-580,-136,695,216,1439,371,29,75.25
-28,-8,0,-28.0,-8.0,0.35956501960754395,566.646274142873,45,-552,-128,695,216,1439,371,29,74.28
-29,-8,0,-29.0,-8.0,0.36755800247192383,536.5901601781381,45,-523,-120,695,216,1439,371,29,73.06
-31,-8,0,-31.0,-8.0,0.3755810260772705,504.58695979979507,45,-492,-112,695,216,1439,371,29,72.75
-30,-8,0,-30.0,-8.0,0.3839750289916992,473.56097812214216,45,-462,-104,695,216,1439,371,29,68.61
-31,-8,0,-31.0,-8.0,0.39338183403015137,441.56200017664565,45,-431,-96,695,216,1439,371,29,66.69
-31,-8,0,-31.0,-8.0,0.39955902099609375,409.56562355744654,45,-400,-88,695,216,1439,371,29,63.45
-29,-8,0,-29.0,-8.0,0.4078638553619385,379.5273376187808,45,-371,-80,695,216,1439,371,29,58.19
-25,-7,0,-25.0,-7.0,0.415571928024292,353.61702447704636,45,-346,-73,695,216,1439,371,29,51.69
-22,-5,0,-22.0,-5.0,0.4235689640045166,331.058907144937,45,-324,-68,695,216,1439,371,29,47.67
-17,-6,0,-17.0,-6.0,0.4315488338470459,313.1980204279714,45,-307,-62,695,216,1439,371,29,38.41
-17,-5,0,-17.0,-5.0,0.43954992294311523,295.5486423585803,45,-290,-57,695,216,1439,371,29,37.25
-13,-4,0,-13.0,-4.0,0.44755101203918457,282.0248216026384,45,-277,-53,695,216,1439,371,29,30.78
-10,-4,0,-10.0,-4.0,0.4555540084838867,271.4590208484515,45,-267,-49,695,216,1439,371,29,25.03
-7,-2,0,-7.0,-2.0,0.46365904808044434,264.21392847463585,45,-260,-47,695,216,1439,371,29,20.08
-7,-3,0,-7.0,-3.0,0.4715590476989746,256.7975856584325,45,-253,-44,695,216,1439,371,29,18.91
-5,-2,0,-5.0,-2.0,0.47954797744750977,251.53131017827582,45,-248,-42,695,216,1439,371,29,14.89
-5,-1,0,-5.0,-1.0,0.4875359535217285,246.43457549621561,45,-243,-41,695,216,1439,371,29,16.73
-5,-2,0,-5.0,-2.0,0.4955768585205078,241.17421089328766,45,-238,-39,695,216,1439,371,29,14.47
-7,-2,0,-7.0,-2.0,0.5036258697509766,233.94443784796422,45,-231,-37,695,216,1439,371,29,18.39
-7,-2,0,-7.0,-2.0,0.5138959884643555,226.71788636982305,45,-224,-35,695,216,1439,371,29,17.99
-8,-2,0,-8.0,-2.0,0.5201468467712402,218.50629281556172,45,-216,-33,695,216,1439,371,29,19.43
-10,-3,0,-10.0,-3.0,0.5276069641113281,208.1730049742281,45,-206,-30,695,216,1439,371,29,21.09
-11,-2,0,-11.0,-2.0,0.5355420112609863,197.0,45,-195,-28,695,216,1439,371,29,23.03
-13,-3,0,-13.0,-3.0,0.543565034866333,183.7090090333079,45,-182,-25,695,216,1439,371,29,23.21
-14,-2,0,-14.0,-2.0,0.5515909194946289,169.5670958647343,45,-168,-23,695,216,1439,371,29,25.45
-13,-2,0,-13.0,-2.0,0.5618228912353516,156.41611170208776,45,-155,-21,695,216,1439,371,29,22.62
-10,-2,0,-10.0,-2.0,0.5676398277282715,146.23952953972466,45,-145,-19,695,216,1439,371,29,17.63
-11,-2,0,-11.0,-2.0,0.5768558979034424,135.07405376311175,45,-134,-17,695,216,1439,371,29,17.95
-9,-2,0,-9.0,-2.0,0.5904719829559326,125.89678312014172,45,-125,-15,695,216,1439,371,29,14.74
-7,-1,0,-7.0,-1.0,0.5918920040130615,118.82760622010359,45,-118,-14,695,216,1439,371,29,13.98
-5,-1,0,-5.0,-1.0,0.6029679775238037,113.7453295744489,45,-113,-13,695,216,1439,371,29,10.31
-4,-1,0,-4.0,-1.0,0.6075799465179443,109.65856099730654,45,-109,-12,695,216,1439,371,29,8.47
-4,0,0,-4.0,-0.0,0.6156008243560791,105.68348972285122,45,-105,-12,695,216,1439,371,29,8.43
-4,0,0,-4.0,-0.0,0.6235458850860596,101.71037311896953,45,-101,-12,695,216,1439,371,29,8.22
-5,-1,0,-5.0,-1.0,0.63211989402771,96.62815324738438,45,-96,-11,695,216,1439,371,29,9.52
-5,0,0,-5.0,-0.0,0.6396410465240479,91.6624241442479,45,-91,-11,695,216,1439,371,29,8.71
-5,0,0,-5.0,-0.0,0.6476008892059326,86.70063436907483,45,-86,-11,695,216,1439,371,29,8.4
-6,0,0,-6.0,-0.0,0.6569399833679199,80.75270893288967,45,-80,-11,695,216,1439,371,29,8.77
-6,-1,0,-6.0,-1.0,0.6636350154876709,74.67261881037788,45,-74,-10,695,216,1439,371,29,10.35
-6,-1,0,-6.0,-1.0,0.6715648174285889,68.59300255857006,45,-68,-9,695,216,1439,371,29,9.91
-4,0,0,-4.0,-0.0,0.6812229156494141,64.6297145282261,45,-64,-9,695,216,1439,371,29,6.51
-3,-1,0,-3.0,-1.0,0.6875498294830322,61.5223536610881,45,-61,-8,695,216,1439,371,29,5.38
-4,-1,0,-4.0,-1.0,0.6955819129943848,57.42821606144492,45,-57,-7,695,216,1439,371,29,6.45
-3,-1,0,-3.0,-1.0,0.7035508155822754,54.3323108288245,45,-54,-6,695,216,1439,371,29,4.97
-4,-1,0,-4.0,-1.0,0.7116248607635498,50.24937810560445,45,-50,-5,695,216,1439,371,29,5.89
-3,0,0,-3.0,-0.0,0.719728946685791,47.265209192385896,45,-47,-5,695,216,1439,371,29,5.57
-4,-1,0,-4.0,-1.0,0.7275388240814209,43.18564576337837,45,-43,-4,695,216,1439,371,29,5.47
-3,0,0,-3.0,-0.0,0.7355668544769287,40.19950248448356,45,-40,-4,695,216,1439,371,29,5.38
-3,-1,0,-3.0,-1.0,0.7435858249664307,37.12142238654117,45,-37,-3,695,216,1439,371,29,4.09
-2,0,0,-2.0,-0.0,0.7524399757385254,35.12833614050059,45,-35,-3,695,216,1439,371,29,4.94
-2,-1,0,-2.0,-1.0,0.7595648765563965,33.06055050963308,45,-33,-2,695,216,1439,371,29,2.78
-2,0,0,-2.0,-0.0,0.7675900459289551,31.064449134018133,45,-31,-2,695,216,1439,371,29,5.16
-1,-1,0,-1.0,-1.0,0.7767329216003418,30.01666203960727,45,-30,-1,695,216,1439,371,29,1.41
-1,0,0,-1.0,-0.0,0.7837798595428467,29.017236257093817,45,-29,-1,695,216,1439,371,29,5.44
-1,0,0,-1.0,-0.0,0.7915658950805664,28.0178514522438,45,-28,-1,695,216,1439,371,29,5.39
-1,0,0,-1.0,-0.0,0.8075740337371826,27.018512172212592,45,-27,-1,695,216,1439,371,29,5.33
0,-1,0,-0.0,-1.0,0.8315658569335938,27.0,45,-27,0,695,216,1439,371,29,-0.13
0,0,1,-0.0,-0.0,0.8455679416656494,27.0,45,-27,0,695,216,1439,371,29,35.04
0,0,0,-0.0,-0.0,0.1105508804321289,324.4225639501667,46,-285,155,437,371,722,216,66,102.06
-1,1,0,-1.0,1.0,0.18158674240112305,323.066556610244,46,-284,154,437,371,722,216,66,4.38
-1,4,0,-1.0,4.0,0.18951678276062012,320.2951763608063,46,-283,150,437,371,722,216,66,4.7
-2,2,0,-2.0,2.0,0.19750070571899414,317.59250620882096,46,-281,148,437,371,722,216,66,6.05
-2,5,0,-2.0,5.0,0.20612287521362305,313.5123602029113,46,-279,143,437,371,722,216,66,6.49
-4,6,0,-4.0,6.0,0.2135307788848877,307.23606559126483,46,-275,137,437,371,722,216,66,9.41
-4,5,0,-4.0,5.0,0.22150874137878418,301.43821920917725,46,-271,132,437,371,722,216,66,9.0
-6,7,0,-6.0,7.0,0.23190879821777344,293.00170647967224,46,-265,125,437,371,722,216,66,11.71
-7,8,0,-7.0,8.0,0.23766279220581055,283.28960446864266,46,-258,117,437,371,722,216,66,12.7
-7,7,0,-7.0,7.0,0.24550890922546387,274.0456166407337,46,-251,110,437,371,722,216,66,12.17
-7,9,0,-7.0,9.0,0.2554738521575928,264.0776400985134,46,-244,101,437,371,722,216,66,12.07
-9,11,0,-9.0,11.0,0.26149582862854004,251.6445906432324,46,-235,90,437,371,722,216,66,13.76
-9,11,0,-9.0,11.0,0.2704126834869385,239.40969069776602,46,-226,79,437,371,722,216,66,13.05
-9,11,0,-9.0,11.0,0.27867579460144043,227.40492518852795,46,-217,68,437,371,722,216,66,12.32
-10,11,0,-10.0,11.0,0.28549981117248535,214.70444802099468,46,-207,57,437,371,722,216,66,12.37
-11,10,0,-11.0,10.0,0.2934868335723877,201.55644370746373,46,-196,47,437,371,722,216,66,12.3
-11,12,0,-11.0,12.0,0.30149269104003906,188.2817038376273,46,-185,35,437,371,722,216,66,11.41
-9,9,0,-9.0,9.0,0.3094758987426758,177.9100896520487,46,-176,26,437,371,722,216,66,9.13
-10,9,0,-10.0,9.0,0.3182337284088135,166.86821147240718,46,-166,17,437,371,722,216,66,9.14
-9,5,0,-9.0,5.0,0.3258507251739502,157.45793088949188,46,-157,12,437,371,722,216,66,8.37
-8,5,0,-8.0,5.0,0.33356475830078125,149.164338901763,46,-149,7,437,371,722,216,66,7.16
-7,3,0,-7.0,3.0,0.3417847156524658,142.0563268566381,46,-142,4,437,371,722,216,66,6.69
-6,2,0,-6.0,2.0,0.35040879249572754,136.01470508735443,46,-136,2,437,371,722,216,66,6.2
-6,2,0,-6.0,2.0,0.35751771926879883,130.0,46,-130,0,437,371,722,216,66,5.96
-5,2,0,-5.0,2.0,0.3654947280883789,125.01599897613104,46,-125,-2,437,371,722,216,66,4.97
-6,0,0,-6.0,-0.0,0.37381577491760254,119.01680553602503,46,-119,-2,437,371,722,216,66,9.2
-4,1,0,-4.0,1.0,0.38150572776794434,115.03912377969506,46,-115,-3,437,371,722,216,66,4.76
-4,0,0,-4.0,-0.0,0.3894937038421631,111.04053313993049,46,-111,-3,437,371,722,216,66,7.53
-4,1,0,-4.0,1.0,0.397723913192749,107.07474025184464,46,-107,-4,437,371,722,216,66,4.55
-5,0,0,-5.0,-0.0,0.4094257354736328,102.07840124139877,46,-102,-4,437,371,722,216,66,7.45
-5,1,0,-5.0,1.0,0.4134988784790039,97.12878049270464,46,-97,-5,437,371,722,216,66,4.96
-6,1,0,-6.0,1.0,0.42180681228637695,91.19758768739445,46,-91,-6,437,371,722,216,66,5.32
-7,1,0,-7.0,1.0,0.4294857978820801,84.29116205154607,46,-84,-7,437,371,722,216,66,5.51
-7,1,0,-7.0,1.0,0.43752384185791016,77.41446893184762,46,-77,-8,437,371,722,216,66,5.15
-7,2,0,-7.0,2.0,0.4456167221069336,70.71067811865476,46,-70,-10,437,371,722,216,66,4.08
-7,1,0,-7.0,1.0,0.4556589126586914,63.953107821277925,46,-63,-11,437,371,722,216,66,4.27
-6,1,0,-6.0,1.0,0.4615159034729004,58.249463516842795,46,-57,-12,437,371,722,216,66,3.54
-4,0,0,-4.0,-0.0,0.46949076652526855,54.3415126767741,46,-53,-12,437,371,722,216,66,3.71
-3,1,0,-3.0,1.0,0.4774746894836426,51.66236541235796,46,-50,-13,437,371,722,216,66,2.0
-2,0,0,-2.0,-0.0,0.4855208396911621,49.72926703662542,46,-48,-13,437,371,722,216,66,2.95
-2,0,0,-2.0,-0.0,0.49347782135009766,47.80167361086848,46,-46,-13,437,371,722,216,66,2.86
0,0,1,-0.0,-0.0,0.5145087242126465,47.80167361086848,46,-46,-13,437,371,722,216,66,41.4
0,0,0,-0.0,-0.0,0.10486030578613281,471.65347449160174,47,336,331,819,715,483,384,57,130.38
0,2,0,-0.0,2.0,0.15384626388549805,470.2520600699161,47,336,329,819,715,483,384,57,4.02
3,2,0,3.0,2.0,0.16187334060668945,466.70975991508897,47,333,327,819,715,483,384,57,10.19
3,3,0,3.0,3.0,0.1699063777923584,462.46729614103526,47,330,324,819,715,483,384,57,14.45
4,3,0,4.0,3.0,0.17784929275512695,457.5117484830308,47,326,321,819,715,483,384,57,13.1
3,4,0,3.0,4.0,0.1862502098083496,452.56822690065195,47,323,317,819,715,483,384,57,12.85
6,6,0,6.0,6.0,0.1944563388824463,444.08332551448046,47,317,311,819,715,483,384,57,21.32
8,9,0,8.0,9.0,0.2061471939086914,432.0705960835567,47,309,302,819,715,483,384,57,24.35
9,10,0,9.0,10.0,0.20984935760498047,418.64543470579014,47,300,292,819,715,483,384,57,25.84
10,11,0,10.0,11.0,0.21784424781799316,403.80812275138794,47,290,281,819,715,483,384,57,27.09
11,11,0,11.0,11.0,0.22588038444519043,388.25378298221386,47,279,270,819,715,483,384,57,28.68
13,12,0,13.0,12.0,0.23384737968444824,370.56713291925934,47,266,258,819,715,483,384,57,29.88
14,14,0,14.0,14.0,0.24184441566467285,350.77058029430003,47,252,244,819,715,483,384,57,31.4
14,15,0,14.0,15.0,0.2498493194580078,330.28018408617856,47,238,229,819,715,483,384,57,29.69
14,14,0,14.0,14.0,0.25787830352783203,310.4851043125902,47,224,215,819,715,483,384,57,28.99
14,14,0,14.0,14.0,0.2669541835784912,290.69055712217414,47,210,201,819,715,483,384,57,27.8
13,14,0,13.0,14.0,0.2741382122039795,271.6210595664482,47,197,187,819,715,483,384,57,24.94
13,12,0,13.0,12.0,0.28188538551330566,253.9310930154084,47,184,175,819,715,483,384,57,24.34
11,11,0,11.0,11.0,0.29085230827331543,238.37994882120435,47,173,164,819,715,483,384,57,21.25
10,11,0,10.0,11.0,0.2979001998901367,223.55759884199867,47,163,153,819,715,483,384,57,18.66
9,10,0,9.0,10.0,0.3058772087097168,210.1547049199708,47,154,143,819,715,483,384,57,16.73
9,9,0,9.0,9.0,0.3146212100982666,197.43606560099397,47,145,134,819,715,483,384,57,16.6
8,10,0,8.0,10.0,0.32187533378601074,184.78365728602733,47,137,124,819,715,483,384,57,14.18
8,9,0,8.0,9.0,0.33099937438964844,172.81782315490494,47,129,115,819,715,483,384,57,13.56
8,9,0,8.0,9.0,0.3378472328186035,160.86329600005092,47,121,106,819,715,483,384,57,12.88
9,10,0,9.0,10.0,0.34593725204467773,147.5127113166862,47,112,96,819,715,483,384,57,12.99
9,8,0,9.0,8.0,0.3538663387298584,135.47324459095236,47,103,88,819,715,483,384,57,13.85
9,9,0,9.0,9.0,0.3618433475494385,122.78843593759146,47,94,79,819,715,483,384,57,11.81
9,8,0,9.0,8.0,0.3699634075164795,110.75197515168747,47,85,71,819,715,483,384,57,12.09
9,6,0,9.0,6.0,0.37847232818603516,100.00499987500625,47,76,65,819,715,483,384,57,9.24
7,5,0,7.0,5.0,0.3891143798828125,91.43850392476902,47,69,60,819,715,483,384,57,8.16
7,5,0,7.0,5.0,0.3938581943511963,82.87943049997388,47,62,55,819,715,483,384,57,7.65
7,4,0,7.0,4.0,0.4019303321838379,75.0066663703967,47,55,51,819,715,483,384,57,5.97
8,4,0,8.0,4.0,0.41267824172973633,66.46803743153546,47,47,47,819,715,483,384,57,5.32
6,4,0,6.0,4.0,0.4178433418273926,59.413803110051795,47,41,43,819,715,483,384,57,5.06
4,3,0,4.0,3.0,0.4264872074127197,54.48853090330111,47,37,40,819,715,483,384,57,4.51
4,3,0,4.0,3.0,0.43382740020751953,49.57822102496216,47,33,37,819,715,483,384,57,4.21
5,4,0,5.0,4.0,0.4419093132019043,43.278170016764804,47,28,33,819,715,483,384,57,4.34
4,3,0,4.0,3.0,0.449871301651001,38.41874542459709,47,24,30,819,715,483,384,57,3.44
4,3,0,4.0,3.0,0.457836389541626,33.60059523282288,47,20,27,819,715,483,384,57,3.03
3,2,0,3.0,2.0,0.4660372734069824,30.23243291566195,47,17,25,819,715,483,384,57,2.27
3,2,0,3.0,2.0,0.4743032455444336,26.92582403567252,47,14,23,819,715,483,384,57,1.95
3,2,0,3.0,2.0,0.4818441867828369,23.706539182259394,47,11,21,819,715,483,384,57,1.6
2,3,0,2.0,3.0,0.48987531661987305,20.12461179749811,47,9,18,819,715,483,384,57,3.45
2,1,0,2.0,1.0,0.49855828285217285,18.384776310850235,47,7,17,819,715,483,384,57,0.79
1,1,0,1.0,1.0,0.5058772563934326,17.08800749063506,47,6,16,819,715,483,384,57,1.6
1,2,0,1.0,2.0,0.5138423442840576,14.866068747318506,47,5,14,819,715,483,384,57,3.19
1,0,0,1.0,-0.0,0.5218312740325928,14.560219778561036,47,4,14,819,715,483,384,57,-0.04
0,0,1,-0.0,-0.0,0.5678563117980957,14.560219778561036,47,4,14,819,715,483,384,57,31.25
0,0,0,-0.0,-0.0,0.08941912651062012,409.49969474958095,48,307,271,1122,972,815,701,36,119.0
1,0,0,1.0,-0.0,0.12958526611328125,408.7505351678454,48,306,271,1122,972,815,701,36,3.49
1,0,0,1.0,-0.0,0.1375563144683838,408.0024509730303,48,305,271,1122,972,815,701,36,3.48
2,0,0,2.0,-0.0,0.14545512199401855,406.5095324835569,48,303,271,1122,972,815,701,36,5.62
2,0,0,2.0,-0.0,0.15337729454040527,405.0209871105447,48,301,271,1122,972,815,701,36,5.59
2,-1,0,2.0,-1.0,0.1613912582397461,404.2091043012267,48,299,272,1122,972,815,701,36,2.92
2,-1,0,2.0,-1.0,0.16944122314453125,403.40798207273986,48,297,273,1122,972,815,701,36,2.88
3,0,0,3.0,-0.0,0.1773841381072998,401.2044366653988,48,294,273,1122,972,815,701,36,7.49
4,-1,0,4.0,-1.0,0.18544316291809082,398.9686704491971,48,290,274,1122,972,815,701,36,7.12
4,-1,0,4.0,-1.0,0.19353914260864258,396.76315353117155,48,286,275,1122,972,815,701,36,7.0
6,-1,0,6.0,-1.0,0.20304131507873535,393.1615444063674,48,280,276,1122,972,815,701,36,10.64
7,0,0,7.0,-0.0,0.20940923690795898,388.20741878537046,48,273,276,1122,972,815,701,36,14.02
8,1,0,8.0,1.0,0.2174382209777832,381.9031290785662,48,265,275,1122,972,815,701,36,17.05
9,1,0,9.0,1.0,0.22659921646118164,374.98266626605556,48,256,274,1122,972,815,701,36,18.05
10,2,0,10.0,2.0,0.2334892749786377,366.742416417845,48,246,272,1122,972,815,701,36,20.5
10,3,0,10.0,3.0,0.24138832092285156,357.8505274552491,48,236,269,1122,972,815,701,36,21.55
12,4,0,12.0,4.0,0.25023627281188965,346.98847243100164,48,224,265,1122,972,815,701,36,24.45
11,5,0,11.0,5.0,0.2573831081390381,336.1086133975147,48,213,260,1122,972,815,701,36,24.22
10,4,0,10.0,4.0,0.2654001712799072,326.71853329739344,48,203,256,1122,972,815,701,36,21.2
10,5,0,10.0,5.0,0.2737312316894531,316.62280397975127,48,193,251,1122,972,815,701,36,22.07
10,6,0,10.0,6.0,0.2813832759857178,305.80058861944656,48,183,245,1122,972,815,701,36,22.85
10,7,0,10.0,7.0,0.28942012786865234,294.2329009475317,48,173,238,1122,972,815,701,36,23.54
10,6,0,10.0,6.0,0.3006281852722168,283.5365937581955,48,163,232,1122,972,815,701,36,21.43
10,8,0,10.0,8.0,0.30539822578430176,271.26555254952666,48,153,224,1122,972,815,701,36,23.34
9,10,0,9.0,10.0,0.3141043186187744,257.9379770409933,48,144,214,1122,972,815,701,36,24.83
9,9,0,9.0,9.0,0.32148122787475586,245.45875417267155,48,135,205,1122,972,815,701,36,22.57
9,9,0,9.0,9.0,0.3298921585083008,233.00643767930532,48,126,196,1122,972,815,701,36,21.69
9,10,0,9.0,10.0,0.3383941650390625,219.73848092675985,48,117,186,1122,972,815,701,36,22.02
8,10,0,8.0,10.0,0.34543514251708984,207.01932276963907,48,109,176,1122,972,815,701,36,21.08
7,10,0,7.0,10.0,0.3561413288116455,194.83326204732086,48,102,166,1122,972,815,701,36,20.64
8,11,0,8.0,11.0,0.3614501953125,181.27603261324978,48,94,155,1122,972,815,701,36,20.56
8,11,0,8.0,11.0,0.3698081970214844,167.72596698186004,48,86,144,1122,972,815,701,36,19.47
8,11,0,8.0,11.0,0.3773763179779053,154.18495387034366,48,78,133,1122,972,815,701,36,18.33
9,11,0,9.0,11.0,0.38538217544555664,140.1606221447379,48,69,122,1122,972,815,701,36,16.85
9,11,0,9.0,11.0,0.39628028869628906,126.17844506887855,48,60,111,1122,972,815,701,36,15.54
8,12,0,8.0,12.0,0.4017171859741211,111.8257573191436,48,52,99,1122,972,815,701,36,15.38
9,9,0,9.0,9.0,0.40957117080688477,99.74467404327912,48,43,90,1122,972,815,701,36,11.43
6,9,0,6.0,9.0,0.4203681945800781,89.05054744357274,48,37,81,1122,972,815,701,36,10.89
5,8,0,5.0,8.0,0.42566633224487305,79.7057087039567,48,32,73,1122,972,815,701,36,9.62
5,7,0,5.0,7.0,0.43683719635009766,71.30918594402827,48,27,66,1122,972,815,701,36,7.91
5,7,0,5.0,7.0,0.4414191246032715,62.96824596572466,48,22,59,1122,972,815,701,36,7.15
4,7,0,4.0,7.0,0.44945311546325684,55.02726596879042,48,18,52,1122,972,815,701,36,6.94
4,6,0,4.0,6.0,0.4573652744293213,48.08326112068523,48,14,46,1122,972,815,701,36,5.44
4,6,0,4.0,6.0,0.4653911590576172,41.23105625617661,48,10,40,1122,972,815,701,36,4.74
3,3,0,3.0,3.0,0.4734232425689697,37.656340767525464,48,7,37,1122,972,815,701,36,2.57
2,3,0,2.0,3.0,0.48465728759765625,34.36568055487916,48,5,34,1122,972,815,701,36,2.8
1,2,0,1.0,2.0,0.4895021915435791,32.2490309931942,48,4,32,1122,972,815,701,36,2.77
1,2,0,1.0,2.0,0.49739718437194824,30.14962686336267,48,3,30,1122,972,815,701,36,2.6
0,1,0,-0.0,1.0,0.5076851844787598,29.154759474226502,48,3,29,1122,972,815,701,36,4.04
1,1,0,1.0,1.0,0.5133821964263916,28.071337695236398,48,2,28,1122,972,815,701,36,1.33
1,1,0,1.0,1.0,0.5216231346130371,27.018512172212592,48,1,27,1122,972,815,701,36,1.22
0,1,0,-0.0,1.0,0.537452220916748,26.019223662515376,48,1,26,1122,972,815,701,36,5.16
0,1,0,-0.0,1.0,0.6099762916564941,25.019992006393608,48,1,25,1122,972,815,701,36,5.09
0,0,1,-0.0,-0.0,0.6263811588287354,25.019992006393608,48,1,25,1122,972,815,701,36,34.43
0,1,1,-0.0,1.0,0.014323949813842773,247.226616690032,49,-164,185,957,1133,1121,947,64,2.09
0,0,0,-0.0,-0.0,0.10730600357055664,247.226616690032,49,-164,185,957,1133,1121,947,64,85.05
1,0,0,1.0,-0.0,0.15828895568847656,247.8911051248108,49,-165,185,957,1133,1121,947,64,2.77
0,-2,0,-0.0,-2.0,0.16628503799438477,249.38724907260195,49,-165,187,957,1133,1121,947,64,1.94
1,-1,0,1.0,-1.0,0.1743161678314209,250.79872407968904,49,-166,188,957,1133,1121,947,64,5.25
1,-1,0,1.0,-1.0,0.18230009078979492,252.21022976873877,49,-167,189,957,1133,1121,947,64,5.27
0,-1,0,-0.0,-1.0,0.190277099609375,252.96047122030745,49,-167,190,957,1133,1121,947,64,2.81
0,-1,0,-0.0,-1.0,0.20711994171142578,253.71243564319033,49,-167,191,957,1133,1121,947,64,2.82
-1,0,0,-1.0,-0.0,0.22242999076843262,253.0553299181821,49,-166,191,957,1133,1121,947,64,1.77
-2,-1,0,-2.0,-1.0,0.23038101196289062,252.50742563338608,49,-164,192,957,1133,1121,947,64,0.97
-1,-1,0,-1.0,-1.0,0.23827910423278809,252.62224763468478,49,-163,193,957,1133,1121,947,64,9.7
-2,0,0,-2.0,-0.0,0.24631810188293457,251.3364279208249,49,-161,193,957,1133,1121,947,64,2.44
-3,0,0,-3.0,-0.0,0.2544100284576416,249.42533953069002,49,-158,193,957,1133,1121,947,64,3.11
-4,0,0,-4.0,-0.0,0.2623140811920166,246.9109151090733,49,-154,193,957,1133,1121,947,64,3.73
-3,0,0,-3.0,-0.0,0.27057504653930664,245.05101509685693,49,-151,193,957,1133,1121,947,64,2.99
-4,2,0,-4.0,2.0,0.2785370349884033,241.0186714758838,49,-147,191,957,1133,1121,947,64,6.25
-5,4,0,-5.0,4.0,0.2903580665588379,234.8041737278109,49,-142,187,957,1133,1121,947,64,9.12
-7,4,0,-7.0,4.0,0.294370174407959,227.40712389896672,49,-135,183,957,1133,1121,947,64,9.28
-7,6,0,-7.0,6.0,0.30280303955078125,218.4330561064419,49,-128,177,957,1133,1121,947,64,11.17
-9,6,0,-9.0,6.0,0.3102879524230957,208.33146665830392,49,-119,171,957,1133,1121,947,64,11.07
-11,7,0,-11.0,7.0,0.31841206550598145,196.36700333813724,49,-108,164,957,1133,1121,947,64,11.8
-12,8,0,-12.0,8.0,0.3263390064239502,183.17205026968497,49,-96,156,957,1133,1121,947,64,12.01
-14,9,0,-14.0,9.0,0.33428215980529785,168.32409215557945,49,-82,147,957,1133,1121,947,64,12.08
-12,8,0,-12.0,8.0,0.34245896339416504,155.63097378092831,49,-70,139,957,1133,1121,947,64,10.15
-12,8,0,-12.0,8.0,0.3503429889678955,143.26548781894402,49,-58,131,957,1133,1121,947,64,9.24
-12,9,0,-12.0,9.0,0.36219096183776855,130.38404810405297,49,-46,122,957,1133,1121,947,64,8.86
-13,9,0,-13.0,9.0,0.36632299423217773,117.72000679578642,49,-33,113,957,1133,1121,947,64,7.82
-11,7,0,-11.0,7.0,0.37430500984191895,108.25894882179486,49,-22,106,957,1133,1121,947,64,5.68
-10,7,0,-10.0,7.0,0.3823111057281494,99.72462083156798,49,-12,99,957,1133,1121,947,64,4.84
-8,7,0,-8.0,7.0,0.3917839527130127,92.0869154657707,49,-4,92,957,1133,1121,947,64,4.25
-6,6,0,-6.0,6.0,0.39838409423828125,86.02325267042627,49,2,86,957,1133,1121,947,64,3.43
-4,5,0,-4.0,5.0,0.40628910064697266,81.2219182240853,49,6,81,957,1133,1121,947,64,2.94
-2,5,0,-2.0,5.0,0.41491103172302246,76.4198926981712,49,8,76,957,1133,1121,947,64,3.49
-2,3,0,-2.0,3.0,0.4223480224609375,73.68174807915459,49,10,73,957,1133,1121,947,64,2.11
0,3,0,-0.0,3.0,0.4303109645843506,70.71067811865476,49,10,70,957,1133,1121,947,64,4.45
-1,2,0,-1.0,2.0,0.43840599060058594,68.8839603971781,49,11,68,957,1133,1121,947,64,1.98
0,2,0,-0.0,2.0,0.44881415367126465,66.91038783328041,49,11,66,957,1133,1121,947,64,3.87
-1,2,0,-1.0,2.0,0.45450401306152344,65.11528238439882,49,12,64,957,1133,1121,947,64,1.86
0,2,0,-0.0,2.0,0.46239614486694336,63.150613615387776,49,12,62,957,1133,1121,947,64,3.62
0,1,0,-0.0,1.0,0.47201108932495117,62.16912416947821,49,12,61,957,1133,1121,947,64,3.31
0,0,1,-0.0,-0.0,0.4753141403198242,62.16912416947821,49,12,61,957,1133,1121,947,64,45.76
0,0,0,-0.0,-0.0,0.5983879566192627,62.16912416947821,49,12,61,957,1133,1121,947,64,35.76
-1,1,0,-1.0,1.0,0.6382901668548584,61.39218191268331,49,13,60,957,1133,1121,947,64,0.9
0,2,0,-0.0,2.0,0.6463479995727539,59.43904440685432,49,13,58,957,1133,1121,947,64,3.37
0,2,0,-0.0,2.0,0.6542890071868896,57.48912940721924,49,13,56,957,1133,1121,947,64,3.29
0,2,0,-0.0,2.0,0.6623311042785645,55.54277630799526,49,13,54,957,1133,1121,947,64,3.22
1,3,0,1.0,3.0,0.6704001426696777,52.392747589718944,49,12,51,957,1133,1121,947,64,4.72
0,3,0,-0.0,3.0,0.6852071285247803,49.47726750741192,49,12,48,957,1133,1121,947,64,3.27
1,2,0,1.0,2.0,0.6863090991973877,47.29693436154187,49,11,46,957,1133,1121,947,64,3.18
0,2,0,-0.0,2.0,0.6971089839935303,45.35416188179427,49,11,44,957,1133,1121,947,64,3.01
0,2,0,-0.0,2.0,0.7023019790649414,43.41658669218482,49,11,42,957,1133,1121,947,64,2.91
0,2,0,-0.0,2.0,0.7107281684875488,41.48493702538308,49,11,40,957,1133,1121,947,64,2.81
1,2,0,1.0,2.0,0.7183289527893066,39.293765408777,49,10,38,957,1133,1121,947,64,3.17
0,1,0,-0.0,1.0,0.7263281345367432,38.3275357934736,49,10,37,957,1133,1121,947,64,2.68
0,1,0,-0.0,1.0,0.7346811294555664,37.36308338453881,49,10,36,957,1133,1121,947,64,2.63
0,1,0,-0.0,1.0,0.7442760467529297,36.40054944640259,49,10,35,957,1133,1121,947,64,2.58
0,0,1,-0.0,-0.0,0.7452940940856934,36.40054944640259,49,10,35,957,1133,1121,947,64,37.91
0,0,0,-0.0,-0.0,0.853302001953125,36.40054944640259,49,10,35,957,1133,1121,947,64,27.91
1,-1,0,1.0,-1.0,0.8703031539916992,37.107950630558946,49,9,36,957,1133,1121,947,64,0.77
1,-1,0,1.0,-1.0,0.8863561153411865,37.8549864614954,49,8,37,957,1133,1121,947,64,0.8
1,-1,0,1.0,-1.0,0.8947751522064209,38.63935817272331,49,7,38,957,1133,1121,947,64,0.83
0,-1,0,-0.0,-1.0,0.9038469791412354,39.6232255123179,49,7,39,957,1133,1121,947,64,3.18
1,-2,0,1.0,-2.0,0.9103600978851318,41.43669871020132,49,6,41,957,1133,1121,947,64,1.03
1,-2,0,1.0,-2.0,0.918328046798706,43.289721643826724,49,5,43,957,1133,1121,947,64,1.12
1,-2,0,1.0,-2.0,0.9271450042724609,45.17742799230607,49,4,45,957,1133,1121,947,64,1.2
1,-1,0,1.0,-1.0,0.9342999458312988,46.09772228646444,49,3,46,957,1133,1121,947,64,1.04
0,-1,0,-0.0,-1.0,0.9423260688781738,47.095647357266465,49,3,47,957,1133,1121,947,64,4.56
1,-1,0,1.0,-1.0,0.9503099918365479,48.041648597857254,49,2,48,957,1133,1121,947,64,1.09
1,-1,0,1.0,-1.0,0.9582970142364502,49.01020301937138,49,1,49,957,1133,1121,947,64,1.12
0,-1,0,-0.0,-1.0,0.9663231372833252,50.00999900019995,49,1,50,957,1133,1121,947,64,5.77
1,0,0,1.0,-0.0,0.974297046661377,50.0,49,0,50,957,1133,1121,947,64,-0.01
0,0,1,-0.0,-0.0,1.0783040523529053,50.0,49,0,50,957,1133,1121,947,64,42.07
0,0,0,-0.0,-0.0,0.06766724586486816,811.6070477762006,50,775,-241,1732,842,957,1083,57,182.2
2,-2,0,2.0,-2.0,0.23367023468017578,809.1044431963034,50,773,-239,1732,842,957,1083,57,9.12
2,-3,0,2.0,-3.0,0.24184632301330566,806.3107341465819,50,771,-236,1732,842,957,1083,57,9.43
3,-4,0,3.0,-4.0,0.2497422695159912,802.2767602267936,50,768,-232,1732,842,957,1083,57,12.87
5,-6,0,5.0,-6.0,0.26071929931640625,795.7669256761052,50,763,-226,1732,842,957,1083,57,19.19
6,-4,0,6.0,-4.0,0.2657432556152344,788.880852854219,50,757,-222,1732,842,957,1083,57,20.94
6,-6,0,6.0,-6.0,0.273754358291626,781.4454555501619,50,751,-216,1732,842,957,1083,57,21.41
9,-4,0,9.0,-4.0,0.28167033195495605,771.6916482637349,50,742,-212,1732,842,957,1083,57,28.2
11,-6,0,11.0,-6.0,0.2897763252258301,759.4715267868836,50,731,-206,1732,842,957,1083,57,32.42
14,-4,0,14.0,-4.0,0.29767918586730957,744.9114041280345,50,717,-202,1732,842,957,1083,57,40.2
19,-5,0,19.0,-5.0,0.30814337730407715,725.2675368441635,50,698,-197,1732,842,957,1083,57,47.44
23,-5,0,23.0,-5.0,0.31369924545288086,701.77560516165,50,675,-192,1732,842,957,1083,57,50.95
26,-4,0,26.0,-4.0,0.3225433826446533,675.6811378157599,50,649,-188,1732,842,957,1083,57,52.38
29,-6,0,29.0,-6.0,0.3327333927154541,646.1609706566933,50,620,-182,1732,842,957,1083,57,55.67
29,-6,0,29.0,-6.0,0.337787389755249,616.6498195896922,50,591,-176,1732,842,957,1083,57,54.05
31,-9,0,31.0,-9.0,0.34734320640563965,584.3706015877253,50,560,-167,1732,842,957,1083,57,57.53
30,-8,0,30.0,-8.0,0.35706520080566406,553.3362449722591,50,530,-159,1732,842,957,1083,57,53.31
28,-9,0,28.0,-9.0,0.3616983890533447,523.9312932055118,50,502,-150,1732,842,957,1083,57,50.37
24,-7,0,24.0,-7.0,0.3697943687438965,498.9318590749643,50,478,-143,1732,842,957,1083,57,45.18
22,-8,0,22.0,-8.0,0.3776721954345703,475.5638758358334,50,456,-135,1732,842,957,1083,57,40.25
21,-8,0,21.0,-8.0,0.38568830490112305,453.16001588842767,50,435,-127,1732,842,957,1083,57,37.71
17,-7,0,17.0,-7.0,0.3937563896179199,434.8838925506439,50,418,-120,1732,842,957,1083,57,31.8
15,-9,0,15.0,-9.0,0.4016883373260498,418.0071769718793,50,403,-111,1732,842,957,1083,57,28.21
14,-9,0,14.0,-9.0,0.40970420837402344,402.15046935195784,50,389,-102,1732,842,957,1083,57,26.13
13,-10,0,13.0,-10.0,0.41782140731811523,387.09172039711723,50,376,-92,1732,842,957,1083,57,24.17
12,-11,0,12.0,-11.0,0.4256563186645508,372.90347276473574,50,364,-81,1732,842,957,1083,57,22.24
13,-11,0,13.0,-11.0,0.4336683750152588,357.91200035762984,50,351,-70,1732,842,957,1083,57,22.57
14,-10,0,14.0,-10.0,0.4465672969818115,342.29957639471303,50,337,-60,1732,842,957,1083,57,22.74
16,-9,0,16.0,-9.0,0.449688196182251,325.0261527938944,50,321,-51,1732,842,957,1083,57,23.91
15,-8,0,15.0,-8.0,0.45766329765319824,309.00647242412253,50,306,-43,1732,842,957,1083,57,21.94
17,-7,0,17.0,-7.0,0.4656522274017334,291.23358322830836,50,289,-36,1732,842,957,1083,57,23.03
19,-7,0,19.0,-7.0,0.4738163948059082,271.55294143131647,50,270,-29,1732,842,957,1083,57,23.62
18,-7,0,18.0,-7.0,0.4817183017730713,252.9584946191766,50,252,-22,1732,842,957,1083,57,21.47
17,-5,0,17.0,-5.0,0.489673376083374,235.61409125941512,50,235,-17,1732,842,957,1083,57,19.91
17,-6,0,17.0,-6.0,0.4977152347564697,218.27734651126764,50,218,-11,1732,842,957,1083,57,18.48
15,-6,0,15.0,-6.0,0.5076682567596436,203.0615670184784,50,203,-5,1732,842,957,1083,57,15.82
14,-4,0,14.0,-4.0,0.5138182640075684,189.0026454841307,50,189,-1,1732,842,957,1083,57,14.63
13,-4,0,13.0,-4.0,0.5217442512512207,176.02556632489498,50,176,3,1732,842,957,1083,57,13.02
11,-3,0,11.0,-3.0,0.5296711921691895,165.10905486980417,50,165,6,1732,842,957,1083,57,11.17
11,-3,0,11.0,-3.0,0.5377073287963867,154.26276284314372,50,154,9,1732,842,957,1083,57,10.54
12,-3,0,12.0,-3.0,0.5466372966766357,142.50614021858848,50,142,12,1732,842,957,1083,57,10.51
11,-2,0,11.0,-2.0,0.5536782741546631,131.7459676802292,50,131,14,1732,842,957,1083,57,9.61
11,-2,0,11.0,-2.0,0.5617022514343262,121.06196760337245,50,120,16,1732,842,957,1083,57,8.93
10,-2,0,10.0,-2.0,0.569695234298706,111.46299834474219,50,110,18,1732,842,957,1083,57,7.72
10,-3,0,10.0,-3.0,0.5802602767944336,102.18121158021175,50,100,21,1732,842,957,1083,57,6.65
9,-1,0,9.0,-1.0,0.5856983661651611,93.62157870918435,50,91,22,1732,842,957,1083,57,6.47
8,-1,0,8.0,-1.0,0.5937213897705078,86.1278120005379,50,83,23,1732,842,957,1083,57,5.51
7,-2,0,7.0,-2.0,0.6035332679748535,80.00624975587844,50,76,25,1732,842,957,1083,57,4.09
7,-1,0,7.0,-1.0,0.6099643707275391,73.7360156233031,50,69,26,1732,842,957,1083,57,4.18
6,-1,0,6.0,-1.0,0.6177012920379639,68.54195795277518,50,63,27,1732,842,957,1083,57,3.41
6,-1,0,6.0,-1.0,0.6256802082061768,63.50590523722971,50,57,28,1732,842,957,1083,57,3.06
5,0,0,5.0,-0.0,0.6340231895446777,59.0592922409336,50,52,28,1732,842,957,1083,57,3.08
4,0,0,4.0,-0.0,0.6439852714538574,55.569775957799216,50,48,28,1732,842,957,1083,57,2.6
3,0,0,3.0,-0.0,0.6498763561248779,53.0,50,45,28,1732,842,957,1083,57,2.21
2,0,0,2.0,-0.0,0.6576724052429199,51.31276644267,50,43,28,1732,842,957,1083,57,1.9
2,0,0,2.0,-0.0,0.6683533191680908,49.64876634922564,50,41,28,1732,842,957,1083,57,1.82
1,0,0,1.0,-0.0,0.6739614009857178,48.82622246293481,50,40,28,1732,842,957,1083,57,1.61
1,0,0,1.0,-0.0,0.6818602085113525,48.010415536631214,50,39,28,1732,842,957,1083,57,1.57
1,0,0,1.0,-0.0,0.6896963119506836,47.20169488482379,50,38,28,1732,842,957,1083,57,1.54
2,0,0,2.0,-0.0,0.6979022026062012,45.60701700396552,50,36,28,1732,842,957,1083,57,1.59
1,0,0,1.0,-0.0,0.7136673927307129,44.82186966202994,50,35,28,1732,842,957,1083,57,1.42
1,1,0,1.0,1.0,0.7217442989349365,43.41658669218482,50,34,27,1732,842,957,1083,57,3.97
1,0,0,1.0,-0.0,0.7300162315368652,42.638011210655684,50,33,27,1732,842,957,1083,57,1.38
1,0,0,1.0,-0.0,0.7422583103179932,41.86884283091664,50,32,27,1732,842,957,1083,57,1.34
1,0,0,1.0,-0.0,0.753697395324707,41.10960958218893,50,31,27,1732,842,957,1083,57,1.29
1,0,0,1.0,-0.0,0.7616603374481201,40.36087214122113,50,30,27,1732,842,957,1083,57,1.25
0,0,1,-0.0,-0.0,0.7837002277374268,40.36087214122113,50,30,27,1732,842,957,1083,57,39.129999999999995
2,0,1,2.0,-0.0,0.004426002502441406,1002.9237259133916,51,-860,-516,844,299,1702,815,23,6.55
1,0,1,1.0,-0.0,0.007993936538696289,1003.7813506934665,51,-861,-516,844,299,1702,815,23,11.25
1,0,1,1.0,-0.0,0.02027297019958496,1004.6392387319938,51,-862,-516,844,299,1702,815,23,11.26
0,0,0,-0.0,-0.0,0.09496593475341797,1004.6392387319938,51,-862,-516,844,299,1702,815,23,206.17
-1,0,0,-1.0,-0.0,0.15207386016845703,1003.7813506934665,51,-861,-516,844,299,1702,815,23,8.81
-3,1,0,-3.0,1.0,0.15995383262634277,1001.7250121665127,51,-858,-517,844,299,1702,815,23,17.3
-3,0,0,-3.0,-0.0,0.16793489456176758,999.1566443756454,51,-855,-517,844,299,1702,815,23,21.58
-4,0,0,-4.0,-0.0,0.17607784271240234,995.7359087629611,51,-851,-517,844,299,1702,815,23,27.28
-5,1,0,-5.0,1.0,0.1888139247894287,991.9879031520495,51,-846,-518,844,299,1702,815,23,28.88
-8,0,0,-8.0,-0.0,0.19205188751220703,985.1740962895848,51,-838,-518,844,299,1702,815,23,46.6
-11,-1,0,-11.0,-1.0,0.20096588134765625,975.3040551540837,51,-827,-517,844,299,1702,815,23,60.59
-13,-2,0,-13.0,-2.0,0.20798683166503906,963.2346546921991,51,-814,-515,844,299,1702,815,23,68.86
-16,-4,0,-16.0,-4.0,0.21595191955566406,947.5890459476618,51,-798,-511,844,299,1702,815,23,80.19
-21,-5,0,-21.0,-5.0,0.22488903999328613,927.235137384256,51,-777,-506,844,299,1702,815,23,91.35
-24,-7,0,-24.0,-7.0,0.2319478988647461,903.3327183269739,51,-753,-499,844,299,1702,815,23,97.63
-22,-8,0,-22.0,-8.0,0.23998594284057617,880.5918464305697,51,-731,-491,844,299,1702,815,23,94.18
-25,-10,0,-25.0,-10.0,0.24800801277160645,854.2815695073843,51,-706,-481,844,299,1702,815,23,99.21
-24,-11,0,-24.0,-11.0,0.255950927734375,828.2656578658806,51,-682,-470,844,299,1702,815,23,97.21
-24,-11,0,-24.0,-11.0,0.26397085189819336,802.2748905456284,51,-658,-459,844,299,1702,815,23,95.3
-25,-14,0,-25.0,-14.0,0.2719569206237793,773.7661145333259,51,-633,-445,844,299,1702,815,23,97.87
-24,-13,0,-24.0,-13.0,0.2823798656463623,746.6625743935476,51,-609,-432,844,299,1702,815,23,93.51
-25,-14,0,-25.0,-14.0,0.2884249687194824,718.1782508542012,51,-584,-418,844,299,1702,815,23,93.43
-25,-14,0,-25.0,-14.0,0.29595303535461426,689.70790919055,51,-559,-404,844,299,1702,815,23,91.08
-23,-13,0,-23.0,-13.0,0.3039698600769043,663.4583634260706,51,-536,-391,844,299,1702,815,23,85.84
-24,-13,0,-24.0,-13.0,0.311992883682251,636.4181015653153,51,-512,-378,844,299,1702,815,23,84.52
-24,-14,0,-24.0,-14.0,0.31995201110839844,608.8021024930844,51,-488,-364,844,299,1702,815,23,83.25
-24,-13,0,-24.0,-13.0,0.328035831451416,581.8049501336337,51,-464,-351,844,299,1702,815,23,79.73
-25,-14,0,-25.0,-14.0,0.33595991134643555,553.4347296655677,51,-439,-337,844,299,1702,815,23,78.98
-23,-14,0,-23.0,-14.0,0.34397292137145996,526.6735231621199,51,-416,-323,844,299,1702,815,23,74.92
-22,-15,0,-22.0,-15.0,0.3519480228424072,500.0999900019995,51,-394,-308,844,299,1702,815,23,72.95
-21,-15,0,-21.0,-15.0,0.35993289947509766,474.31845842218706,51,-373,-293,844,299,1702,815,23,70.02
-21,-16,0,-21.0,-16.0,0.3681049346923828,447.9207519193546,51,-352,-277,844,299,1702,815,23,69.26
-21,-17,0,-21.0,-17.0,0.37731385231018066,420.90497739988774,51,-331,-260,844,299,1702,815,23,67.29
-21,-18,0,-21.0,-18.0,0.38394904136657715,393.2734417679384,51,-310,-242,844,299,1702,815,23,63.89
-20,-15,0,-20.0,-15.0,0.39466285705566406,368.27842728023046,51,-290,-227,844,299,1702,815,23,59.48
-18,-15,0,-18.0,-15.0,0.40071892738342285,344.8593916366495,51,-272,-212,844,299,1702,815,23,54.93
-18,-12,0,-18.0,-12.0,0.40799689292907715,323.2893440866865,51,-254,-200,844,299,1702,815,23,49.69
-14,-12,0,-14.0,-12.0,0.41593098640441895,304.86718419665965,51,-240,-188,844,299,1702,815,23,44.96
-15,-10,0,-15.0,-10.0,0.42395687103271484,286.89545134072796,51,-225,-178,844,299,1702,815,23,41.94
-11,-10,0,-11.0,-10.0,0.4319908618927002,272.06616842231597,51,-214,-168,844,299,1702,815,23,36.78
-13,-9,0,-13.0,-9.0,0.44344186782836914,256.28499761008254,51,-201,-159,844,299,1702,815,23,36.68
-11,-8,0,-11.0,-8.0,0.44827985763549805,242.69528219559604,51,-190,-151,844,299,1702,815,23,33.16
-10,-8,0,-10.0,-8.0,0.45598483085632324,229.88910370002316,51,-180,-143,844,299,1702,815,23,32.86
-10,-7,0,-10.0,-7.0,0.46395301818847656,217.70622407271685,51,-170,-136,844,299,1702,815,23,28.69
-10,-7,0,-10.0,-7.0,0.47200894355773926,205.526154053444,51,-160,-129,844,299,1702,815,23,27.56
-10,-6,0,-10.0,-6.0,0.4815490245819092,193.98195792392653,51,-150,-123,844,299,1702,815,23,24.78
-10,-7,0,-10.0,-7.0,0.49096083641052246,181.8130908378162,51,-140,-116,844,299,1702,815,23,25.22
-10,-6,0,-10.0,-6.0,0.4960038661956787,170.29386365926402,51,-130,-110,844,299,1702,815,23,22.55
-9,-6,0,-9.0,-6.0,0.5039718151092529,159.55249919697278,51,-121,-104,844,299,1702,815,23,21.12
-9,-5,0,-9.0,-5.0,0.5119669437408447,149.4824404403407,51,-112,-99,844,299,1702,815,23,18.74
-7,-4,0,-7.0,-4.0,0.5199530124664307,141.59802258506295,51,-105,-95,844,299,1702,815,23,15.62
-6,-4,0,-6.0,-4.0,0.52964186668396,134.46932735757994,51,-99,-91,844,299,1702,815,23,14.67
-4,-2,0,-4.0,-2.0,0.5395798683166504,130.17680284904833,51,-95,-89,844,299,1702,815,23,9.83
-5,-4,0,-5.0,-4.0,0.5439879894256592,123.79418403139947,51,-90,-85,844,299,1702,815,23,13.9
-5,-4,0,-5.0,-4.0,0.5519578456878662,117.41379816699569,51,-85,-81,844,299,1702,815,23,13.42
-4,-3,0,-4.0,-3.0,0.5599448680877686,112.44998888394787,51,-81,-78,844,299,1702,815,23,11.0
-3,-2,0,-3.0,-2.0,0.5682039260864258,108.90362712049586,51,-78,-76,844,299,1702,815,23,8.5
-3,-4,0,-3.0,-4.0,0.5759458541870117,103.96634070698074,51,-75,-72,844,299,1702,815,23,10.15
-4,-3,0,-4.0,-3.0,0.5839810371398926,99.00505037623081,51,-71,-69,844,299,1702,815,23,10.22
-4,-2,0,-4.0,-2.0,0.5919358730316162,94.75230867899737,51,-67,-67,844,299,1702,815,23,7.95
-4,-4,0,-4.0,-4.0,0.5999529361724854,89.09545442950498,51,-63,-63,844,299,1702,815,23,13.97
-3,-3,0,-3.0,-3.0,0.6079559326171875,84.8528137423857,51,-60,-60,844,299,1702,815,23,12.23
-3,-3,0,-3.0,-3.0,0.6160099506378174,80.61017305526642,51,-57,-57,844,299,1702,815,23,12.04
-4,-3,0,-4.0,-3.0,0.6272439956665039,75.66372975210778,51,-53,-54,844,299,1702,815,23,8.66
-3,-3,0,-3.0,-3.0,0.6319808959960938,71.42128534267638,51,-50,-51,844,299,1702,815,23,10.72
-2,-3,0,-2.0,-3.0,0.6399819850921631,67.88225099390856,51,-48,-48,844,299,1702,815,23,6.63
-3,-3,0,-3.0,-3.0,0.6479458808898926,63.63961030678928,51,-45,-45,844,299,1702,815,23,11.25
-2,-3,0,-2.0,-3.0,0.6566300392150879,60.108235708594876,51,-43,-42,844,299,1702,815,23,6.18
-2,-2,0,-2.0,-2.0,0.6651370525360107,57.28001396647874,51,-41,-40,844,299,1702,815,23,8.67
-3,-2,0,-3.0,-2.0,0.6744320392608643,53.74011537017761,51,-38,-38,844,299,1702,815,23,5.96
-2,-3,0,-2.0,-3.0,0.6799650192260742,50.20956084253277,51,-36,-35,844,299,1702,815,23,5.69
-2,-1,0,-2.0,-1.0,0.6884558200836182,48.08326112068523,51,-34,-34,844,299,1702,815,23,4.01
-3,-2,0,-3.0,-2.0,0.6980388164520264,44.553338819890925,51,-31,-32,844,299,1702,815,23,5.39
-3,-2,0,-3.0,-2.0,0.704110860824585,41.036569057366385,51,-28,-30,844,299,1702,815,23,5.08
-2,-1,0,-2.0,-1.0,0.7121310234069824,38.948684188300895,51,-26,-29,844,299,1702,815,23,3.44
-2,-2,0,-2.0,-2.0,0.7284629344940186,36.124783736376884,51,-24,-27,844,299,1702,815,23,6.25
-2,-1,0,-2.0,-1.0,0.7286338806152344,34.058772731852805,51,-22,-26,844,299,1702,815,23,3.14
-2,-1,0,-2.0,-1.0,0.7359628677368164,32.01562118716424,51,-20,-25,844,299,1702,815,23,2.95
-2,-1,0,-2.0,-1.0,0.743973970413208,30.0,51,-18,-24,844,299,1702,815,23,2.75
-1,-2,0,-1.0,-2.0,0.7523338794708252,27.80287754891569,51,-17,-22,844,299,1702,815,23,3.98
-3,0,0,-3.0,-0.0,0.7599468231201172,26.076809620810597,51,-14,-22,844,299,1702,815,23,1.19
-1,-2,0,-1.0,-2.0,0.7683219909667969,23.853720883753127,51,-13,-20,844,299,1702,815,23,4.54
-2,0,0,-2.0,-0.0,0.7759649753570557,22.825424421026653,51,-11,-20,844,299,1702,815,23,0.73
-3,-2,0,-3.0,-2.0,0.7851698398590088,19.697715603592208,51,-8,-18,844,299,1702,815,23,2.31
-2,-2,0,-2.0,-2.0,0.7919328212738037,17.08800749063506,51,-6,-16,844,299,1702,815,23,2.4
-3,-3,0,-3.0,-3.0,0.799954891204834,13.341664064126334,51,-3,-13,844,299,1702,815,23,1.98
-2,-1,0,-2.0,-1.0,0.8098249435424805,12.041594578792296,51,-1,-12,844,299,1702,815,23,0.32
-2,-3,0,-2.0,-3.0,0.8162310123443604,9.055385138137417,51,1,-9,844,299,1702,815,23,0.99
-2,-2,0,-2.0,-2.0,0.823969841003418,7.615773105863909,51,3,-7,844,299,1702,815,23,-0.41
-2,-2,0,-2.0,-2.0,0.8339190483093262,7.0710678118654755,51,5,-5,844,299,1702,815,23,-1.24
-1,-2,0,-1.0,-2.0,0.8399538993835449,6.708203932499369,51,6,-3,844,299,1702,815,23,-1.17
-1,-1,0,-1.0,-1.0,0.8488178253173828,7.280109889280518,51,7,-2,844,299,1702,815,23,0.04
0,-1,0,-0.0,-1.0,0.8579368591308594,7.0710678118654755,51,7,-1,844,299,1702,815,23,-0.5
0,0,1,-0.0,-0.0,0.8819849491119385,7.0710678118654755,51,7,-1,844,299,1702,815,23,29.01
0,0,0,-0.0,-0.0,0.07929277420043945,276.0670208481991,52,-262,87,575,387,837,300,54,91.61
-2,2,0,-2.0,2.0,0.20730280876159668,273.5415873317986,52,-260,85,575,387,837,300,54,5.49
-5,4,0,-5.0,4.0,0.21535468101501465,267.5556016980396,52,-255,81,575,387,837,300,54,10.21
-7,4,0,-7.0,4.0,0.22335076332092285,259.67864756271354,52,-248,77,575,387,837,300,54,12.91
-9,5,0,-9.0,5.0,0.23314380645751953,249.6096953245206,52,-239,72,575,387,837,300,54,14.91
-10,4,0,-10.0,4.0,0.23933672904968262,238.88281646028875,52,-229,68,575,387,837,300,54,16.26
-13,4,0,-13.0,4.0,0.24731779098510742,225.28204544525957,52,-216,64,575,387,837,300,54,20.45
-15,4,0,-15.0,4.0,0.25700974464416504,209.7641532769601,52,-201,60,575,387,837,300,54,20.25
-14,3,0,-14.0,3.0,0.2635636329650879,195.49424543960367,52,-187,57,575,387,837,300,54,17.28
-15,2,0,-15.0,2.0,0.27280378341674805,180.5796223276591,52,-172,55,575,387,837,300,54,15.92
-14,1,0,-14.0,1.0,0.2793586254119873,166.97305171793442,52,-158,54,575,387,837,300,54,13.75
-13,1,0,-13.0,1.0,0.28729772567749023,154.38264151127873,52,-145,53,575,387,837,300,54,12.32
-12,2,0,-12.0,2.0,0.2953157424926758,142.44297104455524,52,-133,51,575,387,837,300,54,11.72
-13,2,0,-13.0,2.0,0.3033297061920166,129.61867149450345,52,-120,49,575,387,837,300,54,11.3
-11,2,0,-11.0,2.0,0.31130170822143555,118.70130580579136,52,-109,47,575,387,837,300,54,9.73
-11,1,0,-11.0,1.0,0.3207087516784668,108.25894882179486,52,-98,46,575,387,837,300,54,8.33
-10,2,0,-10.0,2.0,0.32741761207580566,98.38699100999075,52,-88,44,575,387,837,300,54,7.94
-8,2,0,-8.0,2.0,0.33578062057495117,90.35485598461214,52,-80,42,575,387,837,300,54,6.86
-8,3,0,-8.0,3.0,0.34328579902648926,81.88406438373708,52,-72,39,575,387,837,300,54,7.43
-6,2,0,-6.0,2.0,0.3523216247558594,75.66372975210778,52,-66,37,575,387,837,300,54,5.8
-6,2,0,-6.0,2.0,0.362959623336792,69.46221994724903,52,-60,35,575,387,837,300,54,5.43
-4,1,0,-4.0,1.0,0.36729979515075684,65.5133574166368,52,-56,34,575,387,837,300,54,3.93
-3,2,0,-3.0,2.0,0.3752915859222412,61.91122676865643,52,-53,32,575,387,837,300,54,6.19
-4,1,0,-4.0,1.0,0.3833646774291992,57.982756057296896,52,-49,31,575,387,837,300,54,3.62
-2,1,0,-2.0,1.0,0.3912956714630127,55.758407437802596,52,-47,30,575,387,837,300,54,4.54
-3,1,0,-3.0,1.0,0.3992776870727539,52.69724850502159,52,-44,29,575,387,837,300,54,3.5
-4,2,0,-4.0,2.0,0.4073026180267334,48.25971404805462,52,-40,27,575,387,837,300,54,4.71
-4,2,0,-4.0,2.0,0.4155588150024414,43.829214001622255,52,-36,25,575,387,837,300,54,4.43
-3,2,0,-3.0,2.0,0.4232766628265381,40.22437072223753,52,-33,23,575,387,837,300,54,6.43
-3,1,0,-3.0,1.0,0.4312906265258789,37.20215047547655,52,-30,22,575,387,837,300,54,2.82
-3,2,0,-3.0,2.0,0.4398336410522461,33.60059523282288,52,-27,20,575,387,837,300,54,5.26
-2,1,0,-2.0,1.0,0.44883179664611816,31.400636936215164,52,-25,19,575,387,837,300,54,3.24
-2,1,0,-2.0,1.0,0.4554767608642578,29.206163733020468,52,-23,18,575,387,837,300,54,3.08
-2,1,0,-2.0,1.0,0.46329665184020996,27.018512172212592,52,-21,17,575,387,837,300,54,2.91
-1,1,0,-1.0,1.0,0.47194576263427734,25.612496949731394,52,-20,16,575,387,837,300,54,3.73
-1,1,0,-1.0,1.0,0.4793276786804199,24.20743687382041,52,-19,15,575,387,837,300,54,3.62
-2,1,0,-2.0,1.0,0.4880506992340088,22.02271554554524,52,-17,14,575,387,837,300,54,2.68
0,0,1,-0.0,-0.0,0.4913787841796875,22.02271554554524,52,-17,14,575,387,592,373,54,33.519999999999996
-1,1,1,-1.0,1.0,0.003960371017456055,713.830512096534,53,-575,423,16,797,592,373,4,45.34
-1,1,1,-1.0,1.0,0.011548280715942383,712.4324529385225,53,-574,422,16,797,592,373,4,45.28
-2,0,1,-2.0,-0.0,0.019394397735595703,710.8220593087977,53,-572,422,16,797,592,373,4,47.8
0,1,1,-0.0,1.0,0.02898240089416504,710.2288363619151,53,-572,421,16,797,592,373,4,21.73
-1,0,1,-1.0,-0.0,0.03543424606323242,709.4237097813972,53,-571,421,16,797,592,373,4,28.46
-1,0,1,-1.0,-0.0,0.04340243339538574,708.6190796189445,53,-570,421,16,797,592,373,4,28.43
0,0,0,-0.0,-0.0,0.10738825798034668,708.6190796189445,53,-570,421,16,797,592,373,4,168.03
1,0,0,1.0,-0.0,0.17137527465820312,709.4237097813972,53,-571,421,16,797,592,373,4,39.68
2,1,0,2.0,1.0,0.17940044403076172,710.4428196554596,53,-573,420,16,797,592,373,4,32.45
3,1,0,3.0,1.0,0.18738937377929688,712.2759296789412,53,-576,419,16,797,592,373,4,20.22
4,1,0,4.0,1.0,0.19658637046813965,714.9293671405588,53,-580,418,16,797,592,373,4,14.87
4,2,0,4.0,2.0,0.20342040061950684,717.0160388722138,53,-584,416,16,797,592,373,4,17.98
3,2,0,3.0,2.0,0.21143841743469238,718.3070374150598,53,-587,414,16,797,592,373,4,26.86
3,2,0,3.0,2.0,0.22024941444396973,719.6137853043117,53,-590,412,16,797,592,373,4,26.63
4,3,0,4.0,3.0,0.22738242149353027,721.1913754337332,53,-594,409,16,797,592,373,4,22.71
4,4,0,4.0,4.0,0.23540544509887695,722.2388801497742,53,-598,405,16,797,592,373,4,31.7
2,5,0,2.0,5.0,0.24459338188171387,721.1102550927978,53,-600,400,16,797,592,373,4,36.18
2,6,0,2.0,6.0,0.2517073154449463,719.4720286432267,53,-602,394,16,797,592,373,4,47.65
0,5,0,-0.0,5.0,0.25950121879577637,716.7461196267476,53,-602,389,16,797,592,373,4,66.59
0,6,0,-0.0,6.0,0.2691383361816406,713.5075332468467,53,-602,383,16,797,592,373,4,73.2
-1,6,0,-1.0,6.0,0.27538228034973145,709.4575392509406,53,-601,377,16,797,592,373,4,82.18
-4,5,0,-4.0,5.0,0.2843663692474365,703.4152400964881,53,-597,372,16,797,592,373,4,98.84
-5,7,0,-5.0,7.0,0.2935452461242676,695.4775337852402,53,-592,365,16,797,592,373,4,107.98
-6,6,0,-6.0,6.0,0.2995772361755371,687.2241264682142,53,-586,359,16,797,592,373,4,109.27
-7,8,0,-7.0,8.0,0.3079402446746826,677.083451282041,53,-579,351,16,797,592,373,4,114.7
-8,10,0,-8.0,10.0,0.3175532817840576,665.0729283319237,53,-571,341,16,797,592,373,4,118.31
-13,11,0,-13.0,11.0,0.3234074115753174,648.2777182658679,53,-558,330,16,797,592,373,4,126.15
-12,11,0,-12.0,11.0,0.33182239532470703,632.3582845191482,53,-546,319,16,797,592,373,4,122.62
-15,12,0,-15.0,12.0,0.342623233795166,613.3596008867881,53,-531,307,16,797,592,373,4,124.66
-16,11,0,-16.0,11.0,0.3474414348602295,594.0042087392984,53,-515,296,16,797,592,373,4,123.33
-19,12,0,-19.0,12.0,0.35546231269836426,571.5522723251129,53,-496,284,16,797,592,373,4,123.87
-16,12,0,-16.0,12.0,0.3633763790130615,551.7100687861333,53,-480,272,16,797,592,373,4,117.56
-18,12,0,-18.0,12.0,0.371462345123291,530.1358316507195,53,-462,260,16,797,592,373,4,116.75
-15,11,0,-15.0,11.0,0.3793802261352539,511.67372416413957,53,-447,249,16,797,592,373,4,110.69
-18,13,0,-18.0,13.0,0.38738536834716797,489.6294517285495,53,-429,236,16,797,592,373,4,110.62
-18,13,0,-18.0,13.0,0.39634132385253906,467.6002566295275,53,-411,223,16,797,592,373,4,107.25
-19,12,0,-19.0,12.0,0.4033844470977783,445.1797389819083,53,-392,211,16,797,592,373,4,104.87
-17,10,0,-17.0,10.0,0.4115173816680908,425.4715031585547,53,-375,201,16,797,592,373,4,100.47
-15,10,0,-15.0,10.0,0.419452428817749,407.53036696668386,53,-360,191,16,797,592,373,4,95.05
-12,9,0,-12.0,9.0,0.4273712635040283,392.7187288632922,53,-348,182,16,797,592,373,4,88.84
-13,9,0,-13.0,9.0,0.4353952407836914,377.0331550407736,53,-335,173,16,797,592,373,4,87.71
-11,8,0,-11.0,8.0,0.44583845138549805,363.5945544146667,53,-324,165,16,797,592,373,4,82.65
-10,8,0,-10.0,8.0,0.4514904022216797,351.062672467467,53,-314,157,16,797,592,373,4,79.05
-11,7,0,-11.0,7.0,0.45944833755493164,338.0961401731762,53,-303,150,16,797,592,373,4,78.53
-11,7,0,-11.0,7.0,0.46736836433410645,325.13535642867265,53,-292,143,16,797,592,373,4,76.41
-13,8,0,-13.0,8.0,0.47540831565856934,309.94515643900615,53,-279,135,16,797,592,373,4,76.54
-12,8,0,-12.0,8.0,0.48383522033691406,295.6653513687392,53,-267,127,16,797,592,373,4,72.72
-14,8,0,-14.0,8.0,0.49350428581237793,279.58898404622454,53,-253,119,16,797,592,373,4,72.34
-12,7,0,-12.0,7.0,0.49951839447021484,265.75364531836624,53,-241,112,16,797,592,373,4,67.63
-11,6,0,-11.0,6.0,0.5073814392089844,253.25086376950424,53,-230,106,16,797,592,373,4,64.39
-10,6,0,-10.0,6.0,0.5154054164886475,241.66091947189145,53,-220,100,16,797,592,373,4,60.61
-9,5,0,-9.0,5.0,0.5241062641143799,231.40008643040736,53,-211,95,16,797,592,373,4,57.45
-8,5,0,-8.0,5.0,0.5313723087310791,222.05629916757596,53,-203,90,16,797,592,373,4,53.79
-9,4,0,-9.0,4.0,0.5393962860107422,212.20744567521658,53,-194,86,16,797,592,373,4,56.37
-8,5,0,-8.0,5.0,0.5474014282226562,202.87188075236054,53,-186,81,16,797,592,373,4,50.41
-8,5,0,-8.0,5.0,0.5592873096466064,193.54586019855861,53,-178,76,16,797,592,373,4,48.69
-9,4,0,-9.0,4.0,0.5638282299041748,183.69812192834198,53,-169,72,16,797,592,373,4,50.23
-8,4,0,-8.0,4.0,0.5716392993927002,174.77127910500627,53,-161,68,16,797,592,373,4,45.9
-7,3,0,-7.0,3.0,0.5830583572387695,167.1556161186336,53,-154,65,16,797,592,373,4,44.61
-6,4,0,-6.0,4.0,0.5882022380828857,160.0781059358212,53,-148,61,16,797,592,373,4,38.91
-7,3,0,-7.0,3.0,0.595374345779419,152.46311029229332,53,-141,58,16,797,592,373,4,41.46
-8,3,0,-8.0,3.0,0.6034152507781982,143.92359083902818,53,-133,55,16,797,592,373,4,40.48
-7,3,0,-7.0,3.0,0.6113872528076172,136.3084736911099,53,-126,52,16,797,592,373,4,38.64
-7,3,0,-7.0,3.0,0.6193654537200928,128.69343417595164,53,-119,49,16,797,592,373,4,37.21
-6,2,0,-6.0,2.0,0.62754225730896,122.38463955905577,53,-113,47,16,797,592,373,4,32.38
-6,3,0,-6.0,3.0,0.6354043483734131,115.69356075426151,53,-107,44,16,797,592,373,4,31.79
-6,2,0,-6.0,2.0,0.643376350402832,109.38464243210744,53,-101,42,16,797,592,373,4,30.1
-4,2,0,-4.0,2.0,0.6513724327087402,104.92378186092989,53,-97,40,16,797,592,373,4,25.89
-4,2,0,-4.0,2.0,0.659421443939209,100.46392387319938,53,-93,38,16,797,592,373,4,25.15
-3,2,0,-3.0,2.0,0.6676802635192871,96.93296652842108,53,-90,36,16,797,592,373,4,21.06
-4,2,0,-4.0,2.0,0.6761534214019775,92.47702417357513,53,-86,34,16,797,592,373,4,23.71
-4,3,0,-4.0,3.0,0.683375358581543,87.66413177577246,53,-82,31,16,797,592,373,4,22.05
-5,2,0,-5.0,2.0,0.6913852691650391,82.28000972289685,53,-77,29,16,797,592,373,4,25.31
-6,2,0,-6.0,2.0,0.6997673511505127,75.96051605933177,53,-71,27,16,797,592,373,4,24.67
-5,3,0,-5.0,3.0,0.707545280456543,70.22819946431775,53,-66,24,16,797,592,373,4,20.93
-6,2,0,-6.0,2.0,0.7163333892822266,63.90618123468183,53,-60,22,16,797,592,373,4,22.77
-5,2,0,-5.0,2.0,0.7233803272247314,58.52349955359813,53,-55,20,16,797,592,373,4,20.65
-5,3,0,-5.0,3.0,0.7319893836975098,52.81098370604357,53,-50,17,16,797,592,373,4,17.51
-5,2,0,-5.0,2.0,0.7397444248199463,47.43416490252569,53,-45,15,16,797,592,373,4,17.88
-5,2,0,-5.0,2.0,0.7496833801269531,42.05948168962618,53,-40,13,16,797,592,373,4,16.71
-4,2,0,-4.0,2.0,0.7557382583618164,37.64306044943742,53,-36,11,16,797,592,373,4,13.7
-4,1,0,-4.0,1.0,0.7642662525177002,33.52610922848042,53,-32,10,16,797,592,373,4,14.06
-2,2,0,-2.0,2.0,0.7733073234558105,31.04834939252005,53,-30,8,16,797,592,373,4,8.43
-1,0,0,-1.0,-0.0,0.7796094417572021,30.083217912982647,53,-29,8,16,797,592,373,4,6.02
-3,1,0,-3.0,1.0,0.7874252796173096,26.92582403567252,53,-26,7,16,797,592,373,4,11.83
-2,0,0,-2.0,-0.0,0.7968723773956299,25.0,53,-24,7,16,797,592,373,4,7.62
-1,1,0,-1.0,1.0,0.8035023212432861,23.769728648009426,53,-23,6,16,797,592,373,4,5.21
-2,1,0,-2.0,1.0,0.8113722801208496,21.587033144922902,53,-21,5,16,797,592,373,4,7.9
-1,1,0,-1.0,1.0,0.8196573257446289,20.396078054371138,53,-20,4,16,797,592,373,4,4.66
-2,0,0,-2.0,-0.0,0.8274023532867432,18.439088914585774,53,-18,4,16,797,592,373,4,7.21
-1,1,0,-1.0,1.0,0.8359313011169434,17.26267650163207,53,-17,3,16,797,592,373,4,4.27
-1,0,0,-1.0,-0.0,0.8434302806854248,16.278820596099706,53,-16,3,16,797,592,373,4,5.53
-1,0,0,-1.0,-0.0,0.8514902591705322,15.297058540778355,53,-15,3,16,797,592,373,4,5.36
-2,0,0,-2.0,-0.0,0.8674213886260986,13.341664064126334,53,-13,3,16,797,592,373,4,6.45
-1,1,0,-1.0,1.0,0.875434398651123,12.165525060596439,53,-12,2,16,797,592,373,4,3.7
-1,0,0,-1.0,-0.0,0.8838422298431396,11.180339887498949,53,-11,2,16,797,592,373,4,5.09
-1,1,0,-1.0,1.0,0.8914022445678711,10.04987562112089,53,-10,1,16,797,592,373,4,3.21
-2,0,0,-2.0,-0.0,0.8994002342224121,8.06225774829855,53,-8,1,16,797,592,373,4,6.46
-2,1,0,-2.0,1.0,0.9074442386627197,6.0,53,-6,0,16,797,592,373,4,4.22
-2,1,0,-2.0,1.0,0.9154033660888672,4.123105625617661,53,-4,-1,16,797,592,373,4,2.92
-1,0,0,-1.0,-0.0,0.923450231552124,3.1622776601683795,53,-3,-1,16,797,592,373,4,2.93
-1,0,0,-1.0,-0.0,0.9313693046569824,2.23606797749979,53,-2,-1,16,797,592,373,4,2.05
-1,0,0,-1.0,-0.0,1.0353822708129883,1.4142135623730951,53,-1,-1,16,797,592,373,4,0.74
0,0,1,-0.0,-0.0,1.10439133644104,1.4142135623730951,53,-1,-1,16,797,592,373,4,27.34
0,0,0,-0.0,-0.0,0.07796597480773926,867.7614879677479,54,837,229,854,1027,17,798,15,189.5
1,0,0,1.0,-0.0,0.1429448127746582,866.796977382824,54,836,229,854,1027,17,798,15,13.64
2,-1,0,2.0,-1.0,0.15089178085327148,865.1335157072577,54,834,230,854,1027,17,798,15,19.41
2,-1,0,2.0,-1.0,0.15920281410217285,863.4726399834566,54,832,231,854,1027,17,798,15,19.36
3,-2,0,3.0,-2.0,0.1668698787689209,861.1213619461545,54,829,233,854,1027,17,798,15,25.61
4,-2,0,4.0,-2.0,0.17490100860595703,857.8169968005997,54,825,235,854,1027,17,798,15,33.92
4,-2,0,4.0,-2.0,0.1831347942352295,854.5232588993701,54,821,237,854,1027,17,798,15,33.75
5,-2,0,5.0,-2.0,0.190903902053833,850.2805419389532,54,816,239,854,1027,17,798,15,41.1
6,-1,0,6.0,-1.0,0.19887995719909668,844.8076704197234,54,810,240,854,1027,17,798,15,49.9
6,-2,0,6.0,-2.0,0.20689082145690918,839.6308712761817,54,804,242,854,1027,17,798,15,47.37
8,-1,0,8.0,-1.0,0.21489882469177246,832.2649818417209,54,796,243,854,1027,17,798,15,60.6
11,-1,0,11.0,-1.0,0.222883939743042,822.0468356486751,54,785,244,854,1027,17,798,15,73.63
11,-1,0,11.0,-1.0,0.2308788299560547,811.8503556690728,54,774,245,854,1027,17,798,15,72.98
13,0,0,13.0,-0.0,0.23888087272644043,799.4660718254403,54,761,245,854,1027,17,798,15,80.89
14,0,0,14.0,-0.0,0.2468719482421875,786.1513849126006,54,747,245,854,1027,17,798,15,83.14
14,0,0,14.0,-0.0,0.2551419734954834,772.8609189239678,54,733,245,854,1027,17,798,15,82.19
16,0,0,16.0,-0.0,0.2628509998321533,757.7031080838985,54,717,245,854,1027,17,798,15,86.68
17,2,0,17.0,2.0,0.2708737850189209,740.9784072427482,54,700,243,854,1027,17,798,15,90.14
17,2,0,17.0,2.0,0.2789039611816406,724.2720483354303,54,683,241,854,1027,17,798,15,88.82
16,2,0,16.0,2.0,0.2869858741760254,708.5266402895519,54,667,239,854,1027,17,798,15,85.28
17,2,0,17.0,2.0,0.2948739528656006,691.8590896996295,54,650,237,854,1027,17,798,15,86.21
17,3,0,17.0,3.0,0.30289387702941895,674.8666534953405,54,633,234,854,1027,17,798,15,86.0
17,3,0,17.0,3.0,0.31146693229675293,657.8882883894499,54,616,231,854,1027,17,798,15,84.59
16,3,0,16.0,3.0,0.3188798427581787,641.8597977751839,54,600,228,854,1027,17,798,15,81.19
18,5,0,18.0,5.0,0.3268849849700928,623.2599778583573,54,582,223,854,1027,17,798,15,86.0
21,5,0,21.0,5.0,0.3349149227142334,601.8679257112809,54,561,218,854,1027,17,798,15,88.62
21,6,0,21.0,6.0,0.3428609371185303,580.1241246491995,54,540,212,854,1027,17,798,15,87.61
29,9,0,29.0,9.0,0.35100793838500977,549.8454328263534,54,511,203,854,1027,17,798,15,95.4
34,11,0,34.0,11.0,0.35904979705810547,514.1915985311311,54,477,192,854,1027,17,798,15,96.06
34,11,0,34.0,11.0,0.3691849708557129,478.5498929056405,54,443,181,854,1027,17,798,15,91.59
30,10,0,30.0,10.0,0.37488794326782227,447.0011185668331,54,413,171,854,1027,17,798,15,84.61
26,10,0,26.0,10.0,0.3829169273376465,419.15390967996467,54,387,161,854,1027,17,798,15,79.07
26,10,0,26.0,10.0,0.39085984230041504,391.3080627842979,54,361,151,854,1027,17,798,15,75.53
25,10,0,25.0,10.0,0.39904189109802246,364.38578457453576,54,336,141,854,1027,17,798,15,71.81
24,10,0,24.0,10.0,0.4068598747253418,338.3858744096745,54,312,131,854,1027,17,798,15,68.66
22,8,0,22.0,8.0,0.4186429977416992,315.0063491423625,54,290,123,854,1027,17,798,15,61.0
19,8,0,19.0,8.0,0.42300987243652344,294.3908965983833,54,271,115,854,1027,17,798,15,57.83
18,8,0,18.0,8.0,0.43123579025268555,274.69619582367716,54,253,107,854,1027,17,798,15,53.29
16,7,0,16.0,7.0,0.4389050006866455,257.2333570904054,54,237,100,854,1027,17,798,15,48.93
15,6,0,15.0,6.0,0.44699788093566895,241.0808992848666,54,222,94,854,1027,17,798,15,45.07
12,6,0,12.0,6.0,0.45557188987731934,227.69277546729498,54,210,88,854,1027,17,798,15,38.7
12,4,0,12.0,4.0,0.4628880023956299,215.08137994721903,54,198,84,854,1027,17,798,15,36.0
10,5,0,10.0,5.0,0.4709498882293701,203.92400545301183,54,188,79,854,1027,17,798,15,32.96
10,3,0,10.0,3.0,0.4788668155670166,193.54586019855861,54,178,76,854,1027,17,798,15,30.04
8,3,0,8.0,3.0,0.48709583282470703,185.0108104949546,54,170,73,854,1027,17,798,15,27.35
6,2,0,6.0,2.0,0.4948887825012207,178.70926109186397,54,164,71,854,1027,17,798,15,21.99
5,2,0,5.0,2.0,0.5056688785552979,173.32628190785147,54,159,69,854,1027,17,798,15,20.94
5,2,0,5.0,2.0,0.5108718872070312,167.94344286098223,54,154,67,854,1027,17,798,15,20.53
4,2,0,4.0,2.0,0.5189528465270996,163.47782724271815,54,150,65,854,1027,17,798,15,17.6
4,2,0,4.0,2.0,0.5268678665161133,159.0125781188394,54,146,63,854,1027,17,798,15,17.3
3,1,0,3.0,1.0,0.5348680019378662,155.8621185535472,54,143,62,854,1027,17,798,15,13.53
4,1,0,4.0,1.0,0.5448398590087891,151.79591562357663,54,139,61,854,1027,17,798,15,14.61
3,2,0,3.0,2.0,0.5514328479766846,148.24641648282767,54,136,59,854,1027,17,798,15,13.18
3,1,0,3.0,1.0,0.5595510005950928,145.09651959988565,54,133,58,854,1027,17,798,15,12.99
3,1,0,3.0,1.0,0.5682539939880371,141.94717327231282,54,130,57,854,1027,17,798,15,12.81
2,0,0,2.0,-0.0,0.574894905090332,140.11780757633915,54,128,57,854,1027,17,798,15,7.44
1,0,0,1.0,-0.0,0.5828878879547119,139.20488497175666,54,127,57,854,1027,17,798,15,4.85
1,1,0,1.0,1.0,0.59232497215271,137.88400922514546,54,126,56,854,1027,17,798,15,6.18
1,0,0,1.0,-0.0,0.5988647937774658,136.97079980784227,54,125,56,854,1027,17,798,15,4.81
1,1,0,1.0,1.0,0.6073129177093506,135.6502856613284,54,124,55,854,1027,17,798,15,6.13
1,1,0,1.0,1.0,0.6158459186553955,134.33167906342868,54,123,54,854,1027,17,798,15,6.08
2,2,0,2.0,2.0,0.6228969097137451,131.70041761513136,54,121,52,854,1027,17,798,15,9.25
2,1,0,2.0,1.0,0.630875825881958,129.46814279968643,54,119,51,854,1027,17,798,15,10.65
4,2,0,4.0,2.0,0.6388537883758545,125.00399993600205,54,115,49,854,1027,17,798,15,15.03
4,3,0,4.0,3.0,0.6468799114227295,120.15406776301833,54,111,46,854,1027,17,798,15,13.53
5,3,0,5.0,3.0,0.6550068855285645,114.38968484964018,54,106,43,854,1027,17,798,15,15.19
5,2,0,5.0,2.0,0.6629509925842285,109.00458705944443,54,101,41,854,1027,17,798,15,17.47
4,2,0,4.0,2.0,0.6708698272705078,104.546640309481,54,97,39,854,1027,17,798,15,13.29
5,3,0,5.0,3.0,0.6788928508758545,98.79271228182775,54,92,36,854,1027,17,798,15,13.77
6,4,0,6.0,4.0,0.6869239807128906,91.76055797563569,54,86,32,854,1027,17,798,15,14.22
6,3,0,6.0,3.0,0.694911003112793,85.09406559801923,54,80,29,854,1027,17,798,15,14.12
5,3,0,5.0,3.0,0.7029237747192383,79.37883848986453,54,75,26,854,1027,17,798,15,11.77
5,4,0,5.0,4.0,0.717350959777832,73.37574531137656,54,70,22,854,1027,17,798,15,10.71
5,2,0,5.0,2.0,0.7201178073883057,68.00735254367721,54,65,20,854,1027,17,798,15,11.64
4,2,0,4.0,2.0,0.7297167778015137,63.60031446463138,54,61,18,854,1027,17,798,15,9.26
4,2,0,4.0,2.0,0.7349598407745361,59.20304046246274,54,57,16,854,1027,17,798,15,8.81
4,2,0,4.0,2.0,0.7428898811340332,54.817880294662984,54,53,14,854,1027,17,798,15,8.35
5,1,0,5.0,1.0,0.7530019283294678,49.72926703662542,54,48,13,854,1027,17,798,15,10.05
3,2,0,3.0,2.0,0.7592098712921143,46.32493928760188,54,45,11,854,1027,17,798,15,6.06
4,1,0,4.0,1.0,0.7669048309326172,42.20189569201838,54,41,10,854,1027,17,798,15,10.94
3,2,0,3.0,2.0,0.7748417854309082,38.8329756778952,54,38,8,854,1027,17,798,15,5.39
2,0,0,2.0,-0.0,0.7829258441925049,36.87817782917155,54,36,8,854,1027,17,798,15,4.84
1,0,0,1.0,-0.0,0.7908909320831299,35.90264614203248,54,35,8,854,1027,17,798,15,3.85
2,1,0,2.0,1.0,0.7997689247131348,33.734255586866,54,33,7,854,1027,17,798,15,4.66
1,1,0,1.0,1.0,0.8069028854370117,32.55764119219941,54,32,6,854,1027,17,798,15,2.53
3,1,0,3.0,1.0,0.8165459632873535,29.427877939124322,54,29,5,854,1027,17,798,15,5.84
1,0,0,1.0,-0.0,0.8237829208374023,28.442925306655784,54,28,5,854,1027,17,798,15,3.98
2,1,0,2.0,1.0,0.8308990001678467,26.30589287593181,54,26,4,854,1027,17,798,15,3.95
2,0,0,2.0,-0.0,0.8395719528198242,24.331050121192877,54,24,4,854,1027,17,798,15,4.61
2,1,0,2.0,1.0,0.8468539714813232,22.20360331117452,54,22,3,854,1027,17,798,15,3.61
1,0,0,1.0,-0.0,0.8567438125610352,21.213203435596427,54,21,3,854,1027,17,798,15,4.04
2,0,0,2.0,-0.0,0.8651049137115479,19.235384061671343,54,19,3,854,1027,17,798,15,4.38
1,0,0,1.0,-0.0,0.8709859848022461,18.24828759089466,54,18,3,854,1027,17,798,15,3.72
1,1,0,1.0,1.0,0.8792998790740967,17.11724276862369,54,17,2,854,1027,17,798,15,1.72
1,0,0,1.0,-0.0,0.8949778079986572,16.1245154965971,54,16,2,854,1027,17,798,15,4.01
1,0,0,1.0,-0.0,0.902885913848877,15.132745950421556,54,15,2,854,1027,17,798,15,3.88
1,0,0,1.0,-0.0,0.9269309043884277,14.142135623730951,54,14,2,854,1027,17,798,15,3.74
1,0,0,1.0,-0.0,0.9348819255828857,13.152946437965905,54,13,2,854,1027,17,798,15,3.59
0,1,0,-0.0,1.0,0.9428629875183105,13.038404810405298,54,13,1,854,1027,17,798,15,-0.22
1,0,0,1.0,-0.0,0.951225996017456,12.041594578792296,54,12,1,854,1027,17,798,15,4.33
1,0,0,1.0,-0.0,0.9591898918151855,11.045361017187261,54,11,1,854,1027,17,798,15,4.16
1,0,0,1.0,-0.0,0.966871976852417,10.04987562112089,54,10,1,854,1027,17,798,15,3.96
1,0,0,1.0,-0.0,0.9749128818511963,9.055385138137417,54,9,1,854,1027,17,798,15,3.75
1,0,0,1.0,-0.0,0.9908678531646729,8.06225774829855,54,8,1,854,1027,17,798,15,3.51
1,0,0,1.0,-0.0,1.0068538188934326,7.0710678118654755,54,7,1,854,1027,17,798,15,3.23
0,0,1,-0.0,-0.0,-0.003879070281982422,423.9257010373398,55,312,-287,1159,739,847,1026,23,121.71
0,0,0,-0.0,-0.0,0.11010098457336426,423.9257010373398,55,312,-287,1159,739,847,1026,23,121.71
1,0,0,1.0,-0.0,0.17412090301513672,423.19026453830435,55,311,-287,1159,739,847,1026,23,4.73
1,0,0,1.0,-0.0,0.18216180801391602,422.4559148597638,55,310,-287,1159,739,847,1026,23,4.72
1,0,0,1.0,-0.0,0.1900959014892578,421.7226576791909,55,309,-287,1159,739,847,1026,23,4.7
1,0,0,1.0,-0.0,0.20638680458068848,420.99049870513704,55,308,-287,1159,739,847,1026,23,4.69
1,0,0,1.0,-0.0,0.21411585807800293,420.2594436773551,55,307,-287,1159,739,847,1026,23,4.68
1,0,0,1.0,-0.0,0.22231197357177734,419.52949836692056,55,306,-287,1159,739,847,1026,23,4.67
2,-1,0,2.0,-1.0,0.23023390769958496,417.3871104861768,55,304,-286,1159,739,847,1026,23,12.14
3,-1,0,3.0,-1.0,0.2419588565826416,414.5189983583382,55,301,-285,1159,739,847,1026,23,14.42
3,-3,0,3.0,-3.0,0.2462937831878662,410.2779545625136,55,298,-282,1159,739,847,1026,23,22.71
3,-2,0,3.0,-2.0,0.25425100326538086,406.7247226319049,55,295,-280,1159,739,847,1026,23,18.07
4,-5,0,4.0,-5.0,0.2662849426269531,400.38231729186043,55,291,-275,1159,739,847,1026,23,27.22
6,-6,0,6.0,-6.0,0.2704458236694336,391.9004975755964,55,285,-269,1159,739,847,1026,23,34.44
7,-9,0,7.0,-9.0,0.27811384201049805,380.63630935579437,55,278,-260,1159,739,847,1026,23,38.12
8,-10,0,8.0,-10.0,0.2861049175262451,367.96738985948195,55,270,-250,1159,739,847,1026,23,40.09
12,-13,0,12.0,-13.0,0.2942068576812744,350.33269901623515,55,258,-237,1159,739,847,1026,23,47.41
14,-15,0,14.0,-15.0,0.3081638813018799,329.8787656094281,55,244,-222,1159,739,847,1026,23,49.07
19,-18,0,19.0,-18.0,0.31010890007019043,303.71203466441693,55,225,-204,1159,739,847,1026,23,53.43
21,-18,0,21.0,-18.0,0.32231879234313965,276.06520968785617,55,204,-186,1159,739,847,1026,23,50.95
22,-15,0,22.0,-15.0,0.32613587379455566,249.7298540423231,55,182,-171,1159,739,847,1026,23,44.66
20,-13,0,20.0,-13.0,0.3345329761505127,226.29184695874486,55,162,-158,1159,739,847,1026,23,39.28
20,-12,0,20.0,-12.0,0.3420889377593994,203.66639388961548,55,142,-146,1159,739,847,1026,23,35.47
17,-11,0,17.0,-11.0,0.3501288890838623,183.98369492974098,55,125,-135,1159,739,847,1026,23,30.91
16,-12,0,16.0,-12.0,0.35813283920288086,164.34719346554112,55,109,-123,1159,739,847,1026,23,28.77
15,-12,0,15.0,-12.0,0.36611390113830566,145.45446022724775,55,94,-111,1159,739,847,1026,23,25.96
15,-12,0,15.0,-12.0,0.374114990234375,126.65701717630967,55,79,-99,1159,739,847,1026,23,23.3
15,-9,0,15.0,-9.0,0.382382869720459,110.43550153822818,55,64,-90,1159,739,847,1026,23,18.81
12,-10,0,12.0,-10.0,0.39386987686157227,95.4148835350125,55,52,-80,1159,739,847,1026,23,16.73
12,-9,0,12.0,-9.0,0.39880895614624023,81.49233092751734,55,40,-71,1159,739,847,1026,23,13.96
10,-8,0,10.0,-8.0,0.4062190055847168,69.77822009767804,55,30,-63,1159,739,847,1026,23,11.28
8,-8,0,8.0,-8.0,0.4160017967224121,59.23681287847955,55,22,-55,1159,739,847,1026,23,9.68
8,-7,0,8.0,-7.0,0.4225490093231201,50.0,55,14,-48,1159,739,847,1026,23,7.55
7,-6,0,7.0,-6.0,0.4301319122314453,42.579337712087536,55,7,-42,1159,739,847,1026,23,5.62
7,-6,0,7.0,-6.0,0.44376587867736816,36.0,55,0,-36,1159,739,847,1026,23,4.26
6,-6,0,6.0,-6.0,0.4461188316345215,30.59411708155671,55,-6,-30,1159,739,847,1026,23,3.04
6,-5,0,6.0,-5.0,0.45411086082458496,27.730849247724095,55,-12,-25,1159,739,847,1026,23,1.02
6,-4,0,6.0,-4.0,0.46285080909729004,27.65863337187866,55,-18,-21,1159,739,847,1026,23,-1.16
5,-4,0,5.0,-4.0,0.4705159664154053,28.600699292150182,55,-23,-17,1159,739,847,1026,23,-0.29
4,-3,0,4.0,-3.0,0.47811198234558105,30.4138126514911,55,-27,-14,1159,739,847,1026,23,-0.27
5,-3,0,5.0,-3.0,0.48615097999572754,33.83784863137726,55,-32,-11,1159,739,847,1026,23,-0.27
4,-2,0,4.0,-2.0,0.49410200119018555,37.107950630558946,55,-36,-9,1159,739,847,1026,23,0.34
2,-2,0,2.0,-2.0,0.502126932144165,38.63935817272331,55,-38,-7,1159,739,847,1026,23,0.66
2,-2,0,2.0,-2.0,0.5114908218383789,40.311288741492746,55,-40,-5,1159,739,847,1026,23,0.73
1,-2,0,1.0,-2.0,0.5181868076324463,41.10960958218893,55,-41,-3,1159,739,847,1026,23,1.16
2,-2,0,2.0,-2.0,0.5261387825012207,43.01162633521314,55,-43,-1,1159,739,847,1026,23,0.87
1,-1,0,1.0,-1.0,0.5341358184814453,44.0,55,-44,0,1159,739,847,1026,23,1.72
0,-2,0,-0.0,-2.0,0.5421078205108643,44.04543109109048,55,-44,2,1159,739,847,1026,23,11.32
1,0,0,1.0,-0.0,0.550102949142456,45.044422518220834,55,-45,2,1159,739,847,1026,23,5.58
0,-2,0,-0.0,-2.0,0.5582578182220459,45.17742799230607,55,-45,4,1159,739,847,1026,23,5.71
-1,0,0,-1.0,-0.0,0.598181962966919,44.181444068749045,55,-44,4,1159,739,847,1026,23,4.77
-1,0,0,-1.0,-0.0,0.60617995262146,43.18564576337837,55,-43,4,1159,739,847,1026,23,4.73
-1,0,0,-1.0,-0.0,0.6172158718109131,42.190046219457976,55,-42,4,1159,739,847,1026,23,4.68
-2,0,0,-2.0,-0.0,0.6221709251403809,40.19950248448356,55,-40,4,1159,739,847,1026,23,5.24
-2,-1,0,-2.0,-1.0,0.6301169395446777,38.3275357934736,55,-38,5,1159,739,847,1026,23,2.61
-2,0,0,-2.0,-0.0,0.638110876083374,36.345563690772494,55,-36,5,1159,739,847,1026,23,4.67
-1,-1,0,-1.0,-1.0,0.6461379528045654,35.510561809129406,55,-35,6,1159,739,847,1026,23,1.21
-1,0,0,-1.0,-0.0,0.6546227931976318,34.52535300326414,55,-34,6,1159,739,847,1026,23,3.74
-1,0,0,-1.0,-0.0,0.6651709079742432,33.54101966249684,55,-33,6,1159,739,847,1026,23,3.68
-2,-1,0,-2.0,-1.0,0.6701288223266602,31.78049716414141,55,-31,7,1159,739,847,1026,23,2.1
-1,0,0,-1.0,-0.0,0.6784348487854004,30.805843601498726,55,-30,7,1159,739,847,1026,23,3.28
-1,0,0,-1.0,-0.0,0.6895489692687988,29.832867780352597,55,-29,7,1159,739,847,1026,23,3.22
-1,0,0,-1.0,-0.0,0.6941499710083008,28.861739379323623,55,-28,7,1159,739,847,1026,23,3.15
-1,0,0,-1.0,-0.0,0.7066938877105713,27.892651361962706,55,-27,7,1159,739,847,1026,23,3.08
-2,0,0,-2.0,-0.0,0.7101278305053711,25.96150997149434,55,-25,7,1159,739,847,1026,23,3.31
-2,0,0,-2.0,-0.0,0.7185277938842773,24.041630560342615,55,-23,7,1159,739,847,1026,23,3.11
-3,0,0,-3.0,-0.0,0.7261459827423096,21.18962010041709,55,-20,7,1159,739,847,1026,23,3.1
-3,0,0,-3.0,-0.0,0.7341468334197998,18.384776310850235,55,-17,7,1159,739,847,1026,23,2.68
-3,1,0,-3.0,1.0,0.7429409027099609,15.231546211727817,55,-14,6,1159,739,847,1026,23,4.71
-2,1,0,-2.0,1.0,0.7501089572906494,13.0,55,-12,5,1159,739,847,1026,23,4.55
-2,1,0,-2.0,1.0,0.7581329345703125,10.770329614269007,55,-10,4,1159,739,847,1026,23,4.12
-2,0,0,-2.0,-0.0,0.7661118507385254,8.94427190999916,55,-8,4,1159,739,847,1026,23,1.46
-2,1,0,-2.0,1.0,0.7741219997406006,6.708203932499369,55,-6,3,1159,739,847,1026,23,7.73
-1,1,0,-1.0,1.0,0.7821159362792969,5.385164807134504,55,-5,2,1159,739,847,1026,23,1.22
-1,1,0,-1.0,1.0,0.7901148796081543,4.123105625617661,55,-4,1,1159,739,847,1026,23,0.57
-1,0,0,-1.0,-0.0,0.7981209754943848,3.1622776601683795,55,-3,1,1159,739,847,1026,23,1.21
0,1,0,-0.0,1.0,0.8062808513641357,3.0,55,-3,0,1159,739,847,1026,23,-1.28
0,0,1,-0.0,-0.0,0.8401079177856445,3.0,55,-3,0,1159,739,847,1026,23,27.81
0,0,0,-0.0,-0.0,0.09287714958190918,759.2950678096098,56,-752,105,410,844,1162,739,27,175.14
-1,0,0,-1.0,-0.0,0.18186211585998535,758.3046881036672,56,-751,105,410,844,1162,739,27,9.42
-2,2,0,-2.0,2.0,0.18992924690246582,756.0489402148514,56,-749,103,410,844,1162,739,27,14.3
-3,1,0,-3.0,1.0,0.19788408279418945,752.9409007352436,56,-746,102,410,844,1162,739,27,20.36
-3,2,0,-3.0,2.0,0.2065742015838623,749.6992730421979,56,-743,100,410,844,1162,739,27,19.75
-5,1,0,-5.0,1.0,0.2138662338256836,744.61063650743,56,-738,99,410,844,1162,739,27,30.75
-6,3,0,-6.0,3.0,0.22185921669006348,738.2682439330572,56,-732,96,410,844,1162,739,27,33.71
-9,3,0,-9.0,3.0,0.2298600673675537,728.9567888427955,56,-723,93,410,844,1162,739,27,45.03
-12,2,0,-12.0,2.0,0.23960113525390625,716.7998325892662,56,-711,91,410,844,1162,739,27,55.31
-17,3,0,-17.0,3.0,0.24809622764587402,699.5570026809824,56,-694,88,410,844,1162,739,27,66.9
-18,4,0,-18.0,4.0,0.25446009635925293,681.1989430408711,56,-676,84,410,844,1162,739,27,67.4
-19,4,0,-19.0,4.0,0.2653062343597412,661.8527026461402,56,-657,80,410,844,1162,739,27,68.31
-21,3,0,-21.0,3.0,0.26986217498779297,640.6442070291434,56,-636,77,410,844,1162,739,27,71.87
-23,4,0,-23.0,4.0,0.2778911590576172,617.3313534885459,56,-613,73,410,844,1162,739,27,72.79
-26,2,0,-26.0,2.0,0.28692007064819336,591.278276279452,56,-587,71,410,844,1162,739,27,75.08
-28,2,0,-28.0,2.0,0.2938532829284668,563.2423989722365,56,-559,69,410,844,1162,739,27,75.2
-28,3,0,-28.0,3.0,0.30226707458496094,535.0859744003761,56,-531,66,410,844,1162,739,27,74.1
-28,1,0,-28.0,1.0,0.30989909172058105,507.1824129442976,56,-503,65,410,844,1162,739,27,69.53
-25,3,0,-25.0,3.0,0.3178691864013672,482.0041493597332,56,-478,62,410,844,1162,739,27,66.39
-23,2,0,-23.0,2.0,0.3260202407836914,458.93899376714546,56,-455,60,410,844,1162,739,27,60.39
-21,2,0,-21.0,2.0,0.3343982696533203,437.85842460777206,56,-434,58,410,844,1162,739,27,56.2
-19,2,0,-19.0,2.0,0.3418440818786621,418.76126850509945,56,-415,56,410,844,1162,739,27,52.18
-16,1,0,-16.0,1.0,0.34990906715393066,402.772888859218,56,-399,55,410,844,1162,739,27,45.2
-16,2,0,-16.0,2.0,0.35789918899536133,386.6497122719736,56,-383,53,410,844,1162,739,27,45.99
-15,0,0,-15.0,-0.0,0.3658871650695801,371.79698761555346,56,-368,53,410,844,1162,739,27,40.34
-17,1,0,-17.0,1.0,0.3739612102508545,354.8309456628607,56,-351,52,410,844,1162,739,27,42.85
-16,1,0,-16.0,1.0,0.3818631172180176,338.85985303662045,56,-335,51,410,844,1162,739,27,40.19
-17,1,0,-17.0,1.0,0.3903772830963135,321.9068188156318,56,-318,50,410,844,1162,739,27,40.06
-16,1,0,-16.0,1.0,0.39788222312927246,305.94934221207274,56,-302,49,410,844,1162,739,27,37.44
-17,0,0,-17.0,-0.0,0.40587806701660156,289.1816038409082,56,-285,49,410,844,1162,739,27,36.34
-15,0,0,-15.0,-0.0,0.4139132499694824,274.4102767754881,56,-270,49,410,844,1162,739,27,32.55
-14,1,0,-14.0,1.0,0.4221000671386719,260.4611295375953,56,-256,48,410,844,1162,739,27,30.99
-13,1,0,-13.0,1.0,0.4298672676086426,247.50353532828578,56,-243,47,410,844,1162,739,27,28.7
-13,0,0,-13.0,-0.0,0.4378831386566162,234.75306174787156,56,-230,47,410,844,1162,739,27,26.69
-14,0,0,-14.0,-0.0,0.4464101791381836,221.05429197371402,56,-216,47,410,844,1162,739,27,26.64
-14,-1,0,-14.0,-1.0,0.4538571834564209,207.62466134830902,56,-202,48,410,844,1162,739,27,24.73
-13,0,0,-13.0,-0.0,0.46185827255249023,195.0,56,-189,48,410,844,1162,739,27,23.08
-13,0,0,-13.0,-0.0,0.46986818313598633,182.42806801586207,56,-176,48,410,844,1162,739,27,21.89
-11,0,0,-11.0,-0.0,0.4782071113586426,171.84004189943624,56,-165,48,410,844,1162,739,27,18.83
-10,0,0,-10.0,-0.0,0.4858541488647461,162.2621335986927,56,-155,48,410,844,1162,739,27,16.92
-9,1,0,-9.0,1.0,0.4958810806274414,153.37861650177967,56,-146,47,410,844,1162,739,27,16.09
-8,1,0,-8.0,1.0,0.5018801689147949,145.46477236774544,56,-138,46,410,844,1162,739,27,14.51
-7,0,0,-7.0,-0.0,0.5099902153015137,138.84163640637487,56,-131,46,410,844,1162,739,27,11.89
-7,1,0,-7.0,1.0,0.5178780555725098,131.91285001848757,56,-124,45,410,844,1162,739,27,12.52
-6,1,0,-6.0,1.0,0.5258932113647461,125.93649193144932,56,-118,44,410,844,1162,739,27,11.23
-5,1,0,-5.0,1.0,0.5338630676269531,120.90492132250036,56,-113,43,410,844,1162,739,27,10.1
-6,1,0,-6.0,1.0,0.5418450832366943,114.94781424629178,56,-107,42,410,844,1162,739,27,10.5
-6,1,0,-6.0,1.0,0.5498602390289307,109.00458705944443,56,-101,41,410,844,1162,739,27,10.08
-5,1,0,-5.0,1.0,0.5595800876617432,104.0,56,-96,40,410,844,1162,739,27,9.03
-6,2,0,-6.0,2.0,0.5658631324768066,97.6933979345585,56,-90,38,410,844,1162,739,27,11.17
-6,1,0,-6.0,1.0,0.5738492012023926,91.7877987534291,56,-84,37,410,844,1162,739,27,8.91
-5,2,0,-5.0,2.0,0.5818390846252441,86.4060183089118,56,-79,35,410,844,1162,739,27,10.61
-5,1,0,-5.0,1.0,0.5899221897125244,81.43709228600933,56,-74,34,410,844,1162,739,27,7.64
-4,2,0,-4.0,2.0,0.5978960990905762,76.96752561957543,56,-70,32,410,844,1162,739,27,9.41
-5,2,0,-5.0,2.0,0.6058552265167236,71.58910531638176,56,-65,30,410,844,1162,739,27,9.4
-5,2,0,-5.0,2.0,0.6140820980072021,66.2117814289874,56,-60,28,410,844,1162,739,27,9.01
-6,2,0,-6.0,2.0,0.6218791007995605,59.93329625508679,56,-54,26,410,844,1162,739,27,8.15
-6,3,0,-6.0,3.0,0.6299231052398682,53.225933528685054,56,-48,23,410,844,1162,739,27,10.35
-6,3,0,-6.0,3.0,0.6379151344299316,46.51881339845203,56,-42,20,410,844,1162,739,27,9.75
-7,2,0,-7.0,2.0,0.6459140777587891,39.35733730830886,56,-35,18,410,844,1162,739,27,6.48
-4,3,0,-4.0,3.0,0.6538741588592529,34.438350715445125,56,-31,15,410,844,1162,739,27,5.21
-5,3,0,-5.0,3.0,0.6624791622161865,28.635642126552707,56,-26,12,410,844,1162,739,27,5.93
-5,2,0,-5.0,2.0,0.670485258102417,23.259406699226016,56,-21,10,410,844,1162,739,27,6.07
-2,2,0,-2.0,2.0,0.6778991222381592,20.615528128088304,56,-19,8,410,844,1162,739,27,2.56
-3,2,0,-3.0,2.0,0.685859203338623,17.08800749063506,56,-16,6,410,844,1162,739,27,3.31
-3,1,0,-3.0,1.0,0.694101095199585,13.92838827718412,56,-13,5,410,844,1162,739,27,5.17
-2,2,0,-2.0,2.0,0.7018382549285889,11.40175425099138,56,-11,3,410,844,1162,739,27,1.44
-2,1,0,-2.0,1.0,0.7098791599273682,9.219544457292887,56,-9,2,410,844,1162,739,27,2.31
-1,1,0,-1.0,1.0,0.7178502082824707,8.06225774829855,56,-8,1,410,844,1162,739,27,0.71
-1,1,0,-1.0,1.0,0.7258532047271729,7.0,56,-7,0,410,844,1162,739,27,0.33
0,1,0,-0.0,1.0,0.7338621616363525,7.0710678118654755,56,-7,-1,410,844,1162,739,27,3.45
-1,0,0,-1.0,-0.0,0.7419202327728271,6.082762530298219,56,-6,-1,410,844,1162,739,27,2.58
0,0,1,-0.0,-0.0,0.7928850650787354,6.082762530298219,56,-6,-1,410,844,1162,739,27,28.72
0,0,0,-0.0,-0.0,0.09782242774963379,851.5409561494972,57,801,-289,1217,556,416,845,33,187.42
2,0,0,2.0,-0.0,0.12187838554382324,849.6599319727864,57,799,-289,1217,556,416,845,33,11.97
3,0,0,3.0,-0.0,0.1348254680633545,846.8394180716908,57,796,-289,1217,556,416,845,33,16.4
3,-1,0,3.0,-1.0,0.13779950141906738,843.6782562090835,57,793,-288,1217,556,416,845,33,20.99
4,0,0,4.0,-0.0,0.1457815170288086,839.9196390131618,57,789,-288,1217,556,416,845,33,20.52
4,-1,0,4.0,-1.0,0.15380644798278809,835.8193584740665,57,785,-287,1217,556,416,845,33,23.53
5,-1,0,5.0,-1.0,0.16179442405700684,830.7803560508638,57,780,-286,1217,556,416,845,33,26.87
7,0,0,7.0,-0.0,0.16976141929626465,824.2117446384758,57,773,-286,1217,556,416,845,33,31.55
7,-1,0,7.0,-1.0,0.17778849601745605,817.3010461268235,57,766,-285,1217,556,416,845,33,33.34
7,-1,0,7.0,-1.0,0.1861894130706787,810.3931144821012,57,759,-284,1217,556,416,845,33,33.16
10,-2,0,10.0,-2.0,0.19422554969787598,800.3280577363261,57,749,-282,1217,556,416,845,33,43.82
12,-2,0,12.0,-2.0,0.20178747177124023,788.396473863246,57,737,-280,1217,556,416,845,33,48.65
15,-2,0,15.0,-2.0,0.2097914218902588,773.6717650270042,57,722,-278,1217,556,416,845,33,55.17
16,-3,0,16.0,-3.0,0.21896052360534668,757.6681331559353,57,706,-275,1217,556,416,845,33,57.83
22,-2,0,22.0,-2.0,0.22579240798950195,736.4679219083476,57,684,-273,1217,556,416,845,33,66.86
25,-4,0,25.0,-4.0,0.2339644432067871,711.7878897536822,57,659,-269,1217,556,416,845,33,71.71
27,-4,0,27.0,-4.0,0.24208855628967285,685.3094191677217,57,632,-265,1217,556,416,845,33,72.65
26,-4,0,26.0,-4.0,0.24979043006896973,659.81588340991,57,606,-261,1217,556,416,845,33,69.51
25,-5,0,25.0,-5.0,0.25786352157592773,634.8992045986512,57,581,-256,1217,556,416,845,33,67.24
23,-7,0,23.0,-7.0,0.2657754421234131,611.0360054857651,57,558,-249,1217,556,416,845,33,64.87
24,-9,0,24.0,-9.0,0.2737843990325928,585.4536702421465,57,534,-240,1217,556,416,845,33,66.42
22,-9,0,22.0,-9.0,0.2818593978881836,561.6983176047441,57,512,-231,1217,556,416,845,33,62.91
21,-10,0,21.0,-10.0,0.28986644744873047,538.4440546612062,57,491,-221,1217,556,416,845,33,61.1
24,-11,0,24.0,-11.0,0.3009023666381836,512.0439434267337,57,467,-210,1217,556,416,845,33,64.09
24,-11,0,24.0,-11.0,0.30579137802124023,485.64390246352315,57,443,-199,1217,556,416,845,33,62.02
29,-14,0,29.0,-14.0,0.314272403717041,453.45451811620535,57,414,-185,1217,556,416,845,33,64.25
29,-15,0,29.0,-15.0,0.3247065544128418,420.86221023037933,57,385,-170,1217,556,416,845,33,60.77
28,-13,0,28.0,-13.0,0.32981443405151367,389.99743588900685,57,357,-157,1217,556,416,845,33,57.58
26,-12,0,26.0,-12.0,0.33779144287109375,361.3668496140729,57,331,-145,1217,556,416,845,33,52.97
24,-11,0,24.0,-11.0,0.34941744804382324,334.970147923662,57,307,-134,1217,556,416,845,33,48.57
21,-11,0,21.0,-11.0,0.35379552841186523,311.3278015211619,57,286,-123,1217,556,416,845,33,42.29
19,-12,0,19.0,-12.0,0.3618924617767334,289.15393824051574,57,267,-111,1217,556,416,845,33,37.87
15,-11,0,15.0,-11.0,0.36976051330566406,271.1162112452887,57,252,-100,1217,556,416,845,33,31.7
12,-11,0,12.0,-11.0,0.37787556648254395,255.9707014484275,57,240,-89,1217,556,416,845,33,26.82
11,-9,0,11.0,-9.0,0.385791540145874,242.5716389028198,57,229,-80,1217,556,416,845,33,24.02
9,-9,0,9.0,-9.0,0.3937954902648926,231.1730953203681,57,220,-71,1217,556,416,845,33,20.47
8,-7,0,8.0,-7.0,0.40195655822753906,221.44976857066254,57,212,-64,1217,556,416,845,33,17.96
8,-8,0,8.0,-8.0,0.41070556640625,211.54668515483763,57,204,-56,1217,556,416,845,33,17.33
7,-6,0,7.0,-6.0,0.4178633689880371,203.24615617521528,57,197,-50,1217,556,416,845,33,15.06
8,-5,0,8.0,-5.0,0.4258115291595459,194.28329830430613,57,189,-45,1217,556,416,845,33,15.9
6,-4,0,6.0,-4.0,0.43502354621887207,187.5366630821824,57,183,-41,1217,556,416,845,33,12.64
6,-4,0,6.0,-4.0,0.441786527633667,180.8258831030558,57,177,-37,1217,556,416,845,33,12.24
4,-3,0,4.0,-3.0,0.44977641105651855,176.30938715791623,57,173,-34,1217,556,416,845,33,8.96
4,-3,0,4.0,-3.0,0.45777153968811035,171.81967291320282,57,169,-31,1217,556,416,845,33,8.73
2,-1,0,2.0,-1.0,0.46578335762023926,169.6732153287607,57,167,-30,1217,556,416,845,33,6.0
3,-2,0,3.0,-2.0,0.4738454818725586,166.37307474468338,57,164,-28,1217,556,416,845,33,7.08
2,-2,0,2.0,-2.0,0.48178744316101074,164.07315441594946,57,162,-26,1217,556,416,845,33,5.02
3,-1,0,3.0,-1.0,0.4897885322570801,160.9534094078159,57,159,-25,1217,556,416,845,33,7.97
4,-1,0,4.0,-1.0,0.49779248237609863,156.84705926475002,57,155,-24,1217,556,416,845,33,9.95
4,-1,0,4.0,-1.0,0.5061495304107666,152.74161188098023,57,151,-23,1217,556,416,845,33,9.78
4,-2,0,4.0,-2.0,0.5162835121154785,148.49242404917499,57,147,-21,1217,556,416,845,33,8.18
7,-1,0,7.0,-1.0,0.5218105316162109,141.4213562373095,57,140,-20,1217,556,416,845,33,15.8
5,-1,0,5.0,-1.0,0.5318753719329834,136.33048081775402,57,135,-19,1217,556,416,845,33,10.97
6,-1,0,6.0,-1.0,0.5412025451660156,130.24976007655445,57,129,-18,1217,556,416,845,33,12.59
6,-1,0,6.0,-1.0,0.5458104610443115,124.16923934694937,57,123,-17,1217,556,416,845,33,12.27
7,-1,0,7.0,-1.0,0.5537824630737305,117.09824934643558,57,116,-16,1217,556,416,845,33,14.11
7,-2,0,7.0,-2.0,0.5617763996124268,109.89540481748998,57,109,-14,1217,556,416,845,33,10.52
7,-1,0,7.0,-1.0,0.5704994201660156,102.82509421342633,57,102,-13,1217,556,416,845,33,12.65
5,-1,0,5.0,-1.0,0.5777685642242432,97.73944955850733,57,97,-12,1217,556,416,845,33,9.1
6,0,0,6.0,-0.0,0.5857875347137451,91.7877987534291,57,91,-12,1217,556,416,845,33,8.77
5,0,0,5.0,-0.0,0.5956385135650635,86.83317338436964,57,86,-12,1217,556,416,845,33,7.72
6,0,0,6.0,-0.0,0.6017754077911377,80.89499366462674,57,80,-12,1217,556,416,845,33,8.05
5,0,0,5.0,-0.0,0.6097955703735352,75.95393340703298,57,75,-12,1217,556,416,845,33,7.05
4,0,0,4.0,-0.0,0.6183223724365234,72.00694410957877,57,71,-12,1217,556,416,845,33,6.15
4,0,0,4.0,-0.0,0.6258494853973389,68.06614430096654,57,67,-12,1217,556,416,845,33,5.92
4,0,0,4.0,-0.0,0.6337864398956299,64.13267497929586,57,63,-12,1217,556,416,845,33,5.68
4,0,0,4.0,-0.0,0.6421554088592529,60.207972893961475,57,59,-12,1217,556,416,845,33,5.43
2,0,0,2.0,-0.0,0.6499834060668945,58.249463516842795,57,57,-12,1217,556,416,845,33,4.17
4,0,0,4.0,-0.0,0.6577684879302979,54.3415126767741,57,53,-12,1217,556,416,845,33,5.04
3,0,0,3.0,-0.0,0.6658554077148438,51.419840528729765,57,50,-12,1217,556,416,845,33,4.35
3,0,0,3.0,-0.0,0.6740624904632568,48.507731342539614,57,47,-12,1217,556,416,845,33,4.16
4,0,0,4.0,-0.0,0.6817774772644043,44.64302857109943,57,43,-12,1217,556,416,845,33,4.33
3,0,0,3.0,-0.0,0.6897964477539062,41.7612260356422,57,40,-12,1217,556,416,845,33,3.69
3,0,0,3.0,-0.0,0.6980433464050293,38.897300677553446,57,37,-12,1217,556,416,845,33,3.48
2,0,0,2.0,-0.0,0.7092695236206055,37.0,57,35,-12,1217,556,416,845,33,2.98
2,0,0,2.0,-0.0,0.714024543762207,35.11409973215888,57,33,-12,1217,556,416,845,33,2.84
2,0,0,2.0,-0.0,0.721846342086792,33.24154027718932,57,31,-12,1217,556,416,845,33,2.7
2,0,0,2.0,-0.0,0.7297835350036621,31.38470965295043,57,29,-12,1217,556,416,845,33,2.55
2,-1,0,2.0,-1.0,0.7378635406494141,29.154759474226502,57,27,-11,1217,556,416,845,33,4.81
1,0,0,1.0,-0.0,0.7514865398406982,28.231188426986208,57,26,-11,1217,556,416,845,33,2.21
1,0,0,1.0,-0.0,0.7537915706634521,27.313000567495326,57,25,-11,1217,556,416,845,33,2.14
1,0,0,1.0,-0.0,0.7641735076904297,26.40075756488817,57,24,-11,1217,556,416,845,33,2.07
1,0,0,1.0,-0.0,0.7698214054107666,25.495097567963924,57,23,-11,1217,556,416,845,33,1.99
1,0,0,1.0,-0.0,0.7777843475341797,24.596747752497688,57,22,-11,1217,556,416,845,33,1.92
1,0,0,1.0,-0.0,0.79412841796875,23.706539182259394,57,21,-11,1217,556,416,845,33,1.84
0,0,1,-0.0,-0.0,0.8388223648071289,23.706539182259394,57,21,-11,1217,556,416,845,33,34.03
0,0,0,-0.0,-0.0,0.10453534126281738,684.7225715572695,58,646,227,1842,794,1196,567,39,164.57
0,1,0,-0.0,1.0,0.14252614974975586,684.3917007094694,58,646,226,1842,794,1196,567,39,1.79
0,1,0,-0.0,1.0,0.1585681438446045,684.0621316810337,58,646,225,1842,794,1196,567,39,1.79
0,1,0,-0.0,1.0,0.1825401782989502,683.7338663544464,58,646,224,1842,794,1196,567,39,1.78
0,1,0,-0.0,1.0,0.19851422309875488,683.4069066083543,58,646,223,1842,794,1196,567,39,1.77
1,1,0,1.0,1.0,0.2065262794494629,682.1356170146813,58,645,222,1842,794,1196,567,39,6.84
0,1,0,-0.0,1.0,0.21474814414978027,681.8108242027256,58,645,221,1842,794,1196,567,39,1.76
1,2,0,1.0,2.0,0.22275233268737793,680.2183472973953,58,644,219,1842,794,1196,567,39,7.26
2,2,0,2.0,2.0,0.23388314247131348,677.6820788540892,58,642,217,1842,794,1196,567,39,11.4
2,2,0,2.0,2.0,0.23857736587524414,675.148131894031,58,640,215,1842,794,1196,567,39,11.37
2,2,0,2.0,2.0,0.24657034873962402,672.6165326543795,58,638,213,1842,794,1196,567,39,11.33
4,2,0,4.0,2.0,0.2576303482055664,668.1893444226719,58,634,211,1842,794,1196,567,39,19.23
7,2,0,7.0,2.0,0.26255130767822266,660.9160309751912,58,627,209,1842,794,1196,567,39,29.02
12,5,0,12.0,5.0,0.2705223560333252,647.9513870654187,58,615,204,1842,794,1196,567,39,42.1
17,5,0,17.0,5.0,0.2817821502685547,630.2420170061656,58,598,199,1842,794,1196,567,39,51.61
21,6,0,21.0,6.0,0.2866041660308838,608.4225505353988,58,577,193,1842,794,1196,567,39,57.06
24,7,0,24.0,7.0,0.294539213180542,583.4423707616717,58,553,186,1842,794,1196,567,39,60.21
26,8,0,26.0,8.0,0.30506229400634766,556.2490449430003,58,527,178,1842,794,1196,567,39,61.7
29,8,0,29.0,8.0,0.310671329498291,526.2166854063067,58,498,170,1842,794,1196,567,39,61.96
30,9,0,30.0,9.0,0.31880831718444824,494.91918532220996,58,468,161,1842,794,1196,567,39,61.38
32,9,0,32.0,9.0,0.32651233673095703,461.7358552246078,58,436,152,1842,794,1196,567,39,59.99
30,9,0,30.0,9.0,0.33452725410461426,430.4474416232486,58,406,143,1842,794,1196,567,39,55.98
28,10,0,28.0,10.0,0.34255433082580566,400.7156098781279,58,378,133,1842,794,1196,567,39,54.0
25,9,0,25.0,9.0,0.3547992706298828,374.1456935473132,58,353,124,1842,794,1196,567,39,48.63
21,8,0,21.0,8.0,0.35854220390319824,351.68167424533226,58,332,116,1842,794,1196,567,39,41.78
20,9,0,20.0,9.0,0.36655616760253906,329.8378389451398,58,312,107,1842,794,1196,567,39,38.09
15,7,0,15.0,7.0,0.37456631660461426,313.38315206788,58,297,100,1842,794,1196,567,39,30.9
15,7,0,15.0,7.0,0.38256335258483887,296.9393877544709,58,282,93,1842,794,1196,567,39,29.75
14,7,0,14.0,7.0,0.3923983573913574,281.46047679914136,58,268,86,1842,794,1196,567,39,27.33
12,7,0,12.0,7.0,0.39853715896606445,267.91229908311414,58,256,79,1842,794,1196,567,39,23.76
10,5,0,10.0,5.0,0.40654730796813965,256.8890811225732,58,246,74,1842,794,1196,567,39,20.55
10,4,0,10.0,4.0,0.42093420028686523,246.16254792311523,58,236,70,1842,794,1196,567,39,20.45
9,4,0,9.0,4.0,0.422626256942749,236.40008460235373,58,227,66,1842,794,1196,567,39,18.31
9,5,0,9.0,5.0,0.43317317962646484,226.37358503146962,58,218,61,1842,794,1196,567,39,17.38
9,3,0,9.0,3.0,0.43853330612182617,216.8985938174796,58,209,58,1842,794,1196,567,39,18.23
9,4,0,9.0,4.0,0.446533203125,207.16177253537873,58,200,54,1842,794,1196,567,39,16.65
8,3,0,8.0,3.0,0.4562263488769531,198.65799757371965,58,192,51,1842,794,1196,567,39,15.46
9,3,0,9.0,3.0,0.4625413417816162,189.19038030513073,58,183,48,1842,794,1196,567,39,16.55
11,4,0,11.0,4.0,0.47055935859680176,177.53872816937718,58,172,44,1842,794,1196,567,39,17.48
10,4,0,10.0,4.0,0.47851037979125977,166.86521506892922,58,162,40,1842,794,1196,567,39,15.52
11,4,0,11.0,4.0,0.48653721809387207,155.23208431248997,58,151,36,1842,794,1196,567,39,15.86
10,3,0,10.0,3.0,0.49450016021728516,144.81022063376605,58,141,33,1842,794,1196,567,39,15.04
10,3,0,10.0,3.0,0.5025391578674316,134.39121995130486,58,131,30,1842,794,1196,567,39,14.31
10,2,0,10.0,2.0,0.5108451843261719,124.19742348374221,58,121,28,1842,794,1196,567,39,14.45
11,3,0,11.0,3.0,0.5185203552246094,112.80514172678478,58,110,25,1842,794,1196,567,39,14.13
9,2,0,9.0,2.0,0.5266482830047607,103.58571330062848,58,101,23,1842,794,1196,567,39,13.94
6,1,0,6.0,1.0,0.5345113277435303,97.51410154434076,58,95,22,1842,794,1196,567,39,9.28
6,2,0,6.0,2.0,0.54252028465271,91.21951545584969,58,89,20,1842,794,1196,567,39,8.55
5,1,0,5.0,1.0,0.5507612228393555,86.12200647918046,58,84,19,1842,794,1196,567,39,9.18
4,1,0,4.0,1.0,0.5600872039794922,82.0,58,80,18,1842,794,1196,567,39,8.44
3,1,0,3.0,1.0,0.5666451454162598,78.85429601486528,58,77,17,1842,794,1196,567,39,6.01
3,0,0,3.0,-0.0,0.5745551586151123,75.92759709091287,58,74,17,1842,794,1196,567,39,4.77
2,1,0,2.0,1.0,0.5839922428131104,73.7563556583431,58,72,16,1842,794,1196,567,39,4.14
2,0,0,2.0,-0.0,0.5905592441558838,71.80529228406496,58,70,16,1842,794,1196,567,39,4.08
1,0,0,1.0,-0.0,0.5985531806945801,70.83078426785913,58,69,16,1842,794,1196,567,39,3.45
2,0,0,2.0,-0.0,0.6079502105712891,68.8839603971781,58,67,16,1842,794,1196,567,39,3.97
2,0,0,2.0,-0.0,0.6150963306427002,66.94027188471824,58,65,16,1842,794,1196,567,39,3.89
2,0,0,2.0,-0.0,0.6225252151489258,65.0,58,63,16,1842,794,1196,567,39,3.81
1,1,0,1.0,1.0,0.6310653686523438,63.788713735268246,58,62,15,1842,794,1196,567,39,2.28
2,0,0,2.0,-0.0,0.638533353805542,61.84658438426491,58,60,15,1842,794,1196,567,39,3.78
1,0,0,1.0,-0.0,0.6467833518981934,60.876925020897694,58,59,15,1842,794,1196,567,39,3.23
1,0,0,1.0,-0.0,0.6545183658599854,59.90826320300064,58,58,15,1842,794,1196,567,39,3.19
1,1,0,1.0,1.0,0.6625163555145264,58.69412236331676,58,57,14,1842,794,1196,567,39,2.22
1,0,0,1.0,-0.0,0.6705663204193115,57.723478758647246,58,56,14,1842,794,1196,567,39,3.22
2,0,0,2.0,-0.0,0.6786973476409912,55.78530272392541,58,54,14,1842,794,1196,567,39,3.61
2,1,0,2.0,1.0,0.6865253448486328,53.600373133029585,58,52,13,1842,794,1196,567,39,3.88
2,0,0,2.0,-0.0,0.6946401596069336,51.66236541235796,58,50,13,1842,794,1196,567,39,3.52
3,1,0,3.0,1.0,0.7029063701629639,48.507731342539614,58,47,12,1842,794,1196,567,39,5.63
2,0,0,2.0,-0.0,0.712942361831665,46.57252408878007,58,45,12,1842,794,1196,567,39,3.38
1,0,0,1.0,-0.0,0.7186682224273682,45.60701700396552,58,44,12,1842,794,1196,567,39,2.97
1,0,0,1.0,-0.0,0.7265822887420654,44.64302857109943,58,43,12,1842,794,1196,567,39,2.92
2,0,0,2.0,-0.0,0.7380633354187012,42.720018726587654,58,41,12,1842,794,1196,567,39,3.16
2,1,0,2.0,1.0,0.7425541877746582,40.52159917870962,58,39,11,1842,794,1196,567,39,3.77
1,0,0,1.0,-0.0,0.7505292892456055,39.56008088970496,58,38,11,1842,794,1196,567,39,2.81
2,0,0,2.0,-0.0,0.7585203647613525,37.64306044943742,58,36,11,1842,794,1196,567,39,2.98
2,1,0,2.0,1.0,0.7665493488311768,35.4400902933387,58,34,10,1842,794,1196,567,39,3.71
1,0,0,1.0,-0.0,0.7747001647949219,34.48187929913333,58,33,10,1842,794,1196,567,39,2.68
2,0,0,2.0,-0.0,0.7865772247314453,32.57299494980466,58,31,10,1842,794,1196,567,39,2.77
1,0,0,1.0,-0.0,0.7905261516571045,31.622776601683793,58,30,10,1842,794,1196,567,39,2.5
2,0,0,2.0,-0.0,0.7989673614501953,29.732137494637012,58,28,10,1842,794,1196,567,39,2.55
2,1,0,2.0,1.0,0.8065223693847656,27.51363298439521,58,26,9,1842,794,1196,567,39,3.89
2,0,0,2.0,-0.0,0.8145322799682617,25.632011235952593,58,24,9,1842,794,1196,567,39,2.35
2,0,0,2.0,-0.0,0.8225221633911133,23.769728648009426,58,22,9,1842,794,1196,567,39,2.17
2,1,0,2.0,1.0,0.8305292129516602,21.540659228538015,58,20,8,1842,794,1196,567,39,4.26
1,0,0,1.0,-0.0,0.8385481834411621,20.615528128088304,58,19,8,1842,794,1196,567,39,1.98
1,0,0,1.0,-0.0,0.854581356048584,19.697715603592208,58,18,8,1842,794,1196,567,39,1.88
0,0,1,-0.0,-0.0,0.8685741424560547,19.697715603592208,58,18,8,1842,794,1196,567,39,32.81
0,0,0,-0.0,-0.0,0.06046128273010254,1410.3449932551964,59,-1368,343,456,1129,1824,786,37,248.49
0,1,0,-0.0,1.0,0.08260011672973633,1410.1021239612398,59,-1368,342,456,1129,1824,786,37,1.95
-1,0,0,-1.0,-0.0,0.09636926651000977,1409.1320023333512,59,-1367,342,456,1129,1824,786,37,8.9
-1,1,0,-1.0,1.0,0.09972119331359863,1407.9193868968493,59,-1366,341,456,1129,1824,786,37,9.3
-1,0,0,-1.0,-0.0,0.11454510688781738,1406.9491817404066,59,-1365,341,456,1129,1824,786,37,8.9
-1,0,0,-1.0,-0.0,0.12261223793029785,1405.9790183356222,59,-1364,341,456,1129,1824,786,37,8.89
-1,0,0,-1.0,-0.0,0.13321328163146973,1405.0088967689849,59,-1363,341,456,1129,1824,786,37,8.89
-2,1,0,-2.0,1.0,0.13853120803833008,1402.8260761762308,59,-1361,340,456,1129,1824,786,37,16.3
-3,0,0,-3.0,-0.0,0.14655709266662598,1399.9157117483894,59,-1358,340,456,1129,1824,786,37,20.27
-4,1,0,-4.0,1.0,0.15445423126220703,1395.792606371018,59,-1354,339,456,1129,1824,786,37,30.73
-4,0,0,-4.0,-0.0,0.16249418258666992,1391.9127127805104,59,-1350,339,456,1129,1824,786,37,25.48
-4,1,0,-4.0,1.0,0.1712021827697754,1387.7896094149141,59,-1346,338,456,1129,1824,786,37,30.59
-4,0,0,-4.0,-0.0,0.18143630027770996,1383.9104017240422,59,-1342,338,456,1129,1824,786,37,25.4
-4,1,0,-4.0,1.0,0.1865541934967041,1379.7873024491855,59,-1338,337,456,1129,1824,786,37,30.46
-4,0,0,-4.0,-0.0,0.19453120231628418,1375.9087905817014,59,-1334,337,456,1129,1824,786,37,25.32
-6,1,0,-6.0,1.0,0.2024552822113037,1369.8467067522556,59,-1328,336,456,1129,1824,786,37,37.58
-7,1,0,-7.0,1.0,0.21046829223632812,1362.8154680660182,59,-1321,335,456,1129,1824,786,37,41.66
-10,1,0,-10.0,1.0,0.21854329109191895,1352.8773041188917,59,-1311,334,456,1129,1824,786,37,53.35
-11,1,0,-11.0,1.0,0.22761130332946777,1341.9720563409658,59,-1300,333,456,1129,1824,786,37,56.77
-13,2,0,-13.0,2.0,0.23448514938354492,1328.8829895818517,59,-1287,331,456,1129,1824,786,37,64.96
-13,3,0,-13.0,3.0,0.24250125885009766,1315.5455142259427,59,-1274,328,456,1129,1824,786,37,66.95
-14,3,0,-14.0,3.0,0.2511141300201416,1301.239793427791,59,-1260,325,456,1129,1824,786,37,69.3
-19,5,0,-19.0,5.0,0.25851917266845703,1281.5931491702038,59,-1241,320,456,1129,1824,786,37,85.79
-28,6,0,-28.0,6.0,0.26735424995422363,1252.9824420158488,59,-1213,314,456,1129,1824,786,37,103.45
-32,7,0,-32.0,7.0,0.2745351791381836,1220.2499743904934,59,-1181,307,456,1129,1824,786,37,109.48
-32,9,0,-32.0,9.0,0.28245019912719727,1187.0151641828338,59,-1149,298,456,1129,1824,786,37,109.3
-33,8,0,-33.0,8.0,0.2904982566833496,1153.063744985506,59,-1116,290,456,1129,1824,786,37,108.92
-31,7,0,-31.0,7.0,0.29845523834228516,1121.3001382324003,59,-1085,283,456,1129,1824,786,37,103.13
-32,7,0,-32.0,7.0,0.30646729469299316,1088.5701631038764,59,-1053,276,456,1129,1824,786,37,102.79
-34,7,0,-34.0,7.0,0.3148941993713379,1053.907965621287,59,-1019,269,456,1129,1824,786,37,103.55
-34,7,0,-34.0,7.0,0.32251930236816406,1019.24923350474,59,-985,262,456,1129,1824,786,37,101.58
-36,8,0,-36.0,8.0,0.3305361270904541,982.4036848465096,59,-949,254,456,1129,1824,786,37,102.81
-34,7,0,-34.0,7.0,0.33867716789245605,947.7520772860379,59,-915,247,456,1129,1824,786,37,97.39
-36,8,0,-36.0,8.0,0.3464841842651367,910.9127290800145,59,-879,239,456,1129,1824,786,37,98.37
-33,8,0,-33.0,8.0,0.3547523021697998,876.9703529766557,59,-846,231,456,1129,1824,786,37,93.01
-32,7,0,-32.0,7.0,0.3626883029937744,844.2582543274303,59,-814,224,456,1129,1824,786,37,88.69
-31,8,0,-31.0,8.0,0.37052011489868164,812.2468836505315,59,-783,216,456,1129,1824,786,37,86.93
-29,8,0,-29.0,8.0,0.3784983158111572,782.1636657375489,59,-754,208,456,1129,1824,786,37,83.61
-29,8,0,-29.0,8.0,0.38674116134643555,752.0804478245661,59,-725,200,456,1129,1824,786,37,81.76
-28,9,0,-28.0,9.0,0.39449620246887207,722.6963401041962,59,-697,191,456,1129,1824,786,37,76.84
-29,9,0,-29.0,9.0,0.4025001525878906,692.3496226618456,59,-668,182,456,1129,1824,786,37,76.4
-28,9,0,-28.0,9.0,0.4115791320800781,662.9698334011888,59,-640,173,456,1129,1824,786,37,72.89
-27,9,0,-27.0,9.0,0.41847920417785645,634.5589019153383,59,-613,164,456,1129,1824,786,37,69.46
-25,8,0,-25.0,8.0,0.426469087600708,608.3420090705556,59,-588,156,456,1129,1824,786,37,65.06
-24,9,0,-24.0,9.0,0.43445324897766113,582.8421741775384,59,-564,147,456,1129,1824,786,37,61.54
-25,8,0,-25.0,8.0,0.44248127937316895,556.6345300104908,59,-539,139,456,1129,1824,786,37,61.45
-24,9,0,-24.0,9.0,0.4504721164703369,531.1544031635245,59,-515,130,456,1129,1824,786,37,57.95
-23,8,0,-23.0,8.0,0.4586772918701172,506.90038469111465,59,-492,122,456,1129,1824,786,37,55.0
-23,9,0,-23.0,9.0,0.4664630889892578,482.420977984996,59,-469,113,456,1129,1824,786,37,53.06
-21,8,0,-21.0,8.0,0.4744911193847656,460.14019602725426,59,-448,105,456,1129,1824,786,37,48.81
-19,8,0,-19.0,8.0,0.4826202392578125,439.82951242498496,59,-429,97,456,1129,1824,786,37,44.54
-18,7,0,-18.0,7.0,0.49045324325561523,420.7386362101774,59,-411,90,456,1129,1824,786,37,41.86
-18,6,0,-18.0,6.0,0.49862027168273926,401.8768468075761,59,-393,84,456,1129,1824,786,37,40.78
-18,5,0,-18.0,5.0,0.5064542293548584,383.2310008337008,59,-375,79,456,1129,1824,786,37,39.98
-17,6,0,-17.0,6.0,0.5145993232727051,365.3669388436781,59,-358,73,456,1129,1824,786,37,36.82
-17,5,0,-17.0,5.0,0.5231881141662598,347.71396290629457,59,-341,68,456,1129,1824,786,37,35.96
-17,5,0,-17.0,5.0,0.5310211181640625,330.06817477606046,59,-324,63,456,1129,1824,786,37,34.69
-16,5,0,-16.0,5.0,0.5385053157806396,313.41346493091197,59,-308,58,456,1129,1824,786,37,32.11
-17,4,0,-17.0,4.0,0.5464622974395752,295.96790366524544,59,-291,54,456,1129,1824,786,37,32.92
-15,4,0,-15.0,4.0,0.5544703006744385,280.49242414011826,59,-276,50,456,1129,1824,786,37,29.02
-15,4,0,-15.0,4.0,0.56252121925354,265.02264054227516,59,-261,46,456,1129,1824,786,37,27.89
-14,3,0,-14.0,3.0,0.5705571174621582,250.7149776140229,59,-247,43,456,1129,1824,786,37,26.63
-15,2,0,-15.0,2.0,0.5788421630859375,235.5949914577982,59,-232,41,456,1129,1824,786,37,26.35
-15,3,0,-15.0,3.0,0.5865132808685303,220.30206535572924,59,-217,38,456,1129,1824,786,37,26.04
-13,3,0,-13.0,3.0,0.5945513248443604,206.9806754264755,59,-204,35,456,1129,1824,786,37,22.26
-13,2,0,-13.0,2.0,0.6026802062988281,193.82982226685345,59,-191,33,456,1129,1824,786,37,22.42
-12,1,0,-12.0,1.0,0.6104681491851807,181.8378398463862,59,-179,32,456,1129,1824,786,37,18.71
-12,1,0,-12.0,1.0,0.6184642314910889,169.85287751463028,59,-167,31,456,1129,1824,786,37,17.83
-11,1,0,-11.0,1.0,0.6294910907745361,158.8584275384847,59,-156,30,456,1129,1824,786,37,16.27
-13,1,0,-13.0,1.0,0.6346111297607422,145.91093173576817,59,-143,29,456,1129,1824,786,37,16.67
-12,0,0,-12.0,-0.0,0.6429531574249268,134.17153200288055,59,-131,29,456,1129,1824,786,37,14.16
-10,1,0,-10.0,1.0,0.6533572673797607,124.19742348374221,59,-121,28,456,1129,1824,786,37,12.93
-10,0,0,-10.0,-0.0,0.6585021018981934,114.47707194019246,59,-111,28,456,1129,1824,786,37,11.22
-7,0,0,-7.0,-0.0,0.6671962738037109,107.70329614269008,59,-104,28,456,1129,1824,786,37,8.62
-8,1,0,-8.0,1.0,0.676699161529541,99.72462083156798,59,-96,27,456,1129,1824,786,37,9.84
-6,0,0,-6.0,-0.0,0.6828522682189941,93.96275858019496,59,-90,27,456,1129,1824,786,37,7.1
-5,0,0,-5.0,-0.0,0.6909222602844238,89.1852005660132,59,-85,27,456,1129,1824,786,37,6.14
-5,0,0,-5.0,-0.0,0.7034592628479004,84.43340571124678,59,-80,27,456,1129,1824,786,37,5.86
-4,0,0,-4.0,-0.0,0.7064902782440186,80.65358020571685,59,-76,27,456,1129,1824,786,37,5.01
-4,0,0,-4.0,-0.0,0.7156832218170166,76.89603370785778,59,-72,27,456,1129,1824,786,37,4.8
-4,-1,0,-4.0,-1.0,0.7224953174591064,73.53910524340094,59,-68,28,456,1129,1824,786,37,3.6
-4,-1,0,-4.0,-1.0,0.7313072681427002,70.26378868236469,59,-64,29,456,1129,1824,786,37,3.37
-4,0,0,-4.0,-0.0,0.744044303894043,66.64082832618455,59,-60,29,456,1129,1824,786,37,4.05
-6,0,0,-6.0,-0.0,0.7465043067932129,61.29437168288782,59,-54,29,456,1129,1824,786,37,4.61
-6,0,0,-6.0,-0.0,0.7544682025909424,56.08029957123981,59,-48,29,456,1129,1824,786,37,4.15
-6,-1,0,-6.0,-1.0,0.7633011341094971,51.61395160225576,59,-42,30,456,1129,1824,786,37,3.02
-5,0,0,-5.0,-0.0,0.7707083225250244,47.634021455258214,59,-37,30,456,1129,1824,786,37,2.88
-4,0,0,-4.0,-0.0,0.7784442901611328,44.598206241955516,59,-33,30,456,1129,1824,786,37,2.27
-4,0,0,-4.0,-0.0,0.7864892482757568,41.72529209005013,59,-29,30,456,1129,1824,786,37,1.97
-5,0,0,-5.0,-0.0,0.7995791435241699,38.41874542459709,59,-24,30,456,1129,1824,786,37,1.79
-3,0,0,-3.0,-0.0,0.8030641078948975,36.61966684720111,59,-21,30,456,1129,1824,786,37,1.16
-3,1,0,-3.0,1.0,0.8147082328796387,34.132096331752024,59,-18,29,456,1129,1824,786,37,1.83
-2,1,0,-2.0,1.0,0.8186120986938477,32.2490309931942,59,-16,28,456,1129,1824,786,37,1.87
-2,1,0,-2.0,1.0,0.8268692493438721,30.4138126514911,59,-14,27,456,1129,1824,786,37,1.7
-3,2,0,-3.0,2.0,0.8344612121582031,27.313000567495326,59,-11,25,456,1129,1824,786,37,2.02
-3,2,0,-3.0,2.0,0.8424892425537109,24.351591323771842,59,-8,23,456,1129,1824,786,37,1.64
-3,2,0,-3.0,2.0,0.8508131504058838,21.587033144922902,59,-5,21,456,1129,1824,786,37,1.22
-3,2,0,-3.0,2.0,0.8584980964660645,19.1049731745428,59,-2,19,456,1129,1824,786,37,0.77
-2,2,0,-2.0,2.0,0.8665041923522949,17.0,59,0,17,456,1129,1824,786,37,0.82
-1,1,0,-1.0,1.0,0.8744931221008301,16.0312195418814,59,1,16,456,1129,1824,786,37,0.67
-2,1,0,-2.0,1.0,0.8824942111968994,15.297058540778355,59,3,15,456,1129,1824,786,37,-0.25
-2,2,0,-2.0,2.0,0.8905391693115234,13.92838827718412,59,5,13,456,1129,1824,786,37,-0.11
-2,3,0,-2.0,3.0,0.8985352516174316,12.206555615733702,59,7,10,456,1129,1824,786,37,-0.35
-2,2,0,-2.0,2.0,0.906447172164917,12.041594578792296,59,9,8,456,1129,1824,786,37,-1.04
-2,2,0,-2.0,2.0,0.9144682884216309,12.529964086141668,59,11,6,456,1129,1824,786,37,-0.39
-1,1,0,-1.0,1.0,0.9225142002105713,13.0,59,12,5,456,1129,1824,786,37,0.34
-1,1,0,-1.0,1.0,0.9304702281951904,13.601470508735444,59,13,4,456,1129,1824,786,37,0.31
0,1,0,-0.0,1.0,0.9384841918945312,13.341664064126334,59,13,3,456,1129,1824,786,37,-0.1
0,0,1,-0.0,-0.0,0.9524941444396973,13.341664064126334,59,13,3,456,1129,1824,786,37,30.88
0,0,0,-0.0,-0.0,0.07697820663452148,740.3039916142557,60,-345,-655,98,471,443,1126,42,172.51
2,0,0,2.0,-0.0,0.08993124961853027,741.238153362332,60,-347,-655,98,471,443,1126,42,4.76
2,0,0,2.0,-0.0,0.09796929359436035,742.1765288662799,60,-349,-655,98,471,443,1126,42,4.74
3,-1,0,3.0,-1.0,0.10599422454833984,742.7112494098901,60,-352,-654,98,471,443,1126,42,7.34
4,0,0,4.0,-0.0,0.1172032356262207,744.61533693579,60,-356,-654,98,471,443,1126,42,2.67
3,-2,0,3.0,-2.0,0.12222433090209961,744.3016861461487,60,-359,-652,98,471,443,1126,42,1.41
4,-1,0,4.0,-1.0,0.13128924369812012,745.3656820648506,60,-363,-651,98,471,443,1126,42,3.98
3,-2,0,3.0,-2.0,0.1442713737487793,745.088585337341,60,-366,-649,98,471,443,1126,42,1.26
4,-2,0,4.0,-2.0,0.14602327346801758,745.3247614295395,60,-370,-647,98,471,443,1126,42,15.38
4,-2,0,4.0,-2.0,0.16072821617126465,745.5876876665816,60,-374,-645,98,471,443,1126,42,13.97
5,-2,0,5.0,-2.0,0.16315531730651855,746.3846193484965,60,-379,-643,98,471,443,1126,42,5.04
6,-3,0,6.0,-3.0,0.17251825332641602,746.8768305416897,60,-385,-640,98,471,443,1126,42,7.81
7,-3,0,7.0,-3.0,0.17874622344970703,747.9525386012136,60,-392,-637,98,471,443,1126,42,3.78
9,-4,0,9.0,-4.0,0.18663334846496582,749.3263641431549,60,-401,-633,98,471,443,1126,42,2.99
10,-5,0,10.0,-5.0,0.19672226905822754,750.5364747965284,60,-411,-628,98,471,443,1126,42,3.32
10,-6,0,10.0,-6.0,0.20199823379516602,751.0825520540335,60,-421,-622,98,471,443,1126,42,7.03
9,-8,0,9.0,-8.0,0.21030020713806152,749.5972251816305,60,-430,-614,98,471,443,1126,42,5.82
7,-8,0,7.0,-8.0,0.22089338302612305,747.1311799142103,60,-437,-606,98,471,443,1126,42,9.48
6,-11,0,6.0,-11.0,0.22606229782104492,741.8045564702336,60,-443,-595,98,471,443,1126,42,19.12
4,-13,0,4.0,-13.0,0.23396921157836914,733.8480769205572,60,-447,-582,98,471,443,1126,42,26.93
2,-12,0,2.0,-12.0,0.241929292678833,725.6038864284011,60,-449,-570,98,471,443,1126,42,27.74
0,-11,0,-0.0,-11.0,0.25004029273986816,716.9951185328949,60,-449,-559,98,471,443,1126,42,28.82
0,-12,0,-0.0,-12.0,0.2583622932434082,707.6793059006318,60,-449,-547,98,471,443,1126,42,30.4
-2,-13,0,-2.0,-13.0,0.2659342288970947,696.3942848702882,60,-447,-534,98,471,443,1126,42,35.23
-5,-14,0,-5.0,-14.0,0.27405238151550293,682.4690469171477,60,-442,-520,98,471,443,1126,42,41.21
-6,-14,0,-6.0,-14.0,0.28205132484436035,667.931134174774,60,-436,-506,98,471,443,1126,42,42.16
-6,-14,0,-6.0,-14.0,0.2899353504180908,653.424823526012,60,-430,-492,98,471,443,1126,42,41.5
-8,-13,0,-8.0,-13.0,0.29796624183654785,638.3768479511142,60,-422,-479,98,471,443,1126,42,42.8
-9,-15,0,-9.0,-15.0,0.3074634075164795,621.1803280851705,60,-413,-464,98,471,443,1126,42,45.91
-11,-15,0,-11.0,-15.0,0.3165302276611328,602.6649151891953,60,-402,-449,98,471,443,1126,42,48.16
-12,-15,0,-12.0,-15.0,0.32196927070617676,583.4860752408749,60,-390,-434,98,471,443,1126,42,48.93
-14,-17,0,-14.0,-17.0,0.32996630668640137,561.4846391487482,60,-376,-417,98,471,443,1126,42,52.27
-17,-18,0,-17.0,-18.0,0.3404092788696289,536.7327081518323,60,-359,-399,98,471,443,1126,42,55.11
-21,-19,0,-21.0,-19.0,0.34595322608947754,508.5705457456222,60,-338,-380,98,471,443,1126,42,55.55
-23,-19,0,-23.0,-19.0,0.35551023483276367,479.10959080360726,60,-315,-361,98,471,443,1126,42,54.27
-20,-16,0,-20.0,-16.0,0.36452627182006836,453.9273069556402,60,-295,-345,98,471,443,1126,42,47.75
-18,-14,0,-18.0,-14.0,0.3699653148651123,431.6132528085763,60,-277,-331,98,471,443,1126,42,42.84
-14,-12,0,-14.0,-12.0,0.37798237800598145,413.43681500321185,60,-263,-319,98,471,443,1126,42,36.93
-12,-12,0,-12.0,-12.0,0.3894462585449219,396.547601177967,60,-251,-307,98,471,443,1126,42,35.01
-12,-12,0,-12.0,-12.0,0.3939673900604248,379.6656423749718,60,-239,-295,98,471,443,1126,42,33.99
-12,-13,0,-12.0,-13.0,0.4032752513885498,362.01243072579706,60,-227,-282,98,471,443,1126,42,34.46
-12,-13,0,-12.0,-13.0,0.4129064083099365,344.363180377926,60,-215,-269,98,471,443,1126,42,33.32
-11,-13,0,-11.0,-13.0,0.4179682731628418,327.34080100103625,60,-204,-256,98,471,443,1126,42,32.56
-12,-11,0,-12.0,-11.0,0.42827725410461426,311.2699792784392,60,-192,-245,98,471,443,1126,42,28.41
-11,-10,0,-11.0,-10.0,0.4377284049987793,296.62434155004877,60,-181,-235,98,471,443,1126,42,25.83
-8,-9,0,-8.0,-9.0,0.44194936752319336,284.6137733842127,60,-173,-226,98,471,443,1126,42,23.21
-9,-9,0,-9.0,-9.0,0.45059728622436523,272.0018382290826,60,-164,-217,98,471,443,1126,42,22.46
-8,-10,0,-8.0,-10.0,0.45796728134155273,259.2006944435142,60,-156,-207,98,471,443,1126,42,23.85
-9,-9,0,-9.0,-9.0,0.46594929695129395,246.60291969074495,60,-147,-198,98,471,443,1126,42,20.99
-8,-9,0,-8.0,-9.0,0.4739723205566406,234.61031520374377,60,-139,-189,98,471,443,1126,42,20.29
-8,-10,0,-8.0,-10.0,0.48194026947021484,221.81523843054606,60,-131,-179,98,471,443,1126,42,21.33
-8,-10,0,-8.0,-10.0,0.4914982318878174,209.02152999152983,60,-123,-169,98,471,443,1126,42,20.51
-7,-7,0,-7.0,-7.0,0.4979732036590576,199.24858845171275,60,-116,-162,98,471,443,1126,42,15.42
-7,-8,0,-7.0,-8.0,0.5060203075408936,188.67167248953936,60,-109,-154,98,471,443,1126,42,16.28
-5,-7,0,-5.0,-7.0,0.5173742771148682,180.06943105369106,60,-104,-147,98,471,443,1126,42,16.74
-4,-7,0,-4.0,-7.0,0.5220422744750977,172.04650534085255,60,-100,-140,98,471,443,1126,42,13.07
-4,-5,0,-4.0,-5.0,0.5304982662200928,165.65325230734229,60,-96,-135,98,471,443,1126,42,11.93
-3,-7,0,-3.0,-7.0,0.5379424095153809,158.21820375671064,60,-93,-128,98,471,443,1126,42,10.87
-4,-7,0,-4.0,-7.0,0.5460443496704102,150.20652449211386,60,-89,-121,98,471,443,1126,42,11.93
-4,-8,0,-4.0,-8.0,0.554802417755127,141.40014144264495,60,-85,-113,98,471,443,1126,42,11.55
-4,-6,0,-4.0,-6.0,0.5619432926177979,134.2013412749664,60,-81,-107,98,471,443,1126,42,11.36
-3,-5,0,-3.0,-5.0,0.5715234279632568,128.40560735419618,60,-78,-102,98,471,443,1126,42,9.19
-2,-6,0,-2.0,-6.0,0.5780303478240967,122.44182292011173,60,-76,-96,98,471,443,1126,42,7.56
-2,-5,0,-2.0,-5.0,0.5859513282775879,117.29023829799307,60,-74,-91,98,471,443,1126,42,6.94
-3,-5,0,-3.0,-5.0,0.5939474105834961,111.5212984142491,60,-71,-86,98,471,443,1126,42,8.16
-3,-5,0,-3.0,-5.0,0.6019842624664307,105.75916035975324,60,-68,-81,98,471,443,1126,42,7.87
-2,-5,0,-2.0,-5.0,0.6159772872924805,100.65783625729296,60,-66,-76,98,471,443,1126,42,6.18
-3,-5,0,-3.0,-5.0,0.617969274520874,94.92101980067429,60,-63,-71,98,471,443,1126,42,7.21
-2,-5,0,-2.0,-5.0,0.627967357635498,89.87213138676528,60,-61,-66,98,471,443,1126,42,5.63
-1,-3,0,-1.0,-3.0,0.6343894004821777,87.0,60,-60,-63,98,471,443,1126,42,3.9
-2,-3,0,-2.0,-3.0,0.6419692039489746,83.45058418010026,60,-58,-60,98,471,443,1126,42,5.48
-2,-4,0,-2.0,-4.0,0.6499474048614502,79.19595949289332,60,-56,-56,98,471,443,1126,42,4.97
-2,-4,0,-2.0,-4.0,0.6579914093017578,74.96665925596525,60,-54,-52,98,471,443,1126,42,4.74
-2,-4,0,-2.0,-4.0,0.6659684181213379,70.76722405181653,60,-52,-48,98,471,443,1126,42,4.5
-3,-3,0,-3.0,-3.0,0.6808242797851562,66.52818951391959,60,-49,-45,98,471,443,1126,42,7.19
-2,-3,0,-2.0,-3.0,0.6823153495788574,63.0317380372777,60,-47,-42,98,471,443,1126,42,4.41
-1,-2,0,-1.0,-2.0,0.6971733570098877,60.959002616512684,60,-46,-40,98,471,443,1126,42,3.07
-2,-2,0,-2.0,-2.0,0.6980364322662354,58.137767414994535,60,-44,-38,98,471,443,1126,42,5.61
-2,-2,0,-2.0,-2.0,0.7059752941131592,55.31726674375732,60,-42,-36,98,471,443,1126,42,5.47
-2,-2,0,-2.0,-2.0,0.7139623165130615,52.49761899362675,60,-40,-34,98,471,443,1126,42,5.33
-3,-2,0,-3.0,-2.0,0.7221822738647461,48.91829923454004,60,-37,-32,98,471,443,1126,42,4.96
-2,-2,0,-2.0,-2.0,0.7299833297729492,46.09772228646444,60,-35,-30,98,471,443,1126,42,5.23
-4,-3,0,-4.0,-3.0,0.7398502826690674,41.10960958218893,60,-31,-27,98,471,443,1126,42,5.84
-4,-3,0,-4.0,-3.0,0.7473232746124268,36.124783736376884,60,-27,-24,98,471,443,1126,42,5.44
-5,-3,0,-5.0,-3.0,0.7540082931518555,30.4138126514911,60,-22,-21,98,471,443,1126,42,3.97
-3,-3,0,-3.0,-3.0,0.7619833946228027,26.1725046566048,60,-19,-18,98,471,443,1126,42,6.14
-3,-2,0,-3.0,-2.0,0.7759313583374023,22.627416997969522,60,-16,-16,98,471,443,1126,42,3.26
-3,-1,0,-3.0,-1.0,0.7788612842559814,19.849433241279208,60,-13,-15,98,471,443,1126,42,1.55
-1,-2,0,-1.0,-2.0,0.7888813018798828,17.69180601295413,60,-12,-13,98,471,443,1126,42,2.35
-2,-1,0,-2.0,-1.0,0.7939693927764893,15.620499351813308,60,-10,-12,98,471,443,1126,42,1.68
-1,-1,0,-1.0,-1.0,0.8020343780517578,14.212670403551895,60,-9,-11,98,471,443,1126,42,3.61
-1,-1,0,-1.0,-1.0,0.8099284172058105,12.806248474865697,60,-8,-10,98,471,443,1126,42,3.4
-1,-1,0,-1.0,-1.0,0.8179774284362793,11.40175425099138,60,-7,-9,98,471,443,1126,42,3.16
0,0,1,-0.0,-0.0,0.8479392528533936,11.40175425099138,60,-7,-9,98,471,443,1126,42,30.3
0,0,0,-0.0,-0.0,0.0728921890258789,444.24542766358326,61,235,377,340,857,105,480,69,125.46
2,-1,0,2.0,-1.0,0.11289834976196289,444.04166471177,61,233,378,340,857,105,480,69,0.53
2,0,0,2.0,-0.0,0.12105822563171387,442.9954853043087,61,231,378,340,857,105,480,69,2.47
3,0,0,3.0,-0.0,0.130568265914917,441.4385574459938,61,228,378,340,857,105,480,69,3.28
4,0,0,4.0,-0.0,0.13705825805664062,439.38593514130605,61,224,378,340,857,105,480,69,4.04
5,0,0,5.0,-0.0,0.14486932754516602,436.85810053151124,61,219,378,340,857,105,480,69,4.75
4,-1,0,4.0,-1.0,0.15298819541931152,435.7361587015702,61,215,379,340,857,105,480,69,2.2
5,0,0,5.0,-0.0,0.16179919242858887,433.2908953578416,61,210,379,340,857,105,480,69,4.57
5,0,0,5.0,-0.0,0.1688692569732666,430.88977708922266,61,205,379,340,857,105,480,69,4.47
5,0,0,5.0,-0.0,0.1770482063293457,428.53354594477196,61,200,379,340,857,105,480,69,4.37
5,2,0,5.0,2.0,0.18672418594360352,424.4455206501772,61,195,377,340,857,105,480,69,7.56
7,3,0,7.0,3.0,0.19354534149169922,418.59288097147567,61,188,374,340,857,105,480,69,10.01
9,4,0,9.0,4.0,0.20117735862731934,411.02433018010015,61,179,370,340,857,105,480,69,12.16
9,6,0,9.0,6.0,0.20886826515197754,401.7412102336528,61,170,364,340,857,105,480,69,14.49
12,6,0,12.0,6.0,0.21718621253967285,391.31572930307823,61,158,358,340,857,105,480,69,15.25
11,7,0,11.0,7.0,0.22959136962890625,380.5390912902379,61,147,351,340,857,105,480,69,15.56
12,8,0,12.0,8.0,0.23290538787841797,368.6109059699672,61,135,343,340,857,105,480,69,16.48
16,10,0,16.0,10.0,0.24141335487365723,353.62409420173844,61,119,333,340,857,105,480,69,18.94
16,13,0,16.0,13.0,0.24888038635253906,336.1681127055331,61,103,320,340,857,105,480,69,20.74
15,12,0,15.0,12.0,0.2572143077850342,320.3248351283428,61,88,308,340,857,105,480,69,18.56
13,15,0,13.0,15.0,0.26642918586730957,302.44668951734286,61,75,293,340,857,105,480,69,19.93
10,16,0,10.0,16.0,0.2731451988220215,284.5241641759097,61,65,277,340,857,105,480,69,19.63
9,17,0,9.0,17.0,0.28089237213134766,265.9624033580686,61,56,260,340,857,105,480,69,19.46
8,18,0,8.0,18.0,0.2889132499694824,246.71440979399642,61,48,242,340,857,105,480,69,19.25
6,18,0,6.0,18.0,0.2972111701965332,227.90348834539589,61,42,224,340,857,105,480,69,18.64
4,18,0,4.0,18.0,0.3048572540283203,209.4755355644186,61,38,206,340,857,105,480,69,19.07
4,18,0,4.0,18.0,0.3129441738128662,191.049731745428,61,34,188,340,857,105,480,69,17.96
3,15,0,3.0,15.0,0.3213202953338623,175.75551200460256,61,31,173,340,857,105,480,69,16.13
3,15,0,3.0,15.0,0.3288693428039551,160.46183346827368,61,28,158,340,857,105,480,69,15.28
3,13,0,3.0,13.0,0.33704137802124023,147.13938969562162,61,25,145,340,857,105,480,69,12.56
3,10,0,3.0,10.0,0.34489917755126953,136.7808466123821,61,22,135,340,857,105,480,69,9.53
2,10,0,2.0,10.0,0.3528563976287842,126.58988901172162,61,20,125,340,857,105,480,69,10.56
1,8,0,1.0,8.0,0.3608882427215576,118.53269591129698,61,19,117,340,857,105,480,69,9.3
0,7,0,-0.0,7.0,0.3697962760925293,111.6288493177279,61,19,110,340,857,105,480,69,6.61
1,5,0,1.0,5.0,0.3768653869628906,106.53168542738823,61,18,105,340,857,105,480,69,7.85
0,6,0,-0.0,6.0,0.3848903179168701,100.62305898749054,61,18,99,340,857,105,480,69,5.79
0,5,0,-0.0,5.0,0.3929271697998047,95.70788891204319,61,18,94,340,857,105,480,69,5.18
0,5,0,-0.0,5.0,0.4009242057800293,90.80198235721508,61,18,89,340,857,105,480,69,4.99
-1,4,0,-1.0,4.0,0.41267824172973633,87.0976463516667,61,19,85,340,857,105,480,69,3.25
-1,4,0,-1.0,4.0,0.41689038276672363,83.43260753446461,61,20,81,340,857,105,480,69,3.1
-1,5,0,-1.0,5.0,0.42487525939941406,78.84795495128583,61,21,76,340,857,105,480,69,3.38
-2,4,0,-2.0,4.0,0.4328732490539551,75.58438992278762,61,23,72,340,857,105,480,69,2.1
-1,5,0,-1.0,5.0,0.44100332260131836,71.16881339463234,61,24,67,340,857,105,480,69,2.92
-1,4,0,-1.0,4.0,0.44961118698120117,67.77905281132217,61,25,63,340,857,105,480,69,2.33
-1,4,0,-1.0,4.0,0.45688533782958984,64.47480127925948,61,26,59,340,857,105,480,69,2.15
-1,5,0,-1.0,5.0,0.4649791717529297,60.37383539249432,61,27,54,340,857,105,480,69,2.25
-1,5,0,-1.0,5.0,0.4728872776031494,56.43580423808985,61,28,49,340,857,105,480,69,1.98
-1,4,0,-1.0,4.0,0.4809892177581787,53.53503525729669,61,29,45,340,857,105,480,69,1.48
-1,3,0,-1.0,3.0,0.4888582229614258,51.61395160225576,61,30,42,340,857,105,480,69,1.03
0,2,0,-0.0,2.0,0.4968912601470947,50.0,61,30,40,340,857,105,480,69,1.59
0,2,0,-0.0,2.0,0.5048742294311523,48.41487374764082,61,30,38,340,857,105,480,69,1.5
-1,0,0,-1.0,-0.0,0.5147151947021484,49.040799340956916,61,31,38,340,857,105,480,69,1.26
0,1,0,-0.0,1.0,0.529367208480835,48.27007354458868,61,31,37,340,857,105,480,69,1.34
0,0,1,-0.0,-0.0,0.5508642196655273,48.27007354458868,61,31,37,340,857,105,480,69,41.54
0,1,1,-0.0,1.0,0.08139252662658691,612.8751912094338,62,496,-360,805,461,309,820,61,4.84
0,1,1,-0.0,1.0,0.09080147743225098,613.4631203259084,62,496,-361,805,461,309,820,61,4.84
0,0,0,-0.0,-0.0,0.09436464309692383,613.4631203259084,62,496,-361,805,461,309,820,61,153.86
0,1,0,-0.0,1.0,0.10711169242858887,614.0521150521347,62,496,-362,805,461,309,820,61,4.83
0,1,0,-0.0,1.0,0.10785651206970215,614.6421723246787,62,496,-363,805,461,309,820,61,4.83
0,1,0,-0.0,1.0,0.11339259147644043,615.2332890863432,62,496,-364,805,461,309,820,61,4.83
0,1,0,-0.0,1.0,0.12935566902160645,615.8254622861903,62,496,-365,805,461,309,820,61,4.83
0,1,0,-0.0,1.0,0.13735461235046387,616.4186888795634,62,496,-366,805,461,309,820,61,4.82
0,1,0,-0.0,1.0,0.14536666870117188,617.0129658281096,62,496,-367,805,461,309,820,61,4.82
1,1,0,1.0,1.0,0.16144561767578125,616.8054798718961,62,495,-368,805,461,309,820,61,0.76
1,0,0,1.0,-0.0,0.16936850547790527,616.0032467446905,62,494,-368,805,461,309,820,61,3.31
2,0,0,2.0,-0.0,0.17735767364501953,614.4005208331125,62,492,-368,805,461,309,820,61,5.14
4,0,0,4.0,-0.0,0.18535566329956055,611.2020942372499,62,488,-368,805,461,309,820,61,8.64
5,0,0,5.0,-0.0,0.19520163536071777,607.2174239924279,62,483,-368,805,461,309,820,61,10.26
7,0,0,7.0,-0.0,0.2014164924621582,601.6643582596529,62,476,-368,805,461,309,820,61,13.37
9,-2,0,9.0,-2.0,0.20939254760742188,593.3338014979427,62,467,-366,805,461,309,820,61,19.05
13,-3,0,13.0,-3.0,0.2190535068511963,581.278762729209,62,454,-363,805,461,309,820,61,25.12
16,-3,0,16.0,-3.0,0.22539067268371582,566.9603160715924,62,438,-360,805,461,309,820,61,28.03
18,-4,0,18.0,-4.0,0.23335552215576172,550.5778782334066,62,420,-356,805,461,309,820,61,30.5
21,-5,0,21.0,-5.0,0.2413806915283203,531.4150919949489,62,399,-351,805,461,309,820,61,33.42
23,-6,0,23.0,-6.0,0.249375581741333,510.29501271323437,62,376,-345,805,461,309,820,61,34.88
26,-8,0,26.0,-8.0,0.2592146396636963,485.8693239956604,62,350,-337,805,461,309,820,61,37.41
25,-9,0,25.0,-9.0,0.2654764652252197,461.7456009535987,62,325,-328,805,461,309,820,61,35.94
24,-9,0,24.0,-9.0,0.2733786106109619,438.5909255787219,62,301,-319,805,461,309,820,61,33.74
26,-10,0,26.0,-10.0,0.2846486568450928,413.6496101775028,62,275,-309,805,461,309,820,61,34.04
24,-13,0,24.0,-13.0,0.2893664836883545,388.09406076362467,62,251,-296,805,461,309,820,61,33.49
24,-15,0,24.0,-15.0,0.29769349098205566,361.23399618529817,62,227,-281,805,461,309,820,61,33.1
23,-16,0,23.0,-16.0,0.30950164794921875,334.4263745579885,62,204,-265,805,461,309,820,61,31.47
19,-14,0,19.0,-14.0,0.31340646743774414,311.8108400937979,62,185,-251,805,461,309,820,61,26.87
16,-12,0,16.0,-12.0,0.3216555118560791,292.71487833726525,62,169,-239,805,461,309,820,61,22.92
14,-12,0,14.0,-12.0,0.3293485641479492,274.8708787776544,62,155,-227,805,461,309,820,61,21.2
11,-10,0,11.0,-10.0,0.33739757537841797,260.43233286210835,62,144,-217,805,461,309,820,61,17.77
10,-11,0,10.0,-11.0,0.3453526496887207,245.7478382407463,62,134,-206,805,461,309,820,61,17.89
8,-10,0,8.0,-10.0,0.3534505367279053,233.00643767930532,62,126,-196,805,461,309,820,61,16.34
9,-11,0,9.0,-11.0,0.3616344928741455,218.89266776207924,62,117,-185,805,461,309,820,61,16.55
10,-10,0,10.0,-10.0,0.3693845272064209,205.11947737842937,62,107,-175,805,461,309,820,61,14.75
8,-11,0,8.0,-11.0,0.37763261795043945,191.56461051039673,62,99,-164,805,461,309,820,61,15.31
6,-9,0,6.0,-9.0,0.3855776786804199,180.75950874020432,62,93,-155,805,461,309,820,61,13.65
7,-11,0,7.0,-11.0,0.39334750175476074,167.72596698186004,62,86,-144,805,461,309,820,61,15.13
7,-10,0,7.0,-10.0,0.4022345542907715,155.5538491969903,62,79,-134,805,461,309,820,61,12.83
7,-9,0,7.0,-9.0,0.41562867164611816,144.25324953012324,62,72,-125,805,461,309,820,61,11.05
6,-7,0,6.0,-7.0,0.4174306392669678,135.20355024924456,62,66,-118,805,461,309,820,61,8.89
6,-7,0,6.0,-7.0,0.4275364875793457,126.17844506887855,62,60,-111,805,461,309,820,61,8.42
6,-6,0,6.0,-6.0,0.43367552757263184,118.07201192492656,62,54,-105,805,461,309,820,61,7.1
5,-5,0,5.0,-5.0,0.44159746170043945,111.35977729862789,62,49,-100,805,461,309,820,61,6.06
4,-5,0,4.0,-5.0,0.4493436813354492,105.11898020814318,62,45,-95,805,461,309,820,61,6.12
5,-5,0,5.0,-5.0,0.4575366973876953,98.48857801796105,62,40,-90,805,461,309,820,61,5.44
5,-5,0,5.0,-5.0,0.46607255935668945,91.92388155425118,62,35,-85,805,461,309,820,61,5.09
4,-4,0,4.0,-4.0,0.47660064697265625,86.7294644281861,62,31,-81,805,461,309,820,61,4.25
4,-4,0,4.0,-4.0,0.4814126491546631,81.59656855530139,62,27,-77,805,461,309,820,61,3.99
2,-3,0,2.0,-3.0,0.48944759368896484,78.10889834071403,62,25,-74,805,461,309,820,61,4.02
2,-3,0,2.0,-3.0,0.4973716735839844,74.63243262818116,62,23,-71,805,461,309,820,61,3.88
2,-3,0,2.0,-3.0,0.5053784847259521,71.16881339463234,62,21,-68,805,461,309,820,61,3.73
2,-3,0,2.0,-3.0,0.51352858543396,67.72001181334805,62,19,-65,805,461,309,820,61,3.58
1,-2,0,1.0,-2.0,0.5213534832000732,65.52098900352466,62,18,-63,805,461,309,820,61,3.81
1,-3,0,1.0,-3.0,0.5293605327606201,62.36184731067546,62,17,-60,805,461,309,820,61,5.83
1,-1,0,1.0,-1.0,0.5373494625091553,61.1310068623117,62,16,-59,805,461,309,820,61,2.02
1,-1,0,1.0,-1.0,0.5453665256500244,59.90826320300064,62,15,-58,805,461,309,820,61,1.97
1,-2,0,1.0,-2.0,0.5536766052246094,57.723478758647246,62,14,-56,805,461,309,820,61,3.46
2,-1,0,2.0,-1.0,0.5615615844726562,56.293871780150276,62,12,-55,805,461,309,820,61,1.19
2,-1,0,2.0,-1.0,0.5693535804748535,54.91812087098393,62,10,-54,805,461,309,820,61,1.1
2,-2,0,2.0,-2.0,0.5789086818695068,52.61178575186362,62,8,-52,805,461,309,820,61,1.87
3,-1,0,3.0,-1.0,0.5853865146636963,51.24451190127583,62,5,-51,805,461,309,820,61,0.64
1,-1,0,1.0,-1.0,0.5933816432952881,50.15974481593781,62,4,-50,805,461,309,820,61,1.43
1,0,0,1.0,-0.0,0.6033196449279785,50.08991914547278,62,3,-50,805,461,309,820,61,0.06
1,0,0,1.0,-0.0,0.6175374984741211,50.039984012787215,62,2,-50,805,461,309,820,61,0.04
0,0,1,-0.0,-0.0,0.6353585720062256,50.039984012787215,62,2,-50,805,461,309,820,61,42.08
0,0,0,-0.0,-0.0,0.09808874130249023,590.5387370867385,63,-344,-480,459,31,803,511,20,150.27
1,0,0,1.0,-0.0,0.12507176399230957,591.121814857141,63,-345,-480,459,31,803,511,20,12.18
1,0,0,1.0,-0.0,0.13307476043701172,591.7060080817162,63,-346,-480,459,31,803,511,20,12.17
2,0,0,2.0,-0.0,0.1413588523864746,592.87772769771,63,-348,-480,459,31,803,511,20,6.71
1,0,0,1.0,-0.0,0.1491086483001709,593.4652475082261,63,-349,-480,459,31,803,511,20,12.14
1,0,0,1.0,-0.0,0.16553783416748047,594.0538696111659,63,-350,-480,459,31,803,511,20,12.13
0,-1,0,-0.0,-1.0,0.2290797233581543,593.2461546440904,63,-350,-479,459,31,803,511,20,7.0
0,-1,0,-0.0,-1.0,0.23773980140686035,592.4390263984978,63,-350,-478,459,31,803,511,20,6.99
0,-3,0,-0.0,-3.0,0.24823379516601562,590.0211860602973,63,-350,-475,459,31,803,511,20,16.84
-1,-4,0,-1.0,-4.0,0.2530796527862549,586.2098600330772,63,-349,-471,459,31,803,511,20,24.89
-3,-5,0,-3.0,-5.0,0.2610807418823242,580.4067539234877,63,-346,-466,459,31,803,511,20,35.75
-4,-8,0,-4.0,-8.0,0.2690446376800537,571.6012596207255,63,-342,-458,459,31,803,511,20,45.97
-5,-8,0,-5.0,-8.0,0.2771468162536621,562.2001422980966,63,-337,-450,459,31,803,511,20,48.41
-6,-10,0,-6.0,-10.0,0.28538966178894043,550.600581183856,63,-331,-440,459,31,803,511,20,53.99
-5,-8,0,-5.0,-8.0,0.2930867671966553,541.2023651093923,63,-326,-432,459,31,803,511,20,47.24
-7,-11,0,-7.0,-11.0,0.3011436462402344,528.2063990524916,63,-319,-421,459,31,803,511,20,56.48
-7,-11,0,-7.0,-11.0,0.3091707229614258,515.2125774862255,63,-312,-410,459,31,803,511,20,55.57
-8,-12,0,-8.0,-12.0,0.31892871856689453,500.8193287004806,63,-304,-398,459,31,803,511,20,58.07
-8,-11,0,-8.0,-11.0,0.32514166831970215,487.2217154438008,63,-296,-387,459,31,803,511,20,56.39
-11,-13,0,-11.0,-13.0,0.3330848217010498,470.2137811676727,63,-285,-374,459,31,803,511,20,61.12
0,0,1,-0.0,-0.0,0.33774685859680176,470.2137811676727,63,-285,-374,459,31,803,511,20,130.13
-11,-12,1,-11.0,-12.0,0.34268879890441895,454.00440526497096,63,-274,-362,459,31,803,511,20,57.61
-13,-12,1,-13.0,-12.0,0.3492436408996582,436.6016491036194,63,-261,-350,459,31,803,511,20,57.34
-15,-14,1,-15.0,-14.0,0.3588266372680664,416.42766478705516,63,-246,-336,459,31,803,511,20,59.69
-17,-16,1,-17.0,-16.0,0.36633777618408203,393.49841168675636,63,-229,-320,459,31,803,511,20,60.87
-19,-21,1,-19.0,-21.0,0.3730638027191162,365.37788657771836,63,-210,-299,459,31,803,511,20,63.63
-20,-21,1,-20.0,-21.0,0.38111376762390137,336.72540741678523,63,-190,-278,459,31,803,511,20,60.27
-19,-21,1,-19.0,-21.0,0.3903517723083496,308.6907837950463,63,-171,-257,459,31,803,511,20,56.4
-19,-18,1,-19.0,-18.0,0.3974747657775879,283.24018076537095,63,-152,-239,459,31,803,511,20,50.43
-16,-16,1,-16.0,-16.0,0.4053816795349121,261.1991577321795,63,-136,-223,459,31,803,511,20,44.83
-14,-13,1,-14.0,-13.0,0.41306066513061523,242.86621831782205,63,-122,-210,459,31,803,511,20,38.8
-13,-11,1,-13.0,-11.0,0.42119669914245605,226.89645215384044,63,-109,-199,459,31,803,511,20,34.2
0,0,0,-0.0,-0.0,0.4282867908477783,226.89645215384044,63,-109,-199,459,31,803,511,20,80.26
-11,-10,0,-11.0,-10.0,0.4303317070007324,212.8966885604377,63,-98,-189,459,31,803,511,20,30.52
-12,-11,0,-12.0,-11.0,0.4405708312988281,197.6866206904251,63,-86,-178,459,31,803,511,20,30.15
-13,-10,0,-13.0,-10.0,0.44551968574523926,183.17477992343814,63,-73,-168,459,31,803,511,20,27.4
-11,-9,0,-11.0,-9.0,0.45307064056396484,170.66048165876012,63,-62,-159,459,31,803,511,20,23.95
-10,-7,0,-10.0,-7.0,0.464552640914917,160.64868502418562,63,-52,-152,459,31,803,511,20,19.78
-9,-6,0,-9.0,-6.0,0.469301700592041,152.2005256232711,63,-43,-146,459,31,803,511,20,16.93
-5,-4,0,-5.0,-4.0,0.4773366451263428,146.99659860010368,63,-38,-142,459,31,803,511,20,12.01
-4,-3,0,-4.0,-3.0,0.48505067825317383,143.09786860746738,63,-34,-139,459,31,803,511,20,9.49
-1,-1,0,-1.0,-1.0,0.4931018352508545,141.89080308462562,63,-33,-138,459,31,803,511,20,4.47
-1,-1,0,-1.0,-1.0,0.501173734664917,140.68759717899798,63,-32,-137,459,31,803,511,20,4.42
-1,0,0,-1.0,-0.0,0.5114858150482178,140.46351839534705,63,-31,-137,459,31,803,511,20,0.86
-1,-1,0,-1.0,-1.0,0.5174686908721924,139.26952286842948,63,-30,-136,459,31,803,511,20,4.35
-1,-2,0,-1.0,-2.0,0.5250897407531738,137.10215169719257,63,-29,-134,459,31,803,511,20,7.48
0,-2,0,-0.0,-2.0,0.5350296497344971,135.14806694880988,63,-29,-132,459,31,803,511,20,7.2
-1,-3,0,-1.0,-3.0,0.5413327217102051,132.00378782444085,63,-28,-129,459,31,803,511,20,10.26
0,-2,0,-0.0,-2.0,0.5491697788238525,130.04999038831184,63,-28,-127,459,31,803,511,20,7.07
-1,-3,0,-1.0,-3.0,0.5590837001800537,126.90547663517127,63,-27,-124,459,31,803,511,20,10.06
0,-2,0,-0.0,-2.0,0.5650618076324463,124.95199078045935,63,-27,-122,459,31,803,511,20,6.93
-1,-3,0,-1.0,-3.0,0.5731217861175537,121.80722474467596,63,-26,-119,459,31,803,511,20,9.87
-1,-3,0,-1.0,-3.0,0.5810647010803223,118.66338946785567,63,-25,-116,459,31,803,511,20,9.71
0,-4,0,-0.0,-4.0,0.5891208648681641,114.75626344561765,63,-25,-112,459,31,803,511,20,9.8
-1,-3,0,-1.0,-3.0,0.5971677303314209,111.61093136427094,63,-24,-109,459,31,803,511,20,9.48
-1,-3,0,-1.0,-3.0,0.6055388450622559,108.4665847162157,63,-23,-106,459,31,803,511,20,9.31
0,-3,0,-0.0,-3.0,0.6130588054656982,105.53672346628922,63,-23,-103,459,31,803,511,20,7.93
-1,-3,0,-1.0,-3.0,0.6216146945953369,102.39140588936164,63,-22,-100,459,31,803,511,20,9.1
-1,-4,0,-1.0,-4.0,0.6291217803955078,98.2700361249552,63,-21,-96,459,31,803,511,20,11.71
-2,-4,0,-2.0,-4.0,0.6370518207550049,93.94147114027967,63,-19,-92,459,31,803,511,20,9.05
-1,-3,0,-1.0,-3.0,0.6475567817687988,90.80198235721508,63,-18,-89,459,31,803,511,20,8.41
-2,-5,0,-2.0,-5.0,0.6530716419219971,85.5102333057278,63,-16,-84,459,31,803,511,20,10.03
-2,-4,0,-2.0,-4.0,0.6614558696746826,81.21576201698781,63,-14,-80,459,31,803,511,20,8.13
-2,-4,0,-2.0,-4.0,0.6716687679290771,76.94153624668537,63,-12,-76,459,31,803,511,20,7.79
-3,-5,0,-3.0,-5.0,0.6770918369293213,71.56814934033156,63,-9,-71,459,31,803,511,20,8.07
-2,-3,0,-2.0,-3.0,0.6862506866455078,68.3593446428504,63,-7,-68,459,31,803,511,20,5.57
-2,-3,0,-2.0,-3.0,0.6948487758636475,65.19202405202648,63,-5,-65,459,31,803,511,20,5.3
-1,-3,0,-1.0,-3.0,0.7010898590087891,62.12889826803627,63,-4,-62,459,31,803,511,20,6.04
-1,-2,0,-1.0,-2.0,0.7100207805633545,60.07495318350236,63,-3,-60,459,31,803,511,20,4.29
0,-3,0,-0.0,-3.0,0.7180438041687012,57.07889277132134,63,-3,-57,459,31,803,511,20,7.81
-1,-2,0,-1.0,-2.0,0.7251327037811279,55.036351623268054,63,-2,-55,459,31,803,511,20,4.06
-1,-2,0,-1.0,-2.0,0.7330796718597412,53.009433122794285,63,-1,-53,459,31,803,511,20,3.92
0,-3,0,-0.0,-3.0,0.7410547733306885,50.00999900019995,63,-1,-50,459,31,803,511,20,8.51
-1,-2,0,-1.0,-2.0,0.749086856842041,48.0,63,0,-48,459,31,803,511,20,3.67
0,-3,0,-0.0,-3.0,0.7571957111358643,45.0,63,0,-45,459,31,803,511,20,9.76
-1,-3,0,-1.0,-3.0,0.7687387466430664,42.01190307520001,63,1,-42,459,31,803,511,20,4.58
-1,-2,0,-1.0,-2.0,0.773134708404541,40.049968789001575,63,2,-40,459,31,803,511,20,3.19
-1,-2,0,-1.0,-2.0,0.7813987731933594,38.118237105091836,63,3,-38,459,31,803,511,20,3.01
-1,-3,0,-1.0,-3.0,0.7922618389129639,35.22782990761707,63,4,-35,459,31,803,511,20,3.82
-1,-2,0,-1.0,-2.0,0.7971048355102539,33.37663853655727,63,5,-33,459,31,803,511,20,2.58
-1,-1,0,-1.0,-1.0,0.8092367649078369,32.55764119219941,63,6,-32,459,31,803,511,20,1.21
0,-2,0,-0.0,-2.0,0.8130698204040527,30.59411708155671,63,6,-30,459,31,803,511,20,4.18
0,-1,0,-0.0,-1.0,0.8211548328399658,29.614185789921695,63,6,-29,459,31,803,511,20,3.53
0,-1,0,-0.0,-1.0,0.8290557861328125,28.635642126552707,63,6,-28,459,31,803,511,20,3.46
0,-2,0,-0.0,-2.0,0.8370816707611084,26.68332812825267,63,6,-26,459,31,803,511,20,3.81
0,-2,0,-0.0,-2.0,0.8451316356658936,24.73863375370596,63,6,-24,459,31,803,511,20,3.6
0,-1,0,-0.0,-1.0,0.8562967777252197,23.769728648009426,63,6,-23,459,31,803,511,20,3.06
0,-2,0,-0.0,-2.0,0.861109733581543,21.840329667841555,63,6,-21,459,31,803,511,20,3.27
0,-2,0,-0.0,-2.0,0.8691277503967285,19.924858845171276,63,6,-19,459,31,803,511,20,3.03
0,-1,0,-0.0,-1.0,0.8771138191223145,18.973665961010276,63,6,-18,459,31,803,511,20,2.58
0,-1,0,-0.0,-1.0,0.8850827217102051,18.027756377319946,63,6,-17,459,31,803,511,20,2.47
0,-2,0,-0.0,-2.0,0.8931427001953125,16.15549442140351,63,6,-15,459,31,803,511,20,2.47
0,-1,0,-0.0,-1.0,0.9010536670684814,15.231546211727817,63,6,-14,459,31,803,511,20,2.1
0,-1,0,-0.0,-1.0,0.9090538024902344,14.317821063276353,63,6,-13,459,31,803,511,20,1.96
0,-2,0,-0.0,-2.0,0.917238712310791,12.529964086141668,63,6,-11,459,31,803,511,20,1.79
0,-1,0,-0.0,-1.0,0.933053731918335,11.661903789690601,63,6,-10,459,31,803,511,20,1.48
1,-1,0,1.0,-1.0,0.9410707950592041,10.295630140987,63,5,-9,459,31,803,511,20,2.4
0,0,1,-0.0,-0.0,0.9741137027740479,10.295630140987,63,5,-9,459,31,803,511,20,29.97
0,0,0,-0.0,-0.0,0.1071629524230957,760.8002365930231,64,744,159,1198,199,454,40,32,175.35
2,1,0,2.0,1.0,0.16117382049560547,758.6356174079885,64,742,158,1198,199,454,40,32,13.32
3,4,0,3.0,4.0,0.1699199676513672,754.8754864214362,64,739,154,1198,199,454,40,32,18.82
3,4,0,3.0,4.0,0.17928385734558105,751.1298156776896,64,736,150,1198,199,454,40,32,18.69
4,6,0,4.0,6.0,0.18543601036071777,746.0294900337385,64,732,144,1198,199,454,40,32,23.92
5,7,0,5.0,7.0,0.19455695152282715,739.7959178043632,64,727,137,1198,199,454,40,32,28.06
7,8,0,7.0,8.0,0.20258092880249023,731.464968402452,64,720,129,1198,199,454,40,32,35.18
9,9,0,9.0,9.0,0.20939087867736816,721.0554763678035,64,711,120,1198,199,454,40,32,41.31
16,11,0,16.0,11.0,0.21716594696044922,703.4955579106381,64,695,109,1198,199,454,40,32,58.54
21,12,0,21.0,12.0,0.22559499740600586,680.9441974200236,64,674,97,1198,199,454,40,32,66.84
25,12,0,25.0,12.0,0.2331860065460205,654.5425883775631,64,649,85,1198,199,454,40,32,71.34
28,10,0,28.0,10.0,0.24119901657104492,625.5125898013564,64,621,75,1198,199,454,40,32,73.31
31,8,0,31.0,8.0,0.24918699264526367,593.7920511424854,64,590,67,1198,199,454,40,32,74.74
32,7,0,32.0,7.0,0.2571878433227539,561.2165357506851,64,558,60,1198,199,454,40,32,73.37
32,5,0,32.0,5.0,0.26518988609313965,528.8676583040411,64,526,55,1198,199,454,40,32,71.36
31,5,0,31.0,5.0,0.27326083183288574,497.51884386422995,64,495,50,1198,199,454,40,32,67.48
29,2,0,29.0,2.0,0.28114986419677734,468.46558037917794,64,466,48,1198,199,454,40,32,63.27
25,2,0,25.0,2.0,0.28922390937805176,443.3926025544405,64,441,46,1198,199,454,40,32,57.16
23,0,0,23.0,-0.0,0.29840803146362305,420.523483291956,64,418,46,1198,199,454,40,32,50.99
22,0,0,22.0,-0.0,0.30521392822265625,398.6627647523656,64,396,46,1198,199,454,40,32,47.98
22,-1,0,22.0,-1.0,0.31319284439086914,376.9416400452463,64,374,47,1198,199,454,40,32,45.57
21,-2,0,21.0,-2.0,0.3211519718170166,356.384623686264,64,353,49,1198,199,454,40,32,42.14
22,-2,0,22.0,-2.0,0.32921886444091797,334.9059569491113,64,331,51,1198,199,454,40,32,41.34
22,-2,0,22.0,-2.0,0.3373558521270752,313.5123602029113,64,309,53,1198,199,454,40,32,39.33
22,-2,0,22.0,-2.0,0.345181941986084,292.22251795506793,64,287,55,1198,199,454,40,32,37.25
21,-1,0,21.0,-1.0,0.3531630039215088,271.8308297452664,64,266,56,1198,199,454,40,32,34.7
20,0,0,20.0,-0.0,0.36177897453308105,252.29347989989753,64,246,56,1198,199,454,40,32,32.33
19,-1,0,19.0,-1.0,0.3691699504852295,234.04700382615454,64,227,57,1198,199,454,40,32,29.11
19,0,0,19.0,-0.0,0.37719202041625977,215.6687274502263,64,208,57,1198,199,454,40,32,27.74
21,0,0,21.0,-0.0,0.385221004486084,195.49424543960367,64,187,57,1198,199,454,40,32,27.12
19,1,0,19.0,1.0,0.39968299865722656,177.08754896942924,64,168,56,1198,199,454,40,32,24.13
17,1,0,17.0,1.0,0.4018418788909912,160.70469812671936,64,151,55,1198,199,454,40,32,20.96
16,2,0,16.0,2.0,0.41261982917785645,145.03103116229988,64,135,53,1198,199,454,40,32,19.21
14,2,0,14.0,2.0,0.4171779155731201,131.30879635424276,64,121,51,1198,199,454,40,32,16.55
12,1,0,12.0,1.0,0.4251828193664551,119.9208072020865,64,109,50,1198,199,454,40,32,13.5
9,1,0,9.0,1.0,0.4337129592895508,111.35977729862789,64,100,49,1198,199,454,40,32,10.75
9,1,0,9.0,1.0,0.4413130283355713,102.88342918079665,64,91,48,1198,199,454,40,32,10.01
5,0,0,5.0,-0.0,0.44919896125793457,98.48857801796105,64,86,48,1198,199,454,40,32,6.05
2,0,0,2.0,-0.0,0.4572470188140869,96.74709297958259,64,84,48,1198,199,454,40,32,3.51
3,0,0,3.0,-0.0,0.465897798538208,94.15412895885129,64,81,48,1198,199,454,40,32,4.22
1,1,0,1.0,1.0,0.4813368320465088,92.78469701410896,64,80,47,1198,199,454,40,32,4.08
1,1,0,1.0,1.0,0.5211999416351318,91.4166286842826,64,79,46,1198,199,454,40,32,4.04
1,1,0,1.0,1.0,0.529202938079834,90.0499861188218,64,78,45,1198,199,454,40,32,4.0
1,2,0,1.0,2.0,0.5371549129486084,88.19297024139736,64,77,43,1198,199,454,40,32,3.26
1,1,0,1.0,1.0,0.5456769466400146,86.83317338436964,64,76,42,1198,199,454,40,32,3.85
1,2,0,1.0,2.0,0.5540189743041992,85.0,64,75,40,1198,199,454,40,32,3.13
1,2,0,1.0,2.0,0.5611798763275146,83.18653737234169,64,74,38,1198,199,454,40,32,3.04
2,2,0,2.0,2.0,0.5691819190979004,80.49844718999243,64,72,36,1198,199,454,40,32,4.68
1,3,0,1.0,3.0,0.5774118900299072,78.29431652425353,64,71,33,1198,199,454,40,32,2.87
2,4,0,2.0,4.0,0.5851559638977051,74.84650960465692,64,69,29,1198,199,454,40,32,3.92
1,3,0,1.0,3.0,0.59322190284729,72.80109889280519,64,68,26,1198,199,454,40,32,2.49
1,3,0,1.0,3.0,0.6013908386230469,70.83784299369935,64,67,23,1198,199,454,40,32,2.32
2,3,0,2.0,3.0,0.6105339527130127,68.00735254367721,64,65,20,1198,199,454,40,32,3.32
2,3,0,2.0,3.0,0.6175780296325684,65.25335240430181,64,63,17,1198,199,454,40,32,3.11
4,4,0,4.0,4.0,0.6251988410949707,60.41522986797286,64,59,13,1198,199,454,40,32,4.55
4,2,0,4.0,2.0,0.6348438262939453,56.089214649520635,64,55,11,1198,199,454,40,32,5.18
3,4,0,3.0,4.0,0.6411638259887695,52.46903848937962,64,52,7,1198,199,454,40,32,3.0
4,3,0,4.0,3.0,0.6501138210296631,48.16637831516918,64,48,4,1198,199,454,40,32,3.7
2,1,0,2.0,1.0,0.6580328941345215,46.09772228646444,64,46,3,1198,199,454,40,32,3.07
2,1,0,2.0,1.0,0.6651768684387207,44.04543109109048,64,44,2,1198,199,454,40,32,2.93
3,2,0,3.0,2.0,0.6732738018035889,41.0,64,41,0,1198,199,454,40,32,2.75
3,1,0,3.0,1.0,0.682420015335083,38.01315561749642,64,38,-1,1198,199,454,40,32,3.39
2,1,0,2.0,1.0,0.6891708374023438,36.05551275463989,64,36,-2,1198,199,454,40,32,2.35
4,1,0,4.0,1.0,0.6981940269470215,32.14031735997639,64,32,-3,1198,199,454,40,32,3.5
3,0,0,3.0,-0.0,0.7062389850616455,29.154759474226502,64,29,-3,1198,199,454,40,32,4.7
4,1,0,4.0,1.0,0.7132198810577393,25.317977802344327,64,25,-4,1198,199,454,40,32,2.84
2,0,0,2.0,-0.0,0.7212519645690918,23.345235059857504,64,23,-4,1198,199,454,40,32,3.49
2,1,0,2.0,1.0,0.7304368019104004,21.587033144922902,64,21,-5,1198,199,454,40,32,1.33
3,0,0,3.0,-0.0,0.7371668815612793,18.681541692269406,64,18,-5,1198,199,454,40,32,2.81
2,0,0,2.0,-0.0,0.745189905166626,16.76305461424021,64,16,-5,1198,199,454,40,32,2.39
1,0,0,1.0,-0.0,0.7544939517974854,15.811388300841896,64,15,-5,1198,199,454,40,32,2.21
1,0,0,1.0,-0.0,0.7611849308013916,14.866068747318506,64,14,-5,1198,199,454,40,32,2.08
1,0,0,1.0,-0.0,0.7691609859466553,13.92838827718412,64,13,-5,1198,199,454,40,32,1.95
1,1,0,1.0,1.0,0.7771480083465576,13.416407864998739,64,12,-6,1198,199,454,40,32,-0.07
0,0,1,-0.0,-0.0,0.7922089099884033,54.70831746635972,65,-28,-47,1158,158,1186,205,25,33.5
1,0,1,1.0,-0.0,0.795490026473999,55.226805085936306,65,-29,-47,1158,158,1186,205,25,2.47
1,0,1,1.0,-0.0,0.04486489295959473,55.758407437802596,65,-30,-47,1158,158,1186,205,25,2.46
0,0,0,-0.0,-0.0,0.10679006576538086,55.758407437802596,65,-30,-47,1158,158,1186,205,25,33.82
-1,1,0,-1.0,1.0,0.11041092872619629,56.08029957123981,65,-29,-48,1158,158,1186,205,25,3.12
-2,1,0,-2.0,1.0,0.11774086952209473,55.94640292279746,65,-27,-49,1158,158,1186,205,25,0.02
-1,2,0,-1.0,2.0,0.12479496002197266,57.245087125446844,65,-26,-51,1158,158,1186,205,25,1.24
-1,1,0,-1.0,1.0,0.13282084465026855,57.697486947006624,65,-25,-52,1158,158,1186,205,25,2.47
-2,2,0,-2.0,2.0,0.1470189094543457,58.69412236331676,65,-23,-54,1158,158,1186,205,25,1.12
-2,2,0,-2.0,2.0,0.14879798889160156,59.80802621722272,65,-21,-56,1158,158,1186,205,25,1.07
-2,2,0,-2.0,2.0,0.15842199325561523,61.032778078668514,65,-19,-58,1158,158,1186,205,25,1.05
-2,2,0,-2.0,2.0,0.1648569107055664,62.36184731067546,65,-17,-60,1158,158,1186,205,25,1.05
-2,2,0,-2.0,2.0,0.17278099060058594,63.788713735268246,65,-15,-62,1158,158,1186,205,25,1.06
-3,2,0,-3.0,2.0,0.18075799942016602,65.11528238439882,65,-12,-64,1158,158,1186,205,25,0.87
-4,3,0,-4.0,3.0,0.18880796432495117,67.47592163134935,65,-8,-67,1158,158,1186,205,25,0.47
-5,2,0,-5.0,2.0,0.19678497314453125,69.06518659932803,65,-3,-69,1158,158,1186,205,25,0.51
-5,2,0,-5.0,2.0,0.20577788352966309,71.02816342831905,65,2,-71,1158,158,1186,205,25,0.46
-6,2,0,-6.0,2.0,0.21279406547546387,73.43704787094863,65,8,-73,1158,158,1186,205,25,0.3
-5,0,0,-5.0,-0.0,0.22163701057434082,74.14849964766651,65,13,-73,1158,158,1186,205,25,1.44
-4,1,0,-4.0,1.0,0.23014307022094727,75.92759709091287,65,17,-74,1158,158,1186,205,25,0.8
-1,0,0,-1.0,-0.0,0.23687100410461426,76.15773105863909,65,18,-74,1158,158,1186,205,25,5.16
-1,0,0,-1.0,-0.0,0.27676892280578613,76.40026177965623,65,19,-74,1158,158,1186,205,25,4.97
-1,-1,0,-1.0,-1.0,0.284837007522583,75.69015788066504,65,20,-73,1158,158,1186,205,25,1.44
-1,-4,0,-1.0,-4.0,0.29277801513671875,72.12489168102785,65,21,-69,1158,158,1186,205,25,5.11
0,-3,0,-0.0,-3.0,0.3007678985595703,69.26037828369117,65,21,-66,1158,158,1186,205,25,5.2
-1,-5,0,-1.0,-5.0,0.30888795852661133,64.8459713474939,65,22,-61,1158,158,1186,205,25,5.44
0,-5,0,-0.0,-5.0,0.31683993339538574,60.166435825965294,65,22,-56,1158,158,1186,205,25,5.93
0,-5,0,-0.0,-5.0,0.3247849941253662,55.54277630799526,65,22,-51,1158,158,1186,205,25,5.51
1,-5,0,1.0,-5.0,0.3336009979248047,50.566787519082126,65,21,-46,1158,158,1186,205,25,6.25
1,-6,0,1.0,-6.0,0.34077906608581543,44.721359549995796,65,20,-40,1158,158,1186,205,25,5.97
1,-5,0,1.0,-5.0,0.3488180637359619,39.824615503479755,65,19,-35,1158,158,1186,205,25,5.15
2,-5,0,2.0,-5.0,0.3571300506591797,34.48187929913333,65,17,-30,1158,158,1186,205,25,6.11
2,-4,0,2.0,-4.0,0.3647749423980713,30.01666203960727,65,15,-26,1158,158,1186,205,25,6.5
2,-5,0,2.0,-5.0,0.3727898597717285,24.698178070456937,65,13,-21,1158,158,1186,205,25,4.99
1,-4,0,1.0,-4.0,0.38124895095825195,20.808652046684813,65,12,-17,1158,158,1186,205,25,3.13
1,-5,0,1.0,-5.0,0.39249205589294434,16.278820596099706,65,11,-12,1158,158,1186,205,25,2.35
1,-4,0,1.0,-4.0,0.3968038558959961,12.806248474865697,65,10,-8,1158,158,1186,205,25,1.48
1,-3,0,1.0,-3.0,0.40479493141174316,10.295630140987,65,9,-5,1158,158,1186,205,25,0.84
1,-4,0,1.0,-4.0,0.41276097297668457,8.06225774829855,65,8,-1,1158,158,1186,205,25,-0.38
1,-3,0,1.0,-3.0,0.4207918643951416,7.280109889280518,65,7,2,1158,158,1186,205,25,-1.19
0,-2,0,-0.0,-2.0,0.4288020133972168,8.06225774829855,65,7,4,1158,158,1186,205,25,-0.48
0,-2,0,-0.0,-2.0,0.4367830753326416,9.219544457292887,65,7,6,1158,158,1186,205,25,-0.33
0,-1,0,-0.0,-1.0,0.44478607177734375,9.899494936611665,65,7,7,1158,158,1186,205,25,0.82
1,-2,0,1.0,-2.0,0.4527740478515625,10.816653826391969,65,6,9,1158,158,1186,205,25,-0.33
0,0,1,-0.0,-0.0,0.4927949905395508,10.816653826391969,65,6,9,1158,158,1186,205,25,30.13
0,0,0,-0.0,-0.0,0.1055593490600586,1124.079178705842,66,-995,523,157,672,1152,149,41,219.61
-1,1,0,-1.0,1.0,0.1885523796081543,1122.728818548807,66,-994,522,157,672,1152,149,41,9.22
-4,5,0,-4.0,5.0,0.19657349586486816,1116.8657036546515,66,-990,517,157,672,1152,149,41,28.49
-7,6,0,-7.0,6.0,0.20500445365905762,1107.8853731320764,66,-983,511,157,672,1152,149,41,40.67
-10,9,0,-10.0,9.0,0.21253442764282227,1094.8666585479714,66,-973,502,157,672,1152,149,41,53.09
-12,7,0,-12.0,7.0,0.22060537338256836,1080.9930619573838,66,-961,495,157,672,1152,149,41,57.17
-13,8,0,-13.0,8.0,0.22884249687194824,1065.7734280793456,66,-948,487,157,672,1152,149,41,59.97
-13,9,0,-13.0,9.0,0.24553251266479492,1050.0995190933095,66,-935,478,157,672,1152,149,41,60.0
-14,9,0,-14.0,9.0,0.24610042572021484,1033.5385817665444,66,-921,469,157,672,1152,149,41,62.09
-19,12,0,-19.0,12.0,0.2528693675994873,1011.1641805364745,66,-902,457,157,672,1152,149,41,74.45
-21,13,0,-21.0,13.0,0.26056337356567383,986.5581584478433,66,-881,444,157,672,1152,149,41,77.85
-22,13,0,-22.0,13.0,0.27091336250305176,961.0629531929737,66,-859,431,157,672,1152,149,41,78.62
-24,14,0,-24.0,14.0,0.27678751945495605,933.3348809510978,66,-835,417,157,672,1152,149,41,81.2
-23,16,0,-23.0,16.0,0.28456735610961914,905.6185731310948,66,-812,401,157,672,1152,149,41,78.75
-24,16,0,-24.0,16.0,0.2925255298614502,877.022804720607,66,-788,385,157,672,1152,149,41,78.82
-23,16,0,-23.0,16.0,0.3005654811859131,849.3444530930899,66,-765,369,157,672,1152,149,41,75.72
-25,19,0,-25.0,19.0,0.3085353374481201,818.5963596303126,66,-740,350,157,672,1152,149,41,78.2
-23,19,0,-23.0,19.0,0.3165304660797119,789.7151385151484,66,-717,331,157,672,1152,149,41,73.63
-22,20,0,-22.0,20.0,0.3246574401855469,761.4105331554063,66,-695,311,157,672,1152,149,41,70.92
-21,20,0,-21.0,20.0,0.3326883316040039,734.1369082126304,66,-674,291,157,672,1152,149,41,67.75
-21,17,0,-21.0,17.0,0.34262943267822266,708.1560562474913,66,-653,274,157,672,1152,149,41,64.72
-19,17,0,-19.0,17.0,0.34868645668029785,684.1089094581359,66,-634,257,157,672,1152,149,41,60.24
-19,15,0,-19.0,15.0,0.35726451873779297,660.9001437433647,66,-615,242,157,672,1152,149,41,57.93
-16,14,0,-16.0,14.0,0.3645365238189697,640.9251126301731,66,-599,228,157,672,1152,149,41,51.49
-17,13,0,-17.0,13.0,0.3726053237915039,620.4425839672838,66,-582,215,157,672,1152,149,41,51.51
-18,13,0,-18.0,13.0,0.38054847717285156,599.0826320300064,66,-564,202,157,672,1152,149,41,51.82
-19,12,0,-19.0,12.0,0.3885483741760254,577.1698190307598,66,-545,190,157,672,1152,149,41,51.73
-18,13,0,-18.0,13.0,0.3965463638305664,555.9298516899412,66,-527,177,157,672,1152,149,41,49.17
-19,11,0,-19.0,11.0,0.40453147888183594,534.4342803376295,66,-508,166,157,672,1152,149,41,48.81
-18,11,0,-18.0,11.0,0.4125354290008545,513.9309292113095,66,-490,155,157,672,1152,149,41,46.04
-17,8,0,-17.0,8.0,0.42056751251220703,495.31606071275337,66,-473,147,157,672,1152,149,41,43.05
-16,8,0,-16.0,8.0,0.4285914897918701,477.67143519369046,66,-457,139,157,672,1152,149,41,40.41
-15,7,0,-15.0,7.0,0.4378163814544678,461.2894969539194,66,-442,132,157,672,1152,149,41,37.86
-14,5,0,-14.0,5.0,0.4445374011993408,446.4448454176619,66,-428,127,157,672,1152,149,41,36.0
-13,5,0,-13.0,5.0,0.4525434970855713,432.560978360277,66,-415,122,157,672,1152,149,41,33.36
-15,5,0,-15.0,5.0,0.46067333221435547,416.7601228524629,66,-400,117,157,672,1152,149,41,36.34
-14,3,0,-14.0,3.0,0.47240352630615234,402.4822977473668,66,-386,114,157,672,1152,149,41,32.57
-15,4,0,-15.0,4.0,0.4766554832458496,386.9638225984439,66,-371,110,157,672,1152,149,41,34.66
-15,4,0,-15.0,4.0,0.48511743545532227,371.4458237751503,66,-356,106,157,672,1152,149,41,33.77
-16,3,0,-16.0,3.0,0.49254631996154785,355.25906040522034,66,-340,103,157,672,1152,149,41,32.17
-16,4,0,-16.0,4.0,0.5007803440093994,338.7875440449368,66,-324,99,157,672,1152,149,41,32.47
-16,3,0,-16.0,3.0,0.5100514888763428,322.6143208228674,66,-308,96,157,672,1152,149,41,30.12
-16,4,0,-16.0,4.0,0.5165374279022217,306.15028989043924,66,-292,92,157,672,1152,149,41,30.28
-17,3,0,-17.0,3.0,0.5245504379272461,289.0432493589843,66,-275,89,157,672,1152,149,41,28.81
-16,4,0,-16.0,4.0,0.5336654186248779,272.5912691191704,66,-259,85,157,672,1152,149,41,27.89
-16,3,0,-16.0,3.0,0.5405983924865723,256.46247288833507,66,-243,82,157,672,1152,149,41,25.64
-16,3,0,-16.0,3.0,0.5486035346984863,240.35390573069537,66,-227,79,157,672,1152,149,41,24.45
-12,4,0,-12.0,4.0,0.5565495491027832,227.705950734714,66,-215,75,157,672,1152,149,41,22.93
-12,3,0,-12.0,3.0,0.5666863918304443,215.3903433304288,66,-203,72,157,672,1152,149,41,19.81
-11,4,0,-11.0,4.0,0.5725734233856201,203.68603290358425,66,-192,68,157,672,1152,149,41,20.96
-12,3,0,-12.0,3.0,0.5805623531341553,191.3765920900464,66,-180,65,157,672,1152,149,41,18.31
-11,3,0,-11.0,3.0,0.590733528137207,180.01388835309348,66,-169,62,157,672,1152,149,41,17.02
-12,3,0,-12.0,3.0,0.597170352935791,167.72000476985446,66,-157,59,157,672,1152,149,41,16.68
-11,3,0,-11.0,3.0,0.6045563220977783,156.37135287513502,66,-146,56,157,672,1152,149,41,15.4
-10,3,0,-10.0,3.0,0.6140923500061035,145.96232390586277,66,-136,53,157,672,1152,149,41,14.33
-9,2,0,-9.0,2.0,0.6205563545227051,136.8575902169843,66,-127,51,157,672,1152,149,41,11.88
-8,3,0,-8.0,3.0,0.6285693645477295,128.3160161476345,66,-119,48,157,672,1152,149,41,13.29
-7,1,0,-7.0,1.0,0.6365375518798828,121.46192819151193,66,-112,47,157,672,1152,149,41,8.77
-8,3,0,-8.0,3.0,0.6445674896240234,112.92475370794483,66,-104,44,157,672,1152,149,41,11.94
-9,2,0,-9.0,2.0,0.6525595188140869,103.87011119662864,66,-95,42,157,672,1152,149,41,9.77
-9,2,0,-9.0,2.0,0.6623883247375488,94.847245611035,66,-86,40,157,672,1152,149,41,9.1
-8,2,0,-8.0,2.0,0.6685655117034912,86.76404785393545,66,-78,38,157,672,1152,149,41,8.17
-7,2,0,-7.0,2.0,0.6765353679656982,79.60527620704548,66,-71,36,157,672,1152,149,41,7.41
-6,2,0,-6.0,2.0,0.6860754489898682,73.35529974037323,66,-65,34,157,672,1152,149,41,6.88
-6,1,0,-6.0,1.0,0.6925663948059082,67.60177512462228,66,-59,33,157,672,1152,149,41,5.29
-7,2,0,-7.0,2.0,0.7008013725280762,60.53924347066124,66,-52,31,157,672,1152,149,41,5.94
-6,2,0,-6.0,2.0,0.708545446395874,54.378304497290095,66,-46,29,157,672,1152,149,41,5.35
-3,1,0,-3.0,1.0,0.7167685031890869,51.31276644267,66,-43,28,157,672,1152,149,41,3.9
-2,1,0,-2.0,1.0,0.7245604991912842,49.09175083453431,66,-41,27,157,672,1152,149,41,4.55
-2,1,0,-2.0,1.0,0.7340683937072754,46.87216658103186,66,-39,26,157,672,1152,149,41,4.44
-3,1,0,-3.0,1.0,0.7405414581298828,43.829214001622255,66,-36,25,157,672,1152,149,41,3.51
-3,2,0,-3.0,2.0,0.7487854957580566,40.22437072223753,66,-33,23,157,672,1152,149,41,6.84
-4,1,0,-4.0,1.0,0.7572505474090576,36.40054944640259,66,-29,22,157,672,1152,149,41,2.97
-3,1,0,-3.0,1.0,0.7645413875579834,33.421549934136806,66,-26,21,157,672,1152,149,41,2.81
-3,1,0,-3.0,1.0,0.7729284763336182,30.479501308256342,66,-23,20,157,672,1152,149,41,2.54
-1,1,0,-1.0,1.0,0.7809133529663086,29.068883707497267,66,-22,19,157,672,1152,149,41,4.48
-2,1,0,-2.0,1.0,0.7885425090789795,26.90724809414742,66,-20,18,157,672,1152,149,41,2.81
-3,1,0,-3.0,1.0,0.7970123291015625,24.041630560342615,66,-17,17,157,672,1152,149,41,2.01
-2,1,0,-2.0,1.0,0.8045485019683838,21.93171219946131,66,-15,16,157,672,1152,149,41,2.22
-2,1,0,-2.0,1.0,0.8199234008789062,19.849433241279208,66,-13,15,157,672,1152,149,41,1.98
-1,0,0,-1.0,-0.0,0.8207504749298096,19.209372712298546,66,-12,15,157,672,1152,149,41,0.71
-1,1,0,-1.0,1.0,0.8303623199462891,17.804493814764857,66,-11,14,157,672,1152,149,41,3.53
-1,0,0,-1.0,-0.0,0.8380584716796875,17.204650534085253,66,-10,14,157,672,1152,149,41,0.56
-2,1,0,-2.0,1.0,0.8447093963623047,15.264337522473747,66,-8,13,157,672,1152,149,41,1.22
-1,0,0,-1.0,-0.0,0.8547713756561279,14.7648230602334,66,-7,13,157,672,1152,149,41,0.29
-1,1,0,-1.0,1.0,0.8605594635009766,13.416407864998739,66,-6,12,157,672,1152,149,41,1.97
0,0,1,-0.0,-0.0,0.8668444156646729,13.416407864998739,66,-6,12,157,672,1152,149,41,30.91
-1,1,1,-1.0,1.0,0.868572473526001,12.083045973594572,66,-5,11,157,672,1152,149,41,11.74
0,0,0,-0.0,-0.0,0.08174562454223633,1036.3329580786283,67,1031,-105,1193,556,162,661,5,209.83
5,0,0,5.0,-0.0,0.1058816909790039,1031.3588124411406,67,1026,-105,1193,556,162,661,5,104.86
7,0,0,7.0,-0.0,0.11379361152648926,1024.395431461894,67,1019,-105,1193,556,162,661,5,121.25
8,0,0,8.0,-0.0,0.12174558639526367,1016.4378977586383,67,1011,-105,1193,556,162,661,5,127.14
10,-1,0,10.0,-1.0,0.12970757484436035,1006.388096114019,67,1001,-104,1193,556,162,661,5,139.7
11,0,0,11.0,-0.0,0.13813567161560059,995.4476380001109,67,990,-104,1193,556,162,661,5,139.92
13,0,0,13.0,-0.0,0.14968180656433105,982.5197199038806,67,977,-104,1193,556,162,661,5,145.69
16,0,0,16.0,-0.0,0.15398669242858887,966.611090356406,67,961,-104,1193,556,162,661,5,152.03
17,0,0,17.0,-0.0,0.16170358657836914,949.7115351515954,67,944,-104,1193,556,162,661,5,152.54
16,-1,0,16.0,-1.0,0.16969871520996094,933.6985594933731,67,928,-103,1193,556,162,661,5,150.19
16,-2,0,16.0,-2.0,0.17784857749938965,917.5756099635604,67,912,-101,1193,556,162,661,5,150.03
16,-2,0,16.0,-2.0,0.18579578399658203,901.4527164527267,67,896,-99,1193,556,162,661,5,148.49
16,-3,0,16.0,-3.0,0.19702363014221191,885.2208763918754,67,880,-96,1193,556,162,661,5,145.52
15,-4,0,15.0,-4.0,0.20186161994934082,869.8787271798294,67,865,-92,1193,556,162,661,5,141.26
14,-3,0,14.0,-3.0,0.21015071868896484,855.6412799766033,67,851,-89,1193,556,162,661,5,137.82
15,-2,0,15.0,-2.0,0.22047162055969238,840.5147232499856,67,836,-87,1193,556,162,661,5,139.89
14,-2,0,14.0,-2.0,0.22574663162231445,826.3830830795122,67,822,-85,1193,556,162,661,5,135.93
15,-2,0,15.0,-2.0,0.23392271995544434,811.2570492759986,67,807,-83,1193,556,162,661,5,136.97
19,-2,0,19.0,-2.0,0.24616575241088867,792.1521318534717,67,788,-81,1193,556,162,661,5,143.51
21,-2,0,21.0,-2.0,0.24980473518371582,771.0577150901222,67,767,-79,1193,556,162,661,5,143.53
25,-2,0,25.0,-2.0,0.25774073600769043,745.9845842911233,67,742,-77,1193,556,162,661,5,144.13
28,-3,0,28.0,-3.0,0.26572370529174805,717.8244910839975,67,714,-74,1193,556,162,661,5,144.47
29,-2,0,29.0,-2.0,0.2737107276916504,688.7735476918375,67,685,-72,1193,556,162,661,5,139.96
30,-2,0,30.0,-2.0,0.2817716598510742,658.729838401146,67,655,-70,1193,556,162,661,5,136.69
32,-2,0,32.0,-2.0,0.28977465629577637,626.7000877612832,67,623,-68,1193,556,162,661,5,133.48
31,-2,0,31.0,-2.0,0.29881978034973145,595.6676925937817,67,592,-66,1193,556,162,661,5,128.76
30,-3,0,30.0,-3.0,0.3057396411895752,565.5201145847954,67,562,-63,1193,556,162,661,5,125.41
31,-3,0,31.0,-3.0,0.3137485980987549,534.379078931801,67,531,-60,1193,556,162,661,5,121.3
29,-4,0,29.0,-4.0,0.3217027187347412,505.11384855297723,67,502,-56,1193,556,162,661,5,115.62
26,-5,0,26.0,-5.0,0.3301737308502197,478.72434657117657,67,476,-51,1193,556,162,661,5,108.72
22,-4,0,22.0,-4.0,0.3379178047180176,456.4263357870578,67,454,-47,1193,556,162,661,5,102.64
21,-3,0,21.0,-3.0,0.3457295894622803,435.22982434571276,67,433,-44,1193,556,162,661,5,99.34
19,-3,0,19.0,-3.0,0.3540356159210205,416.0252396189443,67,414,-41,1193,556,162,661,5,94.27
22,-4,0,22.0,-4.0,0.36170172691345215,393.7423015120423,67,392,-37,1193,556,162,661,5,92.9
20,-3,0,20.0,-3.0,0.37070560455322266,373.5505320569093,67,372,-34,1193,556,162,661,5,88.58
22,-5,0,22.0,-5.0,0.3795506954193115,351.1993735757511,67,350,-29,1193,556,162,661,5,85.38
20,-4,0,20.0,-4.0,0.38586974143981934,330.94561486745823,67,330,-25,1193,556,162,661,5,80.72
21,-4,0,21.0,-4.0,0.39374375343322754,309.7127701597078,67,309,-21,1193,556,162,661,5,77.78
19,-4,0,19.0,-4.0,0.4081127643585205,290.49784852903815,67,290,-17,1193,556,162,661,5,72.75
19,-3,0,19.0,-3.0,0.4101696014404297,271.3613826615718,67,271,-14,1193,556,162,661,5,69.77
20,-3,0,20.0,-3.0,0.4212467670440674,251.24092023394596,67,251,-11,1193,556,162,661,5,66.72
19,-3,0,19.0,-3.0,0.42572665214538574,232.13789005675054,67,232,-8,1193,556,162,661,5,62.3
21,-4,0,21.0,-4.0,0.43381667137145996,211.03791128610044,67,211,-4,1193,556,162,661,5,58.84
18,-3,0,18.0,-3.0,0.44396162033081055,193.00259065618783,67,193,-1,1193,556,162,661,5,53.68
17,-4,0,17.0,-4.0,0.4497838020324707,176.02556632489498,67,176,3,1193,556,162,661,5,49.04
16,-3,0,16.0,-3.0,0.45775270462036133,160.11246047700348,67,160,6,1193,556,162,661,5,45.31
16,-4,0,16.0,-4.0,0.468059778213501,144.34680460612904,67,144,10,1193,556,162,661,5,41.48
15,-3,0,15.0,-3.0,0.4737546443939209,129.65338406690356,67,129,13,1193,556,162,661,5,37.85
12,-3,0,12.0,-3.0,0.48174071311950684,118.0889495253472,67,117,16,1193,556,162,661,5,33.0
12,-3,0,12.0,-3.0,0.49156880378723145,106.70520137275409,67,105,19,1193,556,162,661,5,30.4
10,-1,0,10.0,-1.0,0.497788667678833,97.082439194738,67,95,20,1193,556,162,661,5,27.55
9,-1,0,9.0,-1.0,0.5057876110076904,88.52683209061533,67,86,21,1193,556,162,661,5,24.74
5,-1,0,5.0,-1.0,0.5137107372283936,83.93449827097318,67,81,22,1193,556,162,661,5,18.34
4,0,0,4.0,-0.0,0.5217516422271729,80.0812087820857,67,77,22,1193,556,162,661,5,17.08
2,0,0,2.0,-0.0,0.5297107696533203,78.16009211867653,67,75,22,1193,556,162,661,5,11.66
1,-1,0,1.0,-1.0,0.5377795696258545,77.4919350642375,67,74,23,1193,556,162,661,5,4.46
1,0,0,1.0,-0.0,0.54604172706604,76.53757247260981,67,73,23,1193,556,162,661,5,7.64
1,1,0,1.0,1.0,0.6417417526245117,75.28612089887484,67,72,22,1193,556,162,661,5,8.19
2,3,0,2.0,3.0,0.6497406959533691,72.53275122315436,67,70,19,1193,556,162,661,5,12.22
2,2,0,2.0,2.0,0.6577126979827881,70.09279563550022,67,68,17,1193,556,162,661,5,11.57
2,2,0,2.0,2.0,0.6659166812896729,67.68308503607086,67,66,15,1193,556,162,661,5,11.18
2,2,0,2.0,2.0,0.6739206314086914,65.30696746902278,67,64,13,1193,556,162,661,5,10.79
2,2,0,2.0,2.0,0.681715726852417,62.96824596572466,67,62,11,1193,556,162,661,5,10.39
3,2,0,3.0,2.0,0.6897106170654297,59.682493245507096,67,59,9,1193,556,162,661,5,12.63
2,2,0,2.0,2.0,0.6977217197418213,57.42821606144492,67,57,7,1193,556,162,661,5,9.49
3,2,0,3.0,2.0,0.7057087421417236,54.230987451824994,67,54,5,1193,556,162,661,5,11.58
3,1,0,3.0,1.0,0.7141306400299072,51.15662224971465,67,51,4,1193,556,162,661,5,11.99
2,1,0,2.0,1.0,0.7217037677764893,49.09175083453431,67,49,3,1193,556,162,661,5,8.95
2,1,0,2.0,1.0,0.7297146320343018,47.042533945356304,67,47,2,1193,556,162,661,5,8.65
2,0,0,2.0,-0.0,0.7378396987915039,45.044422518220834,67,45,2,1193,556,162,661,5,11.3
2,0,0,2.0,-0.0,0.7462456226348877,43.04648650006177,67,43,2,1193,556,162,661,5,11.06
4,1,0,4.0,1.0,0.7537107467651367,39.01281840626232,67,39,1,1193,556,162,661,5,11.89
3,0,0,3.0,-0.0,0.7617626190185547,36.013886210738214,67,36,1,1193,556,162,661,5,12.69
2,1,0,2.0,1.0,0.7698097229003906,34.0,67,34,0,1193,556,162,661,5,7.15
2,0,0,2.0,-0.0,0.777735710144043,32.0,67,32,0,1193,556,162,661,5,12.34
2,0,0,2.0,-0.0,0.7857437133789062,30.0,67,30,0,1193,556,162,661,5,12.16
2,0,0,2.0,-0.0,0.793745756149292,28.0,67,28,0,1193,556,162,661,5,11.99
1,1,0,1.0,1.0,0.8081285953521729,27.018512172212592,67,27,-1,1193,556,162,661,5,3.59
2,0,0,2.0,-0.0,0.8097245693206787,25.019992006393608,67,25,-1,1193,556,162,661,5,9.46
1,1,0,1.0,1.0,0.81772780418396,24.08318915758459,67,24,-2,1193,556,162,661,5,3.22
2,0,0,2.0,-0.0,0.8258717060089111,22.090722034374522,67,22,-2,1193,556,162,661,5,8.13
2,0,0,2.0,-0.0,0.8337476253509521,20.09975124224178,67,20,-2,1193,556,162,661,5,7.78
1,1,0,1.0,1.0,0.8417177200317383,19.235384061671343,67,19,-3,1193,556,162,661,5,2.61
2,0,0,2.0,-0.0,0.8497905731201172,17.26267650163207,67,17,-3,1193,556,162,661,5,6.66
2,1,0,2.0,1.0,0.8581247329711914,15.524174696260024,67,15,-4,1193,556,162,661,5,4.05
3,1,0,3.0,1.0,0.8674526214599609,13.0,67,12,-5,1193,556,162,661,5,4.59
2,0,0,2.0,-0.0,0.873741626739502,11.180339887498949,67,10,-5,1193,556,162,661,5,4.29
1,1,0,1.0,1.0,0.8817496299743652,10.816653826391969,67,9,-6,1193,556,162,661,5,0.39
1,0,0,1.0,-0.0,0.88995361328125,10.0,67,8,-6,1193,556,162,661,5,2.45
1,0,0,1.0,-0.0,0.8977386951446533,9.219544457292887,67,7,-6,1193,556,162,661,5,2.17
0,1,0,-0.0,1.0,0.9062166213989258,9.899494936611665,67,7,-7,1193,556,162,661,5,3.09
2,0,0,2.0,-0.0,0.914557695388794,8.602325267042627,67,5,-7,1193,556,162,661,5,2.15
1,0,0,1.0,-0.0,0.9217836856842041,8.06225774829855,67,4,-7,1193,556,162,661,5,1.05
2,0,0,2.0,-0.0,0.9302246570587158,7.280109889280518,67,2,-7,1193,556,162,661,5,0.69
1,0,0,1.0,-0.0,0.9377295970916748,7.0710678118654755,67,1,-7,1193,556,162,661,5,-0.12
1,0,0,1.0,-0.0,0.9459497928619385,7.0,67,0,-7,1193,556,162,661,5,-0.54
1,1,0,1.0,1.0,0.955000638961792,8.06225774829855,67,-1,-8,1193,556,162,661,5,1.78
1,0,0,1.0,-0.0,0.9700536727905273,8.246211251235321,67,-2,-8,1193,556,162,661,5,6.01
-1,0,0,-1.0,-0.0,1.0657176971435547,8.06225774829855,67,-1,-8,1193,556,162,661,5,-0.1
0,-1,0,-0.0,-1.0,1.0737566947937012,7.0710678118654755,67,-1,-7,1193,556,162,661,5,4.51
-1,0,0,-1.0,-0.0,1.0822606086730957,7.0,67,0,-7,1193,556,162,661,5,-0.54
-1,0,0,-1.0,-0.0,1.0978736877441406,7.0710678118654755,67,1,-7,1193,556,162,661,5,8.34
-1,0,0,-1.0,-0.0,1.105743646621704,7.280109889280518,67,2,-7,1193,556,162,661,5,5.39
0,-1,0,-0.0,-1.0,1.1220695972442627,6.324555320336759,67,2,-6,1193,556,162,661,5,3.21
0,-1,0,-0.0,-1.0,1.1357307434082031,5.385164807134504,67,2,-5,1193,556,162,661,5,2.79
0,-1,0,-0.0,-1.0,1.161733627319336,4.47213595499958,67,2,-4,1193,556,162,661,5,2.3
0,-1,0,-0.0,-1.0,1.1857366561889648,3.605551275463989,67,2,-3,1193,556,162,661,5,1.69
0,-1,0,-0.0,-1.0,1.2097606658935547,2.8284271247461903,67,2,-2,1193,556,162,661,5,0.93
0,0,1,-0.0,-0.0,1.2377147674560547,2.8284271247461903,67,2,-2,1193,556,162,661,5,27.76
0,0,0,-0.0,-0.0,0.09939980506896973,436.381713640707,68,427,-90,1618,468,1191,558,6,124.02
1,-1,0,1.0,-1.0,0.26450395584106445,435.19765624368887,68,426,-89,1618,468,1191,558,6,20.82
4,-2,0,4.0,-2.0,0.2756979465484619,430.8746917608413,68,422,-87,1618,468,1191,558,6,51.26
7,-3,0,7.0,-3.0,0.2804069519042969,423.415871218829,68,415,-84,1618,468,1191,558,6,66.49
7,-4,0,7.0,-4.0,0.28841400146484375,415.76916672596104,68,408,-80,1618,468,1191,558,6,65.75
7,-4,0,7.0,-4.0,0.29638099670410156,408.1384568991263,68,401,-76,1618,468,1191,558,6,64.86
6,-4,0,6.0,-4.0,0.3043990135192871,401.50840588959034,68,395,-72,1618,468,1191,558,6,60.02
9,-4,0,9.0,-4.0,0.31319594383239746,391.9438735329333,68,386,-68,1618,468,1191,558,6,69.45
13,-4,0,13.0,-4.0,0.3240509033203125,378.4507894033252,68,373,-64,1618,468,1191,558,6,76.86
14,-3,0,14.0,-3.0,0.3285698890686035,364.1455752854894,68,359,-61,1618,468,1191,558,6,77.49
16,-3,0,16.0,-3.0,0.33638978004455566,347.8692283028207,68,343,-58,1618,468,1191,558,6,78.61
16,-3,0,16.0,-3.0,0.34444499015808105,331.59312417479345,68,327,-55,1618,468,1191,558,6,76.11
17,-3,0,17.0,-3.0,0.3523600101470947,314.33103569326397,68,310,-52,1618,468,1191,558,6,75.09
18,-2,0,18.0,-2.0,0.36040282249450684,296.24989451474914,68,292,-50,1618,468,1191,558,6,71.16
19,-2,0,19.0,-2.0,0.36836791038513184,277.1876620630868,68,273,-48,1618,468,1191,558,6,68.6
19,-3,0,19.0,-3.0,0.3763918876647949,257.9554225055174,68,254,-45,1618,468,1191,558,6,66.83
17,-2,0,17.0,-2.0,0.3845679759979248,240.8692591427972,68,237,-43,1618,468,1191,558,6,60.83
16,-3,0,16.0,-3.0,0.3923459053039551,224.59073890078372,68,221,-40,1618,468,1191,558,6,59.37
16,-2,0,16.0,-2.0,0.400393009185791,208.4922060893404,68,205,-38,1618,468,1191,558,6,54.32
12,-2,0,12.0,-2.0,0.4084179401397705,196.32880583347927,68,193,-36,1618,468,1191,558,6,49.52
11,-1,0,11.0,-1.0,0.41635680198669434,185.33483212823216,68,182,-35,1618,468,1191,558,6,44.39
8,-2,0,8.0,-2.0,0.4246668815612793,177.1016657177453,68,174,-33,1618,468,1191,558,6,39.61
7,-1,0,7.0,-1.0,0.432614803314209,170.03823099526764,68,167,-32,1618,468,1191,558,6,36.56
7,-2,0,7.0,-2.0,0.44382286071777344,162.78820596099706,68,160,-30,1618,468,1191,558,6,35.08
7,-3,0,7.0,-3.0,0.44838786125183105,155.36408851468863,68,153,-27,1618,468,1191,558,6,33.1
7,-3,0,7.0,-3.0,0.4579489231109619,147.95945390545344,68,146,-24,1618,468,1191,558,6,31.88
7,-3,0,7.0,-3.0,0.4672567844390869,140.57738082636197,68,139,-21,1618,468,1191,558,6,30.65
7,-3,0,7.0,-3.0,0.472930908203125,133.2216198670471,68,132,-18,1618,468,1191,558,6,29.4
6,-3,0,6.0,-3.0,0.4803788661956787,126.8897158953396,68,126,-15,1618,468,1191,558,6,26.35
4,-1,0,4.0,-1.0,0.4954228401184082,122.80065146407001,68,122,-14,1618,468,1191,558,6,22.18
4,-2,0,4.0,-2.0,0.4966268539428711,118.6086000254619,68,118,-12,1618,468,1191,558,6,20.56
2,-1,0,2.0,-1.0,0.5072839260101318,116.52038448271615,68,116,-11,1618,468,1191,558,6,13.58
3,-1,0,3.0,-1.0,0.5126309394836426,113.44161493913951,68,113,-10,1618,468,1191,558,6,17.47
2,-1,0,2.0,-1.0,0.5204107761383057,111.36426715962351,68,111,-9,1618,468,1191,558,6,13.1
3,-1,0,3.0,-1.0,0.5283808708190918,108.29589096544707,68,108,-8,1618,468,1191,558,6,16.85
3,-1,0,3.0,-1.0,0.53672194480896,105.23307464861035,68,105,-7,1618,468,1191,558,6,16.49
3,0,0,3.0,-0.0,0.5443868637084961,102.23991392797629,68,102,-7,1618,468,1191,558,6,17.7
2,0,0,2.0,-0.0,0.5523679256439209,100.24470060806208,68,100,-7,1618,468,1191,558,6,14.2
3,-1,0,3.0,-1.0,0.5605599880218506,97.18538984847466,68,97,-6,1618,468,1191,558,6,15.65
2,-1,0,2.0,-1.0,0.5691759586334229,95.13148795220224,68,95,-5,1618,468,1191,558,6,11.69
2,0,0,2.0,-0.0,0.5765688419342041,93.13431161500041,68,93,-5,1618,468,1191,558,6,13.99
3,-1,0,3.0,-1.0,0.5871407985687256,90.08884503644167,68,90,-4,1618,468,1191,558,6,14.8
3,-1,0,3.0,-1.0,0.5923888683319092,87.05170877128145,68,87,-3,1618,468,1191,558,6,14.42
3,-1,0,3.0,-1.0,0.6004018783569336,84.02380615040002,68,84,-2,1618,468,1191,558,6,14.04
4,-1,0,4.0,-1.0,0.6106100082397461,80.00624975587844,68,80,-1,1618,468,1191,558,6,16.13
4,-1,0,4.0,-1.0,0.6166160106658936,76.0,68,76,0,1618,468,1191,558,6,15.54
3,0,0,3.0,-0.0,0.6243569850921631,73.0,68,73,0,1618,468,1191,558,6,17.43
2,0,0,2.0,-0.0,0.6324470043182373,71.0,68,71,0,1618,468,1191,558,6,14.59
3,0,0,3.0,-0.0,0.6405808925628662,68.0,68,68,0,1618,468,1191,558,6,16.93
2,0,0,2.0,-0.0,0.6513168811798096,66.0,68,66,0,1618,468,1191,558,6,14.21
3,0,0,3.0,-0.0,0.6568348407745361,63.0,68,63,0,1618,468,1191,558,6,16.43
2,0,0,2.0,-0.0,0.6655118465423584,61.0,68,61,0,1618,468,1191,558,6,13.83
3,0,0,3.0,-0.0,0.6745438575744629,58.0,68,58,0,1618,468,1191,558,6,15.93
2,0,0,2.0,-0.0,0.6808078289031982,56.0,68,56,0,1618,468,1191,558,6,13.46
3,0,0,3.0,-0.0,0.6884608268737793,53.0,68,53,0,1618,468,1191,558,6,15.42
2,0,0,2.0,-0.0,0.6992888450622559,51.0,68,51,0,1618,468,1191,558,6,13.08
3,0,0,3.0,-0.0,0.7044467926025391,48.0,68,48,0,1618,468,1191,558,6,14.92
2,0,0,2.0,-0.0,0.7125999927520752,46.0,68,46,0,1618,468,1191,558,6,12.7
3,0,0,3.0,-0.0,0.7235729694366455,43.0,68,43,0,1618,468,1191,558,6,14.41
3,0,0,3.0,-0.0,0.7289597988128662,40.0,68,40,0,1618,468,1191,558,6,14.1
3,0,0,3.0,-0.0,0.7366359233856201,37.0,68,37,0,1618,468,1191,558,6,13.79
1,0,0,1.0,-0.0,0.744379997253418,36.0,68,36,0,1618,468,1191,558,6,9.66
3,0,0,3.0,-0.0,0.7527058124542236,33.0,68,33,0,1618,468,1191,558,6,13.39
2,0,0,2.0,-0.0,0.7604320049285889,31.0,68,31,0,1618,468,1191,558,6,11.55
2,0,0,2.0,-0.0,0.7683799266815186,29.0,68,29,0,1618,468,1191,558,6,11.39
3,-1,0,3.0,-1.0,0.7763779163360596,26.019223662515376,68,26,1,1618,468,1191,558,6,7.27
2,0,0,2.0,-0.0,0.7849688529968262,24.020824298928627,68,24,1,1618,468,1191,558,6,8.68
3,0,0,3.0,-0.0,0.7960138320922852,21.02379604162864,68,21,1,1618,468,1191,558,6,9.4
2,0,0,2.0,-0.0,0.8004939556121826,19.026297590440446,68,19,1,1618,468,1191,558,6,7.91
2,0,0,2.0,-0.0,0.8125507831573486,17.029386365926403,68,17,1,1618,468,1191,558,6,7.56
2,0,0,2.0,-0.0,0.8163738250732422,15.033296378372908,68,15,1,1618,468,1191,558,6,7.18
4,0,0,4.0,-0.0,0.8288459777832031,11.045361017187261,68,11,1,1618,468,1191,558,6,7.84
2,0,0,2.0,-0.0,0.8328409194946289,9.055385138137417,68,9,1,1618,468,1191,558,6,5.73
1,0,0,1.0,-0.0,0.8408558368682861,8.06225774829855,68,8,1,1618,468,1191,558,6,4.52
2,0,0,2.0,-0.0,0.8484029769897461,6.082762530298219,68,6,1,1618,468,1191,558,6,4.66
1,0,0,1.0,-0.0,0.8563778400421143,5.0990195135927845,68,5,1,1618,468,1191,558,6,3.45
1,-1,0,1.0,-1.0,0.8645269870758057,4.47213595499958,68,4,2,1618,468,1191,558,6,0.03
1,0,0,1.0,-0.0,0.8723578453063965,3.605551275463989,68,3,2,1618,468,1191,558,6,1.45
2,0,0,2.0,-0.0,0.880375862121582,2.23606797749979,68,1,2,1618,468,1191,558,6,0.3
2,0,0,2.0,-0.0,0.8883547782897949,2.23606797749979,68,-1,2,1618,468,1191,558,6,8.37
2,0,0,2.0,-0.0,0.8963949680328369,3.605551275463989,68,-3,2,1618,468,1191,558,6,-0.63
1,0,0,1.0,-0.0,0.9044578075408936,4.47213595499958,68,-4,2,1618,468,1191,558,6,1.79
1,0,0,1.0,-0.0,0.9128458499908447,5.385164807134504,68,-5,2,1618,468,1191,558,6,2.24
2,0,0,2.0,-0.0,0.920353889465332,7.280109889280518,68,-7,2,1618,468,1191,558,6,1.3
1,0,0,1.0,-0.0,0.92852783203125,8.246211251235321,68,-8,2,1618,468,1191,558,6,3.34
2,0,0,2.0,-0.0,0.937675952911377,10.198039027185569,68,-10,2,1618,468,1191,558,6,2.29
1,0,0,1.0,-0.0,0.9443747997283936,11.180339887498949,68,-11,2,1618,468,1191,558,6,4.13
1,0,0,1.0,-0.0,0.9523727893829346,12.165525060596439,68,-12,2,1618,468,1191,558,6,4.35
0,0,1,-0.0,-0.0,1.0693838596343994,12.165525060596439,68,-12,2,1618,468,1191,558,6,20.53
-1,0,1,-1.0,-0.0,1.1284308433532715,11.180339887498949,68,-11,2,1618,468,1191,558,6,4.32
-1,0,1,-1.0,-0.0,1.1687309741973877,10.198039027185569,68,-10,2,1618,468,1191,558,6,4.1
0,0,0,-0.0,-0.0,1.1735248565673828,10.198039027185569,68,-10,2,1618,468,1191,558,6,19.94
-1,0,0,-1.0,-0.0,1.1843879222869873,9.219544457292887,68,-9,2,1618,468,1191,558,6,3.85
0,1,0,-0.0,1.0,1.2086567878723145,9.055385138137417,68,-9,1,1618,468,1191,558,6,-0.14
-1,0,0,-1.0,-0.0,1.2245028018951416,8.06225774829855,68,-8,1,1618,468,1191,558,6,4.52
-1,0,0,-1.0,-0.0,1.2566258907318115,7.0710678118654755,68,-7,1,1618,468,1191,558,6,4.21
-1,0,0,-1.0,-0.0,1.2883799076080322,6.082762530298219,68,-6,1,1618,468,1191,558,6,3.86
-1,0,0,-1.0,-0.0,1.3043909072875977,5.0990195135927845,68,-5,1,1618,468,1191,558,6,3.45
0,0,1,-0.0,-0.0,1.3523919582366943,5.0990195135927845,68,-5,1,1618,468,1191,558,6,28.43
0,0,0,-0.0,-0.0,0.12122726440429688,1226.9906275110661,69,-1191,-295,432,172,1623,467,37,230.48
-1,0,0,-1.0,-0.0,0.22423219680786133,1226.0199835239227,69,-1190,-295,432,172,1623,467,37,8.45
-3,0,0,-3.0,-0.0,0.23229122161865234,1223.1083353489175,69,-1187,-295,432,172,1623,467,37,19.01
-4,0,0,-4.0,-0.0,0.24026727676391602,1219.226804167297,69,-1183,-295,432,172,1623,467,37,23.87
-5,1,0,-5.0,1.0,0.25028419494628906,1214.6192819151192,69,-1178,-296,432,172,1623,467,37,26.52
-7,1,0,-7.0,1.0,0.256270170211792,1208.0769843019111,69,-1171,-297,432,172,1623,467,37,35.37
-10,1,0,-10.0,1.0,0.2643742561340332,1198.634639913264,69,-1161,-298,432,172,1623,467,37,47.06
-10,1,0,-10.0,1.0,0.2728581428527832,1189.2022536137408,69,-1151,-299,432,172,1623,467,37,46.81
-11,1,0,-11.0,1.0,0.28023624420166016,1178.81296226331,69,-1140,-300,432,172,1623,467,37,50.12
-10,0,0,-10.0,-0.0,0.28834009170532227,1169.144986731757,69,-1130,-300,432,172,1623,467,37,47.68
-13,0,0,-13.0,-0.0,0.299396276473999,1156.5850595611203,69,-1117,-300,432,172,1623,467,37,57.37
-14,-1,0,-14.0,-1.0,0.30449724197387695,1142.8079453696496,69,-1103,-299,432,172,1623,467,37,61.24
-17,-2,0,-17.0,-2.0,0.3122372627258301,1125.8796560911828,69,-1086,-297,432,172,1623,467,37,70.13
-19,-3,0,-19.0,-3.0,0.3202211856842041,1106.7632989939627,69,-1067,-294,432,172,1623,467,37,75.47
-20,-4,0,-20.0,-4.0,0.32827019691467285,1086.420268588542,69,-1047,-290,432,172,1623,467,37,78.18
-22,-3,0,-22.0,-3.0,0.3370392322540283,1064.421908831268,69,-1025,-287,432,172,1623,467,37,80.22
-32,-9,0,-32.0,-9.0,0.34425926208496094,1031.1803915901428,69,-993,-278,432,172,1623,467,37,102.4
-43,-12,0,-43.0,-12.0,0.35227417945861816,986.5373789167849,69,-950,-266,432,172,1623,467,37,114.49
-45,-13,0,-45.0,-13.0,0.3627181053161621,939.6988879423025,69,-905,-253,432,172,1623,467,37,113.03
-48,-14,0,-48.0,-14.0,0.36823606491088867,889.7021973671865,69,-857,-239,432,172,1623,467,37,112.32
-48,-14,0,-48.0,-14.0,0.37634706497192383,839.7059008962602,69,-809,-225,432,172,1623,467,37,108.6
-47,-13,0,-47.0,-13.0,0.38824915885925293,790.9412114689687,69,-762,-212,432,172,1623,467,37,104.72
-46,-14,0,-46.0,-14.0,0.39259815216064453,742.8728020327571,69,-716,-198,432,172,1623,467,37,98.86
-46,-14,0,-46.0,-14.0,0.4002041816711426,694.8064478687572,69,-670,-184,432,172,1623,467,37,94.91
-41,-12,0,-41.0,-12.0,0.4082162380218506,652.0927848090331,69,-629,-172,432,172,1623,467,37,87.31
-41,-12,0,-41.0,-12.0,0.4162411689758301,609.3800127998949,69,-588,-160,432,172,1623,467,37,83.74
-35,-11,0,-35.0,-11.0,0.42426228523254395,572.7215728432097,69,-553,-149,432,172,1623,467,37,74.49
-31,-10,0,-31.0,-10.0,0.43220019340515137,540.1897814657364,69,-522,-139,432,172,1623,467,37,67.57
-28,-8,0,-28.0,-8.0,0.4402761459350586,511.07435858199733,69,-494,-131,432,172,1623,467,37,62.76
-24,-8,0,-24.0,-8.0,0.4487271308898926,485.828158920415,69,-470,-123,432,172,1623,467,37,55.15
-19,-6,0,-19.0,-6.0,0.45844507217407227,465.9291791678216,69,-451,-117,432,172,1623,467,37,47.22
-14,-5,0,-14.0,-5.0,0.46424221992492676,451.12415142619,69,-437,-112,432,172,1623,467,37,37.99
-11,-5,0,-11.0,-5.0,0.47292613983154297,439.2322847879013,69,-426,-107,432,172,1623,467,37,31.53
-6,-3,0,-6.0,-3.0,0.4818150997161865,432.68464266715085,69,-420,-104,432,172,1623,467,37,20.25
-3,-2,0,-3.0,-2.0,0.48849010467529297,429.2936058224022,69,-417,-102,432,172,1623,467,37,11.9
-3,-2,0,-3.0,-2.0,0.4962460994720459,425.9060929359898,69,-414,-100,432,172,1623,467,37,11.83
-2,-2,0,-2.0,-2.0,0.5054931640625,423.4949822607111,69,-412,-98,432,172,1623,467,37,8.57
-2,-2,0,-2.0,-2.0,0.5122172832489014,421.08906421326117,69,-410,-96,432,172,1623,467,37,8.52
-4,-2,0,-4.0,-2.0,0.5202140808105469,416.7397269279712,69,-406,-94,432,172,1623,467,37,14.62
-4,-3,0,-4.0,-3.0,0.528217077255249,412.1710809845834,69,-402,-91,432,172,1623,467,37,14.26
-5,-4,0,-5.0,-4.0,0.5362300872802734,406.4209640262175,69,-397,-87,432,172,1623,467,37,16.73
-8,-5,0,-8.0,-5.0,0.5446152687072754,397.54873915030845,69,-389,-82,432,172,1623,467,37,23.28
-10,-6,0,-10.0,-6.0,0.5525212287902832,386.5449521077723,69,-379,-76,432,172,1623,467,37,26.7
-12,-5,0,-12.0,-5.0,0.5602130889892578,373.80476187443094,69,-367,-71,432,172,1623,467,37,29.64
-12,-5,0,-12.0,-5.0,0.568244218826294,361.08309293014537,69,-355,-66,432,172,1623,467,37,28.9
-14,-4,0,-14.0,-4.0,0.5762221813201904,346.5905365124674,69,-341,-62,432,172,1623,467,37,31.67
-14,-5,0,-14.0,-5.0,0.5842711925506592,331.93071566216946,69,-327,-57,432,172,1623,467,37,30.3
-13,-4,0,-13.0,-4.0,0.5922191143035889,318.44151739369664,69,-314,-53,432,172,1623,467,37,28.3
-14,-5,0,-14.0,-5.0,0.6002101898193359,303.8157336281319,69,-300,-48,432,172,1623,467,37,28.44
-16,-5,0,-16.0,-5.0,0.6082532405853271,287.2368360778262,69,-284,-43,432,172,1623,467,37,29.88
-17,-4,0,-17.0,-4.0,0.61623215675354,269.8332818612263,69,-267,-39,432,172,1623,467,37,30.27
-16,-5,0,-16.0,-5.0,0.6242341995239258,253.2923212416831,69,-251,-34,432,172,1623,467,37,27.3
-17,-4,0,-17.0,-4.0,0.6322441101074219,235.91523901605,69,-234,-30,432,172,1623,467,37,27.45
-17,-3,0,-17.0,-3.0,0.6402442455291748,218.67327225795108,69,-217,-27,432,172,1623,467,37,26.87
-15,-3,0,-15.0,-3.0,0.6482152938842773,203.42074623793906,69,-202,-24,432,172,1623,467,37,23.4
-15,-2,0,-15.0,-2.0,0.6562421321868896,188.28967045486058,69,-187,-22,432,172,1623,467,37,23.95
-15,-3,0,-15.0,-3.0,0.6642522811889648,173.04623659588788,69,-172,-19,432,172,1623,467,37,20.95
-13,-2,0,-13.0,-2.0,0.6728832721710205,159.90622251807463,69,-159,-17,432,172,1623,467,37,19.09
-15,-3,0,-15.0,-3.0,0.6802470684051514,144.6789549312546,69,-144,-14,432,172,1623,467,37,18.47
-13,-2,0,-13.0,-2.0,0.6882960796356201,131.54847015454038,69,-131,-12,432,172,1623,467,37,16.64
-11,-2,0,-11.0,-2.0,0.6962201595306396,120.41594578792295,69,-120,-10,432,172,1623,467,37,13.87
-10,-1,0,-10.0,-1.0,0.7042300701141357,110.3675676999362,69,-110,-9,432,172,1623,467,37,14.39
-11,-2,0,-11.0,-2.0,0.7122411727905273,99.24716620639605,69,-99,-7,432,172,1623,467,37,12.21
-9,-2,0,-9.0,-2.0,0.7202122211456299,90.13878188659973,69,-90,-5,432,172,1623,467,37,9.86
-8,-1,0,-8.0,-1.0,0.7284131050109863,82.09750300709517,69,-82,-4,432,172,1623,467,37,9.76
-7,-1,0,-7.0,-1.0,0.7367382049560547,75.05997601918082,69,-75,-3,432,172,1623,467,37,8.41
-6,-1,0,-6.0,-1.0,0.7442212104797363,69.02897942168927,69,-69,-2,432,172,1623,467,37,7.16
-5,-1,0,-5.0,-1.0,0.7522141933441162,64.00781202322104,69,-64,-1,432,172,1623,467,37,6.0
-4,0,0,-4.0,-0.0,0.7611331939697266,60.00833275470999,69,-60,-1,432,172,1623,467,37,8.1
-2,-1,0,-2.0,-1.0,0.768247127532959,58.0,69,-58,0,432,172,1623,467,37,2.9
-1,0,0,-1.0,-0.0,0.7784502506256104,57.0,69,-57,0,432,172,1623,467,37,7.37
-1,0,0,-1.0,-0.0,0.8082752227783203,56.0,69,-56,0,432,172,1623,467,37,7.36
-1,0,0,-1.0,-0.0,0.8562312126159668,55.0,69,-55,0,432,172,1623,467,37,7.35
-2,0,0,-2.0,-0.0,0.8642301559448242,53.0,69,-53,0,432,172,1623,467,37,7.99
-2,0,0,-2.0,-0.0,0.8722341060638428,51.0,69,-51,0,432,172,1623,467,37,7.96
-1,-1,0,-1.0,-1.0,0.8858160972595215,50.00999900019995,69,-50,1,432,172,1623,467,37,1.46
-2,0,0,-2.0,-0.0,0.8883152008056641,48.010415536631214,69,-48,1,432,172,1623,467,37,6.53
-2,0,0,-2.0,-0.0,0.897705078125,46.010868281309364,69,-46,1,432,172,1623,467,37,6.45
-3,0,0,-3.0,-0.0,0.9044361114501953,43.01162633521314,69,-43,1,432,172,1623,467,37,6.75
-3,0,0,-3.0,-0.0,0.9122211933135986,40.01249804748511,69,-40,1,432,172,1623,467,37,6.59
-3,0,0,-3.0,-0.0,0.9202041625976562,37.013511046643494,69,-37,1,432,172,1623,467,37,6.41
-2,0,0,-2.0,-0.0,0.9282212257385254,35.014282800023196,69,-35,1,432,172,1623,467,37,5.93
-2,0,0,-2.0,-0.0,0.9362452030181885,33.015148038438355,69,-33,1,432,172,1623,467,37,5.82
-1,0,0,-1.0,-0.0,0.9442241191864014,32.01562118716424,69,-32,1,432,172,1623,467,37,5.46
-1,0,0,-1.0,-0.0,0.9522082805633545,31.016124838541646,69,-31,1,432,172,1623,467,37,5.41
-1,0,0,-1.0,-0.0,0.9615380764007568,30.01666203960727,69,-30,1,432,172,1623,467,37,5.36
0,0,1,-0.0,-0.0,-0.004063129425048828,311.4305701115419,70,-283,130,179,301,462,171,51,99.31
-1,0,1,-1.0,-0.0,0.004550933837890625,310.5221409175198,70,-282,130,179,301,462,171,51,3.54
-1,0,1,-1.0,-0.0,0.01689887046813965,309.6142761566398,70,-281,130,179,301,462,171,51,3.53
-1,0,1,-1.0,-0.0,0.024913787841796875,308.70698080866265,70,-280,130,179,301,462,171,51,3.52
-1,0,1,-1.0,-0.0,0.03290200233459473,307.8002599089221,70,-279,130,179,301,462,171,51,3.51
-1,0,1,-1.0,-0.0,0.04090285301208496,306.8941185490527,70,-278,130,179,301,462,171,51,3.5
-1,0,1,-1.0,-0.0,0.04910397529602051,305.9885618777277,70,-277,130,179,301,462,171,51,3.49
-2,0,1,-2.0,-0.0,0.06490683555603027,304.1792234851026,70,-275,130,179,301,462,171,51,4.97
0,0,0,-0.0,-0.0,0.1269068717956543,304.1792234851026,70,-275,130,179,301,462,171,51,97.76
0,2,0,-0.0,2.0,0.21711397171020508,303.3298534598927,70,-275,128,179,301,462,171,51,2.02
-2,4,0,-2.0,4.0,0.22490787506103516,299.8416248621929,70,-273,124,179,301,462,171,51,6.93
-2,4,0,-2.0,4.0,0.23603081703186035,296.37982387470305,70,-271,120,179,301,462,171,51,6.82
-3,4,0,-3.0,4.0,0.24193787574768066,292.0273959751037,70,-268,116,179,301,462,171,51,8.47
-5,5,0,-5.0,5.0,0.2489488124847412,285.4645336990219,70,-263,111,179,301,462,171,51,11.77
-8,6,0,-8.0,6.0,0.26053285598754883,275.77164466275354,70,-255,105,179,301,462,171,51,15.88
-8,6,0,-8.0,6.0,0.2653789520263672,266.101484400219,70,-247,99,179,301,462,171,51,15.45
-10,6,0,-10.0,6.0,0.2729368209838867,254.5937941113255,70,-237,93,179,301,462,171,51,17.55
-11,7,0,-11.0,7.0,0.28090381622314453,241.8098426450007,70,-226,86,179,301,462,171,51,17.94
-12,6,0,-12.0,6.0,0.2889368534088135,228.46443924602357,70,-214,80,179,301,462,171,51,18.65
-12,7,0,-12.0,7.0,0.297076940536499,214.78593994952277,70,-202,73,179,301,462,171,51,17.5
-13,7,0,-13.0,7.0,0.3048889636993408,200.19240744843447,70,-189,66,179,301,462,171,51,17.61
-13,8,0,-13.0,8.0,0.3134899139404297,185.31055015837603,70,-176,58,179,301,462,171,51,16.41
-15,6,0,-15.0,6.0,0.3208918571472168,169.1892431568863,70,-161,52,179,301,462,171,51,17.88
-16,7,0,-16.0,7.0,0.3288998603820801,151.82226450688975,70,-145,45,179,301,462,171,51,16.8
-15,6,0,-15.0,6.0,0.3372647762298584,135.72398461583714,70,-130,39,179,301,462,171,51,15.26
-16,6,0,-16.0,6.0,0.3454399108886719,118.68024266911489,70,-114,33,179,301,462,171,51,14.69
-16,6,0,-16.0,6.0,0.35578083992004395,101.65136496870073,70,-98,27,179,301,462,171,51,13.17
-15,6,0,-15.0,6.0,0.36092090606689453,85.61541917201598,70,-83,21,179,301,462,171,51,11.0
-14,5,0,-14.0,5.0,0.3690319061279297,70.83078426785913,70,-69,16,179,301,462,171,51,9.61
-13,6,0,-13.0,6.0,0.3802378177642822,56.88585061331157,70,-56,10,179,301,462,171,51,7.16
-10,4,0,-10.0,4.0,0.38500380516052246,46.389654018972806,70,-46,6,179,301,462,171,51,5.49
-9,3,0,-9.0,3.0,0.39307284355163574,37.12142238654117,70,-37,3,179,301,462,171,51,4.63
-8,4,0,-8.0,4.0,0.4044208526611328,29.017236257093817,70,-29,-1,179,301,462,171,51,2.77
-8,4,0,-8.0,4.0,0.408998966217041,21.587033144922902,70,-21,-5,179,301,462,171,51,1.61
-6,2,0,-6.0,2.0,0.41924381256103516,16.55294535724685,70,-15,-7,179,301,462,171,51,0.79
-6,2,0,-6.0,2.0,0.428142786026001,12.727922061357855,70,-9,-9,179,301,462,171,51,-0.31
-5,1,0,-5.0,1.0,0.43340492248535156,10.770329614269007,70,-4,-10,179,301,462,171,51,-1.03
-4,1,0,-4.0,1.0,0.4409158229827881,11.0,70,0,-11,179,301,462,171,51,-0.53
-2,1,0,-2.0,1.0,0.4512608051300049,12.165525060596439,70,2,-12,179,301,462,171,51,-0.44
-1,1,0,-1.0,1.0,0.4570808410644531,13.341664064126334,70,3,-13,179,301,462,171,51,0.71
-1,0,0,-1.0,-0.0,0.4657738208770752,13.601470508735444,70,4,-13,179,301,462,171,51,0.75
0,0,1,-0.0,-0.0,0.48389697074890137,13.601470508735444,70,4,-13,179,301,462,171,51,30.96
0,0,0,-0.0,-0.0,0.1012718677520752,1349.8048007026794,71,1082,807,1257,1121,175,314,63,242.72
0,1,0,-0.0,1.0,0.14541983604431152,1349.2071746029221,71,1082,806,1257,1121,175,314,63,3.09
1,0,0,1.0,-0.0,0.15460586547851562,1348.405354483584,71,1081,806,1257,1121,175,314,63,4.36
2,0,0,2.0,-0.0,0.16135692596435547,1346.8025096501715,71,1079,806,1257,1121,175,314,63,7.24
1,1,0,1.0,1.0,0.1723628044128418,1345.4029136284787,71,1078,805,1257,1121,175,314,63,8.54
2,1,0,2.0,1.0,0.17725276947021484,1343.2021441317015,71,1076,804,1257,1121,175,314,63,11.09
2,2,0,2.0,2.0,0.1853349208831787,1340.4029244969588,71,1074,802,1257,1121,175,314,63,13.41
4,3,0,4.0,3.0,0.2001197338104248,1335.4029354468262,71,1070,799,1257,1121,175,314,63,23.73
5,4,0,5.0,4.0,0.2014789581298828,1329.0033860002013,71,1065,795,1257,1121,175,314,63,26.64
7,4,0,7.0,4.0,0.2124638557434082,1321.0015140036744,71,1058,791,1257,1121,175,314,63,29.86
14,8,0,14.0,8.0,0.2173929214477539,1305.0,71,1044,783,1257,1121,175,314,63,50.42
19,9,0,19.0,9.0,0.22554588317871094,1284.406867001263,71,1025,774,1257,1121,175,314,63,59.37
25,11,0,25.0,11.0,0.2416999340057373,1257.842994971948,71,1000,763,1257,1121,175,314,63,69.86
31,12,0,31.0,12.0,0.2418687343597412,1225.95350645936,71,969,751,1257,1121,175,314,63,77.41
36,13,0,36.0,13.0,0.2492198944091797,1189.5936280932242,71,933,738,1257,1121,175,314,63,82.52
41,16,0,41.0,16.0,0.25736188888549805,1147.5835481567344,71,892,722,1257,1121,175,314,63,88.24
42,20,0,42.0,20.0,0.26526474952697754,1102.408272828175,71,850,702,1257,1121,175,314,63,90.26
41,20,0,41.0,20.0,0.27533483505249023,1058.1138880101707,71,809,682,1257,1121,175,314,63,87.2
41,20,0,41.0,20.0,0.28141283988952637,1013.9368816647317,71,768,662,1257,1121,175,314,63,84.91
36,20,0,36.0,20.0,0.2906367778778076,973.6467531913204,71,732,642,1257,1121,175,314,63,78.91
33,17,0,33.0,17.0,0.29831981658935547,937.6705178259579,71,699,625,1257,1121,175,314,63,71.91
27,17,0,27.0,17.0,0.3052358627319336,906.227344544403,71,672,608,1257,1121,175,314,63,65.33
25,16,0,25.0,16.0,0.31384873390197754,876.9680723948849,71,647,592,1257,1121,175,314,63,61.23
25,18,0,25.0,18.0,0.32251596450805664,846.3805290766087,71,622,574,1257,1121,175,314,63,62.17
24,18,0,24.0,18.0,0.3292558193206787,816.5414870047939,71,598,556,1257,1121,175,314,63,60.11
27,19,0,27.0,19.0,0.3372528553009033,783.8430965442,71,571,537,1257,1121,175,314,63,61.77
27,19,0,27.0,19.0,0.34707188606262207,751.1724169589828,71,544,518,1257,1121,175,314,63,60.14
25,19,0,25.0,19.0,0.3532578945159912,719.9736106275008,71,519,499,1257,1121,175,314,63,57.29
27,21,0,27.0,21.0,0.36167478561401367,685.9650136851004,71,492,478,1257,1121,175,314,63,58.75
25,21,0,25.0,21.0,0.37187695503234863,653.4049280499803,71,467,457,1257,1121,175,314,63,56.03
23,20,0,23.0,20.0,0.37755775451660156,622.9807380649903,71,444,437,1257,1121,175,314,63,52.47
21,20,0,21.0,20.0,0.38527774810791016,593.9848482916042,71,423,417,1257,1121,175,314,63,50.82
19,20,0,19.0,20.0,0.39414286613464355,566.4141594275341,71,404,397,1257,1121,175,314,63,47.27
19,21,0,19.0,21.0,0.40218186378479004,538.1458909998291,71,385,376,1257,1121,175,314,63,45.88
18,19,0,18.0,19.0,0.41274380683898926,511.994140591472,71,367,357,1257,1121,175,314,63,42.87
18,18,0,18.0,18.0,0.4172327518463135,486.5408513167214,71,349,339,1257,1121,175,314,63,41.86
18,16,0,18.0,16.0,0.4252159595489502,462.4824320987771,71,331,323,1257,1121,175,314,63,38.11
17,16,0,17.0,16.0,0.43326377868652344,439.14120735817994,71,314,307,1257,1121,175,314,63,37.14
16,14,0,16.0,14.0,0.4415287971496582,417.9150631408253,71,298,293,1257,1121,175,314,63,32.83
16,14,0,16.0,14.0,0.44992780685424805,396.69257618463195,71,282,279,1257,1121,175,314,63,31.73
15,12,0,15.0,12.0,0.45728492736816406,377.59502115361636,71,267,267,1257,1121,175,314,63,28.01
15,12,0,15.0,12.0,0.46527576446533203,358.50941410233565,71,252,255,1257,1121,175,314,63,27.03
14,11,0,14.0,11.0,0.47426390647888184,340.8518739863403,71,238,244,1257,1121,175,314,63,24.7
13,10,0,13.0,10.0,0.48125481605529785,324.6243983436858,71,225,234,1257,1121,175,314,63,22.47
14,10,0,14.0,10.0,0.489926815032959,307.7287766849243,71,211,224,1257,1121,175,314,63,21.95
13,9,0,13.0,9.0,0.4982619285583496,292.2823976910002,71,198,215,1257,1121,175,314,63,19.79
13,9,0,13.0,9.0,0.5052299499511719,276.87722911066555,71,185,206,1257,1121,175,314,63,18.99
13,9,0,13.0,9.0,0.513232946395874,261.5205536855564,71,172,197,1257,1121,175,314,63,18.17
11,8,0,11.0,8.0,0.5212197303771973,248.2780699135548,71,161,189,1257,1121,175,314,63,15.92
10,8,0,10.0,8.0,0.5292208194732666,235.71593073019056,71,151,181,1257,1121,175,314,63,15.08
9,8,0,9.0,8.0,0.5372469425201416,223.8146554629522,71,142,173,1257,1121,175,314,63,14.41
8,7,0,8.0,7.0,0.5507059097290039,213.33541665649423,71,134,166,1257,1121,175,314,63,12.76
8,7,0,8.0,7.0,0.5532479286193848,202.87188075236054,71,126,159,1257,1121,175,314,63,12.29
8,7,0,8.0,7.0,0.5630168914794922,192.4266093865399,71,118,152,1257,1121,175,314,63,11.81
7,6,0,7.0,6.0,0.5699617862701416,183.40392580312997,71,111,146,1257,1121,175,314,63,10.33
9,6,0,9.0,6.0,0.5772669315338135,173.216627377397,71,102,140,1257,1121,175,314,63,10.05
8,7,0,8.0,7.0,0.588040828704834,162.8649747490233,71,94,133,1257,1121,175,314,63,10.31
9,5,0,9.0,5.0,0.5933618545532227,153.6522046701576,71,85,128,1257,1121,175,314,63,8.24
7,5,0,7.0,5.0,0.6012909412384033,145.64683312726027,71,78,123,1257,1121,175,314,63,7.54
7,5,0,7.0,5.0,0.6120479106903076,137.71347065556077,71,71,118,1257,1121,175,314,63,7.14
6,4,0,6.0,4.0,0.6173627376556396,131.2288078129189,71,65,114,1257,1121,175,314,63,5.91
7,5,0,7.0,5.0,0.6292119026184082,123.47064428438041,71,58,109,1257,1121,175,314,63,6.38
6,6,0,6.0,6.0,0.6333248615264893,115.3819743287486,71,52,103,1257,1121,175,314,63,6.81
6,5,0,6.0,5.0,0.6412198543548584,108.25894882179486,71,46,98,1257,1121,175,314,63,5.63
4,4,0,4.0,4.0,0.6492688655853271,102.95630140987001,71,42,94,1257,1121,175,314,63,4.86
5,5,0,5.0,5.0,0.6572568416595459,96.38464608017192,71,37,89,1257,1121,175,314,63,5.14
3,4,0,3.0,4.0,0.6652238368988037,91.54780172128658,71,34,85,1257,1121,175,314,63,4.82
3,5,0,3.0,5.0,0.6732327938079834,85.7962703152066,71,31,80,1257,1121,175,314,63,5.64
3,4,0,3.0,4.0,0.6812379360198975,80.99382692526635,71,28,76,1257,1121,175,314,63,4.39
3,3,0,3.0,3.0,0.6895918846130371,77.1621668954417,71,25,73,1257,1121,175,314,63,3.29
2,4,0,2.0,4.0,0.6972699165344238,72.73238618387272,71,23,69,1257,1121,175,314,63,5.03
3,4,0,3.0,4.0,0.7052288055419922,68.00735254367721,71,20,65,1257,1121,175,314,63,3.76
3,4,0,3.0,4.0,0.713519811630249,63.324560795950255,71,17,61,1257,1121,175,314,63,3.51
2,4,0,2.0,4.0,0.7244539260864258,58.9406481131655,71,15,57,1257,1121,175,314,63,4.13
1,4,0,1.0,4.0,0.7306139469146729,54.817880294662984,71,14,53,1257,1121,175,314,63,7.13
1,2,0,1.0,2.0,0.7375907897949219,52.630789467763066,71,13,51,1257,1121,175,314,63,3.38
0,2,0,-0.0,2.0,0.7471098899841309,50.695167422546305,71,13,49,1257,1121,175,314,63,3.02
1,2,0,1.0,2.0,0.7535879611968994,48.507731342539614,71,12,47,1257,1121,175,314,63,3.31
0,2,0,-0.0,2.0,0.7613089084625244,46.57252408878007,71,12,45,1257,1121,175,314,63,2.95
0,2,0,-0.0,2.0,0.7707319259643555,44.64302857109943,71,12,43,1257,1121,175,314,63,2.86
0,1,0,-0.0,1.0,0.7773218154907227,43.68065933568311,71,12,42,1257,1121,175,314,63,2.67
0,1,0,-0.0,1.0,0.7932138442993164,42.720018726587654,71,12,41,1257,1121,175,314,63,2.63
0,0,1,-0.0,-0.0,0.8502168655395508,42.720018726587654,71,12,41,1257,1121,175,314,63,39.85
0,0,0,-0.0,-0.0,0.1268932819366455,1365.1344256152945,72,-1014,-914,231,166,1245,1080,27,244.2
-2,0,0,-2.0,-0.0,0.2008974552154541,1363.6495150880962,72,-1012,-914,231,166,1245,1080,27,13.57
-4,-3,0,-4.0,-3.0,0.20892834663391113,1358.67030585054,72,-1008,-911,231,166,1245,1080,27,40.85
-6,-3,0,-6.0,-3.0,0.2177274227142334,1352.2085637948016,72,-1002,-908,231,166,1245,1080,27,48.16
-8,-4,0,-8.0,-4.0,0.22878742218017578,1343.5966656701705,72,-994,-904,231,166,1245,1080,27,59.45
-13,-8,0,-13.0,-8.0,0.2330784797668457,1328.5996387173977,72,-981,-896,231,166,1245,1080,27,86.52
-16,-9,0,-16.0,-9.0,0.2409512996673584,1310.7227014132318,72,-965,-887,231,166,1245,1080,27,95.18
-19,-10,0,-19.0,-10.0,0.2488844394683838,1289.9786819943963,72,-946,-877,231,166,1245,1080,27,102.48
-20,-11,0,-20.0,-11.0,0.25691747665405273,1267.845416444765,72,-926,-866,231,166,1245,1080,27,105.22
-22,-15,0,-22.0,-15.0,0.2648963928222656,1241.5381588980663,72,-904,-851,231,166,1245,1080,27,114.3
-23,-16,0,-23.0,-16.0,0.27288031578063965,1213.8311249922701,72,-881,-835,231,166,1245,1080,27,115.81
-24,-18,0,-24.0,-18.0,0.2809164524078369,1184.034627872006,72,-857,-817,231,166,1245,1080,27,118.52
-25,-19,0,-25.0,-19.0,0.28927135467529297,1152.8347669982893,72,-832,-798,231,166,1245,1080,27,119.28
-26,-22,0,-26.0,-22.0,0.30004334449768066,1118.844046326386,72,-806,-776,231,166,1245,1080,27,122.51
-29,-23,0,-29.0,-23.0,0.304903507232666,1082.006469481583,72,-777,-753,231,166,1245,1080,27,123.8
-30,-23,0,-30.0,-23.0,0.31317949295043945,1044.465892214772,72,-747,-730,231,166,1245,1080,27,122.04
-34,-24,0,-34.0,-24.0,0.3247544765472412,1003.3967311088869,72,-713,-706,231,166,1245,1080,27,123.14
-33,-23,0,-33.0,-23.0,0.3289303779602051,963.7888772962676,72,-680,-683,231,166,1245,1080,27,118.52
-33,-26,0,-33.0,-26.0,0.3375523090362549,922.094355258723,72,-647,-657,231,166,1245,1080,27,118.29
-32,-25,0,-32.0,-25.0,0.3478562831878662,881.8440905284789,72,-615,-632,231,166,1245,1080,27,113.59
-31,-25,0,-31.0,-25.0,0.3529224395751953,842.3211976437492,72,-584,-607,231,166,1245,1080,27,109.86
-29,-23,0,-29.0,-23.0,0.36194944381713867,805.655633630151,72,-555,-584,231,166,1245,1080,27,103.69
-28,-21,0,-28.0,-21.0,0.3722825050354004,771.1666486564367,72,-527,-563,231,166,1245,1080,27,98.17
-25,-21,0,-25.0,-21.0,0.37699341773986816,738.761125127737,72,-502,-542,231,166,1245,1080,27,93.56
-23,-19,0,-23.0,-19.0,0.38489246368408203,709.2037788957416,72,-479,-523,231,166,1245,1080,27,87.46
-23,-19,0,-23.0,-19.0,0.39288830757141113,679.6705084083022,72,-456,-504,231,166,1245,1080,27,85.12
-21,-17,0,-21.0,-17.0,0.4009213447570801,652.9885144472298,72,-435,-487,231,166,1245,1080,27,79.05
-19,-18,0,-19.0,-18.0,0.4088883399963379,626.9106794432521,72,-416,-469,231,166,1245,1080,27,77.03
-18,-17,0,-18.0,-17.0,0.41689443588256836,602.2524387663366,72,-398,-452,231,166,1245,1080,27,73.06
-17,-17,0,-17.0,-17.0,0.4249684810638428,578.261186662221,72,-381,-435,231,166,1245,1080,27,70.68
-14,-13,0,-14.0,-13.0,0.4329073429107666,559.2611196927603,72,-367,-422,231,166,1245,1080,27,60.74
-12,-14,0,-12.0,-14.0,0.4408993721008301,540.8225217203884,72,-355,-408,231,166,1245,1080,27,61.03
-10,-13,0,-10.0,-13.0,0.44889235496520996,524.4520950477746,72,-345,-395,231,166,1245,1080,27,54.32
-8,-11,0,-8.0,-11.0,0.45696449279785156,510.9060579010588,72,-337,-384,231,166,1245,1080,27,47.36
-8,-13,0,-8.0,-13.0,0.4648892879486084,495.86490095589545,72,-329,-371,231,166,1245,1080,27,48.66
-8,-13,0,-8.0,-13.0,0.47287750244140625,480.8378104933097,72,-321,-358,231,166,1245,1080,27,47.65
-8,-13,0,-8.0,-13.0,0.480926513671875,465.8261478277062,72,-313,-345,231,166,1245,1080,27,46.62
-10,-15,0,-10.0,-15.0,0.489457368850708,448.00558032238837,72,-303,-330,231,166,1245,1080,27,50.46
-12,-16,0,-12.0,-16.0,0.49977540969848633,428.10863107393664,72,-291,-314,231,166,1245,1080,27,52.57
-13,-16,0,-13.0,-16.0,0.5049715042114258,407.5389551932428,72,-278,-298,231,166,1245,1080,27,52.34
-14,-15,0,-14.0,-15.0,0.5130693912506104,387.02067128255567,72,-264,-283,231,166,1245,1080,27,53.27
-14,-16,0,-14.0,-16.0,0.5208823680877686,365.77178677421256,72,-250,-267,231,166,1245,1080,27,50.43
-12,-13,0,-12.0,-13.0,0.5294413566589355,348.08045047086455,72,-238,-254,231,166,1245,1080,27,45.66
-12,-13,0,-12.0,-13.0,0.5398614406585693,330.3891644712338,72,-226,-241,231,166,1245,1080,27,44.18
-11,-10,0,-11.0,-10.0,0.5465474128723145,315.5724956329369,72,-215,-231,231,166,1245,1080,27,36.84
-9,-9,0,-9.0,-9.0,0.556119441986084,302.8530997034701,72,-206,-222,231,166,1245,1080,27,33.76
-8,-9,0,-8.0,-9.0,0.5608994960784912,290.81437378506587,72,-198,-213,231,166,1245,1080,27,32.4
-9,-9,0,-9.0,-9.0,0.5691003799438477,278.09530740377477,72,-189,-204,231,166,1245,1080,27,31.98
-9,-9,0,-9.0,-9.0,0.5768845081329346,265.37709019431196,72,-180,-195,231,166,1245,1080,27,31.0
-9,-8,0,-9.0,-8.0,0.5850203037261963,253.39692184397188,72,-171,-187,231,166,1245,1080,27,27.95
-9,-9,0,-9.0,-9.0,0.5985813140869141,240.68236329236922,72,-162,-178,231,166,1245,1080,27,28.96
-9,-7,0,-9.0,-7.0,0.6009113788604736,229.4558781116753,72,-153,-171,231,166,1245,1080,27,24.47
-9,-9,0,-9.0,-9.0,0.6160023212432861,216.74870241826133,72,-144,-162,231,166,1245,1080,27,26.83
-10,-8,0,-10.0,-8.0,0.6170125007629395,204.13720875920686,72,-134,-154,231,166,1245,1080,27,24.26
-12,-8,0,-12.0,-8.0,0.6278154850006104,190.26297590440447,72,-122,-146,231,166,1245,1080,27,23.79
-11,-9,0,-11.0,-9.0,0.6332583427429199,176.32356620712955,72,-111,-137,231,166,1245,1080,27,23.09
-10,-9,0,-10.0,-9.0,0.6417784690856934,163.04907236779974,72,-101,-128,231,166,1245,1080,27,21.52
-9,-7,0,-9.0,-7.0,0.6512024402618408,152.00328943809077,72,-92,-121,231,166,1245,1080,27,17.88
-6,-7,0,-6.0,-7.0,0.6569113731384277,142.80056022299073,72,-86,-114,231,166,1245,1080,27,17.22
-6,-8,0,-6.0,-8.0,0.6648902893066406,132.80060240827223,72,-80,-106,231,166,1245,1080,27,19.67
-6,-7,0,-6.0,-7.0,0.6728713512420654,123.60016181219181,72,-74,-99,231,166,1245,1080,27,15.73
-5,-7,0,-5.0,-7.0,0.6809084415435791,115.0,72,-69,-92,231,166,1245,1080,27,15.75
-5,-7,0,-5.0,-7.0,0.6913013458251953,106.40018796975878,72,-64,-85,231,166,1245,1080,27,15.05
-5,-6,0,-5.0,-6.0,0.6970243453979492,98.60020283954795,72,-59,-79,231,166,1245,1080,27,12.98
-3,-5,0,-3.0,-5.0,0.7050294876098633,92.80086206496145,72,-56,-74,231,166,1245,1080,27,10.02
-5,-6,0,-5.0,-6.0,0.7157223224639893,85.0,72,-51,-68,231,166,1245,1080,27,12.07
-5,-5,0,-5.0,-5.0,0.7209103107452393,78.00640999302557,72,-46,-63,231,166,1245,1080,27,9.57
-4,-5,0,-4.0,-5.0,0.7290163040161133,71.61005515987263,72,-42,-58,231,166,1245,1080,27,10.23
-3,-3,0,-3.0,-3.0,0.7368783950805664,67.42403132415029,72,-39,-55,231,166,1245,1080,27,6.78
-3,-5,0,-3.0,-5.0,0.7449173927307129,61.61168720299745,72,-36,-50,231,166,1245,1080,27,8.52
-3,-3,0,-3.0,-3.0,0.7543075084686279,57.42821606144492,72,-33,-47,231,166,1245,1080,27,6.27
-4,-3,0,-4.0,-3.0,0.7608795166015625,52.69724850502159,72,-29,-44,231,166,1245,1080,27,5.39
-3,-4,0,-3.0,-4.0,0.7690443992614746,47.70744176750625,72,-26,-40,231,166,1245,1080,27,7.48
-4,-3,0,-4.0,-3.0,0.7769613265991211,43.04648650006177,72,-22,-37,231,166,1245,1080,27,4.62
-2,-3,0,-2.0,-3.0,0.7848663330078125,39.44616584663204,72,-20,-34,231,166,1245,1080,27,6.52
-3,-3,0,-3.0,-3.0,0.7931373119354248,35.35533905932738,72,-17,-31,231,166,1245,1080,27,4.36
-2,-2,0,-2.0,-2.0,0.8011314868927002,32.64965543462902,72,-15,-29,231,166,1245,1080,27,3.51
-3,-3,0,-3.0,-3.0,0.8128113746643066,28.635642126552707,72,-12,-26,231,166,1245,1080,27,3.62
-2,-3,0,-2.0,-3.0,0.8169033527374268,25.079872407968907,72,-10,-23,231,166,1245,1080,27,4.21
-2,-2,0,-2.0,-2.0,0.82497239112854,22.47220505424423,72,-8,-21,231,166,1245,1080,27,2.53
-2,-2,0,-2.0,-2.0,0.8329024314880371,19.924858845171276,72,-6,-19,231,166,1245,1080,27,2.17
-1,-2,0,-1.0,-2.0,0.840935468673706,17.72004514666935,72,-5,-17,231,166,1245,1080,27,3.4
-1,-1,0,-1.0,-1.0,0.8558545112609863,16.492422502470642,72,-4,-16,231,166,1245,1080,27,1.57
-1,-2,0,-1.0,-2.0,0.8569934368133545,14.317821063276353,72,-3,-14,231,166,1245,1080,27,2.69
-1,-1,0,-1.0,-1.0,0.8648653030395508,13.152946437965905,72,-2,-13,231,166,1245,1080,27,1.16
-2,-1,0,-2.0,-1.0,0.8729434013366699,12.0,72,0,-12,231,166,1245,1080,27,0.05
-1,-2,0,-1.0,-2.0,0.8845133781433105,10.04987562112089,72,1,-10,231,166,1245,1080,27,1.13
-2,-1,0,-2.0,-1.0,0.8889822959899902,9.486832980505138,72,3,-9,231,166,1245,1080,27,-0.71
-1,-1,0,-1.0,-1.0,0.8968772888183594,8.94427190999916,72,4,-8,231,166,1245,1080,27,-0.29
-1,-2,0,-1.0,-2.0,0.9048664569854736,7.810249675906654,72,5,-6,231,166,1245,1080,27,-0.39
-1,0,0,-1.0,-0.0,0.9131503105163574,8.48528137423857,72,6,-6,231,166,1245,1080,27,0.62
0,-1,0,-0.0,-1.0,0.9221823215484619,7.810249675906654,72,6,-5,231,166,1245,1080,27,0.34
-1,-1,0,-1.0,-1.0,0.9355423450469971,8.06225774829855,72,7,-4,231,166,1245,1080,27,0.72
0,-1,0,-0.0,-1.0,0.9448773860931396,7.615773105863909,72,7,-3,231,166,1245,1080,27,-0.14
-1,0,0,-1.0,-0.0,0.9528954029083252,8.54400374531753,72,8,-3,231,166,1245,1080,27,1.47
0,0,1,-0.0,-0.0,0.9829123020172119,8.54400374531753,72,8,-3,231,166,1245,1080,27,29.45
0,0,0,-0.0,-0.0,0.09154653549194336,991.404054863606,73,-69,989,154,1158,223,169,14,204.62
1,0,0,1.0,-0.0,0.15568757057189941,991.4741549833763,73,-70,989,154,1158,223,169,14,100.11
3,2,0,3.0,2.0,0.1635115146636963,989.6959128944608,73,-73,987,154,1158,223,169,14,22.95
3,3,0,3.0,3.0,0.1715104579925537,986.9305953307963,73,-76,984,154,1158,223,169,14,33.51
5,4,0,5.0,4.0,0.17952942848205566,983.3417513763972,73,-81,980,154,1158,223,169,14,40.94
5,4,0,5.0,4.0,0.18750643730163574,979.7816083189151,73,-86,976,154,1158,223,169,14,40.59
5,4,0,5.0,4.0,0.19551849365234375,976.250480153531,73,-91,972,154,1158,223,169,14,40.24
7,5,0,7.0,5.0,0.20354962348937988,971.9531881731754,73,-98,967,154,1158,223,169,14,46.57
10,7,0,10.0,7.0,0.21430540084838867,966.0558990037791,73,-108,960,154,1158,223,169,14,58.34
12,8,0,12.0,8.0,0.2203385829925537,959.5332198522362,73,-120,952,154,1158,223,169,14,62.21
12,10,0,12.0,10.0,0.22756457328796387,951.2034482696117,73,-132,942,154,1158,223,169,14,72.66
12,10,0,12.0,10.0,0.23549652099609375,943.0588528824699,73,-144,932,154,1158,223,169,14,71.26
14,12,0,14.0,12.0,0.24353861808776855,933.4687996928445,73,-158,920,154,1158,223,169,14,78.2
12,12,0,12.0,12.0,0.25181055068969727,923.7770293745131,73,-170,908,154,1158,223,169,14,78.3
13,16,0,13.0,16.0,0.26141858100891113,910.5783876196491,73,-183,892,154,1158,223,169,14,92.06
12,17,0,12.0,17.0,0.2678945064544678,896.4652809785775,73,-195,875,154,1158,223,169,14,94.41
11,18,0,11.0,18.0,0.2755246162414551,881.4108009322327,73,-206,857,154,1158,223,169,14,96.52
8,17,0,8.0,17.0,0.283496618270874,866.8310100590542,73,-214,840,154,1158,223,169,14,94.3
8,17,0,8.0,17.0,0.29154443740844727,852.4159782641336,73,-222,823,154,1158,223,169,14,92.81
5,16,0,5.0,16.0,0.29981350898742676,838.3185552044043,73,-227,807,154,1158,223,169,14,91.18
3,15,0,3.0,15.0,0.3095524311065674,824.7205587348966,73,-230,792,154,1158,223,169,14,88.96
2,17,0,2.0,17.0,0.3155195713043213,808.980222255155,73,-232,775,154,1158,223,169,14,94.54
0,19,0,-0.0,19.0,0.3240044116973877,790.7970662565713,73,-232,756,154,1158,223,169,14,99.83
0,18,0,-0.0,18.0,0.3332645893096924,773.60713543762,73,-232,738,154,1158,223,169,14,96.13
-1,19,0,-1.0,19.0,0.3395504951477051,755.1966631282212,73,-231,719,154,1158,223,169,14,97.78
-2,18,0,-2.0,18.0,0.34753942489624023,737.4564393915074,73,-229,701,154,1158,223,169,14,95.19
-3,20,0,-3.0,20.0,0.35670948028564453,717.5214282514495,73,-226,681,154,1158,223,169,14,98.47
-3,20,0,-3.0,20.0,0.3635735511779785,697.6030389842063,73,-223,661,154,1158,223,169,14,96.71
-3,20,0,-3.0,20.0,0.3715825080871582,677.702737193823,73,-220,641,154,1158,223,169,14,94.93
-3,19,0,-3.0,19.0,0.37951040267944336,658.7662711462997,73,-217,622,154,1158,223,169,14,91.45
-4,18,0,-4.0,18.0,0.3875434398651123,640.4568681808323,73,-213,604,154,1158,223,169,14,89.14
-5,18,0,-5.0,18.0,0.39658641815185547,621.8199096201407,73,-208,586,154,1158,223,169,14,88.84
-5,18,0,-5.0,18.0,0.40352654457092285,603.1857093797896,73,-203,568,154,1158,223,169,14,87.14
-5,19,0,-5.0,19.0,0.41219043731689453,583.6137421274451,73,-198,549,154,1158,223,169,14,86.81
-6,19,0,-6.0,19.0,0.4195094108581543,563.7055969209459,73,-192,530,154,1158,223,169,14,86.41
-5,19,0,-5.0,19.0,0.4275236129760742,544.1415257081562,73,-187,511,154,1158,223,169,14,82.99
-5,20,0,-5.0,20.0,0.43551063537597656,523.6458727040632,73,-182,491,154,1158,223,169,14,82.26
-5,19,0,-5.0,19.0,0.4454224109649658,504.0962209737343,73,-177,472,154,1158,223,169,14,78.91
-5,20,0,-5.0,20.0,0.4515964984893799,483.6196852900014,73,-172,452,154,1158,223,169,14,78.02
-5,18,0,-5.0,18.0,0.4595515727996826,465.02150487907545,73,-167,434,154,1158,223,169,14,73.49
-4,17,0,-4.0,17.0,0.4693284034729004,447.7253622478852,73,-163,417,154,1158,223,169,14,69.09
-5,17,0,-5.0,17.0,0.47550344467163086,430.07441216608083,73,-158,400,154,1158,223,169,14,68.45
-6,15,0,-6.0,15.0,0.4835236072540283,413.9190742162047,73,-152,385,154,1158,223,169,14,66.86
-5,13,0,-5.0,13.0,0.4915175437927246,399.99124990429476,73,-147,372,154,1158,223,169,14,61.02
-5,14,0,-5.0,14.0,0.4995396137237549,385.133743003648,73,-142,358,154,1158,223,169,14,60.21
-5,12,0,-5.0,12.0,0.5075774192810059,372.1357279273249,73,-137,346,154,1158,223,169,14,56.04
-5,13,0,-5.0,13.0,0.5175154209136963,358.2080401107714,73,-132,333,154,1158,223,169,14,56.85
-6,11,0,-6.0,11.0,0.5235695838928223,345.77449298639715,73,-126,322,154,1158,223,169,14,50.21
-4,10,0,-4.0,10.0,0.532212495803833,335.0044775820168,73,-122,312,154,1158,223,169,14,48.44
-6,11,0,-6.0,11.0,0.5416414737701416,322.57867257461396,73,-116,301,154,1158,223,169,14,47.86
-5,10,0,-5.0,10.0,0.5475194454193115,311.4514408378937,73,-111,291,154,1158,223,169,14,44.6
-6,10,0,-6.0,10.0,0.5555264949798584,299.9766657591887,73,-105,281,154,1158,223,169,14,43.37
-6,10,0,-6.0,10.0,0.5635035037994385,288.5168972521367,73,-99,271,154,1158,223,169,14,42.15
-5,9,0,-5.0,9.0,0.5715196132659912,278.3522947633089,73,-94,262,154,1158,223,169,14,38.86
-5,9,0,-5.0,9.0,0.5797135829925537,268.19768828235635,73,-89,253,154,1158,223,169,14,37.83
-4,9,0,-4.0,9.0,0.5890665054321289,258.3815008858026,73,-85,244,154,1158,223,169,14,37.14
-3,9,0,-3.0,9.0,0.5955274105072021,248.8955604264568,73,-82,235,154,1158,223,169,14,37.42
-4,8,0,-4.0,8.0,0.6035065650939941,240.0270818053663,73,-78,227,154,1158,223,169,14,32.93
-3,7,0,-3.0,7.0,0.6132535934448242,232.43278598338918,73,-75,220,154,1158,223,169,14,30.27
-3,6,0,-3.0,6.0,0.6197605133056641,225.78751072634643,73,-72,214,154,1158,223,169,14,26.79
-2,6,0,-2.0,6.0,0.6313865184783936,219.46298093300382,73,-70,208,154,1158,223,169,14,28.73
-3,5,0,-3.0,5.0,0.6358075141906738,213.77090541044166,73,-67,203,154,1158,223,169,14,22.95
-2,5,0,-2.0,5.0,0.643634557723999,208.39625716408634,73,-65,198,154,1158,223,169,14,23.38
-2,5,0,-2.0,5.0,0.6542625427246094,203.0221662774782,73,-63,193,154,1158,223,169,14,22.97
-2,5,0,-2.0,5.0,0.6595315933227539,197.6486782146544,73,-61,188,154,1158,223,169,14,22.56
-2,5,0,-2.0,5.0,0.67061448097229,192.27584351654787,73,-59,183,154,1158,223,169,14,22.15
-1,5,0,-1.0,5.0,0.6759824752807617,187.21111078138497,73,-58,178,154,1158,223,169,14,20.39
-2,5,0,-2.0,5.0,0.6835315227508545,181.8378398463862,73,-56,173,154,1158,223,169,14,21.43
0,4,0,-0.0,4.0,0.6915204524993896,178.03651310896873,73,-56,169,154,1158,223,169,14,15.26
-2,4,0,-2.0,4.0,0.6996474266052246,173.61163555476344,73,-54,165,154,1158,223,169,14,17.64
0,4,0,-0.0,4.0,0.708160400390625,169.81460479004744,73,-54,161,154,1158,223,169,14,14.77
0,4,0,-0.0,4.0,0.7191634178161621,166.02710622064097,73,-54,157,154,1158,223,169,14,14.5
-1,4,0,-1.0,4.0,0.7248976230621338,161.91973320136123,73,-53,153,154,1158,223,169,14,16.8
-1,6,0,-1.0,6.0,0.7315254211425781,155.92626462530293,73,-52,147,154,1158,223,169,14,19.51
-2,5,0,-2.0,5.0,0.7395133972167969,150.5456741324705,73,-50,142,154,1158,223,169,14,19.67
-2,6,0,-2.0,6.0,0.7476675510406494,144.22205101855957,73,-48,136,154,1158,223,169,14,21.76
-2,6,0,-2.0,6.0,0.7555246353149414,137.8985134075056,73,-46,130,154,1158,223,169,14,21.18
-2,6,0,-2.0,6.0,0.7635035514831543,131.5750736271882,73,-44,124,154,1158,223,169,14,20.59
-2,5,0,-2.0,5.0,0.771803617477417,126.19429464123962,73,-42,119,154,1158,223,169,14,17.8
-2,6,0,-2.0,6.0,0.7795596122741699,119.87076374162301,73,-40,113,154,1158,223,169,14,19.59
-2,5,0,-2.0,5.0,0.7874984741210938,114.49017425089369,73,-38,108,154,1158,223,169,14,16.84
-1,4,0,-1.0,4.0,0.7954895496368408,110.38568747804219,73,-37,104,154,1158,223,169,14,13.39
-3,5,0,-3.0,5.0,0.8035495281219482,104.67568963231147,73,-34,99,154,1158,223,169,14,14.48
-2,5,0,-2.0,5.0,0.8116145133972168,99.29753269845128,73,-32,94,154,1158,223,169,14,15.34
-2,4,0,-2.0,4.0,0.8194985389709473,94.86832980505137,73,-30,90,154,1158,223,169,14,12.34
-3,4,0,-3.0,4.0,0.8275115489959717,90.13878188659973,73,-27,86,154,1158,223,169,14,11.21
-3,4,0,-3.0,4.0,0.8378186225891113,85.44003745317531,73,-24,82,154,1158,223,169,14,10.72
-2,3,0,-2.0,3.0,0.8435375690460205,82.00609733428362,73,-22,79,154,1158,223,169,14,8.85
-2,3,0,-2.0,3.0,0.8520464897155762,78.587530817554,73,-20,76,154,1158,223,169,14,8.55
-1,3,0,-1.0,3.0,0.8595285415649414,75.43208866258443,73,-19,73,154,1158,223,169,14,10.09
-1,2,0,-1.0,2.0,0.8676114082336426,73.24616030891995,73,-18,71,154,1158,223,169,14,6.97
0,2,0,-0.0,2.0,0.8756716251373291,71.30918594402827,73,-18,69,154,1158,223,169,14,6.26
0,1,0,-0.0,1.0,0.8860225677490234,70.3420215802759,73,-18,68,154,1158,223,169,14,4.54
0,1,0,-0.0,1.0,0.891573429107666,69.3757882838098,73,-18,67,154,1158,223,169,14,4.5
0,1,0,-0.0,1.0,0.8995935916900635,68.41052550594829,73,-18,66,154,1158,223,169,14,4.46
0,1,0,-0.0,1.0,0.9114065170288086,67.446274915669,73,-18,65,154,1158,223,169,14,4.41
-1,1,0,-1.0,1.0,0.9155266284942627,66.21933252457322,73,-17,64,154,1158,223,169,14,3.9
0,1,0,-0.0,1.0,0.9237716197967529,65.25335240430181,73,-17,63,154,1158,223,169,14,4.4
-1,1,0,-1.0,1.0,0.9315204620361328,64.03124237432849,73,-16,62,154,1158,223,169,14,3.81
0,2,0,-0.0,2.0,0.940077543258667,62.0966987850401,73,-16,60,154,1158,223,169,14,5.85
-2,2,0,-2.0,2.0,0.9475154876708984,59.665735560705194,73,-14,58,154,1158,223,169,14,5.36
-1,3,0,-1.0,3.0,0.9558234214782715,56.515484603779164,73,-13,55,154,1158,223,169,14,8.58
-1,3,0,-1.0,3.0,0.9638595581054688,53.36665625650534,73,-12,52,154,1158,223,169,14,8.3
-2,3,0,-2.0,3.0,0.9714975357055664,50.00999900019995,73,-10,49,154,1158,223,169,14,6.38
-1,2,0,-1.0,2.0,0.9795365333557129,47.853944456021594,73,-9,47,154,1158,223,169,14,5.43
-2,4,0,-2.0,4.0,0.9878404140472412,43.56604182158393,73,-7,43,154,1158,223,169,14,7.12
-1,2,0,-1.0,2.0,0.9955105781555176,41.43669871020132,73,-6,41,154,1158,223,169,14,4.87
-1,3,0,-1.0,3.0,1.004638433456421,38.3275357934736,73,-5,38,154,1158,223,169,14,6.34
-1,2,0,-1.0,2.0,1.0117785930633545,36.22154055254967,73,-4,36,154,1158,223,169,14,4.43
-1,3,0,-1.0,3.0,1.019526481628418,33.13608305156178,73,-3,33,154,1158,223,169,14,5.69
-1,2,0,-1.0,2.0,1.0275254249572754,31.064449134018133,73,-2,31,154,1158,223,169,14,3.95
-1,2,0,-1.0,2.0,1.0355184078216553,29.017236257093817,73,-1,29,154,1158,223,169,14,3.71
0,1,0,-0.0,1.0,1.0437586307525635,28.0178514522438,73,-1,28,154,1158,223,169,14,6.01
-1,1,0,-1.0,1.0,1.0545024871826172,27.0,73,0,27,154,1158,223,169,14,1.88
0,1,0,-0.0,1.0,1.0595135688781738,26.0,73,0,26,154,1158,223,169,14,7.85
-1,1,0,-1.0,1.0,1.067624568939209,25.019992006393608,73,1,25,154,1158,223,169,14,1.7
0,2,0,-0.0,2.0,1.0795326232910156,23.021728866442675,73,1,23,154,1158,223,169,14,6.39
-1,1,0,-1.0,1.0,1.0836715698242188,22.090722034374522,73,2,22,154,1158,223,169,14,1.46
0,1,0,-0.0,1.0,1.0915405750274658,21.095023109728988,73,2,21,154,1158,223,169,14,4.63
-1,2,0,-1.0,2.0,1.0995125770568848,19.235384061671343,73,3,19,154,1158,223,169,14,2.43
0,2,0,-0.0,2.0,1.1075785160064697,17.26267650163207,73,3,17,154,1158,223,169,14,4.2
-1,2,0,-1.0,2.0,1.1160216331481934,15.524174696260024,73,4,15,154,1158,223,169,14,1.85
0,2,0,-0.0,2.0,1.1235084533691406,13.601470508735444,73,4,13,154,1158,223,169,14,3.14
-1,2,0,-1.0,2.0,1.1316115856170654,12.083045973594572,73,5,11,154,1158,223,169,14,1.12
0,1,0,-0.0,1.0,1.1396944522857666,11.180339887498949,73,5,10,154,1158,223,169,14,1.92
-1,2,0,-1.0,2.0,1.150728464126587,10.0,73,6,8,154,1158,223,169,14,0.38
0,1,0,-0.0,1.0,1.1555736064910889,9.219544457292887,73,6,7,154,1158,223,169,14,1.1
0,2,0,-0.0,2.0,1.1637356281280518,7.810249675906654,73,6,5,154,1158,223,169,14,0.69
-1,1,0,-1.0,1.0,1.174034595489502,8.06225774829855,73,7,4,154,1158,223,169,14,1.9
0,2,0,-0.0,2.0,1.1795544624328613,7.280109889280518,73,7,2,154,1158,223,169,14,-0.34
0,1,0,-0.0,1.0,1.1955084800720215,7.0710678118654755,73,7,1,154,1158,223,169,14,-0.43
-1,0,0,-1.0,-0.0,1.2035374641418457,8.06225774829855,73,8,1,154,1158,223,169,14,3.23
0,0,1,-0.0,-0.0,1.2695274353027344,8.06225774829855,73,8,1,154,1158,223,169,14,29.3
0,0,0,-0.0,-0.0,0.09362459182739258,1739.2458135640286,74,1476,-920,1622,237,146,1157,74,277.23
1,0,0,1.0,-0.0,0.10760259628295898,1738.3972503429704,74,1475,-920,1622,237,146,1157,74,4.66
2,0,0,2.0,-0.0,0.11563849449157715,1736.7006074738385,74,1473,-920,1622,237,146,1157,74,7.65
4,-1,0,4.0,-1.0,0.1241905689239502,1732.778693313142,74,1469,-919,1622,237,146,1157,74,15.96
2,-1,0,2.0,-1.0,0.13161253929138184,1730.5528018526334,74,1467,-918,1622,237,146,1157,74,11.82
4,-1,0,4.0,-1.0,0.1396934986114502,1726.631981633608,74,1463,-917,1622,237,146,1157,74,15.93
4,-2,0,4.0,-2.0,0.14874053001403809,1722.1805944789878,74,1459,-915,1622,237,146,1157,74,19.18
5,-1,0,5.0,-1.0,0.1556084156036377,1717.414335563786,74,1454,-914,1622,237,146,1157,74,18.42
6,-2,0,6.0,-2.0,0.16365456581115723,1711.2708727726304,74,1448,-912,1622,237,146,1157,74,23.28
8,-2,0,8.0,-2.0,0.1716156005859375,1703.4377006512448,74,1440,-910,1622,237,146,1157,74,27.94
9,-2,0,9.0,-2.0,0.18217849731445312,1694.7639953692667,74,1431,-908,1622,237,146,1157,74,30.2
10,-3,0,10.0,-3.0,0.187713623046875,1684.7154062333495,74,1421,-905,1622,237,146,1157,74,34.32
12,-3,0,12.0,-3.0,0.19567561149597168,1672.9868499184327,74,1409,-902,1622,237,146,1157,74,38.54
15,-4,0,15.0,-4.0,0.20648455619812012,1658.2038475410675,74,1394,-898,1622,237,146,1157,74,46.24
17,-6,0,17.0,-6.0,0.2119734287261963,1640.668461329101,74,1377,-892,1622,237,146,1157,74,52.93
20,-6,0,20.0,-6.0,0.21999359130859375,1620.6310499308595,74,1357,-886,1622,237,146,1157,74,57.92
20,-8,0,20.0,-8.0,0.23129057884216309,1599.5164894429815,74,1337,-878,1622,237,146,1157,74,60.32
23,-10,0,23.0,-10.0,0.23567461967468262,1574.80792479591,74,1314,-868,1622,237,146,1157,74,67.28
27,-13,0,27.0,-13.0,0.24383258819580078,1545.1194128610255,74,1287,-855,1622,237,146,1157,74,76.05
28,-15,0,28.0,-15.0,0.2516145706176758,1513.499587049828,74,1259,-840,1622,237,146,1157,74,78.96
30,-18,0,30.0,-18.0,0.25966763496398926,1478.5550378663622,74,1229,-822,1622,237,146,1157,74,84.1
30,-19,0,30.0,-19.0,0.26946163177490234,1443.0557854774706,74,1199,-803,1622,237,146,1157,74,84.56
32,-18,0,32.0,-18.0,0.2756166458129883,1406.454407366268,74,1167,-785,1622,237,146,1157,74,83.83
33,-18,0,33.0,-18.0,0.28361058235168457,1369.030678984222,74,1134,-767,1622,237,146,1157,74,83.6
36,-19,0,36.0,-19.0,0.291595458984375,1328.5736712730686,74,1098,-748,1622,237,146,1157,74,86.17
40,-22,0,40.0,-22.0,0.29961657524108887,1283.1367814851228,74,1058,-726,1622,237,146,1157,74,90.89
37,-21,0,37.0,-21.0,0.30760955810546875,1240.752191213056,74,1021,-705,1622,237,146,1157,74,85.76
38,-22,0,38.0,-22.0,0.318650484085083,1196.9870508906936,74,983,-683,1622,237,146,1157,74,85.82
36,-23,0,36.0,-23.0,0.32363247871398926,1154.3002209130864,74,947,-660,1622,237,146,1157,74,83.73
36,-23,0,36.0,-23.0,0.3329124450683594,1111.6159408716665,74,911,-637,1622,237,146,1157,74,81.99
35,-26,0,35.0,-26.0,0.3428316116333008,1068.0341754831632,74,876,-611,1622,237,146,1157,74,81.56
34,-28,0,34.0,-28.0,0.34775447845458984,1024.1352449749984,74,842,-583,1622,237,146,1157,74,78.86
34,-29,0,34.0,-29.0,0.35561156272888184,979.6836224006197,74,808,-554,1622,237,146,1157,74,77.19
34,-30,0,34.0,-30.0,0.3635904788970947,934.6935326619094,74,774,-524,1622,237,146,1157,74,75.43
31,-28,0,31.0,-28.0,0.37167954444885254,893.344838234374,74,743,-496,1622,237,146,1157,74,69.68
32,-26,0,32.0,-26.0,0.37963151931762695,852.3033497528917,74,711,-470,1622,237,146,1157,74,68.01
30,-23,0,30.0,-23.0,0.3876166343688965,814.5980603954321,74,681,-447,1622,237,146,1157,74,63.26
30,-22,0,30.0,-22.0,0.395735502243042,777.448390570075,74,651,-425,1622,237,146,1157,74,61.36
29,-19,0,29.0,-19.0,0.4038245677947998,742.7785672729121,74,622,-406,1622,237,146,1157,74,59.49
29,-19,0,29.0,-19.0,0.41161060333251953,708.1087487102528,74,593,-387,1622,237,146,1157,74,57.91
25,-16,0,25.0,-16.0,0.41985058784484863,678.4283307763613,74,568,-371,1622,237,146,1157,74,50.8
25,-16,0,25.0,-16.0,0.42922258377075195,648.7480250451634,74,543,-355,1622,237,146,1157,74,49.5
21,-13,0,21.0,-13.0,0.4356215000152588,624.0576896409498,74,522,-342,1622,237,146,1157,74,42.31
18,-13,0,18.0,-13.0,0.44362545013427734,601.8778945932472,74,504,-329,1622,237,146,1157,74,37.99
17,-11,0,17.0,-11.0,0.45295047760009766,581.6296072243915,74,487,-318,1622,237,146,1157,74,36.81
16,-11,0,16.0,-11.0,0.45963263511657715,562.21881861069,74,471,-307,1622,237,146,1157,74,34.04
16,-10,0,16.0,-10.0,0.46764063835144043,543.3543963197501,74,455,-297,1622,237,146,1157,74,32.97
16,-8,0,16.0,-8.0,0.4756464958190918,525.5872905617106,74,439,-289,1622,237,146,1157,74,29.11
18,-9,0,18.0,-9.0,0.48362159729003906,505.609533137974,74,421,-280,1622,237,146,1157,74,30.82
17,-7,0,17.0,-7.0,0.49162864685058594,487.5910171444917,74,404,-273,1622,237,146,1157,74,27.38
18,-7,0,18.0,-7.0,0.5077664852142334,468.7771325480798,74,386,-266,1622,237,146,1157,74,27.37
15,-6,0,15.0,-6.0,0.5079545974731445,453.03531871146646,74,371,-260,1622,237,146,1157,74,23.57
15,-7,0,15.0,-7.0,0.5156154632568359,436.74363189404374,74,356,-253,1622,237,146,1157,74,23.95
15,-7,0,15.0,-7.0,0.5236215591430664,420.47235343123333,74,341,-246,1622,237,146,1157,74,23.32
13,-6,0,13.0,-6.0,0.5355474948883057,406.4283454681772,74,328,-240,1622,237,146,1157,74,20.48
12,-6,0,12.0,-6.0,0.5397005081176758,393.20732444856617,74,316,-234,1622,237,146,1157,74,19.41
11,-6,0,11.0,-6.0,0.5478806495666504,380.80047268878224,74,305,-228,1622,237,146,1157,74,18.46
10,-4,0,10.0,-4.0,0.5556304454803467,370.4065334197009,74,295,-224,1622,237,146,1157,74,15.21
9,-6,0,9.0,-6.0,0.5636305809020996,359.6109008358896,74,286,-218,1622,237,146,1157,74,17.23
10,-6,0,10.0,-6.0,0.5716276168823242,348.0229877464993,74,276,-212,1622,237,146,1157,74,16.98
8,-5,0,8.0,-5.0,0.5796165466308594,338.6340207362515,74,268,-207,1622,237,146,1157,74,14.71
8,-6,0,8.0,-6.0,0.5876336097717285,328.63505595112645,74,260,-201,1622,237,146,1157,74,17.06
7,-5,0,7.0,-5.0,0.5956034660339355,320.0390601161052,74,253,-196,1622,237,146,1157,74,14.57
8,-7,0,8.0,-7.0,0.6036064624786377,309.4285054742048,74,245,-189,1622,237,146,1157,74,15.73
7,-5,0,7.0,-5.0,0.6119644641876221,300.83217912982644,74,238,-184,1622,237,146,1157,74,14.16
7,-5,0,7.0,-5.0,0.619673490524292,292.2362058335688,74,231,-179,1622,237,146,1157,74,13.93
7,-7,0,7.0,-7.0,0.627671480178833,282.41812972966164,74,224,-172,1622,237,146,1157,74,13.33
6,-6,0,6.0,-6.0,0.6356315612792969,274.0072991728505,74,218,-166,1622,237,146,1157,74,11.84
6,-6,0,6.0,-6.0,0.6436104774475098,265.60120481654445,74,212,-160,1622,237,146,1157,74,11.59
7,-6,0,7.0,-6.0,0.653740644454956,256.40007800310826,74,205,-154,1622,237,146,1157,74,13.0
6,-6,0,6.0,-6.0,0.6599264144897461,248.0020161208372,74,199,-148,1622,237,146,1157,74,11.09
6,-6,0,6.0,-6.0,0.6682755947113037,239.61009995407122,74,193,-142,1622,237,146,1157,74,10.83
7,-6,0,7.0,-6.0,0.6781585216522217,230.41701326073994,74,186,-136,1622,237,146,1157,74,12.07
6,-6,0,6.0,-6.0,0.6837265491485596,222.03603311174518,74,180,-130,1622,237,146,1157,74,10.29
7,-6,0,7.0,-6.0,0.6919386386871338,212.8497122384712,74,173,-124,1622,237,146,1157,74,11.43
7,-6,0,7.0,-6.0,0.699608564376831,203.66639388961548,74,166,-118,1622,237,146,1157,74,11.11
8,-7,0,8.0,-7.0,0.7076375484466553,193.0932417253385,74,158,-111,1622,237,146,1157,74,11.5
9,-7,0,9.0,-7.0,0.7176334857940674,181.70580618131055,74,149,-104,1622,237,146,1157,74,12.51
10,-6,0,10.0,-6.0,0.7237584590911865,170.07351351694948,74,139,-98,1622,237,146,1157,74,11.79
9,-6,0,9.0,-6.0,0.7317636013031006,159.26079241294764,74,130,-92,1622,237,146,1157,74,12.05
8,-5,0,8.0,-5.0,0.7425224781036377,149.84325143295575,74,122,-87,1622,237,146,1157,74,10.09
6,-4,0,6.0,-4.0,0.7476634979248047,142.63590010933433,74,116,-83,1622,237,146,1157,74,9.38
5,-4,0,5.0,-4.0,0.7562685012817383,136.24243098242192,74,111,-79,1622,237,146,1157,74,8.19
4,-2,0,4.0,-2.0,0.7664644718170166,131.8256424221024,74,107,-77,1622,237,146,1157,74,5.73
3,-2,0,3.0,-2.0,0.7717654705047607,128.22246293064254,74,104,-75,1622,237,146,1157,74,7.03
4,-2,0,4.0,-2.0,0.7796604633331299,123.81033882515628,74,100,-73,1622,237,146,1157,74,5.53
2,-2,0,2.0,-2.0,0.7911596298217773,121.01652779682617,74,98,-71,1622,237,146,1157,74,4.75
3,-1,0,3.0,-1.0,0.7960455417633057,118.00423721205946,74,95,-70,1622,237,146,1157,74,3.89
1,-1,0,1.0,-1.0,0.803640604019165,116.60617479361889,74,94,-69,1622,237,146,1157,74,4.06
1,-1,0,1.0,-1.0,0.8116226196289062,115.20850663036997,74,93,-68,1622,237,146,1157,74,4.04
2,-1,0,2.0,-1.0,0.8198084831237793,113.00442469213318,74,91,-67,1622,237,146,1157,74,4.27
2,-1,0,2.0,-1.0,0.8276164531707764,110.80162453682708,74,89,-66,1622,237,146,1157,74,4.22
2,-1,0,2.0,-1.0,0.8356525897979736,108.60018416190647,74,87,-65,1622,237,146,1157,74,4.17
3,-2,0,3.0,-2.0,0.8436105251312256,105.0,74,84,-63,1622,237,146,1157,74,6.22
2,-1,0,2.0,-1.0,0.8521404266357422,102.80077820717118,74,82,-62,1622,237,146,1157,74,4.07
4,-2,0,4.0,-2.0,0.859642505645752,98.40731680114035,74,78,-60,1622,237,146,1157,74,4.85
3,-3,0,3.0,-3.0,0.8676104545593262,94.2019108086455,74,75,-57,1622,237,146,1157,74,5.16
4,-2,0,4.0,-2.0,0.8756625652313232,89.81091247727082,74,71,-55,1622,237,146,1157,74,4.65
4,-3,0,4.0,-3.0,0.8836014270782471,84.81155581640984,74,67,-52,1622,237,146,1157,74,7.64
4,-3,0,4.0,-3.0,0.8916466236114502,79.81227975693966,74,63,-49,1622,237,146,1157,74,7.48
4,-2,0,4.0,-2.0,0.8996374607086182,75.43208866258443,74,59,-47,1622,237,146,1157,74,4.25
4,-3,0,4.0,-3.0,0.9076735973358154,70.43436661176133,74,55,-44,1622,237,146,1157,74,6.7
3,-2,0,3.0,-2.0,0.9203305244445801,66.84309986827361,74,52,-42,1622,237,146,1157,74,4.94
3,-3,0,3.0,-3.0,0.9240496158599854,62.625873247404705,74,49,-39,1622,237,146,1157,74,4.74
3,-2,0,3.0,-2.0,0.9316215515136719,59.033888572581766,74,46,-37,1622,237,146,1157,74,4.82
3,-2,0,3.0,-2.0,0.939631462097168,55.44366510251645,74,43,-35,1622,237,146,1157,74,4.66
2,-1,0,2.0,-1.0,0.9476416110992432,53.2634959423431,74,41,-34,1622,237,146,1157,74,3.17
1,-2,0,1.0,-2.0,0.9556095600128174,51.22499389946279,74,40,-32,1622,237,146,1157,74,2.21
2,-1,0,2.0,-1.0,0.9656624794006348,49.040799340956916,74,38,-31,1622,237,146,1157,74,3.15
1,-1,0,1.0,-1.0,0.971604585647583,47.634021455258214,74,37,-30,1622,237,146,1157,74,4.02
1,-1,0,1.0,-1.0,0.9796736240386963,46.22769732530488,74,36,-29,1622,237,146,1157,74,3.96
1,-1,0,1.0,-1.0,0.9894585609436035,44.82186966202994,74,35,-28,1622,237,146,1157,74,3.91
1,0,0,1.0,-0.0,0.9981036186218262,44.04543109109048,74,34,-28,1622,237,146,1157,74,1.31
0,0,1,-0.0,-0.0,1.019627571105957,44.04543109109048,74,34,-28,1622,237,146,1157,74,40.25
0,0,0,-0.0,-0.0,0.09571361541748047,204.86336910243372,75,-88,-185,1500,80,1588,265,56,74.92
-1,2,0,-1.0,2.0,0.11880254745483398,206.24742422634034,75,-87,-187,1500,80,1588,265,56,1.66
-1,3,0,-1.0,3.0,0.12673163414001465,208.55694665965936,75,-86,-190,1500,80,1588,265,56,1.52
-2,4,0,-2.0,4.0,0.13589167594909668,211.40482492128697,75,-84,-194,1500,80,1588,265,56,1.14
-2,4,0,-2.0,4.0,0.14281463623046875,214.30818929756276,75,-82,-198,1500,80,1588,265,56,1.17
-3,3,0,-3.0,3.0,0.15074753761291504,215.96759016111653,75,-79,-201,1500,80,1588,265,56,1.1
-3,4,0,-3.0,4.0,0.16056346893310547,218.6343980255623,75,-76,-205,1500,80,1588,265,56,0.98
-3,3,0,-3.0,3.0,0.166825532913208,220.43819995635965,75,-73,-208,1500,80,1588,265,56,1.1
-3,4,0,-3.0,4.0,0.17481064796447754,223.2576986354558,75,-70,-212,1500,80,1588,265,56,1.02
-5,4,0,-5.0,4.0,0.1882936954498291,225.5681715136247,75,-65,-216,1500,80,1588,265,56,0.78
-7,5,0,-7.0,5.0,0.19074463844299316,228.4841351166422,75,-58,-221,1500,80,1588,265,56,0.56
-7,7,0,-7.0,7.0,0.1994166374206543,233.63432966925043,75,-51,-228,1500,80,1588,265,56,0.55
-11,6,0,-11.0,6.0,0.20676159858703613,237.39418695494632,75,-40,-234,1500,80,1588,265,56,0.3
-11,6,0,-11.0,6.0,0.21471452713012695,241.7457341919398,75,-29,-240,1500,80,1588,265,56,0.31
-9,4,0,-9.0,4.0,0.22272348403930664,244.8182999695897,75,-20,-244,1500,80,1588,265,56,0.51
-9,3,0,-9.0,3.0,0.23085355758666992,247.24481794367298,75,-11,-247,1500,80,1588,265,56,0.59
-7,2,0,-7.0,2.0,0.2387557029724121,249.0321264415497,75,-4,-249,1500,80,1588,265,56,0.87
-5,1,0,-5.0,1.0,0.24677157402038574,250.00199999200007,75,1,-250,1500,80,1588,265,56,1.55
-5,1,0,-5.0,1.0,0.25631260871887207,251.07170290576354,75,6,-251,1500,80,1588,265,56,1.44
-5,1,0,-5.0,1.0,0.26294565200805664,252.23996511258878,75,11,-252,1500,80,1588,265,56,1.36
-3,0,0,-3.0,-0.0,0.27074265480041504,252.38858928247924,75,14,-252,1500,80,1588,265,56,8.61
-3,-1,0,-3.0,-1.0,0.2796366214752197,251.57503850740042,75,17,-251,1500,80,1588,265,56,1.41
-3,-1,0,-3.0,-1.0,0.2867166996002197,250.79872407968904,75,20,-250,1500,80,1588,265,56,1.34
-2,-3,0,-2.0,-3.0,0.29556965827941895,247.97782158894776,75,22,-247,1500,80,1588,265,56,4.94
-3,-4,0,-3.0,-4.0,0.3027176856994629,244.28262320517192,75,25,-243,1500,80,1588,265,56,5.79
-3,-7,0,-3.0,-7.0,0.310774564743042,237.65521244020718,75,28,-236,1500,80,1588,265,56,9.42
-3,-7,0,-3.0,-7.0,0.32056760787963867,231.08872754853275,75,31,-229,1500,80,1588,265,56,9.14
-2,-6,0,-2.0,-6.0,0.32678961753845215,225.42848089804446,75,33,-223,1500,80,1588,265,56,8.27
-2,-8,0,-2.0,-8.0,0.33475661277770996,217.83020910791964,75,35,-215,1500,80,1588,265,56,10.19
-3,-10,0,-3.0,-10.0,0.34480762481689453,208.4922060893404,75,38,-205,1500,80,1588,265,56,11.22
-4,-9,0,-4.0,-9.0,0.3512907028198242,200.44949488586894,75,42,-196,1500,80,1588,265,56,9.4
-2,-9,0,-2.0,-9.0,0.3589797019958496,192.1067411623028,75,44,-187,1500,80,1588,265,56,9.87
-1,-8,0,-1.0,-8.0,0.37264347076416016,184.5697700058165,75,45,-179,1500,80,1588,265,56,9.23
-1,-9,0,-1.0,-9.0,0.37476158142089844,176.11359970201053,75,46,-170,1500,80,1588,265,56,9.66
0,-8,0,-0.0,-8.0,0.3845846652984619,168.40427548016706,75,46,-162,1500,80,1588,265,56,9.25
-1,-9,0,-1.0,-9.0,0.39080357551574707,160.0562401157793,75,47,-153,1500,80,1588,265,56,8.87
0,-8,0,-0.0,-8.0,0.39914870262145996,152.42703172337903,75,47,-145,1500,80,1588,265,56,8.47
0,-9,0,-0.0,-9.0,0.40780162811279297,143.8923208513922,75,47,-136,1500,80,1588,265,56,8.68
1,-9,0,1.0,-9.0,0.41470861434936523,135.07405376311175,75,46,-127,1500,80,1588,265,56,8.99
0,-7,0,-0.0,-7.0,0.42272067070007324,128.51459061133875,75,46,-120,1500,80,1588,265,56,6.73
2,-7,0,2.0,-7.0,0.4307126998901367,121.26417442921878,75,44,-113,1500,80,1588,265,56,8.78
0,-7,0,-0.0,-7.0,0.43871450424194336,114.76933388322858,75,44,-106,1500,80,1588,265,56,6.14
1,-6,0,1.0,-6.0,0.44675159454345703,108.85311203635843,75,43,-100,1500,80,1588,265,56,6.32
0,-6,0,-0.0,-6.0,0.45473647117614746,103.36827366266692,75,43,-94,1500,80,1588,265,56,5.1
1,-6,0,1.0,-6.0,0.46273064613342285,97.50897394599124,75,42,-88,1500,80,1588,265,56,5.72
0,-5,0,-0.0,-5.0,0.47155261039733887,93.02150289046077,75,42,-83,1500,80,1588,265,56,4.17
1,-4,0,1.0,-4.0,0.4836006164550781,89.00561780022652,75,41,-79,1500,80,1588,265,56,4.83
1,-5,0,1.0,-5.0,0.48672962188720703,84.11896337925236,75,40,-74,1500,80,1588,265,56,4.76
1,-4,0,1.0,-4.0,0.49471259117126465,80.1311425102625,75,39,-70,1500,80,1588,265,56,4.43
1,-4,0,1.0,-4.0,0.502739667892456,76.15773105863909,75,38,-66,1500,80,1588,265,56,4.26
1,-4,0,1.0,-4.0,0.5107285976409912,72.20110802473879,75,37,-62,1500,80,1588,265,56,4.07
1,-3,0,1.0,-3.0,0.5187335014343262,69.1158447825099,75,36,-59,1500,80,1588,265,56,4.02
2,-3,0,2.0,-3.0,0.5267186164855957,65.5133574166368,75,34,-56,1500,80,1588,265,56,6.27
2,-3,0,2.0,-3.0,0.5357136726379395,61.91122676865643,75,32,-53,1500,80,1588,265,56,6.12
2,-3,0,2.0,-3.0,0.5452985763549805,58.309518948453004,75,30,-50,1500,80,1588,265,56,5.97
1,-2,0,1.0,-2.0,0.550971508026123,56.08029957123981,75,29,-48,1500,80,1588,265,56,4.85
2,-2,0,2.0,-2.0,0.5620834827423096,53.33854141237835,75,27,-46,1500,80,1588,265,56,3.41
1,-2,0,1.0,-2.0,0.5667455196380615,51.10772935672255,75,26,-44,1500,80,1588,265,56,4.92
1,-2,0,1.0,-2.0,0.5747065544128418,48.877397639399746,75,25,-42,1500,80,1588,265,56,4.83
2,-1,0,2.0,-1.0,0.5827286243438721,47.01063709417264,75,23,-41,1500,80,1588,265,56,1.84
0,-1,0,-0.0,-1.0,0.5960805416107178,46.14108798023731,75,23,-40,1500,80,1588,265,56,1.83
0,0,1,-0.0,-0.0,0.610724687576294,46.14108798023731,75,23,-40,1500,80,1588,265,56,40.89
0,0,0,-0.0,-0.0,0.07941746711730957,458.53026072441503,76,-415,195,1062,315,1477,120,75,128.04
-1,1,0,-1.0,1.0,0.15632843971252441,457.20017497809425,76,-414,194,1062,315,1477,120,75,4.33
-3,2,0,-3.0,2.0,0.16339659690856934,453.6353160855094,76,-411,192,1062,315,1477,120,75,8.75
-1,0,0,-1.0,-0.0,0.1873774528503418,452.7294998119738,76,-410,192,1062,315,1477,120,75,3.35
-2,1,0,-2.0,1.0,0.19535160064697266,450.4941731032711,76,-408,191,1062,315,1477,120,75,8.77
-6,3,0,-6.0,3.0,0.20336151123046875,443.78823778915097,76,-402,188,1062,315,1477,120,75,14.95
-10,5,0,-10.0,5.0,0.21148037910461426,432.6118352518803,76,-392,183,1062,315,1477,120,75,20.25
-14,8,0,-14.0,8.0,0.2193765640258789,416.5441153107315,76,-378,175,1062,315,1477,120,75,23.79
-14,9,0,-14.0,9.0,0.23090052604675293,400.064994719608,76,-364,166,1062,315,1477,120,75,22.95
-13,10,0,-13.0,10.0,0.23540258407592773,384.1054542700481,76,-351,156,1062,315,1477,120,75,21.21
-12,10,0,-12.0,10.0,0.24335455894470215,369.10296666377525,76,-339,146,1062,315,1477,120,75,19.51
-13,9,0,-13.0,9.0,0.2513694763183594,353.61702447704636,76,-326,137,1062,315,1477,120,75,19.88
-13,9,0,-13.0,9.0,0.259352445602417,338.16120416156554,76,-313,128,1062,315,1477,120,75,19.23
-14,8,0,-14.0,8.0,0.26752448081970215,322.1816257951406,76,-299,120,1062,315,1477,120,75,19.71
-14,7,0,-14.0,7.0,0.27631545066833496,306.5844092578747,76,-285,113,1062,315,1477,120,75,19.4
-11,7,0,-11.0,7.0,0.28339457511901855,293.7890399589474,76,-274,106,1062,315,1477,120,75,15.54
-8,6,0,-8.0,6.0,0.2913804054260254,284.17600180170035,76,-266,100,1062,315,1477,120,75,12.03
-7,4,0,-7.0,4.0,0.300248384475708,276.2191159206763,76,-259,96,1062,315,1477,120,75,11.12
-6,4,0,-6.0,4.0,0.3073725700378418,269.2080979465514,76,-253,92,1062,315,1477,120,75,9.61
-4,4,0,-4.0,4.0,0.31554245948791504,264.09278672466615,76,-249,88,1062,315,1477,120,75,6.93
-6,3,0,-6.0,3.0,0.3233635425567627,257.4373710244882,76,-243,85,1062,315,1477,120,75,9.91
-6,3,0,-6.0,3.0,0.33144450187683105,250.78476827750126,76,-237,82,1062,315,1477,120,75,9.74
-9,5,0,-9.0,5.0,0.3409404754638672,240.65119987234635,76,-228,77,1062,315,1477,120,75,11.87
-11,4,0,-11.0,4.0,0.3473854064941406,228.9497761518888,76,-217,73,1062,315,1477,120,75,15.06
-14,5,0,-14.0,5.0,0.355365514755249,214.0864311440592,76,-203,68,1062,315,1477,120,75,16.83
-16,6,0,-16.0,6.0,0.36334657669067383,197.0101520226813,76,-187,62,1062,315,1477,120,75,16.68
-18,5,0,-18.0,5.0,0.3714115619659424,178.35358140502814,76,-169,57,1062,315,1477,120,75,16.16
-19,6,0,-19.0,6.0,0.37970447540283203,158.43295111813072,76,-150,51,1062,315,1477,120,75,16.67
-20,6,0,-20.0,6.0,0.3873724937438965,137.56816492197603,76,-130,45,1062,315,1477,120,75,15.07
-17,5,0,-17.0,5.0,0.3953695297241211,119.87076374162301,76,-113,40,1062,315,1477,120,75,12.47
-16,4,0,-16.0,4.0,0.40361642837524414,103.46496991735899,76,-97,36,1062,315,1477,120,75,10.13
-13,4,0,-13.0,4.0,0.41136837005615234,89.88882021697692,76,-84,32,1062,315,1477,120,75,9.17
-10,3,0,-10.0,3.0,0.41936349868774414,79.47955712005447,76,-74,29,1062,315,1477,120,75,7.42
-8,2,0,-8.0,2.0,0.42769551277160645,71.30918594402827,76,-66,27,1062,315,1477,120,75,5.7
-7,1,0,-7.0,1.0,0.43535542488098145,64.47480127925948,76,-59,26,1062,315,1477,120,75,4.21
-4,1,0,-4.0,1.0,0.4433615207672119,60.41522986797286,76,-55,25,1062,315,1477,120,75,3.99
-2,0,0,-2.0,-0.0,0.45310258865356445,58.60034129593445,76,-53,25,1062,315,1477,120,75,2.24
-1,0,0,-1.0,-0.0,0.45943737030029297,57.697486947006624,76,-52,25,1062,315,1477,120,75,2.04
0,0,1,-0.0,-0.0,0.5153944492340088,57.697486947006624,76,-52,25,1062,315,1477,120,75,44.41
-1,0,1,-1.0,-0.0,0.026804447174072266,780.2339392771888,77,-379,682,734,972,1114,290,64,1.97
-1,0,1,-1.0,-0.0,0.04280447959899902,779.748677459603,77,-378,682,734,972,1114,290,64,1.97
-1,0,1,-1.0,-0.0,0.05080127716064453,779.2643967229608,77,-377,682,734,972,1114,290,64,1.96
-3,1,1,-3.0,1.0,0.05918526649475098,776.9407956852311,77,-374,681,734,972,1114,290,64,7.13
-3,1,1,-3.0,1.0,0.06682538986206055,774.6231341755808,77,-371,680,734,972,1114,290,64,7.1
-3,1,1,-3.0,1.0,0.07494735717773438,772.3114656665405,77,-368,679,734,972,1114,290,64,7.07
-4,3,1,-4.0,3.0,0.08279728889465332,767.7707991321369,77,-364,676,734,972,1114,290,64,13.12
-5,3,1,-5.0,3.0,0.09081840515136719,762.7647081505542,77,-359,673,734,972,1114,290,64,13.82
0,0,0,-0.0,-0.0,0.09779644012451172,762.7647081505542,77,-359,673,734,972,1114,290,64,175.62
-7,3,0,-7.0,3.0,0.09878349304199219,756.8381597144795,77,-352,670,734,972,1114,290,64,15.46
-9,5,0,-9.0,5.0,0.11015939712524414,748.247285327518,77,-343,665,734,972,1114,290,64,21.14
-8,4,0,-8.0,4.0,0.11479043960571289,741.0438583511775,77,-335,661,734,972,1114,290,64,18.07
-9,4,0,-9.0,4.0,0.12279248237609863,733.4337052522197,77,-326,657,734,972,1114,290,64,18.68
-9,5,0,-9.0,5.0,0.13078927993774414,724.9779306985834,77,-317,652,734,972,1114,290,64,20.42
-9,4,0,-9.0,4.0,0.13895940780639648,717.4733444526006,77,-308,648,734,972,1114,290,64,18.18
-9,4,0,-9.0,4.0,0.14679431915283203,710.0260558599241,77,-299,644,734,972,1114,290,64,17.94
-8,3,0,-8.0,3.0,0.1547863483428955,703.9616466825448,77,-291,641,734,972,1114,290,64,14.9
-6,3,0,-6.0,3.0,0.16300034523010254,698.7624775272353,77,-285,638,734,972,1114,290,64,13.22
-5,3,0,-5.0,3.0,0.17150330543518066,693.9920748827035,77,-280,635,734,972,1114,290,64,12.42
-5,2,0,-5.0,2.0,0.18097138404846191,690.1550550419811,77,-275,633,734,972,1114,290,64,10.02
-4,4,0,-4.0,4.0,0.1868114471435547,684.8956124841216,77,-271,629,734,972,1114,290,64,14.04
-7,5,0,-7.0,5.0,0.19526934623718262,677.548522247669,77,-264,624,734,972,1114,290,64,17.63
-8,5,0,-8.0,5.0,0.20565247535705566,669.8484903319556,77,-256,619,734,972,1114,290,64,18.02
-10,7,0,-10.0,7.0,0.21084237098693848,659.5907822278901,77,-246,612,734,972,1114,290,64,22.65
-11,9,0,-11.0,9.0,0.21896839141845703,647.1738560850554,77,-235,603,734,972,1114,290,64,26.24
-13,12,0,-13.0,12.0,0.22972846031188965,631.320045618702,77,-222,591,734,972,1114,290,64,31.33
-14,13,0,-14.0,13.0,0.23480629920959473,614.2865780724824,77,-208,578,734,972,1114,290,64,32.47
-14,15,0,-14.0,15.0,0.24280238151550293,595.4871954962592,77,-194,563,734,972,1114,290,64,34.43
-15,17,0,-15.0,17.0,0.25347328186035156,574.5928993644109,77,-179,546,734,972,1114,290,64,36.37
-14,17,0,-14.0,17.0,0.2590053081512451,554.1353625243565,77,-165,529,734,972,1114,290,64,35.08
-14,17,0,-14.0,17.0,0.2668454647064209,533.8023978964501,77,-151,512,734,972,1114,290,64,34.05
-15,19,0,-15.0,19.0,0.27788329124450684,511.414704520705,77,-136,493,734,972,1114,290,64,35.46
-14,19,0,-14.0,19.0,0.28280138969421387,489.44866942305606,77,-122,474,734,972,1114,290,64,34.07
-12,19,0,-12.0,19.0,0.29097747802734375,468.10789354592174,77,-110,455,734,972,1114,290,64,32.66
-13,20,0,-13.0,20.0,0.29886341094970703,445.683744374865,77,-97,435,734,972,1114,290,64,32.6
-12,18,0,-12.0,18.0,0.3069303035736084,425.57490527520537,77,-85,417,734,972,1114,290,64,29.2
-12,21,0,-12.0,21.0,0.3147742748260498,402.67232335982567,77,-73,396,734,972,1114,290,64,31.01
-10,19,0,-10.0,19.0,0.3228023052215576,382.227680839575,77,-63,377,734,972,1114,290,64,27.77
-10,19,0,-10.0,19.0,0.33081746101379395,361.9019204149102,77,-53,358,734,972,1114,290,64,26.59
-7,18,0,-7.0,18.0,0.3392293453216553,343.0976537372414,77,-46,340,734,972,1114,290,64,24.8
-7,17,0,-7.0,17.0,0.3467874526977539,325.3459696999488,77,-39,323,734,972,1114,290,64,22.83
-6,15,0,-6.0,15.0,0.35479140281677246,309.76281248723194,77,-33,308,734,972,1114,290,64,20.16
-5,16,0,-5.0,16.0,0.36837244033813477,293.33939387678566,77,-28,292,734,972,1114,290,64,20.55
-5,15,0,-5.0,15.0,0.37079644203186035,277.95323347642494,77,-23,277,734,972,1114,290,64,18.78
-5,15,0,-5.0,15.0,0.3796713352203369,262.6175927084855,77,-18,262,734,972,1114,290,64,17.97
-4,13,0,-4.0,13.0,0.3868684768676758,249.39326374222702,77,-14,249,734,972,1114,290,64,15.74
-3,10,0,-3.0,10.0,0.39485931396484375,239.25300416086733,77,-11,239,734,972,1114,290,64,12.77
-2,11,0,-2.0,11.0,0.4031684398651123,228.17756243767704,77,-9,228,734,972,1114,290,64,13.91
-2,9,0,-2.0,9.0,0.4108004570007324,219.1118435867856,77,-7,219,734,972,1114,290,64,11.59
-1,6,0,-1.0,6.0,0.41904735565185547,213.08449028495716,77,-6,213,734,972,1114,290,64,9.26
-1,8,0,-1.0,8.0,0.4279472827911377,205.0609665440988,77,-5,205,734,972,1114,290,64,11.14
-1,7,0,-1.0,7.0,0.4348604679107666,198.04039991880444,77,-4,198,734,972,1114,290,64,9.88
-2,6,0,-2.0,6.0,0.44281840324401855,192.01041638411183,77,-2,192,734,972,1114,290,64,7.67
-1,7,0,-1.0,7.0,0.4530184268951416,185.00270268296083,77,-1,185,734,972,1114,290,64,9.38
-1,6,0,-1.0,6.0,0.458829402923584,179.0,77,0,179,734,972,1114,290,64,8.21
-1,6,0,-1.0,6.0,0.46680331230163574,173.0028901492689,77,1,173,734,972,1114,290,64,8.02
0,7,0,-0.0,7.0,0.4768333435058594,166.00301202086666,77,1,166,734,972,1114,290,64,11.85
0,6,0,-0.0,6.0,0.48278331756591797,160.00312496948303,77,1,160,734,972,1114,290,64,10.96
0,6,0,-0.0,6.0,0.49393534660339355,154.00324671902212,77,1,154,734,972,1114,290,64,10.8
0,7,0,-0.0,7.0,0.4987914562225342,147.00340132119393,77,1,147,734,972,1114,290,64,11.27
0,6,0,-0.0,6.0,0.5069053173065186,141.00354605470034,77,1,141,734,972,1114,290,64,10.44
0,6,0,-0.0,6.0,0.5183243751525879,135.00370365289984,77,1,135,734,972,1114,290,64,10.27
0,6,0,-0.0,6.0,0.5228304862976074,129.00387591076478,77,1,129,734,972,1114,290,64,10.1
0,7,0,-0.0,7.0,0.5308833122253418,122.00409829181969,77,1,122,734,972,1114,290,64,10.47
0,7,0,-0.0,7.0,0.5388004779815674,115.00434774390054,77,1,115,734,972,1114,290,64,10.23
-1,8,0,-1.0,8.0,0.5472373962402344,107.01868995647442,77,2,107,734,972,1114,290,64,7.49
0,9,0,-0.0,9.0,0.5547873973846436,98.02040603874276,77,2,98,734,972,1114,290,64,9.93
0,8,0,-0.0,8.0,0.5627844333648682,90.0222194794152,77,2,90,734,972,1114,290,64,9.12
0,8,0,-0.0,8.0,0.5708174705505371,82.02438661763951,77,2,82,734,972,1114,290,64,8.72
0,7,0,-0.0,7.0,0.5788373947143555,75.02666192761077,77,2,75,734,972,1114,290,64,8.01
0,7,0,-0.0,7.0,0.5898523330688477,68.0294054067798,77,2,68,734,972,1114,290,64,7.65
0,5,0,-0.0,5.0,0.5949013233184814,63.0317380372777,77,2,63,734,972,1114,290,64,6.76
0,6,0,-0.0,6.0,0.602790355682373,57.0350769263968,77,2,57,734,972,1114,290,64,6.76
0,5,0,-0.0,5.0,0.6107773780822754,52.03844732503075,77,2,52,734,972,1114,290,64,6.23
0,4,0,-0.0,4.0,0.618943452835083,48.041648597857254,77,2,48,734,972,1114,290,64,5.77
0,4,0,-0.0,4.0,0.626840353012085,44.04543109109048,77,2,44,734,972,1114,290,64,5.56
0,3,0,-0.0,3.0,0.6372544765472412,41.048751503547585,77,2,41,734,972,1114,290,64,5.2
0,1,0,-0.0,1.0,0.6427984237670898,40.049968789001575,77,2,40,734,972,1114,290,64,4.82
-1,2,0,-1.0,2.0,0.651808500289917,38.118237105091836,77,3,38,734,972,1114,290,64,1.73
0,1,0,-0.0,1.0,0.6613473892211914,37.12142238654117,77,3,37,734,972,1114,290,64,4.22
0,1,0,-0.0,1.0,0.6668252944946289,36.124783736376884,77,3,36,734,972,1114,290,64,4.18
-1,1,0,-1.0,1.0,0.675417423248291,35.22782990761707,77,4,35,734,972,1114,290,64,0.84
0,0,1,-0.0,-0.0,0.6817812919616699,35.22782990761707,77,4,35,734,972,1114,290,64,37.55
0,1,1,-0.0,1.0,0.6866364479064941,34.23448553724738,77,4,34,734,972,1114,290,64,13.72
-1,0,1,-1.0,-0.0,0.698798418045044,34.36568055487916,77,5,34,734,972,1114,290,64,12.18
0,1,1,-0.0,1.0,0.7067945003509521,33.37663853655727,77,5,33,734,972,1114,290,64,13.379999999999999
0,0,0,-0.0,-0.0,0.8038163185119629,33.37663853655727,77,5,33,734,972,1114,290,64,26.99
-1,0,0,-1.0,-0.0,0.8672313690185547,33.54101966249684,77,6,33,734,972,1114,290,64,1.78
-1,0,0,-1.0,-0.0,0.8748123645782471,33.734255586866,77,7,33,734,972,1114,290,64,1.57
-1,0,0,-1.0,-0.0,0.8827962875366211,33.95585369269929,77,8,33,734,972,1114,290,64,1.42
-1,0,0,-1.0,-0.0,0.8988113403320312,34.20526275297414,77,9,33,734,972,1114,290,64,1.31
0,0,1,-0.0,-0.0,0.9518163204193115,34.20526275297414,77,9,33,734,972,1114,290,64,37.239999999999995
0,0,0,-0.0,-0.0,0.09562826156616211,304.809776746088,78,-170,-253,555,686,725,939,54,97.9
-1,0,0,-1.0,-0.0,0.1416311264038086,304.253184042501,78,-169,-253,555,686,725,939,54,1.7
-1,0,0,-1.0,-0.0,0.19768810272216797,303.6988640084121,78,-168,-253,555,686,725,939,54,1.69
-1,-2,0,-1.0,-2.0,0.2055802345275879,301.4796842243271,78,-167,-251,555,686,725,939,54,7.12
-2,-4,0,-2.0,-4.0,0.21375417709350586,297.0420845604205,78,-165,-247,555,686,725,939,54,10.25
-2,-5,0,-2.0,-5.0,0.22168326377868652,291.7755987055806,78,-163,-242,555,686,725,939,54,10.58
-2,-6,0,-2.0,-6.0,0.22960829734802246,285.68689154387187,78,-161,-236,555,686,725,939,54,11.15
-2,-7,0,-2.0,-7.0,0.23760509490966797,278.78665678256556,78,-159,-229,555,686,725,939,54,11.75
-3,-8,0,-3.0,-8.0,0.24560117721557617,270.51247660690257,78,-156,-221,555,686,725,939,54,13.47
-3,-9,0,-3.0,-9.0,0.253615140914917,261.444066675838,78,-153,-212,555,686,725,939,54,13.81
-4,-10,0,-4.0,-10.0,0.26160621643066406,251.00796800101784,78,-149,-202,555,686,725,939,54,15.09
-6,-10,0,-6.0,-10.0,0.2696042060852051,239.40133667128927,78,-143,-192,555,686,725,939,54,17.01
-7,-12,0,-7.0,-12.0,0.27759814262390137,225.6014184352572,78,-136,-180,555,686,725,939,54,18.06
-11,-15,0,-11.0,-15.0,0.2856020927429199,207.0024154448445,78,-125,-165,555,686,725,939,54,22.92
-11,-16,0,-11.0,-16.0,0.29364919662475586,187.608635195718,78,-114,-149,555,686,725,939,54,20.88
-12,-15,0,-12.0,-15.0,0.30435824394226074,168.40427548016706,78,-102,-134,555,686,725,939,54,20.26
-12,-14,0,-12.0,-14.0,0.309995174407959,150.0,78,-90,-120,555,686,725,939,54,17.34
-10,-11,0,-10.0,-11.0,0.3177483081817627,135.20724832641184,78,-80,-109,555,686,725,939,54,13.81
-8,-10,0,-8.0,-10.0,0.32558321952819824,122.41323457861898,78,-72,-99,555,686,725,939,54,13.02
-5,-8,0,-5.0,-8.0,0.3336212635040283,113.00442469213318,78,-67,-91,555,686,725,939,54,10.11
-6,-7,0,-6.0,-7.0,0.34408116340637207,103.81233067415451,78,-61,-84,555,686,725,939,54,9.49
-4,-6,0,-4.0,-6.0,0.3497731685638428,96.60745312862771,78,-57,-78,555,686,725,939,54,8.95
-4,-5,0,-4.0,-5.0,0.3576180934906006,90.21086409075129,78,-53,-73,555,686,725,939,54,8.21
-3,-3,0,-3.0,-3.0,0.36559224128723145,86.02325267042627,78,-50,-70,555,686,725,939,54,5.4
-2,-3,0,-2.0,-3.0,0.373629093170166,82.41965784932621,78,-48,-67,555,686,725,939,54,6.97
-3,-3,0,-3.0,-3.0,0.38160014152526855,78.2368199762746,78,-45,-64,555,686,725,939,54,5.13
-2,-3,0,-2.0,-3.0,0.3896040916442871,74.63243262818116,78,-43,-61,555,686,725,939,54,7.06
-3,-2,0,-3.0,-2.0,0.3976001739501953,71.28113354878694,78,-40,-59,555,686,725,939,54,3.48
-3,-3,0,-3.0,-3.0,0.4055972099304199,67.11929677819934,78,-37,-56,555,686,725,939,54,4.61
-3,-3,0,-3.0,-3.0,0.4136221408843994,62.96824596572466,78,-34,-53,555,686,725,939,54,4.4
-3,-3,0,-3.0,-3.0,0.4216482639312744,58.83026432033091,78,-31,-50,555,686,725,939,54,4.18
-3,-2,0,-3.0,-2.0,0.43578124046325684,55.569775957799216,78,-28,-48,555,686,725,939,54,2.83
-3,-3,0,-3.0,-3.0,0.4384441375732422,51.478150704935004,78,-25,-45,555,686,725,939,54,3.67
-4,-3,0,-4.0,-3.0,0.44558024406433105,46.95742752749558,78,-21,-42,555,686,725,939,54,2.89
-2,-2,0,-2.0,-2.0,0.4536111354827881,44.28317965096906,78,-19,-40,555,686,725,939,54,2.81
-3,-2,0,-3.0,-2.0,0.4616851806640625,41.23105625617661,78,-16,-38,555,686,725,939,54,2.01
-2,-2,0,-2.0,-2.0,0.47655320167541504,38.62641583165593,78,-14,-36,555,686,725,939,54,2.37
-3,-3,0,-3.0,-3.0,0.4776031970977783,34.785054261852174,78,-11,-33,555,686,725,939,54,2.3
-2,-2,0,-2.0,-2.0,0.48874831199645996,32.28002478313795,78,-9,-31,555,686,725,939,54,1.89
-2,-2,0,-2.0,-2.0,0.4937551021575928,29.832867780352597,78,-7,-29,555,686,725,939,54,1.67
-1,-1,0,-1.0,-1.0,0.5016531944274902,28.635642126552707,78,-6,-28,555,686,725,939,54,1.49
-1,-2,0,-1.0,-2.0,0.5120522975921631,26.476404589747453,78,-5,-26,555,686,725,939,54,2.56
-1,0,0,-1.0,-0.0,0.5178122520446777,26.30589287593181,78,-4,-26,555,686,725,939,54,0.04
0,-1,0,-0.0,-1.0,0.5261611938476562,25.317977802344327,78,-4,-25,555,686,725,939,54,3.24
0,0,1,-0.0,-0.0,0.5726461410522461,25.317977802344327,78,-4,-25,555,686,725,939,54,34.519999999999996
0,0,0,-0.0,-0.0,0.0881805419921875,528.3076755073695,79,-478,-225,81,486,559,711,40,140.14
2,0,0,2.0,-0.0,0.1251544952392578,530.1179114121687,79,-480,-225,81,486,559,711,40,3.7
3,-1,0,3.0,-1.0,0.13377761840820312,532.4143123545797,79,-483,-224,81,486,559,711,40,2.54
4,-1,0,4.0,-1.0,0.14113664627075195,535.6286026716647,79,-487,-223,81,486,559,711,40,2.27
5,-2,0,5.0,-2.0,0.14916253089904785,539.3560975830346,79,-492,-221,81,486,559,711,40,1.86
7,-2,0,7.0,-2.0,0.1580185890197754,544.9421987697411,79,-499,-219,81,486,559,711,40,1.73
5,-3,0,5.0,-3.0,0.16518545150756836,548.3356636222014,79,-504,-216,81,486,559,711,40,1.72
5,-3,0,5.0,-3.0,0.17316055297851562,551.7698795693726,79,-509,-213,81,486,559,711,40,1.73
3,-2,0,3.0,-2.0,0.18146061897277832,553.7734193693301,79,-512,-211,81,486,559,711,40,2.42
3,-3,0,3.0,-3.0,0.18914365768432617,555.4178607138953,79,-515,-208,81,486,559,711,40,2.53
1,-3,0,1.0,-3.0,0.19725966453552246,555.2305827311749,79,-516,-205,81,486,559,711,40,0.78
0,-3,0,-0.0,-3.0,0.20621347427368164,554.1299486582548,79,-516,-202,81,486,559,711,40,4.16
0,-4,0,-0.0,-4.0,0.2167985439300537,552.6843583818887,79,-516,-198,81,486,559,711,40,5.24
-1,-5,0,-1.0,-5.0,0.22153067588806152,549.976363128453,79,-515,-193,81,486,559,711,40,9.35
-2,-4,0,-2.0,-4.0,0.22987151145935059,546.7083317455479,79,-513,-189,81,486,559,711,40,11.4
-3,-4,0,-3.0,-4.0,0.2372126579284668,542.5172808307584,79,-510,-185,81,486,559,711,40,14.33
-3,-6,0,-3.0,-6.0,0.24558663368225098,537.6709030624588,79,-507,-179,81,486,559,711,40,15.61
-5,-4,0,-5.0,-4.0,0.2531716823577881,531.6286297783445,79,-502,-175,81,486,559,711,40,19.75
-7,-5,0,-7.0,-5.0,0.26135849952697754,523.3784481615573,79,-495,-170,81,486,559,711,40,25.01
-9,-6,0,-9.0,-6.0,0.2691504955291748,512.9249457766701,79,-486,-164,81,486,559,711,40,29.53
-12,-5,0,-12.0,-5.0,0.2790095806121826,499.95699815084095,79,-474,-159,81,486,559,711,40,35.56
-14,-7,0,-14.0,-7.0,0.28517866134643555,484.4625888549084,79,-460,-152,81,486,559,711,40,38.29
-18,-6,0,-18.0,-6.0,0.2931854724884033,465.4889902027759,79,-442,-146,81,486,559,711,40,45.83
-18,-6,0,-18.0,-6.0,0.3029966354370117,446.5153972709116,79,-424,-140,81,486,559,711,40,44.71
-18,-5,0,-18.0,-5.0,0.30956459045410156,427.8562842824679,79,-406,-135,81,486,559,711,40,41.17
-20,-5,0,-20.0,-5.0,0.3177835941314697,407.3033267725664,79,-386,-130,81,486,559,711,40,41.72
-20,-5,0,-20.0,-5.0,0.3271956443786621,386.7570296710843,79,-366,-125,81,486,559,711,40,40.29
-20,-6,0,-20.0,-6.0,0.33330345153808594,365.8920605861789,79,-346,-119,81,486,559,711,40,40.12
-20,-5,0,-20.0,-5.0,0.341153621673584,345.35778549208936,79,-326,-114,81,486,559,711,40,37.33
-19,-6,0,-19.0,-6.0,0.35114550590515137,325.44277530773365,79,-307,-108,81,486,559,711,40,36.5
-17,-5,0,-17.0,-5.0,0.3571765422821045,307.74827375632833,79,-290,-103,81,486,559,711,40,32.31
-14,-6,0,-14.0,-6.0,0.36580848693847656,292.5491411711885,79,-276,-97,81,486,559,711,40,28.33
-13,-3,0,-13.0,-3.0,0.37503957748413086,279.29375216785644,79,-263,-94,81,486,559,711,40,24.59
-12,-4,0,-12.0,-4.0,0.3813364505767822,266.6477076593759,79,-251,-90,81,486,559,711,40,25.05
-11,-3,0,-11.0,-3.0,0.38916850090026855,255.28219679405768,79,-240,-87,81,486,559,711,40,21.5
-11,-3,0,-11.0,-3.0,0.39848756790161133,243.92006887503126,79,-229,-84,81,486,559,711,40,20.84
-12,-3,0,-12.0,-3.0,0.4052004814147949,231.62469643800938,79,-217,-81,81,486,559,711,40,20.84
-11,-3,0,-11.0,-3.0,0.413158655166626,220.27255843613383,79,-206,-78,81,486,559,711,40,19.41
-10,-3,0,-10.0,-3.0,0.4232945442199707,209.85947679340097,79,-196,-75,81,486,559,711,40,18.18
-8,-2,0,-8.0,-2.0,0.42940449714660645,201.67548190099856,79,-188,-73,81,486,559,711,40,14.68
-9,-4,0,-9.0,-4.0,0.4372115135192871,191.83847372203522,79,-179,-69,81,486,559,711,40,17.12
-8,-2,0,-8.0,-2.0,0.4470834732055664,183.65728953678914,79,-171,-67,81,486,559,711,40,13.85
-9,-3,0,-9.0,-3.0,0.4538435935974121,174.18381095842403,79,-162,-64,81,486,559,711,40,15.76
-9,-4,0,-9.0,-4.0,0.46116065979003906,164.34415109762804,79,-153,-60,81,486,559,711,40,15.81
-9,-2,0,-9.0,-2.0,0.4711275100708008,155.24174696260025,79,-144,-58,81,486,559,711,40,13.03
-10,-4,0,-10.0,-4.0,0.4772465229034424,144.4714504668656,79,-134,-54,81,486,559,711,40,17.51
-11,-3,0,-11.0,-3.0,0.48517656326293945,133.15404612703287,79,-123,-51,81,486,559,711,40,13.84
-10,-4,0,-10.0,-4.0,0.49504756927490234,122.38463955905577,79,-113,-47,81,486,559,711,40,15.3
-9,-4,0,-9.0,-4.0,0.5013716220855713,112.53888216967503,79,-104,-43,81,486,559,711,40,13.47
-7,-2,0,-7.0,-2.0,0.5092666149139404,105.30906893520614,79,-97,-41,81,486,559,711,40,9.46
-5,-3,0,-5.0,-3.0,0.5193195343017578,99.53893710503444,79,-92,-38,81,486,559,711,40,7.92
-4,-2,0,-4.0,-2.0,0.5251765251159668,95.0789145920377,79,-88,-36,81,486,559,711,40,7.72
-3,-2,0,-3.0,-2.0,0.5341475009918213,91.54780172128658,79,-85,-34,81,486,559,711,40,5.63
-2,-2,0,-2.0,-2.0,0.5474004745483398,88.95504482602435,79,-83,-32,81,486,559,711,40,3.93
-5,-3,0,-5.0,-3.0,0.5492396354675293,83.21658488546619,79,-78,-29,81,486,559,711,40,6.93
-6,-5,0,-6.0,-5.0,0.5571596622467041,75.8946638440411,79,-72,-24,81,486,559,711,40,6.46
-7,-4,0,-7.0,-4.0,0.5661535263061523,68.00735254367721,79,-65,-20,81,486,559,711,40,7.05
-6,-4,0,-6.0,-4.0,0.5731885433197021,61.1310068623117,79,-59,-16,81,486,559,711,40,5.66
-7,-3,0,-7.0,-3.0,0.5818936824798584,53.600373133029585,79,-52,-13,81,486,559,711,40,6.5
-6,-4,0,-6.0,-4.0,0.5892515182495117,46.87216658103186,79,-46,-9,81,486,559,711,40,4.51
-5,-3,0,-5.0,-3.0,0.5976235866546631,41.43669871020132,79,-41,-6,81,486,559,711,40,3.78
-5,-2,0,-5.0,-2.0,0.6051454544067383,36.22154055254967,79,-36,-4,81,486,559,711,40,3.99
-4,-3,0,-4.0,-3.0,0.6137745380401611,32.01562118716424,79,-32,-1,81,486,559,711,40,2.27
-5,-3,0,-5.0,-3.0,0.6211776733398438,27.073972741361768,79,-27,2,81,486,559,711,40,2.17
-4,-2,0,-4.0,-2.0,0.6292645931243896,23.345235059857504,79,-23,4,81,486,559,711,40,1.66
-2,-1,0,-2.0,-1.0,0.6383106708526611,21.587033144922902,79,-21,5,81,486,559,711,40,1.16
-2,-1,0,-2.0,-1.0,0.6452076435089111,19.924858845171276,79,-19,6,81,486,559,711,40,0.93
-1,0,0,-1.0,-0.0,0.6533114910125732,18.973665961010276,79,-18,6,81,486,559,711,40,2.23
0,0,1,-0.0,-0.0,-0.0030748844146728516,1096.299685305072,80,1092,-97,1191,383,99,480,7,216.56
0,0,0,-0.0,-0.0,0.0759131908416748,1096.299685305072,80,1092,-97,1191,383,99,480,7,216.56
1,0,0,1.0,-0.0,0.1108860969543457,1095.303610876911,80,1091,-97,1191,383,99,480,7,30.17
2,-1,0,2.0,-1.0,0.11937928199768066,1093.2232159993675,80,1089,-96,1191,383,99,480,7,50.14
3,0,0,3.0,-0.0,0.12689709663391113,1090.2348370878633,80,1086,-96,1191,383,99,480,7,66.62
5,-1,0,5.0,-1.0,0.13488316535949707,1085.166346695289,80,1081,-95,1191,383,99,480,7,91.37
7,0,0,7.0,-0.0,0.14323019981384277,1078.1933963811873,80,1074,-95,1191,383,99,480,7,107.73
8,0,0,8.0,-0.0,0.15086007118225098,1070.2247427526613,80,1066,-95,1191,383,99,480,7,114.17
9,1,0,9.0,1.0,0.15888214111328125,1061.3505547179027,80,1057,-96,1191,383,99,480,7,118.07
12,1,0,12.0,1.0,0.16771721839904785,1049.4922581896449,80,1045,-97,1191,383,99,480,7,131.75
12,1,0,12.0,1.0,0.1748790740966797,1037.6381835688198,80,1033,-98,1191,383,99,480,7,130.87
13,1,0,13.0,1.0,0.18302512168884277,1024.7931498600096,80,1020,-99,1191,383,99,480,7,133.71
14,1,0,14.0,1.0,0.19156408309936523,1010.9579615394499,80,1006,-100,1191,383,99,480,7,136.04
15,1,0,15.0,1.0,0.19890213012695312,996.1335251862573,80,991,-101,1191,383,99,480,7,137.92
15,1,0,15.0,1.0,0.2073841094970703,981.315443677516,80,976,-102,1191,383,99,480,7,136.7
17,2,0,17.0,2.0,0.21521925926208496,964.6227241776963,80,959,-104,1191,383,99,480,7,139.9
17,2,0,17.0,2.0,0.22292518615722656,947.9451460923253,80,942,-106,1191,383,99,480,7,138.42
20,3,0,20.0,3.0,0.2308821678161621,928.4207020526848,80,922,-109,1191,383,99,480,7,142.55
21,3,0,21.0,3.0,0.23886609077453613,907.9344690009297,80,901,-112,1191,383,99,480,7,142.42
22,3,0,22.0,3.0,0.24684929847717285,886.490834695994,80,879,-115,1191,383,99,480,7,142.0
24,3,0,24.0,3.0,0.2548971176147461,863.1042810692112,80,855,-118,1191,383,99,480,7,142.62
25,2,0,25.0,2.0,0.2641761302947998,838.6298349093001,80,830,-120,1191,383,99,480,7,141.82
28,1,0,28.0,1.0,0.2740781307220459,811.0764452257259,80,802,-121,1191,383,99,480,7,142.69
32,0,0,32.0,-0.0,0.27889513969421387,779.4491644745025,80,770,-121,1191,383,99,480,7,143.15
33,0,0,33.0,-0.0,0.28689122200012207,746.86678865779,80,737,-121,1191,383,99,480,7,140.13
37,0,0,37.0,-0.0,0.29821109771728516,710.3808837518081,80,700,-121,1191,383,99,480,7,138.34
36,-2,0,36.0,-2.0,0.3039262294769287,674.5791280494824,80,664,-119,1191,383,99,480,7,134.02
33,-1,0,33.0,-1.0,0.31119418144226074,641.938470571752,80,631,-118,1191,383,99,480,7,127.67
33,0,0,33.0,-0.0,0.31885719299316406,609.530967219878,80,598,-118,1191,383,99,480,7,123.09
32,-1,0,32.0,-1.0,0.32688426971435547,577.9662619911304,80,566,-117,1191,383,99,480,7,118.61
31,-1,0,31.0,-1.0,0.3352231979370117,547.4312742253588,80,535,-116,1191,383,99,480,7,113.8
30,-2,0,30.0,-2.0,0.34290528297424316,517.7074463439752,80,505,-114,1191,383,99,480,7,109.42
32,-3,0,32.0,-3.0,0.3508951663970947,485.84977101980814,80,473,-111,1191,383,99,480,7,106.42
32,-4,0,32.0,-4.0,0.35886216163635254,453.7951079507138,80,441,-107,1191,383,99,480,7,102.07
32,-4,0,32.0,-4.0,0.36686015129089355,421.7700795457165,80,409,-103,1191,383,99,480,7,97.1
32,-6,0,32.0,-6.0,0.37519025802612305,389.27882038456704,80,377,-97,1191,383,99,480,7,93.0
29,-5,0,29.0,-5.0,0.3832542896270752,359.95555281173256,80,348,-92,1191,383,99,480,7,86.31
28,-5,0,28.0,-5.0,0.39090824127197266,331.6157414840255,80,320,-87,1191,383,99,480,7,81.08
25,-5,0,25.0,-5.0,0.3990311622619629,306.18458485038076,80,295,-82,1191,383,99,480,7,75.41
22,-5,0,22.0,-5.0,0.40718626976013184,283.6511942509673,80,273,-77,1191,383,99,480,7,70.19
20,-6,0,20.0,-6.0,0.41614627838134766,262.77366686941826,80,253,-71,1191,383,99,480,7,66.6
18,-6,0,18.0,-6.0,0.42285823822021484,243.82370680473218,80,235,-65,1191,383,99,480,7,60.76
17,-5,0,17.0,-5.0,0.43087220191955566,226.10616975217638,80,218,-60,1191,383,99,480,7,57.87
16,-6,0,16.0,-6.0,0.43889617919921875,209.093280618962,80,202,-54,1191,383,99,480,7,52.37
16,-5,0,16.0,-5.0,0.4485940933227539,192.3460423299632,80,186,-49,1191,383,99,480,7,50.14
15,-5,0,15.0,-5.0,0.45490312576293945,176.57009939398006,80,171,-44,1191,383,99,480,7,46.01
14,-4,0,14.0,-4.0,0.4633312225341797,162.0154313638056,80,157,-40,1191,383,99,480,7,43.43
12,-4,0,12.0,-4.0,0.4714040756225586,149.40214188558343,80,145,-36,1191,383,99,480,7,38.27
11,-4,0,11.0,-4.0,0.47890520095825195,137.7679207943562,80,134,-32,1191,383,99,480,7,34.8
11,-4,0,11.0,-4.0,0.4868941307067871,126.14673994994877,80,123,-28,1191,383,99,480,7,32.63
11,-3,0,11.0,-3.0,0.49561119079589844,114.75626344561765,80,112,-25,1191,383,99,480,7,31.66
9,-4,0,9.0,-4.0,0.5028672218322754,105.11898020814318,80,103,-21,1191,383,99,480,7,26.31
9,-3,0,9.0,-3.0,0.511052131652832,95.70788891204319,80,94,-18,1191,383,99,480,7,25.15
8,-3,0,8.0,-3.0,0.5189411640167236,87.29833904490967,80,86,-15,1191,383,99,480,7,22.28
6,-4,0,6.0,-4.0,0.530529260635376,80.75270893288967,80,80,-11,1191,383,99,480,7,17.89
6,-3,0,6.0,-3.0,0.5351512432098389,74.43117626371358,80,74,-8,1191,383,99,480,7,17.02
5,-3,0,5.0,-3.0,0.5429091453552246,69.18092222571191,80,69,-5,1191,383,99,480,7,14.5
6,-4,0,6.0,-4.0,0.5508701801300049,63.00793600809346,80,63,-1,1191,383,99,480,7,14.43
5,-3,0,5.0,-3.0,0.558887243270874,58.034472514187634,80,58,2,1191,383,99,480,7,12.31
5,-3,0,5.0,-3.0,0.5670862197875977,53.23532661682466,80,53,5,1191,383,99,480,7,11.3
6,-3,0,6.0,-3.0,0.5781641006469727,47.67598976424087,80,47,8,1191,383,99,480,7,11.34
5,-2,0,5.0,-2.0,0.5830211639404297,43.174066289845804,80,42,10,1191,383,99,480,7,9.66
6,-2,0,6.0,-2.0,0.592487096786499,37.94733192202055,80,36,12,1191,383,99,480,7,9.56
5,-2,0,5.0,-2.0,0.6014072895050049,34.0147027033899,80,31,14,1191,383,99,480,7,7.39
6,-2,0,6.0,-2.0,0.6069812774658203,29.68164415931166,80,25,16,1191,383,99,480,7,7.0
5,-2,0,5.0,-2.0,0.6148781776428223,26.90724809414742,80,20,18,1191,383,99,480,7,4.64
4,-1,0,4.0,-1.0,0.6228721141815186,24.839484696748443,80,16,19,1191,383,99,480,7,3.6
5,0,0,5.0,-0.0,0.6308891773223877,21.95449840010015,80,11,19,1191,383,99,480,7,4.32
5,-1,0,5.0,-1.0,0.638864278793335,20.8806130178211,80,6,20,1191,383,99,480,7,1.16
6,-1,0,6.0,-1.0,0.6468632221221924,21.0,80,0,21,1191,383,99,480,7,7.7
6,-1,0,6.0,-1.0,0.6548681259155273,22.80350850198276,80,-6,22,1191,383,99,480,7,0.03
6,0,0,6.0,-0.0,0.6628983020782471,25.059928172283335,80,-12,22,1191,383,99,480,7,-0.01
6,-1,0,6.0,-1.0,0.6729562282562256,29.206163733020468,80,-18,23,1191,383,99,480,7,0.08
6,0,0,6.0,-0.0,0.6788802146911621,33.24154027718932,80,-24,23,1191,383,99,480,7,0.26
5,0,0,5.0,-0.0,0.6871912479400635,37.013511046643494,80,-29,23,1191,383,99,480,7,0.81
4,0,0,4.0,-0.0,0.6948580741882324,40.22437072223753,80,-33,23,1191,383,99,480,7,1.37
4,-1,0,4.0,-1.0,0.7031440734863281,44.10215414239989,80,-37,24,1191,383,99,480,7,2.13
4,0,0,4.0,-0.0,0.7109410762786865,47.50789408087881,80,-41,24,1191,383,99,480,7,1.72
2,0,0,2.0,-0.0,0.7207551002502441,49.24428900898052,80,-43,24,1191,383,99,480,7,3.13
2,0,0,2.0,-0.0,0.7269611358642578,51.0,80,-45,24,1191,383,99,480,7,3.22
1,-1,0,1.0,-1.0,0.7365832328796387,52.354560450833695,80,-46,25,1191,383,99,480,7,4.65
1,0,0,1.0,-0.0,0.7429320812225342,53.23532661682466,80,-47,25,1191,383,99,480,7,5.21
0,2,0,-0.0,2.0,0.8228952884674072,52.32590180780452,80,-47,23,1191,383,99,480,7,3.29
-2,3,0,-2.0,3.0,0.8321352005004883,49.24428900898052,80,-45,20,1191,383,99,480,7,8.63
-3,4,0,-3.0,4.0,0.8388621807098389,44.94441010848846,80,-42,16,1191,383,99,480,7,9.8
-2,3,0,-2.0,3.0,0.846898078918457,42.05948168962618,80,-40,13,1191,383,99,480,7,7.34
-2,2,0,-2.0,2.0,0.856452226638794,39.56008088970496,80,-38,11,1191,383,99,480,7,6.95
-2,2,0,-2.0,2.0,0.8628981113433838,37.107950630558946,80,-36,9,1191,383,99,480,7,6.55
-2,1,0,-2.0,1.0,0.8719162940979004,34.92849839314596,80,-34,8,1191,383,99,480,7,7.16
-3,1,0,-3.0,1.0,0.8789291381835938,31.78049716414141,80,-31,7,1191,383,99,480,7,9.3
-2,1,0,-2.0,1.0,0.886998176574707,29.614185789921695,80,-29,6,1191,383,99,480,7,6.52
-3,1,0,-3.0,1.0,0.8981091976165771,26.476404589747453,80,-26,5,1191,383,99,480,7,8.31
-1,1,0,-1.0,1.0,0.9031851291656494,25.317977802344327,80,-25,4,1191,383,99,480,7,3.45
-3,1,0,-3.0,1.0,0.9113082885742188,22.20360331117452,80,-22,3,1191,383,99,480,7,7.3
-2,0,0,-2.0,-0.0,0.9208061695098877,20.223748416156685,80,-20,3,1191,383,99,480,7,6.21
-1,0,0,-1.0,-0.0,0.926875114440918,19.235384061671343,80,-19,3,1191,383,99,480,7,4.82
-2,0,0,-2.0,-0.0,0.934913158416748,17.26267650163207,80,-17,3,1191,383,99,480,7,5.69
-2,1,0,-2.0,1.0,0.9451842308044434,15.132745950421556,80,-15,2,1191,383,99,480,7,4.71
-2,0,0,-2.0,-0.0,0.9510951042175293,13.152946437965905,80,-13,2,1191,383,99,480,7,5.44
-1,0,0,-1.0,-0.0,0.9595561027526855,12.165525060596439,80,-12,2,1191,383,99,480,7,4.28
-2,0,0,-2.0,-0.0,0.966867208480835,10.198039027185569,80,-10,2,1191,383,99,480,7,4.71
-1,1,0,-1.0,1.0,0.9751791954040527,9.055385138137417,80,-9,1,1191,383,99,480,7,2.06
-2,0,0,-2.0,-0.0,0.9829411506652832,7.0710678118654755,80,-7,1,1191,383,99,480,7,4.72
-1,0,0,-1.0,-0.0,0.9929702281951904,6.082762530298219,80,-6,1,1191,383,99,480,7,3.65
-1,0,0,-1.0,-0.0,0.9988992214202881,5.0990195135927845,80,-5,1,1191,383,99,480,7,3.24
-1,1,0,-1.0,1.0,1.0070171356201172,4.0,80,-4,0,1191,383,99,480,7,0.99
-1,0,0,-1.0,-0.0,1.0174760818481445,3.0,80,-3,0,1191,383,99,480,7,8.04
-1,0,0,-1.0,-0.0,1.0327050685882568,2.0,80,-2,0,1191,383,99,480,7,8.0
0,0,1,-0.0,-0.0,1.0979092121124268,2.0,80,-2,0,1191,383,99,480,7,27.51
0,0,0,-0.0,-0.0,0.0930778980255127,852.3526265578115,81,-851,48,342,431,1193,383,18,187.52
-1,0,0,-1.0,-0.0,0.2020399570465088,851.354215353398,81,-850,48,342,431,1193,383,18,14.05
-2,1,0,-2.0,1.0,0.20998477935791016,849.3014776862218,81,-848,47,342,431,1193,383,18,20.48
-4,2,0,-4.0,2.0,0.2188737392425537,845.1987931841834,81,-844,45,342,431,1193,383,18,35.37
-6,3,0,-6.0,3.0,0.22601890563964844,839.0518458355241,81,-838,42,342,431,1193,383,18,47.53
-8,3,0,-8.0,3.0,0.23398184776306152,830.9157598697957,81,-830,39,342,431,1193,383,18,57.73
-7,3,0,-7.0,3.0,0.24250388145446777,823.786987030021,81,-823,36,342,431,1193,383,18,52.36
-7,1,0,-7.0,1.0,0.25009894371032715,816.7502678297694,81,-816,35,342,431,1193,383,18,53.35
-6,2,0,-6.0,2.0,0.2579927444458008,810.6719435135276,81,-810,33,342,431,1193,383,18,46.74
-7,1,0,-7.0,1.0,0.2659878730773926,803.6373560257139,81,-803,32,342,431,1193,383,18,52.81
-10,1,0,-10.0,1.0,0.274000883102417,793.6056955440781,81,-793,31,342,431,1193,383,18,66.33
-13,0,0,-13.0,-0.0,0.28392791748046875,780.6157825716823,81,-780,31,342,431,1193,383,18,76.64
-18,0,0,-18.0,-0.0,0.2902989387512207,762.6303167328191,81,-762,31,342,431,1193,383,18,89.16
-21,-1,0,-21.0,-1.0,0.29800891876220703,741.6906363167867,81,-741,32,342,431,1193,383,18,93.04
-24,-2,0,-24.0,-2.0,0.30757784843444824,717.8056840120452,81,-717,34,342,431,1193,383,18,96.01
-28,-2,0,-28.0,-2.0,0.3140697479248047,689.939852450922,81,-689,36,342,431,1193,383,18,99.65
-31,-3,0,-31.0,-3.0,0.32210493087768555,659.1547617972581,81,-658,39,342,431,1193,383,18,100.16
-32,-3,0,-32.0,-3.0,0.33104586601257324,627.4073636800895,81,-626,42,342,431,1193,383,18,98.13
-34,-1,0,-34.0,-1.0,0.33798789978027344,593.5596010511497,81,-592,43,342,431,1193,383,18,97.44
-33,-2,0,-33.0,-2.0,0.3459899425506592,560.8083451590213,81,-559,45,342,431,1193,383,18,92.54
-33,-2,0,-33.0,-2.0,0.35403990745544434,528.0956352783082,81,-526,47,342,431,1193,383,18,88.92
-30,-1,0,-30.0,-1.0,0.36203694343566895,498.31716807671796,81,-496,48,342,431,1193,383,18,83.06
-29,0,0,-29.0,-0.0,0.37050580978393555,469.4603284623739,81,-467,48,342,431,1193,383,18,79.3
-27,-1,0,-27.0,-1.0,0.3779888153076172,442.7200018070112,81,-440,49,342,431,1193,383,18,73.7
-25,0,0,-25.0,-0.0,0.3860149383544922,417.8827586775985,81,-415,49,342,431,1193,383,18,69.22
-23,0,0,-23.0,-0.0,0.394028902053833,395.05062966662894,81,-392,49,342,431,1193,383,18,64.38
-22,1,0,-22.0,1.0,0.4019949436187744,373.1005226477176,81,-370,48,342,431,1193,383,18,61.47
-23,2,0,-23.0,2.0,0.410449743270874,350.03571246374275,81,-347,46,342,431,1193,383,18,60.87
-23,2,0,-23.0,2.0,0.41803884506225586,326.9740050829729,81,-324,44,342,431,1193,383,18,58.1
-21,2,0,-21.0,2.0,0.4275479316711426,305.8970415025291,81,-303,42,342,431,1193,383,18,53.7
-20,2,0,-20.0,2.0,0.43401288986206055,285.8128758471178,81,-283,40,342,431,1193,383,18,50.35
-21,2,0,-21.0,2.0,0.44199585914611816,264.7413832403238,81,-262,38,342,431,1193,383,18,48.59
-19,2,0,-19.0,2.0,0.452481746673584,245.65219315121126,81,-243,36,342,431,1193,383,18,44.49
-17,2,0,-17.0,2.0,0.4581468105316162,228.54321254414887,81,-226,34,342,431,1193,383,18,40.71
-17,2,0,-17.0,2.0,0.4660007953643799,211.43556938225885,81,-209,32,342,431,1193,383,18,38.58
-12,1,0,-12.0,1.0,0.4792189598083496,199.42417105255822,81,-197,31,342,431,1193,383,18,30.56
-10,2,0,-10.0,2.0,0.48201775550842285,189.2353032602532,81,-187,29,342,431,1193,383,18,27.7
-9,1,0,-9.0,1.0,0.4912688732147217,180.18878988438766,81,-178,28,342,431,1193,383,18,25.17
-9,1,0,-9.0,1.0,0.49823474884033203,171.14321488157222,81,-169,27,342,431,1193,383,18,24.31
-8,2,0,-8.0,2.0,0.5060079097747803,162.92943257741985,81,-161,25,342,431,1193,383,18,21.61
-8,1,0,-8.0,1.0,0.514183759689331,154.8709139896837,81,-153,24,342,431,1193,383,18,21.96
-7,1,0,-7.0,1.0,0.5220017433166504,147.80054127099805,81,-146,23,342,431,1193,383,18,20.65
-5,1,0,-5.0,1.0,0.5300178527832031,142.70599146496969,81,-141,22,342,431,1193,383,18,16.09
-6,1,0,-6.0,1.0,0.5420317649841309,136.6235704408284,81,-135,21,342,431,1193,383,18,18.52
-7,1,0,-7.0,1.0,0.545994758605957,129.55307792561317,81,-128,20,342,431,1193,383,18,19.29
-7,2,0,-7.0,2.0,0.5539679527282715,122.3315167894194,81,-121,18,342,431,1193,383,18,16.38
-6,1,0,-6.0,1.0,0.5619869232177734,116.2497311824849,81,-115,17,342,431,1193,383,18,16.65
-5,1,0,-5.0,1.0,0.5703837871551514,111.15754585272202,81,-110,16,342,431,1193,383,18,13.84
-4,1,0,-4.0,1.0,0.5783817768096924,107.05606008068857,81,-106,15,342,431,1193,383,18,11.33
-2,0,0,-2.0,-0.0,0.5859818458557129,105.07616285342742,81,-104,15,342,431,1193,383,18,7.38
-2,0,0,-2.0,-0.0,0.593984842300415,103.0970416646375,81,-102,15,342,431,1193,383,18,7.29
-2,1,0,-2.0,1.0,0.6020078659057617,100.9752444909147,81,-100,14,342,431,1193,383,18,6.39
-3,1,0,-3.0,1.0,0.6099927425384521,97.86725703727473,81,-97,13,342,431,1193,383,18,8.6
-2,0,0,-2.0,-0.0,0.6179819107055664,95.88534820294495,81,-95,13,342,431,1193,383,18,7.17
-4,1,0,-4.0,1.0,0.6260058879852295,91.7877987534291,81,-91,12,342,431,1193,383,18,10.35
-5,2,0,-5.0,2.0,0.6356558799743652,86.57944328765345,81,-86,10,342,431,1193,383,18,10.22
-5,1,0,-5.0,1.0,0.6422338485717773,81.49846624323675,81,-81,9,342,431,1193,383,18,11.22
-5,1,0,-5.0,1.0,0.6500108242034912,76.4198926981712,81,-76,8,342,431,1193,383,18,10.78
-6,1,0,-6.0,1.0,0.660524845123291,70.34912934784623,81,-70,7,342,431,1193,383,18,11.71
-5,2,0,-5.0,2.0,0.6659917831420898,65.19202405202648,81,-65,5,342,431,1193,383,18,8.41
-6,0,0,-6.0,-0.0,0.6740818023681641,59.21148537234985,81,-59,5,342,431,1193,383,18,10.38
-4,1,0,-4.0,1.0,0.6819899082183838,55.14526271584895,81,-55,4,342,431,1193,383,18,7.53
-4,1,0,-4.0,1.0,0.690098762512207,51.088159097779204,81,-51,3,342,431,1193,383,18,7.15
-2,0,0,-2.0,-0.0,0.7010047435760498,49.09175083453431,81,-49,3,342,431,1193,383,18,6.63
-3,0,0,-3.0,-0.0,0.7066388130187988,46.09772228646444,81,-46,3,342,431,1193,383,18,7.34
-2,0,0,-2.0,-0.0,0.7140407562255859,44.10215414239989,81,-44,3,342,431,1193,383,18,6.32
-2,1,0,-2.0,1.0,0.7219839096069336,42.04759208325728,81,-42,2,342,431,1193,383,18,3.85
-2,0,0,-2.0,-0.0,0.7306778430938721,40.049968789001575,81,-40,2,342,431,1193,383,18,6.53
-2,0,0,-2.0,-0.0,0.740623950958252,38.05259518088089,81,-38,2,342,431,1193,383,18,6.39
-2,0,0,-2.0,-0.0,0.7460949420928955,36.05551275463989,81,-36,2,342,431,1193,383,18,6.25
-3,0,0,-3.0,-0.0,0.7540688514709473,33.06055050963308,81,-33,2,342,431,1193,383,18,6.71
-1,1,0,-1.0,1.0,0.7652769088745117,32.01562118716424,81,-32,1,342,431,1193,383,18,1.85
-2,0,0,-2.0,-0.0,0.7702157497406006,30.01666203960727,81,-30,1,342,431,1193,383,18,6.58
-1,0,0,-1.0,-0.0,0.7781798839569092,29.017236257093817,81,-29,1,342,431,1193,383,18,5.81
-1,0,0,-1.0,-0.0,0.7889919281005859,28.0178514522438,81,-28,1,342,431,1193,383,18,5.75
-1,0,0,-1.0,-0.0,0.7940199375152588,27.018512172212592,81,-27,1,342,431,1193,383,18,5.68
-1,0,0,-1.0,-0.0,0.8020288944244385,26.019223662515376,81,-26,1,342,431,1193,383,18,5.62
-1,0,0,-1.0,-0.0,0.8099968433380127,25.019992006393608,81,-25,1,342,431,1193,383,18,5.55
-1,0,0,-1.0,-0.0,0.8180217742919922,24.020824298928627,81,-24,1,342,431,1193,383,18,5.48
-1,0,0,-1.0,-0.0,0.8260018825531006,23.021728866442675,81,-23,1,342,431,1193,383,18,5.4
-1,0,0,-1.0,-0.0,0.8340039253234863,22.02271554554524,81,-22,1,342,431,1193,383,18,5.32
-1,0,0,-1.0,-0.0,0.8420219421386719,21.02379604162864,81,-21,1,342,431,1193,383,18,5.24
-1,0,0,-1.0,-0.0,0.8499898910522461,20.024984394500787,81,-20,1,342,431,1193,383,18,5.15
-2,0,0,-2.0,-0.0,0.857975959777832,18.027756377319946,81,-18,1,342,431,1193,383,18,5.39
-1,0,0,-1.0,-0.0,0.8659868240356445,17.029386365926403,81,-17,1,342,431,1193,383,18,4.85
-2,0,0,-2.0,-0.0,0.8739798069000244,15.033296378372908,81,-15,1,342,431,1193,383,18,4.97
-1,0,0,-1.0,-0.0,0.8820128440856934,14.035668847618199,81,-14,1,342,431,1193,383,18,4.49
-1,0,0,-1.0,-0.0,0.8899979591369629,13.038404810405298,81,-13,1,342,431,1193,383,18,4.35
-1,0,0,-1.0,-0.0,0.8986737728118896,12.041594578792296,81,-12,1,342,431,1193,383,18,4.19
-1,0,0,-1.0,-0.0,0.9220027923583984,11.045361017187261,81,-11,1,342,431,1193,383,18,4.02
0,0,1,-0.0,-0.0,0.9299807548522949,11.045361017187261,81,-11,1,342,431,1193,383,18,30.19
0,0,0,-0.0,-0.0,0.09680986404418945,1253.3355496434306,82,1211,323,1564,753,353,430,45,233.17
2,1,0,2.0,1.0,0.14882802963256836,1251.145475154668,82,1209,322,1564,753,353,430,45,13.46
3,0,0,3.0,-0.0,0.15677094459533691,1248.2467704744925,82,1206,322,1564,753,353,430,45,16.3
4,1,0,4.0,1.0,0.164747953414917,1244.1241899424672,82,1202,321,1564,753,353,430,45,24.62
6,1,0,6.0,1.0,0.1728229522705078,1238.069464933208,82,1196,320,1564,753,353,430,45,30.57
7,2,0,7.0,2.0,0.18079900741577148,1230.790396452621,82,1189,318,1564,753,353,430,45,36.85
11,4,0,11.0,4.0,0.1887519359588623,1219.1308379333204,82,1178,314,1564,753,353,430,45,49.84
16,4,0,16.0,4.0,0.19750595092773438,1202.640428390797,82,1162,310,1564,753,353,430,45,64.99
19,5,0,19.0,5.0,0.2047898769378662,1182.9936601689799,82,1143,305,1564,753,353,430,45,72.99
23,6,0,23.0,6.0,0.21564388275146484,1159.2243096139764,82,1120,299,1564,753,353,430,45,81.09
25,6,0,25.0,6.0,0.22078299522399902,1133.522827295507,82,1095,293,1564,753,353,430,45,82.96
27,7,0,27.0,7.0,0.22966289520263672,1105.6310415323912,82,1068,286,1564,753,353,430,45,86.72
29,5,0,29.0,5.0,0.2391359806060791,1076.3280169167763,82,1039,281,1564,753,353,430,45,85.62
33,7,0,33.0,7.0,0.24484992027282715,1042.6466323735956,82,1006,274,1564,753,353,430,45,91.56
32,6,0,32.0,6.0,0.2528219223022461,1010.1980003939822,82,974,268,1564,753,353,430,45,87.68
32,6,0,32.0,6.0,0.2630589008331299,977.7566159326154,82,942,262,1564,753,353,430,45,86.03
33,6,0,33.0,6.0,0.26891303062438965,944.3606302679078,82,909,256,1564,753,353,430,45,85.57
32,6,0,32.0,6.0,0.27713894844055176,911.9369495749144,82,877,250,1564,753,353,430,45,82.55
31,6,0,31.0,6.0,0.2847459316253662,880.4839578322822,82,846,244,1564,753,353,430,45,79.58
33,8,0,33.0,8.0,0.2927839756011963,846.5606889054086,82,813,236,1564,753,353,430,45,81.92
35,7,0,35.0,7.0,0.30148887634277344,811.0024660874959,82,778,229,1564,753,353,430,45,81.1
33,7,0,33.0,7.0,0.3087608814239502,777.3731407760368,82,745,222,1564,753,353,430,45,76.89
33,6,0,33.0,6.0,0.3178279399871826,744.043009509531,82,712,216,1564,753,353,430,45,74.1
33,6,0,33.0,6.0,0.3248729705810547,710.7327205075055,82,679,210,1564,753,353,430,45,72.0
33,7,0,33.0,7.0,0.33363986015319824,677.1447408050956,82,646,203,1564,753,353,430,45,70.53
33,6,0,33.0,6.0,0.34352898597717285,643.8773175069922,82,613,197,1564,753,353,430,45,67.63
34,6,0,34.0,6.0,0.348909854888916,609.6900852072305,82,579,191,1564,753,353,430,45,66.22
31,7,0,31.0,7.0,0.3568909168243408,578.0657402060773,82,548,184,1564,753,353,430,45,61.84
29,6,0,29.0,6.0,0.3679778575897217,548.6756783383058,82,519,178,1564,753,353,430,45,57.19
27,6,0,27.0,6.0,0.37284088134765625,521.1986185706942,82,492,172,1564,753,353,430,45,53.37
24,7,0,24.0,7.0,0.3807549476623535,496.23482344551354,82,468,165,1564,753,353,430,45,49.86
21,5,0,21.0,5.0,0.38876795768737793,474.7725771356219,82,447,160,1564,753,353,430,45,43.49
16,6,0,16.0,6.0,0.3968658447265625,457.6865739783067,82,431,154,1564,753,353,430,45,38.88
13,5,0,13.0,5.0,0.41144895553588867,443.7623237725348,82,418,149,1564,753,353,430,45,33.21
12,4,0,12.0,4.0,0.41300296783447266,431.11599367223664,82,406,145,1564,753,353,430,45,30.84
11,4,0,11.0,4.0,0.42358899116516113,419.4114924510295,82,395,141,1564,753,353,430,45,29.71
10,4,0,10.0,4.0,0.4289438724517822,408.648993636348,82,385,137,1564,753,353,430,45,26.4
9,4,0,9.0,4.0,0.43677783012390137,398.82953752198443,82,376,133,1564,753,353,430,45,23.71
9,3,0,9.0,3.0,0.4474449157714844,389.34432062122085,82,367,130,1564,753,353,430,45,24.33
8,4,0,8.0,4.0,0.4531748294830322,380.46944686794495,82,359,126,1564,753,353,430,45,20.95
9,4,0,9.0,4.0,0.46098804473876953,370.6534769835567,82,350,122,1564,753,353,430,45,22.64
11,4,0,11.0,4.0,0.47177982330322266,358.949857222426,82,339,118,1564,753,353,430,45,26.79
11,6,0,11.0,6.0,0.4768218994140625,346.5948643589515,82,328,112,1564,753,353,430,45,24.4
12,5,0,12.0,5.0,0.48477697372436523,333.6240399012038,82,316,107,1564,753,353,430,45,25.78
12,6,0,12.0,6.0,0.49625086784362793,320.3388830597997,82,304,101,1564,753,353,430,45,24.59
12,6,0,12.0,6.0,0.5008149147033691,307.06513966909364,82,292,95,1564,753,353,430,45,23.87
11,5,0,11.0,5.0,0.5089449882507324,295.0610106401725,82,281,90,1564,753,353,430,45,22.09
13,6,0,13.0,6.0,0.5199730396270752,280.8558349046713,82,268,84,1564,753,353,430,45,23.75
15,6,0,15.0,6.0,0.5250778198242188,264.7508262498911,82,253,78,1564,753,353,430,45,25.35
15,6,0,15.0,6.0,0.5327539443969727,248.65236777477105,82,238,72,1564,753,353,430,45,24.27
14,4,0,14.0,4.0,0.5407578945159912,234.0939982143925,82,224,68,1564,753,353,430,45,23.77
14,6,0,14.0,6.0,0.548893928527832,218.96118377465902,82,210,62,1564,753,353,430,45,21.14
14,4,0,14.0,4.0,0.5570039749145508,204.40156555173445,82,196,58,1564,753,353,430,45,22.41
14,4,0,14.0,4.0,0.5647590160369873,189.84203960134857,82,182,54,1564,753,353,430,45,21.45
13,4,0,13.0,4.0,0.5727729797363281,176.24131184259835,82,169,50,1564,753,353,430,45,19.8
13,4,0,13.0,4.0,0.5808169841766357,162.64070831129578,82,156,46,1564,753,353,430,45,18.9
13,4,0,13.0,4.0,0.5887649059295654,149.04026301640775,82,143,42,1564,753,353,430,45,17.96
13,4,0,13.0,4.0,0.5968208312988281,135.4400236266961,82,130,38,1564,753,353,430,45,17.0
12,3,0,12.0,3.0,0.6047918796539307,123.08127396155761,82,118,35,1564,753,353,430,45,14.27
11,4,0,11.0,4.0,0.612764835357666,111.40017953306898,82,107,31,1564,753,353,430,45,12.6
12,2,0,12.0,2.0,0.6209428310394287,99.32774033471213,82,95,29,1564,753,353,430,45,11.14
12,4,0,12.0,4.0,0.6288788318634033,86.68333173107735,82,83,25,1564,753,353,430,45,12.43
10,3,0,10.0,3.0,0.6367568969726562,76.24303246854758,82,73,22,1564,753,353,430,45,12.72
11,3,0,11.0,3.0,0.6450579166412354,64.8459713474939,82,62,19,1564,753,353,430,45,10.32
9,2,0,9.0,2.0,0.6527919769287109,55.65968020030299,82,53,17,1564,753,353,430,45,7.55
6,2,0,6.0,2.0,0.663787841796875,49.33558553417604,82,47,15,1564,753,353,430,45,8.44
5,1,0,5.0,1.0,0.6688878536224365,44.27188724235731,82,42,14,1564,753,353,430,45,5.16
5,2,0,5.0,2.0,0.6771948337554932,38.897300677553446,82,37,12,1564,753,353,430,45,5.82
5,1,0,5.0,1.0,0.6875119209289551,33.83784863137726,82,32,11,1564,753,353,430,45,4.57
4,0,0,4.0,-0.0,0.6927728652954102,30.083217912982647,82,28,11,1564,753,353,430,45,2.65
2,1,0,2.0,1.0,0.7008659839630127,27.85677655436824,82,26,10,1564,753,353,430,45,4.17
2,0,0,2.0,-0.0,0.7094509601593018,26.0,82,24,10,1564,753,353,430,45,2.12
1,0,0,1.0,-0.0,0.7168009281158447,25.079872407968907,82,23,10,1564,753,353,430,45,1.98
1,0,0,1.0,-0.0,0.7488598823547363,24.166091947189145,82,22,10,1564,753,353,430,45,1.91
1,1,0,1.0,1.0,0.7647459506988525,22.847319317591726,82,21,9,1564,753,353,430,45,2.04
1,0,0,1.0,-0.0,0.7730898857116699,21.93171219946131,82,20,9,1564,753,353,430,45,1.87
1,0,0,1.0,-0.0,0.7810928821563721,21.02379604162864,82,19,9,1564,753,353,430,45,1.79
1,1,0,1.0,1.0,0.7887649536132812,19.697715603592208,82,18,8,1564,753,353,430,45,2.0
1,0,0,1.0,-0.0,0.7972719669342041,18.788294228055936,82,17,8,1564,753,353,430,45,1.74
1,0,0,1.0,-0.0,0.8047690391540527,17.88854381999832,82,16,8,1564,753,353,430,45,1.63
0,0,1,-0.0,-0.0,-0.004415988922119141,589.4896097472796,83,-497,317,1051,1062,1548,745,28,150.1
0,0,0,-0.0,-0.0,0.07459592819213867,589.4896097472796,83,-497,317,1051,1062,1548,745,28,150.1
-2,1,0,-2.0,1.0,0.08860588073730469,587.2656979596203,83,-495,316,1051,1062,1548,745,28,14.33
-3,1,0,-3.0,1.0,0.09782195091247559,584.199452242126,83,-492,315,1051,1062,1548,745,28,16.73
-4,1,0,-4.0,1.0,0.10457897186279297,580.2930294256514,83,-488,314,1051,1062,1548,745,28,19.64
-4,0,0,-4.0,-0.0,0.11267685890197754,576.9332717047961,83,-484,314,1051,1062,1548,745,28,16.63
-6,1,0,-6.0,1.0,0.1206049919128418,571.3606566784241,83,-478,313,1051,1062,1548,745,28,25.22
-5,0,0,-5.0,-0.0,0.12882781028747559,567.1842734068003,83,-473,313,1051,1062,1548,745,28,19.59
-5,0,0,-5.0,-0.0,0.13665485382080078,563.0213139837603,83,-468,313,1051,1062,1548,745,28,19.44
-7,-2,0,-7.0,-2.0,0.14865899085998535,558.3421889844972,83,-461,315,1051,1062,1548,745,28,20.65
-9,-3,0,-9.0,-3.0,0.152940034866333,552.6554080075576,83,-452,318,1051,1062,1548,745,28,23.92
-10,-3,0,-10.0,-3.0,0.16064882278442383,546.2645879058974,83,-442,321,1051,1062,1548,745,28,26.07
-11,-3,0,-11.0,-3.0,0.16862702369689941,539.2003338277898,83,-431,324,1051,1062,1548,745,28,27.96
-14,-4,0,-14.0,-4.0,0.17658090591430664,530.5402906471854,83,-417,328,1051,1062,1548,745,28,32.21
-16,-5,0,-16.0,-5.0,0.184600830078125,521.238908754901,83,-401,333,1051,1062,1548,745,28,33.47
-20,-4,0,-20.0,-4.0,0.19257688522338867,508.65508942701047,83,-381,337,1051,1062,1548,745,28,40.88
-21,-5,0,-21.0,-5.0,0.2019050121307373,496.552112068814,83,-360,342,1051,1062,1548,745,28,39.05
-21,-3,0,-21.0,-3.0,0.20859789848327637,483.6796460468437,83,-339,345,1051,1062,1548,745,28,40.1
-19,-3,0,-19.0,-3.0,0.21657896041870117,472.7620966194308,83,-320,348,1051,1062,1548,745,28,35.19
-18,-1,0,-18.0,-1.0,0.22455596923828125,461.52464722915937,83,-302,349,1051,1062,1548,745,28,35.46
-16,0,0,-16.0,-0.0,0.23256397247314453,451.21724257833944,83,-286,349,1051,1062,1548,745,28,32.92
-12,0,0,-12.0,-0.0,0.24058294296264648,443.7082374714267,83,-274,349,1051,1062,1548,745,28,25.76
-9,0,0,-9.0,-0.0,0.2487640380859375,438.2077133050033,83,-265,349,1051,1062,1548,745,28,20.01
-7,1,0,-7.0,1.0,0.25658702850341797,433.20664814843275,83,-258,348,1051,1062,1548,745,28,18.64
-7,3,0,-7.0,3.0,0.2656378746032715,426.64505153581706,83,-251,345,1051,1062,1548,745,28,23.4
-6,3,0,-6.0,3.0,0.2725818157196045,420.7006061321994,83,-245,342,1051,1062,1548,745,28,21.66
-5,4,0,-5.0,4.0,0.2809300422668457,414.5407097017131,83,-240,338,1051,1062,1548,745,28,22.82
-7,4,0,-7.0,4.0,0.2885730266571045,407.2407150568322,83,-233,334,1051,1062,1548,745,28,24.85
-5,5,0,-5.0,5.0,0.2965848445892334,400.2811511925087,83,-228,329,1051,1062,1548,745,28,24.97
-6,7,0,-6.0,7.0,0.30464696884155273,391.111237373717,83,-222,322,1051,1062,1548,745,28,30.45
-5,7,0,-5.0,7.0,0.3191659450531006,382.510130584799,83,-217,315,1051,1062,1548,745,28,30.71
-6,8,0,-6.0,8.0,0.3205900192260742,372.5184559186296,83,-211,307,1051,1062,1548,745,28,32.34
-6,9,0,-6.0,9.0,0.3311469554901123,361.70291677010295,83,-205,298,1051,1062,1548,745,28,34.32
-7,9,0,-7.0,9.0,0.33659887313842773,350.3212811120672,83,-198,289,1051,1062,1548,745,28,33.32
-7,8,0,-7.0,8.0,0.34458398818969727,339.7675676105652,83,-191,281,1051,1062,1548,745,28,30.33
-7,10,0,-7.0,10.0,0.3525660037994385,327.5622078323444,83,-184,271,1051,1062,1548,745,28,34.75
-8,12,0,-8.0,12.0,0.3605978488922119,313.1405435263853,83,-176,259,1051,1062,1548,745,28,37.5
-8,12,0,-8.0,12.0,0.3686490058898926,298.7189314389029,83,-168,247,1051,1062,1548,745,28,36.41
-8,13,0,-8.0,13.0,0.38021087646484375,283.47133893923035,83,-160,234,1051,1062,1548,745,28,34.85
-9,15,0,-9.0,15.0,0.38463592529296875,266.0112779564054,83,-151,219,1051,1062,1548,745,28,35.68
-8,14,0,-8.0,14.0,0.3926060199737549,249.94799459087486,83,-143,205,1051,1062,1548,745,28,32.29
-8,13,0,-8.0,13.0,0.4005608558654785,234.71045992882378,83,-135,192,1051,1062,1548,745,28,30.56
-8,13,0,-8.0,13.0,0.4087188243865967,219.4766502386985,83,-127,179,1051,1062,1548,745,28,29.16
-8,12,0,-8.0,12.0,0.41757988929748535,205.0609665440988,83,-119,167,1051,1062,1548,745,28,27.92
-8,13,0,-8.0,13.0,0.4250669479370117,189.8341381311591,83,-111,154,1051,1062,1548,745,28,26.38
-7,13,0,-7.0,13.0,0.43259596824645996,175.2055935180153,83,-104,141,1051,1062,1548,745,28,23.62
-6,12,0,-6.0,12.0,0.44065403938293457,162.00308639035245,83,-98,129,1051,1062,1548,745,28,20.78
-5,11,0,-5.0,11.0,0.45115089416503906,150.2431362824938,83,-93,118,1051,1062,1548,745,28,18.11
-5,11,0,-5.0,11.0,0.45669984817504883,138.53880322855397,83,-88,107,1051,1062,1548,745,28,16.96
-5,11,0,-5.0,11.0,0.4649200439453125,126.90547663517127,83,-83,96,1051,1062,1548,745,28,15.79
-5,10,0,-5.0,10.0,0.4740610122680664,116.10340218959993,83,-78,86,1051,1062,1548,745,28,14.28
-5,10,0,-5.0,10.0,0.4807608127593994,105.38026380684383,83,-73,76,1051,1062,1548,745,28,13.18
-6,9,0,-6.0,9.0,0.48859596252441406,94.75230867899737,83,-67,67,1051,1062,1548,745,28,12.81
-6,10,0,-6.0,10.0,0.49654603004455566,83.48652585896721,83,-61,57,1051,1062,1548,745,28,11.72
-6,8,0,-6.0,8.0,0.5045850276947021,73.66138744281159,83,-55,49,1051,1062,1548,745,28,10.48
-5,7,0,-5.0,7.0,0.512596845626831,65.29931086925804,83,-50,42,1051,1062,1548,745,28,8.63
-5,6,0,-5.0,6.0,0.5222949981689453,57.62811813689564,83,-45,36,1051,1062,1548,745,28,7.97
-4,6,0,-4.0,6.0,0.5288019180297852,50.80354318352215,83,-41,30,1051,1062,1548,745,28,6.24
-6,5,0,-6.0,5.0,0.5365979671478271,43.01162633521314,83,-35,25,1051,1062,1548,745,28,8.23
-5,5,0,-5.0,5.0,0.5455260276794434,36.05551275463989,83,-30,20,1051,1062,1548,745,28,6.0
-5,4,0,-5.0,4.0,0.5525968074798584,29.68164415931166,83,-25,16,1051,1062,1548,745,28,6.15
-4,3,0,-4.0,3.0,0.5605778694152832,24.698178070456937,83,-21,13,1051,1062,1548,745,28,5.52
-2,2,0,-2.0,2.0,0.5699169635772705,21.95449840010015,83,-19,11,1051,1062,1548,745,28,3.19
-2,1,0,-2.0,1.0,0.5768249034881592,19.72308292331602,83,-17,10,1051,1062,1548,745,28,4.75
-1,1,0,-1.0,1.0,0.5848100185394287,18.35755975068582,83,-16,9,1051,1062,1548,745,28,2.64
-1,0,0,-1.0,-0.0,0.5944328308105469,17.4928556845359,83,-15,9,1051,1062,1548,745,28,1.57
-2,0,0,-2.0,-0.0,0.6007099151611328,15.811388300841896,83,-13,9,1051,1062,1548,745,28,1.38
-1,0,0,-1.0,-0.0,0.6102838516235352,15.0,83,-12,9,1051,1062,1548,745,28,1.21
-1,0,0,-1.0,-0.0,0.619088888168335,14.212670403551895,83,-11,9,1051,1062,1548,745,28,1.08
-1,0,0,-1.0,-0.0,0.6250438690185547,13.45362404707371,83,-10,9,1051,1062,1548,745,28,0.95
-1,0,0,-1.0,-0.0,0.6333558559417725,12.727922061357855,83,-9,9,1051,1062,1548,745,28,0.81
-1,0,0,-1.0,-0.0,0.6437258720397949,12.041594578792296,83,-8,9,1051,1062,1548,745,28,0.66
-1,0,0,-1.0,-0.0,0.6725778579711914,11.40175425099138,83,-7,9,1051,1062,1548,745,28,0.51
-1,0,0,-1.0,-0.0,0.6965830326080322,10.816653826391969,83,-6,9,1051,1062,1548,745,28,0.35
-1,1,0,-1.0,1.0,0.7125630378723145,9.433981132056603,83,-5,8,1051,1062,1548,745,28,2.39
0,1,0,-0.0,1.0,0.720587968826294,8.602325267042627,83,-5,7,1051,1062,1548,745,28,0.92
-1,1,0,-1.0,1.0,0.7285809516906738,7.211102550927978,83,-4,6,1051,1062,1548,745,28,2.38
-1,1,0,-1.0,1.0,0.7446010112762451,5.830951894845301,83,-3,5,1051,1062,1548,745,28,1.9
0,1,0,-0.0,1.0,0.7539210319519043,5.0,83,-3,4,1051,1062,1548,745,28,0.47
0,0,1,-0.0,-0.0,0.7665948867797852,5.0,83,-3,4,1051,1062,1548,745,28,28.4
-1,1,1,-1.0,1.0,0.7729678153991699,3.605551275463989,83,-2,3,1051,1062,1548,745,28,11.83
0,0,0,-0.0,-0.0,0.07648420333862305,647.3801047298256,84,-626,-165,427,894,1053,1059,32,159.04
-1,0,0,-1.0,-0.0,0.14568209648132324,646.4131805586889,84,-625,-165,427,894,1053,1059,32,7.11
-2,0,0,-2.0,-0.0,0.15594696998596191,644.4796350545143,84,-623,-165,427,894,1053,1059,32,11.28
-2,-2,0,-2.0,-2.0,0.1615440845489502,642.0358245456401,84,-621,-163,427,894,1053,1059,32,12.38
-3,-2,0,-3.0,-2.0,0.16960597038269043,638.6274344247983,84,-618,-161,427,894,1053,1059,32,16.79
-4,-2,0,-4.0,-2.0,0.18042612075805664,634.2531040523176,84,-614,-159,427,894,1053,1059,32,20.95
-7,-4,0,-7.0,-4.0,0.18561601638793945,626.477453704441,84,-607,-155,427,894,1053,1059,32,31.63
-11,-5,0,-11.0,-5.0,0.19480514526367188,614.5860395420644,84,-596,-150,427,894,1053,1059,32,42.86
-16,-8,0,-16.0,-8.0,0.21011900901794434,597.129801634452,84,-580,-142,427,894,1053,1059,32,53.61
-19,-7,0,-19.0,-7.0,0.21068310737609863,577.0147311811025,84,-561,-135,427,894,1053,1059,32,57.97
-23,-7,0,-23.0,-7.0,0.21748614311218262,553.017178756682,84,-538,-128,427,894,1053,1059,32,63.05
-23,-8,0,-23.0,-8.0,0.22598910331726074,528.7958017987662,84,-515,-120,427,894,1053,1059,32,60.95
-22,-6,0,-22.0,-6.0,0.23433613777160645,506.0088932024812,84,-493,-114,427,894,1053,1059,32,58.56
-20,-5,0,-20.0,-5.0,0.24152898788452148,485.3967449417023,84,-473,-109,427,894,1053,1059,32,54.78
-20,-5,0,-20.0,-5.0,0.24972105026245117,464.7848964843845,84,-453,-104,427,894,1053,1059,32,53.3
-18,-5,0,-18.0,-5.0,0.2574939727783203,446.12330134168064,84,-435,-99,427,894,1053,1059,32,48.31
-17,-4,0,-17.0,-4.0,0.26551008224487305,428.65953856178214,84,-418,-95,427,894,1053,1059,32,46.91
-18,-5,0,-18.0,-5.0,0.273529052734375,410.0,84,-400,-90,427,894,1053,1059,32,45.75
-18,-4,0,-18.0,-4.0,0.281466007232666,391.56097864828155,84,-382,-86,427,894,1053,1059,32,46.17
-18,-4,0,-18.0,-4.0,0.28957319259643555,373.121963974248,84,-364,-82,427,894,1053,1059,32,44.84
-15,-4,0,-15.0,-4.0,0.29758405685424805,357.61012289922667,84,-349,-78,427,894,1053,1059,32,37.95
-14,-4,0,-14.0,-4.0,0.305462121963501,343.0757933751666,84,-335,-74,427,894,1053,1059,32,35.12
-15,-3,0,-15.0,-3.0,0.3135111331939697,327.7819397099236,84,-320,-71,427,894,1053,1059,32,36.3
-13,-3,0,-13.0,-3.0,0.3215341567993164,314.4407734375426,84,-307,-68,427,894,1053,1059,32,33.34
-13,-2,0,-13.0,-2.0,0.32947206497192383,301.3171087077533,84,-294,-66,427,894,1053,1059,32,30.29
-14,-3,0,-14.0,-3.0,0.3395881652832031,287.0,84,-280,-63,427,894,1053,1059,32,32.78
-13,-3,0,-13.0,-3.0,0.34549713134765625,273.65854636754904,84,-267,-60,427,894,1053,1059,32,30.93
-13,-3,0,-13.0,-3.0,0.353546142578125,260.31711430484165,84,-254,-57,427,894,1053,1059,32,30.02
-15,-3,0,-15.0,-3.0,0.36235499382019043,245.0244885720609,84,-239,-54,427,894,1053,1059,32,30.16
-15,-3,0,-15.0,-3.0,0.36946702003479004,229.73245308401684,84,-224,-51,427,894,1053,1059,32,28.91
-15,-3,0,-15.0,-3.0,0.3774840831756592,214.44113411377026,84,-209,-48,427,894,1053,1059,32,27.63
-13,-3,0,-13.0,-3.0,0.3854861259460449,201.0994778710278,84,-196,-45,427,894,1053,1059,32,26.32
-12,-3,0,-12.0,-3.0,0.39354515075683594,188.73261509341728,84,-184,-42,427,894,1053,1059,32,23.05
-12,-2,0,-12.0,-2.0,0.4014921188354492,176.58992043715293,84,-172,-40,427,894,1053,1059,32,20.71
-12,-3,0,-12.0,-3.0,0.40949201583862305,164.2224101637776,84,-160,-37,427,894,1053,1059,32,21.39
-10,-3,0,-10.0,-3.0,0.41768908500671387,153.80507143784303,84,-150,-34,427,894,1053,1059,32,17.36
-11,-2,0,-11.0,-2.0,0.42612504959106445,142.63590010933433,84,-139,-32,427,894,1053,1059,32,17.72
-10,-3,0,-10.0,-3.0,0.43366408348083496,132.21951444472938,84,-129,-29,427,894,1053,1059,32,15.82
-10,-2,0,-10.0,-2.0,0.4414691925048828,122.0245876862528,84,-119,-27,427,894,1053,1059,32,16.08
-10,-3,0,-10.0,-3.0,0.4494900703430176,111.61093136427094,84,-109,-24,427,894,1053,1059,32,14.25
-10,-2,0,-10.0,-2.0,0.4597749710083008,101.41498903022176,84,-99,-22,427,894,1053,1059,32,14.79
-9,-1,0,-9.0,-1.0,0.46844005584716797,92.41753080449618,84,-90,-21,427,894,1053,1059,32,11.28
-9,-2,0,-9.0,-2.0,0.4734940528869629,83.19855767980596,84,-81,-19,427,894,1053,1059,32,13.37
-9,-1,0,-9.0,-1.0,0.48148512840270996,74.21590126111789,84,-72,-18,427,894,1053,1059,32,9.8
-7,-1,0,-7.0,-1.0,0.4930140972137451,67.1863081289633,84,-65,-17,427,894,1053,1059,32,8.45
-8,-2,0,-8.0,-2.0,0.4977381229400635,58.9406481131655,84,-57,-15,427,894,1053,1059,32,11.09
-7,0,0,-7.0,-0.0,0.5060350894927979,52.20153254455275,84,-50,-15,427,894,1053,1059,32,6.04
-7,-1,0,-7.0,-1.0,0.5171561241149902,45.221676218380054,84,-43,-14,427,894,1053,1059,32,6.42
-6,-1,0,-6.0,-1.0,0.5217480659484863,39.21734310225516,84,-37,-13,427,894,1053,1059,32,5.63
-6,-1,0,-6.0,-1.0,0.5295610427856445,33.24154027718932,84,-31,-12,427,894,1053,1059,32,4.98
-6,0,0,-6.0,-0.0,0.537492036819458,27.730849247724095,84,-25,-12,427,894,1053,1059,32,3.31
-5,-1,0,-5.0,-1.0,0.54551100730896,22.825424421026653,84,-20,-11,427,894,1053,1059,32,3.36
-4,0,0,-4.0,-0.0,0.5534751415252686,19.4164878389476,84,-16,-11,427,894,1053,1059,32,1.75
-3,0,0,-3.0,-0.0,0.5647141933441162,17.029386365926403,84,-13,-11,427,894,1053,1059,32,1.17
-2,0,0,-2.0,-0.0,0.5700809955596924,15.556349186104045,84,-11,-11,427,894,1053,1059,32,0.83
-2,-1,0,-2.0,-1.0,0.5778591632843018,13.45362404707371,84,-9,-10,427,894,1053,1059,32,1.89
-2,0,0,-2.0,-0.0,0.5894901752471924,12.206555615733702,84,-7,-10,427,894,1053,1059,32,0.27
-2,0,0,-2.0,-0.0,0.5935091972351074,11.180339887498949,84,-5,-10,427,894,1053,1059,32,-0.07
-2,0,0,-2.0,-0.0,0.6016631126403809,10.44030650891055,84,-3,-10,427,894,1053,1059,32,-0.4
-2,0,0,-2.0,-0.0,0.616793155670166,10.04987562112089,84,-1,-10,427,894,1053,1059,32,-0.72
-1,0,0,-1.0,-0.0,0.6176431179046631,10.0,84,0,-10,427,894,1053,1059,32,-0.49
-2,0,0,-2.0,-0.0,0.6255431175231934,10.198039027185569,84,2,-10,427,894,1053,1059,32,0.78
-2,0,0,-2.0,-0.0,0.6335430145263672,10.770329614269007,84,4,-10,427,894,1053,1059,32,-0.19
-2,0,0,-2.0,-0.0,0.6473941802978516,11.661903789690601,84,6,-10,427,894,1053,1059,32,-0.22
-2,0,0,-2.0,-0.0,0.6494870185852051,12.806248474865697,84,8,-10,427,894,1053,1059,32,-0.08
-2,0,0,-2.0,-0.0,0.6593949794769287,14.142135623730951,84,10,-10,427,894,1053,1059,32,0.12
-3,0,0,-3.0,-0.0,0.6654901504516602,16.401219466856727,84,13,-10,427,894,1053,1059,32,-0.06
-3,0,0,-3.0,-0.0,0.6735010147094727,18.867962264113206,84,16,-10,427,894,1053,1059,32,0.29
-1,0,0,-1.0,-0.0,0.6814641952514648,19.72308292331602,84,17,-10,427,894,1053,1059,32,1.62
-1,0,0,-1.0,-0.0,0.6896390914916992,20.591260281974,84,18,-10,427,894,1053,1059,32,1.7
-2,-1,0,-2.0,-1.0,0.6988379955291748,21.93171219946131,84,20,-9,427,894,1053,1059,32,0.31
-1,0,0,-1.0,-0.0,0.7082581520080566,22.847319317591726,84,21,-9,427,894,1053,1059,32,2.06
0,0,1,-0.0,-0.0,0.7424750328063965,22.847319317591726,84,21,-9,427,894,1053,1059,32,33.769999999999996
0,0,0,-0.0,-0.0,0.06847977638244629,352.23855552735847,85,-346,66,60,969,406,903,50,107.79
1,0,0,1.0,-0.0,0.08952569961547852,353.2208940592275,85,-347,66,60,969,406,903,50,5.07
1,0,0,1.0,-0.0,0.09757471084594727,354.2033314354906,85,-348,66,60,969,406,903,50,5.08
2,0,0,2.0,-0.0,0.10604357719421387,356.16849944934773,85,-350,66,60,969,406,903,50,4.05
2,0,0,2.0,-0.0,0.11348772048950195,358.13405311419353,85,-352,66,60,969,406,903,50,4.06
2,0,0,2.0,-0.0,0.12152767181396484,360.0999861149678,85,-354,66,60,969,406,903,50,4.07
2,0,0,2.0,-0.0,0.13079071044921875,362.0662922725616,85,-356,66,60,969,406,903,50,4.08
3,0,0,3.0,-0.0,0.1374807357788086,365.0164379860173,85,-359,66,60,969,406,903,50,3.71
3,-1,0,3.0,-1.0,0.1455075740814209,368.1480680378481,85,-362,67,60,969,406,903,50,4.03
4,-2,0,4.0,-2.0,0.15346956253051758,372.44731170999205,85,-366,69,60,969,406,903,50,2.88
4,-1,0,4.0,-1.0,0.16175365447998047,376.5634076752546,85,-370,70,60,969,406,903,50,4.92
4,-2,0,4.0,-2.0,0.16948771476745605,380.8674310045426,85,-374,72,60,969,406,903,50,2.91
4,-1,0,4.0,-1.0,0.1774766445159912,384.98441526898205,85,-378,73,60,969,406,903,50,5.0
4,-2,0,4.0,-2.0,0.1857776641845703,389.2929488187527,85,-382,75,60,969,406,903,50,2.94
4,-2,0,4.0,-2.0,0.19350075721740723,393.605132080363,85,-386,77,60,969,406,903,50,2.96
3,-2,0,3.0,-2.0,0.2029125690460205,396.94080163167905,85,-389,79,60,969,406,903,50,2.63
2,-2,0,2.0,-2.0,0.2094707489013672,399.30189080443887,85,-391,81,60,969,406,903,50,2.37
1,-2,0,1.0,-2.0,0.217498779296875,400.6906537467526,85,-392,83,60,969,406,903,50,2.43
0,-2,0,-0.0,-2.0,0.22737956047058105,401.10971067776455,85,-392,85,60,969,406,903,50,5.33
1,-2,0,1.0,-2.0,0.23348069190979004,402.51459600864166,85,-393,87,60,969,406,903,50,2.43
1,-1,0,1.0,-1.0,0.24148964881896973,403.7078151336682,85,-394,88,60,969,406,903,50,3.37
0,-1,0,-0.0,-1.0,0.2494657039642334,403.92697359795125,85,-394,89,60,969,406,903,50,9.63
-1,-1,0,-1.0,-1.0,0.2576456069946289,403.17365985391456,85,-393,90,60,969,406,903,50,2.38
-2,-1,0,-2.0,-1.0,0.2734987735748291,401.44987233775527,85,-391,91,60,969,406,903,50,4.93
-3,0,0,-3.0,-0.0,0.28150463104248047,398.5285435197835,85,-388,91,60,969,406,903,50,8.82
-5,0,0,-5.0,-0.0,0.2895207405090332,393.66229181876184,85,-383,91,60,969,406,903,50,12.35
-6,0,0,-6.0,-0.0,0.29746174812316895,387.82728114458376,85,-377,91,60,969,406,903,50,13.91
-8,0,0,-8.0,-0.0,0.3056366443634033,380.0552591400361,85,-369,91,60,969,406,903,50,16.87
-9,1,0,-9.0,1.0,0.3136906623840332,371.07950630558946,85,-360,90,60,969,406,903,50,19.24
-11,1,0,-11.0,1.0,0.3235945701599121,360.16940458623077,85,-349,89,60,969,406,903,50,21.4
-13,2,0,-13.0,2.0,0.3294987678527832,347.08068226278453,85,-336,87,60,969,406,903,50,24.29
-14,2,0,-14.0,2.0,0.33759570121765137,333.030028676094,85,-322,85,60,969,406,903,50,24.63
-14,3,0,-14.0,3.0,0.3477916717529297,318.7287247801804,85,-308,82,60,969,406,903,50,25.31
-15,3,0,-15.0,3.0,0.3534996509552002,303.4633421024688,85,-293,79,60,969,406,903,50,25.24
-16,4,0,-16.0,4.0,0.3657996654510498,286.9738664059848,85,-277,75,60,969,406,903,50,26.9
-16,3,0,-16.0,3.0,0.36957263946533203,270.74896121684384,85,-261,72,60,969,406,903,50,24.12
-16,3,0,-16.0,3.0,0.37748074531555176,254.53094114468678,85,-245,69,60,969,406,903,50,23.11
-17,2,0,-17.0,2.0,0.38547468185424805,237.6404847663798,85,-228,67,60,969,406,903,50,21.83
-15,3,0,-15.0,3.0,0.3935377597808838,222.40728405337808,85,-213,64,60,969,406,903,50,20.33
-14,3,0,-14.0,3.0,0.4014756679534912,208.13937638034758,85,-199,61,60,969,406,903,50,18.84
-13,3,0,-13.0,3.0,0.40948057174682617,194.83326204732086,85,-186,58,60,969,406,903,50,17.5
-13,4,0,-13.0,4.0,0.41760754585266113,181.23189564753773,85,-173,54,60,969,406,903,50,19.51
-14,3,0,-14.0,3.0,0.42626476287841797,166.97904060090895,85,-159,51,60,969,406,903,50,16.23
-14,2,0,-14.0,2.0,0.43680667877197266,153.05554547287727,85,-145,49,60,969,406,903,50,14.34
-15,3,0,-15.0,3.0,0.4416027069091797,137.8985134075056,85,-130,46,60,969,406,903,50,14.44
-15,2,0,-15.0,2.0,0.4496316909790039,123.13001258832064,85,-115,44,60,969,406,903,50,12.55
-13,3,0,-13.0,3.0,0.4614887237548828,109.9317970379817,85,-102,41,60,969,406,903,50,11.44
-13,4,0,-13.0,4.0,0.4656045436859131,96.38464608017192,85,-89,37,60,969,406,903,50,11.36
-11,3,0,-11.0,3.0,0.4734675884246826,85.0881895447306,85,-78,34,60,969,406,903,50,9.09
-11,2,0,-11.0,2.0,0.48148560523986816,74.24957912338628,85,-67,32,60,969,406,903,50,7.39
-10,3,0,-10.0,3.0,0.4895355701446533,63.953107821277925,85,-57,29,60,969,406,903,50,7.11
-8,2,0,-8.0,2.0,0.49745965003967285,55.94640292279746,85,-49,27,60,969,406,903,50,5.37
-6,2,0,-6.0,2.0,0.5054845809936523,49.73932046178355,85,-43,25,60,969,406,903,50,4.82
-5,1,0,-5.0,1.0,0.5138006210327148,44.94441010848846,85,-38,24,60,969,406,903,50,3.38
-3,1,0,-3.0,1.0,0.5254707336425781,41.88078318274385,85,-35,23,60,969,406,903,50,3.31
-2,1,0,-2.0,1.0,0.5297517776489258,39.66106403010388,85,-33,22,60,969,406,903,50,4.06
-2,0,0,-2.0,-0.0,0.5384657382965088,38.01315561749642,85,-31,22,60,969,406,903,50,1.65
-1,1,0,-1.0,1.0,0.5454726219177246,36.61966684720111,85,-30,21,60,969,406,903,50,3.38
-1,0,0,-1.0,-0.0,0.5535037517547607,35.805027579936315,85,-29,21,60,969,406,903,50,1.48
0,1,0,-0.0,1.0,0.5633156299591064,35.22782990761707,85,-29,20,60,969,406,903,50,0.79
-1,0,0,-1.0,-0.0,0.5696306228637695,34.40930106817051,85,-28,20,60,969,406,903,50,1.48
0,1,0,-0.0,1.0,0.578528642654419,33.83784863137726,85,-28,19,60,969,406,903,50,0.76
-1,0,0,-1.0,-0.0,0.588397741317749,33.015148038438355,85,-27,19,60,969,406,903,50,1.48
0,0,1,-0.0,-0.0,0.5994696617126465,33.015148038438355,85,-27,19,60,969,406,903,50,36.879999999999995
-1,0,1,-1.0,-0.0,0.6014716625213623,32.202484376209235,85,-26,19,60,969,406,903,50,11.43
-1,1,1,-1.0,1.0,0.008231878280639648,1886.8094763382974,86,1713,-791,1798,160,86,950,9,24.04
-1,1,1,-1.0,1.0,0.032115936279296875,1888.1366475973077,86,1714,-792,1798,160,86,950,9,24.04
0,0,0,-0.0,-0.0,0.11511087417602539,1888.1366475973077,86,1714,-792,1798,160,86,950,9,289.04
1,0,0,1.0,-0.0,0.1521749496459961,1887.2289209314274,86,1713,-792,1798,160,86,950,9,27.81
3,-1,0,3.0,-1.0,0.16042780876159668,1884.0862506796232,86,1710,-791,1798,160,86,950,9,76.75
3,-2,0,3.0,-2.0,0.1717379093170166,1880.52386318281,86,1707,-789,1798,160,86,950,9,83.23
5,-2,0,5.0,-2.0,0.17636489868164062,1875.1461276391235,86,1702,-787,1798,160,86,950,9,109.86
4,-3,0,4.0,-3.0,0.18410682678222656,1870.2566668775705,86,1698,-784,1798,160,86,950,9,101.83
5,-3,0,5.0,-3.0,0.1921088695526123,1864.4597072610607,86,1693,-781,1798,160,86,950,9,113.68
7,-5,0,7.0,-5.0,0.20026779174804688,1856.0096982505238,86,1686,-776,1798,160,86,950,9,138.57
10,-6,0,10.0,-6.0,0.20812082290649414,1844.4175232305727,86,1676,-770,1798,160,86,950,9,160.77
11,-7,0,11.0,-7.0,0.21610188484191895,1831.5004777504155,86,1665,-763,1798,160,86,950,9,167.25
15,-8,0,15.0,-8.0,0.22411584854125977,1814.5316200055595,86,1650,-755,1798,160,86,950,9,185.15
19,-8,0,19.0,-8.0,0.2327117919921875,1793.9258624592044,86,1631,-747,1798,160,86,950,9,196.48
25,-9,0,25.0,-9.0,0.2400989532470703,1767.4501407394778,86,1606,-738,1798,160,86,950,9,207.59
29,-11,0,29.0,-11.0,0.2482469081878662,1736.5074143233596,86,1577,-727,1798,160,86,950,9,213.6
33,-11,0,33.0,-11.0,0.2564578056335449,1701.9377191895126,86,1544,-716,1798,160,86,950,9,215.8
34,-15,0,34.0,-15.0,0.26714491844177246,1664.7825683854333,86,1510,-701,1798,160,86,950,9,218.3
37,-14,0,37.0,-14.0,0.27227091789245605,1625.330120314024,86,1473,-687,1798,160,86,950,9,216.6
35,-14,0,35.0,-14.0,0.28080081939697266,1587.694240085288,86,1438,-673,1798,160,86,950,9,212.42
35,-15,0,35.0,-15.0,0.2881147861480713,1549.6364089682456,86,1403,-658,1798,160,86,950,9,210.74
35,-15,0,35.0,-15.0,0.29631686210632324,1511.5796373330782,86,1368,-643,1798,160,86,950,9,207.97
34,-18,0,34.0,-18.0,0.30413293838500977,1473.153420387707,86,1334,-625,1798,160,86,950,9,205.15
34,-20,0,34.0,-20.0,0.3121058940887451,1433.8845839188034,86,1300,-605,1798,160,86,950,9,202.21
30,-17,0,30.0,-17.0,0.32031679153442383,1399.5156304950654,86,1270,-588,1798,160,86,950,9,194.75
28,-14,0,28.0,-14.0,0.32809972763061523,1368.2251276745358,86,1242,-574,1798,160,86,950,9,189.72
28,-13,0,28.0,-13.0,0.33609580993652344,1337.3544780648099,86,1214,-561,1798,160,86,950,9,188.33
26,-13,0,26.0,-13.0,0.3442418575286865,1308.2996598639013,86,1188,-548,1798,160,86,950,9,182.14
27,-13,0,27.0,-13.0,0.3521099090576172,1278.3372012110108,86,1161,-535,1798,160,86,950,9,181.67
29,-14,0,29.0,-14.0,0.36024975776672363,1246.1400402843976,86,1132,-521,1798,160,86,950,9,181.92
29,-15,0,29.0,-15.0,0.36813974380493164,1213.5258546895489,86,1103,-506,1798,160,86,950,9,178.87
32,-15,0,32.0,-15.0,0.37608885765075684,1178.1858936517615,86,1071,-491,1798,160,86,950,9,180.31
33,-15,0,33.0,-15.0,0.3841848373413086,1141.9369509740895,86,1038,-476,1798,160,86,950,9,178.48
31,-15,0,31.0,-15.0,0.39226293563842773,1107.5062076575464,86,1007,-461,1798,160,86,950,9,172.69
33,-15,0,33.0,-15.0,0.40009284019470215,1071.2572053433294,86,974,-446,1798,160,86,950,9,172.31
32,-13,0,32.0,-13.0,0.4086189270019531,1036.751175547923,86,942,-433,1798,160,86,950,9,165.72
31,-13,0,31.0,-13.0,0.4197728633880615,1003.1555213425285,86,911,-420,1798,160,86,950,9,162.03
32,-14,0,32.0,-14.0,0.4241337776184082,968.2339593300784,86,879,-406,1798,160,86,950,9,160.53
32,-13,0,32.0,-13.0,0.4322018623352051,933.7333666523865,86,847,-393,1798,160,86,950,9,155.96
32,-14,0,32.0,-14.0,0.4400968551635742,898.8136625574847,86,815,-379,1798,160,86,950,9,153.68
29,-14,0,29.0,-14.0,0.4491007328033447,866.614677927855,86,786,-365,1798,160,86,950,9,148.34
30,-16,0,30.0,-16.0,0.4561119079589844,832.6686015456569,86,756,-349,1798,160,86,950,9,145.15
28,-15,0,28.0,-15.0,0.4641609191894531,800.9619216916619,86,728,-334,1798,160,86,950,9,139.76
26,-14,0,26.0,-14.0,0.47346973419189453,771.4946532543178,86,702,-320,1798,160,86,950,9,134.4
25,-15,0,25.0,-15.0,0.48011183738708496,742.5321541859315,86,677,-305,1798,160,86,950,9,130.1
24,-14,0,24.0,-14.0,0.48812079429626465,714.9055881723125,86,653,-291,1798,160,86,950,9,125.83
24,-14,0,24.0,-14.0,0.49757885932922363,687.2917866525105,86,629,-277,1798,160,86,950,9,122.75
25,-14,0,25.0,-14.0,0.5041089057922363,658.7753790177651,86,604,-263,1798,160,86,950,9,120.63
25,-13,0,25.0,-13.0,0.5121109485626221,630.6671071175347,86,579,-250,1798,160,86,950,9,117.41
26,-13,0,26.0,-13.0,0.521460771560669,601.6460753632488,86,553,-237,1798,160,86,950,9,115.08
24,-11,0,24.0,-11.0,0.5281438827514648,575.253857005757,86,529,-226,1798,160,86,950,9,110.31
23,-11,0,23.0,-11.0,0.5365328788757324,549.7826843399126,86,506,-215,1798,160,86,950,9,105.73
24,-10,0,24.0,-10.0,0.5440988540649414,523.7833521600319,86,482,-205,1798,160,86,950,9,104.57
22,-10,0,22.0,-10.0,0.5521318912506104,499.62485926943225,86,460,-195,1798,160,86,950,9,98.73
19,-9,0,19.0,-9.0,0.5603859424591064,478.61989093642984,86,441,-186,1798,160,86,950,9,91.99
18,-7,0,18.0,-7.0,0.5710358619689941,459.31470692761405,86,423,-179,1798,160,86,950,9,87.82
16,-7,0,16.0,-7.0,0.5763387680053711,441.85178510446235,86,407,-172,1798,160,86,950,9,83.78
15,-5,0,15.0,-5.0,0.5842318534851074,426.09036600233054,86,392,-167,1798,160,86,950,9,77.31
13,-6,0,13.0,-6.0,0.5939717292785645,411.7790669764552,86,379,-161,1798,160,86,950,9,74.17
13,-4,0,13.0,-4.0,0.6002707481384277,398.25243250983414,86,366,-157,1798,160,86,950,9,69.66
12,-5,0,12.0,-5.0,0.6091008186340332,385.25316351718647,86,354,-152,1798,160,86,950,9,69.43
13,-5,0,13.0,-5.0,0.6161048412322998,371.33542788158525,86,341,-147,1798,160,86,950,9,68.38
12,-5,0,12.0,-5.0,0.6241939067840576,358.33643409511126,86,329,-142,1798,160,86,950,9,66.17
13,-6,0,13.0,-6.0,0.6321277618408203,344.02325502791234,86,316,-136,1798,160,86,950,9,66.12
14,-5,0,14.0,-5.0,0.6431827545166016,329.18839590726765,86,302,-131,1798,160,86,950,9,64.0
14,-6,0,14.0,-6.0,0.6482598781585693,313.95700342562833,86,288,-125,1798,160,86,950,9,64.77
15,-6,0,15.0,-6.0,0.6561198234558105,297.80866340655706,86,273,-119,1798,160,86,950,9,62.44
15,-6,0,15.0,-6.0,0.665949821472168,281.6611439300778,86,258,-113,1798,160,86,950,9,60.09
15,-6,0,15.0,-6.0,0.6722629070281982,265.51459470243816,86,243,-107,1798,160,86,950,9,57.68
16,-6,0,16.0,-6.0,0.6811408996582031,248.4552273549502,86,227,-101,1798,160,86,950,9,55.47
14,-5,0,14.0,-5.0,0.6883039474487305,233.63432966925043,86,213,-96,1798,160,86,950,9,50.43
14,-6,0,14.0,-6.0,0.6963717937469482,218.4055860091495,86,199,-90,1798,160,86,950,9,50.15
13,-5,0,13.0,-5.0,0.7108328342437744,204.50183373260984,86,186,-85,1798,160,86,950,9,45.32
11,-3,0,11.0,-3.0,0.7121098041534424,193.25889371514057,86,175,-82,1798,160,86,950,9,38.98
11,-4,0,11.0,-4.0,0.7233989238739014,181.60396471443016,86,164,-78,1798,160,86,950,9,38.64
10,-3,0,10.0,-3.0,0.7281138896942139,171.29214809792072,86,154,-75,1798,160,86,950,9,34.66
10,-3,0,10.0,-3.0,0.737799882888794,160.99689437998487,86,144,-72,1798,160,86,950,9,33.09
10,-3,0,10.0,-3.0,0.7440879344940186,150.72159765607583,86,134,-69,1798,160,86,950,9,31.49
9,-4,0,9.0,-4.0,0.7521767616271973,140.8900280360537,86,125,-65,1798,160,86,950,9,30.93
9,-2,0,9.0,-2.0,0.760117769241333,132.00378782444085,86,116,-63,1798,160,86,950,9,26.42
6,-3,0,6.0,-3.0,0.7681128978729248,125.29964086141668,86,110,-60,1798,160,86,950,9,24.91
4,-1,0,4.0,-1.0,0.7764427661895752,121.31364309095659,86,106,-59,1798,160,86,950,9,16.51
3,-1,0,3.0,-1.0,0.7858607769012451,118.20744477400736,86,103,-58,1798,160,86,950,9,14.45
3,-1,0,3.0,-1.0,0.7921228408813477,115.10430052782563,86,100,-57,1798,160,86,950,9,14.18
3,-2,0,3.0,-2.0,0.8001008033752441,111.50784725749125,86,97,-55,1798,160,86,950,9,16.43
3,-2,0,3.0,-2.0,0.8080909252166748,107.91200118615167,86,94,-53,1798,160,86,950,9,16.09
4,-2,0,4.0,-2.0,0.8161487579345703,103.4456378974,86,90,-51,1798,160,86,950,9,17.99
5,-2,0,5.0,-2.0,0.8247199058532715,98.11218069128827,86,85,-49,1798,160,86,950,9,17.74
3,-2,0,3.0,-2.0,0.835878849029541,94.51454914456292,86,82,-47,1798,160,86,950,9,15.08
2,-2,0,2.0,-2.0,0.840101957321167,91.7877987534291,86,80,-45,1798,160,86,950,9,11.08
3,-1,0,3.0,-1.0,0.8482987880706787,88.68483523128404,86,77,-44,1798,160,86,950,9,12.15
2,-2,0,2.0,-2.0,0.8592739105224609,85.95929269136641,86,75,-42,1798,160,86,950,9,10.65
2,-2,0,2.0,-2.0,0.8641128540039062,83.24061508662703,86,73,-40,1798,160,86,950,9,10.4
2,-1,0,2.0,-1.0,0.8721587657928467,81.00617260431454,86,71,-39,1798,160,86,950,9,11.65
2,-2,0,2.0,-2.0,0.8800809383392334,78.29431652425353,86,69,-37,1798,160,86,950,9,9.98
3,-1,0,3.0,-1.0,0.8887467384338379,75.17978451685,86,66,-36,1798,160,86,950,9,11.24
1,-2,0,1.0,-2.0,0.8961279392242432,73.35529974037323,86,65,-34,1798,160,86,950,9,6.6
1,-1,0,1.0,-1.0,0.9072568416595459,72.00694410957877,86,64,-33,1798,160,86,950,9,6.38
2,-1,0,2.0,-1.0,0.9121179580688477,69.77105417004964,86,62,-32,1798,160,86,950,9,11.94
1,-1,0,1.0,-1.0,0.9208798408508301,68.42514157822401,86,61,-31,1798,160,86,950,9,6.2
2,-1,0,2.0,-1.0,0.9310379028320312,66.18912297349165,86,59,-30,1798,160,86,950,9,12.09
3,-2,0,3.0,-2.0,0.9361207485198975,62.609903369994115,86,56,-28,1798,160,86,950,9,11.43
1,-1,0,1.0,-1.0,0.944119930267334,61.26989472816156,86,55,-27,1798,160,86,950,9,5.82
2,-2,0,2.0,-2.0,0.9546527862548828,58.60034129593445,86,53,-25,1798,160,86,950,9,8.21
3,-1,0,3.0,-1.0,0.9601988792419434,55.46169849544819,86,50,-24,1798,160,86,950,9,10.1
2,-2,0,2.0,-2.0,0.9683048725128174,52.80151512977634,86,48,-22,1798,160,86,950,9,7.71
2,-1,0,2.0,-1.0,0.9789028167724609,50.566787519082126,86,46,-21,1798,160,86,950,9,9.81
3,-2,0,3.0,-2.0,0.98447585105896,47.01063709417264,86,43,-19,1798,160,86,950,9,9.49
3,-2,0,3.0,-2.0,0.9921207427978516,43.46262762420146,86,40,-17,1798,160,86,950,9,9.02
3,-2,0,3.0,-2.0,1.0010757446289062,39.92492955535426,86,37,-15,1798,160,86,950,9,8.54
4,-2,0,4.0,-2.0,1.0081279277801514,35.4682957019364,86,33,-13,1798,160,86,950,9,10.11
3,-2,0,3.0,-2.0,1.0176928043365479,31.953090617340916,86,30,-11,1798,160,86,950,9,7.49
4,-1,0,4.0,-1.0,1.024202823638916,27.85677655436824,86,26,-10,1798,160,86,950,9,8.47
2,-2,0,2.0,-2.0,1.0321288108825684,25.298221281347036,86,24,-8,1798,160,86,950,9,4.93
1,0,0,1.0,-0.0,1.0427148342132568,24.351591323771842,86,23,-8,1798,160,86,950,9,3.57
2,-1,0,2.0,-1.0,1.0487947463989258,22.135943621178654,86,21,-7,1798,160,86,950,9,6.0
1,-2,0,1.0,-2.0,1.0568459033966064,20.615528128088304,86,20,-5,1798,160,86,950,9,2.53
1,0,0,1.0,-0.0,1.066175937652588,19.6468827043885,86,19,-5,1798,160,86,950,9,3.75
1,-1,0,1.0,-1.0,1.0721278190612793,18.439088914585774,86,18,-4,1798,160,86,950,9,2.77
1,-1,0,1.0,-1.0,1.0801489353179932,17.26267650163207,86,17,-3,1798,160,86,950,9,2.55
1,0,0,1.0,-0.0,1.0880849361419678,16.278820596099706,86,16,-3,1798,160,86,950,9,4.04
2,-1,0,2.0,-1.0,1.096214771270752,14.142135623730951,86,14,-2,1798,160,86,950,9,4.04
1,0,0,1.0,-0.0,1.1043567657470703,13.152946437965905,86,13,-2,1798,160,86,950,9,4.11
2,-1,0,2.0,-1.0,1.112116813659668,11.045361017187261,86,11,-1,1798,160,86,950,9,3.45
1,-1,0,1.0,-1.0,1.1201229095458984,10.0,86,10,0,1798,160,86,950,9,1.49
1,0,0,1.0,-0.0,1.1281158924102783,9.0,86,9,0,1798,160,86,950,9,7.94
3,-1,0,3.0,-1.0,1.136673927307129,6.082762530298219,86,6,1,1798,160,86,950,9,2.77
1,-1,0,1.0,-1.0,1.1440978050231934,5.385164807134504,86,5,2,1798,160,86,950,9,0.01
1,0,0,1.0,-0.0,1.1523687839508057,4.47213595499958,86,4,2,1798,160,86,950,9,1.57
1,-1,0,1.0,-1.0,1.1681287288665771,4.242640687119285,86,3,3,1798,160,86,950,9,-1.07
1,0,0,1.0,-0.0,1.1762397289276123,3.605551275463989,86,2,3,1798,160,86,950,9,0.08
1,-1,0,1.0,-1.0,1.1845948696136475,4.123105625617661,86,1,4,1798,160,86,950,9,0.57
1,-1,0,1.0,-1.0,1.192112922668457,5.0,86,0,5,1798,160,86,950,9,0.32
1,0,0,1.0,-0.0,1.200401782989502,5.0990195135927845,86,-1,5,1798,160,86,950,9,5.2
0,-1,0,-0.0,-1.0,1.2081289291381836,6.082762530298219,86,-1,6,1798,160,86,950,9,2.92
0,0,1,-0.0,-0.0,1.2821147441864014,6.082762530298219,86,-1,6,1798,160,86,950,9,28.72
0,0,0,-0.0,-0.0,0.10068798065185547,1651.66885300898,87,-1339,967,460,1121,1799,154,42,269.96
-2,2,0,-2.0,2.0,0.14766907691955566,1648.8765872556987,87,-1337,965,460,1121,1799,154,42,19.68
-4,3,0,-4.0,3.0,0.15567994117736816,1643.877428520752,87,-1333,962,460,1121,1799,154,42,33.52
-5,2,0,-5.0,2.0,0.16368603706359863,1638.6531054497166,87,-1328,960,460,1121,1799,154,42,31.7
-7,4,0,-7.0,4.0,0.17167997360229492,1630.6369920984866,87,-1321,956,460,1121,1799,154,42,45.67
-6,3,0,-6.0,3.0,0.17969799041748047,1624.0178570446817,87,-1315,953,460,1121,1799,154,42,38.75
-7,4,0,-7.0,4.0,0.18784689903259277,1616.0027846510661,87,-1308,949,460,1121,1799,154,42,45.45
-8,5,0,-8.0,5.0,0.19572091102600098,1606.5914228577221,87,-1300,944,460,1121,1799,154,42,51.77
-8,5,0,-8.0,5.0,0.20366907119750977,1597.1803279529836,87,-1292,939,460,1121,1799,154,42,51.61
-10,6,0,-10.0,6.0,0.2175140380859375,1585.5639375313756,87,-1282,933,460,1121,1799,154,42,59.79
-9,7,0,-9.0,7.0,0.21967697143554688,1574.1680342326863,87,-1273,926,460,1121,1799,154,42,59.86
-11,8,0,-11.0,8.0,0.22953104972839355,1560.5665637838074,87,-1262,918,460,1121,1799,154,42,69.13
-13,9,0,-13.0,9.0,0.23566889762878418,1544.75952821143,87,-1249,909,460,1121,1799,154,42,74.81
-12,8,0,-12.0,8.0,0.24470210075378418,1530.3496332537868,87,-1237,901,460,1121,1799,154,42,69.38
-13,11,0,-13.0,11.0,0.2541680335998535,1513.3657852614483,87,-1224,890,460,1121,1799,154,42,76.51
-15,12,0,-15.0,12.0,0.25972890853881836,1494.1770310107165,87,-1209,878,460,1121,1799,154,42,82.92
-16,13,0,-16.0,13.0,0.2681539058685303,1473.592209534239,87,-1193,865,460,1121,1799,154,42,85.93
-20,15,0,-20.0,15.0,0.27743005752563477,1448.5955267085426,87,-1173,850,460,1121,1799,154,42,97.14
-22,17,0,-22.0,17.0,0.2836930751800537,1420.8061092210999,87,-1151,833,460,1121,1799,154,42,101.7
-26,20,0,-26.0,20.0,0.29169201850891113,1388.0180114105149,87,-1125,813,460,1121,1799,154,42,110.13
-26,19,0,-26.0,19.0,0.2996559143066406,1355.8159904647828,87,-1099,794,460,1121,1799,154,42,108.89
-28,21,0,-28.0,21.0,0.3078300952911377,1320.8217139341707,87,-1071,773,460,1121,1799,154,42,111.46
-31,22,0,-31.0,22.0,0.31566810607910156,1282.8098066354187,87,-1040,751,460,1121,1799,154,42,115.0
-31,21,0,-31.0,21.0,0.3238101005554199,1245.383876561761,87,-1009,730,460,1121,1799,154,42,111.31
-34,22,0,-34.0,22.0,0.33165788650512695,1204.9435671432916,87,-975,708,460,1121,1799,154,42,113.01
-34,23,0,-34.0,23.0,0.34284400939941406,1163.9183820182582,87,-941,685,460,1121,1799,154,42,112.15
-35,24,0,-35.0,24.0,0.3476829528808594,1121.49765938231,87,-906,661,460,1121,1799,154,42,111.83
-36,23,0,-36.0,23.0,0.3556559085845947,1078.86236378882,87,-870,638,460,1121,1799,154,42,108.85
-39,23,0,-39.0,23.0,0.3636620044708252,1033.8210676901492,87,-831,615,460,1121,1799,154,42,108.43
-40,24,0,-40.0,24.0,0.37169599533081055,987.40164067111,87,-791,591,460,1121,1799,154,42,107.14
-41,23,0,-41.0,23.0,0.3796539306640625,940.8102890593831,87,-750,568,460,1121,1799,154,42,103.98
-41,24,0,-41.0,24.0,0.3877389430999756,893.6537360745492,87,-709,544,460,1121,1799,154,42,101.58
-38,21,0,-38.0,21.0,0.39568305015563965,850.7467308194607,87,-671,523,460,1121,1799,154,42,94.15
-35,21,0,-35.0,21.0,0.40504002571105957,810.246875958186,87,-636,502,460,1121,1799,154,42,89.22
-32,20,0,-32.0,20.0,0.4122309684753418,772.7483419587518,87,-604,482,460,1121,1799,154,42,83.62
-27,18,0,-27.0,18.0,0.4196810722351074,740.4221768693858,87,-577,464,460,1121,1799,154,42,75.78
-24,18,0,-24.0,18.0,0.4329650402069092,710.4400045042509,87,-553,446,460,1121,1799,154,42,72.06
-23,16,0,-23.0,16.0,0.4356839656829834,682.4954212300622,87,-530,430,460,1121,1799,154,42,66.86
-21,15,0,-21.0,15.0,0.445267915725708,656.7389131154024,87,-509,415,460,1121,1799,154,42,62.55
-20,14,0,-20.0,14.0,0.4516749382019043,632.3938646128693,87,-489,401,460,1121,1799,154,42,58.96
-19,13,0,-19.0,13.0,0.4604461193084717,609.4620578838358,87,-470,388,460,1121,1799,154,42,55.44
-19,13,0,-19.0,13.0,0.46895909309387207,586.5372963418439,87,-451,375,460,1121,1799,154,42,54.1
-18,11,0,-18.0,11.0,0.47567200660705566,565.6721665417169,87,-433,364,460,1121,1799,154,42,49.36
-18,13,0,-18.0,13.0,0.4836900234222412,543.5310478712324,87,-415,351,460,1121,1799,154,42,50.81
-17,12,0,-17.0,12.0,0.49335503578186035,522.8049349422785,87,-398,339,460,1121,1799,154,42,47.45
-19,13,0,-19.0,13.0,0.4996941089630127,499.9169931098562,87,-379,326,460,1121,1799,154,42,48.74
-20,14,0,-20.0,14.0,0.5079739093780518,475.631159618459,87,-359,312,460,1121,1799,154,42,48.97
-19,14,0,-19.0,14.0,0.5173099040985107,452.1106059362023,87,-340,298,460,1121,1799,154,42,46.81
-20,12,0,-20.0,12.0,0.5236709117889404,429.18061466007526,87,-320,286,460,1121,1799,154,42,43.55
-18,13,0,-18.0,13.0,0.5316710472106934,407.1031810241723,87,-302,273,460,1121,1799,154,42,41.85
-18,11,0,-18.0,11.0,0.5423679351806641,386.39358172723314,87,-284,262,460,1121,1799,154,42,38.16
-18,11,0,-18.0,11.0,0.5476748943328857,365.7280410359588,87,-266,251,460,1121,1799,154,42,36.66
-15,10,0,-15.0,10.0,0.5593979358673096,347.96838936891953,87,-251,241,460,1121,1799,154,42,32.48
-16,11,0,-16.0,11.0,0.5644419193267822,328.8236609491476,87,-235,230,460,1121,1799,154,42,32.82
-14,11,0,-14.0,11.0,0.5718419551849365,311.1301978272119,87,-221,219,460,1121,1799,154,42,30.66
-15,10,0,-15.0,10.0,0.579658031463623,293.4569815151788,87,-206,209,460,1121,1799,154,42,28.71
-13,10,0,-13.0,10.0,0.5878241062164307,277.2183255125822,87,-193,199,460,1121,1799,154,42,26.65
-14,8,0,-14.0,8.0,0.5962939262390137,261.767072031606,87,-179,191,460,1121,1799,154,42,23.88
-12,8,0,-12.0,8.0,0.6036679744720459,247.7458375028731,87,-167,183,460,1121,1799,154,42,21.85
-10,8,0,-10.0,8.0,0.6117269992828369,235.10423220350586,87,-157,175,460,1121,1799,154,42,20.24
-10,8,0,-10.0,8.0,0.6197109222412109,222.48145990171855,87,-147,167,460,1121,1799,154,42,19.42
-8,6,0,-8.0,6.0,0.6276600360870361,212.7016690108472,87,-139,161,460,1121,1799,154,42,15.71
-6,6,0,-6.0,6.0,0.636030912399292,204.24005483743878,87,-133,155,460,1121,1799,154,42,15.27
-6,6,0,-6.0,6.0,0.6437020301818848,195.78048932414077,87,-127,149,460,1121,1799,154,42,14.85
-5,4,0,-5.0,4.0,0.6516540050506592,189.49670181826386,87,-122,145,460,1121,1799,154,42,11.07
-4,4,0,-4.0,4.0,0.6596770286560059,183.86136081297778,87,-118,141,460,1121,1799,154,42,11.2
-4,4,0,-4.0,4.0,0.6677110195159912,178.22738285684386,87,-114,137,460,1121,1799,154,42,10.99
-4,3,0,-4.0,3.0,0.6756649017333984,173.3666634621547,87,-110,134,460,1121,1799,154,42,8.72
-4,4,0,-4.0,4.0,0.6837599277496338,167.73789077009405,87,-106,130,460,1121,1799,154,42,10.51
-4,5,0,-4.0,5.0,0.6916570663452148,161.33505508723144,87,-102,125,460,1121,1799,154,42,13.41
-5,4,0,-5.0,4.0,0.6996679306030273,155.08062419270823,87,-97,121,460,1121,1799,154,42,9.66
-5,5,0,-5.0,5.0,0.7076890468597412,148.05404418657398,87,-92,116,460,1121,1799,154,42,10.97
-5,6,0,-5.0,6.0,0.7156751155853271,140.24621207005913,87,-87,110,460,1121,1799,154,42,13.07
-5,5,0,-5.0,5.0,0.7273139953613281,133.22537295875736,87,-82,105,460,1121,1799,154,42,10.27
-5,6,0,-5.0,6.0,0.7316980361938477,125.41929676090518,87,-77,99,460,1121,1799,154,42,12.1
-4,5,0,-4.0,5.0,0.7396590709686279,119.01680553602503,87,-73,94,460,1121,1799,154,42,11.55
-3,5,0,-3.0,5.0,0.7476739883422852,113.22985472038724,87,-70,89,460,1121,1799,154,42,8.47
-3,4,0,-3.0,4.0,0.7556500434875488,108.23123393919151,87,-67,85,460,1121,1799,154,42,9.63
-3,4,0,-3.0,4.0,0.7637429237365723,103.23274674249446,87,-64,81,460,1121,1799,154,42,9.42
-3,5,0,-3.0,5.0,0.7726190090179443,97.45255255764212,87,-61,76,460,1121,1799,154,42,7.76
-4,4,0,-4.0,4.0,0.7818629741668701,91.8313671900838,87,-57,72,460,1121,1799,154,42,7.65
-4,5,0,-4.0,5.0,0.7877199649810791,85.42833253669417,87,-53,67,460,1121,1799,154,42,10.82
-4,4,0,-4.0,4.0,0.7960538864135742,79.81227975693966,87,-49,63,460,1121,1799,154,42,7.07
-4,5,0,-4.0,5.0,0.8103640079498291,73.40980860893181,87,-45,58,460,1121,1799,154,42,9.64
-4,4,0,-4.0,4.0,0.8119440078735352,67.80117993073571,87,-41,54,460,1121,1799,154,42,6.45
-5,4,0,-5.0,4.0,0.822180986404419,61.61168720299745,87,-36,50,460,1121,1799,154,42,5.47
-4,4,0,-4.0,4.0,0.8276989459991455,56.0357029044876,87,-32,46,460,1121,1799,154,42,5.55
-4,3,0,-4.0,3.0,0.835874080657959,51.31276644267,87,-28,43,460,1121,1799,154,42,4.05
-3,4,0,-3.0,4.0,0.8473179340362549,46.32493928760188,87,-25,39,460,1121,1799,154,42,6.07
-5,4,0,-5.0,4.0,0.8516860008239746,40.311288741492746,87,-20,35,460,1121,1799,154,42,3.85
-3,4,0,-3.0,4.0,0.8596949577331543,35.35533905932738,87,-17,31,460,1121,1799,154,42,4.67
-3,3,0,-3.0,3.0,0.8676741123199463,31.304951684997057,87,-14,28,460,1121,1799,154,42,3.09
-2,2,0,-2.0,2.0,0.8756859302520752,28.635642126552707,87,-12,26,460,1121,1799,154,42,2.55
-3,4,0,-3.0,4.0,0.8836500644683838,23.769728648009426,87,-9,22,460,1121,1799,154,42,3.19
-2,4,0,-2.0,4.0,0.891793966293335,19.313207915827967,87,-7,18,460,1121,1799,154,42,4.25
-1,2,0,-1.0,2.0,0.8999719619750977,17.08800749063506,87,-6,16,460,1121,1799,154,42,3.69
-1,1,0,-1.0,1.0,0.9076550006866455,15.811388300841896,87,-5,15,460,1121,1799,154,42,1.54
-1,1,0,-1.0,1.0,0.9156811237335205,14.560219778561036,87,-4,14,460,1121,1799,154,42,1.35
0,1,0,-0.0,1.0,0.9482929706573486,13.601470508735444,87,-4,13,460,1121,1799,154,42,2.13
-1,0,0,-1.0,-0.0,0.9716649055480957,13.341664064126334,87,-3,13,460,1121,1799,154,42,-0.11
0,0,1,-0.0,-0.0,0.9786899089813232,13.341664064126334,87,-3,13,460,1121,1799,154,42,30.88
0,0,0,-0.0,-0.0,0.05731606483459473,1522.7796951627638,88,1163,-983,1626,125,463,1108,4,258.78
2,0,0,2.0,-0.0,0.1163179874420166,1521.2527732102906,88,1161,-983,1626,125,463,1108,4,70.88
2,-2,0,2.0,-2.0,0.1251659393310547,1518.4340617886573,88,1159,-981,1626,125,463,1108,4,108.17
4,-2,0,4.0,-2.0,0.1354808807373047,1514.0891651418683,88,1155,-979,1626,125,463,1108,4,133.6
4,-2,0,4.0,-2.0,0.14033794403076172,1509.7450115830818,88,1151,-977,1626,125,463,1108,4,133.38
6,-3,0,6.0,-3.0,0.1485588550567627,1503.2301886271443,88,1145,-974,1626,125,463,1108,4,157.83
8,-3,0,8.0,-3.0,0.1608588695526123,1495.1956393729886,88,1137,-971,1626,125,463,1108,4,168.86
9,-3,0,9.0,-3.0,0.16455698013305664,1486.4077502489013,88,1128,-968,1626,125,463,1108,4,173.05
12,-4,0,12.0,-4.0,0.17248201370239258,1474.7040381039174,88,1116,-964,1626,125,463,1108,4,186.68
13,-4,0,13.0,-4.0,0.1803760528564453,1462.261604501739,88,1103,-960,1626,125,463,1108,4,188.55
13,-5,0,13.0,-5.0,0.18831491470336914,1449.18080307462,88,1090,-955,1626,125,463,1108,4,190.1
15,-6,0,15.0,-6.0,0.19708585739135742,1433.954671529055,88,1075,-949,1626,125,463,1108,4,195.42
16,-8,0,16.0,-8.0,0.2043449878692627,1416.672862731548,88,1059,-941,1626,125,463,1108,4,199.37
18,-8,0,18.0,-8.0,0.21233105659484863,1397.9163065076536,88,1041,-933,1626,125,463,1108,4,200.61
17,-8,0,17.0,-8.0,0.22142601013183594,1379.9278966670686,88,1024,-925,1626,125,463,1108,4,197.82
18,-7,0,18.0,-7.0,0.22831296920776367,1361.8957375658388,88,1006,-918,1626,125,463,1108,4,196.19
19,-9,0,19.0,-9.0,0.2363288402557373,1341.8084811179276,88,987,-909,1626,125,463,1108,4,198.5
18,-11,0,18.0,-11.0,0.25112390518188477,1321.1226286760816,88,969,-898,1626,125,463,1108,4,198.32
18,-12,0,18.0,-12.0,0.2523000240325928,1299.7680562315725,88,951,-886,1626,125,463,1108,4,197.81
19,-14,0,19.0,-14.0,0.26312994956970215,1276.3259771704093,88,932,-872,1626,125,463,1108,4,199.0
20,-17,0,20.0,-17.0,0.26834702491760254,1250.1075953692946,88,912,-855,1626,125,463,1108,4,200.8
19,-19,0,19.0,-19.0,0.2763500213623047,1223.2518138143103,88,893,-836,1626,125,463,1108,4,199.43
21,-18,0,21.0,-18.0,0.2842869758605957,1195.6203410782205,88,872,-818,1626,125,463,1108,4,197.3
20,-18,0,20.0,-18.0,0.29231786727905273,1168.7189568069819,88,852,-800,1626,125,463,1108,4,194.92
21,-18,0,21.0,-18.0,0.3009679317474365,1141.0893917656058,88,831,-782,1626,125,463,1108,4,192.2
21,-16,0,21.0,-16.0,0.31467485427856445,1114.8345168678622,88,810,-766,1626,125,463,1108,4,187.51
22,-18,0,22.0,-18.0,0.31655287742614746,1086.4842382657928,88,788,-748,1626,125,463,1108,4,187.03
21,-18,0,21.0,-18.0,0.3242819309234619,1058.862125113558,88,767,-730,1626,125,463,1108,4,184.14
23,-19,0,23.0,-19.0,0.3326759338378906,1029.1049509160862,88,744,-711,1626,125,463,1108,4,182.39
27,-20,0,27.0,-20.0,0.34030604362487793,995.7760792467351,88,717,-691,1626,125,463,1108,4,180.46
28,-19,0,28.0,-19.0,0.3482949733734131,962.4474011601881,88,689,-672,1626,125,463,1108,4,176.51
33,-24,0,33.0,-24.0,0.35633397102355957,922.0845948176338,88,656,-648,1626,125,463,1108,4,175.5
37,-27,0,37.0,-27.0,0.3643970489501953,876.8135491653856,88,619,-621,1626,125,463,1108,4,171.9
38,-25,0,38.0,-25.0,0.3723020553588867,832.3322653844436,88,581,-596,1626,125,463,1108,4,165.96
36,-24,0,36.0,-24.0,0.38036584854125977,790.0689843298495,88,545,-572,1626,125,463,1108,4,160.11
29,-20,0,29.0,-20.0,0.38829588890075684,755.618951588696,88,516,-552,1626,125,463,1108,4,152.97
23,-16,0,23.0,-16.0,0.3963148593902588,728.2478973536415,88,493,-536,1626,125,463,1108,4,145.73
19,-15,0,19.0,-15.0,0.40432095527648926,704.3557339867406,88,474,-521,1626,125,463,1108,4,140.63
14,-15,0,14.0,-15.0,0.4131450653076172,683.8391623766513,88,460,-506,1626,125,463,1108,4,137.74
14,-15,0,14.0,-15.0,0.42031002044677734,663.322696732141,88,446,-491,1626,125,463,1108,4,135.18
13,-16,0,13.0,-16.0,0.42833900451660156,642.7394495439034,88,433,-475,1626,125,463,1108,4,131.29
12,-17,0,12.0,-17.0,0.4368929862976074,622.0972592770362,88,421,-458,1626,125,463,1108,4,127.68
12,-17,0,12.0,-17.0,0.4443390369415283,601.4665410477959,88,409,-441,1626,125,463,1108,4,124.94
12,-18,0,12.0,-18.0,0.45230603218078613,580.1189533190585,88,397,-423,1626,125,463,1108,4,122.45
12,-16,0,12.0,-16.0,0.46129393577575684,560.2445894428611,88,385,-407,1626,125,463,1108,4,118.91
11,-16,0,11.0,-16.0,0.4683229923248291,541.0702357365446,88,374,-391,1626,125,463,1108,4,115.15
11,-14,0,11.0,-14.0,0.47632598876953125,523.3526535711843,88,363,-377,1626,125,463,1108,4,111.8
10,-13,0,10.0,-13.0,0.4842839241027832,507.05522381689354,88,353,-364,1626,125,463,1108,4,107.71
11,-12,0,11.0,-12.0,0.49228906631469727,490.7830477919954,88,342,-352,1626,125,463,1108,4,107.01
11,-12,0,11.0,-12.0,0.5021240711212158,474.51132757817277,88,331,-340,1626,125,463,1108,4,104.68
13,-13,0,13.0,-13.0,0.5083160400390625,456.12827143249956,88,318,-327,1626,125,463,1108,4,104.94
13,-14,0,13.0,-14.0,0.5166828632354736,437.0286031829038,88,305,-313,1626,125,463,1108,4,102.25
14,-13,0,14.0,-13.0,0.5263199806213379,417.9485614283174,88,291,-300,1626,125,463,1108,4,98.47
13,-14,0,13.0,-14.0,0.5323779582977295,398.84834210511644,88,278,-286,1626,125,463,1108,4,96.35
13,-12,0,13.0,-12.0,0.5409219264984131,381.1836827567518,88,265,-274,1626,125,463,1108,4,91.34
11,-10,0,11.0,-10.0,0.5483050346374512,366.3495598468763,88,254,-264,1626,125,463,1108,4,85.91
10,-11,0,10.0,-11.0,0.5563399791717529,351.4896869041822,88,244,-253,1626,125,463,1108,4,84.49
12,-12,0,12.0,-12.0,0.5643348693847656,334.5220471060166,88,232,-241,1626,125,463,1108,4,84.2
12,-11,0,12.0,-11.0,0.5730540752410889,318.27660925679095,88,220,-230,1626,125,463,1108,4,79.49
12,-12,0,12.0,-12.0,0.5803189277648926,301.3104711091203,88,208,-218,1626,125,463,1108,4,78.3
10,-11,0,10.0,-11.0,0.5883228778839111,286.44894833111186,88,198,-207,1626,125,463,1108,4,73.77
10,-11,0,10.0,-11.0,0.5976929664611816,271.5879231482873,88,188,-196,1626,125,463,1108,4,71.1
8,-9,0,8.0,-9.0,0.6043999195098877,259.55538907909425,88,180,-187,1626,125,463,1108,4,65.55
6,-7,0,6.0,-7.0,0.6125180721282959,250.3517525403008,88,174,-180,1626,125,463,1108,4,59.33
6,-8,0,6.0,-8.0,0.6203360557556152,240.4329428343795,88,168,-172,1626,125,463,1108,4,57.91
4,-6,0,4.0,-6.0,0.6283290386199951,233.34952324785237,88,164,-166,1626,125,463,1108,4,50.77
5,-5,0,5.0,-5.0,0.6363298892974854,226.2785893539201,88,159,-161,1626,125,463,1108,4,53.03
5,-5,0,5.0,-5.0,0.6456120014190674,219.20766409959302,88,154,-156,1626,125,463,1108,4,51.92
5,-6,0,5.0,-6.0,0.6523120403289795,211.42611002428248,88,149,-150,1626,125,463,1108,4,49.87
6,-6,0,6.0,-6.0,0.6607718467712402,202.94087809014724,88,143,-144,1626,125,463,1108,4,52.37
6,-5,0,6.0,-5.0,0.6696739196777344,195.1665955024066,88,137,-139,1626,125,463,1108,4,47.04
6,-6,0,6.0,-6.0,0.6765179634094238,186.6815470259447,88,131,-133,1626,125,463,1108,4,49.27
7,-6,0,7.0,-6.0,0.6842999458312988,177.49647883831386,88,124,-127,1626,125,463,1108,4,46.35
6,-4,0,6.0,-4.0,0.6923260688781738,170.4494059831245,88,118,-123,1626,125,463,1108,4,40.47
6,-4,0,6.0,-4.0,0.7003059387207031,163.41664541900252,88,112,-119,1626,125,463,1108,4,39.2
5,-5,0,5.0,-5.0,0.7083089351654053,156.348968656656,88,107,-114,1626,125,463,1108,4,40.51
5,-4,0,5.0,-4.0,0.7163209915161133,150.0133327407934,88,102,-110,1626,125,463,1108,4,36.2
5,-4,0,5.0,-4.0,0.7242980003356934,143.68368035375485,88,97,-106,1626,125,463,1108,4,35.07
5,-4,0,5.0,-4.0,0.7323310375213623,137.3608386695422,88,92,-102,1626,125,463,1108,4,33.93
4,-3,0,4.0,-3.0,0.7404060363769531,132.45754036671525,88,88,-99,1626,125,463,1108,4,29.84
3,-2,0,3.0,-2.0,0.7495298385620117,128.9728653632228,88,85,-97,1626,125,463,1108,4,24.91
3,-3,0,3.0,-3.0,0.7564558982849121,124.73972903610141,88,82,-94,1626,125,463,1108,4,28.36
2,-1,0,2.0,-1.0,0.7643170356750488,122.67436570041843,88,80,-93,1626,125,463,1108,4,17.78
2,-3,0,2.0,-3.0,0.772291898727417,119.09659944767525,88,78,-90,1626,125,463,1108,4,24.89
3,-2,0,3.0,-2.0,0.7803199291229248,115.62439189029277,88,75,-88,1626,125,463,1108,4,23.03
2,-2,0,2.0,-2.0,0.7883338928222656,112.80514172678478,88,73,-86,1626,125,463,1108,4,22.07
3,-3,0,3.0,-3.0,0.8033120632171631,108.57716150277645,88,70,-83,1626,125,463,1108,4,25.7
2,-2,0,2.0,-2.0,0.8043980598449707,105.75916035975324,88,68,-81,1626,125,463,1108,4,21.14
3,-3,0,3.0,-3.0,0.8122990131378174,101.53324578678651,88,65,-78,1626,125,463,1108,4,24.56
3,-3,0,3.0,-3.0,0.8205618858337402,97.30878685915265,88,62,-75,1626,125,463,1108,4,23.86
3,-3,0,3.0,-3.0,0.8285388946533203,93.08598175880189,88,59,-72,1626,125,463,1108,4,23.15
2,-2,0,2.0,-2.0,0.8363449573516846,90.27181176868004,88,57,-70,1626,125,463,1108,4,19.04
2,-3,0,2.0,-3.0,0.8445229530334473,86.68333173107735,88,55,-67,1626,125,463,1108,4,20.74
1,-2,0,1.0,-2.0,0.8522799015045166,84.50443775329198,88,54,-65,1626,125,463,1108,4,15.16
2,-2,0,2.0,-2.0,0.8603370189666748,81.68843247363729,88,52,-63,1626,125,463,1108,4,18.06
1,-2,0,1.0,-2.0,0.8685190677642822,79.51100552753688,88,51,-61,1626,125,463,1108,4,14.6
2,-3,0,2.0,-3.0,0.8781740665435791,75.92759709091287,88,49,-58,1626,125,463,1108,4,19.01
2,-1,0,2.0,-1.0,0.8844170570373535,73.87827826905551,88,47,-57,1626,125,463,1108,4,12.74
2,-2,0,2.0,-2.0,0.8923220634460449,71.06335201775947,88,45,-55,1626,125,463,1108,4,16.66
2,-3,0,2.0,-3.0,0.9021439552307129,67.47592163134935,88,43,-52,1626,125,463,1108,4,17.9
3,-2,0,3.0,-2.0,0.9084899425506592,64.03124237432849,88,40,-50,1626,125,463,1108,4,15.62
2,-2,0,2.0,-2.0,0.9163789749145508,61.220911460055866,88,38,-48,1626,125,463,1108,4,15.18
2,-2,0,2.0,-2.0,0.9256229400634766,58.412327466040935,88,36,-46,1626,125,463,1108,4,14.75
1,-2,0,1.0,-2.0,0.9323248863220215,56.22277118748239,88,35,-44,1626,125,463,1108,4,12.22
1,-1,0,1.0,-1.0,0.9410600662231445,54.817880294662984,88,34,-43,1626,125,463,1108,4,10.44
1,-1,0,1.0,-1.0,0.9494669437408447,53.41348144429457,88,33,-42,1626,125,463,1108,4,10.28
1,-2,0,1.0,-2.0,0.9563748836517334,51.22499389946279,88,32,-40,1626,125,463,1108,4,11.63
1,-1,0,1.0,-1.0,0.9643280506134033,49.8196748283246,88,31,-39,1626,125,463,1108,4,10.05
1,-2,0,1.0,-2.0,0.9782099723815918,47.634021455258214,88,30,-37,1626,125,463,1108,4,11.17
1,-2,0,1.0,-2.0,0.9803168773651123,45.45327270945405,88,29,-35,1626,125,463,1108,4,10.84
2,-1,0,2.0,-1.0,0.9941020011901855,43.41658669218482,88,27,-34,1626,125,463,1108,4,9.35
1,-2,0,1.0,-2.0,0.9963510036468506,41.23105625617661,88,26,-32,1626,125,463,1108,4,10.41
3,-2,0,3.0,-2.0,1.0042948722839355,37.8021163428716,88,23,-30,1626,125,463,1108,4,11.55
2,-2,0,2.0,-2.0,1.0125188827514648,35.0,88,21,-28,1626,125,463,1108,4,11.36
2,-3,0,2.0,-3.0,1.0203070640563965,31.400636936215164,88,19,-25,1626,125,463,1108,4,13.02
3,-3,0,3.0,-3.0,1.028393030166626,27.202941017470888,88,16,-22,1626,125,463,1108,4,11.71
2,-2,0,2.0,-2.0,1.0407068729400635,24.413111231467404,88,14,-20,1626,125,463,1108,4,9.53
2,-1,0,2.0,-1.0,1.0444509983062744,22.47220505424423,88,12,-19,1626,125,463,1108,4,6.38
1,-2,0,1.0,-2.0,1.0523040294647217,20.248456731316587,88,11,-17,1626,125,463,1108,4,8.78
1,-1,0,1.0,-1.0,1.0603060722351074,18.867962264113206,88,10,-16,1626,125,463,1108,4,6.26
0,-1,0,-0.0,-1.0,1.0684239864349365,18.027756377319946,88,10,-15,1626,125,463,1108,4,3.72
1,0,0,1.0,-0.0,1.0763108730316162,17.4928556845359,88,9,-15,1626,125,463,1108,4,2.07
1,-2,0,1.0,-2.0,1.0843029022216797,15.264337522473747,88,8,-13,1626,125,463,1108,4,8.38
2,0,0,2.0,-0.0,1.0923240184783936,14.317821063276353,88,6,-13,1626,125,463,1108,4,2.43
1,-2,0,1.0,-2.0,1.100489854812622,12.083045973594572,88,5,-11,1626,125,463,1108,4,9.0
1,0,0,1.0,-0.0,1.108293056488037,11.704699910719626,88,4,-11,1626,125,463,1108,4,1.04
1,-1,0,1.0,-1.0,1.1163349151611328,10.44030650891055,88,3,-10,1626,125,463,1108,4,3.98
1,-1,0,1.0,-1.0,1.1242918968200684,9.219544457292887,88,2,-9,1626,125,463,1108,4,3.53
1,-1,0,1.0,-1.0,1.1323158740997314,8.06225774829855,88,1,-8,1626,125,463,1108,4,3.03
1,-1,0,1.0,-1.0,1.1413869857788086,7.0,88,0,-7,1626,125,463,1108,4,2.45
0,-1,0,-0.0,-1.0,1.1483259201049805,6.0,88,0,-6,1626,125,463,1108,4,9.05
1,0,0,1.0,-0.0,1.1563210487365723,6.082762530298219,88,-1,-6,1626,125,463,1108,4,8.18
1,-1,0,1.0,-1.0,1.1646208763122559,5.385164807134504,88,-2,-5,1626,125,463,1108,4,0.92
0,-1,0,-0.0,-1.0,1.1722919940948486,4.47213595499958,88,-2,-4,1626,125,463,1108,4,2.66
1,0,0,1.0,-0.0,1.1883299350738525,5.0,88,-3,-4,1626,125,463,1108,4,3.03
0,-1,0,-0.0,-1.0,1.2123639583587646,4.242640687119285,88,-3,-3,1626,125,463,1108,4,1.58
1,-1,0,1.0,-1.0,1.2203140258789062,4.47213595499958,88,-4,-2,1626,125,463,1108,4,4.58
0,-1,0,-0.0,-1.0,1.236598014831543,4.123105625617661,88,-4,-1,1626,125,463,1108,4,0.0
1,-1,0,1.0,-1.0,1.244339942932129,5.0,88,-5,0,1626,125,463,1108,4,1.6
1,-1,0,1.0,-1.0,1.2541840076446533,6.082762530298219,88,-6,1,1626,125,463,1108,4,1.77
0,0,1,-0.0,-0.0,1.337312936782837,6.082762530298219,88,-6,1,1626,125,463,1108,4,18.72
0,0,0,-0.0,-0.0,1.4463648796081543,6.082762530298219,88,-6,1,1626,125,463,1108,4,18.72
-1,0,0,-1.0,-0.0,1.4922969341278076,5.0990195135927845,88,-5,1,1626,125,463,1108,4,4.11
-1,0,0,-1.0,-0.0,1.5083370208740234,4.123105625617661,88,-4,1,1626,125,463,1108,4,3.59
-1,0,0,-1.0,-0.0,1.5173358917236328,3.1622776601683795,88,-3,1,1626,125,463,1108,4,2.93
-1,0,0,-1.0,-0.0,1.532296895980835,2.23606797749979,88,-2,1,1626,125,463,1108,4,2.05
-1,0,0,-1.0,-0.0,1.5404210090637207,1.4142135623730951,88,-1,1,1626,125,463,1108,4,0.74
-1,0,0,-1.0,-0.0,1.5483498573303223,1.0,88,0,1,1626,125,463,1108,4,-1.32
-1,0,0,-1.0,-0.0,1.5643658638000488,1.4142135623730951,88,1,1,1626,125,463,1108,4,1.59
-1,0,0,-1.0,-0.0,1.5883219242095947,2.23606797749979,88,2,1,1626,125,463,1108,4,1.35
0,0,1,-0.0,-0.0,1.6453239917755127,2.23606797749979,88,2,1,1626,125,463,1108,4,27.58
0,0,0,-0.0,-0.0,0.08275127410888672,909.8796623729976,89,-909,40,715,164,1624,124,24,194.79
-1,2,0,-1.0,2.0,0.15374016761779785,908.7948063231876,89,-908,38,715,164,1624,124,24,8.79
-2,2,0,-2.0,2.0,0.1625971794128418,906.7149496947759,89,-906,36,715,164,1624,124,24,16.13
-1,3,0,-1.0,3.0,0.16971421241760254,905.6014575960002,89,-905,33,715,164,1624,124,24,8.79
-2,3,0,-2.0,3.0,0.17773222923278809,903.4982014370588,89,-903,30,715,164,1624,124,24,15.9
-2,4,0,-2.0,4.0,0.1862802505493164,901.3750606711948,89,-901,26,715,164,1624,124,24,15.83
-2,3,0,-2.0,3.0,0.19372820854187012,899.2941676670654,89,-899,23,715,164,1624,124,24,15.7
-3,4,0,-3.0,4.0,0.2042992115020752,896.2014282514841,89,-896,19,715,164,1624,124,24,22.14
-4,5,0,-4.0,5.0,0.21061110496520996,892.1098587057538,89,-892,14,715,164,1624,124,24,27.96
-5,5,0,-5.0,5.0,0.21779322624206543,887.0456583513613,89,-887,9,715,164,1624,124,24,33.34
-6,5,0,-6.0,5.0,0.2257990837097168,881.0090805434414,89,-881,4,715,164,1624,124,24,38.29
-9,5,0,-9.0,5.0,0.233734130859375,872.0005733943069,89,-872,-1,715,164,1624,124,24,51.65
-9,5,0,-9.0,5.0,0.24179410934448242,863.0208572218866,89,-863,-6,715,164,1624,124,24,51.2
-10,5,0,-10.0,5.0,0.2523231506347656,853.070923194549,89,-853,-11,715,164,1624,124,24,54.71
-9,4,0,-9.0,4.0,0.2581362724304199,844.133283314904,89,-844,-15,715,164,1624,124,24,50.61
-10,4,0,-10.0,4.0,0.26869821548461914,834.2163987839126,89,-834,-19,715,164,1624,124,24,54.11
-10,4,0,-10.0,4.0,0.27399611473083496,824.3209326469879,89,-824,-23,715,164,1624,124,24,53.63
-10,3,0,-10.0,3.0,0.2823772430419922,814.4151275608773,89,-814,-26,715,164,1624,124,24,53.61
-9,3,0,-9.0,3.0,0.2897062301635742,805.5221908799285,89,-805,-29,715,164,1624,124,24,49.33
-8,3,0,-8.0,3.0,0.29836106300354004,797.6421503406149,89,-797,-32,715,164,1624,124,24,44.88
-9,2,0,-9.0,2.0,0.3057372570037842,788.7331614684398,89,-788,-34,715,164,1624,124,24,49.21
-10,2,0,-10.0,2.0,0.3190422058105469,778.8324595187337,89,-778,-36,715,164,1624,124,24,52.58
-14,2,0,-14.0,2.0,0.3217310905456543,764.9444424270301,89,-764,-38,715,164,1624,124,24,64.91
-15,2,0,-15.0,2.0,0.3297240734100342,750.0673303110862,89,-749,-40,715,164,1624,124,24,66.88
-17,1,0,-17.0,1.0,0.3377420902252197,733.1473248945263,89,-732,-41,715,164,1624,124,24,71.66
-18,1,0,-18.0,1.0,0.3467721939086914,715.2342273689088,89,-714,-42,715,164,1624,124,24,72.85
-21,1,0,-21.0,1.0,0.35598111152648926,694.3327732434931,89,-693,-43,715,164,1624,124,24,77.65
-24,1,0,-24.0,1.0,0.36204028129577637,670.4453743594627,89,-669,-44,715,164,1624,124,24,81.2
-25,1,0,-25.0,1.0,0.3697211742401123,645.5702905183912,89,-644,-45,715,164,1624,124,24,80.83
-26,0,0,-26.0,-0.0,0.3831140995025635,619.636183578719,89,-618,-45,715,164,1624,124,24,80.86
-25,2,0,-25.0,2.0,0.385728120803833,594.859647311868,89,-593,-47,715,164,1624,124,24,76.2
-22,1,0,-22.0,1.0,0.3958301544189453,573.013961435496,89,-571,-48,715,164,1624,124,24,70.31
-20,1,0,-20.0,1.0,0.4017190933227539,553.1744751884346,89,-551,-49,715,164,1624,124,24,65.41
-19,1,0,-19.0,1.0,0.4097292423248291,534.3444581915302,89,-532,-50,715,164,1624,124,24,62.2
-16,0,0,-16.0,-0.0,0.41772007942199707,518.4168207147603,89,-516,-50,715,164,1624,124,24,56.23
-14,0,0,-14.0,-0.0,0.42572522163391113,504.4838946884231,89,-502,-50,715,164,1624,124,24,51.18
-14,1,0,-14.0,1.0,0.4345071315765381,490.657721838758,89,-488,-51,715,164,1624,124,24,49.33
-12,0,0,-12.0,-0.0,0.44365906715393066,478.72434657117657,89,-476,-51,715,164,1624,124,24,45.07
-10,0,0,-10.0,-0.0,0.4497382640838623,468.7824655423878,89,-466,-51,715,164,1624,124,24,39.67
-12,0,0,-12.0,-0.0,0.45787811279296875,456.8555570418291,89,-454,-51,715,164,1624,124,24,43.69
-12,0,0,-12.0,-0.0,0.4657251834869385,444.9325791622816,89,-442,-51,715,164,1624,124,24,42.93
-13,-1,0,-13.0,-1.0,0.4737722873687744,431.90392450173454,89,-429,-50,715,164,1624,124,24,45.71
-13,-3,0,-13.0,-3.0,0.481708288192749,418.6466290321708,89,-416,-47,715,164,1624,124,24,44.01
-13,-3,0,-13.0,-3.0,0.4900400638580322,405.3948692324559,89,-403,-44,715,164,1624,124,24,43.06
-12,-3,0,-12.0,-3.0,0.4985060691833496,393.14373961694974,89,-391,-41,715,164,1624,124,24,40.06
-14,-2,0,-14.0,-2.0,0.50862717628479,379.0118731649445,89,-377,-39,715,164,1624,124,24,44.12
-15,-3,0,-15.0,-3.0,0.5137331485748291,363.78565117387467,89,-362,-36,715,164,1624,124,24,43.69
-18,-3,0,-18.0,-3.0,0.5227882862091064,345.5792239125495,89,-344,-33,715,164,1624,124,24,46.93
-20,-2,0,-20.0,-2.0,0.5328381061553955,325.4796460610095,89,-324,-31,715,164,1624,124,24,49.77
-21,-3,0,-21.0,-3.0,0.5377562046051025,304.2909791630373,89,-303,-28,715,164,1624,124,24,46.91
-21,-1,0,-21.0,-1.0,0.5458600521087646,283.28960446864266,89,-282,-27,715,164,1624,124,24,44.6
-22,-2,0,-22.0,-2.0,0.5570361614227295,261.1991577321795,89,-260,-25,715,164,1624,124,24,45.17
-20,-2,0,-20.0,-2.0,0.5617461204528809,241.09956449566639,89,-240,-23,715,164,1624,124,24,41.24
-19,-1,0,-19.0,-1.0,0.570061206817627,222.0923231451281,89,-221,-22,715,164,1624,124,24,36.19
-15,0,0,-15.0,-0.0,0.5814721584320068,207.17142660125697,89,-206,-22,715,164,1624,124,24,29.6
-15,-1,0,-15.0,-1.0,0.5857622623443604,192.15098230297966,89,-191,-21,715,164,1624,124,24,29.37
-11,0,0,-11.0,-0.0,0.593724250793457,181.22085972646747,89,-180,-21,715,164,1624,124,24,22.68
-9,0,0,-9.0,-0.0,0.601776123046875,172.28464818433474,89,-171,-21,715,164,1624,124,24,19.46
-6,0,0,-6.0,-0.0,0.6099851131439209,166.33099530754933,89,-165,-21,715,164,1624,124,24,14.88
-5,0,0,-5.0,-0.0,0.6177451610565186,161.37224048763778,89,-160,-21,715,164,1624,124,24,13.05
-5,0,0,-5.0,-0.0,0.6257562637329102,156.41611170208776,89,-155,-21,715,164,1624,124,24,12.77
-2,0,0,-2.0,-0.0,0.6337242126464844,154.434452114805,89,-153,-21,715,164,1624,124,24,7.59
-3,-1,0,-3.0,-1.0,0.6417481899261475,151.32745950421557,89,-150,-20,715,164,1624,124,24,9.11
-2,0,0,-2.0,-0.0,0.6568222045898438,149.34523762075577,89,-148,-20,715,164,1624,124,24,7.5
-3,0,0,-3.0,-0.0,0.6578061580657959,146.37281168304446,89,-145,-20,715,164,1624,124,24,9.15
-3,0,0,-3.0,-0.0,0.6695842742919922,143.4015341619468,89,-142,-20,715,164,1624,124,24,9.03
-3,0,0,-3.0,-0.0,0.673795223236084,140.4314779527724,89,-139,-20,715,164,1624,124,24,8.9
-4,0,0,-4.0,-0.0,0.681779146194458,136.4734406395618,89,-135,-20,715,164,1624,124,24,10.26
-5,0,0,-5.0,-0.0,0.6897492408752441,131.52946437965906,89,-130,-20,715,164,1624,124,24,11.39
-6,1,0,-6.0,1.0,0.6977391242980957,125.76565508913791,89,-124,-21,715,164,1624,124,24,11.06
-6,1,0,-6.0,1.0,0.7062282562255859,120.03332870498926,89,-118,-22,715,164,1624,124,24,10.62
-7,0,0,-7.0,-0.0,0.7137322425842285,113.1591799192624,89,-111,-22,715,164,1624,124,24,12.28
-7,1,0,-7.0,1.0,0.7241861820220947,106.51291001564083,89,-104,-23,715,164,1624,124,24,10.74
-5,0,0,-5.0,-0.0,0.7298691272735596,101.6366075781753,89,-99,-23,715,164,1624,124,24,9.24
-5,0,0,-5.0,-0.0,0.737741231918335,96.77293009927931,89,-94,-23,715,164,1624,124,24,8.9
-3,0,0,-3.0,-0.0,0.7457361221313477,93.86160024205851,89,-91,-23,715,164,1624,124,24,6.55
-5,0,0,-5.0,-0.0,0.7540051937103271,89.02246907382428,89,-86,-23,715,164,1624,124,24,8.34
-3,-1,0,-3.0,-1.0,0.7650010585784912,85.86617494683223,89,-83,-22,715,164,1624,124,24,8.33
-3,0,0,-3.0,-0.0,0.7697911262512207,82.96987405076617,89,-80,-22,715,164,1624,124,24,6.04
-5,0,0,-5.0,-0.0,0.7777962684631348,78.16009211867653,89,-75,-22,715,164,1624,124,24,7.6
-5,0,0,-5.0,-0.0,0.7857391834259033,73.37574531137656,89,-70,-22,715,164,1624,124,24,7.22
-6,0,0,-6.0,-0.0,0.7937202453613281,67.67569726275453,89,-64,-22,715,164,1624,124,24,7.48
-7,0,0,-7.0,-0.0,0.8021602630615234,61.09828148156051,89,-57,-22,715,164,1624,124,24,7.47
-6,0,0,-6.0,-0.0,0.8135831356048584,55.54277630799526,89,-51,-22,715,164,1624,124,24,6.27
-6,0,0,-6.0,-0.0,0.8177940845489502,50.08991914547278,89,-45,-22,715,164,1624,124,24,5.67
-5,0,0,-5.0,-0.0,0.8267641067504883,45.65084884205331,89,-40,-22,715,164,1624,124,24,4.63
-5,0,0,-5.0,-0.0,0.8339762687683105,41.340053217188775,89,-35,-22,715,164,1624,124,24,4.13
-4,0,0,-4.0,-0.0,0.8431410789489746,38.01315561749642,89,-31,-22,715,164,1624,124,24,3.27
-4,-1,0,-4.0,-1.0,0.8497922420501709,34.20526275297414,89,-27,-21,715,164,1624,124,24,3.9
-3,0,0,-3.0,-0.0,0.8577570915222168,31.89043743820395,89,-24,-21,715,164,1624,124,24,2.22
-3,0,0,-3.0,-0.0,0.8657162189483643,29.698484809834994,89,-21,-21,715,164,1624,124,24,1.92
-2,-1,0,-2.0,-1.0,0.8737332820892334,27.586228448267445,89,-19,-20,715,164,1624,124,24,3.05
-2,0,0,-2.0,-0.0,0.8817472457885742,26.248809496813376,89,-17,-20,715,164,1624,124,24,1.3
-3,0,0,-3.0,-0.0,0.8921761512756348,24.413111231467404,89,-14,-20,715,164,1624,124,24,1.19
-2,-1,0,-2.0,-1.0,0.897747278213501,22.47220505424423,89,-12,-19,715,164,1624,124,24,2.09
-2,0,0,-2.0,-0.0,0.9063112735748291,21.470910553583888,89,-10,-19,715,164,1624,124,24,0.61
-1,0,0,-1.0,-0.0,0.9159832000732422,21.02379604162864,89,-9,-19,715,164,1624,124,24,0.5
-2,0,0,-2.0,-0.0,0.9217450618743896,20.248456731316587,89,-7,-19,715,164,1624,124,24,0.29
-1,-1,0,-1.0,-1.0,0.9311110973358154,18.973665961010276,89,-6,-18,715,164,1624,124,24,2.0
-2,0,0,-2.0,-0.0,0.946160078048706,18.439088914585774,89,-4,-18,715,164,1624,124,24,-0.05
-1,0,0,-1.0,-0.0,0.9537482261657715,18.24828759089466,89,-3,-18,715,164,1624,124,24,0.0
-1,-1,0,-1.0,-1.0,0.9673442840576172,17.11724276862369,89,-2,-17,715,164,1624,124,24,1.33
-1,0,0,-1.0,-0.0,0.969886064529419,17.029386365926403,89,-1,-17,715,164,1624,124,24,-0.18
-1,0,0,-1.0,-0.0,0.985877275466919,17.0,89,0,-17,715,164,1624,124,24,-0.26
-1,0,0,-1.0,-0.0,0.993725061416626,17.029386365926403,89,1,-17,715,164,1624,124,24,8.69
0,0,1,-0.0,-0.0,0.9982831478118896,17.029386365926403,89,1,-17,715,164,1624,124,24,32.0
0,0,0,-0.0,-0.0,0.08587765693664551,337.3499666518436,90,-333,-54,381,127,714,181,33,104.74
-1,0,0,-1.0,-0.0,0.10587167739868164,336.3628992620916,90,-332,-54,381,127,714,181,33,6.1
-1,0,0,-1.0,-0.0,0.12991070747375488,335.37590849671955,90,-331,-54,381,127,714,181,33,6.09
0,1,0,-0.0,1.0,0.13788270950317383,335.538373364359,90,-331,-55,381,127,714,181,33,15.62
-1,1,0,-1.0,1.0,0.14603662490844727,334.7177915797127,90,-330,-56,381,127,714,181,33,3.17
-1,2,0,-1.0,2.0,0.1544177532196045,334.07334524023315,90,-329,-58,381,127,714,181,33,2.23
0,2,0,-0.0,2.0,0.16187071800231934,334.4263745579885,90,-329,-60,381,127,714,181,33,7.95
-1,3,0,-1.0,3.0,0.16991066932678223,333.99550895184206,90,-328,-63,381,127,714,181,33,1.44
-1,3,0,-1.0,3.0,0.17786073684692383,333.5940646954019,90,-327,-66,381,127,714,181,33,1.34
-1,2,0,-1.0,2.0,0.1861248016357422,333.01651610693426,90,-326,-68,381,127,714,181,33,2.0
-2,4,0,-2.0,4.0,0.19391465187072754,331.9036004625439,90,-324,-72,381,127,714,181,33,3.42
-4,4,0,-4.0,4.0,0.2022557258605957,328.9012009707474,90,-320,-76,381,127,714,181,33,8.62
-4,4,0,-4.0,4.0,0.2098846435546875,325.9693237100694,90,-316,-80,381,127,714,181,33,8.37
-5,4,0,-5.0,4.0,0.21816182136535645,322.1443775700579,90,-311,-84,381,127,714,181,33,10.53
-7,4,0,-7.0,4.0,0.22667264938354492,316.4806471176397,90,-304,-88,381,127,714,181,33,14.56
-7,3,0,-7.0,3.0,0.23387861251831055,310.6283953536766,90,-297,-91,381,127,714,181,33,14.95
-8,1,0,-8.0,1.0,0.24187874794006348,303.29028998634294,90,-289,-92,381,127,714,181,33,18.21
-10,1,0,-10.0,1.0,0.25112080574035645,294.0918223956593,90,-279,-93,381,127,714,181,33,21.02
-10,0,0,-10.0,-0.0,0.2578728199005127,284.6225570821821,90,-269,-93,381,127,714,181,33,21.32
-11,-1,0,-11.0,-1.0,0.26593971252441406,273.91239475423527,90,-258,-92,381,127,714,181,33,22.99
-10,-3,0,-10.0,-3.0,0.2792518138885498,263.48624252510797,90,-248,-89,381,127,714,181,33,24.02
-12,-3,0,-12.0,-3.0,0.2821037769317627,251.18120948828954,90,-236,-86,381,127,714,181,33,24.94
-11,-3,0,-11.0,-3.0,0.28987669944763184,239.8207664069148,90,-225,-83,381,127,714,181,33,23.27
-10,-4,0,-10.0,-4.0,0.29790782928466797,229.05457864884517,90,-215,-79,381,127,714,181,33,23.16
-9,-3,0,-9.0,-3.0,0.3058907985687256,219.57231155134292,90,-206,-76,381,127,714,181,33,20.88
-9,-4,0,-9.0,-4.0,0.31519365310668945,209.74508337503408,90,-197,-72,381,127,714,181,33,19.89
-9,-4,0,-9.0,-4.0,0.3219637870788574,199.9199839935968,90,-188,-68,381,127,714,181,33,19.26
-10,-5,0,-10.0,-5.0,0.3298976421356201,188.8200201249857,90,-178,-63,381,127,714,181,33,19.28
-11,-5,0,-11.0,-5.0,0.33788061141967773,176.78518037437414,90,-167,-58,381,127,714,181,33,19.78
-10,-2,0,-10.0,-2.0,0.34612059593200684,166.68833192518306,90,-157,-56,381,127,714,181,33,16.6
-9,-2,0,-9.0,-2.0,0.3561406135559082,157.54364474646383,90,-148,-54,381,127,714,181,33,15.22
-6,-2,0,-6.0,-2.0,0.36196160316467285,151.22169156572744,90,-142,-52,381,127,714,181,33,13.69
-4,-1,0,-4.0,-1.0,0.37120580673217773,147.12239802287073,90,-138,-51,381,127,714,181,33,9.41
-4,0,0,-4.0,-0.0,0.38114166259765625,143.37712509323097,90,-134,-51,381,127,714,181,33,7.24
-3,-1,0,-3.0,-1.0,0.3858776092529297,140.21768789992225,90,-131,-50,381,127,714,181,33,9.17
-2,0,0,-2.0,-0.0,0.3948178291320801,138.351002887583,90,-129,-50,381,127,714,181,33,4.74
-3,-1,0,-3.0,-1.0,0.40188169479370117,135.19245541079576,90,-126,-49,381,127,714,181,33,8.89
-3,-1,0,-3.0,-1.0,0.41017770767211914,132.03408650799233,90,-123,-48,381,127,714,181,33,8.78
-2,0,0,-2.0,-0.0,0.4181506633758545,130.17296186228538,90,-121,-48,381,127,714,181,33,4.58
-3,-1,0,-3.0,-1.0,0.4288456439971924,127.01574705523721,90,-118,-47,381,127,714,181,33,8.51
-3,-1,0,-3.0,-1.0,0.43389463424682617,123.8587905640936,90,-115,-46,381,127,714,181,33,8.4
-3,-1,0,-3.0,-1.0,0.44206666946411133,120.70211265756701,90,-112,-45,381,127,714,181,33,8.28
-2,-1,0,-2.0,-1.0,0.4535386562347412,118.4736257569591,90,-110,-44,381,127,714,181,33,6.81
-4,-1,0,-4.0,-1.0,0.4580216407775879,114.38968484964018,90,-106,-43,381,127,714,181,33,8.0
-3,-1,0,-3.0,-1.0,0.46611571311950684,111.23398761170077,90,-103,-42,381,127,714,181,33,7.93
-3,-1,0,-3.0,-1.0,0.477144718170166,108.07867504739313,90,-100,-41,381,127,714,181,33,7.81
-2,-1,0,-2.0,-1.0,0.48191070556640625,105.84894897919393,90,-98,-40,381,127,714,181,33,6.67
-2,0,0,-2.0,-0.0,0.489912748336792,104.0,90,-96,-40,381,127,714,181,33,4.07
-2,0,0,-2.0,-0.0,0.4978766441345215,102.15674231297707,90,-94,-40,381,127,714,181,33,4.0
-2,-1,0,-2.0,-1.0,0.5060207843780518,99.92497185388645,90,-92,-39,381,127,714,181,33,6.79
-2,-1,0,-2.0,-1.0,0.5138576030731201,97.6933979345585,90,-90,-38,381,127,714,181,33,6.72
-3,0,0,-3.0,-0.0,0.5218737125396729,94.93682109698007,90,-87,-38,381,127,714,181,33,4.69
-2,-1,0,-2.0,-1.0,0.53029465675354,92.70382947861431,90,-85,-37,381,127,714,181,33,6.83
-4,-2,0,-4.0,-2.0,0.5383718013763428,88.23831367382311,90,-81,-35,381,127,714,181,33,8.56
-6,-2,0,-6.0,-2.0,0.5458626747131348,81.93900170248598,90,-75,-33,381,127,714,181,33,8.97
-7,-2,0,-7.0,-2.0,0.5539166927337646,74.73285756613352,90,-68,-31,381,127,714,181,33,8.5
-7,-3,0,-7.0,-3.0,0.5630908012390137,67.11929677819934,90,-61,-28,381,127,714,181,33,10.46
-6,-2,0,-6.0,-2.0,0.5699036121368408,60.83584469702052,90,-55,-26,381,127,714,181,33,7.46
-6,-2,0,-6.0,-2.0,0.5782496929168701,54.56189146281496,90,-49,-24,381,127,714,181,33,6.94
-6,-2,0,-6.0,-2.0,0.5876946449279785,48.30113870293329,90,-43,-22,381,127,714,181,33,6.39
-4,-1,0,-4.0,-1.0,0.593883752822876,44.294469180700204,90,-39,-21,381,127,714,181,33,4.5
-3,-1,0,-3.0,-1.0,0.6019177436828613,41.182520563948,90,-36,-20,381,127,714,181,33,4.4
-2,0,0,-2.0,-0.0,0.6159286499023438,39.44616584663204,90,-34,-20,381,127,714,181,33,2.29
-1,0,0,-1.0,-0.0,0.6258537769317627,38.58756276314948,90,-33,-20,381,127,714,181,33,1.92
0,-1,0,-0.0,-1.0,0.6339397430419922,38.07886552931954,90,-33,-19,381,127,714,181,33,0.79
-1,0,0,-1.0,-0.0,0.6498677730560303,37.21558813185679,90,-32,-19,381,127,714,181,33,1.92
-1,0,0,-1.0,-0.0,0.6578736305236816,36.359317925395686,90,-31,-19,381,127,714,181,33,1.87
-1,0,0,-1.0,-0.0,0.6738836765289307,35.510561809129406,90,-30,-19,381,127,714,181,33,1.82
-1,0,0,-1.0,-0.0,0.6818747520446777,34.66987164671943,90,-29,-19,381,127,714,181,33,1.76
-1,0,0,-1.0,-0.0,0.689917802810669,33.83784863137726,90,-28,-19,381,127,714,181,33,1.7
-1,0,0,-1.0,-0.0,0.6988387107849121,33.015148038438355,90,-27,-19,381,127,714,181,33,1.65
-2,0,0,-2.0,-0.0,0.7058637142181396,31.400636936215164,90,-25,-19,381,127,714,181,33,1.73
-2,0,0,-2.0,-0.0,0.713883638381958,29.832867780352597,90,-23,-19,381,127,714,181,33,1.58
0,0,1,-0.0,-0.0,0.7188847064971924,29.832867780352597,90,-23,-19,381,127,714,181,33,35.9
-1,0,1,-1.0,-0.0,0.004853487014770508,109.00458705944443,91,1,-109,404,37,404,146,3,42.34
-1,0,1,-1.0,-0.0,0.010271310806274414,109.01834707974616,91,2,-109,404,37,404,146,3,41.23
-1,0,1,-1.0,-0.0,0.01827526092529297,109.04127658827184,91,3,-109,404,37,404,146,3,40.19
0,0,0,-0.0,-0.0,0.14229035377502441,109.04127658827184,91,3,-109,404,37,404,146,3,49.52
0,1,0,-0.0,1.0,0.21031928062438965,110.04090148667449,91,3,-110,404,37,404,146,3,15.99
1,3,0,1.0,3.0,0.2182912826538086,113.01769772916099,91,2,-113,404,37,404,146,3,6.35
2,2,0,2.0,2.0,0.2264704704284668,115.0,91,0,-115,404,37,404,146,3,7.22
3,3,0,3.0,3.0,0.2353973388671875,118.03812943282352,91,-3,-118,404,37,404,146,3,5.21
4,2,0,4.0,2.0,0.24228143692016602,120.20399327809372,91,-7,-120,404,37,404,146,3,6.43
5,2,0,5.0,2.0,0.2503082752227783,122.58874336577564,91,-12,-122,404,37,404,146,3,5.9
3,2,0,3.0,2.0,0.2591392993927002,124.90396310766124,91,-15,-124,404,37,404,146,3,6.59
3,1,0,3.0,1.0,0.2662832736968994,126.28935030318273,91,-18,-125,404,37,404,146,3,9.6
2,0,0,2.0,-0.0,0.27429747581481934,126.58988901172162,91,-20,-125,404,37,404,146,3,25.26
2,0,0,2.0,-0.0,0.28401732444763184,126.92123541787639,91,-22,-125,404,37,404,146,3,24.16
1,0,0,1.0,-0.0,0.2909114360809326,127.09838708654017,91,-23,-125,404,37,404,146,3,31.53
2,-2,0,2.0,-2.0,0.3222954273223877,125.51493934986385,91,-25,-123,404,37,404,146,3,16.99
1,-4,0,1.0,-4.0,0.33031129837036133,121.80722474467596,91,-26,-119,404,37,404,146,3,27.21
1,-5,0,1.0,-5.0,0.33863139152526855,117.15374513859982,91,-27,-114,404,37,404,146,3,28.99
1,-5,0,1.0,-5.0,0.3463003635406494,112.53888216967503,91,-28,-109,404,37,404,146,3,28.04
1,-6,0,1.0,-6.0,0.35428428649902344,107.00467279516349,91,-29,-103,404,37,404,146,3,28.82
0,-5,0,-0.0,-5.0,0.36429548263549805,102.20078277586722,91,-29,-98,404,37,404,146,3,27.23
0,-7,0,-0.0,-7.0,0.37032628059387207,95.50916186418976,91,-29,-91,404,37,404,146,3,28.69
0,-6,0,-0.0,-6.0,0.3783392906188965,89.81091247727082,91,-29,-85,404,37,404,146,3,26.18
-1,-7,0,-1.0,-7.0,0.38756537437438965,82.87339742040264,91,-28,-78,404,37,404,146,3,26.91
0,-6,0,-0.0,-6.0,0.3942832946777344,77.25283166331187,91,-28,-72,404,37,404,146,3,23.41
-1,-6,0,-1.0,-6.0,0.40227842330932617,71.30918594402827,91,-27,-66,404,37,404,146,3,23.31
0,-5,0,-0.0,-5.0,0.41112542152404785,66.70832032063167,91,-27,-61,404,37,404,146,3,19.79
-1,-5,0,-1.0,-5.0,0.41829442977905273,61.741396161732524,91,-26,-56,404,37,404,146,3,20.14
0,-4,0,-0.0,-4.0,0.42628931999206543,58.137767414994535,91,-26,-52,404,37,404,146,3,16.46
-1,-4,0,-1.0,-4.0,0.4349253177642822,54.120236510939236,91,-25,-48,404,37,404,146,3,17.39
-1,-3,0,-1.0,-3.0,0.44232845306396484,51.0,91,-24,-45,404,37,404,146,3,15.79
-1,-4,0,-1.0,-4.0,0.4504973888397217,47.01063709417264,91,-23,-41,404,37,404,146,3,15.87
-1,-4,0,-1.0,-4.0,0.4593772888183594,43.04648650006177,91,-22,-37,404,37,404,146,3,14.97
-2,-4,0,-2.0,-4.0,0.46627044677734375,38.58756276314948,91,-20,-33,404,37,404,146,3,16.44
0,-3,0,-0.0,-3.0,0.4743003845214844,36.05551275463989,91,-20,-30,404,37,404,146,3,10.5
-1,-2,0,-1.0,-2.0,0.48244237899780273,33.83784863137726,91,-19,-28,404,37,404,146,3,11.67
0,-2,0,-0.0,-2.0,0.4902923107147217,32.202484376209235,91,-19,-26,404,37,404,146,3,7.91
0,-2,0,-0.0,-2.0,0.4983253479003906,30.610455730027933,91,-19,-24,404,37,404,146,3,7.51
-1,-1,0,-1.0,-1.0,0.5062963962554932,29.206163733020468,91,-18,-23,404,37,404,146,3,9.29
0,-1,0,-0.0,-1.0,0.5158114433288574,28.42534080710379,91,-18,-22,404,37,404,146,3,4.85
0,-2,0,-0.0,-2.0,0.5223054885864258,26.90724809414742,91,-18,-20,404,37,404,146,3,6.74
0,-1,0,-0.0,-1.0,0.5326244831085205,26.1725046566048,91,-18,-19,404,37,404,146,3,4.36
0,-1,0,-0.0,-1.0,0.5463132858276367,25.45584412271571,91,-18,-18,404,37,404,146,3,4.19
0,-1,0,-0.0,-1.0,0.5576024055480957,24.758836806279895,91,-18,-17,404,37,404,146,3,4.02
-1,-1,0,-1.0,-1.0,0.5626034736633301,23.345235059857504,91,-17,-16,404,37,404,146,3,10.32
0,-1,0,-0.0,-1.0,0.5706744194030762,22.67156809750927,91,-17,-15,404,37,404,146,3,3.73
0,-1,0,-0.0,-1.0,0.5782613754272461,22.02271554554524,91,-17,-14,404,37,404,146,3,3.53
0,-1,0,-0.0,-1.0,0.5862853527069092,21.400934559032695,91,-17,-13,404,37,404,146,3,3.33
-1,-1,0,-1.0,-1.0,0.5942573547363281,20.0,91,-16,-12,404,37,404,146,3,8.02
0,-1,0,-0.0,-1.0,0.6022634506225586,19.4164878389476,91,-16,-11,404,37,404,146,3,2.98
-1,-1,0,-1.0,-1.0,0.6103253364562988,18.027756377319946,91,-15,-10,404,37,404,146,3,7.3
0,-1,0,-0.0,-1.0,0.6183273792266846,17.4928556845359,91,-15,-9,404,37,404,146,3,2.59
-1,-1,0,-1.0,-1.0,0.6262784004211426,16.1245154965971,91,-14,-8,404,37,404,146,3,6.6
-2,-1,0,-2.0,-1.0,0.6345174312591553,13.892443989449804,91,-12,-7,404,37,404,146,3,9.57
-1,-1,0,-1.0,-1.0,0.6460332870483398,12.529964086141668,91,-11,-6,404,37,404,146,3,6.01
-2,0,0,-2.0,-0.0,0.6505224704742432,10.816653826391969,91,-9,-6,404,37,404,146,3,5.22
-2,-1,0,-2.0,-1.0,0.65828537940979,8.602325267042627,91,-7,-5,404,37,404,146,3,7.35
-2,-1,0,-2.0,-1.0,0.6662814617156982,6.4031242374328485,91,-5,-4,404,37,404,146,3,6.43
-1,-1,0,-1.0,-1.0,0.6742813587188721,5.0,91,-4,-3,404,37,404,146,3,5.73
-1,0,0,-1.0,-0.0,0.6827492713928223,4.242640687119285,91,-3,-3,404,37,404,146,3,2.07
0,-1,0,-0.0,-1.0,0.6903104782104492,3.605551275463989,91,-3,-2,404,37,404,146,3,1.32
-1,0,0,-1.0,-0.0,0.7062633037567139,2.8284271247461903,91,-2,-2,404,37,404,146,3,1.72
-1,-1,0,-1.0,-1.0,0.7222764492034912,1.4142135623730951,91,-1,-1,404,37,404,146,3,10.07
0,-1,0,-0.0,-1.0,0.7384142875671387,1.0,91,-1,0,404,37,404,146,3,-1.03
-1,0,0,-1.0,-0.0,0.7462773323059082,0.0,91,0,0,404,37,404,146,3,9.22
-1,-1,0,-1.0,-1.0,0.7543613910675049,1.4142135623730951,91,1,1,404,37,404,146,3,8.68
-1,0,0,-1.0,-0.0,0.7702922821044922,2.23606797749979,91,2,1,404,37,404,146,3,1.95
-1,-1,0,-1.0,-1.0,0.786318302154541,3.605551275463989,91,3,2,404,37,404,146,3,2.36
-1,0,0,-1.0,-0.0,0.8102693557739258,4.47213595499958,91,4,2,404,37,404,146,3,3.14
-1,0,0,-1.0,-0.0,0.8182904720306396,5.385164807134504,91,5,2,404,37,404,146,3,3.58
-1,-1,0,-1.0,-1.0,0.8269174098968506,6.708203932499369,91,6,3,404,37,404,146,3,2.94
-1,0,0,-1.0,-0.0,0.866889476776123,7.615773105863909,91,7,3,404,37,404,146,3,4.07
0,0,1,-0.0,-0.0,0.9123084545135498,7.615773105863909,91,7,3,404,37,404,146,3,19.17
0,0,0,-0.0,-0.0,1.0093083381652832,7.615773105863909,91,7,3,404,37,404,146,3,19.17
1,0,0,1.0,-0.0,1.1062793731689453,6.708203932499369,91,6,3,404,37,404,146,3,3.64
2,0,0,2.0,-0.0,1.114741325378418,5.0,91,4,3,404,37,404,146,3,3.88
2,1,0,2.0,1.0,1.126204252243042,2.8284271247461903,91,2,2,404,37,404,146,3,4.78
2,0,0,2.0,-0.0,1.138289451599121,2.0,91,0,2,404,37,404,146,3,0.04
1,0,0,1.0,-0.0,1.146303415298462,2.23606797749979,91,-1,2,404,37,404,146,3,4.57
2,1,0,2.0,1.0,1.1546282768249512,3.1622776601683795,91,-3,1,404,37,404,146,3,0.53
1,0,0,1.0,-0.0,1.1625924110412598,4.123105625617661,91,-4,1,404,37,404,146,3,3.62
1,0,0,1.0,-0.0,1.1703083515167236,5.0990195135927845,91,-5,1,404,37,404,146,3,4.24
1,1,0,1.0,1.0,1.178309440612793,6.0,91,-6,0,404,37,404,146,3,2.48
1,0,0,1.0,-0.0,1.186995267868042,7.0,91,-7,0,404,37,404,146,3,9.73
0,0,1,-0.0,-0.0,1.2082734107971191,7.0,91,-7,0,404,37,404,146,3,18.99
1,0,1,1.0,-0.0,1.210362434387207,8.0,91,-8,0,404,37,404,146,3,9.8
0,0,0,-0.0,-0.0,1.3483564853668213,8.0,91,-8,0,404,37,404,146,3,19.28
-1,0,0,-1.0,-0.0,1.4584014415740967,7.0,91,-7,0,404,37,404,146,3,9.73
-1,0,0,-1.0,-0.0,1.4743742942810059,6.0,91,-6,0,404,37,404,146,3,9.66
-1,0,0,-1.0,-0.0,1.4902684688568115,5.0,91,-5,0,404,37,404,146,3,9.58
-1,0,0,-1.0,-0.0,1.530294418334961,4.0,91,-4,0,404,37,404,146,3,9.51
-1,0,0,-1.0,-0.0,1.5863182544708252,3.0,91,-3,0,404,37,404,146,3,9.43
0,0,1,-0.0,-0.0,1.593388319015503,3.0,91,-3,0,404,37,404,146,3,27.81
0,0,0,-0.0,-0.0,0.13349390029907227,827.0362748997169,92,167,810,574,847,407,37,74,184.24
0,1,0,-0.0,1.0,0.24149703979492188,826.0568987666649,92,167,809,574,847,407,37,74,5.28
0,4,0,-0.0,4.0,0.24952101707458496,822.1398907728538,92,167,805,574,847,407,37,74,11.81
0,7,0,-0.0,7.0,0.2575080394744873,815.2870660080412,92,167,798,574,847,407,37,74,17.79
1,6,0,1.0,6.0,0.26576900482177734,809.2094907995086,92,166,792,574,847,407,37,74,18.12
1,9,0,1.0,9.0,0.27349400520324707,800.1962259346141,92,165,783,574,847,407,37,74,22.71
1,9,0,1.0,9.0,0.28150200843811035,791.1839229913611,92,164,774,574,847,407,37,74,22.56
1,9,0,1.0,9.0,0.2895081043243408,782.1726152199398,92,163,765,574,847,407,37,74,22.41
2,10,0,2.0,10.0,0.30022692680358887,771.9753882087174,92,161,755,574,847,407,37,74,26.4
1,12,0,1.0,12.0,0.3055150508880615,760.0322361584408,92,160,743,574,847,407,37,74,26.84
2,15,0,2.0,15.0,0.31348705291748047,744.9483203551774,92,158,728,574,847,407,37,74,32.14
2,15,0,2.0,15.0,0.32439303398132324,729.8664261356321,92,156,713,574,847,407,37,74,31.75
3,17,0,3.0,17.0,0.3299989700317383,712.6184112131822,92,153,696,574,847,407,37,74,35.29
2,19,0,2.0,19.0,0.3375511169433594,693.6353508869051,92,151,677,574,847,407,37,74,35.96
3,21,0,3.0,21.0,0.348560094833374,672.4879181070839,92,148,656,574,847,407,37,74,38.57
4,21,0,4.0,21.0,0.35362792015075684,651.1228762683738,92,144,635,574,847,407,37,74,39.08
4,23,0,4.0,23.0,0.3615279197692871,627.8088881180323,92,140,612,574,847,407,37,74,40.12
3,28,0,3.0,28.0,0.3728909492492676,599.8541489395568,92,137,584,574,847,407,37,74,42.98
3,32,0,3.0,32.0,0.3776249885559082,568.0316892568583,92,134,552,574,847,407,37,74,45.02
4,34,0,4.0,34.0,0.38552093505859375,534.063666616631,92,130,518,574,847,407,37,74,45.32
6,31,0,6.0,31.0,0.39348697662353516,502.5385557347814,92,124,487,574,847,407,37,74,42.61
6,31,0,6.0,31.0,0.40152406692504883,471.02016941952706,92,118,456,574,847,407,37,74,40.86
7,28,0,7.0,28.0,0.409743070602417,442.15947349344447,92,111,428,574,847,407,37,74,39.04
7,24,0,7.0,24.0,0.4174950122833252,417.17142759302203,92,104,404,574,847,407,37,74,33.46
7,21,0,7.0,21.0,0.4262571334838867,395.0923942573433,92,97,383,574,847,407,37,74,28.97
6,19,0,6.0,19.0,0.4335200786590576,375.2026119312071,92,91,364,574,847,407,37,74,26.44
7,18,0,7.0,18.0,0.44150400161743164,356.0505582076793,92,84,346,574,847,407,37,74,24.0
7,17,0,7.0,17.0,0.45102596282958984,337.8905148121208,92,77,329,574,847,407,37,74,22.14
5,14,0,5.0,14.0,0.4574880599975586,323.12381527829234,92,72,315,574,847,407,37,74,19.08
5,13,0,5.0,13.0,0.46551990509033203,309.3428518650463,92,67,302,574,847,407,37,74,17.44
4,13,0,4.0,13.0,0.4734771251678467,295.78708558691335,92,63,289,574,847,407,37,74,17.52
4,12,0,4.0,12.0,0.48153090476989746,283.21370023358685,92,59,277,574,847,407,37,74,15.91
4,11,0,4.0,11.0,0.48955512046813965,271.6265819097976,92,55,266,574,847,407,37,74,14.38
3,11,0,3.0,11.0,0.497560977935791,260.24795868555816,92,52,255,574,847,407,37,74,14.87
3,11,0,3.0,11.0,0.5056860446929932,248.8714527622644,92,49,244,574,847,407,37,74,14.46
3,10,0,3.0,10.0,0.513498067855835,238.47851056227267,92,46,234,574,847,407,37,74,12.93
4,9,0,4.0,9.0,0.5215511322021484,228.8864347225497,92,42,225,574,847,407,37,74,10.87
3,9,0,3.0,9.0,0.5295329093933105,219.49259668608414,92,39,216,574,847,407,37,74,11.12
3,8,0,3.0,8.0,0.5434889793395996,211.09239683134018,92,36,208,574,847,407,37,74,9.81
4,8,0,4.0,8.0,0.5455200672149658,202.54382241875462,92,32,200,574,847,407,37,74,9.01
3,7,0,3.0,7.0,0.5557940006256104,195.1665955024066,92,29,193,574,847,407,37,74,8.25
3,8,0,3.0,8.0,0.5615110397338867,186.81809334215998,92,26,185,574,847,407,37,74,8.9
4,7,0,4.0,7.0,0.571821928024292,179.35439777156287,92,22,178,574,847,407,37,74,7.3
4,9,0,4.0,9.0,0.5775051116943359,169.95587662684687,92,18,169,574,847,407,37,74,8.56
3,8,0,3.0,8.0,0.585644006729126,161.69724796668618,92,15,161,574,847,407,37,74,7.87
2,9,0,2.0,9.0,0.5995559692382812,152.55490814785344,92,13,152,574,847,407,37,74,9.03
3,9,0,3.0,9.0,0.6015961170196533,143.34922392534952,92,10,143,574,847,407,37,74,7.89
2,8,0,2.0,8.0,0.6120800971984863,135.2368293032634,92,8,135,574,847,407,37,74,7.5
2,8,0,2.0,8.0,0.617682933807373,127.1416532848303,92,6,127,574,847,407,37,74,7.16
3,8,0,3.0,8.0,0.6255021095275879,119.03780911962384,92,3,119,574,847,407,37,74,6.18
2,8,0,2.0,8.0,0.637131929397583,111.00450441310929,92,1,111,574,847,407,37,74,6.38
2,8,0,2.0,8.0,0.6414871215820312,103.00485425454472,92,-1,103,574,847,407,37,74,6.0
3,8,0,3.0,8.0,0.6495230197906494,95.08417323613851,92,-4,95,574,847,407,37,74,5.06
3,6,0,3.0,6.0,0.6610350608825684,89.27485648266257,92,-7,89,574,847,407,37,74,3.68
1,5,0,1.0,5.0,0.6656761169433594,84.38009243891595,92,-8,84,574,847,407,37,74,4.15
1,3,0,1.0,3.0,0.6735410690307617,81.49846624323675,92,-9,81,574,847,407,37,74,2.87
1,3,0,1.0,3.0,0.6815221309661865,78.63841300535,92,-10,78,574,847,407,37,74,2.76
0,2,0,-0.0,2.0,0.689486026763916,76.6550715869472,92,-10,76,574,847,407,37,74,4.17
1,2,0,1.0,2.0,0.699131965637207,74.81310045707235,92,-11,74,574,847,407,37,74,1.96
0,2,0,-0.0,2.0,0.7055459022521973,72.83543093852057,92,-11,72,574,847,407,37,74,3.93
0,1,0,-0.0,1.0,0.7135009765625,71.84705978674423,92,-11,71,574,847,407,37,74,3.62
0,2,0,-0.0,2.0,0.727571964263916,69.87131027825369,92,-11,69,574,847,407,37,74,3.84
0,2,0,-0.0,2.0,0.7295119762420654,67.89698078707183,92,-11,67,574,847,407,37,74,3.78
0,2,0,-0.0,2.0,0.7380030155181885,65.92419889539804,92,-11,65,574,847,407,37,74,3.71
0,1,0,-0.0,1.0,0.7455899715423584,64.93843238021688,92,-11,64,574,847,407,37,74,3.44
0,2,0,-0.0,2.0,0.7535030841827393,62.96824596572466,92,-11,62,574,847,407,37,74,3.61
0,2,0,-0.0,2.0,0.762890100479126,61.0,92,-11,60,574,847,407,37,74,3.55
0,1,0,-0.0,1.0,0.7695469856262207,60.01666435249463,92,-11,59,574,847,407,37,74,3.3
0,1,0,-0.0,1.0,0.7775499820709229,59.033888572581766,92,-11,58,574,847,407,37,74,3.28
0,1,0,-0.0,1.0,0.7878129482269287,58.05170109479997,92,-11,57,574,847,407,37,74,3.25
0,0,1,-0.0,-0.0,0.7905020713806152,58.05170109479997,92,-11,57,574,847,407,37,74,44.52
0,1,1,-0.0,1.0,0.7993240356445312,57.0701322935211,92,-11,56,574,847,407,37,74,13.22
0,1,1,-0.0,1.0,0.8015351295471191,56.089214649520635,92,-11,55,574,847,407,37,74,13.18
0,1,1,-0.0,1.0,0.8118269443511963,55.10898293381942,92,-11,54,574,847,407,37,74,13.15
1,1,1,1.0,1.0,0.8175160884857178,54.3415126767741,92,-12,53,574,847,407,37,74,10.79
0,1,1,-0.0,1.0,0.8255119323730469,53.36665625650534,92,-12,52,574,847,407,37,74,12.98
0,1,1,-0.0,1.0,0.8364770412445068,52.392747589718944,92,-12,51,574,847,407,37,74,12.94
0,0,0,-0.0,-0.0,0.9195280075073242,52.392747589718944,92,-12,51,574,847,407,37,74,32.8
0,0,1,-0.0,-0.0,1.0374999046325684,52.392747589718944,92,-12,51,574,847,407,37,74,42.8
0,1,1,-0.0,1.0,0.04877281188964844,533.9007398384085,93,295,-445,881,352,586,796,45,5.0
0,1,1,-0.0,1.0,0.05663299560546875,534.7345135672467,93,295,-446,881,352,586,796,45,5.0
0,1,1,-0.0,1.0,0.06464481353759766,535.5688564507835,93,295,-447,881,352,586,796,45,5.01
0,0,0,-0.0,-0.0,0.0708320140838623,535.5688564507835,93,295,-447,881,352,586,796,45,141.36
0,1,0,-0.0,1.0,0.07264280319213867,536.4037658331641,93,295,-448,881,352,586,796,45,5.01
1,0,0,1.0,-0.0,0.19266486167907715,535.8544578521298,93,294,-448,881,352,586,796,45,2.4
2,0,0,2.0,-0.0,0.20082592964172363,534.7597591442347,93,292,-448,881,352,586,796,45,3.94
3,-1,0,3.0,-1.0,0.21186399459838867,532.2875162917124,93,289,-447,881,352,586,796,45,8.25
5,-4,0,5.0,-4.0,0.2166728973388672,526.2176355843654,93,284,-443,881,352,586,796,45,18.03
5,-4,0,5.0,-4.0,0.22464680671691895,520.1557459069351,93,279,-439,881,352,586,796,45,17.87
6,-6,0,6.0,-6.0,0.23263001441955566,511.87693833576833,93,273,-433,881,352,586,796,45,22.99
6,-6,0,6.0,-6.0,0.24074101448059082,503.60500394654537,93,267,-427,881,352,586,796,45,22.73
5,-7,0,5.0,-7.0,0.24866294860839844,495.0191915471561,93,262,-420,881,352,586,796,45,24.77
5,-9,0,5.0,-9.0,0.25661683082580566,484.73704211665114,93,257,-411,881,352,586,796,45,27.91
8,-12,0,8.0,-12.0,0.2648298740386963,470.3211668636656,93,249,-399,881,352,586,796,45,34.94
8,-16,0,8.0,-16.0,0.2726569175720215,452.5151931151041,93,241,-383,881,352,586,796,45,37.66
10,-18,0,10.0,-18.0,0.2825949192047119,431.9560162794356,93,231,-365,881,352,586,796,45,40.71
11,-20,0,11.0,-20.0,0.2886848449707031,409.1760012512953,93,220,-345,881,352,586,796,45,41.69
14,-20,0,14.0,-20.0,0.2971608638763428,384.78695404080423,93,206,-325,881,352,586,796,45,42.13
14,-20,0,14.0,-20.0,0.30701494216918945,360.40116536992497,93,192,-305,881,352,586,796,45,40.34
12,-20,0,12.0,-20.0,0.31269097328186035,337.08307581366347,93,180,-285,881,352,586,796,45,38.49
10,-18,0,10.0,-18.0,0.3210179805755615,316.52646018934973,93,170,-267,881,352,586,796,45,33.38
9,-17,0,9.0,-17.0,0.3313019275665283,297.3566881709574,93,161,-250,881,352,586,796,45,30.33
7,-16,0,7.0,-16.0,0.3367128372192383,280.12854192316786,93,154,-234,881,352,586,796,45,26.43
7,-15,0,7.0,-15.0,0.3446919918060303,263.7612556839992,93,147,-219,881,352,586,796,45,24.7
5,-13,0,5.0,-13.0,0.3540618419647217,250.19992006393608,93,142,-206,881,352,586,796,45,20.57
4,-12,0,4.0,-12.0,0.36075496673583984,238.0756182392477,93,138,-194,881,352,586,796,45,18.15
5,-12,0,5.0,-12.0,0.3690769672393799,225.41739063346466,93,133,-182,881,352,586,796,45,18.33
5,-11,0,5.0,-11.0,0.3780379295349121,213.60009363293827,93,128,-171,881,352,586,796,45,17.02
5,-10,0,5.0,-10.0,0.38463878631591797,202.6079958935481,93,123,-161,881,352,586,796,45,15.86
6,-10,0,6.0,-10.0,0.393967866897583,191.02355875650522,93,117,-151,881,352,586,796,45,16.41
7,-9,0,7.0,-9.0,0.40064096450805664,179.62182495454164,93,110,-142,881,352,586,796,45,18.93
7,-9,0,7.0,-9.0,0.40891599655151367,168.22009392459628,93,103,-133,881,352,586,796,45,18.32
7,-8,0,7.0,-8.0,0.4175548553466797,157.610278852618,93,96,-125,881,352,586,796,45,14.61
8,-7,0,8.0,-7.0,0.4246199131011963,147.20054347725758,93,88,-118,881,352,586,796,45,12.33
8,-7,0,8.0,-7.0,0.43300485610961914,136.82470537150812,93,80,-111,881,352,586,796,45,11.64
8,-6,0,8.0,-6.0,0.44066596031188965,127.31457104353767,93,72,-105,881,352,586,796,45,10.03
5,-5,0,5.0,-5.0,0.4510529041290283,120.37026210821342,93,67,-100,881,352,586,796,45,8.66
6,-4,0,6.0,-4.0,0.456636905670166,113.74093370462545,93,61,-96,881,352,586,796,45,7.1
5,-5,0,5.0,-5.0,0.46465086936950684,106.85036265731624,93,56,-91,881,352,586,796,45,7.81
6,-4,0,6.0,-4.0,0.4726388454437256,100.34440691936945,93,50,-87,881,352,586,796,45,6.32
4,-3,0,4.0,-3.0,0.48070383071899414,95.77055915050303,93,46,-84,881,352,586,796,45,5.08
4,-4,0,4.0,-4.0,0.4926738739013672,90.35485598461214,93,42,-80,881,352,586,796,45,5.9
4,-3,0,4.0,-3.0,0.4974799156188965,85.86617494683223,93,38,-77,881,352,586,796,45,4.58
3,-5,0,3.0,-5.0,0.5057649612426758,80.05623023850174,93,35,-72,881,352,586,796,45,7.4
3,-4,0,3.0,-4.0,0.512678861618042,75.15317691222374,93,32,-68,881,352,586,796,45,5.63
2,-3,0,2.0,-3.0,0.5207409858703613,71.58910531638176,93,30,-65,881,352,586,796,45,5.21
2,-3,0,2.0,-3.0,0.5294399261474609,68.0294054067798,93,28,-62,881,352,586,796,45,5.04
2,-4,0,2.0,-4.0,0.536672830581665,63.56099432828282,93,26,-58,881,352,586,796,45,7.03
2,-4,0,2.0,-4.0,0.5446608066558838,59.09314681077663,93,24,-54,881,352,586,796,45,6.8
1,-3,0,1.0,-3.0,0.5526368618011475,55.94640292279746,93,23,-51,881,352,586,796,45,5.15
1,-4,0,1.0,-4.0,0.5609228610992432,51.894122981316485,93,22,-47,881,352,586,796,45,4.52
1,-2,0,1.0,-2.0,0.5686638355255127,49.658836071740545,93,21,-45,881,352,586,796,45,6.19
1,-3,0,1.0,-3.0,0.5788187980651855,46.51881339845203,93,20,-42,881,352,586,796,45,4.64
1,-2,0,1.0,-2.0,0.5846738815307617,44.28317965096906,93,19,-40,881,352,586,796,45,6.35
1,-2,0,1.0,-2.0,0.5928997993469238,42.04759208325728,93,18,-38,881,352,586,796,45,6.26
0,-2,0,-0.0,-2.0,0.6006288528442383,40.24922359499622,93,18,-36,881,352,586,796,45,2.24
1,0,0,1.0,-0.0,0.60971999168396,39.81205847478876,93,17,-36,881,352,586,796,45,0.59
0,-1,0,-0.0,-1.0,0.6187708377838135,38.91015291668744,93,17,-35,881,352,586,796,45,2.05
1,-1,0,1.0,-1.0,0.6726548671722412,37.57658845611187,93,16,-34,881,352,586,796,45,2.5
0,0,1,-0.0,-0.0,0.6946299076080322,37.57658845611187,93,16,-34,881,352,586,796,45,38.269999999999996
0,0,0,-0.0,-0.0,0.09057283401489258,759.8822277169008,94,730,-211,1595,175,865,386,25,175.22
0,1,0,-0.0,1.0,0.1695249080657959,760.1605093662785,94,730,-212,1595,175,865,386,25,21.59
0,3,0,-0.0,3.0,0.1775798797607422,761.0026281163555,94,730,-215,1595,175,865,386,25,8.03
0,4,0,-0.0,4.0,0.1855158805847168,762.1423751504701,94,730,-219,1595,175,865,386,25,6.09
1,3,0,1.0,3.0,0.19356393814086914,762.0531477528323,94,729,-222,1595,175,865,386,25,0.73
2,4,0,2.0,4.0,0.20162391662597656,761.3179362132486,94,727,-226,1595,175,865,386,25,5.06
4,3,0,4.0,3.0,0.21002674102783203,758.3996308015979,94,723,-229,1595,175,865,386,25,18.38
5,3,0,5.0,3.0,0.21752381324768066,754.5515224290519,94,718,-232,1595,175,865,386,25,23.31
5,3,0,5.0,3.0,0.2255568504333496,750.728979059687,94,713,-235,1595,175,865,386,25,23.1
6,1,0,6.0,1.0,0.23351573944091797,745.3489115843666,94,707,-236,1595,175,865,386,25,31.19
6,0,0,6.0,-0.0,0.24152684211730957,739.6600570532385,94,701,-236,1595,175,865,386,25,32.99
11,0,0,11.0,-0.0,0.249680757522583,729.2434435769718,94,690,-236,1595,175,865,386,25,50.49
14,0,0,14.0,-0.0,0.25762176513671875,716.0111730971801,94,676,-236,1595,175,865,386,25,58.31
21,-2,0,21.0,-2.0,0.26552271842956543,695.5436722449568,94,655,-234,1595,175,865,386,25,74.2
21,-2,0,21.0,-2.0,0.27364182472229004,675.1148050517038,94,634,-232,1595,175,865,386,25,72.74
24,-3,0,24.0,-3.0,0.28153085708618164,651.5681084890512,94,610,-229,1595,175,865,386,25,76.64
23,-3,0,23.0,-3.0,0.2895388603210449,629.0031796422018,94,587,-226,1595,175,865,386,25,73.37
21,-4,0,21.0,-4.0,0.29758286476135254,607.9802628375365,94,566,-222,1595,175,865,386,25,69.61
18,-4,0,18.0,-4.0,0.3057687282562256,589.7694464788761,94,548,-218,1595,175,865,386,25,63.46
17,-6,0,17.0,-6.0,0.3135058879852295,571.7560668676809,94,531,-212,1595,175,865,386,25,63.55
20,-7,0,20.0,-7.0,0.32176995277404785,550.5869595259227,94,511,-205,1595,175,865,386,25,67.4
18,-8,0,18.0,-8.0,0.3295557498931885,530.9030043237653,94,493,-197,1595,175,865,386,25,63.69
18,-9,0,18.0,-9.0,0.3432497978210449,510.8512503655051,94,475,-188,1595,175,865,386,25,61.81
17,-9,0,17.0,-9.0,0.34556078910827637,491.7367181734551,94,458,-179,1595,175,865,386,25,58.5
18,-10,0,18.0,-10.0,0.35505175590515137,471.3395803452114,94,440,-169,1595,175,865,386,25,58.62
16,-10,0,16.0,-10.0,0.36156773567199707,452.83219850182917,94,424,-159,1595,175,865,386,25,53.8
15,-9,0,15.0,-9.0,0.36986279487609863,435.63861169551996,94,409,-150,1595,175,865,386,25,50.46
13,-10,0,13.0,-10.0,0.37757277488708496,420.01904718714843,94,396,-140,1595,175,865,386,25,45.96
15,-11,0,15.0,-11.0,0.38637495040893555,402.2461932697437,94,381,-129,1595,175,865,386,25,48.09
14,-11,0,14.0,-11.0,0.393535852432251,385.5035667798678,94,367,-118,1595,175,865,386,25,44.99
14,-10,0,14.0,-10.0,0.40158581733703613,369.15173032237027,94,353,-108,1595,175,865,386,25,43.23
17,-10,0,17.0,-10.0,0.41214895248413086,350.0,94,336,-98,1595,175,865,386,25,45.86
15,-10,0,15.0,-10.0,0.4190497398376465,332.84380721293286,94,321,-88,1595,175,865,386,25,41.39
13,-8,0,13.0,-8.0,0.42555785179138184,318.22004965118083,94,308,-80,1595,175,865,386,25,36.73
12,-7,0,12.0,-7.0,0.4335017204284668,304.8688242506931,94,296,-73,1595,175,865,386,25,33.85
13,-6,0,13.0,-6.0,0.4415397644042969,290.82297020696285,94,283,-67,1595,175,865,386,25,34.27
12,-5,0,12.0,-5.0,0.44954490661621094,278.0017985553331,94,271,-62,1595,175,865,386,25,31.72
11,-5,0,11.0,-5.0,0.45752573013305664,266.17475462560304,94,260,-57,1595,175,865,386,25,29.06
10,-4,0,10.0,-4.0,0.4664647579193115,255.55625603768732,94,250,-53,1595,175,865,386,25,26.74
10,-3,0,10.0,-3.0,0.4735267162322998,245.15301344262525,94,240,-50,1595,175,865,386,25,26.59
9,-3,0,9.0,-3.0,0.4815328121185303,235.73289969794203,94,231,-47,1595,175,865,386,25,23.99
9,-3,0,9.0,-3.0,0.48952579498291016,226.3183598385248,94,222,-44,1595,175,865,386,25,23.31
7,-2,0,7.0,-2.0,0.49752092361450195,219.06391761310215,94,215,-42,1595,175,865,386,25,19.91
8,-3,0,8.0,-3.0,0.5055208206176758,210.6418761785035,94,207,-39,1595,175,865,386,25,20.36
8,-2,0,8.0,-2.0,0.5136599540710449,202.41047403728888,94,199,-37,1595,175,865,386,25,20.88
7,-2,0,7.0,-2.0,0.5215599536895752,195.1640335717624,94,192,-35,1595,175,865,386,25,18.37
6,-2,0,6.0,-2.0,0.5295639038085938,188.904737897174,94,186,-33,1595,175,865,386,25,15.96
7,-2,0,7.0,-2.0,0.5375628471374512,181.6645259812713,94,179,-31,1595,175,865,386,25,17.46
9,-2,0,9.0,-2.0,0.5455167293548584,172.45579143653018,94,170,-29,1595,175,865,386,25,20.46
8,-2,0,8.0,-2.0,0.5535788536071777,164.23458831805192,94,162,-27,1595,175,865,386,25,18.07
7,-3,0,7.0,-3.0,0.5624988079071045,156.84705926475002,94,155,-24,1595,175,865,386,25,15.0
8,-3,0,8.0,-3.0,0.5766549110412598,148.49242404917499,94,147,-21,1595,175,865,386,25,15.83
7,-2,0,7.0,-2.0,0.5775988101959229,141.2834031300209,94,140,-19,1595,175,865,386,25,14.56
6,-3,0,6.0,-3.0,0.5901439189910889,134.9518432626987,94,134,-16,1595,175,865,386,25,11.91
7,-2,0,7.0,-2.0,0.5935287475585938,127.76932339180638,94,127,-14,1595,175,865,386,25,13.45
6,-2,0,6.0,-2.0,0.6028759479522705,121.59358535712317,94,121,-12,1595,175,865,386,25,11.56
6,-1,0,6.0,-1.0,0.6095788478851318,115.52488909321661,94,115,-11,1595,175,865,386,25,12.61
6,-1,0,6.0,-1.0,0.6179158687591553,109.45775440780794,94,109,-10,1595,175,865,386,25,12.19
4,0,0,4.0,-0.0,0.6255209445953369,105.47511554864494,94,105,-10,1595,175,865,386,25,9.36
5,-1,0,5.0,-1.0,0.63370680809021,100.40418317978589,94,100,-9,1595,175,865,386,25,10.16
5,-1,0,5.0,-1.0,0.6423988342285156,95.33624704172071,94,95,-8,1595,175,865,386,25,9.82
4,0,0,4.0,-0.0,0.6511528491973877,91.35097153287424,94,91,-8,1595,175,865,386,25,8.85
4,-1,0,4.0,-1.0,0.65753173828125,87.28115489611719,94,87,-7,1595,175,865,386,25,7.93
4,0,0,4.0,-0.0,0.6660208702087402,83.2946576918352,94,83,-7,1595,175,865,386,25,8.55
4,-1,0,4.0,-1.0,0.6752197742462158,79.22752047110903,94,79,-6,1595,175,865,386,25,7.53
3,0,0,3.0,-0.0,0.6815297603607178,76.23647421018367,94,76,-6,1595,175,865,386,25,7.39
3,0,0,3.0,-0.0,0.6895487308502197,73.24616030891995,94,73,-6,1595,175,865,386,25,7.23
2,-1,0,2.0,-1.0,0.6988968849182129,71.17583859709698,94,71,-5,1595,175,865,386,25,4.19
2,0,0,2.0,-0.0,0.7058267593383789,69.18092222571191,94,69,-5,1595,175,865,386,25,6.32
3,0,0,3.0,-0.0,0.7135417461395264,66.18912297349165,94,66,-5,1595,175,865,386,25,7.07
3,0,0,3.0,-0.0,0.7215268611907959,63.198101237299845,94,63,-5,1595,175,865,386,25,6.9
3,0,0,3.0,-0.0,0.7296369075775146,60.207972893961475,94,60,-5,1595,175,865,386,25,6.73
4,0,0,4.0,-0.0,0.7403497695922852,56.22277118748239,94,56,-5,1595,175,865,386,25,7.21
3,1,0,3.0,1.0,0.7455649375915527,53.33854141237835,94,53,-6,1595,175,865,386,25,4.13
2,0,0,2.0,-0.0,0.7542917728424072,51.35172830587107,94,51,-6,1595,175,865,386,25,5.23
1,0,0,1.0,-0.0,0.7643718719482422,50.35871324805669,94,50,-6,1595,175,865,386,25,4.44
2,0,0,2.0,-0.0,0.7698898315429688,48.373546489791295,94,48,-6,1595,175,865,386,25,5.06
2,0,0,2.0,-0.0,0.7776868343353271,46.389654018972806,94,46,-6,1595,175,865,386,25,4.95
1,0,0,1.0,-0.0,0.7888038158416748,45.39823785126467,94,45,-6,1595,175,865,386,25,4.23
2,0,0,2.0,-0.0,0.7935707569122314,43.41658669218482,94,43,-6,1595,175,865,386,25,4.77
2,0,0,2.0,-0.0,0.8016617298126221,41.43669871020132,94,41,-6,1595,175,865,386,25,4.64
1,0,0,1.0,-0.0,0.8135099411010742,40.44749683231337,94,40,-6,1595,175,865,386,25,3.99
3,0,0,3.0,-0.0,0.817896842956543,37.48332962798263,94,37,-6,1595,175,865,386,25,4.9
2,0,0,2.0,-0.0,0.8255307674407959,35.510561809129406,94,35,-6,1595,175,865,386,25,4.24
2,0,0,2.0,-0.0,0.8335368633270264,33.54101966249684,94,33,-6,1595,175,865,386,25,4.09
1,0,0,1.0,-0.0,0.8415877819061279,32.55764119219941,94,32,-6,1595,175,865,386,25,3.55
1,0,0,1.0,-0.0,0.8558497428894043,31.575306807693888,94,31,-6,1595,175,865,386,25,3.49
1,0,0,1.0,-0.0,0.85782790184021,30.59411708155671,94,30,-6,1595,175,865,386,25,3.42
2,0,0,2.0,-0.0,0.8673617839813232,28.635642126552707,94,28,-6,1595,175,865,386,25,3.68
2,0,0,2.0,-0.0,0.8736169338226318,26.68332812825267,94,26,-6,1595,175,865,386,25,3.5
1,0,0,1.0,-0.0,0.8815467357635498,25.709920264364882,94,25,-6,1595,175,865,386,25,3.07
1,0,0,1.0,-0.0,0.8895328044891357,24.73863375370596,94,24,-6,1595,175,865,386,25,2.99
1,0,0,1.0,-0.0,0.8975329399108887,23.769728648009426,94,23,-6,1595,175,865,386,25,2.91
2,0,0,2.0,-0.0,0.9108798503875732,21.840329667841555,94,21,-6,1595,175,865,386,25,3.0
2,0,0,2.0,-0.0,0.9138219356536865,19.924858845171276,94,19,-6,1595,175,865,386,25,2.77
2,0,0,2.0,-0.0,0.9225187301635742,18.027756377319946,94,17,-6,1595,175,865,386,25,2.51
1,0,0,1.0,-0.0,0.9295659065246582,17.08800749063506,94,16,-6,1595,175,865,386,25,2.22
1,-1,0,1.0,-1.0,0.9375977516174316,15.811388300841896,94,15,-5,1595,175,865,386,25,1.83
1,0,0,1.0,-0.0,0.9465517997741699,14.866068747318506,94,14,-5,1595,175,865,386,25,2.2
1,0,0,1.0,-0.0,0.9615557193756104,13.92838827718412,94,13,-5,1595,175,865,386,25,2.06
0,0,1,-0.0,-0.0,-0.001322031021118164,547.5216890681136,95,152,526,1734,706,1582,180,5,143.33
1,0,1,1.0,-0.0,0.0035719871520996094,547.2449177470723,95,151,526,1734,706,1582,180,5,7.57
1,-1,1,1.0,-1.0,0.01039886474609375,547.9315650699456,95,150,527,1734,706,1582,180,5,31.51
0,0,0,-0.0,-0.0,0.06434297561645508,547.9315650699456,95,150,527,1734,706,1582,180,5,143.4
1,0,0,1.0,-0.0,0.08235001564025879,547.6586528121326,95,149,527,1734,706,1582,180,5,7.47
1,0,0,1.0,-0.0,0.13036394119262695,547.3874313500448,95,148,527,1734,706,1582,180,5,7.42
-1,1,0,-1.0,1.0,0.16284799575805664,546.6964422785281,95,149,526,1734,706,1582,180,5,17.25
-1,2,0,-1.0,2.0,0.17147397994995117,545.0467869825488,95,150,524,1734,706,1582,180,5,34.96
-2,2,0,-2.0,2.0,0.1783769130706787,543.6800529723341,95,152,522,1734,706,1582,180,5,29.84
-2,3,0,-2.0,3.0,0.1863718032836914,541.3658651965416,95,154,519,1734,706,1582,180,5,43.82
-1,4,0,-1.0,4.0,0.1953258514404297,537.8196723809942,95,155,515,1734,706,1582,180,5,57.62
-2,5,0,-2.0,5.0,0.2023458480834961,533.6187777805425,95,157,510,1734,706,1582,180,5,62.57
-2,7,0,-2.0,7.0,0.21036601066589355,527.5319895513446,95,159,503,1734,706,1582,180,5,74.6
-2,7,0,-2.0,7.0,0.2187328338623047,521.4757904255958,95,161,496,1734,706,1582,180,5,73.86
-1,7,0,-1.0,7.0,0.22636079788208008,515.135904398053,95,162,489,1734,706,1582,180,5,75.11
0,7,0,-0.0,7.0,0.23434901237487793,508.4958210251093,95,162,482,1734,706,1582,180,5,76.44
0,7,0,-0.0,7.0,0.24234890937805176,501.8655198357425,95,162,475,1734,706,1582,180,5,75.73
0,7,0,-0.0,7.0,0.2504119873046875,495.24539371911374,95,162,468,1734,706,1582,180,5,75.01
0,6,0,-0.0,6.0,0.25833702087402344,489.57941133180833,95,162,462,1734,706,1582,180,5,69.56
1,6,0,1.0,6.0,0.2671329975128174,483.5876342505048,95,161,456,1734,706,1582,180,5,71.65
1,7,0,1.0,7.0,0.27436280250549316,476.656060488063,95,160,449,1734,706,1582,180,5,75.24
1,7,0,1.0,7.0,0.28272390365600586,469.7286450707472,95,159,442,1734,706,1582,180,5,74.49
2,7,0,2.0,7.0,0.2914910316467285,462.4651338209184,95,157,435,1734,706,1582,180,5,76.52
2,7,0,2.0,7.0,0.29834699630737305,455.20215289473316,95,155,428,1734,706,1582,180,5,75.72
4,7,0,4.0,7.0,0.30638599395751953,447.26055046247933,95,151,421,1734,706,1582,180,5,76.23
5,9,0,5.0,9.0,0.31556200981140137,437.10410659246844,95,146,412,1734,706,1582,180,5,81.74
7,10,0,7.0,10.0,0.3223550319671631,425.3527947480773,95,139,402,1734,706,1582,180,5,83.17
7,10,0,7.0,10.0,0.33054184913635254,413.62785206027894,95,132,392,1734,706,1582,180,5,81.53
6,11,0,6.0,11.0,0.3433568477630615,401.29415644885734,95,126,381,1734,706,1582,180,5,81.66
9,12,0,9.0,12.0,0.346343994140625,387.1046370169182,95,117,369,1734,706,1582,180,5,81.81
8,13,0,8.0,13.0,0.35463881492614746,372.3130403303113,95,109,356,1734,706,1582,180,5,80.86
8,16,0,8.0,16.0,0.36234283447265625,354.6843667262486,95,101,340,1734,706,1582,180,5,81.88
9,15,0,9.0,15.0,0.37198400497436523,337.7706322343611,95,92,325,1734,706,1582,180,5,77.92
10,17,0,10.0,17.0,0.37834692001342773,318.7287247801804,95,82,308,1734,706,1582,180,5,76.64
10,17,0,10.0,17.0,0.38635993003845215,299.7749155616594,95,72,291,1734,706,1582,180,5,73.25
9,17,0,9.0,17.0,0.39457082748413086,281.1494264621573,95,63,274,1734,706,1582,180,5,69.9
8,16,0,8.0,16.0,0.4023458957672119,263.79727064547126,95,55,258,1734,706,1582,180,5,65.89
6,15,0,6.0,15.0,0.4104008674621582,247.8911051248108,95,49,243,1734,706,1582,180,5,62.32
6,13,0,6.0,13.0,0.4186069965362549,233.98504225697846,95,43,230,1734,706,1582,180,5,57.54
5,12,0,5.0,12.0,0.42990684509277344,221.28714377477965,95,38,218,1734,706,1582,180,5,54.17
3,10,0,3.0,10.0,0.4344899654388428,210.92415698539605,95,35,208,1734,706,1582,180,5,50.22
3,10,0,3.0,10.0,0.4423379898071289,200.5691900566984,95,32,198,1734,706,1582,180,5,48.4
1,7,0,1.0,7.0,0.45033788681030273,193.49935400408964,95,31,191,1734,706,1582,180,5,43.7
2,8,0,2.0,8.0,0.4588749408721924,185.28356645962967,95,29,183,1734,706,1582,180,5,43.05
0,7,0,-0.0,7.0,0.46634387969970703,178.3732042656632,95,29,176,1734,706,1582,180,5,38.63
1,7,0,1.0,7.0,0.47528886795043945,171.30382365843442,95,28,169,1734,706,1582,180,5,40.21
0,7,0,-0.0,7.0,0.4830939769744873,164.40194646049662,95,28,162,1734,706,1582,180,5,36.43
0,5,0,-0.0,5.0,0.490339994430542,159.47727110782904,95,28,157,1734,706,1582,180,5,30.98
0,6,0,-0.0,6.0,0.49835681915283203,153.57408635573907,95,28,151,1734,706,1582,180,5,32.58
1,4,0,1.0,4.0,0.5070719718933105,149.4590244849738,95,27,147,1734,706,1582,180,5,28.58
0,5,0,-0.0,5.0,0.5143558979034424,144.5441109142811,95,27,142,1734,706,1582,180,5,28.87
1,5,0,1.0,5.0,0.5225028991699219,139.44532978913278,95,26,137,1734,706,1582,180,5,31.76
0,4,0,-0.0,4.0,0.5311048030853271,135.51752654177244,95,26,133,1734,706,1582,180,5,24.86
0,6,0,-0.0,6.0,0.5383358001708984,129.634100452003,95,26,127,1734,706,1582,180,5,28.84
1,5,0,1.0,5.0,0.5463500022888184,124.53513560437472,95,25,122,1734,706,1582,180,5,30.04
0,6,0,-0.0,6.0,0.5547208786010742,118.66338946785567,95,25,116,1734,706,1582,180,5,27.07
1,6,0,1.0,6.0,0.5623409748077393,112.58774356030055,95,24,110,1734,706,1582,180,5,28.35
0,6,0,-0.0,6.0,0.5712099075317383,106.73331251301067,95,24,104,1734,706,1582,180,5,25.08
0,5,0,-0.0,5.0,0.5784080028533936,101.86756107809786,95,24,99,1734,706,1582,180,5,22.43
0,5,0,-0.0,5.0,0.5863478183746338,97.01546268507923,95,24,94,1734,706,1582,180,5,21.63
0,5,0,-0.0,5.0,0.5949199199676514,92.17917335276988,95,24,89,1734,706,1582,180,5,20.81
0,5,0,-0.0,5.0,0.6025378704071045,87.36131867136622,95,24,84,1734,706,1582,180,5,19.99
0,5,0,-0.0,5.0,0.6119430065155029,82.56512580987206,95,24,79,1734,706,1582,180,5,19.15
0,4,0,-0.0,4.0,0.6184108257293701,78.74642849044012,95,24,75,1734,706,1582,180,5,16.68
0,5,0,-0.0,5.0,0.6263539791107178,74.0,95,24,70,1734,706,1582,180,5,17.62
0,3,0,-0.0,3.0,0.636016845703125,71.16881339463234,95,24,67,1734,706,1582,180,5,13.35
0,3,0,-0.0,3.0,0.6423618793487549,68.35202996254024,95,24,64,1734,706,1582,180,5,12.94
1,3,0,1.0,3.0,0.6503520011901855,65.19202405202648,95,23,61,1734,706,1582,180,5,16.22
0,2,0,-0.0,2.0,0.658674955368042,63.324560795950255,95,23,59,1734,706,1582,180,5,9.85
0,4,0,-0.0,4.0,0.6663408279418945,59.61543424315552,95,23,55,1734,706,1582,180,5,13.54
1,3,0,1.0,3.0,0.6743710041046143,56.462376853972415,95,22,52,1734,706,1582,180,5,14.3
0,4,0,-0.0,4.0,0.682365894317627,52.80151512977634,95,22,48,1734,706,1582,180,5,12.4
1,4,0,1.0,4.0,0.6903419494628906,48.75448697299562,95,21,44,1734,706,1582,180,5,13.49
0,2,0,-0.0,2.0,0.6985399723052979,46.95742752749558,95,21,42,1734,706,1582,180,5,7.91
2,3,0,2.0,3.0,0.7064039707183838,43.382023926967726,95,19,39,1734,706,1582,180,5,12.59
0,2,0,-0.0,2.0,0.7143399715423584,41.593268686170845,95,19,37,1734,706,1582,180,5,7.38
1,2,0,1.0,2.0,0.7232270240783691,39.35733730830886,95,18,35,1734,706,1582,180,5,12.52
1,2,0,1.0,2.0,0.7303769588470459,37.12142238654117,95,17,33,1734,706,1582,180,5,12.25
1,1,0,1.0,1.0,0.7384068965911865,35.77708763999664,95,16,32,1734,706,1582,180,5,6.43
0,1,0,-0.0,1.0,0.7466228008270264,34.88552708502482,95,16,31,1734,706,1582,180,5,4.67
1,1,0,1.0,1.0,0.7543590068817139,33.54101966249684,95,15,30,1734,706,1582,180,5,6.26
1,2,0,1.0,2.0,0.7623410224914551,31.304951684997057,95,14,28,1734,706,1582,180,5,12.73
0,1,0,-0.0,1.0,0.7704060077667236,30.4138126514911,95,14,27,1734,706,1582,180,5,4.41
0,1,0,-0.0,1.0,0.7844808101654053,29.5296461204668,95,14,26,1734,706,1582,180,5,4.3
1,1,0,1.0,1.0,0.7880668640136719,28.178005607210743,95,13,25,1734,706,1582,180,5,5.94
1,1,0,1.0,1.0,0.7964119911193848,26.832815729997478,95,12,24,1734,706,1582,180,5,5.74
0,1,0,-0.0,1.0,0.8024449348449707,25.942243542145693,95,12,23,1734,706,1582,180,5,4.15
1,1,0,1.0,1.0,0.8103699684143066,24.596747752497688,95,11,22,1734,706,1582,180,5,5.56
0,1,0,-0.0,1.0,0.8194429874420166,23.706539182259394,95,11,21,1734,706,1582,180,5,4.01
1,0,0,1.0,-0.0,0.8264148235321045,23.259406699226016,95,10,21,1734,706,1582,180,5,1.65
0,2,0,-0.0,2.0,0.8344459533691406,21.470910553583888,95,10,19,1734,706,1582,180,5,5.42
1,1,0,1.0,1.0,0.8434348106384277,20.12461179749811,95,9,18,1734,706,1582,180,5,5.19
1,1,0,1.0,1.0,0.850369930267334,18.788294228055936,95,8,17,1734,706,1582,180,5,4.95
1,2,0,1.0,2.0,0.8583498001098633,16.55294535724685,95,7,15,1734,706,1582,180,5,9.27
1,1,0,1.0,1.0,0.8663280010223389,15.231546211727817,95,6,14,1734,706,1582,180,5,4.45
1,1,0,1.0,1.0,0.8743758201599121,13.92838827718412,95,5,13,1734,706,1582,180,5,4.15
0,1,0,-0.0,1.0,0.8823540210723877,13.0,95,5,12,1734,706,1582,180,5,3.62
1,1,0,1.0,1.0,0.8903348445892334,11.704699910719626,95,4,11,1734,706,1582,180,5,3.84
1,1,0,1.0,1.0,0.8983488082885742,10.44030650891055,95,3,10,1734,706,1582,180,5,3.46
0,1,0,-0.0,1.0,0.9063408374786377,9.486832980505138,95,3,9,1734,706,1582,180,5,3.61
1,1,0,1.0,1.0,0.9143679141998291,8.246211251235321,95,2,8,1734,706,1582,180,5,3.01
0,1,0,-0.0,1.0,0.9223718643188477,7.280109889280518,95,2,7,1734,706,1582,180,5,3.56
1,1,0,1.0,1.0,0.930351972579956,6.082762530298219,95,1,6,1734,706,1582,180,5,2.41
0,1,0,-0.0,1.0,0.9383299350738525,5.0990195135927845,95,1,5,1734,706,1582,180,5,3.73
0,1,0,-0.0,1.0,0.9463818073272705,4.123105625617661,95,1,4,1734,706,1582,180,5,3.21
1,1,0,1.0,1.0,0.954387903213501,3.0,95,0,3,1734,706,1582,180,5,1.26
0,1,0,-0.0,1.0,0.9623539447784424,2.0,95,0,2,1734,706,1582,180,5,8.46
1,1,0,1.0,1.0,0.9703869819641113,1.4142135623730951,95,-1,1,1734,706,1582,180,5,-1.19
0,1,0,-0.0,1.0,0.9783849716186523,1.0,95,-1,0,1734,706,1582,180,5,-1.5
1,1,0,1.0,1.0,0.9887309074401855,2.23606797749979,95,-2,-1,1734,706,1582,180,5,-0.12
1,1,0,1.0,1.0,1.0023539066314697,3.605551275463989,95,-3,-2,1734,706,1582,180,5,1.59
0,0,1,-0.0,-0.0,1.0893518924713135,3.605551275463989,95,-3,-2,1734,706,1582,180,5,27.99
0,0,0,-0.0,-0.0,0.10199093818664551,1564.168788846012,96,-1468,-540,269,168,1737,708,52,262.44
-2,0,0,-2.0,-0.0,0.18395400047302246,1562.291906143023,96,-1466,-540,269,168,1737,708,52,11.13
-4,0,0,-4.0,-0.0,0.19220614433288574,1558.5390595041242,96,-1462,-540,269,168,1737,708,52,19.39
-4,-1,0,-4.0,-1.0,0.19994592666625977,1554.4404137824004,96,-1458,-539,269,168,1737,708,52,22.38
-7,-1,0,-7.0,-1.0,0.20803093910217285,1547.5286750170415,96,-1451,-538,269,168,1737,708,52,32.71
-9,-1,0,-9.0,-1.0,0.21682214736938477,1538.7439683066186,96,-1442,-537,269,168,1737,708,52,39.3
-10,-1,0,-10.0,-1.0,0.22442197799682617,1529.0258336601119,96,-1432,-536,269,168,1737,708,52,42.37
-12,-2,0,-12.0,-2.0,0.23196101188659668,1517.0880000843722,96,-1420,-534,269,168,1737,708,52,49.93
-11,-2,0,-11.0,-2.0,0.23996400833129883,1506.0893067809757,96,-1409,-532,269,168,1737,708,52,46.81
-14,-3,0,-14.0,-3.0,0.2493741512298584,1491.9336446370528,96,-1395,-529,269,168,1737,708,52,56.62
-15,-4,0,-15.0,-4.0,0.2560420036315918,1476.4907720673366,96,-1380,-525,269,168,1737,708,52,60.52
-16,-4,0,-16.0,-4.0,0.2639760971069336,1460.1154063977272,96,-1364,-521,269,168,1737,708,52,62.57
-18,-6,0,-18.0,-6.0,0.2719459533691406,1441.1596025423416,96,-1346,-515,269,168,1737,708,52,70.1
-29,-6,0,-29.0,-6.0,0.2799689769744873,1411.9383839247378,96,-1317,-509,269,168,1737,708,52,90.1
-37,-10,0,-37.0,-10.0,0.28838205337524414,1373.827136141953,96,-1280,-499,269,168,1737,708,52,104.35
-43,-10,0,-43.0,-10.0,0.2976400852203369,1330.146608460887,96,-1237,-489,269,168,1737,708,52,109.97
-48,-12,0,-48.0,-12.0,0.3041961193084717,1281.1127975318957,96,-1189,-477,269,168,1737,708,52,114.43
-50,-14,0,-50.0,-14.0,0.3120429515838623,1229.508031693978,96,-1139,-463,269,168,1737,708,52,114.97
-52,-13,0,-52.0,-13.0,0.32161402702331543,1176.464619102504,96,-1087,-450,269,168,1737,708,52,113.34
-54,-14,0,-54.0,-14.0,0.327955961227417,1121.2426142454628,96,-1033,-436,269,168,1737,708,52,112.48
-54,-13,0,-54.0,-13.0,0.33605504035949707,1066.4755037036716,96,-979,-423,269,168,1737,708,52,108.7
-52,-13,0,-52.0,-13.0,0.3453099727630615,1013.6217243133653,96,-927,-410,269,168,1737,708,52,103.81
-48,-13,0,-48.0,-13.0,0.3522219657897949,964.4946863513557,96,-879,-397,269,168,1737,708,52,97.44
-45,-14,0,-45.0,-14.0,0.3629591464996338,917.7390696706772,96,-834,-383,269,168,1737,708,52,92.64
-39,-12,0,-39.0,-12.0,0.3680391311645508,877.306103934083,96,-795,-371,269,168,1737,708,52,83.57
-37,-13,0,-37.0,-13.0,0.37604212760925293,838.2887330747086,96,-758,-358,269,168,1737,708,52,80.19
-31,-13,0,-31.0,-13.0,0.3867361545562744,804.7074002393665,96,-727,-345,269,168,1737,708,52,72.98
-29,-12,0,-29.0,-12.0,0.3921520709991455,773.3647263743027,96,-698,-333,269,168,1737,708,52,68.39
-26,-11,0,-26.0,-11.0,0.4002089500427246,745.1630694015907,96,-672,-322,269,168,1737,708,52,63.02
-23,-10,0,-23.0,-10.0,0.4111320972442627,720.1006874041991,96,-649,-312,269,168,1737,708,52,57.72
-21,-10,0,-21.0,-10.0,0.4159810543060303,696.8414453805112,96,-628,-302,269,168,1737,708,52,55.64
-21,-10,0,-21.0,-10.0,0.42444396018981934,673.5822147295755,96,-607,-292,269,168,1737,708,52,54.57
-22,-9,0,-22.0,-9.0,0.4319429397583008,649.8569073265284,96,-585,-283,269,168,1737,708,52,52.0
-19,-8,0,-19.0,-8.0,0.44125795364379883,629.2702122300085,96,-566,-275,269,168,1737,708,52,46.78
-18,-8,0,-18.0,-8.0,0.44835400581359863,609.5842845743318,96,-548,-267,269,168,1737,708,52,45.07
-17,-8,0,-17.0,-8.0,0.4560239315032959,590.7977657371429,96,-531,-259,269,168,1737,708,52,43.76
-17,-8,0,-17.0,-8.0,0.4653661251068115,572.0113635234881,96,-514,-251,269,168,1737,708,52,42.93
-16,-8,0,-16.0,-8.0,0.47203803062438965,554.1236324142835,96,-498,-243,269,168,1737,708,52,41.13
-17,-8,0,-17.0,-8.0,0.48023414611816406,535.3372768638478,96,-481,-235,269,168,1737,708,52,41.32
-19,-9,0,-19.0,-9.0,0.48993992805480957,514.3150785267724,96,-462,-226,269,168,1737,708,52,43.42
-20,-10,0,-20.0,-10.0,0.49597811698913574,491.9552825206779,96,-442,-216,269,168,1737,708,52,44.14
-21,-10,0,-21.0,-10.0,0.5044901371002197,468.697130351787,96,-421,-206,269,168,1737,708,52,43.82
-21,-10,0,-21.0,-10.0,0.5119640827178955,445.43910919451156,96,-400,-196,269,168,1737,708,52,42.48
-19,-8,0,-19.0,-8.0,0.5200591087341309,424.8588000736245,96,-381,-188,269,168,1737,708,52,36.77
-18,-8,0,-18.0,-8.0,0.5287721157073975,405.1777387764535,96,-363,-180,269,168,1737,708,52,35.12
-16,-8,0,-16.0,-8.0,0.5386030673980713,387.28929755416686,96,-347,-172,269,168,1737,708,52,33.96
-16,-7,0,-16.0,-7.0,0.5440599918365479,369.845913861435,96,-331,-165,269,168,1737,708,52,30.61
-13,-7,0,-13.0,-7.0,0.5521941184997559,355.0887213077881,96,-318,-158,269,168,1737,708,52,27.3
-13,-6,0,-13.0,-6.0,0.5599291324615479,340.77705321808276,96,-305,-152,269,168,1737,708,52,26.23
-14,-7,0,-14.0,-7.0,0.5683081150054932,325.12459150301135,96,-291,-145,269,168,1737,708,52,28.6
-16,-6,0,-16.0,-6.0,0.5773601531982422,308.1330881291394,96,-275,-139,269,168,1737,708,52,25.94
-14,-5,0,-14.0,-5.0,0.591123104095459,293.3888205095757,96,-261,-134,269,168,1737,708,52,22.7
-13,-4,0,-13.0,-4.0,0.5919661521911621,280.0071427660373,96,-248,-130,269,168,1737,708,52,20.22
-12,-4,0,-12.0,-4.0,0.5999600887298584,267.52943763257156,96,-236,-126,269,168,1737,708,52,18.85
-10,-4,0,-10.0,-4.0,0.6079521179199219,256.82678987987214,96,-226,-122,269,168,1737,708,52,17.09
-10,-4,0,-10.0,-4.0,0.6162710189819336,246.13004692641653,96,-216,-118,269,168,1737,708,52,16.59
-9,-4,0,-9.0,-4.0,0.6272859573364258,236.31546711969574,96,-207,-114,269,168,1737,708,52,15.75
-8,-4,0,-8.0,-4.0,0.6319739818572998,227.37853900489378,96,-199,-110,269,168,1737,708,52,15.4
-8,-4,0,-8.0,-4.0,0.6399600505828857,218.44221203787512,96,-191,-106,269,168,1737,708,52,15.03
-8,-4,0,-8.0,-4.0,0.6519849300384521,209.50656314301946,96,-183,-102,269,168,1737,708,52,14.65
-6,-4,0,-6.0,-4.0,0.6559610366821289,202.31905496022858,96,-177,-98,269,168,1737,708,52,12.01
-6,-4,0,-6.0,-4.0,0.6643099784851074,195.13328778042973,96,-171,-94,269,168,1737,708,52,11.74
-7,-4,0,-7.0,-4.0,0.6719441413879395,187.0721785835617,96,-164,-90,269,168,1737,708,52,13.97
-9,-5,0,-9.0,-5.0,0.6802980899810791,176.7766952966369,96,-155,-85,269,168,1737,708,52,16.2
-9,-5,0,-9.0,-5.0,0.6879711151123047,166.48123017325406,96,-146,-80,269,168,1737,708,52,15.72
-10,-5,0,-10.0,-5.0,0.6959400177001953,155.30936868070773,96,-136,-75,269,168,1737,708,52,14.24
-10,-5,0,-10.0,-5.0,0.7041110992431641,144.138821973818,96,-126,-70,269,168,1737,708,52,13.6
-8,-5,0,-8.0,-5.0,0.7120089530944824,134.71822445385777,96,-118,-65,269,168,1737,708,52,11.73
-8,-4,0,-8.0,-4.0,0.7199580669403076,125.78155667664477,96,-110,-61,269,168,1737,708,52,11.33
-8,-4,0,-8.0,-4.0,0.7280910015106201,116.84605256490268,96,-102,-57,269,168,1737,708,52,10.84
-5,-3,0,-5.0,-3.0,0.7360601425170898,111.01801655587259,96,-97,-54,269,168,1737,708,52,9.14
-4,-4,0,-4.0,-4.0,0.7439630031585693,105.58882516630251,96,-93,-50,269,168,1737,708,52,5.94
-4,-3,0,-4.0,-3.0,0.7522311210632324,100.64790112068906,96,-89,-47,269,168,1737,708,52,6.36
-3,-3,0,-3.0,-3.0,0.7600820064544678,96.60227740586657,96,-86,-44,269,168,1737,708,52,4.8
-4,-3,0,-4.0,-3.0,0.7679569721221924,91.67878707749138,96,-82,-41,269,168,1737,708,52,5.91
-4,-3,0,-4.0,-3.0,0.7760090827941895,86.76404785393545,96,-78,-38,269,168,1737,708,52,5.69
-6,-4,0,-6.0,-4.0,0.783959150314331,79.62411694957753,96,-72,-34,269,168,1737,708,52,6.82
-5,-4,0,-5.0,-4.0,0.7925629615783691,73.40980860893181,96,-67,-30,269,168,1737,708,52,5.41
-7,-4,0,-7.0,-4.0,0.7999391555786133,65.39113089708727,96,-60,-26,269,168,1737,708,52,6.9
-5,-3,0,-5.0,-3.0,0.8079559803009033,59.61543424315552,96,-55,-23,269,168,1737,708,52,5.49
-5,-2,0,-5.0,-2.0,0.8160021305084229,54.230987451824994,96,-50,-21,269,168,1737,708,52,7.68
-3,-2,0,-3.0,-2.0,0.8262159824371338,50.695167422546305,96,-47,-19,269,168,1737,708,52,3.98
-3,-2,0,-3.0,-2.0,0.8319549560546875,47.16990566028302,96,-44,-17,269,168,1737,708,52,3.77
-4,-2,0,-4.0,-2.0,0.8401410579681396,42.720018726587654,96,-40,-15,269,168,1737,708,52,4.87
-4,-2,0,-4.0,-2.0,0.8479509353637695,38.27531841800928,96,-36,-13,269,168,1737,708,52,4.55
-2,-2,0,-2.0,-2.0,0.8560740947723389,35.73513677041127,96,-34,-11,269,168,1737,708,52,2.12
-2,-1,0,-2.0,-1.0,0.8641560077667236,33.52610922848042,96,-32,-10,269,168,1737,708,52,3.53
-1,0,0,-1.0,-0.0,0.871955156326294,32.57299494980466,96,-31,-10,269,168,1737,708,52,2.44
0,-1,0,-0.0,-1.0,0.8803260326385498,32.28002478313795,96,-31,-9,269,168,1737,708,52,0.26
-1,0,0,-1.0,-0.0,0.8880541324615479,31.32091952673165,96,-30,-9,269,168,1737,708,52,2.52
0,0,1,-0.0,-0.0,0.9179580211639404,31.32091952673165,96,-30,-9,269,168,1737,708,52,36.36
0,0,0,-0.0,-0.0,0.08494186401367188,1384.9014405364737,97,1056,896,1355,1073,299,177,52,246.08
2,2,0,2.0,2.0,0.12700796127319336,1382.082486684496,97,1054,894,1355,1073,299,177,52,16.41
4,4,0,4.0,4.0,0.13497686386108398,1376.4446955835167,97,1050,890,1355,1073,299,177,52,27.43
5,3,0,5.0,3.0,0.14493393898010254,1370.6910665791909,97,1045,887,1355,1073,299,177,52,26.94
6,5,0,6.0,5.0,0.15095281600952148,1362.8811393514843,97,1039,882,1355,1073,299,177,52,37.0
6,4,0,6.0,4.0,0.1589357852935791,1355.7186286246863,97,1033,878,1355,1073,299,177,52,32.3
6,5,0,6.0,5.0,0.16701984405517578,1347.9087506207532,97,1027,873,1355,1073,299,177,52,36.78
7,5,0,7.0,5.0,0.17495989799499512,1339.3371494885073,97,1020,868,1355,1073,299,177,52,37.29
8,7,0,8.0,7.0,0.1838698387145996,1328.7080190922309,97,1012,861,1355,1073,299,177,52,45.47
12,10,0,12.0,10.0,0.19089198112487793,1313.0883443241737,97,1000,851,1355,1073,299,177,52,59.62
12,11,0,12.0,11.0,0.19892382621765137,1296.8207277800582,97,988,840,1355,1073,299,177,52,59.91
16,13,0,16.0,13.0,0.2069239616394043,1276.21040585007,97,972,827,1355,1073,299,177,52,70.29
18,14,0,18.0,14.0,0.21565580368041992,1253.4292959716556,97,954,813,1355,1073,299,177,52,73.67
21,16,0,21.0,16.0,0.22292685508728027,1227.0688652231381,97,933,797,1355,1073,299,177,52,79.68
21,17,0,21.0,17.0,0.23093390464782715,1200.059998500075,97,912,780,1355,1073,299,177,52,80.7
21,19,0,21.0,19.0,0.23909997940063477,1171.7516801780146,97,891,761,1355,1073,299,177,52,81.94
23,19,0,23.0,19.0,0.24692296981811523,1141.922939606697,97,868,742,1355,1073,299,177,52,83.85
24,20,0,24.0,20.0,0.25498080253601074,1110.6844736467688,97,844,722,1355,1073,299,177,52,85.08
23,19,0,23.0,19.0,0.26317596435546875,1080.856142139184,97,821,703,1355,1073,299,177,52,81.37
22,20,0,22.0,20.0,0.2741398811340332,1051.1374791148871,97,799,683,1355,1073,299,177,52,79.48
22,20,0,22.0,20.0,0.2790408134460449,1021.4196003602045,97,777,663,1355,1073,299,177,52,78.21
21,19,0,21.0,19.0,0.2870299816131592,993.1122796542192,97,756,644,1355,1073,299,177,52,74.85
21,19,0,21.0,19.0,0.29492783546447754,964.8056799169458,97,735,625,1355,1073,299,177,52,73.63
21,20,0,21.0,20.0,0.30338501930236816,935.853086760951,97,714,605,1355,1073,299,177,52,72.69
21,19,0,21.0,19.0,0.3109569549560547,907.5488967543291,97,693,586,1355,1073,299,177,52,71.07
21,18,0,21.0,18.0,0.32202601432800293,879.8909023282375,97,672,568,1355,1073,299,177,52,70.08
19,17,0,19.0,17.0,0.327009916305542,854.4062265690718,97,653,551,1355,1073,299,177,52,64.59
21,19,0,21.0,19.0,0.33495187759399414,826.1041096617303,97,632,532,1355,1073,299,177,52,67.32
19,17,0,19.0,17.0,0.34291887283325195,800.621008967414,97,613,515,1355,1073,299,177,52,62.19
21,18,0,21.0,18.0,0.35123300552368164,772.9637766415707,97,592,497,1355,1073,299,177,52,64.97
21,20,0,21.0,20.0,0.3588988780975342,744.0228491115041,97,571,477,1355,1073,299,177,52,63.55
23,21,0,23.0,21.0,0.3669168949127197,712.9095314273754,97,548,456,1355,1073,299,177,52,65.08
24,21,0,24.0,21.0,0.3749198913574219,681.0293679423818,97,524,435,1355,1073,299,177,52,64.84
24,21,0,24.0,21.0,0.383389949798584,649.1502137410108,97,500,414,1355,1073,299,177,52,62.98
24,21,0,24.0,21.0,0.39125490188598633,617.2722251972788,97,476,393,1355,1073,299,177,52,61.07
23,20,0,23.0,20.0,0.3989219665527344,586.8032038085681,97,453,373,1355,1073,299,177,52,57.8
22,19,0,22.0,19.0,0.40710997581481934,557.742772252586,97,431,354,1355,1073,299,177,52,54.64
23,18,0,23.0,18.0,0.4149188995361328,528.5451730930857,97,408,336,1355,1073,299,177,52,53.03
20,17,0,20.0,17.0,0.4230070114135742,502.2997113278087,97,388,319,1355,1073,299,177,52,48.71
20,16,0,20.0,16.0,0.43251991271972656,476.689626486669,97,368,303,1355,1073,299,177,52,46.65
18,15,0,18.0,15.0,0.4414329528808594,453.25930768159634,97,350,288,1355,1073,299,177,52,43.46
17,13,0,17.0,13.0,0.44715380668640137,431.87266641916574,97,333,275,1355,1073,299,177,52,38.59
15,13,0,15.0,13.0,0.4549248218536377,412.02912518413063,97,318,262,1355,1073,299,177,52,36.21
14,11,0,14.0,11.0,0.465595006942749,394.2296285161733,97,304,251,1355,1073,299,177,52,33.0
11,11,0,11.0,11.0,0.47094082832336426,378.74661714660897,97,293,240,1355,1073,299,177,52,27.94
12,10,0,12.0,10.0,0.48018383979797363,363.1266996517882,97,281,230,1355,1073,299,177,52,29.75
9,9,0,9.0,9.0,0.4895448684692383,350.46397817750113,97,272,221,1355,1073,299,177,52,23.25
9,8,0,9.0,8.0,0.4949209690093994,338.43463179763387,97,263,213,1355,1073,299,177,52,22.96
10,8,0,10.0,8.0,0.5029079914093018,325.6286228205377,97,253,205,1355,1073,299,177,52,24.98
9,8,0,9.0,8.0,0.5109198093414307,313.6000637755037,97,244,197,1355,1073,299,177,52,21.93
11,8,0,11.0,8.0,0.5189669132232666,300.0166662037294,97,233,189,1355,1073,299,177,52,22.95
11,9,0,11.0,9.0,0.5304749011993408,285.80412873154927,97,222,180,1355,1073,299,177,52,24.9
12,9,0,12.0,9.0,0.5354108810424805,270.8154353060401,97,210,171,1355,1073,299,177,52,23.27
12,9,0,12.0,9.0,0.5429348945617676,255.82806726393412,97,198,162,1355,1073,299,177,52,22.42
11,7,0,11.0,7.0,0.5509128570556641,242.88680491125902,97,187,155,1355,1073,299,177,52,18.55
12,9,0,12.0,9.0,0.5589067935943604,227.9056822459677,97,175,146,1355,1073,299,177,52,20.67
10,8,0,10.0,8.0,0.5670499801635742,215.10230124292022,97,165,138,1355,1073,299,177,52,19.1
8,6,0,8.0,6.0,0.5749168395996094,205.11703976023054,97,157,132,1355,1073,299,177,52,15.19
8,7,0,8.0,7.0,0.5829048156738281,194.48907424325924,97,149,125,1355,1073,299,177,52,16.33
7,6,0,7.0,6.0,0.597761869430542,185.27007313648906,97,142,119,1355,1073,299,177,52,15.25
8,7,0,8.0,7.0,0.5989799499511719,174.64249196572982,97,134,112,1355,1073,299,177,52,15.37
7,6,0,7.0,6.0,0.6102819442749023,165.42369842317032,97,127,106,1355,1073,299,177,52,14.34
8,6,0,8.0,6.0,0.6149358749389648,155.43809056984713,97,119,100,1355,1073,299,177,52,13.05
7,5,0,7.0,5.0,0.6234598159790039,146.8638825579659,97,112,95,1355,1073,299,177,52,11.17
6,4,0,6.0,4.0,0.6308989524841309,139.70325694127536,97,106,91,1355,1073,299,177,52,9.4
5,3,0,5.0,3.0,0.6389398574829102,133.9589489358587,97,101,88,1355,1073,299,177,52,7.71
5,3,0,5.0,3.0,0.6470048427581787,128.22246293064254,97,96,85,1355,1073,299,177,52,7.47
5,4,0,5.0,4.0,0.6549220085144043,121.82774724995944,97,91,81,1355,1073,299,177,52,9.31
5,4,0,5.0,4.0,0.6687169075012207,115.43396380615195,97,86,77,1355,1073,299,177,52,9.03
5,4,0,5.0,4.0,0.6709809303283691,109.04127658827184,97,81,73,1355,1073,299,177,52,8.74
6,5,0,6.0,5.0,0.6807699203491211,101.23734488813898,97,75,68,1355,1073,299,177,52,9.65
6,5,0,6.0,5.0,0.6869568824768066,93.43446901438462,97,69,63,1355,1073,299,177,52,9.22
8,5,0,8.0,5.0,0.6956539154052734,84.17244204607586,97,61,58,1355,1073,299,177,52,7.52
8,5,0,8.0,5.0,0.7040069103240967,74.95331880577403,97,53,53,1355,1073,299,177,52,6.85
7,5,0,7.0,5.0,0.7108988761901855,66.48308055437865,97,46,48,1355,1073,299,177,52,6.4
7,3,0,7.0,3.0,0.718904972076416,59.54829972383762,97,39,45,1355,1073,299,177,52,4.26
6,4,0,6.0,4.0,0.7269020080566406,52.630789467763066,97,33,41,1355,1073,299,177,52,4.5
5,2,0,5.0,2.0,0.7349438667297363,48.010415536631214,97,28,39,1355,1073,299,177,52,2.72
5,3,0,5.0,3.0,0.7429399490356445,42.720018726587654,97,23,36,1355,1073,299,177,52,3.0
3,3,0,3.0,3.0,0.7509148120880127,38.58756276314948,97,20,33,1355,1073,299,177,52,3.51
3,2,0,3.0,2.0,0.7589378356933594,35.35533905932738,97,17,31,1355,1073,299,177,52,2.2
2,1,0,2.0,1.0,0.7669439315795898,33.54101966249684,97,15,30,1355,1073,299,177,52,1.49
1,1,0,1.0,1.0,0.7757968902587891,32.202484376209235,97,14,29,1355,1073,299,177,52,2.37
1,1,0,1.0,1.0,0.7829129695892334,30.870698080866262,97,13,28,1355,1073,299,177,52,2.28
1,1,0,1.0,1.0,0.7909138202667236,29.546573405388315,97,12,27,1355,1073,299,177,52,2.19
1,0,0,1.0,-0.0,0.8057618141174316,29.154759474226502,97,11,27,1355,1073,299,177,52,0.38
0,1,0,-0.0,1.0,0.8149099349975586,28.231188426986208,97,11,26,1355,1073,299,177,52,2.03
0,0,1,-0.0,-0.0,-0.0027887821197509766,914.4796334528178,98,-592,-697,752,350,1344,1047,53,195.35
0,0,0,-0.0,-0.0,0.09125113487243652,914.4796334528178,98,-592,-697,752,350,1344,1047,53,195.35
-1,-2,0,-1.0,-2.0,0.16027426719665527,912.3080620053732,98,-591,-695,752,350,1344,1047,53,10.14
-3,-2,0,-3.0,-2.0,0.17046618461608887,908.8415703520609,98,-588,-693,752,350,1344,1047,53,14.05
-4,-4,0,-4.0,-4.0,0.17621111869812012,903.2037422420259,98,-584,-689,752,350,1344,1047,53,22.07
-4,-4,0,-4.0,-4.0,0.1862480640411377,897.5661535508121,98,-580,-685,752,350,1344,1047,53,22.0
-6,-5,0,-6.0,-5.0,0.19250106811523438,889.8741484052674,98,-574,-680,752,350,1344,1047,53,26.61
-10,-7,0,-10.0,-7.0,0.20022916793823242,878.0802924562195,98,-564,-673,752,350,1344,1047,53,36.01
-14,-11,0,-14.0,-11.0,0.21043014526367188,860.6648592803124,98,-550,-662,752,350,1344,1047,53,47.71
-19,-12,0,-19.0,-12.0,0.21625018119812012,839.3217499862612,98,-531,-650,752,350,1344,1047,53,53.52
-20,-13,0,-20.0,-13.0,0.2243661880493164,816.6333326530334,98,-511,-637,752,350,1344,1047,53,54.89
-20,-15,0,-20.0,-15.0,0.23420310020446777,792.4424269308149,98,-491,-622,752,350,1344,1047,53,56.55
-21,-17,0,-21.0,-17.0,0.2402491569519043,766.110305373841,98,-470,-605,752,350,1344,1047,53,58.7
-22,-19,0,-22.0,-19.0,0.24824810028076172,737.6313442364011,98,-448,-586,752,350,1344,1047,53,60.42
-27,-23,0,-27.0,-23.0,0.25797224044799805,703.0007112371935,98,-421,-563,752,350,1344,1047,53,65.83
-28,-23,0,-28.0,-23.0,0.26427626609802246,667.8689991308175,98,-393,-540,752,350,1344,1047,53,64.14
-29,-21,0,-29.0,-21.0,0.2725062370300293,633.9219194822025,98,-364,-519,752,350,1344,1047,53,60.49
-29,-20,0,-29.0,-20.0,0.2813100814819336,601.0207983090103,98,-335,-499,752,350,1344,1047,53,57.24
-27,-19,0,-27.0,-19.0,0.2882192134857178,570.3192088646498,98,-308,-480,752,350,1344,1047,53,53.06
-23,-18,0,-23.0,-18.0,0.2962052822113037,542.8342288397075,98,-285,-462,752,350,1344,1047,53,48.13
-20,-16,0,-20.0,-16.0,0.3061811923980713,518.7880106556049,98,-265,-446,752,350,1344,1047,53,42.89
-19,-15,0,-19.0,-15.0,0.3122062683105469,496.26303509328596,98,-246,-431,752,350,1344,1047,53,39.83
-18,-15,0,-18.0,-15.0,0.3202221393585205,474.3838108536167,98,-228,-416,752,350,1344,1047,53,37.97
-14,-14,0,-14.0,-14.0,0.3318440914154053,455.411901469428,98,-214,-402,752,350,1344,1047,53,33.9
-11,-13,0,-11.0,-13.0,0.33626317977905273,438.78240621064106,98,-203,-389,752,350,1344,1047,53,30.62
-9,-12,0,-9.0,-12.0,0.34418725967407227,423.9870281034551,98,-194,-377,752,350,1344,1047,53,27.99
-7,-12,0,-7.0,-12.0,0.3522062301635742,410.11461812522606,98,-187,-365,752,350,1344,1047,53,27.64
-7,-12,0,-7.0,-12.0,0.3606252670288086,396.24361193588976,98,-180,-353,752,350,1344,1047,53,27.04
-7,-13,0,-7.0,-13.0,0.3682222366333008,381.4826339428834,98,-173,-340,752,350,1344,1047,53,28.47
-6,-13,0,-6.0,-13.0,0.3762052059173584,367.17570725743826,98,-167,-327,752,350,1344,1047,53,26.76
-5,-14,0,-5.0,-14.0,0.3841891288757324,352.4386471430169,98,-162,-313,752,350,1344,1047,53,25.13
-6,-12,0,-6.0,-12.0,0.3923022747039795,339.0235979987234,98,-156,-301,752,350,1344,1047,53,25.45
-5,-12,0,-5.0,-12.0,0.40117406845092773,326.0705445145268,98,-151,-289,752,350,1344,1047,53,22.51
-6,-12,0,-6.0,-12.0,0.41069817543029785,312.65636088203934,98,-145,-277,752,350,1344,1047,53,24.11
-7,-11,0,-7.0,-11.0,0.4162020683288574,299.66648127543397,98,-138,-266,752,350,1344,1047,53,21.4
-6,-11,0,-6.0,-11.0,0.4273982048034668,287.1393389976372,98,-132,-255,752,350,1344,1047,53,21.92
-6,-11,0,-6.0,-11.0,0.4322330951690674,274.612454196819,98,-126,-244,752,350,1344,1047,53,21.33
-7,-11,0,-7.0,-11.0,0.4403252601623535,261.6295090390226,98,-119,-233,752,350,1344,1047,53,19.6
-7,-11,0,-7.0,-11.0,0.4517812728881836,248.65236777477105,98,-112,-222,752,350,1344,1047,53,18.92
-5,-10,0,-5.0,-10.0,0.45639920234680176,237.4721036248258,98,-107,-212,752,350,1344,1047,53,19.52
-6,-11,0,-6.0,-11.0,0.4642190933227539,224.94888308235718,98,-101,-201,752,350,1344,1047,53,18.68
-4,-11,0,-4.0,-11.0,0.47521424293518066,213.32838535928593,98,-97,-190,752,350,1344,1047,53,15.79
-5,-11,0,-5.0,-11.0,0.4805440902709961,201.25854019146615,98,-92,-179,752,350,1344,1047,53,16.77
-4,-10,0,-4.0,-10.0,0.4882371425628662,190.53870997778904,98,-88,-169,752,350,1344,1047,53,14.29
-6,-12,0,-6.0,-12.0,0.49973106384277344,177.12425017484196,98,-82,-157,752,350,1344,1047,53,17.62
-6,-11,0,-6.0,-11.0,0.5043442249298096,164.59647626847908,98,-76,-146,752,350,1344,1047,53,16.25
-7,-9,0,-7.0,-9.0,0.5122032165527344,153.39491516996253,98,-69,-137,752,350,1344,1047,53,12.0
-7,-9,0,-7.0,-9.0,0.5201961994171143,142.22517358048822,98,-62,-128,752,350,1344,1047,53,11.32
-7,-9,0,-7.0,-9.0,0.5296902656555176,131.0953851209111,98,-55,-119,752,350,1344,1047,53,10.61
-5,-7,0,-5.0,-7.0,0.5362861156463623,122.65398485169571,98,-50,-112,752,350,1344,1047,53,8.8
-4,-6,0,-4.0,-6.0,0.5445141792297363,115.55085460523432,98,-46,-106,752,350,1344,1047,53,7.87
-4,-6,0,-4.0,-6.0,0.5521881580352783,108.46197490364999,98,-42,-100,752,350,1344,1047,53,7.51
-5,-6,0,-5.0,-6.0,0.5603461265563965,101.01980003939822,98,-37,-94,752,350,1344,1047,53,6.69
-5,-7,0,-5.0,-7.0,0.5701572895050049,92.69843580125827,98,-32,-87,752,350,1344,1047,53,7.02
-4,-7,0,-4.0,-7.0,0.5787961483001709,84.75848040166836,98,-28,-80,752,350,1344,1047,53,7.02
-4,-6,0,-4.0,-6.0,0.5845251083374023,77.79460135510689,98,-24,-74,752,350,1344,1047,53,5.73
-3,-5,0,-3.0,-5.0,0.5922181606292725,72.12489168102785,98,-21,-69,752,350,1344,1047,53,5.14
-2,-5,0,-2.0,-5.0,0.6001882553100586,66.76076692189807,98,-19,-64,752,350,1344,1047,53,6.15
-2,-4,0,-2.0,-4.0,0.608208179473877,62.36184731067546,98,-17,-60,752,350,1344,1047,53,4.69
-2,-5,0,-2.0,-5.0,0.6162242889404297,57.0087712549569,98,-15,-55,752,350,1344,1047,53,5.51
-1,-3,0,-1.0,-3.0,0.6241981983184814,53.85164807134504,98,-14,-52,752,350,1344,1047,53,5.54
0,-4,0,-0.0,-4.0,0.632540225982666,50.0,98,-14,-48,752,350,1344,1047,53,3.56
-1,-4,0,-1.0,-4.0,0.6401851177215576,45.880278987817846,98,-13,-44,752,350,1344,1047,53,6.0
-1,-3,0,-1.0,-3.0,0.6481852531433105,42.720018726587654,98,-12,-41,752,350,1344,1047,53,5.8
0,-4,0,-0.0,-4.0,0.6564412117004395,38.897300677553446,98,-12,-37,752,350,1344,1047,53,3.04
0,-2,0,-0.0,-2.0,0.6641852855682373,37.0,98,-12,-35,752,350,1344,1047,53,2.55
-1,-2,0,-1.0,-2.0,0.6722612380981445,34.785054261852174,98,-11,-33,752,350,1344,1047,53,3.72
0,-2,0,-0.0,-2.0,0.6802992820739746,32.89376840679705,98,-11,-31,752,350,1344,1047,53,2.41
0,-1,0,-0.0,-1.0,0.6887311935424805,31.953090617340916,98,-11,-30,752,350,1344,1047,53,2.26
0,-1,0,-0.0,-1.0,0.6962392330169678,31.016124838541646,98,-11,-29,752,350,1344,1047,53,2.2
0,0,1,-0.0,-0.0,0.734201192855835,31.016124838541646,98,-11,-29,752,350,1344,1047,53,36.260000000000005
0,0,0,-0.0,-0.0,0.08019161224365234,1259.816256443772,99,1124,569,1887,948,763,379,21,233.83
2,3,0,2.0,3.0,0.1772305965423584,1256.678160866974,99,1122,566,1887,948,763,379,21,31.17
3,2,0,3.0,2.0,0.1883106231689453,1253.0989585822822,99,1119,564,1887,948,763,379,21,36.61
5,6,0,5.0,6.0,0.1933305263519287,1245.9373981063416,99,1114,558,1887,948,763,379,21,59.37
9,6,0,9.0,6.0,0.20525145530700684,1235.2040317291714,99,1105,552,1887,948,763,379,21,79.52
13,9,0,13.0,9.0,0.21351051330566406,1219.5544268297335,99,1092,543,1887,948,763,379,21,98.55
18,11,0,18.0,11.0,0.2171785831451416,1198.5407794480755,99,1074,532,1887,948,763,379,21,114.35
25,13,0,25.0,13.0,0.22598052024841309,1170.3683180947783,99,1049,519,1887,948,763,379,21,130.24
29,15,0,29.0,15.0,0.2369706630706787,1137.7240438700414,99,1020,504,1887,948,763,379,21,135.92
32,13,0,32.0,13.0,0.24125456809997559,1103.2792031031854,99,988,491,1887,948,763,379,21,134.83
34,13,0,34.0,13.0,0.24944543838500977,1067.0520137275407,99,954,478,1887,948,763,379,21,134.4
36,13,0,36.0,13.0,0.2571704387664795,1029.0524767960087,99,918,465,1887,948,763,379,21,133.61
33,12,0,33.0,12.0,0.26529645919799805,994.2001810500741,99,885,453,1887,948,763,379,21,127.02
32,11,0,32.0,11.0,0.2766904830932617,960.7148380242703,99,853,442,1887,948,763,379,21,122.49
31,11,0,31.0,11.0,0.28149843215942383,928.1406143467702,99,822,431,1887,948,763,379,21,118.86
30,11,0,30.0,11.0,0.28924059867858887,896.4730893897485,99,792,420,1887,948,763,379,21,115.28
29,10,0,29.0,10.0,0.2972264289855957,866.1806970834665,99,763,410,1887,948,763,379,21,110.81
28,10,0,28.0,10.0,0.3051795959472656,836.7944789492818,99,735,400,1887,948,763,379,21,107.3
28,11,0,28.0,11.0,0.3141286373138428,806.9510517993021,99,707,389,1887,948,763,379,21,105.9
29,10,0,29.0,10.0,0.3214704990386963,776.739982233437,99,678,379,1887,948,763,379,21,103.58
28,10,0,28.0,10.0,0.32921266555786133,747.4362849099581,99,650,369,1887,948,763,379,21,100.0
26,10,0,26.0,10.0,0.337909460067749,719.900687595171,99,624,359,1887,948,763,379,21,95.43
25,9,0,25.0,9.0,0.34517550468444824,693.7586035502551,99,599,350,1887,948,763,379,21,91.05
23,8,0,23.0,8.0,0.3531785011291504,669.8805863734223,99,576,342,1887,948,763,379,21,85.5
21,7,0,21.0,7.0,0.3614084720611572,648.2669203345177,99,555,335,1887,948,763,379,21,79.88
21,8,0,21.0,8.0,0.3691844940185547,626.1669106556175,99,534,327,1887,948,763,379,21,79.23
19,7,0,19.0,7.0,0.3772716522216797,606.320872146094,99,515,320,1887,948,763,379,21,73.63
18,8,0,18.0,8.0,0.38651251792907715,586.8159847856907,99,497,312,1887,948,763,379,21,71.99
16,7,0,16.0,7.0,0.3951904773712158,569.5489443410461,99,481,305,1887,948,763,379,21,66.34
16,8,0,16.0,8.0,0.4012124538421631,551.7553805809238,99,465,297,1887,948,763,379,21,66.54
16,7,0,16.0,7.0,0.4091835021972656,534.5100560326251,99,449,290,1887,948,763,379,21,63.62
16,7,0,16.0,7.0,0.4189934730529785,517.2794215895312,99,433,283,1887,948,763,379,21,62.24
18,8,0,18.0,8.0,0.42577457427978516,497.84535751576516,99,415,275,1887,948,763,379,21,64.53
18,9,0,18.0,9.0,0.4332096576690674,477.87550680067295,99,397,266,1887,948,763,379,21,64.05
18,8,0,18.0,8.0,0.44318366050720215,458.48118827275783,99,379,258,1887,948,763,379,21,61.01
19,8,0,19.0,8.0,0.44919443130493164,438.2921400162225,99,360,250,1887,948,763,379,21,60.2
18,9,0,18.0,9.0,0.4571986198425293,418.3837950972767,99,342,241,1887,948,763,379,21,58.42
17,8,0,17.0,8.0,0.46517443656921387,399.892485550804,99,325,233,1887,948,763,379,21,54.43
16,8,0,16.0,8.0,0.47324562072753906,382.2381456631455,99,309,225,1887,948,763,379,21,51.72
16,8,0,16.0,8.0,0.48145055770874023,364.6066373504465,99,293,217,1887,948,763,379,21,50.02
14,9,0,14.0,9.0,0.48916053771972656,348.0014367786432,99,279,208,1887,948,763,379,21,48.2
15,8,0,15.0,8.0,0.49718666076660156,331.20386471175124,99,264,200,1887,948,763,379,21,45.86
14,8,0,14.0,8.0,0.5054335594177246,315.220557705236,99,250,192,1887,948,763,379,21,43.43
15,9,0,15.0,9.0,0.513251543045044,297.8489550090784,99,235,183,1887,948,763,379,21,43.76
15,9,0,15.0,9.0,0.5212736129760742,280.49242414011826,99,220,174,1887,948,763,379,21,41.92
15,10,0,15.0,10.0,0.5291695594787598,262.5280937347468,99,205,164,1887,948,763,379,21,41.27
15,10,0,15.0,10.0,0.5371644496917725,244.57309745759036,99,190,154,1887,948,763,379,21,39.23
14,10,0,14.0,10.0,0.5451855659484863,227.40272645683032,99,176,144,1887,948,763,379,21,36.98
12,10,0,12.0,10.0,0.5531735420227051,211.7829077144801,99,164,134,1887,948,763,379,21,35.56
9,8,0,9.0,8.0,0.5611615180969238,199.75234666956982,99,155,126,1887,948,763,379,21,28.78
7,8,0,7.0,8.0,0.569474458694458,189.2828571212935,99,148,118,1887,948,763,379,21,24.05
6,7,0,6.0,7.0,0.5772585868835449,180.23595645708434,99,142,111,1887,948,763,379,21,21.22
7,7,0,7.0,7.0,0.5851695537567139,170.41420128616042,99,135,104,1887,948,763,379,21,22.03
6,6,0,6.0,6.0,0.5931975841522217,162.00308639035245,99,129,98,1887,948,763,379,21,19.43
8,6,0,8.0,6.0,0.6030864715576172,152.00328943809077,99,121,92,1887,948,763,379,21,23.63
8,7,0,8.0,7.0,0.6095426082611084,141.40014144264495,99,113,85,1887,948,763,379,21,21.06
10,7,0,10.0,7.0,0.617180585861206,129.20139318134306,99,103,78,1887,948,763,379,21,22.21
11,7,0,11.0,7.0,0.6251754760742188,116.21101496846157,99,92,71,1887,948,763,379,21,20.36
10,6,0,10.0,6.0,0.6331684589385986,104.63746938836012,99,82,65,1887,948,763,379,21,17.51
9,6,0,9.0,6.0,0.6411755084991455,93.86160024205851,99,73,59,1887,948,763,379,21,16.23
8,4,0,8.0,4.0,0.6491785049438477,85.14693182963201,99,65,55,1887,948,763,379,21,12.48
7,5,0,7.0,5.0,0.6571896076202393,76.57675887630658,99,58,50,1887,948,763,379,21,12.88
5,3,0,5.0,3.0,0.6652164459228516,70.83784299369935,99,53,47,1887,948,763,379,21,9.22
5,4,0,5.0,4.0,0.6732125282287598,64.4437739428721,99,48,43,1887,948,763,379,21,10.84
4,2,0,4.0,2.0,0.6812076568603516,60.14149981501958,99,44,41,1887,948,763,379,21,6.71
4,2,0,4.0,2.0,0.6903214454650879,55.86591089385369,99,40,39,1887,948,763,379,21,6.32
2,3,0,2.0,3.0,0.6986715793609619,52.3450093132096,99,38,36,1887,948,763,379,21,5.99
3,2,0,3.0,2.0,0.706263542175293,48.79549159502341,99,35,34,1887,948,763,379,21,6.1
2,2,0,2.0,2.0,0.7212784290313721,45.967379738244816,99,33,32,1887,948,763,379,21,8.29
3,2,0,3.0,2.0,0.7214624881744385,42.42640687119285,99,30,30,1887,948,763,379,21,5.64
3,3,0,3.0,3.0,0.7291834354400635,38.18376618407357,99,27,27,1887,948,763,379,21,10.31
2,2,0,2.0,2.0,0.7371854782104492,35.35533905932738,99,25,25,1887,948,763,379,21,9.13
2,2,0,2.0,2.0,0.7451746463775635,32.526911934581186,99,23,23,1887,948,763,379,21,9.03
2,2,0,2.0,2.0,0.7531836032867432,29.698484809834994,99,21,21,1887,948,763,379,21,8.92
