dx,dy,button,rx,ry,time,distance,targetID,directionX,directionY,targetX,targetY,initMouseX,initMouseY,targetSize
0,0,0,-0.0,-0.0,0.18907380104064941,866.9863168829945,1,784,393,1748,947,964,554,20
0,2,0,-0.0,2.0,0.24800467491149902,866.0918901576478,1,784,391,1748,947,964,554,20
0,6,0,-0.0,6.0,0.25606870651245117,863.4305925487154,1,784,385,1748,947,964,554,20
1,7,0,1.0,7.0,0.264082670211792,859.4670781576494,1,783,378,1748,947,964,554,20
2,6,0,2.0,6.0,0.27195167541503906,855.0693613809242,1,781,372,1748,947,964,554,20
2,7,0,2.0,7.0,0.27989768981933594,850.2708875697236,1,779,365,1748,947,964,554,20
5,6,0,5.0,6.0,0.2878756523132324,843.2039615472961,1,774,359,1748,947,964,554,20
5,8,0,5.0,8.0,0.29598474502563477,835.3176917585482,1,769,351,1748,947,964,554,20
4,11,0,4.0,11.0,0.30395984649658203,827.1529131526689,1,765,340,1748,947,964,554,20
4,9,0,4.0,9.0,0.31196069717407227,819.8686643077928,1,761,331,1748,947,964,554,20
5,9,0,5.0,9.0,0.3201627731323242,811.7177130864345,1,756,322,1748,947,964,554,20
6,8,0,6.0,8.0,0.3279128074645996,803.0781020295652,1,750,314,1748,947,964,554,20
8,5,0,8.0,5.0,0.335979700088501,793.7692454927595,1,742,309,1748,947,964,554,20
10,6,0,10.0,6.0,0.34401869773864746,782.2329202955403,1,732,303,1748,947,964,554,20
19,6,0,19.0,6.0,0.3519287109375,762.3846192150644,1,713,297,1748,947,964,554,20
27,6,0,27.0,6.0,0.35984373092651367,735.1691083237415,1,686,291,1748,947,964,554,20
35,5,0,35.0,5.0,0.36784887313842773,701.0534438423036,1,651,286,1748,947,964,554,20
40,4,0,40.0,4.0,0.37588071823120117,662.9375899739886,1,611,282,1748,947,964,554,20
47,5,0,47.0,5.0,0.38424086570739746,618.3510165504629,1,564,277,1748,947,964,554,20
49,5,0,49.0,5.0,0.39213085174560547,572.4165176229122,1,515,272,1748,947,964,554,20
48,7,0,48.0,7.0,0.40010976791381836,526.9487871296479,1,467,265,1748,947,964,554,20
45,9,0,45.0,9.0,0.40798282623291016,483.5787677767349,1,422,256,1748,947,964,554,20
39,11,0,39.0,11.0,0.4158668518066406,444.6581133115299,1,383,245,1748,947,964,554,20
36,13,0,36.0,13.0,0.42385387420654297,407.41226623088113,1,347,232,1748,947,964,554,20
33,13,0,33.0,13.0,0.4319038391113281,372.8276374558138,1,314,219,1748,947,964,554,20
27,12,0,27.0,12.0,0.4399378299713135,343.86155484878543,1,287,207,1748,947,964,554,20
21,11,0,21.0,11.0,0.44786977767944336,320.4118641937665,1,266,196,1748,947,964,554,20
17,9,0,17.0,9.0,0.4560887813568115,301.40006422606916,1,249,187,1748,947,964,554,20
11,7,0,11.0,7.0,0.4638707637786865,288.40241285887754,1,238,180,1748,947,964,554,20
6,5,0,6.0,5.0,0.4731888771057129,280.6011011679068,1,232,175,1748,947,964,554,20
2,3,0,2.0,3.0,0.47998785972595215,277.20027855139693,1,230,172,1748,947,964,554,20
0,4,0,-0.0,4.0,0.48778271675109863,274.82275190019493,1,230,168,1748,947,964,554,20
-1,3,0,-1.0,3.0,0.49587488174438477,273.87673381240666,1,231,165,1748,947,964,554,20
-4,3,0,-4.0,3.0,0.5039618015289307,275.4277491765648,1,235,162,1748,947,964,554,20
-6,3,0,-6.0,3.0,0.511887788772583,278.7247824486149,1,241,159,1748,947,964,554,20
-7,2,0,-7.0,2.0,0.5199177265167236,283.51831288694746,1,248,157,1748,947,964,554,20
-8,1,0,-8.0,1.0,0.5286357402801514,289.7865907608277,1,256,156,1748,947,964,554,20
-8,0,0,-8.0,-0.0,0.5359578132629395,296.6463761403353,1,264,156,1748,947,964,554,20
-6,0,0,-6.0,-0.0,0.544022798538208,301.8268750444708,1,270,156,1748,947,964,554,20
-3,0,0,-3.0,-0.0,0.5519528388977051,304.42805218364344,1,273,156,1748,947,964,554,20
-2,0,0,-2.0,-0.0,0.5598816871643066,306.16609558901155,1,275,156,1748,947,964,554,20
1,1,0,1.0,1.0,0.6160087585449219,304.80311307228203,1,274,155,1748,947,964,554,20
1,2,0,1.0,2.0,0.6239027976989746,302.95047531518463,1,273,153,1748,947,964,554,20
3,1,0,3.0,1.0,0.6318597793579102,299.84512260159914,1,270,152,1748,947,964,554,20
2,2,0,2.0,2.0,0.6399757862091064,297.12212554617423,1,268,150,1748,947,964,554,20
4,2,0,4.0,2.0,0.647925853729248,292.65491900843114,1,264,148,1748,947,964,554,20
4,3,0,4.0,3.0,0.6559367179870605,287.6995129320839,1,260,145,1748,947,964,554,20
6,4,0,6.0,4.0,0.6639506816864014,280.5116176678654,1,254,141,1748,947,964,554,20
8,4,0,8.0,4.0,0.6726727485656738,271.5759222660915,1,246,137,1748,947,964,554,20
9,4,0,9.0,4.0,0.6799466609954834,261.7682836535566,1,237,133,1748,947,964,554,20
11,5,0,11.0,5.0,0.6880416870117188,249.73062969160952,1,226,128,1748,947,964,554,20
13,4,0,13.0,4.0,0.6958696842193604,236.46500765828807,1,213,124,1748,947,964,554,20
16,6,0,16.0,6.0,0.7038958072662354,219.6366695456107,1,197,118,1748,947,964,554,20
15,7,0,15.0,7.0,0.711784839630127,203.17832910500073,1,182,111,1748,947,964,554,20
15,7,0,15.0,7.0,0.7199568748474121,186.73586353280888,1,167,104,1748,947,964,554,20
15,7,0,15.0,7.0,0.7279608249664307,170.31361568112376,1,152,97,1748,947,964,554,20
12,8,0,12.0,8.0,0.7359168529510498,155.89454481688057,1,140,89,1748,947,964,554,20
12,7,0,12.0,7.0,0.744053840637207,142.0131573252789,1,128,82,1748,947,964,554,20
10,7,0,10.0,7.0,0.7518608570098877,129.8177385026664,1,118,75,1748,947,964,554,20
10,7,0,10.0,7.0,0.7601966857910156,117.62444906835053,1,108,68,1748,947,964,554,20
10,7,0,10.0,7.0,0.7679388523101807,105.43396380615195,1,98,61,1748,947,964,554,20
9,8,0,9.0,8.0,0.7757997512817383,93.58571330062848,1,89,53,1748,947,964,554,20
8,7,0,8.0,7.0,0.7838118076324463,83.15041599477696,1,81,46,1748,947,964,554,20
8,6,0,8.0,6.0,0.7920458316802979,73.24061508662703,1,73,40,1748,947,964,554,20
6,6,0,6.0,6.0,0.7999436855316162,65.13321502504735,1,67,34,1748,947,964,554,20
6,5,0,6.0,5.0,0.8078317642211914,57.54257916307313,1,61,29,1748,947,964,554,20
6,5,0,6.0,5.0,0.8165638446807861,50.00833275470999,1,55,24,1748,947,964,554,20
5,5,0,5.0,5.0,0.823894739151001,43.48831648126533,1,50,19,1748,947,964,554,20
4,3,0,4.0,3.0,0.8320107460021973,38.703182647543684,1,46,16,1748,947,964,554,20
3,3,0,3.0,3.0,0.8399448394775391,34.9221548904324,1,43,13,1748,947,964,554,20
3,2,0,3.0,2.0,0.8477687835693359,31.484937025383083,1,40,11,1748,947,964,554,20
2,1,0,2.0,1.0,0.8559517860412598,29.293765408777,1,38,10,1748,947,964,554,20
1,1,0,1.0,1.0,0.8637616634368896,28.078865529319543,1,37,9,1748,947,964,554,20
1,0,0,1.0,-0.0,0.8718416690826416,27.107950630558946,1,36,9,1748,947,964,554,20
1,2,0,1.0,2.0,0.8798308372497559,25.693136595149497,1,35,7,1748,947,964,554,20
2,1,0,2.0,1.0,0.8878467082977295,23.541019662496844,1,33,6,1748,947,964,554,20
2,2,0,2.0,2.0,0.8960158824920654,21.25699921617557,1,31,4,1748,947,964,554,20
3,2,0,3.0,2.0,0.9039828777313232,18.071337695236398,1,28,2,1748,947,964,554,20
3,3,0,3.0,3.0,0.9119536876678467,15.019992006393608,1,25,-1,1748,947,964,554,20
2,2,0,2.0,2.0,0.9199638366699219,13.194827009486403,1,23,-3,1748,947,964,554,20
2,1,0,2.0,1.0,0.9280447959899902,11.377558326431949,1,21,-4,1748,947,964,554,20
2,1,0,2.0,1.0,0.9358468055725098,9.6468827043885,1,19,-5,1748,947,964,554,20
2,1,0,2.0,1.0,0.9440498352050781,8.027756377319946,1,17,-6,1748,947,964,554,20
2,1,0,2.0,1.0,0.9520187377929688,6.552945357246848,1,15,-7,1748,947,964,554,20
2,1,0,2.0,1.0,0.9608848094940186,5.264337522473747,1,13,-8,1748,947,964,554,20
1,1,0,1.0,1.0,0.9679367542266846,5.0,1,12,-9,1748,947,964,554,20
2,0,0,2.0,-0.0,0.9758927822113037,3.45362404707371,1,10,-9,1748,947,964,554,20
1,0,0,1.0,-0.0,0.9839568138122559,2.727922061357855,1,9,-9,1748,947,964,554,20
1,0,0,1.0,-0.0,0.9919028282165527,2.0415945787922958,1,8,-9,1748,947,964,554,20
1,0,0,1.0,-0.0,0.9998598098754883,1.4017542509913792,1,7,-9,1748,947,964,554,20
1,0,0,1.0,-0.0,1.0159306526184082,0.8166538263919687,1,6,-9,1748,947,964,554,20
1,0,0,1.0,-0.0,1.023965835571289,0.2956301409870008,1,5,-9,1748,947,964,554,20
1,-1,0,1.0,-1.0,1.0318717956542969,-1.0557280900008408,1,4,-8,1748,947,964,554,20
0,-1,0,-0.0,-1.0,1.0398938655853271,-1.9377422517014509,1,4,-7,1748,947,964,554,20
2,-1,0,2.0,-1.0,1.0480067729949951,-3.675444679663241,1,2,-6,1748,947,964,554,20
1,-2,0,1.0,-2.0,1.0560088157653809,-5.876894374382339,1,1,-4,1748,947,964,554,20
2,-1,0,2.0,-1.0,1.0639748573303223,-6.83772233983162,1,-1,-3,1748,947,964,554,20
0,-1,0,-0.0,-1.0,1.071840763092041,-7.76393202250021,1,-1,-2,1748,947,964,554,20
0,-1,0,-0.0,-1.0,1.079850673675537,-8.585786437626904,1,-1,-1,1748,947,964,554,20
0,-1,0,-0.0,-1.0,1.0879838466644287,-9.0,1,-1,0,1748,947,964,554,20
0,0,1,-0.0,-0.0,1.1258807182312012,-9.0,1,-1,0,1748,947,964,554,20
0,0,0,-0.0,-0.0,0.0634162425994873,1616.2711022807152,2,-1574,-479,175,468,1749,947,58
-3,0,0,-3.0,-0.0,0.09849715232849121,1613.4012907934527,2,-1571,-479,175,468,1749,947,58
-4,0,0,-4.0,-0.0,0.10640120506286621,1609.5756009412567,2,-1567,-479,175,468,1749,947,58
-5,0,0,-5.0,-0.0,0.11444830894470215,1604.7946627407007,2,-1562,-479,175,468,1749,947,58
-8,0,0,-8.0,-0.0,0.12245416641235352,1597.1479022524366,2,-1554,-479,175,468,1749,947,58
-6,0,0,-6.0,-0.0,0.13039231300354004,1591.4150702829197,2,-1548,-479,175,468,1749,947,58
-7,0,0,-7.0,-0.0,0.138383150100708,1584.7292213999224,2,-1541,-479,175,468,1749,947,58
-5,0,0,-5.0,-0.0,0.1463613510131836,1579.955251086866,2,-1536,-479,175,468,1749,947,58
-7,-1,0,-7.0,-1.0,0.15449023246765137,1572.9753431310983,2,-1529,-478,175,468,1749,947,58
-9,-4,0,-9.0,-4.0,0.1625051498413086,1563.1921994533197,2,-1520,-474,175,468,1749,947,58
-12,-5,0,-12.0,-5.0,0.17045927047729492,1550.2482388782328,2,-1508,-469,175,468,1749,947,58
-16,-8,0,-16.0,-8.0,0.17844629287719727,1532.5969390338853,2,-1492,-461,175,468,1749,947,58
-23,-13,0,-23.0,-13.0,0.18644428253173828,1506.7945826183918,2,-1469,-448,175,468,1749,947,58
-32,-15,0,-32.0,-15.0,0.19437432289123535,1471.8191096864405,2,-1437,-433,175,468,1749,947,58
-38,-16,0,-38.0,-16.0,0.2024693489074707,1430.8253320174986,2,-1399,-417,175,468,1749,947,58
-44,-17,0,-44.0,-17.0,0.21033215522766113,1383.8074886551246,2,-1355,-400,175,468,1749,947,58
-49,-15,0,-49.0,-15.0,0.21849322319030762,1332.5656429272883,2,-1306,-385,175,468,1749,947,58
-51,-13,0,-51.0,-13.0,0.22639727592468262,1279.9724978012334,2,-1255,-372,175,468,1749,947,58
-51,-11,0,-51.0,-11.0,0.23442316055297852,1227.9554486933894,2,-1204,-361,175,468,1749,947,58
-52,-10,0,-52.0,-10.0,0.24244117736816406,1175.2860955769604,2,-1152,-351,175,468,1749,947,58
-49,-7,0,-49.0,-7.0,0.2505321502685547,1126.398199756257,2,-1103,-344,175,468,1749,947,58
-46,-7,0,-46.0,-7.0,0.2584652900695801,1080.4223722279987,2,-1057,-337,175,468,1749,947,58
-40,-5,0,-40.0,-5.0,0.26656031608581543,1040.8191435939068,2,-1017,-332,175,468,1749,947,58
-37,-6,0,-37.0,-6.0,0.2743523120880127,1003.8000774593309,2,-980,-326,175,468,1749,947,58
-36,-7,0,-36.0,-7.0,0.28249526023864746,967.4421709261406,2,-944,-319,175,468,1749,947,58
-37,-9,0,-37.0,-9.0,0.2904243469238281,929.5139539933677,2,-907,-310,175,468,1749,947,58
-36,-9,0,-36.0,-9.0,0.2983062267303467,892.5432708234595,2,-871,-301,175,468,1749,947,58
-38,-11,0,-38.0,-11.0,0.3063852787017822,853.0368473028777,2,-833,-290,175,468,1749,947,58
-38,-12,0,-38.0,-12.0,0.3143582344055176,813.2048444410659,2,-795,-278,175,468,1749,947,58
-37,-11,0,-37.0,-11.0,0.32241225242614746,774.6497993529271,2,-758,-267,175,468,1749,947,58
-34,-11,0,-34.0,-11.0,0.3302931785583496,738.92707987152,2,-724,-256,175,468,1749,947,58
-30,-9,0,-30.0,-9.0,0.3384072780609131,707.6444189702383,2,-694,-247,175,468,1749,947,58
-25,-9,0,-25.0,-9.0,0.34646034240722656,681.0739398119043,2,-669,-238,175,468,1749,947,58
-21,-7,0,-21.0,-7.0,0.35432934761047363,658.9425848135875,2,-648,-231,175,468,1749,947,58
-19,-8,0,-19.0,-8.0,0.3625321388244629,638.3604723086318,2,-629,-223,175,468,1749,947,58
-16,-6,0,-16.0,-6.0,0.37049221992492676,621.275326304174,2,-613,-217,175,468,1749,947,58
-16,-7,0,-16.0,-7.0,0.37849926948547363,603.8578039338695,2,-597,-210,175,468,1749,947,58
-18,-8,0,-18.0,-8.0,0.38649535179138184,584.2250810265347,2,-579,-202,175,468,1749,947,58
-17,-8,0,-17.0,-8.0,0.3943781852722168,565.5418404115895,2,-562,-194,175,468,1749,947,58
-17,-7,0,-17.0,-7.0,0.4023933410644531,547.1892050359847,2,-545,-187,175,468,1749,947,58
-17,-6,0,-17.0,-6.0,0.41036033630371094,529.1621628165062,2,-528,-181,175,468,1749,947,58
-16,-4,0,-16.0,-4.0,0.41854214668273926,512.73148330146,2,-512,-177,175,468,1749,947,58
-15,-4,0,-15.0,-4.0,0.42652225494384766,497.24899049784415,2,-497,-173,175,468,1749,947,58
-14,-3,0,-14.0,-3.0,0.4344792366027832,483.0439434267337,2,-483,-170,175,468,1749,947,58
-15,-4,0,-15.0,-4.0,0.4425222873687744,467.56822290597694,2,-468,-166,175,468,1749,947,58
-13,-4,0,-13.0,-4.0,0.45044636726379395,453.9792956224935,2,-455,-162,175,468,1749,947,58
-11,-2,0,-11.0,-2.0,0.45850229263305664,442.94914980323887,2,-444,-160,175,468,1749,947,58
-11,-3,0,-11.0,-3.0,0.4664943218231201,431.5844113732031,2,-433,-157,175,468,1749,947,58
-11,-4,0,-11.0,-4.0,0.47446227073669434,419.8797166279626,2,-422,-153,175,468,1749,947,58
-13,-4,0,-13.0,-4.0,0.4824352264404297,406.29530206516125,2,-409,-149,175,468,1749,947,58
-15,-4,0,-15.0,-4.0,0.49042534828186035,390.83449119861507,2,-394,-145,175,468,1749,947,58
-14,-5,0,-14.0,-5.0,0.49844813346862793,375.96913462633177,2,-380,-140,175,468,1749,947,58
-14,-5,0,-14.0,-5.0,0.5064611434936523,361.10383233185496,2,-366,-135,175,468,1749,947,58
-15,-5,0,-15.0,-5.0,0.5145113468170166,345.30068127108717,2,-351,-130,175,468,1749,947,58
-14,-4,0,-14.0,-4.0,0.5227072238922119,330.784657816311,2,-337,-126,175,468,1749,947,58
-13,-4,0,-13.0,-4.0,0.5305373668670654,317.2080299473136,2,-324,-122,175,468,1749,947,58
-13,-3,0,-13.0,-3.0,0.5385832786560059,303.98948932361213,2,-311,-119,175,468,1749,947,58
-11,-4,0,-11.0,-4.0,0.5465762615203857,292.2864765283469,2,-300,-115,175,468,1749,947,58
-10,-4,0,-10.0,-4.0,0.5545651912689209,281.517310306527,2,-290,-111,175,468,1749,947,58
-10,-3,0,-10.0,-3.0,0.5625362396240234,271.1066477104431,2,-280,-108,175,468,1749,947,58
-9,-4,0,-9.0,-4.0,0.5705201625823975,261.27056344038743,2,-271,-104,175,468,1749,947,58
-11,-5,0,-11.0,-5.0,0.5784013271331787,249.2103520719529,2,-260,-99,175,468,1749,947,58
-13,-5,0,-13.0,-5.0,0.5866012573242188,235.2820463065927,2,-247,-94,175,468,1749,947,58
-16,-7,0,-16.0,-7.0,0.5946493148803711,217.84002916869053,2,-231,-87,175,468,1749,947,58
-16,-5,0,-16.0,-5.0,0.6027953624725342,201.10649708341572,2,-215,-82,175,468,1749,947,58
-16,-5,0,-16.0,-5.0,0.6108062267303467,184.37759957408838,2,-199,-77,175,468,1749,947,58
-15,-5,0,-15.0,-5.0,0.6185262203216553,168.5854245636555,2,-184,-72,175,468,1749,947,58
-13,-5,0,-13.0,-5.0,0.6265032291412354,154.65728953678914,2,-171,-67,175,468,1749,947,58
-14,-4,0,-14.0,-4.0,0.634493350982666,140.1685549976709,2,-157,-63,175,468,1749,947,58
-14,-5,0,-14.0,-5.0,0.6425423622131348,125.31461369552787,2,-143,-58,175,468,1749,947,58
-13,-4,0,-13.0,-4.0,0.6504862308502197,111.76931483814221,2,-130,-54,175,468,1749,947,58
-10,-4,0,-10.0,-4.0,0.6585471630096436,101.0,2,-120,-50,175,468,1749,947,58
-9,-3,0,-9.0,-3.0,0.6672203540802002,91.5404496424333,2,-111,-47,175,468,1749,947,58
-9,-3,0,-9.0,-3.0,0.6746902465820312,82.08555261599052,2,-102,-44,175,468,1749,947,58
-9,-2,0,-9.0,-2.0,0.6826653480529785,73.04410811016969,2,-93,-42,175,468,1749,947,58
-10,-3,0,-10.0,-3.0,0.6904451847076416,62.706052144883,2,-83,-39,175,468,1749,947,58
-10,-2,0,-10.0,-2.0,0.6984481811523438,52.8413098624405,2,-73,-37,175,468,1749,947,58
-9,-2,0,-9.0,-2.0,0.7064142227172852,43.94518489934754,2,-64,-35,175,468,1749,947,58
-9,-2,0,-9.0,-2.0,0.7145872116088867,35.1404708432983,2,-55,-33,175,468,1749,947,58
-7,-2,0,-7.0,-2.0,0.7224533557891846,28.140178508646613,2,-48,-31,175,468,1749,947,58
-5,-1,0,-5.0,-1.0,0.7313442230224609,23.43090691567332,2,-43,-30,175,468,1749,947,58
-4,-1,0,-4.0,-1.0,0.7388381958007812,19.60041152089147,2,-39,-29,175,468,1749,947,58
-2,0,0,-2.0,-0.0,0.7465393543243408,18.010637094172637,2,-37,-29,175,468,1749,947,58
-2,-1,0,-2.0,-1.0,0.7544863224029541,15.82186966202994,2,-35,-28,175,468,1749,947,58
-1,0,0,-1.0,-0.0,0.762451171875,15.045431091090478,2,-34,-28,175,468,1749,947,58
-2,-1,0,-2.0,-1.0,0.7704513072967529,12.868842830916641,2,-32,-27,175,468,1749,947,58
-2,-1,0,-2.0,-1.0,0.7784762382507324,10.698866482558415,2,-30,-26,175,468,1749,947,58
-1,0,0,-1.0,-0.0,0.7864291667938232,9.948684188300895,2,-29,-26,175,468,1749,947,58
-1,0,0,-1.0,-0.0,0.7944521903991699,9.209946349085598,2,-28,-26,175,468,1749,947,58
0,0,1,-0.0,-0.0,0.837529182434082,9.209946349085598,2,-28,-26,175,468,1749,947,58
0,0,0,-0.0,-0.0,0.08262825012207031,804.4357981136664,3,821,-103,1024,391,203,494,46
1,0,0,1.0,-0.0,0.10796928405761719,803.443585491472,3,820,-103,1024,391,203,494,46
2,0,0,2.0,-0.0,0.11580419540405273,801.4592166990433,3,818,-103,1024,391,203,494,46
5,0,0,5.0,-0.0,0.12383127212524414,796.4986272105647,3,813,-103,1024,391,203,494,46
10,2,0,10.0,2.0,0.1320052146911621,786.8357858232741,3,803,-105,1024,391,203,494,46
13,1,0,13.0,1.0,0.14002132415771484,774.0796697946824,3,790,-106,1024,391,203,494,46
19,3,0,19.0,3.0,0.14775323867797852,755.6668093607175,3,771,-109,1024,391,203,494,46
24,3,0,24.0,3.0,0.15571212768554688,732.3495879392534,3,747,-112,1024,391,203,494,46
26,4,0,26.0,4.0,0.1637892723083496,707.2718671837222,3,721,-116,1024,391,203,494,46
27,5,0,27.0,5.0,0.17183828353881836,681.4693038025149,3,694,-121,1024,391,203,494,46
28,5,0,28.0,5.0,0.1797783374786377,654.8141338154583,3,666,-126,1024,391,203,494,46
29,4,0,29.0,4.0,0.18802714347839355,627.1299870025994,3,637,-130,1024,391,203,494,46
29,5,0,29.0,5.0,0.19588613510131836,599.8073538422616,3,608,-135,1024,391,203,494,46
31,3,0,31.0,3.0,0.2040703296661377,570.2731242859396,3,577,-138,1024,391,203,494,46
31,1,0,31.0,1.0,0.21182513236999512,540.4154772457001,3,546,-139,1024,391,203,494,46
31,0,0,31.0,-0.0,0.2197251319885254,510.42853317009576,3,515,-139,1024,391,203,494,46
31,0,0,31.0,-0.0,0.22782230377197266,480.5642957954823,3,484,-139,1024,391,203,494,46
30,-2,0,30.0,-2.0,0.2359452247619629,451.220412888353,3,454,-137,1024,391,203,494,46
27,-5,0,27.0,-5.0,0.24399018287658691,423.9373557893768,3,427,-132,1024,391,203,494,46
28,-7,0,28.0,-7.0,0.25173115730285645,395.1219917679528,3,399,-125,1024,391,203,494,46
26,-7,0,26.0,-7.0,0.25993919372558594,368.2198870200747,3,373,-118,1024,391,203,494,46
22,-6,0,22.0,-6.0,0.2677133083343506,345.4358831601504,3,351,-112,1024,391,203,494,46
19,-4,0,19.0,-4.0,0.27576422691345215,326.12461958446875,3,332,-108,1024,391,203,494,46
17,-5,0,17.0,-5.0,0.2837343215942383,308.41213013406735,3,315,-103,1024,391,203,494,46
14,-5,0,14.0,-5.0,0.2918572425842285,293.55173352866035,3,301,-98,1024,391,203,494,46
12,-6,0,12.0,-6.0,0.2997143268585205,280.29028998634294,3,289,-92,1024,391,203,494,46
12,-8,0,12.0,-8.0,0.308685302734375,266.4563870430224,3,277,-84,1024,391,203,494,46
12,-8,0,12.0,-8.0,0.3158872127532959,252.68278872646368,3,265,-76,1024,391,203,494,46
12,-9,0,12.0,-9.0,0.3242301940917969,238.72122573455903,3,253,-67,1024,391,203,494,46
12,-8,0,12.0,-8.0,0.33176326751708984,225.11690792850052,3,241,-59,1024,391,203,494,46
11,-7,0,11.0,-7.0,0.3398323059082031,212.80500418778223,3,230,-52,1024,391,203,494,46
11,-5,0,11.0,-5.0,0.3478081226348877,200.98660674245681,3,219,-47,1024,391,203,494,46
11,-4,0,11.0,-4.0,0.3556373119354248,189.3982109152523,3,208,-43,1024,391,203,494,46
10,-4,0,10.0,-4.0,0.3637661933898926,178.80436070610565,3,198,-39,1024,391,203,494,46
12,-4,0,12.0,-4.0,0.3718433380126953,166.2643653728826,3,186,-35,1024,391,203,494,46
10,-3,0,10.0,-3.0,0.380352258682251,155.88543819998318,3,176,-32,1024,391,203,494,46
9,-2,0,9.0,-2.0,0.38783931732177734,146.6732153287607,3,167,-30,1024,391,203,494,46
8,-2,0,8.0,-2.0,0.39603614807128906,138.4465855941215,3,159,-28,1024,391,203,494,46
7,-1,0,7.0,-1.0,0.403914213180542,131.37940277122465,3,152,-27,1024,391,203,494,46
6,-1,0,6.0,-1.0,0.41182422637939453,125.29699929533302,3,146,-26,1024,391,203,494,46
5,-1,0,5.0,-1.0,0.41975927352905273,120.19916200872126,3,141,-25,1024,391,203,494,46
6,-1,0,6.0,-1.0,0.42774033546447754,114.11673858431726,3,135,-24,1024,391,203,494,46
6,0,0,6.0,-0.0,0.43574023246765137,108.21356637177422,3,129,-24,1024,391,203,494,46
6,-1,0,6.0,-1.0,0.4437873363494873,102.13193037750197,3,123,-23,1024,391,203,494,46
6,-1,0,6.0,-1.0,0.4518003463745117,96.05040949110591,3,117,-22,1024,391,203,494,46
7,-1,0,7.0,-1.0,0.45987725257873535,88.9866063420086,3,110,-21,1024,391,203,494,46
7,0,0,7.0,-0.0,0.4687232971191406,82.11898020814318,3,103,-21,1024,391,203,494,46
5,-1,0,5.0,-1.0,0.47575926780700684,77.0199980003999,3,98,-20,1024,391,203,494,46
4,0,0,4.0,-0.0,0.4837362766265869,73.1041102138717,3,94,-20,1024,391,203,494,46
5,0,0,5.0,-0.0,0.49170732498168945,68.21951545584969,3,89,-20,1024,391,203,494,46
7,0,0,7.0,-0.0,0.49974822998046875,61.403791384036765,3,82,-20,1024,391,203,494,46
8,0,0,8.0,-0.0,0.5077593326568604,53.6550715869472,3,74,-20,1024,391,203,494,46
7,0,0,7.0,-0.0,0.515862226486206,46.92138442565336,3,67,-20,1024,391,203,494,46
6,0,0,6.0,-0.0,0.5238173007965088,41.19501538281614,3,61,-20,1024,391,203,494,46
6,0,0,6.0,-0.0,0.5318713188171387,35.52349955359813,3,55,-20,1024,391,203,494,46
5,0,0,5.0,-0.0,0.53981614112854,30.85164807134504,3,50,-20,1024,391,203,494,46
5,0,0,5.0,-0.0,0.5475783348083496,26.244289008980523,3,45,-20,1024,391,203,494,46
4,1,0,4.0,1.0,0.5556232929229736,23.065171225124082,3,41,-21,1024,391,203,494,46
4,0,0,4.0,-0.0,0.5637333393096924,19.5440947723653,3,37,-21,1024,391,203,494,46
5,0,0,5.0,-0.0,0.571857213973999,15.275318418009277,3,32,-21,1024,391,203,494,46
6,0,0,6.0,-0.0,0.5797452926635742,10.421549934136806,3,26,-21,1024,391,203,494,46
6,0,0,6.0,-0.0,0.5877671241760254,6.0,3,20,-21,1024,391,203,494,46
5,0,0,5.0,-0.0,0.5959203243255615,2.80697580112788,3,15,-21,1024,391,203,494,46
3,0,0,3.0,-0.0,0.6045172214508057,1.1867732448956474,3,12,-21,1024,391,203,494,46
2,0,0,2.0,-0.0,0.6118912696838379,0.259406699226016,3,10,-21,1024,391,203,494,46
2,0,0,2.0,-0.0,0.6198842525482178,-0.5277949457557689,3,8,-21,1024,391,203,494,46
2,0,0,2.0,-0.0,0.6278162002563477,-1.159670332158445,3,6,-21,1024,391,203,494,46
2,0,0,2.0,-0.0,0.6358742713928223,-1.6224416735680514,3,4,-21,1024,391,203,494,46
3,0,0,3.0,-0.0,0.6437273025512695,-1.9762039583713609,3,1,-21,1024,391,203,494,46
1,0,0,1.0,-0.0,0.6518161296844482,-2.0,3,0,-21,1024,391,203,494,46
2,-1,0,2.0,-1.0,0.6597352027893066,-2.90024875775822,3,-2,-20,1024,391,203,494,46
1,0,0,1.0,-0.0,0.6679491996765137,-2.7762515838433153,3,-3,-20,1024,391,203,494,46
0,0,1,-0.0,-0.0,0.6727831363677979,-2.7762515838433153,3,-3,-20,1024,391,203,494,46
0,0,0,-0.0,-0.0,0.07780313491821289,883.6918199915815,4,885,35,1912,446,1027,411,4
1,0,0,1.0,-0.0,0.09346818923950195,882.6926019810497,4,884,35,1912,446,1027,411,4
0,2,0,-0.0,2.0,0.10158228874206543,882.6157357858834,4,884,33,1912,446,1027,411,4
1,4,0,1.0,4.0,0.10944128036499023,881.4760890935306,4,883,29,1912,446,1027,411,4
2,5,0,2.0,5.0,0.11745810508728027,879.326840621571,4,881,24,1912,446,1027,411,4
1,7,0,1.0,7.0,0.12579607963562012,878.1641892283508,4,880,17,1912,446,1027,411,4
4,7,0,4.0,7.0,0.13353919982910156,874.0570757661854,4,876,10,1912,446,1027,411,4
7,8,0,7.0,8.0,0.14153528213500977,867.0023014929247,4,869,2,1912,446,1027,411,4
6,7,0,6.0,7.0,0.14962530136108398,861.0144842353459,4,863,-5,1912,446,1027,411,4
7,5,0,7.0,5.0,0.157515287399292,854.0584092221745,4,856,-10,1912,446,1027,411,4
6,5,0,6.0,5.0,0.16543030738830566,848.1323426384859,4,850,-15,1912,446,1027,411,4
5,4,0,5.0,4.0,0.17349720001220703,843.2135824748677,4,845,-19,1912,446,1027,411,4
3,3,0,3.0,3.0,0.18148207664489746,840.287361890228,4,842,-22,1912,446,1027,411,4
2,1,0,2.0,1.0,0.18942523002624512,838.3148219566283,4,840,-23,1912,446,1027,411,4
2,2,0,2.0,2.0,0.19744515419006348,836.3728287581844,4,838,-25,1912,446,1027,411,4
1,3,0,1.0,3.0,0.20560526847839355,835.4682083518156,4,837,-28,1912,446,1027,411,4
2,1,0,2.0,1.0,0.21418309211730957,833.5034410461755,4,835,-29,1912,446,1027,411,4
2,3,0,2.0,3.0,0.22154808044433594,831.6144192610874,4,833,-32,1912,446,1027,411,4
4,4,0,4.0,4.0,0.22950410842895508,827.7812964872129,4,829,-36,1912,446,1027,411,4
6,4,0,6.0,4.0,0.2374560832977295,821.9714800889652,4,823,-40,1912,446,1027,411,4
8,4,0,8.0,4.0,0.24554228782653809,814.1868658585483,4,815,-44,1912,446,1027,411,4
9,3,0,9.0,3.0,0.253521203994751,805.3691844503356,4,806,-47,1912,446,1027,411,4
12,3,0,12.0,3.0,0.2613332271575928,793.5727496590114,4,794,-50,1912,446,1027,411,4
13,2,0,13.0,2.0,0.26941609382629395,780.7291996597546,4,781,-52,1912,446,1027,411,4
14,1,0,14.0,1.0,0.2774622440338135,766.828979682738,4,767,-53,1912,446,1027,411,4
18,1,0,18.0,1.0,0.28581929206848145,748.9440724847624,4,749,-54,1912,446,1027,411,4
20,0,0,20.0,-0.0,0.2937042713165283,728.9972640167678,4,729,-54,1912,446,1027,411,4
25,-1,0,25.0,-1.0,0.30152416229248047,703.992209588746,4,704,-53,1912,446,1027,411,4
27,-2,0,27.0,-2.0,0.3094792366027832,676.9182572298376,4,677,-51,1912,446,1027,411,4
27,-2,0,27.0,-2.0,0.31762123107910156,649.8443065640752,4,650,-49,1912,446,1027,411,4
29,-3,0,29.0,-3.0,0.32550621032714844,620.7013730513206,4,621,-46,1912,446,1027,411,4
28,-2,0,28.0,-2.0,0.3335592746734619,592.6301371440906,4,593,-44,1912,446,1027,411,4
31,-1,0,31.0,-1.0,0.34151411056518555,561.6426172673603,4,562,-43,1912,446,1027,411,4
33,-1,0,33.0,-1.0,0.3496372699737549,528.664677550711,4,529,-42,1912,446,1027,411,4
33,-1,0,33.0,-1.0,0.35756826400756836,495.6916716200905,4,496,-41,1912,446,1027,411,4
34,-1,0,34.0,-1.0,0.36539721488952637,461.7283687677518,4,462,-40,1912,446,1027,411,4
32,-1,0,32.0,-1.0,0.37406110763549805,429.76498236888085,4,430,-39,1912,446,1027,411,4
30,-2,0,30.0,-2.0,0.38137125968933105,399.70760510600246,4,400,-37,1912,446,1027,411,4
25,-2,0,25.0,-2.0,0.3894631862640381,374.62979170532964,4,375,-35,1912,446,1027,411,4
24,-1,0,24.0,-1.0,0.3976120948791504,350.64287884487334,4,351,-34,1912,446,1027,411,4
19,-1,0,19.0,-1.0,0.40552711486816406,331.63602922945836,4,332,-33,1912,446,1027,411,4
17,-1,0,17.0,-1.0,0.41378211975097656,314.62122480970856,4,315,-32,1912,446,1027,411,4
15,-1,0,15.0,-1.0,0.4217052459716797,299.59741378201505,4,300,-31,1912,446,1027,411,4
13,0,0,13.0,-0.0,0.43053722381591797,286.6693610343848,4,287,-31,1912,446,1027,411,4
11,-2,0,11.0,-2.0,0.4374971389770508,275.5193686934301,4,276,-29,1912,446,1027,411,4
13,0,0,13.0,-0.0,0.44557929039001465,262.59402865522117,4,263,-29,1912,446,1027,411,4
12,-2,0,12.0,-2.0,0.4535400867462158,250.4480144505003,4,251,-27,1912,446,1027,411,4
11,-1,0,11.0,-1.0,0.46148228645324707,239.40422531513403,4,240,-26,1912,446,1027,411,4
11,0,0,11.0,-0.0,0.46953630447387695,228.471256342304,4,229,-26,1912,446,1027,411,4
12,-1,0,12.0,-1.0,0.4775571823120117,216.43534512527958,4,217,-25,1912,446,1027,411,4
11,0,0,11.0,-0.0,0.4854302406311035,205.51144546747295,4,206,-25,1912,446,1027,411,4
11,0,0,11.0,-0.0,0.494232177734375,194.596032513375,4,195,-25,1912,446,1027,411,4
12,0,0,12.0,-0.0,0.5022902488708496,182.69975636150687,4,183,-25,1912,446,1027,411,4
12,0,0,12.0,-0.0,0.5094931125640869,170.81782315490494,4,171,-25,1912,446,1027,411,4
9,0,0,9.0,-0.0,0.5176842212677002,161.9176622576103,4,162,-25,1912,446,1027,411,4
9,0,0,9.0,-0.0,0.5256602764129639,153.0290295396317,4,153,-25,1912,446,1027,411,4
8,0,0,8.0,-0.0,0.533635139465332,145.13938969562162,4,145,-25,1912,446,1027,411,4
5,0,0,5.0,-0.0,0.5414831638336182,140.21462653327893,4,140,-25,1912,446,1027,411,4
5,0,0,5.0,-0.0,0.5494561195373535,135.2953021774598,4,135,-25,1912,446,1027,411,4
4,0,0,4.0,-0.0,0.5574502944946289,131.3641631023867,4,131,-25,1912,446,1027,411,4
4,0,0,4.0,-0.0,0.5654642581939697,127.43724348115578,4,127,-25,1912,446,1027,411,4
4,0,0,4.0,-0.0,0.5733792781829834,123.51493934986385,4,123,-25,1912,446,1027,411,4
3,0,0,3.0,-0.0,0.5814282894134521,120.57650672131263,4,120,-25,1912,446,1027,411,4
3,-1,0,3.0,-1.0,0.589550256729126,117.4361754243663,4,117,-24,1912,446,1027,411,4
3,0,0,3.0,-0.0,0.5973372459411621,114.49892703368559,4,114,-24,1912,446,1027,411,4
3,0,0,3.0,-0.0,0.6054770946502686,111.5649593844862,4,111,-24,1912,446,1027,411,4
5,-1,0,5.0,-1.0,0.6133971214294434,106.4665847162157,4,106,-23,1912,446,1027,411,4
6,-1,0,6.0,-1.0,0.6214361190795898,100.39140588936164,4,100,-22,1912,446,1027,411,4
6,-1,0,6.0,-1.0,0.6294562816619873,94.317184344228,4,94,-21,1912,446,1027,411,4
5,-1,0,5.0,-1.0,0.6374251842498779,89.21951545584969,4,89,-20,1912,446,1027,411,4
7,0,0,7.0,-0.0,0.6455061435699463,82.40379138403677,4,82,-20,1912,446,1027,411,4
8,-1,0,8.0,-1.0,0.6535012722015381,74.40026177965623,4,74,-19,1912,446,1027,411,4
10,-2,0,10.0,-2.0,0.6614882946014404,64.21933252457322,4,64,-17,1912,446,1027,411,4
11,-2,0,11.0,-2.0,0.6694562435150146,53.08175741568164,4,53,-15,1912,446,1027,411,4
9,-2,0,9.0,-2.0,0.677558183670044,43.880278987817846,4,44,-13,1912,446,1027,411,4
8,-2,0,8.0,-2.0,0.685460090637207,35.64306044943742,4,36,-11,1912,446,1027,411,4
5,-1,0,5.0,-1.0,0.693350076675415,30.57299494980466,4,31,-10,1912,446,1027,411,4
3,-1,0,3.0,-1.0,0.7014932632446289,27.410882339705484,4,28,-9,1912,446,1027,411,4
1,0,0,1.0,-0.0,0.7094912528991699,26.460498941515414,4,27,-9,1912,446,1027,411,4
0,-1,0,-0.0,-1.0,0.7334342002868652,26.160255680657446,4,27,-8,1912,446,1027,411,4
1,0,0,1.0,-0.0,0.7574551105499268,25.202941017470888,4,26,-8,1912,446,1027,411,4
1,-1,0,1.0,-1.0,0.7813851833343506,23.96150997149434,4,25,-7,1912,446,1027,411,4
1,-1,0,1.0,-1.0,0.7895143032073975,22.73863375370596,4,24,-6,1912,446,1027,411,4
1,-1,0,1.0,-1.0,0.7975912094116211,21.53720459187964,4,23,-5,1912,446,1027,411,4
1,-1,0,1.0,-1.0,0.8054962158203125,20.360679774997898,4,22,-4,1912,446,1027,411,4
1,-1,0,1.0,-1.0,0.8133692741394043,19.213203435596427,4,21,-3,1912,446,1027,411,4
1,0,0,1.0,-0.0,0.8214712142944336,18.223748416156685,4,20,-3,1912,446,1027,411,4
0,-1,0,-0.0,-1.0,0.8294472694396973,18.09975124224178,4,20,-2,1912,446,1027,411,4
1,0,0,1.0,-0.0,0.8373861312866211,17.1049731745428,4,19,-2,1912,446,1027,411,4
1,-1,0,1.0,-1.0,0.8453631401062012,16.027756377319946,4,18,-1,1912,446,1027,411,4
2,0,0,2.0,-0.0,0.8533182144165039,14.031219541881399,4,16,-1,1912,446,1027,411,4
2,-1,0,2.0,-1.0,0.8614470958709717,12.0,4,14,0,1912,446,1027,411,4
2,0,0,2.0,-0.0,0.8773891925811768,10.0,4,12,0,1912,446,1027,411,4
1,-1,0,1.0,-1.0,0.8853111267089844,9.045361017187261,4,11,1,1912,446,1027,411,4
1,0,0,1.0,-0.0,0.8933532238006592,8.04987562112089,4,10,1,1912,446,1027,411,4
2,0,0,2.0,-0.0,0.9013962745666504,6.062257748298549,4,8,1,1912,446,1027,411,4
1,-1,0,1.0,-1.0,0.9094421863555908,5.280109889280518,4,7,2,1912,446,1027,411,4
1,0,0,1.0,-0.0,0.9254090785980225,4.324555320336759,4,6,2,1912,446,1027,411,4
1,0,0,1.0,-0.0,0.9333412647247314,3.3851648071345037,4,5,2,1912,446,1027,411,4
1,0,0,1.0,-0.0,0.9417202472686768,2.4721359549995796,4,4,2,1912,446,1027,411,4
1,0,0,1.0,-0.0,0.9494071006774902,1.6055512754639891,4,3,2,1912,446,1027,411,4
1,0,0,1.0,-0.0,0.9574000835418701,0.8284271247461903,4,2,2,1912,446,1027,411,4
1,0,0,1.0,-0.0,0.9654331207275391,0.2360679774997898,4,1,2,1912,446,1027,411,4
1,0,0,1.0,-0.0,0.9734811782836914,0.0,4,0,2,1912,446,1027,411,4
1,0,0,1.0,-0.0,0.9814960956573486,0.2360679774997898,4,-1,2,1912,446,1027,411,4
0,0,1,-0.0,-0.0,1.0315351486206055,0.2360679774997898,4,-1,2,1912,446,1027,411,4
1,0,1,1.0,-0.0,1.0376691818237305,0.8284271247461903,4,-2,2,1912,446,1027,411,4
0,0,0,-0.0,-0.0,0.1170499324798584,1290.8170697416933,5,-1258,409,656,853,1914,444,65
-4,1,0,-4.0,1.0,0.22094488143920898,1286.7039091471595,5,-1254,408,656,853,1914,444,65
-9,4,0,-9.0,4.0,0.22888588905334473,1276.9083237568627,5,-1245,404,656,853,1914,444,65
-13,5,0,-13.0,5.0,0.23687982559204102,1263.0,5,-1232,399,656,853,1914,444,65
-16,6,0,-16.0,6.0,0.24506878852844238,1245.9299667822177,5,-1216,393,656,853,1914,444,65
-16,8,0,-16.0,8.0,0.25302886962890625,1228.2479914683458,5,-1200,385,656,853,1914,444,65
-18,9,0,-18.0,9.0,0.2610208988189697,1208.3628501370074,5,-1182,376,656,853,1914,444,65
-27,10,0,-27.0,10.0,0.2689399719238281,1179.6026576398717,5,-1155,366,656,853,1914,444,65
-32,12,0,-32.0,12.0,0.2769308090209961,1145.4739912201883,5,-1123,354,656,853,1914,444,65
-36,14,0,-36.0,14.0,0.2849459648132324,1106.9332728478873,5,-1087,340,656,853,1914,444,65
-38,14,0,-38.0,14.0,0.2929868698120117,1066.4885069949526,5,-1049,326,656,853,1914,444,65
-41,16,0,-41.0,16.0,0.3014988899230957,1022.5918641825376,5,-1008,310,656,853,1914,444,65
-43,14,0,-43.0,14.0,0.30965685844421387,977.3765402465028,5,-965,296,656,853,1914,444,65
-45,15,0,-45.0,15.0,0.3174629211425781,929.9568597395623,5,-920,281,656,853,1914,444,65
-46,13,0,-46.0,13.0,0.3250467777252197,882.166286842826,5,-874,268,656,853,1914,444,65
-46,14,0,-46.0,14.0,0.3328857421875,834.083136886985,5,-828,254,656,853,1914,444,65
-47,15,0,-47.0,15.0,0.34142589569091797,784.7508800117696,5,-781,239,656,853,1914,444,65
-46,14,0,-46.0,14.0,0.3490128517150879,736.6676785191374,5,-735,225,656,853,1914,444,65
-47,14,0,-47.0,14.0,0.3569297790527344,687.6283763165541,5,-688,211,656,853,1914,444,65
-44,14,0,-44.0,14.0,0.36495375633239746,641.4574968028792,5,-644,197,656,853,1914,444,65
-39,14,0,-39.0,14.0,0.3729257583618164,600.0711985211792,5,-605,183,656,853,1914,444,65
-35,13,0,-35.0,13.0,0.38092494010925293,562.8108943185221,5,-570,170,656,853,1914,444,65
-33,11,0,-33.0,11.0,0.38959383964538574,528.0446410778341,5,-537,159,656,853,1914,444,65
-27,9,0,-27.0,9.0,0.39719486236572266,499.6013544000805,5,-510,150,656,853,1914,444,65
-25,8,0,-25.0,8.0,0.4052889347076416,473.3602675319855,5,-485,142,656,853,1914,444,65
-21,6,0,-21.0,6.0,0.41296982765197754,451.52042356037043,5,-464,136,656,853,1914,444,65
-17,6,0,-17.0,6.0,0.42105579376220703,433.5201391991543,5,-447,130,656,853,1914,444,65
-12,3,0,-12.0,3.0,0.429034948348999,421.16001588842767,5,-435,127,656,853,1914,444,65
-8,2,0,-8.0,2.0,0.4370388984680176,412.9202175671499,5,-427,125,656,853,1914,444,65
-5,2,0,-5.0,2.0,0.4449498653411865,407.5600072800072,5,-422,123,656,853,1914,444,65
-3,0,0,-3.0,-0.0,0.4530928134918213,404.68066135335096,5,-419,123,656,853,1914,444,65
-1,0,0,-1.0,-0.0,0.4609489440917969,403.7212411622826,5,-418,123,656,853,1914,444,65
-2,0,0,-2.0,-0.0,0.46888184547424316,401.8029506584758,5,-416,123,656,853,1914,444,65
-1,0,0,-1.0,-0.0,0.4850888252258301,400.84408278270365,5,-415,123,656,853,1914,444,65
-1,0,0,-1.0,-0.0,0.5009028911590576,399.88540146663905,5,-414,123,656,853,1914,444,65
-1,0,0,-1.0,-0.0,0.5329067707061768,398.92690795539795,5,-413,123,656,853,1914,444,65
-2,0,0,-2.0,-0.0,0.5411777496337891,397.01048938225273,5,-411,123,656,853,1914,444,65
-2,0,0,-2.0,-0.0,0.5490758419036865,395.09483724343943,5,-409,123,656,853,1914,444,65
-4,2,0,-4.0,2.0,0.5571877956390381,390.6890109761549,5,-405,121,656,853,1914,444,65
-6,2,0,-6.0,2.0,0.5649287700653076,384.36762602296545,5,-399,119,656,853,1914,444,65
-9,5,0,-9.0,5.0,0.5729279518127441,374.32007088008834,5,-390,114,656,853,1914,444,65
-12,4,0,-12.0,4.0,0.5809128284454346,361.68007315585584,5,-378,110,656,853,1914,444,65
-13,5,0,-13.0,5.0,0.5889317989349365,347.80258029665885,5,-365,105,656,853,1914,444,65
-15,5,0,-15.0,5.0,0.5969488620758057,332.0054944640259,5,-350,100,656,853,1914,444,65
-15,5,0,-15.0,5.0,0.604895830154419,316.209706929603,5,-335,95,656,853,1914,444,65
-15,5,0,-15.0,5.0,0.6135127544403076,300.41540277189324,5,-320,90,656,853,1914,444,65
-15,4,0,-15.0,4.0,0.621100902557373,284.89272632864265,5,-305,86,656,853,1914,444,65
-13,3,0,-13.0,3.0,0.629065752029419,271.5671260199299,5,-292,83,656,853,1914,444,65
-14,2,0,-14.0,2.0,0.637192964553833,257.56001105124994,5,-278,81,656,853,1914,444,65
-14,3,0,-14.0,3.0,0.6451218128204346,243.2816739269071,5,-264,78,656,853,1914,444,65
-13,1,0,-13.0,1.0,0.6529028415679932,230.54523419784255,5,-251,77,656,853,1914,444,65
-13,1,0,-13.0,1.0,0.6609508991241455,217.83994876720575,5,-238,76,656,853,1914,444,65
-13,1,0,-13.0,1.0,0.6689438819885254,205.17082451262846,5,-225,75,656,853,1914,444,65
-14,1,0,-14.0,1.0,0.6768958568572998,191.6000894454204,5,-211,74,656,853,1914,444,65
-16,1,0,-16.0,1.0,0.6850259304046631,176.21623375712088,5,-195,73,656,853,1914,444,65
-16,1,0,-16.0,1.0,0.6929068565368652,160.93781381574738,5,-179,72,656,853,1914,444,65
-15,2,0,-15.0,2.0,0.7010867595672607,146.31432920547917,5,-164,70,656,853,1914,444,65
-14,2,0,-14.0,2.0,0.7090058326721191,132.69365500832143,5,-150,68,656,853,1914,444,65
-14,3,0,-14.0,3.0,0.7169909477233887,118.7348665704123,5,-136,65,656,853,1914,444,65
-14,3,0,-14.0,3.0,0.7250058650970459,104.85028315644803,5,-122,62,656,853,1914,444,65
-12,3,0,-12.0,3.0,0.7329659461975098,92.82387592123551,5,-110,59,656,853,1914,444,65
-10,2,0,-10.0,2.0,0.7409608364105225,83.10430052782563,5,-100,57,656,853,1914,444,65
-9,2,0,-9.0,2.0,0.748917818069458,74.3296760081587,5,-91,55,656,853,1914,444,65
-9,2,0,-9.0,2.0,0.7570068836212158,65.63708311906906,5,-82,53,656,853,1914,444,65
-9,3,0,-9.0,3.0,0.7649428844451904,56.48163651289458,5,-73,50,656,853,1914,444,65
-8,3,0,-8.0,3.0,0.7731287479400635,48.2122185206219,5,-65,47,656,853,1914,444,65
-8,2,0,-8.0,2.0,0.7809708118438721,40.622310621461224,5,-57,45,656,853,1914,444,65
-8,3,0,-8.0,3.0,0.7889597415924072,32.53681120105021,5,-49,42,656,853,1914,444,65
-7,2,0,-7.0,2.0,0.7969257831573486,26.0,5,-42,40,656,853,1914,444,65
-8,2,0,-8.0,2.0,0.805264949798584,18.99019513592785,5,-34,38,656,853,1914,444,65
-8,4,0,-8.0,4.0,0.813452959060669,10.80186911806539,5,-26,34,656,853,1914,444,65
-7,3,0,-7.0,3.0,0.8210389614105225,4.359317925395686,5,-19,31,656,853,1914,444,65
-8,4,0,-8.0,4.0,0.8291139602661133,-2.845240525773498,5,-11,27,656,853,1914,444,65
-7,3,0,-7.0,3.0,0.836878776550293,-7.668949878807123,5,-4,24,656,853,1914,444,65
-8,4,0,-8.0,4.0,0.8448357582092285,-11.603921945628862,5,4,20,656,853,1914,444,65
-9,3,0,-9.0,3.0,0.8528809547424316,-10.599065440967305,5,13,17,656,853,1914,444,65
-7,3,0,-7.0,3.0,0.8608238697052002,-7.586888768532596,5,20,14,656,853,1914,444,65
-8,4,0,-8.0,4.0,0.8688757419586182,-2.267862505362988,5,28,10,656,853,1914,444,65
-6,4,0,-6.0,4.0,0.877011775970459,2.5253530032641365,5,34,6,656,853,1914,444,65
-6,3,0,-6.0,3.0,0.8849997520446777,8.11234224026316,5,40,3,656,853,1914,444,65
-3,3,0,-3.0,3.0,0.8940079212188721,11.0,5,43,0,656,853,1914,444,65
-2,2,0,-2.0,2.0,0.9010019302368164,13.044422518220834,5,45,-2,656,853,1914,444,65
-1,2,0,-1.0,2.0,0.908991813659668,14.173585522460783,5,46,-4,656,853,1914,444,65
-1,2,0,-1.0,2.0,0.9169619083404541,15.381430961928537,5,47,-6,656,853,1914,444,65
0,2,0,-0.0,2.0,0.9249439239501953,15.675989764240867,5,47,-8,656,853,1914,444,65
0,0,1,-0.0,-0.0,0.9260668754577637,15.675989764240867,5,47,-8,656,853,1914,444,65
0,1,1,-0.0,1.0,0.933114767074585,15.853944456021594,5,47,-9,656,853,1914,444,65
0,1,1,-0.0,1.0,0.9408547878265381,16.052055106935853,5,47,-10,656,853,1914,444,65
0,0,0,-0.0,-0.0,1.0171897411346436,16.052055106935853,5,47,-10,656,853,1914,444,65
2,0,0,2.0,-0.0,1.028991937637329,14.097722286464439,5,45,-10,656,853,1914,444,65
2,0,0,2.0,-0.0,1.037726879119873,12.147480109288232,5,43,-10,656,853,1914,444,65
3,-1,0,3.0,-1.0,1.0450468063354492,9.0,5,40,-9,656,853,1914,444,65
3,-2,0,3.0,-2.0,1.0530247688293457,5.656340767525464,5,37,-7,656,853,1914,444,65
4,-2,0,4.0,-2.0,1.0609209537506104,1.376638536557273,5,33,-5,656,853,1914,444,65
2,-2,0,2.0,-2.0,1.0690419673919678,-0.8551769952051274,5,31,-3,656,853,1914,444,65
3,-2,0,3.0,-2.0,1.0768558979034424,-3.9821485477562,5,28,-1,656,853,1914,444,65
4,-2,0,4.0,-2.0,1.0848617553710938,-7.979175701071373,5,24,1,656,853,1914,444,65
4,-2,0,4.0,-2.0,1.092857837677002,-11.776251583843315,5,20,3,656,853,1914,444,65
5,-3,0,5.0,-3.0,1.100829839706421,-15.84450557859649,5,15,6,656,853,1914,444,65
6,-4,0,6.0,-4.0,1.1092498302459717,-18.54637595292629,5,9,10,656,853,1914,444,65
6,-3,0,6.0,-3.0,1.1169347763061523,-18.658335935873666,5,3,13,656,853,1914,444,65
5,-2,0,5.0,-2.0,1.125180959701538,-16.86725404957844,5,-2,15,656,853,1914,444,65
5,-2,0,5.0,-2.0,1.1331019401550293,-13.615223689149765,5,-7,17,656,853,1914,444,65
2,0,0,2.0,-0.0,1.1410748958587646,-12.764615938328657,5,-9,17,656,853,1914,444,65
0,-1,0,-0.0,-1.0,1.1490108966827393,-11.875388202501892,5,-9,18,656,853,1914,444,65
0,0,1,-0.0,-0.0,1.2081289291381836,-11.875388202501892,5,-9,18,656,853,1914,444,65
0,1,1,-0.0,1.0,0.019418716430664062,1245.3832488608823,6,988,-789,1653,47,665,835,38
0,1,1,-0.0,1.0,0.027849674224853516,1246.0075098591312,6,988,-790,1653,47,665,835,38
-1,1,1,-1.0,1.0,0.043724775314331055,1247.4130447843627,6,989,-791,1653,47,665,835,38
0,0,0,-0.0,-0.0,0.04740571975708008,1247.4130447843627,6,989,-791,1653,47,665,835,38
0,1,0,-0.0,1.0,0.051573753356933594,1248.0378842007842,6,989,-792,1653,47,665,835,38
0,-1,0,-0.0,-1.0,0.15546679496765137,1247.4130447843627,6,989,-791,1653,47,665,835,38
2,-1,0,2.0,-1.0,0.1634807586669922,1245.2266410735062,6,987,-790,1653,47,665,835,38
1,-1,0,1.0,-1.0,0.17138981819152832,1243.8210482883155,6,986,-789,1653,47,665,835,38
1,-2,0,1.0,-2.0,0.1795656681060791,1241.7910215416352,6,985,-787,1653,47,665,835,38
2,-3,0,2.0,-3.0,0.18745064735412598,1238.3563536245404,6,983,-784,1653,47,665,835,38
3,-4,0,3.0,-4.0,0.1954646110534668,1233.5174649480941,6,980,-780,1653,47,665,835,38
6,-5,0,6.0,-5.0,0.20343971252441406,1225.709202986786,6,974,-775,1653,47,665,835,38
10,-8,0,10.0,-8.0,0.21153664588928223,1212.9029994281207,6,964,-767,1653,47,665,835,38
12,-9,0,12.0,-9.0,0.21941280364990234,1197.9091995707815,6,952,-758,1653,47,665,835,38
16,-12,0,16.0,-12.0,0.22747468948364258,1177.9177081153073,6,936,-746,1653,47,665,835,38
20,-14,0,20.0,-14.0,0.23544073104858398,1153.5527706674868,6,916,-732,1653,47,665,835,38
22,-16,0,22.0,-16.0,0.2434237003326416,1126.378540046914,6,894,-716,1653,47,665,835,38
24,-18,0,24.0,-18.0,0.2514326572418213,1096.3941007554236,6,870,-698,1653,47,665,835,38
30,-24,0,30.0,-24.0,0.2594306468963623,1057.9753943335938,6,840,-674,1653,47,665,835,38
33,-26,0,33.0,-26.0,0.26751160621643066,1015.9652168068258,6,807,-648,1653,47,665,835,38
41,-27,0,41.0,-27.0,0.2754948139190674,967.1019217099214,6,766,-621,1653,47,665,835,38
44,-29,0,44.0,-29.0,0.2834007740020752,914.6744614693067,6,722,-592,1653,47,665,835,38
51,-32,0,51.0,-32.0,0.29146265983581543,854.9799768873427,6,671,-560,1653,47,665,835,38
53,-30,0,53.0,-30.0,0.29941463470458984,795.1400370943564,6,618,-530,1653,47,665,835,38
54,-28,0,54.0,-28.0,0.3074326515197754,736.0496672405068,6,564,-502,1653,47,665,835,38
53,-26,0,53.0,-26.0,0.31540465354919434,679.3530625693568,6,511,-476,1653,47,665,835,38
49,-26,0,49.0,-26.0,0.3234286308288574,625.9372062456933,6,462,-450,1653,47,665,835,38
47,-26,0,47.0,-26.0,0.33179259300231934,574.2967217168825,6,415,-424,1653,47,665,835,38
44,-28,0,44.0,-28.0,0.33946681022644043,523.6389223046942,6,371,-396,1653,47,665,835,38
41,-26,0,41.0,-26.0,0.3473196029663086,476.7822102496216,6,330,-370,1653,47,665,835,38
36,-27,0,36.0,-27.0,0.35533976554870605,432.7576784073515,6,294,-343,1653,47,665,835,38
32,-25,0,32.0,-25.0,0.3633136749267578,393.02912518413063,6,262,-318,1653,47,665,835,38
23,-20,0,23.0,-20.0,0.37128782272338867,363.00130889828114,6,239,-298,1653,47,665,835,38
15,-15,0,15.0,-15.0,0.37940382957458496,341.9224293390479,6,224,-283,1653,47,665,835,38
9,-13,0,9.0,-13.0,0.38744282722473145,326.14489710844634,6,215,-270,1653,47,665,835,38
5,-9,0,5.0,-9.0,0.395479679107666,315.9940297975473,6,210,-261,1653,47,665,835,38
3,-8,0,3.0,-8.0,0.4037296772003174,307.8914192816936,6,207,-253,1653,47,665,835,38
3,-7,0,3.0,-7.0,0.41216468811035156,300.5809756540586,6,204,-246,1653,47,665,835,38
1,-9,0,1.0,-9.0,0.4195997714996338,293.05448242254107,6,203,-237,1653,47,665,835,38
2,-9,0,2.0,-9.0,0.4275836944580078,284.94900888142405,6,201,-228,1653,47,665,835,38
2,-7,0,2.0,-7.0,0.43566274642944336,278.3919972023457,6,199,-221,1653,47,665,835,38
1,-7,0,1.0,-7.0,0.44355273246765137,272.547594742265,6,198,-214,1653,47,665,835,38
1,-5,0,1.0,-5.0,0.45155763626098633,268.2107240337658,6,197,-209,1653,47,665,835,38
1,-3,0,1.0,-3.0,0.45954060554504395,265.3448610402516,6,196,-206,1653,47,665,835,38
1,-2,0,1.0,-2.0,0.46758270263671875,263.207370562854,6,195,-204,1653,47,665,835,38
1,-2,0,1.0,-2.0,0.47541165351867676,261.07141946296485,6,194,-202,1653,47,665,835,38
0,-2,0,-0.0,-2.0,0.4834146499633789,259.6323742855449,6,194,-200,1653,47,665,835,38
0,-3,0,-0.0,-3.0,0.4914546012878418,257.4868893817571,6,194,-197,1653,47,665,835,38
0,-2,0,-0.0,-2.0,0.4997556209564209,256.0654467576762,6,194,-195,1653,47,665,835,38
0,-1,0,-0.0,-1.0,0.5075857639312744,255.35743110038044,6,194,-194,1653,47,665,835,38
0,-2,0,-0.0,-2.0,0.5157217979431152,253.9468812791236,6,194,-192,1653,47,665,835,38
1,-2,0,1.0,-2.0,0.5236196517944336,251.83020511013905,6,193,-190,1653,47,665,835,38
0,-2,0,-0.0,-2.0,0.5314056873321533,250.43088167468852,6,193,-188,1653,47,665,835,38
1,-3,0,1.0,-3.0,0.5394597053527832,247.62520511009456,6,192,-185,1653,47,665,835,38
2,-5,0,2.0,-5.0,0.5475037097930908,242.72504656604804,6,190,-180,1653,47,665,835,38
3,-6,0,3.0,-6.0,0.5553348064422607,236.43100829773977,6,187,-174,1653,47,665,835,38
4,-7,0,4.0,-7.0,0.5634346008300781,228.7458375028731,6,183,-167,1653,47,665,835,38
5,-6,0,5.0,-6.0,0.5716986656188965,221.01041644062033,6,178,-161,1653,47,665,835,38
4,-7,0,4.0,-7.0,0.5796515941619873,213.36178687555318,6,174,-154,1653,47,665,835,38
5,-6,0,5.0,-6.0,0.5876607894897461,205.64416306683776,6,169,-148,1653,47,665,835,38
5,-5,0,5.0,-5.0,0.5956625938415527,198.5890622251036,6,164,-143,1653,47,665,835,38
5,-4,0,5.0,-4.0,0.6036226749420166,192.19185590358356,6,159,-139,1653,47,665,835,38
5,-5,0,5.0,-5.0,0.6113436222076416,185.13720875920686,6,154,-134,1653,47,665,835,38
6,-3,0,6.0,-3.0,0.6194686889648438,178.6486782146544,6,148,-131,1653,47,665,835,38
7,-5,0,7.0,-5.0,0.6274898052215576,170.0952141118331,6,141,-126,1653,47,665,835,38
8,-6,0,8.0,-6.0,0.6359477043151855,160.13402803487674,6,133,-120,1653,47,665,835,38
9,-5,0,9.0,-5.0,0.6436817646026611,150.11830178901394,6,124,-115,1653,47,665,835,38
10,-6,0,10.0,-6.0,0.6517086029052734,138.7244432546839,6,114,-109,1653,47,665,835,38
9,-6,0,9.0,-6.0,0.6597237586975098,128.08500943332058,6,105,-103,1653,47,665,835,38
7,-5,0,7.0,-5.0,0.6675577163696289,119.59292911256333,6,98,-98,1653,47,665,835,38
7,-5,0,7.0,-5.0,0.6755156517028809,111.11533345459327,6,91,-93,1653,47,665,835,38
6,-5,0,6.0,-5.0,0.6834466457366943,103.34786471369249,6,85,-88,1653,47,665,835,38
5,-5,0,5.0,-5.0,0.6915178298950195,96.27792503337315,6,80,-83,1653,47,665,835,38
6,-5,0,6.0,-5.0,0.69956374168396,88.5174404457249,6,74,-78,1653,47,665,835,38
5,-6,0,5.0,-6.0,0.7076168060302734,80.72462083156798,6,69,-72,1653,47,665,835,38
5,-4,0,5.0,-4.0,0.7155838012695312,74.38094023943002,6,64,-68,1653,47,665,835,38
3,-5,0,3.0,-5.0,0.7235226631164551,68.69264507357501,6,61,-63,1653,47,665,835,38
2,-4,0,2.0,-4.0,0.731407642364502,64.43860018001261,6,59,-59,1653,47,665,835,38
3,-3,0,3.0,-3.0,0.739433765411377,60.19595949289332,6,56,-56,1653,47,665,835,38
3,-4,0,3.0,-4.0,0.747492790222168,55.24957912338628,6,53,-52,1653,47,665,835,38
3,-2,0,3.0,-2.0,0.7554576396942139,51.710678118654755,6,50,-50,1653,47,665,835,38
2,-3,0,2.0,-3.0,0.7636086940765381,48.178865724273734,6,48,-47,1653,47,665,835,38
3,-3,0,3.0,-3.0,0.7716026306152344,43.93647591023825,6,45,-44,1653,47,665,835,38
2,-1,0,2.0,-1.0,0.7796387672424316,41.81118318204309,6,43,-43,1653,47,665,835,38
2,-2,0,2.0,-2.0,0.7876198291778564,38.982756057296896,6,41,-41,1653,47,665,835,38
1,-1,0,1.0,-1.0,0.7954716682434082,37.568542494923804,6,40,-40,1653,47,665,835,38
2,-2,0,2.0,-2.0,0.8033957481384277,34.74011537017761,6,38,-38,1653,47,665,835,38
2,-2,0,2.0,-2.0,0.8114588260650635,31.91168824543142,6,36,-36,1653,47,665,835,38
1,-1,0,1.0,-1.0,0.8193717002868652,30.49747468305833,6,35,-35,1653,47,665,835,38
2,-2,0,2.0,-2.0,0.8274517059326172,27.669047558312137,6,33,-33,1653,47,665,835,38
2,-2,0,2.0,-2.0,0.8355367183685303,24.840620433565945,6,31,-31,1653,47,665,835,38
2,-2,0,2.0,-2.0,0.8435416221618652,22.012193308819754,6,29,-29,1653,47,665,835,38
2,-2,0,2.0,-2.0,0.8517618179321289,19.18376618407357,6,27,-27,1653,47,665,835,38
2,-3,0,2.0,-3.0,0.8595516681671143,15.655446902326915,6,25,-24,1653,47,665,835,38
2,-2,0,2.0,-2.0,0.8674337863922119,12.827660925679098,6,23,-22,1653,47,665,835,38
2,-3,0,2.0,-3.0,0.8754246234893799,9.319604517012593,6,21,-19,1653,47,665,835,38
3,-3,0,3.0,-3.0,0.8834147453308105,5.0831891575845916,6,18,-16,1653,47,665,835,38
3,-3,0,3.0,-3.0,0.891488790512085,0.8494332412792076,6,15,-13,1653,47,665,835,38
3,-3,0,3.0,-3.0,0.8993957042694092,-3.379500648186692,6,12,-10,1653,47,665,835,38
2,-3,0,2.0,-3.0,0.907801628112793,-6.793444384266298,6,10,-7,1653,47,665,835,38
3,-2,0,3.0,-2.0,0.9157078266143799,-10.397674732957373,6,7,-5,1653,47,665,835,38
2,-2,0,2.0,-2.0,0.9235947132110596,-13.1690481051547,6,5,-3,1653,47,665,835,38
1,-1,0,1.0,-1.0,0.9315576553344727,-14.52786404500042,6,4,-2,1653,47,665,835,38
0,-1,0,-0.0,-1.0,0.9396066665649414,-14.876894374382339,6,4,-1,1653,47,665,835,38
0,0,1,-0.0,-0.0,0.957406759262085,-14.876894374382339,6,4,-1,1653,47,665,835,38
0,0,0,-0.0,-0.0,0.08153533935546875,1321.8566615527227,7,-1064,842,585,890,1649,48,70
1,0,0,1.0,-0.0,0.11357927322387695,1322.6409687395264,7,-1065,842,585,890,1649,48,70
-1,0,0,-1.0,-0.0,0.13764715194702148,1321.8566615527227,7,-1064,842,585,890,1649,48,70
-3,1,0,-3.0,1.0,0.14540815353393555,1318.8840423019985,7,-1061,841,585,890,1649,48,70
-4,0,0,-4.0,-0.0,0.1535782814025879,1315.7516426049608,7,-1057,841,585,890,1649,48,70
-5,2,0,-5.0,2.0,0.16154026985168457,1310.594664079789,7,-1052,839,585,890,1649,48,70
-8,1,0,-8.0,1.0,0.16946625709533691,1303.723272375587,7,-1044,838,585,890,1649,48,70
-12,5,0,-12.0,5.0,0.17751836776733398,1291.2401743274104,7,-1032,833,585,890,1649,48,70
-15,8,0,-15.0,8.0,0.18545317649841309,1274.5472500066578,7,-1017,825,585,890,1649,48,70
-20,14,0,-20.0,14.0,0.19365930557250977,1250.1964830328475,7,-997,811,585,890,1649,48,70
-26,20,0,-26.0,20.0,0.20157718658447266,1217.4064835347988,7,-971,791,585,890,1649,48,70
-34,26,0,-34.0,26.0,0.20960426330566406,1174.6255618992184,7,-937,765,585,890,1649,48,70
-35,27,0,-35.0,27.0,0.21766233444213867,1130.4389730912553,7,-902,738,585,890,1649,48,70
-31,27,0,-31.0,27.0,0.22548222541809082,1089.3495897628993,7,-871,711,585,890,1649,48,70
-30,28,0,-30.0,28.0,0.23347115516662598,1048.4066641847835,7,-841,683,585,890,1649,48,70
-28,27,0,-28.0,27.0,0.24161934852600098,1009.6554455895973,7,-813,656,585,890,1649,48,70
-25,25,0,-25.0,25.0,0.24961018562316895,974.5073055703956,7,-788,631,585,890,1649,48,70
-25,22,0,-25.0,22.0,0.257587194442749,941.2427976686947,7,-763,609,585,890,1649,48,70
-26,24,0,-26.0,24.0,0.26554226875305176,905.953771446823,7,-737,585,585,890,1649,48,70
-25,24,0,-25.0,24.0,0.2735321521759033,871.4573900630961,7,-712,561,585,890,1649,48,70
-27,25,0,-27.0,25.0,0.28174614906311035,834.7821566346369,7,-685,536,585,890,1649,48,70
-28,25,0,-28.0,25.0,0.28960537910461426,797.3280603223707,7,-657,511,585,890,1649,48,70
-29,23,0,-29.0,23.0,0.2975313663482666,760.3162892837038,7,-628,488,585,890,1649,48,70
-28,22,0,-28.0,22.0,0.30552220344543457,724.7078385800689,7,-600,466,585,890,1649,48,70
-25,20,0,-25.0,20.0,0.31362318992614746,692.6956781512448,7,-575,446,585,890,1649,48,70
-24,20,0,-24.0,20.0,0.32159423828125,661.4746944433804,7,-551,426,585,890,1649,48,70
-23,18,0,-23.0,18.0,0.3295621871948242,632.2690611739765,7,-528,408,585,890,1649,48,70
-18,15,0,-18.0,15.0,0.3376011848449707,608.8547972951666,7,-510,393,585,890,1649,48,70
-15,13,0,-15.0,13.0,0.34535932540893555,589.0392615853589,7,-495,380,585,890,1649,48,70
-13,11,0,-13.0,11.0,0.3535652160644531,572.0296533119284,7,-482,369,585,890,1649,48,70
-11,10,0,-11.0,10.0,0.3615562915802002,557.2178653164729,7,-471,359,585,890,1649,48,70
-10,9,0,-10.0,9.0,0.36962437629699707,543.8099860921544,7,-461,350,585,890,1649,48,70
-9,9,0,-9.0,9.0,0.37751126289367676,531.202260680757,7,-452,341,585,890,1649,48,70
-7,8,0,-7.0,8.0,0.3855931758880615,520.8003238574083,7,-445,333,585,890,1649,48,70
-7,7,0,-7.0,7.0,0.3935713768005371,511.0036629913759,7,-438,326,585,890,1649,48,70
-5,6,0,-5.0,6.0,0.4014613628387451,503.4134099370111,7,-433,320,585,890,1649,48,70
-4,4,0,-4.0,4.0,0.40970826148986816,497.81985698733115,7,-429,316,585,890,1649,48,70
-3,4,0,-3.0,4.0,0.41760921478271484,493.0340898086032,7,-426,312,585,890,1649,48,70
-3,3,0,-3.0,3.0,0.4255812168121338,488.8415791057445,7,-423,309,585,890,1649,48,70
-4,4,0,-4.0,4.0,0.4335951805114746,483.2528340491733,7,-419,305,585,890,1649,48,70
-3,5,0,-3.0,5.0,0.4415593147277832,477.88985172257014,7,-416,300,585,890,1649,48,70
-5,6,0,-5.0,6.0,0.4495203495025635,470.3286059585386,7,-411,294,585,890,1649,48,70
-5,6,0,-5.0,6.0,0.45748233795166016,462.7750495956984,7,-406,288,585,890,1649,48,70
-6,8,0,-6.0,8.0,0.4655473232269287,453.2622246293481,7,-400,280,585,890,1649,48,70
-7,6,0,-7.0,6.0,0.47359633445739746,444.0876746483883,7,-393,274,585,890,1649,48,70
-8,7,0,-8.0,7.0,0.4824373722076416,433.5232118049222,7,-385,267,585,890,1649,48,70
-8,6,0,-8.0,6.0,0.48990321159362793,423.53026072441503,7,-377,261,585,890,1649,48,70
-10,7,0,-10.0,7.0,0.49761533737182617,411.323873437216,7,-367,254,585,890,1649,48,70
-10,7,0,-10.0,7.0,0.5060553550720215,399.1174956161062,7,-357,247,585,890,1649,48,70
-12,8,0,-12.0,8.0,0.5135023593902588,384.697510118895,7,-345,239,585,890,1649,48,70
-14,9,0,-14.0,9.0,0.521517276763916,368.06451096567656,7,-331,230,585,890,1649,48,70
-14,9,0,-14.0,9.0,0.5294873714447021,351.4324002979046,7,-317,221,585,890,1649,48,70
-17,11,0,-17.0,11.0,0.5374712944030762,331.1966684720111,7,-300,210,585,890,1649,48,70
-15,10,0,-15.0,10.0,0.5455613136291504,313.1738071710737,7,-285,200,585,890,1649,48,70
-16,11,0,-16.0,11.0,0.5537211894989014,293.7582698579611,7,-269,189,585,890,1649,48,70
-16,11,0,-16.0,11.0,0.5615642070770264,274.3428518650463,7,-253,178,585,890,1649,48,70
-15,11,0,-15.0,11.0,0.5695321559906006,255.74559325981193,7,-238,167,585,890,1649,48,70
-14,10,0,-14.0,10.0,0.5776002407073975,238.5415873317986,7,-224,157,585,890,1649,48,70
-13,9,0,-13.0,9.0,0.5854451656341553,222.73047937719747,7,-211,148,585,890,1649,48,70
-13,8,0,-13.0,8.0,0.5934653282165527,207.49536078036627,7,-198,140,585,890,1649,48,70
-11,7,0,-11.0,7.0,0.6015541553497314,194.4733099948663,7,-187,133,585,890,1649,48,70
-10,7,0,-10.0,7.0,0.6096162796020508,182.26711670199887,7,-177,126,585,890,1649,48,70
-8,6,0,-8.0,6.0,0.6175713539123535,172.27035485085656,7,-169,120,585,890,1649,48,70
-9,7,0,-9.0,7.0,0.6254012584686279,160.88006534611938,7,-160,113,585,890,1649,48,70
-8,6,0,-8.0,6.0,0.633507251739502,150.88437266214714,7,-152,107,585,890,1649,48,70
-8,6,0,-8.0,6.0,0.6415252685546875,140.88916964952674,7,-144,101,585,890,1649,48,70
-6,5,0,-6.0,5.0,0.6494913101196289,133.1071087134628,7,-138,96,585,890,1649,48,70
-6,4,0,-6.0,4.0,0.6573262214660645,125.89748288895012,7,-132,92,585,890,1649,48,70
-6,4,0,-6.0,4.0,0.6654782295227051,118.68799562750502,7,-126,88,585,890,1649,48,70
-7,4,0,-7.0,4.0,0.6741063594818115,110.66056432679369,7,-119,84,585,890,1649,48,70
-6,4,0,-6.0,4.0,0.6814332008361816,103.45215780189199,7,-113,80,585,890,1649,48,70
-7,5,0,-7.0,5.0,0.6897413730621338,94.84991336154215,7,-106,75,585,890,1649,48,70
-7,5,0,-7.0,5.0,0.6976191997528076,86.24768039018313,7,-99,70,585,890,1649,48,70
-6,5,0,-6.0,5.0,0.7056732177734375,78.46365056704283,7,-93,65,585,890,1649,48,70
-6,6,0,-6.0,6.0,0.7135791778564453,70.11898020814318,7,-87,59,585,890,1649,48,70
-8,7,0,-8.0,7.0,0.7215292453765869,59.57801012920498,7,-79,52,585,890,1649,48,70
-8,5,0,-8.0,5.0,0.7296051979064941,50.14693182963201,7,-71,47,585,890,1649,48,70
-8,5,0,-8.0,5.0,0.737626314163208,40.71657678474378,7,-63,42,585,890,1649,48,70
-7,5,0,-7.0,5.0,0.7460982799530029,32.11929677819934,7,-56,37,585,890,1649,48,70
-7,4,0,-7.0,4.0,0.7535521984100342,24.07622195096772,7,-49,33,585,890,1649,48,70
-7,4,0,-7.0,4.0,0.7614891529083252,16.039200620699383,7,-42,29,585,890,1649,48,70
-7,3,0,-7.0,3.0,0.7696373462677002,8.60045871318328,7,-35,26,585,890,1649,48,70
-8,3,0,-8.0,3.0,0.777421236038208,0.46829570193639825,7,-27,23,585,890,1649,48,70
-8,3,0,-8.0,3.0,0.7853913307189941,-7.413771551732555,7,-19,20,585,890,1649,48,70
-6,3,0,-6.0,3.0,0.7935101985931396,-13.599065440967305,7,-13,17,585,890,1649,48,70
-5,2,0,-5.0,2.0,0.801612377166748,-18.0,7,-8,15,585,890,1649,48,70
-3,2,0,-3.0,2.0,0.8094983100891113,-21.07161172281588,7,-5,13,585,890,1649,48,70
-2,3,0,-2.0,3.0,0.8175492286682129,-24.559693491089448,7,-3,10,585,890,1649,48,70
-2,3,0,-2.0,3.0,0.825411319732666,-27.928932188134524,7,-1,7,585,890,1649,48,70
-2,2,0,-2.0,2.0,0.8334431648254395,-29.900980486407214,7,1,5,585,890,1649,48,70
0,0,1,-0.0,-0.0,0.8716132640838623,-29.900980486407214,7,1,5,585,890,1649,48,70
-1,0,1,-1.0,-0.0,0.02405238151550293,513.2063829413592,8,-105,-535,478,350,584,885,64
-1,0,1,-1.0,-0.0,0.03214430809020996,513.0146787014089,8,-104,-535,478,350,584,885,64
-1,0,1,-1.0,-0.0,0.048078298568725586,512.8247424631154,8,-103,-535,478,350,584,885,64
0,0,0,-0.0,-0.0,0.05496335029602051,512.8247424631154,8,-103,-535,478,350,584,885,64
2,0,0,2.0,-0.0,0.08797550201416016,513.2063829413592,8,-105,-535,478,350,584,885,64
2,0,0,2.0,-0.0,0.09598851203918457,513.595087954428,8,-107,-535,478,350,584,885,64
2,-1,0,2.0,-1.0,0.10404348373413086,513.0110090631198,8,-109,-534,478,350,584,885,64
2,-1,0,2.0,-1.0,0.11209344863891602,512.4354874546663,8,-111,-533,478,350,584,885,64
2,-2,0,2.0,-2.0,0.12007331848144531,510.890412514349,8,-113,-531,478,350,584,885,64
2,-2,0,2.0,-2.0,0.12793350219726562,509.35570561323175,8,-115,-529,478,350,584,885,64
3,-3,0,3.0,-3.0,0.13605332374572754,507.07327887774215,8,-118,-526,478,350,584,885,64
4,-3,0,4.0,-3.0,0.14411330223083496,505.0409667800027,8,-122,-523,478,350,584,885,64
6,-5,0,6.0,-5.0,0.15201234817504883,501.58035945862923,8,-128,-518,478,350,584,885,64
10,-7,0,10.0,-7.0,0.16001534461975098,497.3061495958648,8,-138,-511,478,350,584,885,64
13,-9,0,13.0,-9.0,0.167952299118042,492.21846590901396,8,-151,-502,478,350,584,885,64
15,-12,0,15.0,-12.0,0.17614030838012695,485.35481055074763,8,-166,-490,478,350,584,885,64
14,-17,0,14.0,-17.0,0.1841444969177246,474.0918888897549,8,-180,-473,478,350,584,885,64
12,-20,0,12.0,-20.0,0.19205737113952637,460.0091462564492,8,-192,-453,478,350,584,885,64
11,-22,0,11.0,-22.0,0.2000284194946289,444.41368578159046,8,-203,-431,478,350,584,885,64
9,-25,0,9.0,-25.0,0.20801734924316406,426.0174669158372,8,-212,-406,478,350,584,885,64
8,-26,0,8.0,-26.0,0.2160043716430664,407.089968002003,8,-220,-380,478,350,584,885,64
6,-28,0,6.0,-28.0,0.22398829460144043,386.3061080118243,8,-226,-352,478,350,584,885,64
2,-31,0,2.0,-31.0,0.23201346397399902,361.7321424522006,8,-228,-321,478,350,584,885,64
-3,-33,0,-3.0,-33.0,0.2400524616241455,333.47092907644515,8,-225,-288,478,350,584,885,64
-9,-30,0,-9.0,-30.0,0.24802947044372559,304.48179742743883,8,-216,-258,478,350,584,885,64
-9,-24,0,-9.0,-24.0,0.25601744651794434,280.41798923877604,8,-207,-234,478,350,584,885,64
-10,-19,0,-10.0,-19.0,0.26400232315063477,259.6058984314275,8,-197,-215,478,350,584,885,64
-8,-15,0,-8.0,-15.0,0.2720654010772705,243.17449009673845,8,-189,-200,478,350,584,885,64
-9,-15,0,-9.0,-15.0,0.28000330924987793,226.11818998280614,8,-180,-185,478,350,584,885,64
-10,-13,0,-10.0,-13.0,0.2879784107208252,209.83465425782137,8,-170,-172,478,350,584,885,64
-10,-12,0,-10.0,-12.0,0.29671430587768555,194.27416997969522,8,-160,-160,478,350,584,885,64
-11,-10,0,-11.0,-10.0,0.30428051948547363,179.42611002428248,8,-149,-150,478,350,584,885,64
-9,-9,0,-9.0,-9.0,0.31206250190734863,166.69826370655582,8,-140,-141,478,350,584,885,64
-9,-7,0,-9.0,-7.0,0.32013750076293945,155.39530410338463,8,-131,-134,478,350,584,885,64
-7,-3,0,-7.0,-3.0,0.3280503749847412,148.38015411901608,8,-124,-131,478,350,584,885,64
-6,-4,0,-6.0,-4.0,0.3359653949737549,141.35801106380978,8,-118,-127,478,350,584,885,64
-7,-4,0,-7.0,-4.0,0.34406447410583496,133.6804152578089,8,-111,-123,478,350,584,885,64
-6,-3,0,-6.0,-3.0,0.3520324230194092,127.45218719101973,8,-105,-120,478,350,584,885,64
-5,-3,0,-5.0,-3.0,0.3600883483886719,121.91231269784754,8,-100,-117,478,350,584,885,64
-5,-2,0,-5.0,-2.0,0.36817240715026855,117.16433890176299,8,-95,-115,478,350,584,885,64
-2,-2,0,-2.0,-2.0,0.37654542922973633,114.34889818512471,8,-93,-113,478,350,584,885,64
-4,-3,0,-4.0,-3.0,0.38416433334350586,109.49558296992879,8,-89,-110,478,350,584,885,64
-4,-2,0,-4.0,-2.0,0.39230847358703613,105.43725841270262,8,-85,-108,478,350,584,885,64
-4,-3,0,-4.0,-3.0,0.4000663757324219,100.61221663180206,8,-81,-105,478,350,584,885,64
-4,-3,0,-4.0,-3.0,0.4081385135650635,95.80062597655773,8,-77,-102,478,350,584,885,64
-5,-4,0,-5.0,-4.0,0.41614246368408203,89.60592090848209,8,-72,-98,478,350,584,885,64
-4,-3,0,-4.0,-3.0,0.4240844249725342,84.8289347721702,8,-68,-95,478,350,584,885,64
-3,-4,0,-3.0,-4.0,0.4320793151855469,79.83022847155415,8,-65,-91,478,350,584,885,64
-4,-5,0,-4.0,-5.0,0.4400184154510498,73.43718509140881,8,-61,-86,478,350,584,885,64
-4,-5,0,-4.0,-5.0,0.4480173587799072,67.04544411531506,8,-57,-81,478,350,584,885,64
-5,-7,0,-5.0,-7.0,0.4565904140472412,58.44335243676011,8,-52,-74,478,350,584,885,64
-7,-8,0,-7.0,-8.0,0.46411848068237305,47.881161734166085,8,-45,-66,478,350,584,885,64
-6,-6,0,-6.0,-6.0,0.47240543365478516,39.56116265125938,8,-39,-60,478,350,584,885,64
-4,-4,0,-4.0,-4.0,0.48018836975097656,34.037867924396224,8,-35,-56,478,350,584,885,64
-2,-2,0,-2.0,-2.0,0.4880244731903076,31.28506932918696,8,-33,-54,478,350,584,885,64
-1,-3,0,-1.0,-3.0,0.49604129791259766,28.207972893961475,8,-32,-51,478,350,584,885,64
-1,-2,0,-1.0,-2.0,0.5040943622589111,25.982756057296896,8,-31,-49,478,350,584,885,64
-2,-2,0,-2.0,-2.0,0.5121033191680908,23.226805085936306,8,-29,-47,478,350,584,885,64
-1,-2,0,-1.0,-2.0,0.5200464725494385,21.0,8,-28,-45,478,350,584,885,64
0,-2,0,-0.0,-2.0,0.5281233787536621,19.312766442669997,8,-28,-43,478,350,584,885,64
-1,-1,0,-1.0,-1.0,0.5362603664398193,17.929950931279713,8,-27,-42,478,350,584,885,64
0,-1,0,-0.0,-1.0,0.5441033840179443,17.09175083453431,8,-27,-41,478,350,584,885,64
0,0,1,-0.0,-0.0,0.5579354763031006,17.09175083453431,8,-27,-41,478,350,584,885,64
0,0,0,-0.0,-0.0,0.08607172966003418,823.771215167346,9,792,332,1297,723,505,391,70
0,1,0,-0.0,1.0,0.13221979141235352,823.3851117068608,9,792,331,1297,723,505,391,70
4,3,0,4.0,3.0,0.14049291610717773,818.5385169985008,9,788,328,1297,723,505,391,70
6,5,0,6.0,5.0,0.14806485176086426,811.0809653927927,9,782,323,1297,723,505,391,70
5,4,0,5.0,4.0,0.15625977516174316,804.9345212574609,9,777,319,1297,723,505,391,70
6,5,0,6.0,5.0,0.16401290893554688,797.4884383581552,9,771,314,1297,723,505,391,70
9,3,0,9.0,3.0,0.1721508502960205,788.0218709123105,9,762,311,1297,723,505,391,70
10,5,0,10.0,5.0,0.18015575408935547,776.8743745186197,9,752,306,1297,723,505,391,70
14,6,0,14.0,6.0,0.18810272216796875,761.6454669424787,9,738,300,1297,723,505,391,70
19,8,0,19.0,8.0,0.1960897445678711,741.0315715227055,9,719,292,1297,723,505,391,70
28,10,0,28.0,10.0,0.2040848731994629,711.3276760244122,9,691,282,1297,723,505,391,70
31,10,0,31.0,10.0,0.21205592155456543,678.8515251787308,9,660,272,1297,723,505,391,70
34,10,0,34.0,10.0,0.22012972831726074,643.6162391219356,9,626,262,1297,723,505,391,70
33,10,0,33.0,10.0,0.22806382179260254,609.3236764235813,9,593,252,1297,723,505,391,70
31,10,0,31.0,10.0,0.23606586456298828,576.8888788007182,9,562,242,1297,723,505,391,70
30,11,0,30.0,11.0,0.24402976036071777,544.987068821366,9,532,231,1297,723,505,391,70
31,12,0,31.0,12.0,0.25200986862182617,511.774176420211,9,501,219,1297,723,505,391,70
29,12,0,29.0,12.0,0.2601358890533447,480.39596428377274,9,472,207,1297,723,505,391,70
28,12,0,28.0,12.0,0.2680697441101074,449.9340161300298,9,444,195,1297,723,505,391,70
29,12,0,29.0,12.0,0.2761118412017822,418.5570526405691,9,415,183,1297,723,505,391,70
26,13,0,26.0,13.0,0.28406476974487305,389.5244398147179,9,389,170,1297,723,505,391,70
26,12,0,26.0,12.0,0.29224491119384766,360.8951881495909,9,363,158,1297,723,505,391,70
24,11,0,24.0,11.0,0.30039191246032715,334.4996617048519,9,339,147,1297,723,505,391,70
24,11,0,24.0,11.0,0.30794477462768555,308.1049402150893,9,315,136,1297,723,505,391,70
23,11,0,23.0,11.0,0.31612372398376465,282.63028822831114,9,292,125,1297,723,505,391,70
23,10,0,23.0,10.0,0.3240838050842285,257.5508502807674,9,269,115,1297,723,505,391,70
22,9,0,22.0,9.0,0.3321077823638916,233.78430013674534,9,247,106,1297,723,505,391,70
21,8,0,21.0,8.0,0.34004878997802734,211.3331078032346,9,226,98,1297,723,505,391,70
19,8,0,19.0,8.0,0.3481438159942627,190.71885167172013,9,207,90,1297,723,505,391,70
16,7,0,16.0,7.0,0.3563387393951416,173.25465180878913,9,191,83,1297,723,505,391,70
15,6,0,15.0,6.0,0.3642427921295166,157.1067411623028,9,176,77,1297,723,505,391,70
12,7,0,12.0,7.0,0.37216782569885254,143.31432920547917,9,164,70,1297,723,505,391,70
11,6,0,11.0,6.0,0.3800177574157715,130.8463143998081,9,153,64,1297,723,505,391,70
9,6,0,9.0,6.0,0.3881707191467285,120.24174696260025,9,144,58,1297,723,505,391,70
8,4,0,8.0,4.0,0.3960838317871094,111.32839779072276,9,136,54,1297,723,505,391,70
6,4,0,6.0,4.0,0.4040799140930176,104.2838827718412,9,130,50,1297,723,505,391,70
5,2,0,5.0,2.0,0.41223883628845215,98.89921583041479,9,125,48,1297,723,505,391,70
4,2,0,4.0,2.0,0.42084574699401855,94.4488315899375,9,121,46,1297,723,505,391,70
2,1,0,2.0,1.0,0.4288647174835205,92.22421153223941,9,119,45,1297,723,505,391,70
1,1,0,1.0,1.0,0.43619370460510254,90.93649193144932,9,118,44,1297,723,505,391,70
1,0,0,1.0,-0.0,0.4442157745361328,90.0,9,117,44,1297,723,505,391,70
1,0,0,1.0,-0.0,0.4922177791595459,89.06449935416659,9,116,44,1297,723,505,391,70
2,1,0,2.0,1.0,0.5006997585296631,86.8400590938793,9,114,43,1297,723,505,391,70
3,1,0,3.0,1.0,0.5081527233123779,83.68024266911489,9,111,42,1297,723,505,391,70
4,2,0,4.0,2.0,0.5161738395690918,79.23221962301179,9,107,40,1297,723,505,391,70
5,2,0,5.0,2.0,0.5240678787231445,73.84851859350222,9,102,38,1297,723,505,391,70
7,3,0,7.0,3.0,0.5321488380432129,66.24228365658294,9,95,35,1297,723,505,391,70
8,3,0,8.0,3.0,0.5400867462158203,57.69843580125827,9,87,32,1297,723,505,391,70
10,2,0,10.0,2.0,0.5481927394866943,47.63776376451628,9,77,30,1297,723,505,391,70
10,4,0,10.0,4.0,0.5561978816986084,36.867934435323804,9,67,26,1297,723,505,391,70
9,4,0,9.0,4.0,0.5640769004821777,27.032249677083293,9,58,22,1297,723,505,391,70
9,3,0,9.0,3.0,0.5720477104187012,17.55473337388365,9,49,19,1297,723,505,391,70
7,4,0,7.0,4.0,0.5801467895507812,9.598206241955516,9,42,15,1297,723,505,391,70
7,3,0,7.0,3.0,0.5881617069244385,2.0,9,35,12,1297,723,505,391,70
5,2,0,5.0,2.0,0.5962498188018799,-3.3772233983162074,9,30,10,1297,723,505,391,70
4,2,0,4.0,2.0,0.6041877269744873,-7.797058982529112,9,26,8,1297,723,505,391,70
3,1,0,3.0,1.0,0.6122958660125732,-10.958369439657385,9,23,7,1297,723,505,391,70
1,1,0,1.0,1.0,0.6200447082519531,-12.196491498017242,9,22,6,1297,723,505,391,70
0,0,1,-0.0,-0.0,0.6592319011688232,-12.196491498017242,9,22,6,1297,723,505,391,70
0,0,0,-0.0,-0.0,0.06859946250915527,656.4161767081133,10,235,-646,1510,71,1275,717,62
1,0,0,1.0,-0.0,0.11158347129821777,656.0749595204296,10,234,-646,1510,71,1275,717,62
-2,0,0,-2.0,-0.0,0.1515204906463623,656.7586786075476,10,236,-646,1510,71,1275,717,62
-2,0,0,-2.0,-0.0,0.1594843864440918,657.447528864764,10,238,-646,1510,71,1275,717,62
-2,0,0,-2.0,-0.0,0.1678915023803711,658.141494905074,10,240,-646,1510,71,1275,717,62
-4,-1,0,-4.0,-1.0,0.17555546760559082,658.6093096819387,10,244,-645,1510,71,1275,717,62
-2,-5,0,-2.0,-5.0,0.18355154991149902,654.6500565157127,10,246,-640,1510,71,1275,717,62
0,-8,0,-0.0,-8.0,0.19155144691467285,647.1887642832193,10,246,-632,1510,71,1275,717,62
1,-14,0,1.0,-14.0,0.19966745376586914,633.7924488139137,10,245,-618,1510,71,1275,717,62
0,-21,0,-0.0,-21.0,0.20767641067504883,614.3169763767261,10,245,-597,1510,71,1275,717,62
1,-25,0,1.0,-25.0,0.21558356285095215,590.8681532286406,10,244,-572,1510,71,1275,717,62
0,-27,0,-0.0,-27.0,0.22359156608581543,566.1272896125247,10,244,-545,1510,71,1275,717,62
2,-25,0,2.0,-25.0,0.2314014434814453,542.5538335675213,10,242,-520,1510,71,1275,717,62
3,-23,0,3.0,-23.0,0.2393934726715088,520.4798273735857,10,239,-497,1510,71,1275,717,62
4,-23,0,4.0,-23.0,0.24746346473693848,498.0567077355697,10,235,-474,1510,71,1275,717,62
7,-22,0,7.0,-22.0,0.2555553913116455,475.24895061619634,10,228,-452,1510,71,1275,717,62
8,-22,0,8.0,-22.0,0.26363635063171387,452.01138702933287,10,220,-430,1510,71,1275,717,62
11,-21,0,11.0,-21.0,0.271714448928833,428.30599821905224,10,209,-409,1510,71,1275,717,62
11,-21,0,11.0,-21.0,0.2794475555419922,404.600734618297,10,198,-388,1510,71,1275,717,62
13,-21,0,13.0,-21.0,0.2875044345855713,379.9914840966903,10,185,-367,1510,71,1275,717,62
15,-20,0,15.0,-20.0,0.2954683303833008,355.4052277079077,10,170,-347,1510,71,1275,717,62
17,-21,0,17.0,-21.0,0.3034543991088867,329.1180362047977,10,153,-326,1510,71,1275,717,62
18,-19,0,18.0,-19.0,0.3114893436431885,304.37143587371895,10,135,-307,1510,71,1275,717,62
20,-18,0,20.0,-18.0,0.31980037689208984,280.0401903291599,10,115,-289,1510,71,1275,717,62
20,-15,0,20.0,-15.0,0.3277254104614258,259.0017241328058,10,95,-274,1510,71,1275,717,62
19,-15,0,19.0,-15.0,0.33574342727661133,238.92035862453946,10,76,-259,1510,71,1275,717,62
17,-14,0,17.0,-14.0,0.3434765338897705,221.0039682227246,10,59,-245,1510,71,1275,717,62
18,-15,0,18.0,-15.0,0.35148143768310547,202.62576912660984,10,41,-230,1510,71,1275,717,62
17,-15,0,17.0,-15.0,0.35948944091796875,185.33538776631067,10,24,-215,1510,71,1275,717,62
15,-15,0,15.0,-15.0,0.3674194812774658,169.2023975880409,10,9,-200,1510,71,1275,717,62
13,-14,0,13.0,-14.0,0.37562036514282227,155.04300578092153,10,-4,-186,1510,71,1275,717,62
13,-15,0,13.0,-15.0,0.38373756408691406,140.8429515575195,10,-17,-171,1510,71,1275,717,62
11,-12,0,11.0,-12.0,0.3914813995361328,130.4465855941215,10,-28,-159,1510,71,1275,717,62
10,-12,0,10.0,-12.0,0.39989447593688965,120.83214415926557,10,-38,-147,1510,71,1275,717,62
9,-12,0,9.0,-12.0,0.4075443744659424,111.94754282603111,10,-47,-135,1510,71,1275,717,62
7,-10,0,7.0,-10.0,0.41558241844177246,105.1653406708183,10,-54,-125,1510,71,1275,717,62
6,-10,0,6.0,-10.0,0.42351651191711426,98.71121771072848,10,-60,-115,1510,71,1275,717,62
5,-9,0,5.0,-9.0,0.4315824508666992,93.34226956268733,10,-65,-106,1510,71,1275,717,62
3,-7,0,3.0,-7.0,0.4395265579223633,89.10412149464314,10,-68,-99,1510,71,1275,717,62
1,-6,0,1.0,-6.0,0.44755053520202637,84.80155439371269,10,-69,-93,1510,71,1275,717,62
1,-6,0,1.0,-6.0,0.455397367477417,80.66467659918243,10,-70,-87,1510,71,1275,717,62
0,-6,0,-0.0,-6.0,0.46354246139526367,76.05606008068857,10,-70,-81,1510,71,1275,717,62
0,-5,0,-0.0,-5.0,0.47144055366516113,72.32473082471591,10,-70,-76,1510,71,1275,717,62
-1,-5,0,-1.0,-5.0,0.4794595241546631,68.00505037623081,10,-69,-71,1510,71,1275,717,62
-2,-4,0,-2.0,-4.0,0.4874303340911865,63.752308678997366,10,-67,-67,1510,71,1275,717,62
-4,-5,0,-4.0,-5.0,0.49544548988342285,57.3911760301898,10,-63,-62,1510,71,1275,717,62
-3,-3,0,-3.0,-3.0,0.503577470779419,53.1486779456457,10,-60,-59,1510,71,1275,717,62
-5,-4,0,-5.0,-4.0,0.5114154815673828,46.78174593052023,10,-55,-55,1510,71,1275,717,62
-5,-3,0,-5.0,-3.0,0.5195004940032959,41.13875518748573,10,-50,-52,1510,71,1275,717,62
-4,-4,0,-4.0,-4.0,0.5274474620819092,35.483080554378645,10,-46,-48,1510,71,1275,717,62
-4,-3,0,-4.0,-3.0,0.5354704856872559,30.554853586049575,10,-42,-45,1510,71,1275,717,62
-5,-4,0,-5.0,-4.0,0.5435135364532471,24.226805085936306,10,-37,-41,1510,71,1275,717,62
-5,-4,0,-5.0,-4.0,0.5513684749603271,17.918299234540036,10,-32,-37,1510,71,1275,717,62
-5,-3,0,-5.0,-3.0,0.5596094131469727,12.416586692184822,10,-27,-34,1510,71,1275,717,62
-4,-4,0,-4.0,-4.0,0.5675604343414307,6.802116342871599,10,-23,-30,1510,71,1275,717,62
-2,-2,0,-2.0,-2.0,0.5753824710845947,4.0,10,-21,-28,1510,71,1275,717,62
-2,-2,0,-2.0,-2.0,0.5834953784942627,1.2024843762092345,10,-19,-26,1510,71,1275,717,62
0,-1,0,-0.0,-1.0,0.591482400894165,0.4006369362151645,10,-19,-25,1510,71,1275,717,62
0,0,1,-0.0,-0.0,0.603717565536499,0.4006369362151645,10,-19,-25,1510,71,1275,717,62
0,0,0,-0.0,-0.0,0.09778690338134766,1556.571868410438,11,-1483,538,46,634,1529,96,43
-1,1,0,-1.0,1.0,0.16098284721374512,1555.2908995486841,11,-1482,537,46,634,1529,96,43
-4,7,0,-4.0,7.0,0.1688218116760254,1549.1541325615137,11,-1478,530,46,634,1529,96,43
-9,13,0,-9.0,13.0,0.17675280570983887,1536.3214183334153,11,-1469,517,46,634,1529,96,43
-12,18,0,-12.0,18.0,0.1846907138824463,1519.0811666921975,11,-1457,499,46,634,1529,96,43
-15,22,0,-15.0,22.0,0.19266676902770996,1497.8459434715558,11,-1442,477,46,634,1529,96,43
-17,25,0,-17.0,25.0,0.20083189010620117,1473.9678926318118,11,-1425,452,46,634,1529,96,43
-19,25,0,-19.0,25.0,0.20876193046569824,1448.4097454420262,11,-1406,427,46,634,1529,96,43
-23,24,0,-23.0,24.0,0.21680879592895508,1419.5200449837553,11,-1383,403,46,634,1529,96,43
-27,22,0,-27.0,22.0,0.22497081756591797,1387.5087859150897,11,-1356,381,46,634,1529,96,43
-28,20,0,-28.0,20.0,0.232954740524292,1355.1922104124844,11,-1328,361,46,634,1529,96,43
-33,18,0,-33.0,18.0,0.2408459186553955,1318.6544330535394,11,-1295,343,46,634,1529,96,43
-36,17,0,-36.0,17.0,0.2487657070159912,1279.521818348312,11,-1259,326,46,634,1529,96,43
-39,15,0,-39.0,15.0,0.25679969787597656,1238.0158855232924,11,-1220,311,46,634,1529,96,43
-45,14,0,-45.0,14.0,0.2650167942047119,1190.9546196124672,11,-1175,297,46,634,1529,96,43
-47,11,0,-47.0,11.0,0.2731177806854248,1142.6923992189688,11,-1128,286,46,634,1529,96,43
-51,8,0,-51.0,8.0,0.2810077667236328,1091.3007686772494,11,-1077,278,46,634,1529,96,43
-55,7,0,-55.0,7.0,0.288787841796875,1036.319724586655,11,-1022,271,46,634,1529,96,43
-56,5,0,-56.0,5.0,0.2967698574066162,980.9540907646418,11,-966,266,46,634,1529,96,43
-60,4,0,-60.0,4.0,0.3047947883605957,922.122473488995,11,-906,262,46,634,1529,96,43
-57,4,0,-57.0,4.0,0.3128688335418701,866.3359003218567,11,-849,258,46,634,1529,96,43
-54,4,0,-54.0,4.0,0.3207728862762451,813.5903186594007,11,-795,254,46,634,1529,96,43
-50,6,0,-50.0,6.0,0.32893872261047363,764.1936066983735,11,-745,248,46,634,1529,96,43
-45,7,0,-45.0,7.0,0.33689379692077637,719.3249286630837,11,-700,241,46,634,1529,96,43
-40,6,0,-40.0,6.0,0.34485888481140137,679.5890378816956,11,-660,235,46,634,1529,96,43
-37,6,0,-37.0,6.0,0.35276269912719727,642.7544726779624,11,-623,229,46,634,1529,96,43
-31,4,0,-31.0,4.0,0.360792875289917,612.3158769524099,11,-592,225,46,634,1529,96,43
-28,4,0,-28.0,4.0,0.3688948154449463,584.7532500944588,11,-564,221,46,634,1529,96,43
-24,3,0,-24.0,3.0,0.3768448829650879,561.343541219442,11,-540,218,46,634,1529,96,43
-22,3,0,-22.0,3.0,0.3848717212677002,539.8466813666637,11,-518,215,46,634,1529,96,43
-18,2,0,-18.0,2.0,0.39292073249816895,522.4786104346701,11,-500,213,46,634,1529,96,43
-14,4,0,-14.0,4.0,0.40077877044677734,508.03402537076954,11,-486,209,46,634,1529,96,43
-13,3,0,-13.0,3.0,0.4089207649230957,494.911814169825,11,-473,206,46,634,1529,96,43
-8,3,0,-8.0,3.0,0.4168999195098877,486.37954235463616,11,-465,203,46,634,1529,96,43
-9,4,0,-9.0,4.0,0.4248027801513672,476.53090356278375,11,-456,199,46,634,1529,96,43
-7,4,0,-7.0,4.0,0.43294286727905273,468.5160875803777,11,-449,195,46,634,1529,96,43
-7,3,0,-7.0,3.0,0.4407799243927002,460.9004046480974,11,-442,192,46,634,1529,96,43
-9,4,0,-9.0,4.0,0.4487779140472412,451.0519039258289,11,-433,188,46,634,1529,96,43
-8,4,0,-8.0,4.0,0.4567837715148926,442.1209345300642,11,-425,184,46,634,1529,96,43
-9,4,0,-9.0,4.0,0.4650099277496338,432.2725449439884,11,-416,180,46,634,1529,96,43
-10,5,0,-10.0,5.0,0.47294187545776367,421.1097148898676,11,-406,175,46,634,1529,96,43
-11,6,0,-11.0,6.0,0.48089075088500977,408.6347285776605,11,-395,169,46,634,1529,96,43
-11,6,0,-11.0,6.0,0.48902177810668945,396.163037672323,11,-384,163,46,634,1529,96,43
-12,7,0,-12.0,7.0,0.49693870544433594,382.3856715353187,11,-372,156,46,634,1529,96,43
-12,7,0,-12.0,7.0,0.5048267841339111,368.61647809095547,11,-360,149,46,634,1529,96,43
-11,6,0,-11.0,6.0,0.5127599239349365,356.1604433129222,11,-349,143,46,634,1529,96,43
-12,7,0,-12.0,7.0,0.5207967758178711,342.40748478808194,11,-337,136,46,634,1529,96,43
-10,8,0,-10.0,8.0,0.5288877487182617,330.15950791627444,11,-327,128,46,634,1529,96,43
-12,8,0,-12.0,8.0,0.5367817878723145,316.08307581366347,11,-315,120,46,634,1529,96,43
-13,8,0,-13.0,8.0,0.5449357032775879,301.0993635510632,11,-302,112,46,634,1529,96,43
-15,10,0,-15.0,10.0,0.5527527332305908,283.58660508958695,11,-287,102,46,634,1529,96,43
-16,9,0,-16.0,9.0,0.5609958171844482,265.5135249861689,11,-271,93,46,634,1529,96,43
-15,10,0,-15.0,10.0,0.5689249038696289,248.1189328159578,11,-256,83,46,634,1529,96,43
-16,9,0,-16.0,9.0,0.5767488479614258,230.14935795259362,11,-240,74,46,634,1529,96,43
-15,10,0,-15.0,10.0,0.5848677158355713,212.92520172054998,11,-225,64,46,634,1529,96,43
-16,8,0,-16.0,8.0,0.5927608013153076,195.37236422426963,11,-209,56,46,634,1529,96,43
-15,7,0,-15.0,7.0,0.6007487773895264,179.09247861926244,11,-194,49,46,634,1529,96,43
-15,7,0,-15.0,7.0,0.6087608337402344,162.86136081297778,11,-179,42,46,634,1529,96,43
-15,5,0,-15.0,5.0,0.6168649196624756,147.12197952677099,11,-164,37,46,634,1529,96,43
-16,4,0,-16.0,4.0,0.6250457763671875,130.63442880823604,11,-148,33,46,634,1529,96,43
-15,5,0,-15.0,5.0,0.6329119205474854,114.91541487263319,11,-133,28,46,634,1529,96,43
-13,4,0,-13.0,4.0,0.6408329010009766,101.37646832622684,11,-120,24,46,634,1529,96,43
-12,2,0,-12.0,2.0,0.6488797664642334,89.21796586763884,11,-108,22,46,634,1529,96,43
-11,3,0,-11.0,3.0,0.6567819118499756,77.84331034521254,11,-97,19,46,634,1529,96,43
-10,3,0,-10.0,3.0,0.6648557186126709,67.45903006477066,11,-87,16,46,634,1529,96,43
-9,2,0,-9.0,2.0,0.6728658676147461,58.2464510246358,11,-78,14,46,634,1529,96,43
-10,2,0,-10.0,2.0,0.6808679103851318,48.05070600652827,11,-68,12,46,634,1529,96,43
-9,2,0,-9.0,2.0,0.688971757888794,38.841457201508724,11,-59,10,46,634,1529,96,43
-8,2,0,-8.0,2.0,0.6967697143554688,30.62363799656123,11,-51,8,46,634,1529,96,43
-8,2,0,-8.0,2.0,0.7047758102416992,22.416586692184822,11,-43,6,46,634,1529,96,43
-8,2,0,-8.0,2.0,0.7127878665924072,14.227829907617071,11,-35,4,46,634,1529,96,43
-7,2,0,-7.0,2.0,0.7208096981048584,7.071337695236398,11,-28,2,46,634,1529,96,43
-6,2,0,-6.0,2.0,0.7287707328796387,1.0,11,-22,0,46,634,1529,96,43
-5,2,0,-5.0,2.0,0.7369377613067627,-3.88275723137631,11,-17,-2,46,634,1529,96,43
-5,2,0,-5.0,2.0,0.7448587417602539,-8.350889359326482,11,-12,-4,46,634,1529,96,43
-4,1,0,-4.0,1.0,0.7529349327087402,-11.566018867943397,11,-8,-5,46,634,1529,96,43
-3,2,0,-3.0,2.0,0.7608847618103027,-12.397674732957373,11,-5,-7,46,634,1529,96,43
-3,1,0,-3.0,1.0,0.7688517570495605,-12.753788748764679,11,-2,-8,46,634,1529,96,43
-3,1,0,-3.0,1.0,0.7767627239227295,-11.944614861862583,11,1,-9,46,634,1529,96,43
-2,1,0,-2.0,1.0,0.7848618030548096,-10.55969349108945,11,3,-10,46,634,1529,96,43
-3,1,0,-3.0,1.0,0.792759895324707,-8.470035913858332,11,6,-11,46,634,1529,96,43
-2,1,0,-2.0,1.0,0.8006737232208252,-6.5777948981440435,11,8,-12,46,634,1529,96,43
-1,0,0,-1.0,-0.0,0.8092548847198486,-6.0,11,9,-12,46,634,1529,96,43
-2,1,0,-2.0,1.0,0.8168487548828125,-3.9706136340735974,11,11,-13,46,634,1529,96,43
0,0,1,-0.0,-0.0,0.8497827053070068,-3.9706136340735974,11,11,-13,46,634,1529,96,43
1,0,1,1.0,-0.0,0.0020949840545654297,359.94009949469984,12,373,-91,409,556,35,647,48
0,1,1,-0.0,1.0,0.009965896606445312,360.17834400184506,12,373,-92,409,556,35,647,48
1,0,1,1.0,-0.0,0.058278799057006836,359.20751558391964,12,372,-92,409,556,35,647,48
0,0,0,-0.0,-0.0,0.08208680152893066,359.20751558391964,12,372,-92,409,556,35,647,48
2,0,0,2.0,-0.0,0.08989191055297852,357.26631112648806,12,370,-92,409,556,35,647,48
4,-1,0,4.0,-1.0,0.09787893295288086,353.1432088742949,12,366,-91,409,556,35,647,48
5,0,0,5.0,-0.0,0.10595297813415527,348.29289544658246,12,361,-91,409,556,35,647,48
6,-1,0,6.0,-1.0,0.11406493186950684,342.23080154459973,12,355,-90,409,556,35,647,48
8,-1,0,8.0,-1.0,0.12211084365844727,334.23176855214837,12,347,-89,409,556,35,647,48
11,-2,0,11.0,-2.0,0.13006591796875,323.08068226278453,12,336,-87,409,556,35,647,48
9,-2,0,9.0,-2.0,0.13796591758728027,313.86683767425296,12,327,-85,409,556,35,647,48
9,-2,0,9.0,-2.0,0.14590883255004883,304.65331277807013,12,318,-83,409,556,35,647,48
9,-2,0,9.0,-2.0,0.15405797958374023,295.4401352366355,12,309,-81,409,556,35,647,48
9,-1,0,9.0,-1.0,0.16212677955627441,286.4834939252005,12,300,-80,409,556,35,647,48
10,-2,0,10.0,-2.0,0.16986393928527832,276.3065100859454,12,290,-78,409,556,35,647,48
13,-4,0,13.0,-4.0,0.17792177200317383,262.7141433553636,12,277,-74,409,556,35,647,48
15,-4,0,15.0,-4.0,0.18608379364013672,247.189970316013,12,262,-70,409,556,35,647,48
18,-4,0,18.0,-4.0,0.19385695457458496,228.76866894455097,12,244,-66,409,556,35,647,48
20,-4,0,20.0,-4.0,0.2018418312072754,208.42202993692314,12,224,-62,409,556,35,647,48
21,-5,0,21.0,-5.0,0.21007084846496582,186.85065804972012,12,203,-57,409,556,35,647,48
21,-4,0,21.0,-4.0,0.21789097785949707,165.5600168811978,12,182,-53,409,556,35,647,48
20,-4,0,20.0,-4.0,0.22596096992492676,145.24833824885843,12,162,-49,409,556,35,647,48
21,-4,0,21.0,-4.0,0.2340548038482666,124.00675660252813,12,141,-45,409,556,35,647,48
19,-4,0,19.0,-4.0,0.24192380905151367,104.70508925446578,12,122,-41,409,556,35,647,48
21,-3,0,21.0,-3.0,0.250108003616333,83.91200118615167,12,101,-38,409,556,35,647,48
17,-1,0,17.0,-1.0,0.2579669952392578,67.7877987534291,12,84,-37,409,556,35,647,48
18,-1,0,18.0,-1.0,0.2660038471221924,51.179784516850006,12,66,-36,409,556,35,647,48
16,-1,0,16.0,-1.0,0.27400994300842285,37.032778078668514,12,50,-35,409,556,35,647,48
15,-1,0,15.0,-1.0,0.282012939453125,24.795491595023407,12,35,-34,409,556,35,647,48
13,0,0,13.0,-0.0,0.28996896743774414,16.496913462633174,12,22,-34,409,556,35,647,48
12,-2,0,12.0,-2.0,0.29788899421691895,9.526109228480422,12,10,-32,409,556,35,647,48
12,-1,0,12.0,-1.0,0.30591678619384766,7.064449134018133,12,-2,-31,409,556,35,647,48
13,0,0,13.0,-0.0,0.3139488697052002,10.438350715445125,12,-15,-31,409,556,35,647,48
13,-1,0,13.0,-1.0,0.3222048282623291,17.036569057366385,12,-28,-30,409,556,35,647,48
9,-1,0,9.0,-1.0,0.3300647735595703,23.010637094172637,12,-37,-29,409,556,35,647,48
5,-1,0,5.0,-1.0,0.33800196647644043,26.47771785649585,12,-42,-28,409,556,35,647,48
1,0,0,1.0,-0.0,0.3461289405822754,27.312766442669997,12,-43,-28,409,556,35,647,48
0,0,1,-0.0,-0.0,0.4380979537963867,27.312766442669997,12,-43,-28,409,556,35,647,48
1,0,1,1.0,-0.0,0.5140419006347656,28.153619241621193,12,-44,-28,409,556,35,647,48
1,-1,1,1.0,-1.0,0.5300178527832031,28.478567053607705,12,-45,-27,409,556,35,647,48
0,0,0,-0.0,-0.0,0.5328028202056885,28.478567053607705,12,-45,-27,409,556,35,647,48
2,0,0,2.0,-0.0,0.5379898548126221,30.203320931470607,12,-47,-27,409,556,35,647,48
3,0,0,3.0,-0.0,0.5459389686584473,32.824290580701486,12,-50,-27,409,556,35,647,48
2,-1,0,2.0,-1.0,0.5540978908538818,34.137767414994535,12,-52,-26,409,556,35,647,48
3,0,0,3.0,-0.0,0.5621027946472168,36.83584469702052,12,-55,-26,409,556,35,647,48
1,-1,0,1.0,-1.0,0.5700538158416748,37.326992425847855,12,-56,-25,409,556,35,647,48
1,0,0,1.0,-0.0,0.5780339241027832,38.24146527838174,12,-57,-25,409,556,35,647,48
1,0,0,1.0,-0.0,0.5860397815704346,39.15853069855251,12,-58,-25,409,556,35,647,48
0,-1,0,-0.0,-1.0,0.626147985458374,38.76941930590086,12,-58,-24,409,556,35,647,48
-3,-1,0,-3.0,-1.0,0.6341328620910645,35.61543424315552,12,-55,-23,409,556,35,647,48
-4,-1,0,-4.0,-1.0,0.6420669555664062,31.54277630799526,12,-51,-22,409,556,35,647,48
-4,-2,0,-4.0,-2.0,0.6500508785247803,27.078371156488537,12,-47,-20,409,556,35,647,48
-4,-3,0,-4.0,-3.0,0.6579928398132324,22.238512086787566,12,-43,-17,409,556,35,647,48
-5,-3,0,-5.0,-3.0,0.6660478115081787,16.496913462633174,12,-38,-14,409,556,35,647,48
-5,-2,0,-5.0,-2.0,0.673975944519043,11.114099732158877,12,-33,-12,409,556,35,647,48
-4,-2,0,-4.0,-2.0,0.6821320056915283,6.6757233003559335,12,-29,-10,409,556,35,647,48
-2,-2,0,-2.0,-2.0,0.6899538040161133,4.160255680657446,12,-27,-8,409,556,35,647,48
-3,0,0,-3.0,-0.0,0.6979508399963379,1.2982212813470362,12,-24,-8,409,556,35,647,48
-2,-1,0,-2.0,-1.0,0.705894947052002,-0.9132072387696084,12,-22,-7,409,556,35,647,48
-2,0,0,-2.0,-0.0,0.7139809131622314,-2.810379899582909,12,-20,-7,409,556,35,647,48
0,0,1,-0.0,-0.0,0.7309730052947998,-2.810379899582909,12,-20,-7,409,556,35,647,48
0,0,0,-0.0,-0.0,0.1120290756225586,569.2319125571871,13,225,-537,654,26,429,563,26
2,0,0,2.0,-0.0,0.15515804290771484,568.4619506038207,13,223,-537,654,26,429,563,26
5,0,0,5.0,-0.0,0.16318202018737793,566.5627662298537,13,218,-537,654,26,429,563,26
8,0,0,8.0,-0.0,0.17111611366271973,563.6012486979195,13,210,-537,654,26,429,563,26
13,-2,0,13.0,-2.0,0.1790602207183838,557.1175317423592,13,197,-535,654,26,429,563,26
16,-2,0,16.0,-2.0,0.1871042251586914,549.8943062422998,13,181,-533,654,26,429,563,26
19,-5,0,19.0,-5.0,0.19497013092041016,539.2934002864781,13,162,-528,654,26,429,563,26
21,-8,0,21.0,-8.0,0.20306611061096191,525.7773194929423,13,141,-520,654,26,429,563,26
22,-9,0,22.0,-9.0,0.21110224723815918,511.6732316404183,13,119,-511,654,26,429,563,26
20,-10,0,20.0,-10.0,0.21915817260742188,497.687771539519,13,99,-501,654,26,429,563,26
19,-13,0,19.0,-13.0,0.22704124450683594,481.5139027368189,13,80,-488,654,26,429,563,26
20,-17,0,20.0,-17.0,0.23543214797973633,461.806276285392,13,60,-471,654,26,429,563,26
20,-21,0,20.0,-21.0,0.24319124221801758,438.7742799230607,13,40,-450,654,26,429,563,26
18,-23,0,18.0,-23.0,0.2511022090911865,414.56636911712314,13,22,-427,654,26,429,563,26
14,-27,0,14.0,-27.0,0.2591731548309326,387.0799920015996,13,8,-400,654,26,429,563,26
11,-28,0,11.0,-28.0,0.26706910133361816,359.01209657751724,13,-3,-372,654,26,429,563,26
8,-29,0,8.0,-29.0,0.27506113052368164,330.17633951075356,13,-11,-343,654,26,429,563,26
6,-27,0,6.0,-27.0,0.28298211097717285,303.45694809878955,13,-17,-316,654,26,429,563,26
3,-26,0,3.0,-26.0,0.29107213020324707,277.68883707497264,13,-20,-290,654,26,429,563,26
0,-27,0,-0.0,-27.0,0.29903316497802734,250.75936002348806,13,-20,-263,654,26,429,563,26
0,-25,0,-0.0,-25.0,0.3072061538696289,225.83885781003056,13,-20,-238,654,26,429,563,26
-1,-24,0,-1.0,-24.0,0.3150761127471924,201.84180226389836,13,-19,-214,654,26,429,563,26
-2,-20,0,-2.0,-20.0,0.32296013832092285,181.74342094150447,13,-17,-194,654,26,429,563,26
-2,-16,0,-2.0,-16.0,0.33107423782348633,165.63090438107287,13,-15,-178,654,26,429,563,26
-2,-14,0,-2.0,-14.0,0.33901405334472656,151.51443705644803,13,-13,-164,654,26,429,563,26
-3,-12,0,-3.0,-12.0,0.3471062183380127,139.3285921946369,13,-10,-152,654,26,429,563,26
-1,-13,0,-1.0,-13.0,0.3550410270690918,126.29106216839614,13,-9,-139,654,26,429,563,26
-1,-13,0,-1.0,-13.0,0.36293816566467285,113.25371281669304,13,-8,-126,654,26,429,563,26
-2,-12,0,-2.0,-12.0,0.3710482120513916,101.15778554264269,13,-6,-114,654,26,429,563,26
0,-10,0,-0.0,-10.0,0.379108190536499,91.17293314484334,13,-6,-104,654,26,429,563,26
-1,-9,0,-1.0,-9.0,0.3936312198638916,82.13148795220224,13,-5,-95,654,26,429,563,26
-1,-6,0,-1.0,-6.0,0.3949730396270752,76.08984229416954,13,-4,-89,654,26,429,563,26
0,-5,0,-0.0,-5.0,0.403170108795166,71.09518416651456,13,-4,-84,654,26,429,563,26
0,-4,0,-0.0,-4.0,0.411060094833374,67.09993757800315,13,-4,-80,654,26,429,563,26
0,-4,0,-0.0,-4.0,0.41909313201904297,63.105190361761785,13,-4,-76,654,26,429,563,26
0,-3,0,-0.0,-3.0,0.4269702434539795,60.109506905736964,13,-4,-73,654,26,429,563,26
0,-3,0,-0.0,-3.0,0.4350621700286865,57.11419257183242,13,-4,-70,654,26,429,563,26
0,-3,0,-0.0,-3.0,0.44308924674987793,54.11929677819934,13,-4,-67,654,26,429,563,26
1,-3,0,1.0,-3.0,0.4514172077178955,51.19501538281614,13,-5,-64,654,26,429,563,26
1,-4,0,1.0,-4.0,0.45905017852783203,47.29925372672534,13,-6,-60,654,26,429,563,26
1,-3,0,1.0,-3.0,0.46708106994628906,44.42821606144492,13,-7,-57,654,26,429,563,26
0,-3,0,-0.0,-3.0,0.47501206398010254,41.45181356024793,13,-7,-54,654,26,429,563,26
0,-4,0,-0.0,-4.0,0.4831821918487549,37.48762224545735,13,-7,-50,654,26,429,563,26
0,-3,0,-0.0,-3.0,0.49108314514160156,34.51841748206689,13,-7,-47,654,26,429,563,26
-1,-2,0,-1.0,-2.0,0.5013890266418457,32.39823785126467,13,-6,-45,654,26,429,563,26
0,-2,0,-0.0,-2.0,0.5069921016693115,30.416586692184822,13,-6,-43,654,26,429,563,26
-1,-2,0,-1.0,-2.0,0.5150871276855469,28.303752856126764,13,-5,-41,654,26,429,563,26
-2,-3,0,-2.0,-3.0,0.5235800743103027,25.118237105091836,13,-3,-38,654,26,429,563,26
-1,-2,0,-1.0,-2.0,0.5318281650543213,23.055512754639892,13,-2,-36,654,26,429,563,26
-2,-3,0,-2.0,-3.0,0.5389702320098877,20.0,13,0,-33,654,26,429,563,26
-2,-3,0,-2.0,-3.0,0.5470740795135498,17.066592756745816,13,2,-30,654,26,429,563,26
-1,-3,0,-1.0,-3.0,0.5549581050872803,14.166155414412248,13,3,-27,654,26,429,563,26
-3,-2,0,-3.0,-2.0,0.5630671977996826,12.709920264364882,13,6,-25,654,26,429,563,26
-2,-2,0,-2.0,-2.0,0.5709571838378906,11.351591323771842,13,8,-23,654,26,429,563,26
-2,-2,0,-2.0,-2.0,0.5790750980377197,10.259406699226016,13,10,-21,654,26,429,563,26
-1,-1,0,-1.0,-1.0,0.5870630741119385,9.825424421026653,13,11,-20,654,26,429,563,26
-1,-2,0,-1.0,-2.0,0.5951220989227295,8.633307652783937,13,12,-18,654,26,429,563,26
0,-1,0,-0.0,-1.0,0.6032900810241699,7.808652046684813,13,12,-17,654,26,429,563,26
-1,-1,0,-1.0,-1.0,0.6109981536865234,7.615528128088304,13,13,-16,654,26,429,563,26
-1,-2,0,-1.0,-2.0,0.6189451217651367,6.798989873223331,13,14,-14,654,26,429,563,26
0,-1,0,-0.0,-1.0,0.6269421577453613,6.104973174542799,13,14,-13,654,26,429,563,26
-1,-1,0,-1.0,-1.0,0.6431560516357422,6.209372712298546,13,15,-12,654,26,429,563,26
0,0,1,-0.0,-0.0,0.6729762554168701,6.209372712298546,13,15,-12,654,26,429,563,26
0,0,0,-0.0,-0.0,0.09902739524841309,778.2132713396084,14,482,635,1121,673,639,38,38
0,3,0,-0.0,3.0,0.16619038581848145,775.8257670709978,14,482,632,1121,673,639,38,38
-1,7,0,-1.0,7.0,0.17400836944580078,770.882269708594,14,483,625,1121,673,639,38,38
0,11,0,-0.0,11.0,0.182037353515625,762.2073988384902,14,483,614,1121,673,639,38,38
-1,12,0,-1.0,12.0,0.19019055366516113,753.4376997531905,14,484,602,1121,673,639,38,38
0,15,0,-0.0,15.0,0.1980905532836914,741.8054941967756,14,484,587,1121,673,639,38,38
0,18,0,-0.0,18.0,0.20614242553710938,728.0053547331505,14,484,569,1121,673,639,38,38
4,22,0,4.0,22.0,0.21398043632507324,708.7423994793762,14,480,547,1121,673,639,38,38
6,26,0,6.0,26.0,0.22196555137634277,685.3557339867406,14,474,521,1121,673,639,38,38
9,27,0,9.0,27.0,0.2301654815673828,659.4253827798603,14,465,494,1121,673,639,38,38
12,26,0,12.0,26.0,0.23812651634216309,632.3317127240159,14,453,468,1121,673,639,38,38
15,23,0,15.0,23.0,0.24760150909423828,605.3949070900562,14,438,445,1121,673,639,38,38
15,22,0,15.0,22.0,0.2540395259857178,579.2123368838193,14,423,423,1121,673,639,38,38
17,20,0,17.0,20.0,0.26206541061401367,553.0533191932375,14,406,403,1121,673,639,38,38
17,19,0,17.0,19.0,0.27027034759521484,527.6049761939604,14,389,384,1121,673,639,38,38
16,15,0,16.0,15.0,0.27805352210998535,505.68085537781917,14,373,369,1121,673,639,38,38
16,16,0,16.0,16.0,0.28607940673828125,483.0537819795804,14,357,353,1121,673,639,38,38
16,14,0,16.0,14.0,0.2940495014190674,461.83469092818166,14,341,339,1121,673,639,38,38
15,13,0,15.0,13.0,0.3020925521850586,442.033621333629,14,326,326,1121,673,639,38,38
15,14,0,15.0,14.0,0.31011533737182617,421.52809218028307,14,311,312,1121,673,639,38,38
14,13,0,14.0,13.0,0.3181943893432617,402.43801442204995,14,297,299,1121,673,639,38,38
12,13,0,12.0,13.0,0.32598233222961426,384.75859123986453,14,285,286,1121,673,639,38,38
12,12,0,12.0,12.0,0.33397936820983887,367.78805565839286,14,273,274,1121,673,639,38,38
10,10,0,10.0,10.0,0.3420243263244629,353.6459445640057,14,263,264,1121,673,639,38,38
11,10,0,11.0,10.0,0.350008487701416,338.7988261579403,14,252,254,1121,673,639,38,38
8,8,0,8.0,8.0,0.3579733371734619,327.48520891951506,14,244,246,1121,673,639,38,38
7,7,0,7.0,7.0,0.3660285472869873,317.58579886857973,14,237,239,1121,673,639,38,38
5,6,0,5.0,6.0,0.3741424083709717,309.80541358073776,14,232,233,1121,673,639,38,38
6,6,0,6.0,6.0,0.3820455074310303,301.3201523476161,14,226,227,1121,673,639,38,38
5,8,0,5.0,8.0,0.390317440032959,292.1301978272119,14,221,219,1121,673,639,38,38
6,7,0,6.0,7.0,0.39798736572265625,282.9420474196994,14,215,212,1121,673,639,38,38
8,7,0,8.0,7.0,0.4059903621673584,272.3314263858261,14,207,205,1121,673,639,38,38
8,8,0,8.0,8.0,0.41413354873657227,261.01785657346926,14,199,197,1121,673,639,38,38
9,6,0,9.0,6.0,0.4221804141998291,250.40861159213154,14,190,191,1121,673,639,38,38
9,5,0,9.0,5.0,0.43647146224975586,240.53227159642404,14,181,186,1121,673,639,38,38
10,5,0,10.0,5.0,0.4380035400390625,230.0020080240318,14,171,181,1121,673,639,38,38
9,3,0,9.0,3.0,0.446028470993042,221.68236329236922,14,162,178,1121,673,639,38,38
10,4,0,10.0,4.0,0.45414233207702637,212.0411218809327,14,152,174,1121,673,639,38,38
9,3,0,9.0,3.0,0.46214938163757324,203.91253890259293,14,143,171,1121,673,639,38,38
8,4,0,8.0,4.0,0.47006654739379883,195.74170531128786,14,135,167,1121,673,639,38,38
7,4,0,7.0,4.0,0.48207640647888184,188.2510554858527,14,128,163,1121,673,639,38,38
6,4,0,6.0,4.0,0.48604536056518555,181.4120754844877,14,122,159,1121,673,639,38,38
7,5,0,7.0,5.0,0.49409937858581543,173.20041623263984,14,115,154,1121,673,639,38,38
5,5,0,5.0,5.0,0.5020294189453125,166.20529150107996,14,110,149,1121,673,639,38,38
7,5,0,7.0,5.0,0.5101354122161865,158.04519197086375,14,103,144,1121,673,639,38,38
6,5,0,6.0,5.0,0.5180535316467285,150.49926253526885,14,97,139,1121,673,639,38,38
8,6,0,8.0,6.0,0.5260574817657471,141.0312469488381,14,89,133,1121,673,639,38,38
8,5,0,8.0,5.0,0.5340075492858887,132.47607071745688,14,81,128,1121,673,639,38,38
6,5,0,6.0,5.0,0.5419833660125732,125.06248644251562,14,75,123,1121,673,639,38,38
7,5,0,7.0,5.0,0.5500564575195312,117.19104228986575,14,68,118,1121,673,639,38,38
6,4,0,6.0,4.0,0.558199405670166,110.76902558006668,14,62,114,1121,673,639,38,38
5,5,0,5.0,5.0,0.5720415115356445,104.00406497347964,14,57,109,1121,673,639,38,38
5,6,0,5.0,6.0,0.5739715099334717,96.3819743287486,14,52,103,1121,673,639,38,38
4,4,0,4.0,4.0,0.5821075439453125,91.02272492535349,14,48,99,1121,673,639,38,38
4,5,0,4.0,5.0,0.5900974273681641,84.78824596263297,14,44,94,1121,673,639,38,38
4,6,0,4.0,6.0,0.5980684757232666,77.66436778875658,14,40,88,1121,673,639,38,38
4,5,0,4.0,5.0,0.6094133853912354,71.47098982546837,14,36,83,1121,673,639,38,38
4,6,0,4.0,6.0,0.6139774322509766,64.38465086573187,14,32,77,1121,673,639,38,38
4,7,0,4.0,7.0,0.6221344470977783,56.39230729988306,14,28,70,1121,673,639,38,38
5,6,0,5.0,6.0,0.6300463676452637,49.007352543677214,14,23,64,1121,673,639,38,38
3,5,0,3.0,5.0,0.6381993293762207,43.297672508690084,14,20,59,1121,673,639,38,38
1,3,0,1.0,3.0,0.6460754871368408,40.135437767890075,14,19,56,1121,673,639,38,38
2,3,0,2.0,3.0,0.6542303562164307,36.65968020030299,14,17,53,1121,673,639,38,38
1,4,0,1.0,4.0,0.6620573997497559,32.54609587543949,14,16,49,1121,673,639,38,38
1,4,0,1.0,4.0,0.6699624061584473,28.434164902525687,14,15,45,1121,673,639,38,38
2,6,0,2.0,6.0,0.6780874729156494,22.10960958218893,14,13,39,1121,673,639,38,38
2,5,0,2.0,5.0,0.686070442199707,16.735136770411273,14,11,34,1121,673,639,38,38
3,5,0,3.0,5.0,0.6941084861755371,11.083217912982647,14,8,29,1121,673,639,38,38
2,5,0,2.0,5.0,0.7021834850311279,5.738633753705962,14,6,24,1121,673,639,38,38
2,6,0,2.0,6.0,0.7101254463195801,-0.5609110854142259,14,4,18,1121,673,639,38,38
3,4,0,3.0,4.0,0.7180764675140381,-4.964331152381801,14,1,14,1121,673,639,38,38
1,4,0,1.0,4.0,0.72621750831604,-9.0,14,0,10,1121,673,639,38,38
1,3,0,1.0,3.0,0.734142541885376,-11.928932188134524,14,-1,7,1121,673,639,38,38
1,3,0,1.0,3.0,0.7422354221343994,-14.52786404500042,14,-2,4,1121,673,639,38,38
1,3,0,1.0,3.0,0.7501113414764404,-15.83772233983162,14,-3,1,1121,673,639,38,38
1,1,0,1.0,1.0,0.758082389831543,-15.0,14,-4,0,1121,673,639,38,38
0,2,0,-0.0,2.0,0.7660913467407227,-14.52786404500042,14,-4,-2,1121,673,639,38,38
0,1,0,-0.0,1.0,0.7825603485107422,-14.0,14,-4,-3,1121,673,639,38,38
0,1,0,-0.0,1.0,0.7902565002441406,-13.34314575050762,14,-4,-4,1121,673,639,38,38
0,0,1,-0.0,-0.0,0.7960994243621826,-13.34314575050762,14,-4,-4,1121,673,639,38,38
0,1,1,-0.0,1.0,0.004015922546386719,313.25205797532533,15,-339,84,786,762,1125,677,73
0,0,0,-0.0,-0.0,0.09213876724243164,313.25205797532533,15,-339,84,786,762,1125,677,73
1,0,0,1.0,-0.0,0.1242978572845459,314.2227862375605,15,-340,84,786,762,1125,677,73
2,0,0,2.0,-0.0,0.14815092086791992,316.1647341799005,15,-342,84,786,762,1125,677,73
2,-1,0,2.0,-1.0,0.15606093406677246,318.3458762282976,15,-344,85,786,762,1125,677,73
1,-3,0,1.0,-3.0,0.1640787124633789,320.046345297912,15,-345,88,786,762,1125,677,73
0,-3,0,-0.0,-3.0,0.1721358299255371,320.79966367697153,15,-345,91,786,762,1125,677,73
-1,-4,0,-1.0,-4.0,0.1801588535308838,320.87672941787616,15,-344,95,786,762,1125,677,73
-5,-3,0,-5.0,-3.0,0.18828892707824707,316.8809997718778,15,-339,98,786,762,1125,677,73
-5,-4,0,-5.0,-4.0,0.19639086723327637,313.22771940382967,15,-334,102,786,762,1125,677,73
-7,-2,0,-7.0,-2.0,0.20402884483337402,307.13991315496946,15,-327,104,786,762,1125,677,73
-9,-2,0,-9.0,-2.0,0.2120208740234375,299.2014319778482,15,-318,106,786,762,1125,677,73
-9,0,0,-9.0,-0.0,0.22009873390197754,290.67568014775753,15,-309,106,786,762,1125,677,73
-9,0,0,-9.0,-0.0,0.22807979583740234,282.1760518958019,15,-300,106,786,762,1125,677,73
-9,0,0,-9.0,-0.0,0.23618292808532715,273.7046980592965,15,-291,106,786,762,1125,677,73
-9,1,0,-9.0,1.0,0.2440187931060791,264.9136088647371,15,-282,105,786,762,1125,677,73
-10,3,0,-10.0,3.0,0.2526438236236572,254.49612734079608,15,-272,102,786,762,1125,677,73
-10,4,0,-10.0,4.0,0.26011180877685547,243.72843974111748,15,-262,98,786,762,1125,677,73
-13,5,0,-13.0,5.0,0.2684767246246338,229.80067720004024,15,-249,93,786,762,1125,677,73
-14,5,0,-14.0,5.0,0.276134729385376,214.9362468835461,15,-235,88,786,762,1125,677,73
-16,6,0,-16.0,6.0,0.2840149402618408,197.8482413874434,15,-219,82,786,762,1125,677,73
-16,7,0,-16.0,7.0,0.2920498847961426,180.41164478835236,15,-203,75,786,762,1125,677,73
-17,7,0,-17.0,7.0,0.3000829219818115,162.04039991880444,15,-186,68,786,762,1125,677,73
-20,9,0,-20.0,9.0,0.308121919631958,140.17321022221284,15,-166,59,786,762,1125,677,73
-21,8,0,-21.0,8.0,0.31623291969299316,117.70751445521458,15,-145,51,786,762,1125,677,73
-22,9,0,-22.0,9.0,0.32475972175598145,93.9730741346068,15,-123,42,786,762,1125,677,73
-21,8,0,-21.0,8.0,0.33213186264038086,71.5174404457249,15,-102,34,786,762,1125,677,73
-20,7,0,-20.0,7.0,0.34024477005004883,50.33075929238663,15,-82,27,786,762,1125,677,73
-17,7,0,-17.0,7.0,0.3481268882751465,32.007352543677214,15,-65,20,786,762,1125,677,73
-15,5,0,-15.0,5.0,0.35613274574279785,16.201532544552748,15,-50,15,786,762,1125,677,73
-13,4,0,-13.0,4.0,0.3641197681427002,2.600518131237564,15,-37,11,786,762,1125,677,73
-10,3,0,-10.0,3.0,0.3720877170562744,-7.839744319342554,15,-27,8,786,762,1125,677,73
-6,2,0,-6.0,2.0,0.38017773628234863,-14.159670332158445,15,-21,6,786,762,1125,677,73
-2,1,0,-2.0,1.0,0.38804078102111816,-16.3531172956115,15,-19,5,786,762,1125,677,73
0,0,1,-0.0,-0.0,0.417036771774292,-16.3531172956115,15,-19,5,786,762,1125,677,73
0,0,0,-0.0,-0.0,0.10559296607971191,740.1693142217962,16,-727,-185,78,572,805,757,20
-1,0,0,-1.0,-0.0,0.1824049949645996,739.2002402562348,16,-726,-185,78,572,805,757,20
-3,0,0,-3.0,-0.0,0.190324068069458,736.293507944428,16,-723,-185,78,572,805,757,20
-1,0,0,-1.0,-0.0,0.19845008850097656,735.3247614295395,16,-722,-185,78,572,805,757,20
-2,0,0,-2.0,-0.0,0.20657706260681152,733.3875167098248,16,-720,-185,78,572,805,757,20
-1,-2,0,-1.0,-2.0,0.21433401107788086,731.923176616016,16,-719,-183,78,572,805,757,20
-1,-3,0,-1.0,-3.0,0.22251200675964355,730.2188865464053,16,-718,-180,78,572,805,757,20
-3,-4,0,-3.0,-4.0,0.23046207427978516,726.3429907319007,16,-715,-176,78,572,805,757,20
-6,-7,0,-6.0,-7.0,0.23848390579223633,718.8634988802773,16,-709,-169,78,572,805,757,20
-9,-9,0,-9.0,-9.0,0.2464909553527832,708.0529228406497,16,-700,-160,78,572,805,757,20
-12,-9,0,-12.0,-9.0,0.254288911819458,694.3756100263552,16,-688,-151,78,572,805,757,20
-15,-10,0,-15.0,-10.0,0.26219701766967773,677.6118090899836,16,-673,-141,78,572,805,757,20
-18,-10,0,-18.0,-10.0,0.2704601287841797,657.9715562806548,16,-655,-131,78,572,805,757,20
-20,-8,0,-20.0,-8.0,0.27834391593933105,636.8029066106615,16,-635,-123,78,572,805,757,20
-21,-8,0,-21.0,-8.0,0.2863271236419678,614.6767163901661,16,-614,-115,78,572,805,757,20
-23,-7,0,-23.0,-7.0,0.2944071292877197,590.7869838803101,16,-591,-108,78,572,805,757,20
-28,-7,0,-28.0,-7.0,0.3025510311126709,561.9877621068479,16,-563,-101,78,572,805,757,20
-30,-6,0,-30.0,-6.0,0.3105180263519287,531.4000369412621,16,-533,-95,78,572,805,757,20
-36,-8,0,-36.0,-8.0,0.3183109760284424,494.5572316397814,16,-497,-87,78,572,805,757,20
-37,-8,0,-37.0,-8.0,0.32634401321411133,456.73439984642226,16,-460,-79,78,572,805,757,20
-37,-7,0,-37.0,-7.0,0.33441591262817383,419.0839078781678,16,-423,-72,78,572,805,757,20
-35,-6,0,-35.0,-6.0,0.34247493743896484,383.57337308308854,16,-388,-66,78,572,805,757,20
-33,-6,0,-33.0,-6.0,0.35054612159729004,350.0347205478938,16,-355,-60,78,572,805,757,20
-29,-7,0,-29.0,-7.0,0.35875606536865234,320.28018408617856,16,-326,-53,78,572,805,757,20
-26,-7,0,-26.0,-7.0,0.36637210845947266,293.5061778613411,16,-300,-46,78,572,805,757,20
-22,-7,0,-22.0,-7.0,0.3742349147796631,270.72228269234347,16,-278,-39,78,572,805,757,20
-19,-7,0,-19.0,-7.0,0.382357120513916,250.96934685897497,16,-259,-32,78,572,805,757,20
-17,-7,0,-17.0,-7.0,0.39034104347229004,233.28789530101986,16,-242,-25,78,572,805,757,20
-17,-7,0,-17.0,-7.0,0.3983590602874756,215.71885167172013,16,-225,-18,78,572,805,757,20
-16,-7,0,-16.0,-7.0,0.40632009506225586,199.28927349484493,16,-209,-11,78,572,805,757,20
-15,-5,0,-15.0,-5.0,0.41526198387145996,184.09276132818556,16,-194,-6,78,572,805,757,20
-13,-4,0,-13.0,-4.0,0.4225001335144043,171.01104938649465,16,-181,-2,78,572,805,757,20
-13,-4,0,-13.0,-4.0,0.4303319454193115,158.01190434013895,16,-168,2,78,572,805,757,20
-13,-4,0,-13.0,-4.0,0.43865394592285156,145.11608556174951,16,-155,6,78,572,805,757,20
-11,-4,0,-11.0,-4.0,0.4463520050048828,134.34680460612904,16,-144,10,78,572,805,757,20
-11,-4,0,-11.0,-4.0,0.4544529914855957,123.73481222179961,16,-133,14,78,572,805,757,20
-8,-2,0,-8.0,-2.0,0.4624481201171875,116.01983970788092,16,-125,16,78,572,805,757,20
-8,-3,0,-8.0,-3.0,0.4703190326690674,108.53269591129698,16,-117,19,78,572,805,757,20
-8,-2,0,-8.0,-2.0,0.47826600074768066,101.00450441310929,16,-109,21,78,572,805,757,20
-6,-1,0,-6.0,-1.0,0.4862840175628662,95.32331175955302,16,-103,22,78,572,805,757,20
-5,-1,0,-5.0,-1.0,0.4944031238555908,90.66280345788111,16,-98,23,78,572,805,757,20
-4,0,0,-4.0,-0.0,0.5023190975189209,86.77293009927931,16,-94,23,78,572,805,757,20
-1,0,0,-1.0,-0.0,0.5102701187133789,85.80187889597991,16,-93,23,78,572,805,757,20
-1,0,0,-1.0,-0.0,0.5183241367340088,84.83142938920619,16,-92,23,78,572,805,757,20
-1,0,0,-1.0,-0.0,0.5263469219207764,83.86160024205851,16,-91,23,78,572,805,757,20
-1,0,0,-1.0,-0.0,0.5343320369720459,82.89241088485109,16,-90,23,78,572,805,757,20
-1,0,0,-1.0,-0.0,0.5423080921173096,81.92388155425118,16,-89,23,78,572,805,757,20
-1,0,0,-1.0,-0.0,0.550429105758667,80.95603333479313,16,-88,23,78,572,805,757,20
-1,0,0,-1.0,-0.0,0.5591099262237549,79.98888820293314,16,-87,23,78,572,805,757,20
-2,1,0,-2.0,1.0,0.5663959980010986,77.80091115700337,16,-85,22,78,572,805,757,20
-2,1,0,-2.0,1.0,0.574476957321167,75.61541917201598,16,-83,21,78,572,805,757,20
-2,2,0,-2.0,2.0,0.5826640129089355,73.19855767980596,16,-81,19,78,572,805,757,20
-4,2,0,-4.0,2.0,0.5903489589691162,68.85429601486528,16,-77,17,78,572,805,757,20
-3,2,0,-3.0,2.0,0.598452091217041,65.50496672405067,16,-74,15,78,572,805,757,20
-4,3,0,-4.0,3.0,0.6063261032104492,61.02112361825881,16,-70,12,78,572,805,757,20
-4,2,0,-4.0,2.0,0.6143350601196289,56.753277073114546,16,-66,10,78,572,805,757,20
-4,2,0,-4.0,2.0,0.6223161220550537,52.51399843235114,16,-62,8,78,572,805,757,20
-5,2,0,-5.0,2.0,0.6303629875183105,47.3149195236284,16,-57,6,78,572,805,757,20
-6,1,0,-6.0,1.0,0.6383500099182129,41.24451190127583,16,-51,5,78,572,805,757,20
-5,2,0,-5.0,2.0,0.6464970111846924,36.09772228646444,16,-46,3,78,572,805,757,20
-4,0,0,-4.0,-0.0,0.6543800830841064,32.1070065428546,16,-42,3,78,572,805,757,20
-5,0,0,-5.0,-0.0,0.6624429225921631,27.12142238654117,16,-37,3,78,572,805,757,20
-4,0,0,-4.0,-0.0,0.6704220771789551,23.136083051561783,16,-33,3,78,572,805,757,20
-2,0,0,-2.0,-0.0,0.6783571243286133,21.144823004794873,16,-31,3,78,572,805,757,20
-2,1,0,-2.0,1.0,0.686424970626831,19.068883707497267,16,-29,2,78,572,805,757,20
-3,0,0,-3.0,-0.0,0.6944630146026611,16.076809620810597,16,-26,2,78,572,805,757,20
-2,0,0,-2.0,-0.0,0.7023289203643799,14.083189157584592,16,-24,2,78,572,805,757,20
-2,0,0,-2.0,-0.0,0.7103829383850098,12.090722034374522,16,-22,2,78,572,805,757,20
-3,0,0,-3.0,-0.0,0.7184100151062012,9.104973174542799,16,-19,2,78,572,805,757,20
-2,0,0,-2.0,-0.0,0.7263169288635254,7.11724276862369,16,-17,2,78,572,805,757,20
-2,0,0,-2.0,-0.0,0.7343099117279053,5.1327459504215565,16,-15,2,78,572,805,757,20
-1,0,0,-1.0,-0.0,0.7422881126403809,4.142135623730951,16,-14,2,78,572,805,757,20
-2,0,0,-2.0,-0.0,0.7503089904785156,2.1655250605964387,16,-12,2,78,572,805,757,20
-2,0,0,-2.0,-0.0,0.7583110332489014,0.19803902718556898,16,-10,2,78,572,805,757,20
-2,0,0,-2.0,-0.0,0.7664470672607422,-1.7537887487646788,16,-8,2,78,572,805,757,20
-2,0,0,-2.0,-0.0,0.7743399143218994,-3.675444679663241,16,-6,2,78,572,805,757,20
-2,0,0,-2.0,-0.0,0.7824549674987793,-5.52786404500042,16,-4,2,78,572,805,757,20
-1,0,0,-1.0,-0.0,0.7986059188842773,-6.39444872453601,16,-3,2,78,572,805,757,20
0,0,1,-0.0,-0.0,0.8042681217193604,-6.39444872453601,16,-3,2,78,572,805,757,20
0,0,0,-0.0,-0.0,0.12557125091552734,1549.96166087224,17,1503,436,1584,1006,81,570,31
3,0,0,3.0,-0.0,0.1317453384399414,1547.0806637302696,17,1500,436,1584,1006,81,570,31
3,0,0,3.0,-0.0,0.1395251750946045,1544.200115443813,17,1497,436,1584,1006,81,570,31
3,1,0,3.0,1.0,0.14754533767700195,1541.0401665766858,17,1494,435,1584,1006,81,570,31
3,1,0,3.0,1.0,0.15552234649658203,1537.8802271907516,17,1491,434,1584,1006,81,570,31
3,1,0,3.0,1.0,0.16357636451721191,1534.7202973440078,17,1488,433,1584,1006,81,570,31
6,1,0,6.0,1.0,0.17153620719909668,1528.6800186567164,17,1482,432,1584,1006,81,570,31
9,0,0,9.0,-0.0,0.17969918251037598,1520.0416932448447,17,1473,432,1584,1006,81,570,31
10,2,0,10.0,2.0,0.18835020065307617,1509.883274221342,17,1463,430,1584,1006,81,570,31
12,2,0,12.0,2.0,0.19572019577026367,1497.8069936379854,17,1451,428,1584,1006,81,570,31
15,2,0,15.0,2.0,0.20370721817016602,1482.8558008032683,17,1436,426,1584,1006,81,570,31
15,2,0,15.0,2.0,0.2115633487701416,1467.9082911630105,17,1421,424,1584,1006,81,570,31
17,2,0,17.0,2.0,0.21958327293395996,1451.0491124106313,17,1404,422,1584,1006,81,570,31
19,3,0,19.0,3.0,0.22752118110656738,1431.9920525006348,17,1385,419,1584,1006,81,570,31
22,3,0,22.0,3.0,0.23561930656433105,1410.0701737107545,17,1363,416,1584,1006,81,570,31
26,4,0,26.0,4.0,0.24358820915222168,1384.040028019213,17,1337,412,1584,1006,81,570,31
28,4,0,28.0,4.0,0.2516152858734131,1356.1108634971863,17,1309,408,1584,1006,81,570,31
28,4,0,28.0,4.0,0.25976037979125977,1328.1965604482466,17,1281,404,1584,1006,81,570,31
34,5,0,34.0,5.0,0.26764822006225586,1294.2784272262336,17,1247,399,1584,1006,81,570,31
40,6,0,40.0,6.0,0.27558231353759766,1254.3691346491769,17,1207,393,1584,1006,81,570,31
43,6,0,43.0,6.0,0.28354334831237793,1211.6478712328164,17,1164,387,1584,1006,81,570,31
46,7,0,46.0,7.0,0.2916073799133301,1165.8149728047997,17,1118,380,1584,1006,81,570,31
45,8,0,45.0,8.0,0.2996213436126709,1120.6553174269031,17,1073,372,1584,1006,81,570,31
45,9,0,45.0,9.0,0.3075752258300781,1075.2077783615377,17,1028,363,1584,1006,81,570,31
45,11,0,45.0,11.0,0.31555819511413574,1029.123077036419,17,983,352,1584,1006,81,570,31
45,12,0,45.0,12.0,0.32370829582214355,982.7193994305212,17,938,340,1584,1006,81,570,31
46,13,0,46.0,13.0,0.3321692943572998,935.048946107515,17,892,327,1584,1006,81,570,31
45,14,0,45.0,14.0,0.3398153781890869,887.9828348313162,17,847,313,1584,1006,81,570,31
44,14,0,44.0,14.0,0.3475782871246338,841.8605487475777,17,803,299,1584,1006,81,570,31
43,15,0,43.0,15.0,0.3557612895965576,796.32977265721,17,760,284,1584,1006,81,570,31
42,15,0,42.0,15.0,0.3636603355407715,751.73659101415,17,718,269,1584,1006,81,570,31
38,14,0,38.0,14.0,0.37160825729370117,711.2403183519901,17,680,255,1584,1006,81,570,31
35,14,0,35.0,14.0,0.3795323371887207,673.5535563774251,17,645,241,1584,1006,81,570,31
30,13,0,30.0,13.0,0.3876802921295166,640.9031940766869,17,615,228,1584,1006,81,570,31
28,11,0,28.0,11.0,0.3957843780517578,610.8258543716455,17,587,217,1584,1006,81,570,31
25,12,0,25.0,12.0,0.4037153720855713,583.2215308729702,17,562,205,1584,1006,81,570,31
22,12,0,22.0,12.0,0.411541223526001,558.4535726630361,17,540,193,1584,1006,81,570,31
20,11,0,20.0,11.0,0.41963934898376465,535.9301226108444,17,520,182,1584,1006,81,570,31
18,9,0,18.0,9.0,0.42777538299560547,515.9736339970187,17,502,173,1584,1006,81,570,31
17,9,0,17.0,9.0,0.4356672763824463,496.97753856980876,17,485,164,1584,1006,81,570,31
16,8,0,16.0,8.0,0.4436612129211426,479.2640994448211,17,469,156,1584,1006,81,570,31
17,7,0,17.0,7.0,0.4515984058380127,460.9254143245557,17,452,149,1584,1006,81,570,31
16,6,0,16.0,6.0,0.45960330963134766,443.85182793577275,17,436,143,1584,1006,81,570,31
16,6,0,16.0,6.0,0.4675593376159668,426.77935669290844,17,420,137,1584,1006,81,570,31
16,6,0,16.0,6.0,0.47557640075683594,409.70813507631334,17,404,131,1584,1006,81,570,31
15,6,0,15.0,6.0,0.48366236686706543,393.5902593063129,17,389,125,1584,1006,81,570,31
14,6,0,14.0,6.0,0.49175429344177246,378.4285195559671,17,375,119,1584,1006,81,570,31
12,6,0,12.0,6.0,0.49959230422973633,365.1815355853043,17,363,113,1584,1006,81,570,31
12,5,0,12.0,5.0,0.5076172351837158,352.23970373585695,17,351,108,1584,1006,81,570,31
11,6,0,11.0,6.0,0.5156981945037842,339.9704213029587,17,340,102,1584,1006,81,570,31
12,5,0,12.0,5.0,0.5235424041748047,327.04239503313033,17,328,97,1584,1006,81,570,31
11,5,0,11.0,5.0,0.5317263603210449,315.0802932621092,17,317,92,1584,1006,81,570,31
13,4,0,13.0,4.0,0.5396683216094971,301.4806471176397,17,304,88,1584,1006,81,570,31
13,4,0,13.0,4.0,0.547762393951416,287.8811648155098,17,291,84,1584,1006,81,570,31
14,4,0,14.0,4.0,0.5556013584136963,273.3210016630769,17,277,80,1584,1006,81,570,31
13,3,0,13.0,3.0,0.5635433197021484,260.0,17,264,77,1584,1006,81,570,31
14,3,0,14.0,3.0,0.57159423828125,245.72207424765554,17,250,74,1584,1006,81,570,31
15,3,0,15.0,3.0,0.5795552730560303,230.4913440429214,17,235,71,1584,1006,81,570,31
14,1,0,14.0,1.0,0.5876421928405762,216.82105167564055,17,221,70,1584,1006,81,570,31
14,1,0,14.0,1.0,0.5957002639770508,203.19715855161817,17,207,69,1584,1006,81,570,31
13,0,0,13.0,-0.0,0.6037003993988037,190.90531804691204,17,194,69,1584,1006,81,570,31
14,1,0,14.0,1.0,0.6117782592773438,177.4162155328911,17,180,68,1584,1006,81,570,31
14,0,0,14.0,-0.0,0.6198663711547852,164.38784797192923,17,166,68,1584,1006,81,570,31
15,0,0,15.0,-0.0,0.6276562213897705,150.60495161679194,17,151,68,1584,1006,81,570,31
13,0,0,13.0,-0.0,0.6355392932891846,138.8440769090575,17,138,68,1584,1006,81,570,31
14,0,0,14.0,-0.0,0.6435973644256592,126.42135623730951,17,124,68,1584,1006,81,570,31
13,0,0,13.0,-0.0,0.6515903472900391,115.17296186228538,17,111,68,1584,1006,81,570,31
10,0,0,10.0,-0.0,0.6596453189849854,106.75795661885921,17,101,68,1584,1006,81,570,31
11,0,0,11.0,-0.0,0.66758131980896,97.8007092176286,17,90,68,1584,1006,81,570,31
9,0,0,9.0,-0.0,0.6764533519744873,90.75916035975324,17,81,68,1584,1006,81,570,31
8,0,0,8.0,-0.0,0.683462381362915,84.76472322419383,17,73,68,1584,1006,81,570,31
8,0,0,8.0,-0.0,0.6917433738708496,79.06912352095134,17,65,68,1584,1006,81,570,31
7,0,0,7.0,-0.0,0.6997601985931396,74.37561188601732,17,58,68,1584,1006,81,570,31
7,0,0,7.0,-0.0,0.7075963020324707,70.0,17,51,68,1584,1006,81,570,31
6,0,0,6.0,-0.0,0.7155282497406006,66.54140052758476,17,45,68,1584,1006,81,570,31
5,0,0,5.0,-0.0,0.7235872745513916,63.89233169326408,17,40,68,1584,1006,81,570,31
4,0,0,4.0,-0.0,0.7316033840179443,61.941536246685374,17,36,68,1584,1006,81,570,31
4,1,0,4.0,1.0,0.7396373748779297,59.24957912338628,17,32,67,1584,1006,81,570,31
3,1,0,3.0,1.0,0.7477912902832031,57.09022125087424,17,29,66,1584,1006,81,570,31
4,2,0,4.0,2.0,0.756385326385498,53.709533545207535,17,25,64,1584,1006,81,570,31
5,3,0,5.0,3.0,0.763857364654541,49.19501538281614,17,20,61,1584,1006,81,570,31
5,3,0,5.0,3.0,0.7718253135681152,44.90826320300064,17,15,58,1584,1006,81,570,31
5,4,0,5.0,4.0,0.779731273651123,39.91812087098393,17,10,54,1584,1006,81,570,31
7,4,0,7.0,4.0,0.7875301837921143,35.08991914547278,17,3,50,1584,1006,81,570,31
7,5,0,7.0,5.0,0.7956123352050781,30.17742799230607,17,-4,45,1584,1006,81,570,31
8,5,0,8.0,5.0,0.8036482334136963,26.761226035642203,17,-12,40,1584,1006,81,570,31
8,4,0,8.0,4.0,0.8116843700408936,26.182520563948003,17,-20,36,1584,1006,81,570,31
7,5,0,7.0,5.0,0.8195722103118896,26.10960958218893,17,-27,31,1584,1006,81,570,31
7,4,0,7.0,4.0,0.8282952308654785,28.416586692184822,17,-34,27,1584,1006,81,570,31
3,4,0,3.0,4.0,0.8359012603759766,28.56604182158393,17,-37,23,1584,1006,81,570,31
3,2,0,3.0,2.0,0.8435742855072021,30.17742799230607,17,-40,21,1584,1006,81,570,31
1,2,0,1.0,2.0,0.8516511917114258,30.188494110780013,17,-41,19,1584,1006,81,570,31
0,2,0,-0.0,2.0,0.85968017578125,29.384682042344295,17,-41,17,1584,1006,81,570,31
0,1,0,-0.0,1.0,0.8675704002380371,29.011362169330773,17,-41,16,1584,1006,81,570,31
0,2,0,-0.0,2.0,0.8755843639373779,28.324358044868937,17,-41,14,1584,1006,81,570,31
-1,2,0,-1.0,2.0,0.8834922313690186,26.761226035642203,17,-40,12,1584,1006,81,570,31
-2,2,0,-2.0,2.0,0.8917663097381592,24.293765408777,17,-38,10,1584,1006,81,570,31
-2,1,0,-2.0,1.0,0.9000132083892822,22.107950630558946,17,-36,9,1584,1006,81,570,31
-3,2,0,-3.0,2.0,0.9077613353729248,18.734255586866,17,-33,7,1584,1006,81,570,31
-3,1,0,-3.0,1.0,0.915581226348877,15.59411708155671,17,-30,6,1584,1006,81,570,31
-3,2,0,-3.0,2.0,0.9235703945159912,12.294688127912362,17,-27,4,1584,1006,81,570,31
-3,2,0,-3.0,2.0,0.9316372871398926,9.083189157584592,17,-24,2,1584,1006,81,570,31
-3,1,0,-3.0,1.0,0.9395883083343506,6.023796041628639,17,-21,1,1584,1006,81,570,31
-3,1,0,-3.0,1.0,0.9475572109222412,3.0,17,-18,0,1584,1006,81,570,31
-1,2,0,-1.0,2.0,0.955632209777832,2.11724276862369,17,-17,-2,1584,1006,81,570,31
-1,2,0,-1.0,2.0,0.9635493755340576,1.4924225024706423,17,-16,-4,1584,1006,81,570,31
0,1,0,-0.0,1.0,0.971520185470581,1.763054614240211,17,-16,-5,1584,1006,81,570,31
-1,1,0,-1.0,1.0,0.9796552658081055,1.1554944214035103,17,-15,-6,1584,1006,81,570,31
0,0,1,-0.0,-0.0,0.9865303039550781,1.1554944214035103,17,-15,-6,1584,1006,81,570,31
0,2,1,-0.0,2.0,0.9875922203063965,2.0,17,-15,-8,1584,1006,81,570,31
0,1,1,-0.0,1.0,1.067744255065918,2.4928556845359005,17,-15,-9,1584,1006,81,570,31
0,0,0,-0.0,-0.0,1.0815143585205078,2.4928556845359005,17,-15,-9,1584,1006,81,570,31
0,0,1,-0.0,-0.0,1.2306163311004639,2.4928556845359005,17,-15,-9,1584,1006,81,570,31
-1,0,1,-1.0,-0.0,0.05558943748474121,745.6883507821339,18,162,-733,1760,282,1599,1015,11
-1,0,1,-1.0,-0.0,0.06356525421142578,745.9047875729652,18,163,-733,1760,282,1599,1015,11
-2,0,1,-2.0,-0.0,0.07184743881225586,746.3414669775653,18,165,-733,1760,282,1599,1015,11
0,0,0,-0.0,-0.0,0.07848238945007324,746.3414669775653,18,165,-733,1760,282,1599,1015,11
-2,1,0,-2.0,1.0,0.07956337928771973,747.758261329625,18,167,-734,1760,282,1599,1015,11
-1,1,0,-1.0,1.0,0.08749246597290039,748.9555689826822,18,168,-735,1760,282,1599,1015,11
-2,0,0,-2.0,-0.0,0.09558534622192383,749.4037380607283,18,170,-735,1760,282,1599,1015,11
-1,1,0,-1.0,1.0,0.10355734825134277,750.6037321241869,18,171,-736,1760,282,1599,1015,11
-1,0,0,-1.0,-0.0,0.11148333549499512,750.8306688670419,18,172,-736,1760,282,1599,1015,11
-1,0,0,-1.0,-0.0,0.11953234672546387,751.0588601425156,18,173,-736,1760,282,1599,1015,11
-1,1,0,-1.0,1.0,0.13548541069030762,752.261513613362,18,174,-737,1760,282,1599,1015,11
0,0,1,-0.0,-0.0,0.16341829299926758,752.261513613362,18,174,-737,1760,282,1599,1015,11
-1,1,1,-1.0,1.0,0.16748523712158203,753.4648970123799,18,175,-738,1760,282,1599,1015,11
-1,0,1,-1.0,-0.0,0.1754753589630127,753.6962501554888,18,176,-738,1760,282,1599,1015,11
0,1,1,-0.0,1.0,0.18363523483276367,754.6690068707555,18,176,-739,1760,282,1599,1015,11
-1,1,1,-1.0,1.0,0.1914653778076172,755.8738397395458,18,177,-740,1760,282,1599,1015,11
0,0,0,-0.0,-0.0,0.2554752826690674,755.8738397395458,18,177,-740,1760,282,1599,1015,11
2,-1,0,2.0,-1.0,0.26367926597595215,754.4379500657049,18,175,-739,1760,282,1599,1015,11
4,-3,0,4.0,-3.0,0.27166032791137695,750.6037321241869,18,171,-736,1760,282,1599,1015,11
5,-4,0,5.0,-4.0,0.2797362804412842,745.5864373941218,18,166,-732,1760,282,1599,1015,11
6,-7,0,6.0,-7.0,0.2875504493713379,737.445284179245,18,160,-725,1760,282,1599,1015,11
7,-10,0,7.0,-10.0,0.2954723834991455,726.1867066625323,18,153,-715,1760,282,1599,1015,11
9,-14,0,9.0,-14.0,0.3035714626312256,710.6374780571515,18,144,-701,1760,282,1599,1015,11
11,-20,0,11.0,-20.0,0.3114752769470215,688.8659812961001,18,133,-681,1760,282,1599,1015,11
11,-25,0,11.0,-25.0,0.31951427459716797,662.2480798024076,18,122,-656,1760,282,1599,1015,11
10,-28,0,10.0,-28.0,0.327587366104126,632.9090844313162,18,112,-628,1760,282,1599,1015,11
10,-32,0,10.0,-32.0,0.33545827865600586,599.6651966171031,18,102,-596,1760,282,1599,1015,11
8,-37,0,8.0,-37.0,0.3436472415924072,561.8483042225671,18,94,-559,1760,282,1599,1015,11
7,-42,0,7.0,-42.0,0.3518064022064209,519.2690149150529,18,87,-517,1760,282,1599,1015,11
4,-41,0,4.0,-41.0,0.3597574234008789,478.18216026670524,18,83,-476,1760,282,1599,1015,11
4,-34,0,4.0,-34.0,0.367565393447876,444.0044543208898,18,79,-442,1760,282,1599,1015,11
4,-30,0,4.0,-30.0,0.3754763603210449,413.7708203779246,18,75,-412,1760,282,1599,1015,11
5,-26,0,5.0,-26.0,0.3834552764892578,387.2958067581146,18,70,-386,1760,282,1599,1015,11
5,-23,0,5.0,-23.0,0.391559362411499,363.77364330982226,18,65,-363,1760,282,1599,1015,11
6,-20,0,6.0,-20.0,0.39971137046813965,343.037354317033,18,59,-343,1760,282,1599,1015,11
5,-19,0,5.0,-19.0,0.40851736068725586,323.46917663610384,18,54,-324,1760,282,1599,1015,11
5,-16,0,5.0,-16.0,0.4155404567718506,306.8733717392365,18,49,-308,1760,282,1599,1015,11
4,-14,0,4.0,-14.0,0.4236443042755127,292.4239398568985,18,45,-294,1760,282,1599,1015,11
4,-13,0,4.0,-13.0,0.43167924880981445,278.9753510430087,18,41,-281,1760,282,1599,1015,11
3,-13,0,3.0,-13.0,0.43953824043273926,265.6806236138819,18,38,-268,1760,282,1599,1015,11
1,-13,0,1.0,-13.0,0.447629451751709,252.6703320136022,18,37,-255,1760,282,1599,1015,11
2,-11,0,2.0,-11.0,0.4554884433746338,241.49746449000241,18,35,-244,1760,282,1599,1015,11
1,-10,0,1.0,-10.0,0.4634592533111572,231.4571842850202,18,34,-234,1760,282,1599,1015,11
1,-8,0,1.0,-8.0,0.47176146507263184,223.39658491317246,18,33,-226,1760,282,1599,1015,11
1,-8,0,1.0,-8.0,0.4797043800354004,215.33610689126738,18,32,-218,1760,282,1599,1015,11
1,-7,0,1.0,-7.0,0.487532377243042,208.2650932525058,18,31,-211,1760,282,1599,1015,11
0,-6,0,-0.0,-6.0,0.4957294464111328,202.3306537876153,18,31,-205,1760,282,1599,1015,11
1,-6,0,1.0,-6.0,0.5035994052886963,196.2486024796197,18,30,-199,1760,282,1599,1015,11
1,-5,0,1.0,-5.0,0.51151442527771,191.1555505204989,18,29,-194,1760,282,1599,1015,11
0,-3,0,-0.0,-3.0,0.5194523334503174,188.18902660347973,18,29,-191,1760,282,1599,1015,11
0,-4,0,-0.0,-4.0,0.5275473594665527,184.2353032602532,18,29,-187,1760,282,1599,1015,11
0,-3,0,-0.0,-3.0,0.5357062816619873,181.27130750601393,18,29,-184,1760,282,1599,1015,11
0,-4,0,-0.0,-4.0,0.5437004566192627,177.3211452355431,18,29,-180,1760,282,1599,1015,11
-1,-5,0,-1.0,-5.0,0.5515363216400146,172.55280904564702,18,30,-175,1760,282,1599,1015,11
-1,-5,0,-1.0,-5.0,0.5595142841339111,167.80335644888382,18,31,-170,1760,282,1599,1015,11
-2,-4,0,-2.0,-4.0,0.567549467086792,164.24833824885843,18,33,-166,1760,282,1599,1015,11
-1,-4,0,-1.0,-4.0,0.5754823684692383,160.5294535724685,18,34,-162,1760,282,1599,1015,11
-1,-4,0,-1.0,-4.0,0.5835723876953125,156.83015788165073,18,35,-158,1760,282,1599,1015,11
0,-3,0,-0.0,-3.0,0.5915012359619141,153.90248582070703,18,35,-155,1760,282,1599,1015,11
-1,-3,0,-1.0,-3.0,0.599663257598877,151.20499351813308,18,36,-152,1760,282,1599,1015,11
-1,-3,0,-1.0,-3.0,0.6074793338775635,148.52524222420234,18,37,-149,1760,282,1599,1015,11
0,-2,0,-0.0,-2.0,0.6154623031616211,146.58495967608397,18,37,-147,1760,282,1599,1015,11
0,-3,0,-0.0,-3.0,0.6234683990478516,143.67750334196495,18,37,-144,1760,282,1599,1015,11
0,-4,0,-0.0,-4.0,0.6320843696594238,139.80676779764127,18,37,-140,1760,282,1599,1015,11
0,-3,0,-0.0,-3.0,0.6396512985229492,136.90842117365693,18,37,-137,1760,282,1599,1015,11
0,-4,0,-0.0,-4.0,0.6474483013153076,133.0507153186828,18,37,-133,1760,282,1599,1015,11
0,-4,0,-0.0,-4.0,0.6556813716888428,129.2013412749664,18,37,-129,1760,282,1599,1015,11
0,-4,0,-0.0,-4.0,0.6635744571685791,125.36103712382777,18,37,-125,1760,282,1599,1015,11
0,-4,0,-0.0,-4.0,0.6714613437652588,121.53062870309307,18,37,-121,1760,282,1599,1015,11
-1,-5,0,-1.0,-5.0,0.6794352531433105,117.06555615733703,18,38,-116,1760,282,1599,1015,11
0,-5,0,-0.0,-5.0,0.6875784397125244,112.32433677630571,18,38,-111,1760,282,1599,1015,11
0,-5,0,-0.0,-5.0,0.6954452991485596,107.60550608207397,18,38,-106,1760,282,1599,1015,11
1,-4,0,1.0,-4.0,0.7036004066467285,103.50345616615168,18,37,-102,1760,282,1599,1015,11
0,-7,0,-0.0,-7.0,0.71268630027771,96.95096860746347,18,37,-95,1760,282,1599,1015,11
1,-6,0,1.0,-6.0,0.7197504043579102,91.00520819205592,18,36,-89,1760,282,1599,1015,11
1,-7,0,1.0,-7.0,0.7276723384857178,84.15716460273958,18,35,-82,1760,282,1599,1015,11
1,-7,0,1.0,-7.0,0.7355453968048096,77.34682750416071,18,34,-75,1760,282,1599,1015,11
2,-6,0,2.0,-6.0,0.7434754371643066,71.05918747922567,18,32,-69,1760,282,1599,1015,11
0,-4,0,-0.0,-4.0,0.7514553070068359,67.44998274671983,18,32,-65,1760,282,1599,1015,11
0,-2,0,-0.0,-2.0,0.7595994472503662,65.66116330771806,18,32,-63,1760,282,1599,1015,11
1,-1,0,1.0,-1.0,0.7673642635345459,64.31810730249349,18,31,-62,1760,282,1599,1015,11
0,-1,0,-0.0,-1.0,0.7841253280639648,63.425141578224014,18,31,-61,1760,282,1599,1015,11
0,-1,0,-0.0,-1.0,0.7915513515472412,62.53517601961218,18,31,-60,1760,282,1599,1015,11
0,-2,0,-0.0,-2.0,0.799748420715332,60.76473218982953,18,31,-58,1760,282,1599,1015,11
1,-2,0,1.0,-2.0,0.807537317276001,58.52952069707436,18,30,-56,1760,282,1599,1015,11
1,-2,0,1.0,-2.0,0.8155252933502197,56.29437168288782,18,29,-54,1760,282,1599,1015,11
2,-2,0,2.0,-2.0,0.8235774040222168,53.59180830116101,18,27,-52,1760,282,1599,1015,11
1,-3,0,1.0,-3.0,0.831599235534668,50.47071299343465,18,26,-49,1760,282,1599,1015,11
1,-2,0,1.0,-2.0,0.839470386505127,48.23532661682466,18,25,-47,1760,282,1599,1015,11
1,-2,0,1.0,-2.0,0.8475632667541504,46.0,18,24,-45,1760,282,1599,1015,11
1,-1,0,1.0,-1.0,0.8555183410644531,44.64876634922564,18,23,-44,1760,282,1599,1015,11
1,-2,0,1.0,-2.0,0.8635232448577881,42.41307836451879,18,22,-42,1760,282,1599,1015,11
1,-2,0,1.0,-2.0,0.8722734451293945,40.17742799230607,18,21,-40,1760,282,1599,1015,11
1,-2,0,1.0,-2.0,0.8795642852783203,37.941821107167776,18,20,-38,1760,282,1599,1015,11
2,-2,0,2.0,-2.0,0.8876514434814453,35.24922359499622,18,18,-36,1760,282,1599,1015,11
1,-2,0,1.0,-2.0,0.8954782485961914,33.01315561749642,18,17,-34,1760,282,1599,1015,11
1,-3,0,1.0,-3.0,0.9035964012145996,29.88552708502482,18,16,-31,1760,282,1599,1015,11
2,-2,0,2.0,-2.0,0.9114482402801514,27.202484376209235,18,14,-29,1760,282,1599,1015,11
1,-2,0,1.0,-2.0,0.9195582866668701,24.966648127543394,18,13,-27,1760,282,1599,1015,11
2,-3,0,2.0,-3.0,0.9274423122406006,21.40075756488817,18,11,-24,1760,282,1599,1015,11
2,-4,0,2.0,-4.0,0.9354512691497803,16.93171219946131,18,9,-20,1760,282,1599,1015,11
3,-3,0,3.0,-3.0,0.9438142776489258,13.027756377319946,18,6,-17,1760,282,1599,1015,11
1,-4,0,1.0,-4.0,0.9514203071594238,8.92838827718412,18,5,-13,1760,282,1599,1015,11
3,-3,0,3.0,-3.0,0.959618330001831,5.198039027185569,18,2,-10,1760,282,1599,1015,11
1,-3,0,1.0,-3.0,0.9677343368530273,2.0710678118654755,18,1,-7,1760,282,1599,1015,11
1,-2,0,1.0,-2.0,0.9755783081054688,0.0,18,0,-5,1760,282,1599,1015,11
1,-2,0,1.0,-2.0,0.9836304187774658,-1.8377223398316205,18,-1,-3,1760,282,1599,1015,11
0,-2,0,-0.0,-2.0,0.9914772510528564,-3.585786437626905,18,-1,-1,1760,282,1599,1015,11
1,-1,0,1.0,-1.0,0.9995083808898926,-3.0,18,-2,0,1760,282,1599,1015,11
0,-2,0,-0.0,-2.0,1.007427453994751,-2.1715728752538097,18,-2,2,1760,282,1599,1015,11
0,-1,0,-0.0,-1.0,1.0166003704071045,-1.3944487245360109,18,-2,3,1760,282,1599,1015,11
1,0,0,1.0,-0.0,1.0234134197235107,-0.7573593128807152,18,-3,3,1760,282,1599,1015,11
0,-1,0,-0.0,-1.0,1.0317344665527344,0.0,18,-3,4,1760,282,1599,1015,11
0,-1,0,-0.0,-1.0,1.0476162433624268,0.8309518948453007,18,-3,5,1760,282,1599,1015,11
0,-1,0,-0.0,-1.0,1.0554814338684082,1.7082039324993694,18,-3,6,1760,282,1599,1015,11
0,0,1,-0.0,-0.0,1.0984022617340088,1.7082039324993694,18,-3,6,1760,282,1599,1015,11
1,0,1,1.0,-0.0,0.05151033401489258,1125.1492897165415,19,-747,864,1017,1140,1763,276,35
0,0,0,-0.0,-0.0,0.10153937339782715,1125.1492897165415,19,-747,864,1017,1140,1763,276,35
-1,0,0,-1.0,-0.0,0.12356424331665039,1124.495510284644,19,-746,864,1017,1140,1763,276,35
-2,0,0,-2.0,-0.0,0.13150429725646973,1123.1894579410914,19,-744,864,1017,1140,1763,276,35
-4,2,0,-4.0,2.0,0.139404296875,1119.0651389775148,19,-740,862,1017,1140,1763,276,35
-4,3,0,-4.0,3.0,0.14746522903442383,1114.1838930960782,19,-736,859,1017,1140,1763,276,35
-6,4,0,-6.0,4.0,0.15539216995239258,1107.2441905564822,19,-730,855,1017,1140,1763,276,35
-7,3,0,-7.0,3.0,0.16341924667358398,1100.422480532766,19,-723,852,1017,1140,1763,276,35
-6,4,0,-6.0,4.0,0.1714153289794922,1093.4922332011151,19,-717,848,1017,1140,1763,276,35
-8,4,0,-8.0,4.0,0.17973732948303223,1085.278095582054,19,-709,844,1017,1140,1763,276,35
-10,4,0,-10.0,4.0,0.1876201629638672,1075.7950402522881,19,-699,840,1017,1140,1763,276,35
-11,6,0,-11.0,6.0,0.1956043243408203,1064.1567878897122,19,-688,834,1017,1140,1763,276,35
-14,7,0,-14.0,7.0,0.20348119735717773,1049.866908288002,19,-674,827,1017,1140,1763,276,35
-19,11,0,-19.0,11.0,0.21140623092651367,1029.3656148784708,19,-655,816,1017,1140,1763,276,35
-25,15,0,-25.0,15.0,0.21939516067504883,1002.0686924834852,19,-630,801,1017,1140,1763,276,35
-25,15,0,-25.0,15.0,0.2272932529449463,974.877512599212,19,-605,786,1017,1140,1763,276,35
-26,18,0,-26.0,18.0,0.23604536056518555,944.8029943808659,19,-579,768,1017,1140,1763,276,35
-27,21,0,-27.0,21.0,0.24341917037963867,911.8234493163919,19,-552,747,1017,1140,1763,276,35
-27,23,0,-27.0,23.0,0.2516453266143799,877.3159396991647,19,-525,724,1017,1140,1763,276,35
-27,27,0,-27.0,27.0,0.2596461772918701,839.6288577908172,19,-498,697,1017,1140,1763,276,35
-27,29,0,-27.0,29.0,0.26741623878479004,800.3524331645438,19,-471,668,1017,1140,1763,276,35
-27,30,0,-27.0,30.0,0.27541518211364746,760.2901646103596,19,-444,638,1017,1140,1763,276,35
-27,33,0,-27.0,33.0,0.28335118293762207,717.7884049166807,19,-417,605,1017,1140,1763,276,35
-27,33,0,-27.0,33.0,0.2913801670074463,675.3034016961061,19,-390,572,1017,1140,1763,276,35
-26,31,0,-26.0,31.0,0.2993583679199219,635.0559791919709,19,-364,541,1017,1140,1763,276,35
-25,31,0,-25.0,31.0,0.3075063228607178,595.3895818839508,19,-339,510,1017,1140,1763,276,35
-20,28,0,-20.0,28.0,0.3155403137207031,561.0008650512558,19,-319,482,1017,1140,1763,276,35
-16,27,0,-16.0,27.0,0.3236873149871826,529.6571137376701,19,-303,455,1017,1140,1763,276,35
-13,26,0,-13.0,26.0,0.3312711715698242,500.82332894530737,19,-290,429,1017,1140,1763,276,35
-11,26,0,-11.0,26.0,0.33934831619262695,473.1530373260988,19,-279,403,1017,1140,1763,276,35
-12,24,0,-12.0,24.0,0.34745335578918457,446.6054356885821,19,-267,379,1017,1140,1763,276,35
-11,23,0,-11.0,23.0,0.35564517974853516,421.4883122729727,19,-256,356,1017,1140,1763,276,35
-12,21,0,-12.0,21.0,0.36353635787963867,397.44058681552895,19,-244,335,1017,1140,1763,276,35
-11,19,0,-11.0,19.0,0.37146639823913574,375.6130410467793,19,-233,316,1017,1140,1763,276,35
-9,15,0,-9.0,15.0,0.3793933391571045,358.2026119312071,19,-224,301,1017,1140,1763,276,35
-8,13,0,-8.0,13.0,0.3873481750488281,343.0,19,-216,288,1017,1140,1763,276,35
-7,11,0,-7.0,11.0,0.3961672782897949,330.0014409191985,19,-209,277,1017,1140,1763,276,35
-8,9,0,-8.0,9.0,0.40353822708129883,318.0,19,-201,268,1017,1140,1763,276,35
-6,10,0,-6.0,10.0,0.41184520721435547,306.40222633742025,19,-195,258,1017,1140,1763,276,35
-7,7,0,-7.0,7.0,0.4195132255554199,296.6000637755037,19,-188,251,1017,1140,1763,276,35
-6,8,0,-6.0,8.0,0.4275221824645996,286.60006587614566,19,-182,243,1017,1140,1763,276,35
-7,7,0,-7.0,7.0,0.4355123043060303,276.8043566729398,19,-175,236,1017,1140,1763,276,35
-5,5,0,-5.0,5.0,0.4434773921966553,269.8117849740488,19,-170,231,1017,1140,1763,276,35
-4,4,0,-4.0,4.0,0.45145416259765625,264.2205540141047,19,-166,227,1017,1140,1763,276,35
-4,4,0,-4.0,4.0,0.4597182273864746,258.6320010448714,19,-162,223,1017,1140,1763,276,35
-5,4,0,-5.0,4.0,0.46755027770996094,252.462427807663,19,-157,219,1017,1140,1763,276,35
-5,5,0,-5.0,5.0,0.47542738914489746,245.48809496813374,19,-152,214,1017,1140,1763,276,35
-5,5,0,-5.0,5.0,0.48346638679504395,238.51907952244974,19,-147,209,1017,1140,1763,276,35
-6,5,0,-6.0,5.0,0.4915022850036621,230.98588669519077,19,-141,204,1017,1140,1763,276,35
-6,6,0,-6.0,6.0,0.4993312358856201,222.64348520249825,19,-135,198,1017,1140,1763,276,35
-5,7,0,-5.0,7.0,0.5074403285980225,214.0432859877127,19,-130,191,1017,1140,1763,276,35
-6,8,0,-6.0,8.0,0.5155062675476074,204.05429197371402,19,-124,183,1017,1140,1763,276,35
-5,9,0,-5.0,9.0,0.5233943462371826,193.80085388821365,19,-119,174,1017,1140,1763,276,35
-7,7,0,-7.0,7.0,0.5314822196960449,184.07958623390888,19,-112,167,1017,1140,1763,276,35
-6,7,0,-6.0,7.0,0.5394713878631592,174.92706948213427,19,-106,160,1017,1140,1763,276,35
-6,6,0,-6.0,6.0,0.5474493503570557,166.61917111238685,19,-100,154,1017,1140,1763,276,35
-6,6,0,-6.0,6.0,0.5555672645568848,158.32826355154492,19,-94,148,1017,1140,1763,276,35
-6,6,0,-6.0,6.0,0.5634512901306152,150.05687654209268,19,-88,142,1017,1140,1763,276,35
-6,6,0,-6.0,6.0,0.5715432167053223,141.80806024884254,19,-82,136,1017,1140,1763,276,35
-7,6,0,-7.0,6.0,0.5795421600341797,133.08331019803634,19,-75,130,1017,1140,1763,276,35
-6,6,0,-6.0,6.0,0.5874803066253662,124.90489773083945,19,-69,124,1017,1140,1763,276,35
-5,5,0,-5.0,5.0,0.595494270324707,118.11846653955189,19,-64,119,1017,1140,1763,276,35
-4,5,0,-4.0,5.0,0.6033873558044434,111.82546332150332,19,-60,114,1017,1140,1763,276,35
-3,4,0,-3.0,4.0,0.6114053726196289,106.89108119634763,19,-57,110,1017,1140,1763,276,35
-2,3,0,-2.0,3.0,0.619300365447998,103.30793822520607,19,-55,107,1017,1140,1763,276,35
-2,3,0,-2.0,3.0,0.6274673938751221,99.72617529928752,19,-53,104,1017,1140,1763,276,35
-1,3,0,-1.0,3.0,0.6354432106018066,96.6001760562016,19,-52,101,1017,1140,1763,276,35
-1,3,0,-1.0,3.0,0.6435322761535645,93.47624178980746,19,-51,98,1017,1140,1763,276,35
0,2,0,-0.0,2.0,0.6513752937316895,91.70602559196064,19,-51,96,1017,1140,1763,276,35
-2,4,0,-2.0,4.0,0.6593713760375977,87.23531071570709,19,-49,92,1017,1140,1763,276,35
-1,4,0,-1.0,4.0,0.667438268661499,83.23971268913334,19,-48,88,1017,1140,1763,276,35
-3,4,0,-3.0,4.0,0.6754631996154785,78.29428104561154,19,-45,84,1017,1140,1763,276,35
-1,4,0,-1.0,4.0,0.6834602355957031,74.30169768410661,19,-44,80,1017,1140,1763,276,35
-2,4,0,-2.0,4.0,0.6915152072906494,69.83317338436964,19,-42,76,1017,1140,1763,276,35
-2,5,0,-2.0,5.0,0.6993663311004639,64.49233092751734,19,-40,71,1017,1140,1763,276,35
-2,4,0,-2.0,4.0,0.7074222564697266,60.02596964660685,19,-38,67,1017,1140,1763,276,35
-2,4,0,-2.0,4.0,0.7154333591461182,55.56031973468694,19,-36,63,1017,1140,1763,276,35
-2,4,0,-2.0,4.0,0.7234082221984863,51.095521144932874,19,-34,59,1017,1140,1763,276,35
-3,4,0,-3.0,4.0,0.7315452098846436,46.13477647065839,19,-31,55,1017,1140,1763,276,35
-3,5,0,-3.0,5.0,0.7401983737945557,40.30619512757761,19,-28,50,1017,1140,1763,276,35
-4,4,0,-4.0,4.0,0.747582197189331,34.884487084291386,19,-24,46,1017,1140,1763,276,35
-4,4,0,-4.0,4.0,0.7554943561553955,29.518813398452032,19,-20,42,1017,1140,1763,276,35
-3,4,0,-3.0,4.0,0.7637612819671631,24.6293165929973,19,-17,38,1017,1140,1763,276,35
-3,3,0,-3.0,3.0,0.7716042995452881,20.69615364994153,19,-14,35,1017,1140,1763,276,35
-3,4,0,-3.0,4.0,0.7794923782348633,15.89376840679705,19,-11,31,1017,1140,1763,276,35
-4,5,0,-4.0,5.0,0.7873761653900146,9.92582403567252,19,-7,26,1017,1140,1763,276,35
-4,4,0,-4.0,4.0,0.7954452037811279,5.203603311174518,19,-3,22,1017,1140,1763,276,35
-3,2,0,-3.0,2.0,0.8033812046051025,3.0,19,0,20,1017,1140,1763,276,35
-3,1,0,-3.0,1.0,0.8113951683044434,2.2353840616713434,19,3,19,1017,1140,1763,276,35
0,2,0,-0.0,2.0,0.8204011917114258,0.26267650163206824,19,3,17,1017,1140,1763,276,35
-1,0,0,-1.0,-0.0,0.8276383876800537,0.4642491965729789,19,4,17,1017,1140,1763,276,35
0,1,0,-0.0,1.0,0.8355412483215332,-0.5075774975293577,19,4,16,1017,1140,1763,276,35
0,0,1,-0.0,-0.0,0.8684072494506836,-0.5075774975293577,19,4,16,1017,1140,1763,276,35
0,0,0,-0.0,-0.0,0.09890103340148926,1198.415971308342,20,-637,-1021,376,103,1013,1124,11
-1,0,0,-1.0,-0.0,0.10582613945007324,1197.886943981021,20,-636,-1021,376,103,1013,1124,11
0,-1,0,-0.0,-1.0,0.13812804222106934,1197.0382689415508,20,-636,-1020,376,103,1013,1124,11
0,-3,0,-0.0,-3.0,0.14586901664733887,1194.4936431678161,20,-636,-1017,376,103,1013,1124,11
0,-2,0,-0.0,-2.0,0.15371918678283691,1192.7983970602065,20,-636,-1015,376,103,1013,1124,11
0,-3,0,-0.0,-3.0,0.1618180274963379,1190.2572944768,20,-636,-1012,376,103,1013,1124,11
0,-3,0,-0.0,-3.0,0.16997122764587402,1187.7183238300652,20,-636,-1009,376,103,1013,1124,11
0,-5,0,-0.0,-5.0,0.17789006233215332,1183.491480827692,20,-636,-1004,376,103,1013,1124,11
1,-5,0,1.0,-5.0,0.18604421615600586,1179.8080013234212,20,-637,-999,376,103,1013,1124,11
1,-5,0,1.0,-5.0,0.1939551830291748,1176.135047316775,20,-638,-994,376,103,1013,1124,11
0,-5,0,-0.0,-5.0,0.2020561695098877,1171.9303292888667,20,-638,-989,376,103,1013,1124,11
-1,-6,0,-1.0,-6.0,0.20989608764648438,1166.3487951929606,20,-637,-983,376,103,1013,1124,11
-2,-7,0,-2.0,-7.0,0.21796822547912598,1159.3886808106647,20,-635,-976,376,103,1013,1124,11
-2,-9,0,-2.0,-9.0,0.22587323188781738,1150.758625319318,20,-633,-967,376,103,1013,1124,11
-5,-13,0,-5.0,-13.0,0.23390412330627441,1137.1471008587291,20,-628,-954,376,103,1013,1124,11
-6,-17,0,-6.0,-17.0,0.24193120002746582,1119.6568365505987,20,-622,-937,376,103,1013,1124,11
-8,-20,0,-8.0,-20.0,0.2505311965942383,1098.5782708988067,20,-614,-917,376,103,1013,1124,11
-11,-23,0,-11.0,-23.0,0.2579941749572754,1073.3529106929698,20,-603,-894,376,103,1013,1124,11
-13,-26,0,-13.0,-26.0,0.2659912109375,1044.535135190814,20,-590,-868,376,103,1013,1124,11
-14,-28,0,-14.0,-28.0,0.27394723892211914,1013.5165683483013,20,-576,-840,376,103,1013,1124,11
-16,-29,0,-16.0,-29.0,0.2817962169647217,980.5561881496153,20,-560,-811,376,103,1013,1124,11
-20,-32,0,-20.0,-32.0,0.2904942035675049,942.8612767699713,20,-540,-779,376,103,1013,1124,11
-24,-32,0,-24.0,-32.0,0.29792308807373047,902.8904118890121,20,-516,-747,376,103,1013,1124,11
-29,-35,0,-29.0,-35.0,0.30585408210754395,857.6198467459463,20,-487,-712,376,103,1013,1124,11
-34,-38,0,-34.0,-38.0,0.3139510154724121,807.0868180188618,20,-453,-674,376,103,1013,1124,11
-36,-39,0,-36.0,-39.0,0.32263708114624023,754.6801958719209,20,-417,-635,376,103,1013,1124,11
-34,-37,0,-34.0,-37.0,0.3301980495452881,705.1359024862776,20,-383,-598,376,103,1013,1124,11
-31,-35,0,-31.0,-35.0,0.33801722526550293,658.9826804970141,20,-352,-563,376,103,1013,1124,11
-31,-34,0,-31.0,-34.0,0.34581518173217773,613.7745954707578,20,-321,-529,376,103,1013,1124,11
-25,-29,0,-25.0,-29.0,0.3537862300872803,576.0473302580436,20,-296,-500,376,103,1013,1124,11
-22,-26,0,-22.0,-26.0,0.3620011806488037,542.4961187077038,20,-274,-474,376,103,1013,1124,11
-22,-24,0,-22.0,-24.0,0.36997413635253906,510.75575614819854,20,-252,-450,376,103,1013,1124,11
-19,-22,0,-19.0,-22.0,0.3779110908508301,482.31201503759377,20,-233,-428,376,103,1013,1124,11
-18,-21,0,-18.0,-21.0,0.385836124420166,455.2977297358743,20,-215,-407,376,103,1013,1124,11
-18,-21,0,-18.0,-21.0,0.39402318000793457,428.36474245143665,20,-197,-386,376,103,1013,1124,11
-17,-20,0,-17.0,-20.0,0.4024670124053955,402.86762558457616,20,-180,-366,376,103,1013,1124,11
-16,-20,0,-16.0,-20.0,0.4098701477050781,377.89946461179596,20,-164,-346,376,103,1013,1124,11
-15,-18,0,-15.0,-18.0,0.41811203956604004,355.25685281476603,20,-149,-328,376,103,1013,1124,11
-12,-14,0,-12.0,-14.0,0.42616701126098633,337.5857556875358,20,-137,-314,376,103,1013,1124,11
-8,-9,0,-8.0,-9.0,0.43376922607421875,326.15857228826195,20,-129,-305,376,103,1013,1124,11
-3,-7,0,-3.0,-7.0,0.4419081211090088,318.5428874198906,20,-126,-298,376,103,1013,1124,11
-1,-4,0,-1.0,-4.0,0.44983720779418945,314.4698733840172,20,-125,-294,376,103,1013,1124,11
-1,-4,0,-1.0,-4.0,0.4579651355743408,310.39816105995294,20,-124,-290,376,103,1013,1124,11
0,-4,0,-0.0,-4.0,0.4659130573272705,306.7242371070944,20,-124,-286,376,103,1013,1124,11
0,-6,0,-0.0,-6.0,0.47385215759277344,301.22867272677126,20,-124,-280,376,103,1013,1124,11
-1,-8,0,-1.0,-8.0,0.48191213607788086,293.5180061570826,20,-123,-272,376,103,1013,1124,11
0,-8,0,-0.0,-8.0,0.49007201194763184,286.247317584214,20,-123,-264,376,103,1013,1124,11
0,-8,0,-0.0,-8.0,0.4978790283203125,279.01584462842914,20,-123,-256,376,103,1013,1124,11
0,-7,0,-0.0,-7.0,0.5058591365814209,272.7228834647948,20,-123,-249,376,103,1013,1124,11
-1,-7,0,-1.0,-7.0,0.5138421058654785,266.01291482141585,20,-122,-242,376,103,1013,1124,11
-1,-6,0,-1.0,-6.0,0.5217561721801758,260.2112365643658,20,-121,-236,376,103,1013,1124,11
0,-7,0,-0.0,-7.0,0.5299460887908936,254.00193049473592,20,-121,-229,376,103,1013,1124,11
-1,-5,0,-1.0,-5.0,0.5381240844726562,249.11808278829744,20,-120,-224,376,103,1013,1124,11
-1,-6,0,-1.0,-6.0,0.545910120010376,243.3646512690564,20,-119,-218,376,103,1013,1124,11
-2,-6,0,-2.0,-6.0,0.5540561676025391,237.1425200166216,20,-117,-212,376,103,1013,1124,11
-1,-5,0,-1.0,-5.0,0.5618760585784912,232.28674636397204,20,-116,-207,376,103,1013,1124,11
-1,-5,0,-1.0,-5.0,0.5698580741882324,227.44139046219803,20,-115,-202,376,103,1013,1124,11
-2,-5,0,-2.0,-5.0,0.578106164932251,222.1079038695043,20,-113,-197,376,103,1013,1124,11
-2,-5,0,-2.0,-5.0,0.5862550735473633,216.77691493931465,20,-111,-192,376,103,1013,1124,11
-2,-6,0,-2.0,-6.0,0.5939311981201172,210.58524995926786,20,-109,-186,376,103,1013,1124,11
-3,-7,0,-3.0,-7.0,0.6018171310424805,203.03124765284662,20,-106,-179,376,103,1013,1124,11
-3,-7,0,-3.0,-7.0,0.609882116317749,195.48191938426766,20,-103,-172,376,103,1013,1124,11
-4,-6,0,-4.0,-6.0,0.6179561614990234,188.27959023135372,20,-99,-166,376,103,1013,1124,11
-3,-7,0,-3.0,-7.0,0.6258840560913086,180.73368030596927,20,-96,-159,376,103,1013,1124,11
-3,-5,0,-3.0,-5.0,0.6338222026824951,174.90275150758535,20,-93,-154,376,103,1013,1124,11
-3,-6,0,-3.0,-6.0,0.6424121856689453,168.216627377397,20,-90,-148,376,103,1013,1124,11
-3,-7,0,-3.0,-7.0,0.650158166885376,160.6804152578089,20,-87,-141,376,103,1013,1124,11
-4,-7,0,-4.0,-7.0,0.657912015914917,152.62296786953354,20,-83,-134,376,103,1013,1124,11
-4,-7,0,-4.0,-7.0,0.665877103805542,144.56603892595405,20,-79,-127,376,103,1013,1124,11
-3,-7,0,-3.0,-7.0,0.6740550994873047,137.04224723651762,20,-76,-120,376,103,1013,1124,11
-2,-4,0,-2.0,-4.0,0.681934118270874,132.59360450253493,20,-74,-116,376,103,1013,1124,11
-2,-5,0,-2.0,-5.0,0.689906120300293,127.30646242719968,20,-72,-111,376,103,1013,1124,11
-2,-5,0,-2.0,-5.0,0.6979382038116455,122.02755606560333,20,-70,-106,376,103,1013,1124,11
-3,-5,0,-3.0,-5.0,0.7059001922607422,116.2023102090055,20,-67,-101,376,103,1013,1124,11
-3,-5,0,-3.0,-5.0,0.7143070697784424,110.37764081484765,20,-64,-96,376,103,1013,1124,11
-3,-6,0,-3.0,-6.0,0.7219891548156738,103.72442227944924,20,-61,-90,376,103,1013,1124,11
-3,-6,0,-3.0,-6.0,0.7300350666046143,97.07840124139877,20,-58,-84,376,103,1013,1124,11
-3,-7,0,-3.0,-7.0,0.7380161285400391,89.62557793746889,20,-55,-77,376,103,1013,1124,11
-2,-5,0,-2.0,-5.0,0.745913028717041,84.40357934669059,20,-53,-72,376,103,1013,1124,11
0,-1,0,-0.0,-1.0,0.753791093826294,83.60022573334675,20,-53,-71,376,103,1013,1124,11
0,-1,0,-0.0,-1.0,0.8100681304931641,82.80091115700337,20,-53,-70,376,103,1013,1124,11
-1,-2,0,-1.0,-2.0,0.8261961936950684,80.60373823613078,20,-52,-68,376,103,1013,1124,11
0,-2,0,-0.0,-2.0,0.8339841365814209,79.02380615040002,20,-52,-66,376,103,1013,1124,11
0,-1,0,-0.0,-1.0,0.8498351573944092,78.24061508662703,20,-52,-65,376,103,1013,1124,11
0,-1,0,-0.0,-1.0,0.8579480648040771,77.46211251235322,20,-52,-64,376,103,1013,1124,11
0,-1,0,-0.0,-1.0,0.8659501075744629,76.68843247363729,20,-52,-63,376,103,1013,1124,11
-1,-1,0,-1.0,-1.0,0.8739831447601318,75.2807573457052,20,-51,-62,376,103,1013,1124,11
0,-2,0,-0.0,-2.0,0.8827412128448486,73.74642849044012,20,-51,-60,376,103,1013,1124,11
-1,-3,0,-1.0,-3.0,0.8904180526733398,70.82216034906945,20,-50,-57,376,103,1013,1124,11
-1,-2,0,-1.0,-2.0,0.8979251384735107,68.66138744281159,20,-49,-55,376,103,1013,1124,11
-1,-2,0,-1.0,-2.0,0.9058811664581299,66.50524456289902,20,-48,-53,376,103,1013,1124,11
-1,-2,0,-1.0,-2.0,0.9139420986175537,64.35416353759881,20,-47,-51,376,103,1013,1124,11
-1,-2,0,-1.0,-2.0,0.9220240116119385,62.208630398186216,20,-46,-49,376,103,1013,1124,11
-2,-1,0,-2.0,-1.0,0.9298360347747803,60.115282384398824,20,-44,-48,376,103,1013,1124,11
-1,-2,0,-1.0,-2.0,0.9378480911254883,57.96824596572466,20,-43,-46,376,103,1013,1124,11
-2,-2,0,-2.0,-2.0,0.9458541870117188,55.14149981501958,20,-41,-44,376,103,1013,1124,11
-2,-3,0,-2.0,-3.0,0.9540672302246094,51.586217403180434,20,-39,-41,376,103,1013,1124,11
-3,-2,0,-3.0,-2.0,0.9627091884613037,48.075418038862395,20,-36,-39,376,103,1013,1124,11
-2,-1,0,-2.0,-1.0,0.9699950218200684,45.99019513592785,20,-34,-38,376,103,1013,1124,11
-3,-2,0,-3.0,-2.0,0.9780511856079102,42.50789408087881,20,-31,-36,376,103,1013,1124,11
-2,-2,0,-2.0,-2.0,0.9859402179718018,39.68780594300866,20,-29,-34,376,103,1013,1124,11
-1,-2,0,-1.0,-2.0,0.9938650131225586,37.5205832509386,20,-28,-32,376,103,1013,1124,11
-1,-2,0,-1.0,-2.0,1.0018210411071777,35.36087214122113,20,-27,-30,376,103,1013,1124,11
-1,-1,0,-1.0,-1.0,1.009932041168213,33.948684188300895,20,-26,-29,376,103,1013,1124,11
-2,-2,0,-2.0,-2.0,1.0179481506347656,31.124783736376884,20,-24,-27,376,103,1013,1124,11
-2,-2,0,-2.0,-2.0,1.0258822441101074,28.301651610693426,20,-22,-25,376,103,1013,1124,11
-2,-2,0,-2.0,-2.0,1.0355091094970703,25.479501308256342,20,-20,-23,376,103,1013,1124,11
-1,-2,0,-1.0,-2.0,1.0418481826782227,23.319604517012593,20,-19,-21,376,103,1013,1124,11
-2,-2,0,-2.0,-2.0,1.0499942302703857,20.495097567963924,20,-17,-19,376,103,1013,1124,11
-2,-3,0,-2.0,-3.0,1.0580382347106934,16.93171219946131,20,-15,-16,376,103,1013,1124,11
-2,-2,0,-2.0,-2.0,1.0659971237182617,14.104973174542799,20,-13,-14,376,103,1013,1124,11
-2,-3,0,-2.0,-3.0,1.0739901065826416,10.556349186104045,20,-11,-11,376,103,1013,1124,11
-2,-2,0,-2.0,-2.0,1.0819451808929443,7.727922061357855,20,-9,-9,376,103,1013,1124,11
-1,-2,0,-1.0,-2.0,1.0897800922393799,5.63014581273465,20,-8,-7,376,103,1013,1124,11
-2,-2,0,-2.0,-2.0,1.097905158996582,2.810249675906654,20,-6,-5,376,103,1013,1124,11
-2,-2,0,-2.0,-2.0,1.1068370342254639,0.0,20,-4,-3,376,103,1013,1124,11
-1,-1,0,-1.0,-1.0,1.1141481399536133,-1.3944487245360109,20,-3,-2,376,103,1013,1124,11
-2,-1,0,-2.0,-1.0,1.1221282482147217,-3.585786437626905,20,-1,-1,376,103,1013,1124,11
-1,0,0,-1.0,-0.0,1.1378800868988037,-4.0,20,0,-1,376,103,1013,1124,11
0,-1,0,-0.0,-1.0,1.178185224533081,-5.0,20,0,0,376,103,1013,1124,11
0,0,1,-0.0,-0.0,1.2597920894622803,-5.0,20,0,0,376,103,1013,1124,11
0,0,0,-0.0,-0.0,0.0779106616973877,1376.9575902357135,21,1231,673,1607,776,376,103,53
1,4,0,1.0,4.0,0.11687874794006348,1374.1646331771133,21,1230,669,1607,776,376,103,53
4,11,0,4.0,11.0,0.12483954429626465,1365.4165443892064,21,1226,658,1607,776,376,103,53
5,12,0,5.0,12.0,0.13313055038452148,1355.3605611859634,21,1221,646,1607,776,376,103,53
4,12,0,4.0,12.0,0.14089560508728027,1346.240868069451,21,1217,634,1607,776,376,103,53
2,14,0,2.0,14.0,0.14900851249694824,1338.047286570374,21,1215,620,1607,776,376,103,53
4,17,0,4.0,17.0,0.15698456764221191,1326.8229743761747,21,1211,603,1607,776,376,103,53
10,19,0,10.0,19.0,0.16482853889465332,1309.4613435064305,21,1201,584,1607,776,376,103,53
11,18,0,11.0,18.0,0.1728076934814453,1291.746561369067,21,1190,566,1607,776,376,103,53
14,20,0,14.0,20.0,0.18073463439941406,1270.569319396383,21,1176,546,1607,776,376,103,53
19,24,0,19.0,24.0,0.1888256072998047,1243.304140070456,21,1157,522,1607,776,376,103,53
23,26,0,23.0,26.0,0.19672751426696777,1211.7285647507695,21,1134,496,1607,776,376,103,53
30,32,0,30.0,32.0,0.20491552352905273,1171.5441536745107,21,1104,464,1607,776,376,103,53
36,35,0,36.0,35.0,0.21285152435302734,1124.940919422018,21,1068,429,1607,776,376,103,53
38,35,0,38.0,35.0,0.22087574005126953,1076.7855639243742,21,1030,394,1607,776,376,103,53
40,31,0,40.0,31.0,0.2289116382598877,1028.4519903722503,21,990,363,1607,776,376,103,53
39,25,0,39.0,25.0,0.23679065704345703,983.2794459415093,21,951,338,1607,776,376,103,53
37,18,0,37.0,18.0,0.24470162391662598,942.3986782312335,21,914,320,1607,776,376,103,53
36,12,0,36.0,12.0,0.2526416778564453,904.4558022818709,21,878,308,1607,776,376,103,53
34,8,0,34.0,8.0,0.260852575302124,869.7321028075303,21,844,300,1607,776,376,103,53
31,4,0,31.0,4.0,0.26886463165283203,839.2080674612321,21,813,296,1607,776,376,103,53
26,1,0,26.0,1.0,0.27675652503967285,814.4724861647762,21,787,295,1607,776,376,103,53
19,0,0,19.0,-0.0,0.2847745418548584,796.7083322782139,21,768,295,1607,776,376,103,53
14,-1,0,14.0,-1.0,0.29293060302734375,784.019752845571,21,754,296,1607,776,376,103,53
9,-1,0,9.0,-1.0,0.3010077476501465,776.0187030238135,21,745,297,1607,776,376,103,53
7,-1,0,7.0,-1.0,0.3088645935058594,769.8944653658549,21,738,298,1607,776,376,103,53
6,-1,0,6.0,-1.0,0.31689453125,764.7117047318827,21,732,299,1607,776,376,103,53
4,0,0,4.0,-0.0,0.32474660873413086,761.0101651185962,21,728,299,1607,776,376,103,53
2,0,0,2.0,-0.0,0.332749605178833,759.1604931477385,21,726,299,1607,776,376,103,53
4,-1,0,4.0,-1.0,0.3408036231994629,755.8465322555315,21,722,300,1607,776,376,103,53
5,0,0,5.0,-0.0,0.3489196300506592,751.2316257075493,21,717,300,1607,776,376,103,53
5,0,0,5.0,-0.0,0.356919527053833,746.6215114789388,21,712,300,1607,776,376,103,53
8,0,0,8.0,-0.0,0.364884614944458,739.2555128844222,21,704,300,1607,776,376,103,53
10,2,0,10.0,2.0,0.37276172637939453,729.2747844327918,21,694,298,1607,776,376,103,53
14,2,0,14.0,2.0,0.3807556629180908,715.6306358289145,21,680,296,1607,776,376,103,53
18,5,0,18.0,5.0,0.38878369331359863,697.1355336311444,21,662,291,1607,776,376,103,53
20,7,0,20.0,7.0,0.39684557914733887,676.0113959188982,21,642,284,1607,776,376,103,53
22,10,0,22.0,10.0,0.40480756759643555,651.8465903137671,21,620,274,1607,776,376,103,53
22,10,0,22.0,10.0,0.41292858123779297,627.6818798161687,21,598,264,1607,776,376,103,53
24,11,0,24.0,11.0,0.4208385944366455,601.2838273062681,21,574,253,1607,776,376,103,53
26,13,0,26.0,13.0,0.4289116859436035,572.2507835347982,21,548,240,1607,776,376,103,53
30,14,0,30.0,14.0,0.4368157386779785,539.1548460377917,21,518,226,1607,776,376,103,53
29,14,0,29.0,14.0,0.4449336528778076,506.97748545318495,21,489,212,1607,776,376,103,53
28,12,0,28.0,12.0,0.4527406692504883,476.5146764025903,21,461,200,1607,776,376,103,53
27,13,0,27.0,13.0,0.4608025550842285,446.5727457228146,21,434,187,1607,776,376,103,53
25,13,0,25.0,13.0,0.46889162063598633,418.47384624969783,21,409,174,1607,776,376,103,53
24,13,0,24.0,13.0,0.4769105911254883,391.30803970208865,21,385,161,1607,776,376,103,53
22,13,0,22.0,13.0,0.48476171493530273,366.0114794237536,21,363,148,1607,776,376,103,53
21,13,0,21.0,13.0,0.4930105209350586,341.68056788467896,21,342,135,1607,776,376,103,53
19,13,0,19.0,13.0,0.5009815692901611,319.2723562638631,21,323,122,1607,776,376,103,53
18,13,0,18.0,13.0,0.5092425346374512,297.89195729440394,21,305,109,1607,776,376,103,53
19,13,0,19.0,13.0,0.5166575908660889,275.6819517306264,21,286,96,1607,776,376,103,53
20,14,0,20.0,14.0,0.5247666835784912,252.35229476330892,21,266,82,1607,776,376,103,53
21,12,0,21.0,12.0,0.5327575206756592,228.80384612481814,21,245,70,1607,776,376,103,53
20,11,0,20.0,11.0,0.5407426357269287,206.606964642076,21,225,59,1607,776,376,103,53
19,9,0,19.0,9.0,0.5487415790557861,185.98113123577767,21,206,50,1607,776,376,103,53
18,8,0,18.0,8.0,0.5569875240325928,166.634368688456,21,188,42,1607,776,376,103,53
19,8,0,19.0,8.0,0.5649845600128174,146.38619434281853,21,169,34,1607,776,376,103,53
17,7,0,17.0,7.0,0.5728836059570312,128.37940277122465,21,152,27,1607,776,376,103,53
16,6,0,16.0,6.0,0.5808436870574951,111.61177275218861,21,136,21,1607,776,376,103,53
15,7,0,15.0,7.0,0.5889475345611572,95.80722474467596,21,121,14,1607,776,376,103,53
15,6,0,15.0,6.0,0.5967535972595215,80.30145812734649,21,106,8,1607,776,376,103,53
13,6,0,13.0,6.0,0.6047697067260742,67.02150289046077,21,93,2,1607,776,376,103,53
12,5,0,12.0,5.0,0.612818717956543,55.05553651663777,21,81,-3,1607,776,376,103,53
9,3,0,9.0,3.0,0.6208107471466064,46.24956747275377,21,72,-6,1607,776,376,103,53
9,4,0,9.0,4.0,0.6288456916809082,37.788713735268246,21,63,-10,1607,776,376,103,53
9,2,0,9.0,2.0,0.6372246742248535,29.317266743757322,21,54,-12,1607,776,376,103,53
6,0,0,6.0,-0.0,0.6447715759277344,23.477267507411923,21,48,-12,1607,776,376,103,53
6,1,0,6.0,1.0,0.6528465747833252,17.965895873961216,21,42,-13,1607,776,376,103,53
5,0,0,5.0,-0.0,0.6609585285186768,13.217343102255157,21,37,-13,1607,776,376,103,53
2,0,0,2.0,-0.0,0.6689376831054688,11.336309405188942,21,35,-13,1607,776,376,103,53
3,-1,0,3.0,-1.0,0.6767797470092773,8.176014981270121,21,32,-12,1607,776,376,103,53
2,-1,0,2.0,-1.0,0.6848306655883789,5.953090617340916,21,30,-11,1607,776,376,103,53
3,0,0,3.0,-0.0,0.6927547454833984,3.154759474226502,21,27,-11,1607,776,376,103,53
3,-1,0,3.0,-1.0,0.7007577419281006,0.0,21,24,-10,1607,776,376,103,53
2,-2,0,2.0,-2.0,0.7096717357635498,-2.5906001785607486,21,22,-8,1607,776,376,103,53
3,-3,0,3.0,-3.0,0.7171835899353027,-6.353117295611501,21,19,-5,1607,776,376,103,53
2,-2,0,2.0,-2.0,0.7250607013702393,-8.737323498367932,21,17,-3,1607,776,376,103,53
2,-3,0,2.0,-3.0,0.7332875728607178,-11.0,21,15,0,1607,776,376,103,53
2,-3,0,2.0,-3.0,0.7407715320587158,-12.658335935873666,21,13,3,1607,776,376,103,53
2,-2,0,2.0,-2.0,0.7487585544586182,-13.916954026405428,21,11,5,1607,776,376,103,53
3,-1,0,3.0,-1.0,0.7567846775054932,-16.0,21,8,6,1607,776,376,103,53
1,-1,0,1.0,-1.0,0.7649176120758057,-16.100505063388333,21,7,7,1607,776,376,103,53
0,-1,0,-0.0,-1.0,0.7731475830078125,-15.36985418726535,21,7,8,1607,776,376,103,53
0,0,1,-0.0,-0.0,0.8027186393737793,-15.36985418726535,21,7,8,1607,776,376,103,53
0,0,0,-0.0,-0.0,0.06670641899108887,1496.0270358040939,22,-1326,-697,274,71,1600,768,4
-4,2,0,-4.0,2.0,0.09164547920227051,1493.4213453070677,22,-1322,-699,274,71,1600,768,4
-8,1,0,-8.0,1.0,0.09962248802185059,1486.8236967485439,22,-1314,-700,274,71,1600,768,4
-12,2,0,-12.0,2.0,0.1076045036315918,1477.191671150159,22,-1302,-702,274,71,1600,768,4
-14,1,0,-14.0,1.0,0.11554837226867676,1465.3626000413121,22,-1288,-703,274,71,1600,768,4
-18,0,0,-18.0,-0.0,0.12353754043579102,1449.5884402956644,22,-1270,-703,274,71,1600,768,4
-23,0,0,-23.0,-0.0,0.13159942626953125,1429.508994033918,22,-1247,-703,274,71,1600,768,4
-25,-1,0,-25.0,-1.0,0.13957643508911133,1407.2863442182359,22,-1222,-702,274,71,1600,768,4
-25,-1,0,-25.0,-1.0,0.14771556854248047,1385.1589670978594,22,-1197,-701,274,71,1600,768,4
-23,-1,0,-23.0,-1.0,0.15574049949645996,1364.8489309356758,22,-1174,-700,274,71,1600,768,4
-18,-1,0,-18.0,-1.0,0.16360950469970703,1348.902291063273,22,-1156,-699,274,71,1600,768,4
-15,-1,0,-15.0,-1.0,0.17162442207336426,1335.5668207607423,22,-1141,-698,274,71,1600,768,4
-12,0,0,-12.0,-0.0,0.17957758903503418,1325.3450945402255,22,-1129,-698,274,71,1600,768,4
-7,-2,0,-7.0,-2.0,0.1876845359802246,1318.340865079923,22,-1122,-696,274,71,1600,768,4
-5,-1,0,-5.0,-1.0,0.19561553001403809,1313.5660378711516,22,-1117,-695,274,71,1600,768,4
-2,-1,0,-2.0,-1.0,0.20353150367736816,1311.3396361946898,22,-1115,-694,274,71,1600,768,4
-4,-2,0,-4.0,-2.0,0.21155548095703125,1306.8869317095346,22,-1111,-692,274,71,1600,768,4
-8,-4,0,-8.0,-4.0,0.219679594039917,1297.9819229512386,22,-1103,-688,274,71,1600,768,4
-11,-7,0,-11.0,-7.0,0.22777247428894043,1284.944054728099,22,-1092,-681,274,71,1600,768,4
-18,-10,0,-18.0,-10.0,0.23569846153259277,1264.3794849886033,22,-1074,-671,274,71,1600,768,4
-22,-13,0,-22.0,-13.0,0.24366259574890137,1238.833590776781,22,-1052,-658,274,71,1600,768,4
-27,-15,0,-27.0,-15.0,0.2515676021575928,1207.9892561506485,22,-1025,-643,274,71,1600,768,4
-31,-19,0,-31.0,-19.0,0.2595794200897217,1171.6319695713814,22,-994,-624,274,71,1600,768,4
-34,-21,0,-34.0,-21.0,0.26749753952026367,1131.670587075452,22,-960,-603,274,71,1600,768,4
-34,-19,0,-34.0,-19.0,0.27556657791137695,1092.7748627000897,22,-926,-584,274,71,1600,768,4
-35,-20,0,-35.0,-20.0,0.28365659713745117,1052.5032005641328,22,-891,-564,274,71,1600,768,4
-33,-17,0,-33.0,-17.0,0.29178643226623535,1015.532800454118,22,-858,-547,274,71,1600,768,4
-31,-16,0,-31.0,-16.0,0.2996785640716553,980.7970288925379,22,-827,-531,274,71,1600,768,4
-32,-16,0,-32.0,-16.0,0.30763840675354004,945.2328119316813,22,-795,-515,274,71,1600,768,4
-34,-18,0,-34.0,-18.0,0.31552553176879883,906.916937899168,22,-761,-497,274,71,1600,768,4
-35,-19,0,-35.0,-19.0,0.32355356216430664,867.2295439065564,22,-726,-478,274,71,1600,768,4
-39,-22,0,-39.0,-22.0,0.33164548873901367,822.5635209006035,22,-687,-456,274,71,1600,768,4
-42,-24,0,-42.0,-24.0,0.33952856063842773,774.3047082170763,22,-645,-432,274,71,1600,768,4
-45,-24,0,-45.0,-24.0,0.34753847122192383,723.5783899758868,22,-600,-408,274,71,1600,768,4
-46,-23,0,-46.0,-23.0,0.35558152198791504,672.641386219375,22,-554,-385,274,71,1600,768,4
-44,-22,0,-44.0,-22.0,0.36368536949157715,623.9944089207187,22,-510,-363,274,71,1600,768,4
-43,-21,0,-43.0,-21.0,0.37180256843566895,576.83762835531,22,-467,-342,274,71,1600,768,4
-40,-20,0,-40.0,-20.0,0.37961554527282715,532.8018324575936,22,-427,-322,274,71,1600,768,4
-40,-21,0,-40.0,-21.0,0.38738346099853516,488.2754327926293,22,-387,-301,274,71,1600,768,4
-38,-20,0,-38.0,-20.0,0.3954343795776367,446.06472746691406,22,-349,-281,274,71,1600,768,4
-32,-20,0,-32.0,-20.0,0.40352654457092285,408.62148019800424,22,-317,-261,274,71,1600,768,4
-28,-19,0,-28.0,-19.0,0.41143155097961426,374.9416400452463,22,-289,-242,274,71,1600,768,4
-23,-18,0,-23.0,-18.0,0.4195985794067383,345.75278575447817,22,-266,-224,274,71,1600,768,4
-16,-13,0,-16.0,-13.0,0.4275023937225342,325.14064253773176,22,-250,-211,274,71,1600,768,4
-12,-13,0,-12.0,-13.0,0.43582844734191895,307.5932815808508,22,-238,-198,274,71,1600,768,4
-7,-9,0,-7.0,-9.0,0.4435904026031494,296.4660784745898,22,-231,-189,274,71,1600,768,4
-3,-7,0,-3.0,-7.0,0.4515724182128906,289.73275441746335,22,-228,-182,274,71,1600,768,4
-3,-5,0,-3.0,-5.0,0.45952653884887695,284.27609051403505,22,-225,-177,274,71,1600,768,4
-1,-5,0,-1.0,-5.0,0.4675445556640625,280.41812972966164,22,-224,-172,274,71,1600,768,4
-1,-5,0,-1.0,-5.0,0.4755384922027588,276.6000717874997,22,-223,-167,274,71,1600,768,4
-1,-5,0,-1.0,-5.0,0.4841923713684082,272.8235797743709,22,-222,-162,274,71,1600,768,4
0,-7,0,-0.0,-7.0,0.4918215274810791,268.75634803269156,22,-222,-155,274,71,1600,768,4
-1,-6,0,-1.0,-6.0,0.499861478805542,264.5370518333239,22,-221,-149,274,71,1600,768,4
-1,-6,0,-1.0,-6.0,0.5077395439147949,260.3909297212844,22,-220,-143,274,71,1600,768,4
-1,-5,0,-1.0,-5.0,0.5155544281005859,256.8532402733255,22,-219,-138,274,71,1600,768,4
-1,-4,0,-1.0,-4.0,0.5235223770141602,253.8906016249913,22,-218,-134,274,71,1600,768,4
-3,-4,0,-3.0,-4.0,0.5316073894500732,249.24689052802225,22,-215,-130,274,71,1600,768,4
-2,-3,0,-2.0,-3.0,0.5395383834838867,245.98790293076797,22,-213,-127,274,71,1600,768,4
-4,-2,0,-4.0,-2.0,0.5474834442138672,241.52823244954578,22,-209,-125,274,71,1600,768,4
-2,0,0,-2.0,-0.0,0.5562965869903564,239.81397809059757,22,-207,-125,274,71,1600,768,4
-2,-1,0,-2.0,-1.0,0.5638594627380371,237.58505796480713,22,-205,-124,274,71,1600,768,4
-1,0,0,-1.0,-0.0,0.5717434883117676,236.72997298202839,22,-204,-124,274,71,1600,768,4
-2,0,0,-2.0,-0.0,0.5797004699707031,235.0232056149777,22,-202,-124,274,71,1600,768,4
-3,-1,0,-3.0,-1.0,0.5875864028930664,231.94443784796422,22,-199,-123,274,71,1600,768,4
-5,-2,0,-5.0,-2.0,0.595597505569458,226.64164100180878,22,-194,-121,274,71,1600,768,4
-7,-4,0,-7.0,-4.0,0.603609561920166,218.58558429779586,22,-187,-117,274,71,1600,768,4
-10,-5,0,-10.0,-5.0,0.611560583114624,207.45882650296693,22,-177,-112,274,71,1600,768,4
-12,-6,0,-12.0,-6.0,0.6195855140686035,194.1147623204332,22,-165,-106,274,71,1600,768,4
-14,-6,0,-14.0,-6.0,0.6280865669250488,179.11046352985792,22,-151,-100,274,71,1600,768,4
-16,-7,0,-16.0,-7.0,0.6358535289764404,161.93291310777101,22,-135,-93,274,71,1600,768,4
-16,-7,0,-16.0,-7.0,0.643667459487915,144.82302271782856,22,-119,-86,274,71,1600,768,4
-17,-6,0,-17.0,-6.0,0.651592493057251,127.63024338479042,22,-102,-80,274,71,1600,768,4
-16,-8,0,-16.0,-8.0,0.659543514251709,110.16059914247963,22,-86,-72,274,71,1600,768,4
-16,-7,0,-16.0,-7.0,0.6675283908843994,93.524865872714,22,-70,-65,274,71,1600,768,4
-13,-6,0,-13.0,-6.0,0.6755244731903076,80.03657720797473,22,-57,-59,274,71,1600,768,4
-11,-6,0,-11.0,-6.0,0.683537483215332,68.178344238091,22,-46,-53,274,71,1600,768,4
-8,-4,0,-8.0,-4.0,0.6917755603790283,60.00806399170998,22,-38,-49,274,71,1600,768,4
-7,-4,0,-7.0,-4.0,0.7000494003295898,52.644304369257,22,-31,-45,274,71,1600,768,4
-4,-1,0,-4.0,-1.0,0.7077884674072266,49.62363799656123,22,-27,-44,274,71,1600,768,4
-3,-2,0,-3.0,-2.0,0.7157914638519287,46.373546489791295,22,-24,-42,274,71,1600,768,4
-1,0,0,-1.0,-0.0,0.7316365242004395,45.885279575251516,22,-23,-42,274,71,1600,768,4
-1,0,0,-1.0,-0.0,0.7798326015472412,45.41307836451879,22,-22,-42,274,71,1600,768,4
-1,-1,0,-1.0,-1.0,0.7878484725952148,44.06517122512408,22,-21,-41,274,71,1600,768,4
-2,-3,0,-2.0,-3.0,0.7957954406738281,40.485291572496,22,-19,-38,274,71,1600,768,4
-2,-2,0,-2.0,-2.0,0.8036985397338867,37.81205847478876,22,-17,-36,274,71,1600,768,4
-2,-3,0,-2.0,-3.0,0.8117315769195557,34.24913792078372,22,-15,-33,274,71,1600,768,4
-3,-3,0,-3.0,-3.0,0.8195483684539795,30.31098884280702,22,-12,-30,274,71,1600,768,4
-1,-2,0,-1.0,-2.0,0.8274295330047607,28.083217912982647,22,-11,-28,274,71,1600,768,4
-1,-1,0,-1.0,-1.0,0.8356995582580566,26.792360097775937,22,-10,-27,274,71,1600,768,4
-1,-2,0,-1.0,-2.0,0.8435614109039307,24.570660511172846,22,-9,-25,274,71,1600,768,4
-1,-1,0,-1.0,-1.0,0.8516254425048828,23.298221281347036,22,-8,-24,274,71,1600,768,4
-1,-1,0,-1.0,-1.0,0.8603494167327881,22.041630560342615,22,-7,-23,274,71,1600,768,4
-1,-1,0,-1.0,-1.0,0.8676455020904541,20.80350850198276,22,-6,-22,274,71,1600,768,4
0,-2,0,-0.0,-2.0,0.8756375312805176,18.8806130178211,22,-6,-20,274,71,1600,768,4
0,-2,0,-0.0,-2.0,0.8916714191436768,16.973665961010276,22,-6,-18,274,71,1600,768,4
-1,-1,0,-1.0,-1.0,0.8995194435119629,15.72004514666935,22,-5,-17,274,71,1600,768,4
-1,-1,0,-1.0,-1.0,0.9075644016265869,14.492422502470642,22,-4,-16,274,71,1600,768,4
0,-2,0,-0.0,-2.0,0.9155614376068115,12.560219778561036,22,-4,-14,274,71,1600,768,4
-1,-1,0,-1.0,-1.0,0.9235014915466309,11.341664064126334,22,-3,-13,274,71,1600,768,4
0,-2,0,-0.0,-2.0,0.9316534996032715,9.40175425099138,22,-3,-11,274,71,1600,768,4
-1,-1,0,-1.0,-1.0,0.9407985210418701,8.198039027185569,22,-2,-10,274,71,1600,768,4
0,-1,0,-0.0,-1.0,0.9476995468139648,7.219544457292887,22,-2,-9,274,71,1600,768,4
0,-2,0,-0.0,-2.0,0.9556055068969727,5.280109889280518,22,-2,-7,274,71,1600,768,4
-1,-1,0,-1.0,-1.0,0.9636945724487305,4.082762530298219,22,-1,-6,274,71,1600,768,4
0,-1,0,-0.0,-1.0,0.9795684814453125,3.0990195135927845,22,-1,-5,274,71,1600,768,4
-1,0,0,-1.0,-0.0,0.9876794815063477,3.0,22,0,-5,274,71,1600,768,4
0,-1,0,-0.0,-1.0,0.9957144260406494,2.0,22,0,-4,274,71,1600,768,4
0,-1,0,-0.0,-1.0,1.0195024013519287,1.0,22,0,-3,274,71,1600,768,4
0,-1,0,-0.0,-1.0,1.0274755954742432,0.0,22,0,-2,274,71,1600,768,4
0,-1,0,-0.0,-1.0,1.0437533855438232,-1.0,22,0,-1,274,71,1600,768,4
-1,-1,0,-1.0,-1.0,1.0516984462738037,-1.0,22,1,0,274,71,1600,768,4
0,-1,0,-0.0,-1.0,1.059612512588501,-0.5857864376269049,22,1,1,274,71,1600,768,4
0,-1,0,-0.0,-1.0,1.0836355686187744,0.2360679774997898,22,1,2,274,71,1600,768,4
0,-2,0,-0.0,-2.0,1.0916833877563477,2.1231056256176606,22,1,4,274,71,1600,768,4
0,-1,0,-0.0,-1.0,1.0995965003967285,3.0990195135927845,22,1,5,274,71,1600,768,4
0,-1,0,-0.0,-1.0,1.115553379058838,4.082762530298219,22,1,6,274,71,1600,768,4
0,0,1,-0.0,-0.0,1.1745045185089111,4.082762530298219,22,1,6,274,71,1600,768,4
0,0,0,-0.0,-0.0,1.2685894966125488,4.082762530298219,22,1,6,274,71,1600,768,4
5,4,0,5.0,4.0,1.3236005306243896,2.4721359549995796,22,-4,2,274,71,1600,768,4
7,7,0,7.0,7.0,1.3316645622253418,10.083045973594572,22,-11,-5,274,71,1600,768,4
5,6,0,5.0,6.0,1.339475393295288,17.4164878389476,22,-16,-11,274,71,1600,768,4
7,8,0,7.0,8.0,1.3474135398864746,27.832867780352597,22,-23,-19,274,71,1600,768,4
10,11,0,10.0,11.0,1.3555564880371094,42.598206241955516,22,-33,-30,274,71,1600,768,4
11,11,0,11.0,11.0,1.3635303974151611,58.14149981501958,22,-44,-41,274,71,1600,768,4
13,12,0,13.0,12.0,1.3715245723724365,75.83315488916018,22,-57,-53,274,71,1600,768,4
12,11,0,12.0,11.0,1.3795444965362549,92.11163583744573,22,-69,-64,274,71,1600,768,4
12,8,0,12.0,8.0,1.3875715732574463,106.37435120913067,22,-81,-72,274,71,1600,768,4
8,7,0,8.0,7.0,1.3955883979797363,117.00420160649792,22,-89,-79,274,71,1600,768,4
3,3,0,3.0,3.0,1.4035274982452393,121.23960402403117,22,-92,-82,274,71,1600,768,4
-1,0,0,-1.0,-0.0,1.4436814785003662,120.494897852931,22,-91,-82,274,71,1600,768,4
-2,0,0,-2.0,-0.0,1.4516913890838623,119.01652779682617,22,-89,-82,274,71,1600,768,4
-3,-1,0,-3.0,-1.0,1.4595425128936768,116.1397477566293,22,-86,-81,274,71,1600,768,4
-3,-1,0,-3.0,-1.0,1.4677155017852783,113.27792503337315,22,-83,-80,274,71,1600,768,4
-3,-2,0,-3.0,-2.0,1.475759506225586,109.73182178770737,22,-80,-78,274,71,1600,768,4
-3,-3,0,-3.0,-3.0,1.4834973812103271,105.48953437428223,22,-77,-75,274,71,1600,768,4
